date,country,geoid,cases,deaths,population,cum_cases,cum_deaths
2020-03-03,Andorra,AD,1,0,77006,1,0
2020-03-14,Andorra,AD,1,0,77006,2,0
2020-03-16,Andorra,AD,3,0,77006,5,0
2020-03-17,Andorra,AD,9,0,77006,14,0
2020-03-18,Andorra,AD,0,0,77006,14,0
2020-03-19,Andorra,AD,39,0,77006,53,0
2020-03-20,Andorra,AD,22,0,77006,75,0
2020-03-21,Andorra,AD,0,0,77006,75,0
2020-03-22,Andorra,AD,13,0,77006,88,0
2020-03-23,Andorra,AD,25,0,77006,113,0
2020-03-24,Andorra,AD,20,0,77006,133,0
2020-03-25,Andorra,AD,31,0,77006,164,0
2020-03-26,Andorra,AD,24,0,77006,188,0
2020-03-27,Andorra,AD,36,3,77006,224,3
2020-03-28,Andorra,AD,43,0,77006,267,3
2020-03-29,Andorra,AD,41,1,77006,308,4
2020-03-30,Andorra,AD,26,2,77006,334,6
2020-03-31,Andorra,AD,36,2,77006,370,8
2020-04-01,Andorra,AD,6,4,77006,376,12
2020-04-02,Andorra,AD,14,2,77006,390,14
2020-04-03,Andorra,AD,38,1,77006,428,15
2020-04-04,Andorra,AD,11,1,77006,439,16
2020-04-05,Andorra,AD,27,1,77006,466,17
2020-04-06,Andorra,AD,35,1,77006,501,18
2020-04-07,Andorra,AD,25,3,77006,526,21
2020-04-08,Andorra,AD,19,1,77006,545,22
2020-04-09,Andorra,AD,19,1,77006,564,23
2020-04-10,Andorra,AD,19,2,77006,583,25
2020-04-11,Andorra,AD,18,1,77006,601,26
2020-04-12,Andorra,AD,21,2,77006,622,28
2020-04-13,Andorra,AD,16,1,77006,638,29
2020-04-14,Andorra,AD,8,0,77006,646,29
2020-04-15,Andorra,AD,13,2,77006,659,31
2020-04-16,Andorra,AD,14,2,77006,673,33
2020-04-17,Andorra,AD,9,0,77006,682,33
2020-04-18,Andorra,AD,14,2,77006,696,35
2020-04-19,Andorra,AD,8,0,77006,704,35
2020-04-20,Andorra,AD,9,1,77006,713,36
2020-04-21,Andorra,AD,4,0,77006,717,36
2020-04-22,Andorra,AD,0,1,77006,717,37
2020-04-23,Andorra,AD,6,0,77006,723,37
2020-04-24,Andorra,AD,1,0,77006,724,37
2020-04-25,Andorra,AD,7,3,77006,731,40
2020-04-26,Andorra,AD,2,0,77006,733,40
2020-04-27,Andorra,AD,7,0,77006,740,40
2020-04-28,Andorra,AD,3,0,77006,743,40
2020-04-29,Andorra,AD,0,1,77006,743,41
2020-04-30,Andorra,AD,0,1,77006,743,42
2020-05-01,Andorra,AD,2,0,77006,745,42
2020-05-02,Andorra,AD,1,1,77006,746,43
2020-05-03,Andorra,AD,1,1,77006,747,44
2019-12-31,United_Arab_Emirates,AE,0,0,9630959,0,0
2020-01-01,United_Arab_Emirates,AE,0,0,9630959,0,0
2020-01-02,United_Arab_Emirates,AE,0,0,9630959,0,0
2020-01-03,United_Arab_Emirates,AE,0,0,9630959,0,0
2020-01-04,United_Arab_Emirates,AE,0,0,9630959,0,0
2020-01-05,United_Arab_Emirates,AE,0,0,9630959,0,0
2020-01-06,United_Arab_Emirates,AE,0,0,9630959,0,0
2020-01-07,United_Arab_Emirates,AE,0,0,9630959,0,0
2020-01-08,United_Arab_Emirates,AE,0,0,9630959,0,0
2020-01-09,United_Arab_Emirates,AE,0,0,9630959,0,0
2020-01-10,United_Arab_Emirates,AE,0,0,9630959,0,0
2020-01-11,United_Arab_Emirates,AE,0,0,9630959,0,0
2020-01-12,United_Arab_Emirates,AE,0,0,9630959,0,0
2020-01-13,United_Arab_Emirates,AE,0,0,9630959,0,0
2020-01-14,United_Arab_Emirates,AE,0,0,9630959,0,0
2020-01-15,United_Arab_Emirates,AE,0,0,9630959,0,0
2020-01-16,United_Arab_Emirates,AE,0,0,9630959,0,0
2020-01-17,United_Arab_Emirates,AE,0,0,9630959,0,0
2020-01-18,United_Arab_Emirates,AE,0,0,9630959,0,0
2020-01-19,United_Arab_Emirates,AE,0,0,9630959,0,0
2020-01-20,United_Arab_Emirates,AE,0,0,9630959,0,0
2020-01-21,United_Arab_Emirates,AE,0,0,9630959,0,0
2020-01-22,United_Arab_Emirates,AE,0,0,9630959,0,0
2020-01-23,United_Arab_Emirates,AE,0,0,9630959,0,0
2020-01-24,United_Arab_Emirates,AE,0,0,9630959,0,0
2020-01-25,United_Arab_Emirates,AE,0,0,9630959,0,0
2020-01-26,United_Arab_Emirates,AE,0,0,9630959,0,0
2020-01-27,United_Arab_Emirates,AE,1,0,9630959,1,0
2020-01-28,United_Arab_Emirates,AE,0,0,9630959,1,0
2020-01-29,United_Arab_Emirates,AE,0,0,9630959,1,0
2020-01-30,United_Arab_Emirates,AE,3,0,9630959,4,0
2020-01-31,United_Arab_Emirates,AE,0,0,9630959,4,0
2020-02-01,United_Arab_Emirates,AE,0,0,9630959,4,0
2020-02-02,United_Arab_Emirates,AE,1,0,9630959,5,0
2020-02-03,United_Arab_Emirates,AE,0,0,9630959,5,0
2020-02-04,United_Arab_Emirates,AE,0,0,9630959,5,0
2020-02-05,United_Arab_Emirates,AE,0,0,9630959,5,0
2020-02-06,United_Arab_Emirates,AE,0,0,9630959,5,0
2020-02-07,United_Arab_Emirates,AE,0,0,9630959,5,0
2020-02-08,United_Arab_Emirates,AE,2,0,9630959,7,0
2020-02-09,United_Arab_Emirates,AE,0,0,9630959,7,0
2020-02-10,United_Arab_Emirates,AE,0,0,9630959,7,0
2020-02-11,United_Arab_Emirates,AE,1,0,9630959,8,0
2020-02-12,United_Arab_Emirates,AE,0,0,9630959,8,0
2020-02-13,United_Arab_Emirates,AE,0,0,9630959,8,0
2020-02-14,United_Arab_Emirates,AE,0,0,9630959,8,0
2020-02-15,United_Arab_Emirates,AE,0,0,9630959,8,0
2020-02-16,United_Arab_Emirates,AE,0,0,9630959,8,0
2020-02-17,United_Arab_Emirates,AE,1,0,9630959,9,0
2020-02-18,United_Arab_Emirates,AE,0,0,9630959,9,0
2020-02-19,United_Arab_Emirates,AE,0,0,9630959,9,0
2020-02-20,United_Arab_Emirates,AE,0,0,9630959,9,0
2020-02-21,United_Arab_Emirates,AE,0,0,9630959,9,0
2020-02-22,United_Arab_Emirates,AE,2,0,9630959,11,0
2020-02-23,United_Arab_Emirates,AE,2,0,9630959,13,0
2020-02-24,United_Arab_Emirates,AE,0,0,9630959,13,0
2020-02-25,United_Arab_Emirates,AE,0,0,9630959,13,0
2020-02-26,United_Arab_Emirates,AE,0,0,9630959,13,0
2020-02-27,United_Arab_Emirates,AE,0,0,9630959,13,0
2020-02-28,United_Arab_Emirates,AE,6,0,9630959,19,0
2020-02-29,United_Arab_Emirates,AE,0,0,9630959,19,0
2020-03-01,United_Arab_Emirates,AE,2,0,9630959,21,0
2020-03-02,United_Arab_Emirates,AE,0,0,9630959,21,0
2020-03-04,United_Arab_Emirates,AE,6,0,9630959,27,0
2020-03-06,United_Arab_Emirates,AE,2,0,9630959,29,0
2020-03-08,United_Arab_Emirates,AE,16,0,9630959,45,0
2020-03-10,United_Arab_Emirates,AE,14,0,9630959,59,0
2020-03-11,United_Arab_Emirates,AE,15,0,9630959,74,0
2020-03-13,United_Arab_Emirates,AE,11,0,9630959,85,0
2020-03-15,United_Arab_Emirates,AE,0,0,9630959,85,0
2020-03-16,United_Arab_Emirates,AE,1,0,9630959,86,0
2020-03-17,United_Arab_Emirates,AE,12,0,9630959,98,0
2020-03-18,United_Arab_Emirates,AE,15,0,9630959,113,0
2020-03-19,United_Arab_Emirates,AE,0,0,9630959,113,0
2020-03-20,United_Arab_Emirates,AE,27,0,9630959,140,0
2020-03-21,United_Arab_Emirates,AE,0,0,9630959,140,0
2020-03-22,United_Arab_Emirates,AE,13,2,9630959,153,2
2020-03-23,United_Arab_Emirates,AE,0,0,9630959,153,2
2020-03-24,United_Arab_Emirates,AE,45,0,9630959,198,2
2020-03-25,United_Arab_Emirates,AE,50,0,9630959,248,2
2020-03-26,United_Arab_Emirates,AE,85,0,9630959,333,2
2020-03-27,United_Arab_Emirates,AE,0,0,9630959,333,2
2020-03-28,United_Arab_Emirates,AE,72,0,9630959,405,2
2020-03-29,United_Arab_Emirates,AE,63,0,9630959,468,2
2020-03-30,United_Arab_Emirates,AE,0,0,9630959,468,2
2020-03-31,United_Arab_Emirates,AE,143,3,9630959,611,5
2020-04-01,United_Arab_Emirates,AE,53,1,9630959,664,6
2020-04-02,United_Arab_Emirates,AE,0,0,9630959,664,6
2020-04-03,United_Arab_Emirates,AE,360,2,9630959,1024,8
2020-04-04,United_Arab_Emirates,AE,0,0,9630959,1024,8
2020-04-05,United_Arab_Emirates,AE,481,2,9630959,1505,10
2020-04-06,United_Arab_Emirates,AE,294,0,9630959,1799,10
2020-04-07,United_Arab_Emirates,AE,277,1,9630959,2076,11
2020-04-08,United_Arab_Emirates,AE,283,1,9630959,2359,12
2020-04-09,United_Arab_Emirates,AE,300,0,9630959,2659,12
2020-04-10,United_Arab_Emirates,AE,331,2,9630959,2990,14
2020-04-11,United_Arab_Emirates,AE,370,2,9630959,3360,16
2020-04-12,United_Arab_Emirates,AE,376,4,9630959,3736,20
2020-04-13,United_Arab_Emirates,AE,387,2,9630959,4123,22
2020-04-14,United_Arab_Emirates,AE,398,3,9630959,4521,25
2020-04-15,United_Arab_Emirates,AE,412,3,9630959,4933,28
2020-04-16,United_Arab_Emirates,AE,432,5,9630959,5365,33
2020-04-17,United_Arab_Emirates,AE,460,0,9630959,5825,33
2020-04-18,United_Arab_Emirates,AE,0,2,9630959,5825,35
2020-04-19,United_Arab_Emirates,AE,477,2,9630959,6302,37
2020-04-20,United_Arab_Emirates,AE,479,4,9630959,6781,41
2020-04-21,United_Arab_Emirates,AE,484,2,9630959,7265,43
2020-04-22,United_Arab_Emirates,AE,490,3,9630959,7755,46
2020-04-23,United_Arab_Emirates,AE,483,6,9630959,8238,52
2020-04-24,United_Arab_Emirates,AE,518,4,9630959,8756,56
2020-04-25,United_Arab_Emirates,AE,525,8,9630959,9281,64
2020-04-26,United_Arab_Emirates,AE,532,0,9630959,9813,64
2020-04-27,United_Arab_Emirates,AE,536,12,9630959,10349,76
2020-04-28,United_Arab_Emirates,AE,490,6,9630959,10839,82
2020-04-29,United_Arab_Emirates,AE,541,7,9630959,11380,89
2020-04-30,United_Arab_Emirates,AE,549,9,9630959,11929,98
2020-05-01,United_Arab_Emirates,AE,552,7,9630959,12481,105
2020-05-02,United_Arab_Emirates,AE,557,6,9630959,13038,111
2020-05-03,United_Arab_Emirates,AE,561,8,9630959,13599,119
2019-12-31,Afghanistan,AF,0,0,37172386,0,0
2020-01-01,Afghanistan,AF,0,0,37172386,0,0
2020-01-02,Afghanistan,AF,0,0,37172386,0,0
2020-01-03,Afghanistan,AF,0,0,37172386,0,0
2020-01-04,Afghanistan,AF,0,0,37172386,0,0
2020-01-05,Afghanistan,AF,0,0,37172386,0,0
2020-01-06,Afghanistan,AF,0,0,37172386,0,0
2020-01-07,Afghanistan,AF,0,0,37172386,0,0
2020-01-08,Afghanistan,AF,0,0,37172386,0,0
2020-01-09,Afghanistan,AF,0,0,37172386,0,0
2020-01-10,Afghanistan,AF,0,0,37172386,0,0
2020-01-11,Afghanistan,AF,0,0,37172386,0,0
2020-01-12,Afghanistan,AF,0,0,37172386,0,0
2020-01-13,Afghanistan,AF,0,0,37172386,0,0
2020-01-14,Afghanistan,AF,0,0,37172386,0,0
2020-01-15,Afghanistan,AF,0,0,37172386,0,0
2020-01-16,Afghanistan,AF,0,0,37172386,0,0
2020-01-17,Afghanistan,AF,0,0,37172386,0,0
2020-01-18,Afghanistan,AF,0,0,37172386,0,0
2020-01-19,Afghanistan,AF,0,0,37172386,0,0
2020-01-20,Afghanistan,AF,0,0,37172386,0,0
2020-01-21,Afghanistan,AF,0,0,37172386,0,0
2020-01-22,Afghanistan,AF,0,0,37172386,0,0
2020-01-23,Afghanistan,AF,0,0,37172386,0,0
2020-01-24,Afghanistan,AF,0,0,37172386,0,0
2020-01-25,Afghanistan,AF,0,0,37172386,0,0
2020-01-26,Afghanistan,AF,0,0,37172386,0,0
2020-01-27,Afghanistan,AF,0,0,37172386,0,0
2020-01-28,Afghanistan,AF,0,0,37172386,0,0
2020-01-29,Afghanistan,AF,0,0,37172386,0,0
2020-01-30,Afghanistan,AF,0,0,37172386,0,0
2020-01-31,Afghanistan,AF,0,0,37172386,0,0
2020-02-01,Afghanistan,AF,0,0,37172386,0,0
2020-02-02,Afghanistan,AF,0,0,37172386,0,0
2020-02-03,Afghanistan,AF,0,0,37172386,0,0
2020-02-04,Afghanistan,AF,0,0,37172386,0,0
2020-02-05,Afghanistan,AF,0,0,37172386,0,0
2020-02-06,Afghanistan,AF,0,0,37172386,0,0
2020-02-07,Afghanistan,AF,0,0,37172386,0,0
2020-02-08,Afghanistan,AF,0,0,37172386,0,0
2020-02-09,Afghanistan,AF,0,0,37172386,0,0
2020-02-10,Afghanistan,AF,0,0,37172386,0,0
2020-02-11,Afghanistan,AF,0,0,37172386,0,0
2020-02-12,Afghanistan,AF,0,0,37172386,0,0
2020-02-13,Afghanistan,AF,0,0,37172386,0,0
2020-02-14,Afghanistan,AF,0,0,37172386,0,0
2020-02-15,Afghanistan,AF,0,0,37172386,0,0
2020-02-16,Afghanistan,AF,0,0,37172386,0,0
2020-02-17,Afghanistan,AF,0,0,37172386,0,0
2020-02-18,Afghanistan,AF,0,0,37172386,0,0
2020-02-19,Afghanistan,AF,0,0,37172386,0,0
2020-02-20,Afghanistan,AF,0,0,37172386,0,0
2020-02-21,Afghanistan,AF,0,0,37172386,0,0
2020-02-22,Afghanistan,AF,0,0,37172386,0,0
2020-02-23,Afghanistan,AF,0,0,37172386,0,0
2020-02-24,Afghanistan,AF,0,0,37172386,0,0
2020-02-25,Afghanistan,AF,1,0,37172386,1,0
2020-02-26,Afghanistan,AF,0,0,37172386,1,0
2020-02-27,Afghanistan,AF,0,0,37172386,1,0
2020-02-28,Afghanistan,AF,0,0,37172386,1,0
2020-02-29,Afghanistan,AF,0,0,37172386,1,0
2020-03-01,Afghanistan,AF,0,0,37172386,1,0
2020-03-02,Afghanistan,AF,0,0,37172386,1,0
2020-03-08,Afghanistan,AF,3,0,37172386,4,0
2020-03-11,Afghanistan,AF,3,0,37172386,7,0
2020-03-15,Afghanistan,AF,3,0,37172386,10,0
2020-03-16,Afghanistan,AF,6,0,37172386,16,0
2020-03-17,Afghanistan,AF,5,0,37172386,21,0
2020-03-18,Afghanistan,AF,1,0,37172386,22,0
2020-03-19,Afghanistan,AF,0,0,37172386,22,0
2020-03-20,Afghanistan,AF,0,0,37172386,22,0
2020-03-21,Afghanistan,AF,2,0,37172386,24,0
2020-03-22,Afghanistan,AF,0,0,37172386,24,0
2020-03-23,Afghanistan,AF,10,0,37172386,34,0
2020-03-24,Afghanistan,AF,6,1,37172386,40,1
2020-03-25,Afghanistan,AF,2,0,37172386,42,1
2020-03-26,Afghanistan,AF,33,0,37172386,75,1
2020-03-27,Afghanistan,AF,0,0,37172386,75,1
2020-03-28,Afghanistan,AF,16,1,37172386,91,2
2020-03-29,Afghanistan,AF,15,1,37172386,106,3
2020-03-30,Afghanistan,AF,8,1,37172386,114,4
2020-03-31,Afghanistan,AF,27,0,37172386,141,4
2020-04-01,Afghanistan,AF,25,0,37172386,166,4
2020-04-02,Afghanistan,AF,26,0,37172386,192,4
2020-04-03,Afghanistan,AF,43,0,37172386,235,4
2020-04-04,Afghanistan,AF,0,0,37172386,235,4
2020-04-05,Afghanistan,AF,35,1,37172386,270,5
2020-04-06,Afghanistan,AF,29,2,37172386,299,7
2020-04-07,Afghanistan,AF,38,0,37172386,337,7
2020-04-08,Afghanistan,AF,30,4,37172386,367,11
2020-04-09,Afghanistan,AF,56,3,37172386,423,14
2020-04-10,Afghanistan,AF,61,1,37172386,484,15
2020-04-11,Afghanistan,AF,37,0,37172386,521,15
2020-04-12,Afghanistan,AF,34,3,37172386,555,18
2020-04-13,Afghanistan,AF,52,0,37172386,607,18
2020-04-14,Afghanistan,AF,58,3,37172386,665,21
2020-04-15,Afghanistan,AF,49,2,37172386,714,23
2020-04-16,Afghanistan,AF,70,2,37172386,784,25
2020-04-17,Afghanistan,AF,10,4,37172386,794,29
2020-04-18,Afghanistan,AF,51,1,37172386,845,30
2020-04-19,Afghanistan,AF,63,0,37172386,908,30
2020-04-20,Afghanistan,AF,88,3,37172386,996,33
2020-04-21,Afghanistan,AF,35,2,37172386,1031,35
2020-04-22,Afghanistan,AF,61,1,37172386,1092,36
2020-04-23,Afghanistan,AF,84,4,37172386,1176,40
2020-04-24,Afghanistan,AF,105,2,37172386,1281,42
2020-04-25,Afghanistan,AF,70,1,37172386,1351,43
2020-04-26,Afghanistan,AF,112,4,37172386,1463,47
2020-04-27,Afghanistan,AF,68,10,37172386,1531,57
2020-04-28,Afghanistan,AF,172,0,37172386,1703,57
2020-04-29,Afghanistan,AF,124,3,37172386,1827,60
2020-04-30,Afghanistan,AF,122,0,37172386,1949,60
2020-05-01,Afghanistan,AF,222,4,37172386,2171,64
2020-05-02,Afghanistan,AF,164,4,37172386,2335,68
2020-05-03,Afghanistan,AF,134,4,37172386,2469,72
2020-03-15,Antigua_and_Barbuda,AG,1,0,96286,1,0
2020-03-21,Antigua_and_Barbuda,AG,0,0,96286,1,0
2020-03-22,Antigua_and_Barbuda,AG,0,0,96286,1,0
2020-03-23,Antigua_and_Barbuda,AG,0,0,96286,1,0
2020-03-24,Antigua_and_Barbuda,AG,0,0,96286,1,0
2020-03-25,Antigua_and_Barbuda,AG,2,0,96286,3,0
2020-03-26,Antigua_and_Barbuda,AG,0,0,96286,3,0
2020-03-27,Antigua_and_Barbuda,AG,4,0,96286,7,0
2020-03-28,Antigua_and_Barbuda,AG,0,0,96286,7,0
2020-03-29,Antigua_and_Barbuda,AG,0,0,96286,7,0
2020-03-30,Antigua_and_Barbuda,AG,0,0,96286,7,0
2020-03-31,Antigua_and_Barbuda,AG,0,0,96286,7,0
2020-04-01,Antigua_and_Barbuda,AG,0,0,96286,7,0
2020-04-02,Antigua_and_Barbuda,AG,0,0,96286,7,0
2020-04-03,Antigua_and_Barbuda,AG,2,0,96286,9,0
2020-04-04,Antigua_and_Barbuda,AG,6,0,96286,15,0
2020-04-05,Antigua_and_Barbuda,AG,0,0,96286,15,0
2020-04-06,Antigua_and_Barbuda,AG,0,0,96286,15,0
2020-04-07,Antigua_and_Barbuda,AG,0,0,96286,15,0
2020-04-08,Antigua_and_Barbuda,AG,0,0,96286,15,0
2020-04-09,Antigua_and_Barbuda,AG,0,0,96286,15,0
2020-04-10,Antigua_and_Barbuda,AG,4,2,96286,19,2
2020-04-11,Antigua_and_Barbuda,AG,2,0,96286,21,2
2020-04-12,Antigua_and_Barbuda,AG,0,0,96286,21,2
2020-04-13,Antigua_and_Barbuda,AG,0,0,96286,21,2
2020-04-14,Antigua_and_Barbuda,AG,2,0,96286,23,2
2020-04-15,Antigua_and_Barbuda,AG,0,0,96286,23,2
2020-04-16,Antigua_and_Barbuda,AG,0,0,96286,23,2
2020-04-17,Antigua_and_Barbuda,AG,0,0,96286,23,2
2020-04-18,Antigua_and_Barbuda,AG,0,0,96286,23,2
2020-04-19,Antigua_and_Barbuda,AG,0,0,96286,23,2
2020-04-20,Antigua_and_Barbuda,AG,0,0,96286,23,2
2020-04-21,Antigua_and_Barbuda,AG,0,1,96286,23,3
2020-04-22,Antigua_and_Barbuda,AG,1,0,96286,24,3
2020-04-23,Antigua_and_Barbuda,AG,0,0,96286,24,3
2020-04-24,Antigua_and_Barbuda,AG,0,0,96286,24,3
2020-04-25,Antigua_and_Barbuda,AG,0,0,96286,24,3
2020-04-26,Antigua_and_Barbuda,AG,0,0,96286,24,3
2020-04-27,Antigua_and_Barbuda,AG,0,0,96286,24,3
2020-04-28,Antigua_and_Barbuda,AG,0,0,96286,24,3
2020-04-29,Antigua_and_Barbuda,AG,0,0,96286,24,3
2020-04-30,Antigua_and_Barbuda,AG,0,0,96286,24,3
2020-05-01,Antigua_and_Barbuda,AG,0,0,96286,24,3
2020-05-02,Antigua_and_Barbuda,AG,1,0,96286,25,3
2020-05-03,Antigua_and_Barbuda,AG,0,0,96286,25,3
2020-03-27,Anguilla,AI,2,0,0,2,0
2020-03-28,Anguilla,AI,0,0,0,2,0
2020-03-29,Anguilla,AI,0,0,0,2,0
2020-03-30,Anguilla,AI,0,0,0,2,0
2020-03-31,Anguilla,AI,0,0,0,2,0
2020-04-01,Anguilla,AI,0,0,0,2,0
2020-04-02,Anguilla,AI,0,0,0,2,0
2020-04-03,Anguilla,AI,1,0,0,3,0
2020-04-04,Anguilla,AI,0,0,0,3,0
2020-04-05,Anguilla,AI,0,0,0,3,0
2020-04-06,Anguilla,AI,0,0,0,3,0
2020-04-07,Anguilla,AI,0,0,0,3,0
2020-04-08,Anguilla,AI,0,0,0,3,0
2020-04-09,Anguilla,AI,0,0,0,3,0
2020-04-10,Anguilla,AI,0,0,0,3,0
2020-04-11,Anguilla,AI,0,0,0,3,0
2020-04-12,Anguilla,AI,0,0,0,3,0
2020-04-13,Anguilla,AI,0,0,0,3,0
2020-04-14,Anguilla,AI,0,0,0,3,0
2020-04-15,Anguilla,AI,0,0,0,3,0
2020-04-16,Anguilla,AI,0,0,0,3,0
2020-04-17,Anguilla,AI,0,0,0,3,0
2020-04-18,Anguilla,AI,0,0,0,3,0
2020-04-19,Anguilla,AI,0,0,0,3,0
2020-04-20,Anguilla,AI,0,0,0,3,0
2020-04-21,Anguilla,AI,0,0,0,3,0
2020-04-22,Anguilla,AI,0,0,0,3,0
2020-04-23,Anguilla,AI,0,0,0,3,0
2020-04-24,Anguilla,AI,0,0,0,3,0
2020-04-25,Anguilla,AI,0,0,0,3,0
2020-04-26,Anguilla,AI,0,0,0,3,0
2020-04-27,Anguilla,AI,0,0,0,3,0
2020-04-28,Anguilla,AI,0,0,0,3,0
2020-04-29,Anguilla,AI,0,0,0,3,0
2020-04-30,Anguilla,AI,0,0,0,3,0
2020-05-01,Anguilla,AI,0,0,0,3,0
2020-05-02,Anguilla,AI,0,0,0,3,0
2020-05-03,Anguilla,AI,0,0,0,3,0
2020-03-09,Albania,AL,2,0,2866376,2,0
2020-03-10,Albania,AL,4,0,2866376,6,0
2020-03-11,Albania,AL,4,0,2866376,10,0
2020-03-12,Albania,AL,1,1,2866376,11,1
2020-03-13,Albania,AL,12,0,2866376,23,1
2020-03-14,Albania,AL,10,0,2866376,33,1
2020-03-15,Albania,AL,5,0,2866376,38,1
2020-03-16,Albania,AL,4,0,2866376,42,1
2020-03-17,Albania,AL,9,0,2866376,51,1
2020-03-18,Albania,AL,4,0,2866376,55,1
2020-03-19,Albania,AL,4,1,2866376,59,2
2020-03-20,Albania,AL,11,0,2866376,70,2
2020-03-21,Albania,AL,0,0,2866376,70,2
2020-03-22,Albania,AL,6,0,2866376,76,2
2020-03-23,Albania,AL,13,0,2866376,89,2
2020-03-24,Albania,AL,11,2,2866376,100,4
2020-03-25,Albania,AL,23,1,2866376,123,5
2020-03-26,Albania,AL,23,0,2866376,146,5
2020-03-27,Albania,AL,28,1,2866376,174,6
2020-03-28,Albania,AL,12,3,2866376,186,9
2020-03-29,Albania,AL,11,1,2866376,197,10
2020-03-30,Albania,AL,15,0,2866376,212,10
2020-03-31,Albania,AL,11,2,2866376,223,12
2020-04-01,Albania,AL,20,3,2866376,243,15
2020-04-02,Albania,AL,16,0,2866376,259,15
2020-04-03,Albania,AL,18,1,2866376,277,16
2020-04-04,Albania,AL,27,1,2866376,304,17
2020-04-05,Albania,AL,29,2,2866376,333,19
2020-04-06,Albania,AL,28,2,2866376,361,21
2020-04-07,Albania,AL,16,1,2866376,377,22
2020-04-08,Albania,AL,6,0,2866376,383,22
2020-04-09,Albania,AL,17,0,2866376,400,22
2020-04-10,Albania,AL,9,1,2866376,409,23
2020-04-11,Albania,AL,7,0,2866376,416,23
2020-04-12,Albania,AL,17,0,2866376,433,23
2020-04-13,Albania,AL,13,0,2866376,446,23
2020-04-14,Albania,AL,21,0,2866376,467,23
2020-04-15,Albania,AL,8,1,2866376,475,24
2020-04-16,Albania,AL,19,1,2866376,494,25
2020-04-17,Albania,AL,24,1,2866376,518,26
2020-04-18,Albania,AL,21,0,2866376,539,26
2020-04-19,Albania,AL,9,0,2866376,548,26
2020-04-20,Albania,AL,14,0,2866376,562,26
2020-04-21,Albania,AL,22,0,2866376,584,26
2020-04-22,Albania,AL,25,0,2866376,609,26
2020-04-23,Albania,AL,25,1,2866376,634,27
2020-04-24,Albania,AL,29,0,2866376,663,27
2020-04-25,Albania,AL,15,0,2866376,678,27
2020-04-26,Albania,AL,34,0,2866376,712,27
2020-04-27,Albania,AL,14,1,2866376,726,28
2020-04-28,Albania,AL,10,0,2866376,736,28
2020-04-29,Albania,AL,14,2,2866376,750,30
2020-04-30,Albania,AL,16,1,2866376,766,31
2020-05-01,Albania,AL,7,0,2866376,773,31
2020-05-02,Albania,AL,9,0,2866376,782,31
2020-05-03,Albania,AL,7,0,2866376,789,31
2019-12-31,Armenia,AM,0,0,2951776,0,0
2020-01-01,Armenia,AM,0,0,2951776,0,0
2020-01-02,Armenia,AM,0,0,2951776,0,0
2020-01-03,Armenia,AM,0,0,2951776,0,0
2020-01-04,Armenia,AM,0,0,2951776,0,0
2020-01-05,Armenia,AM,0,0,2951776,0,0
2020-01-06,Armenia,AM,0,0,2951776,0,0
2020-01-07,Armenia,AM,0,0,2951776,0,0
2020-01-08,Armenia,AM,0,0,2951776,0,0
2020-01-09,Armenia,AM,0,0,2951776,0,0
2020-01-10,Armenia,AM,0,0,2951776,0,0
2020-01-11,Armenia,AM,0,0,2951776,0,0
2020-01-12,Armenia,AM,0,0,2951776,0,0
2020-01-13,Armenia,AM,0,0,2951776,0,0
2020-01-14,Armenia,AM,0,0,2951776,0,0
2020-01-15,Armenia,AM,0,0,2951776,0,0
2020-01-16,Armenia,AM,0,0,2951776,0,0
2020-01-17,Armenia,AM,0,0,2951776,0,0
2020-01-18,Armenia,AM,0,0,2951776,0,0
2020-01-19,Armenia,AM,0,0,2951776,0,0
2020-01-20,Armenia,AM,0,0,2951776,0,0
2020-01-21,Armenia,AM,0,0,2951776,0,0
2020-01-22,Armenia,AM,0,0,2951776,0,0
2020-01-23,Armenia,AM,0,0,2951776,0,0
2020-01-24,Armenia,AM,0,0,2951776,0,0
2020-01-25,Armenia,AM,0,0,2951776,0,0
2020-01-26,Armenia,AM,0,0,2951776,0,0
2020-01-27,Armenia,AM,0,0,2951776,0,0
2020-01-28,Armenia,AM,0,0,2951776,0,0
2020-01-29,Armenia,AM,0,0,2951776,0,0
2020-01-30,Armenia,AM,0,0,2951776,0,0
2020-01-31,Armenia,AM,0,0,2951776,0,0
2020-02-01,Armenia,AM,0,0,2951776,0,0
2020-02-02,Armenia,AM,0,0,2951776,0,0
2020-02-03,Armenia,AM,0,0,2951776,0,0
2020-02-04,Armenia,AM,0,0,2951776,0,0
2020-02-05,Armenia,AM,0,0,2951776,0,0
2020-02-06,Armenia,AM,0,0,2951776,0,0
2020-02-07,Armenia,AM,0,0,2951776,0,0
2020-02-08,Armenia,AM,0,0,2951776,0,0
2020-02-09,Armenia,AM,0,0,2951776,0,0
2020-02-10,Armenia,AM,0,0,2951776,0,0
2020-02-11,Armenia,AM,0,0,2951776,0,0
2020-02-12,Armenia,AM,0,0,2951776,0,0
2020-02-13,Armenia,AM,0,0,2951776,0,0
2020-02-14,Armenia,AM,0,0,2951776,0,0
2020-02-15,Armenia,AM,0,0,2951776,0,0
2020-02-16,Armenia,AM,0,0,2951776,0,0
2020-02-17,Armenia,AM,0,0,2951776,0,0
2020-02-18,Armenia,AM,0,0,2951776,0,0
2020-02-19,Armenia,AM,0,0,2951776,0,0
2020-02-20,Armenia,AM,0,0,2951776,0,0
2020-02-21,Armenia,AM,0,0,2951776,0,0
2020-02-22,Armenia,AM,0,0,2951776,0,0
2020-02-23,Armenia,AM,0,0,2951776,0,0
2020-02-24,Armenia,AM,0,0,2951776,0,0
2020-02-25,Armenia,AM,0,0,2951776,0,0
2020-02-26,Armenia,AM,0,0,2951776,0,0
2020-02-27,Armenia,AM,0,0,2951776,0,0
2020-02-28,Armenia,AM,0,0,2951776,0,0
2020-02-29,Armenia,AM,0,0,2951776,0,0
2020-03-01,Armenia,AM,1,0,2951776,1,0
2020-03-02,Armenia,AM,0,0,2951776,1,0
2020-03-12,Armenia,AM,3,0,2951776,4,0
2020-03-13,Armenia,AM,2,0,2951776,6,0
2020-03-14,Armenia,AM,7,0,2951776,13,0
2020-03-15,Armenia,AM,7,0,2951776,20,0
2020-03-16,Armenia,AM,10,0,2951776,30,0
2020-03-17,Armenia,AM,22,0,2951776,52,0
2020-03-18,Armenia,AM,26,0,2951776,78,0
2020-03-19,Armenia,AM,37,0,2951776,115,0
2020-03-20,Armenia,AM,7,0,2951776,122,0
2020-03-21,Armenia,AM,14,0,2951776,136,0
2020-03-22,Armenia,AM,24,0,2951776,160,0
2020-03-23,Armenia,AM,30,0,2951776,190,0
2020-03-24,Armenia,AM,4,0,2951776,194,0
2020-03-25,Armenia,AM,71,0,2951776,265,0
2020-03-26,Armenia,AM,25,0,2951776,290,0
2020-03-27,Armenia,AM,39,1,2951776,329,1
2020-03-28,Armenia,AM,43,0,2951776,372,1
2020-03-29,Armenia,AM,52,2,2951776,424,3
2020-03-30,Armenia,AM,0,0,2951776,424,3
2020-03-31,Armenia,AM,58,0,2951776,482,3
2020-04-01,Armenia,AM,50,0,2951776,532,3
2020-04-02,Armenia,AM,39,0,2951776,571,3
2020-04-03,Armenia,AM,92,1,2951776,663,4
2020-04-04,Armenia,AM,73,3,2951776,736,7
2020-04-05,Armenia,AM,34,0,2951776,770,7
2020-04-06,Armenia,AM,52,0,2951776,822,7
2020-04-07,Armenia,AM,11,1,2951776,833,8
2020-04-08,Armenia,AM,20,0,2951776,853,8
2020-04-09,Armenia,AM,28,1,2951776,881,9
2020-04-10,Armenia,AM,40,1,2951776,921,10
2020-04-11,Armenia,AM,16,1,2951776,937,11
2020-04-12,Armenia,AM,30,2,2951776,967,13
2020-04-13,Armenia,AM,46,0,2951776,1013,13
2020-04-14,Armenia,AM,26,1,2951776,1039,14
2020-04-15,Armenia,AM,72,3,2951776,1111,17
2020-04-16,Armenia,AM,48,1,2951776,1159,18
2020-04-17,Armenia,AM,42,1,2951776,1201,19
2020-04-18,Armenia,AM,47,1,2951776,1248,20
2020-04-19,Armenia,AM,43,0,2951776,1291,20
2020-04-20,Armenia,AM,48,2,2951776,1339,22
2020-04-21,Armenia,AM,62,2,2951776,1401,24
2020-04-22,Armenia,AM,72,0,2951776,1473,24
2020-04-23,Armenia,AM,50,0,2951776,1523,24
2020-04-24,Armenia,AM,73,3,2951776,1596,27
2020-04-25,Armenia,AM,81,1,2951776,1677,28
2020-04-26,Armenia,AM,69,0,2951776,1746,28
2020-04-27,Armenia,AM,62,1,2951776,1808,29
2020-04-28,Armenia,AM,59,1,2951776,1867,30
2020-04-29,Armenia,AM,65,0,2951776,1932,30
2020-04-30,Armenia,AM,0,0,2951776,1932,30
2020-05-01,Armenia,AM,134,2,2951776,2066,32
2020-05-02,Armenia,AM,82,1,2951776,2148,33
2020-05-03,Armenia,AM,125,0,2951776,2273,33
2020-03-22,Angola,AO,2,0,30809762,2,0
2020-03-23,Angola,AO,0,0,30809762,2,0
2020-03-24,Angola,AO,0,0,30809762,2,0
2020-03-25,Angola,AO,0,0,30809762,2,0
2020-03-26,Angola,AO,0,0,30809762,2,0
2020-03-27,Angola,AO,1,0,30809762,3,0
2020-03-28,Angola,AO,1,0,30809762,4,0
2020-03-29,Angola,AO,0,0,30809762,4,0
2020-03-30,Angola,AO,3,2,30809762,7,2
2020-03-31,Angola,AO,0,0,30809762,7,2
2020-04-01,Angola,AO,0,0,30809762,7,2
2020-04-02,Angola,AO,1,0,30809762,8,2
2020-04-03,Angola,AO,0,0,30809762,8,2
2020-04-04,Angola,AO,0,0,30809762,8,2
2020-04-05,Angola,AO,2,0,30809762,10,2
2020-04-06,Angola,AO,4,0,30809762,14,2
2020-04-07,Angola,AO,2,0,30809762,16,2
2020-04-08,Angola,AO,1,0,30809762,17,2
2020-04-09,Angola,AO,2,0,30809762,19,2
2020-04-10,Angola,AO,0,0,30809762,19,2
2020-04-11,Angola,AO,0,0,30809762,19,2
2020-04-12,Angola,AO,0,0,30809762,19,2
2020-04-13,Angola,AO,0,0,30809762,19,2
2020-04-14,Angola,AO,0,0,30809762,19,2
2020-04-15,Angola,AO,0,0,30809762,19,2
2020-04-16,Angola,AO,0,0,30809762,19,2
2020-04-17,Angola,AO,0,0,30809762,19,2
2020-04-18,Angola,AO,0,0,30809762,19,2
2020-04-19,Angola,AO,5,0,30809762,24,2
2020-04-20,Angola,AO,0,0,30809762,24,2
2020-04-21,Angola,AO,0,0,30809762,24,2
2020-04-22,Angola,AO,0,0,30809762,24,2
2020-04-23,Angola,AO,0,0,30809762,24,2
2020-04-24,Angola,AO,1,0,30809762,25,2
2020-04-25,Angola,AO,0,0,30809762,25,2
2020-04-26,Angola,AO,0,0,30809762,25,2
2020-04-27,Angola,AO,1,0,30809762,26,2
2020-04-28,Angola,AO,1,0,30809762,27,2
2020-04-29,Angola,AO,0,0,30809762,27,2
2020-04-30,Angola,AO,0,0,30809762,27,2
2020-05-01,Angola,AO,0,0,30809762,27,2
2020-05-02,Angola,AO,2,0,30809762,29,2
2020-05-03,Angola,AO,6,0,30809762,35,2
2020-03-04,Argentina,AR,1,0,44494502,1,0
2020-03-06,Argentina,AR,1,0,44494502,2,0
2020-03-07,Argentina,AR,6,0,44494502,8,0
2020-03-08,Argentina,AR,1,1,44494502,9,1
2020-03-09,Argentina,AR,3,0,44494502,12,1
2020-03-11,Argentina,AR,7,0,44494502,19,1
2020-03-13,Argentina,AR,12,0,44494502,31,1
2020-03-14,Argentina,AR,3,1,44494502,34,2
2020-03-15,Argentina,AR,11,0,44494502,45,2
2020-03-16,Argentina,AR,11,0,44494502,56,2
2020-03-17,Argentina,AR,9,0,44494502,65,2
2020-03-18,Argentina,AR,14,0,44494502,79,2
2020-03-19,Argentina,AR,18,0,44494502,97,2
2020-03-20,Argentina,AR,31,1,44494502,128,3
2020-03-21,Argentina,AR,30,0,44494502,158,3
2020-03-22,Argentina,AR,67,1,44494502,225,4
2020-03-23,Argentina,AR,41,0,44494502,266,4
2020-03-24,Argentina,AR,35,0,44494502,301,4
2020-03-25,Argentina,AR,86,2,44494502,387,6
2020-03-26,Argentina,AR,115,2,44494502,502,8
2020-03-27,Argentina,AR,87,4,44494502,589,12
2020-03-28,Argentina,AR,101,5,44494502,690,17
2020-03-29,Argentina,AR,55,2,44494502,745,19
2020-03-30,Argentina,AR,75,1,44494502,820,20
2020-03-31,Argentina,AR,146,4,44494502,966,24
2020-04-01,Argentina,AR,0,0,44494502,966,24
2020-04-02,Argentina,AR,167,7,44494502,1133,31
2020-04-03,Argentina,AR,0,3,44494502,1133,34
2020-04-04,Argentina,AR,132,3,44494502,1265,37
2020-04-05,Argentina,AR,186,6,44494502,1451,43
2020-04-06,Argentina,AR,103,3,44494502,1554,46
2020-04-07,Argentina,AR,74,7,44494502,1628,53
2020-04-08,Argentina,AR,87,7,44494502,1715,60
2020-04-09,Argentina,AR,80,5,44494502,1795,65
2020-04-10,Argentina,AR,99,14,44494502,1894,79
2020-04-11,Argentina,AR,81,3,44494502,1975,82
2020-04-12,Argentina,AR,162,7,44494502,2137,89
2020-04-13,Argentina,AR,66,6,44494502,2203,95
2020-04-14,Argentina,AR,69,3,44494502,2272,98
2020-04-15,Argentina,AR,160,7,44494502,2432,105
2020-04-16,Argentina,AR,0,4,44494502,2432,109
2020-04-17,Argentina,AR,128,6,44494502,2560,115
2020-04-18,Argentina,AR,98,7,44494502,2658,122
2020-04-19,Argentina,AR,170,10,44494502,2828,132
2020-04-20,Argentina,AR,102,2,44494502,2930,134
2020-04-21,Argentina,AR,90,8,44494502,3020,142
2020-04-22,Argentina,AR,112,9,44494502,3132,151
2020-04-23,Argentina,AR,144,8,44494502,3276,159
2020-04-24,Argentina,AR,147,6,44494502,3423,165
2020-04-25,Argentina,AR,0,2,44494502,3423,167
2020-04-26,Argentina,AR,344,18,44494502,3767,185
2020-04-27,Argentina,AR,0,1,44494502,3767,186
2020-04-28,Argentina,AR,223,11,44494502,3990,197
2020-04-29,Argentina,AR,124,10,44494502,4114,207
2020-04-30,Argentina,AR,158,7,44494502,4272,214
2020-05-01,Argentina,AR,143,4,44494502,4415,218
2020-05-02,Argentina,AR,104,7,44494502,4519,225
2020-05-03,Argentina,AR,149,12,44494502,4668,237
2019-12-31,Austria,AT,0,0,8847037,0,0
2020-01-01,Austria,AT,0,0,8847037,0,0
2020-01-02,Austria,AT,0,0,8847037,0,0
2020-01-03,Austria,AT,0,0,8847037,0,0
2020-01-04,Austria,AT,0,0,8847037,0,0
2020-01-05,Austria,AT,0,0,8847037,0,0
2020-01-06,Austria,AT,0,0,8847037,0,0
2020-01-07,Austria,AT,0,0,8847037,0,0
2020-01-08,Austria,AT,0,0,8847037,0,0
2020-01-09,Austria,AT,0,0,8847037,0,0
2020-01-10,Austria,AT,0,0,8847037,0,0
2020-01-11,Austria,AT,0,0,8847037,0,0
2020-01-12,Austria,AT,0,0,8847037,0,0
2020-01-13,Austria,AT,0,0,8847037,0,0
2020-01-14,Austria,AT,0,0,8847037,0,0
2020-01-15,Austria,AT,0,0,8847037,0,0
2020-01-16,Austria,AT,0,0,8847037,0,0
2020-01-17,Austria,AT,0,0,8847037,0,0
2020-01-18,Austria,AT,0,0,8847037,0,0
2020-01-19,Austria,AT,0,0,8847037,0,0
2020-01-20,Austria,AT,0,0,8847037,0,0
2020-01-21,Austria,AT,0,0,8847037,0,0
2020-01-22,Austria,AT,0,0,8847037,0,0
2020-01-23,Austria,AT,0,0,8847037,0,0
2020-01-24,Austria,AT,0,0,8847037,0,0
2020-01-25,Austria,AT,0,0,8847037,0,0
2020-01-26,Austria,AT,0,0,8847037,0,0
2020-01-27,Austria,AT,0,0,8847037,0,0
2020-01-28,Austria,AT,0,0,8847037,0,0
2020-01-29,Austria,AT,0,0,8847037,0,0
2020-01-30,Austria,AT,0,0,8847037,0,0
2020-01-31,Austria,AT,0,0,8847037,0,0
2020-02-01,Austria,AT,0,0,8847037,0,0
2020-02-02,Austria,AT,0,0,8847037,0,0
2020-02-03,Austria,AT,0,0,8847037,0,0
2020-02-04,Austria,AT,0,0,8847037,0,0
2020-02-05,Austria,AT,0,0,8847037,0,0
2020-02-06,Austria,AT,0,0,8847037,0,0
2020-02-07,Austria,AT,0,0,8847037,0,0
2020-02-08,Austria,AT,0,0,8847037,0,0
2020-02-09,Austria,AT,0,0,8847037,0,0
2020-02-10,Austria,AT,0,0,8847037,0,0
2020-02-11,Austria,AT,0,0,8847037,0,0
2020-02-12,Austria,AT,0,0,8847037,0,0
2020-02-13,Austria,AT,0,0,8847037,0,0
2020-02-14,Austria,AT,0,0,8847037,0,0
2020-02-15,Austria,AT,0,0,8847037,0,0
2020-02-16,Austria,AT,0,0,8847037,0,0
2020-02-17,Austria,AT,0,0,8847037,0,0
2020-02-18,Austria,AT,0,0,8847037,0,0
2020-02-19,Austria,AT,0,0,8847037,0,0
2020-02-20,Austria,AT,0,0,8847037,0,0
2020-02-21,Austria,AT,0,0,8847037,0,0
2020-02-22,Austria,AT,0,0,8847037,0,0
2020-02-23,Austria,AT,0,0,8847037,0,0
2020-02-24,Austria,AT,0,0,8847037,0,0
2020-02-25,Austria,AT,0,0,8847037,0,0
2020-02-26,Austria,AT,2,0,8847037,2,0
2020-02-27,Austria,AT,0,0,8847037,2,0
2020-02-28,Austria,AT,3,0,8847037,5,0
2020-02-29,Austria,AT,2,0,8847037,7,0
2020-03-01,Austria,AT,3,0,8847037,10,0
2020-03-02,Austria,AT,4,0,8847037,14,0
2020-03-03,Austria,AT,4,0,8847037,18,0
2020-03-04,Austria,AT,6,0,8847037,24,0
2020-03-05,Austria,AT,5,0,8847037,29,0
2020-03-06,Austria,AT,12,0,8847037,41,0
2020-03-07,Austria,AT,33,0,8847037,74,0
2020-03-08,Austria,AT,25,0,8847037,99,0
2020-03-09,Austria,AT,3,0,8847037,102,0
2020-03-10,Austria,AT,29,0,8847037,131,0
2020-03-11,Austria,AT,51,0,8847037,182,0
2020-03-12,Austria,AT,64,0,8847037,246,0
2020-03-13,Austria,AT,115,1,8847037,361,1
2020-03-14,Austria,AT,143,0,8847037,504,1
2020-03-15,Austria,AT,151,0,8847037,655,1
2020-03-16,Austria,AT,205,0,8847037,860,1
2020-03-17,Austria,AT,156,2,8847037,1016,3
2020-03-18,Austria,AT,316,0,8847037,1332,3
2020-03-19,Austria,AT,314,1,8847037,1646,4
2020-03-20,Austria,AT,550,2,8847037,2196,6
2020-03-21,Austria,AT,453,0,8847037,2649,6
2020-03-22,Austria,AT,375,2,8847037,3024,8
2020-03-23,Austria,AT,607,8,8847037,3631,16
2020-03-24,Austria,AT,855,9,8847037,4486,25
2020-03-25,Austria,AT,796,5,8847037,5282,30
2020-03-26,Austria,AT,606,4,8847037,5888,34
2020-03-27,Austria,AT,1141,18,8847037,7029,52
2020-03-28,Austria,AT,668,16,8847037,7697,68
2020-03-29,Austria,AT,594,0,8847037,8291,68
2020-03-30,Austria,AT,522,18,8847037,8813,86
2020-03-31,Austria,AT,805,22,8847037,9618,108
2020-04-01,Austria,AT,564,20,8847037,10182,128
2020-04-02,Austria,AT,529,18,8847037,10711,146
2020-04-03,Austria,AT,418,12,8847037,11129,158
2020-04-04,Austria,AT,396,10,8847037,11525,168
2020-04-05,Austria,AT,241,18,8847037,11766,186
2020-04-06,Austria,AT,217,18,8847037,11983,204
2020-04-07,Austria,AT,314,16,8847037,12297,220
2020-04-08,Austria,AT,343,23,8847037,12640,243
2020-04-09,Austria,AT,329,30,8847037,12969,273
2020-04-10,Austria,AT,279,22,8847037,13248,295
2020-04-11,Austria,AT,312,24,8847037,13560,319
2020-04-12,Austria,AT,247,18,8847037,13807,337
2020-04-13,Austria,AT,130,13,8847037,13937,350
2020-04-14,Austria,AT,106,18,8847037,14043,368
2020-04-15,Austria,AT,191,16,8847037,14234,384
2020-04-16,Austria,AT,136,9,8847037,14370,393
2020-04-17,Austria,AT,78,17,8847037,14448,410
2020-04-18,Austria,AT,155,21,8847037,14603,431
2020-04-19,Austria,AT,59,12,8847037,14662,443
2020-04-20,Austria,AT,48,9,8847037,14710,452
2020-04-21,Austria,AT,73,10,8847037,14783,462
2020-04-22,Austria,AT,50,1,8847037,14833,463
2020-04-23,Austria,AT,91,31,8847037,14924,494
2020-04-24,Austria,AT,61,14,8847037,14985,508
2020-04-25,Austria,AT,83,5,8847037,15068,513
2020-04-26,Austria,AT,66,23,8847037,15134,536
2020-04-27,Austria,AT,55,6,8847037,15189,542
2020-04-28,Austria,AT,67,7,8847037,15256,549
2020-04-29,Austria,AT,58,20,8847037,15314,569
2020-04-30,Austria,AT,50,11,8847037,15364,580
2020-05-01,Austria,AT,93,4,8847037,15457,584
2020-05-02,Austria,AT,74,5,8847037,15531,589
2020-05-03,Austria,AT,27,7,8847037,15558,596
2019-12-31,Australia,AU,0,0,24992369,0,0
2020-01-01,Australia,AU,0,0,24992369,0,0
2020-01-02,Australia,AU,0,0,24992369,0,0
2020-01-03,Australia,AU,0,0,24992369,0,0
2020-01-04,Australia,AU,0,0,24992369,0,0
2020-01-05,Australia,AU,0,0,24992369,0,0
2020-01-06,Australia,AU,0,0,24992369,0,0
2020-01-07,Australia,AU,0,0,24992369,0,0
2020-01-08,Australia,AU,0,0,24992369,0,0
2020-01-09,Australia,AU,0,0,24992369,0,0
2020-01-10,Australia,AU,0,0,24992369,0,0
2020-01-11,Australia,AU,0,0,24992369,0,0
2020-01-12,Australia,AU,0,0,24992369,0,0
2020-01-13,Australia,AU,0,0,24992369,0,0
2020-01-14,Australia,AU,0,0,24992369,0,0
2020-01-15,Australia,AU,0,0,24992369,0,0
2020-01-16,Australia,AU,0,0,24992369,0,0
2020-01-17,Australia,AU,0,0,24992369,0,0
2020-01-18,Australia,AU,0,0,24992369,0,0
2020-01-19,Australia,AU,0,0,24992369,0,0
2020-01-20,Australia,AU,0,0,24992369,0,0
2020-01-21,Australia,AU,0,0,24992369,0,0
2020-01-22,Australia,AU,0,0,24992369,0,0
2020-01-23,Australia,AU,0,0,24992369,0,0
2020-01-24,Australia,AU,0,0,24992369,0,0
2020-01-25,Australia,AU,1,0,24992369,1,0
2020-01-26,Australia,AU,3,0,24992369,4,0
2020-01-27,Australia,AU,0,0,24992369,4,0
2020-01-28,Australia,AU,0,0,24992369,4,0
2020-01-29,Australia,AU,0,0,24992369,4,0
2020-01-30,Australia,AU,2,0,24992369,6,0
2020-01-31,Australia,AU,1,0,24992369,7,0
2020-02-01,Australia,AU,2,0,24992369,9,0
2020-02-02,Australia,AU,2,0,24992369,11,0
2020-02-03,Australia,AU,0,0,24992369,11,0
2020-02-04,Australia,AU,0,0,24992369,11,0
2020-02-05,Australia,AU,1,0,24992369,12,0
2020-02-06,Australia,AU,1,0,24992369,13,0
2020-02-07,Australia,AU,1,0,24992369,14,0
2020-02-08,Australia,AU,0,0,24992369,14,0
2020-02-09,Australia,AU,0,0,24992369,14,0
2020-02-10,Australia,AU,0,0,24992369,14,0
2020-02-11,Australia,AU,0,0,24992369,14,0
2020-02-12,Australia,AU,0,0,24992369,14,0
2020-02-13,Australia,AU,0,0,24992369,14,0
2020-02-14,Australia,AU,1,0,24992369,15,0
2020-02-15,Australia,AU,0,0,24992369,15,0
2020-02-16,Australia,AU,0,0,24992369,15,0
2020-02-17,Australia,AU,0,0,24992369,15,0
2020-02-18,Australia,AU,0,0,24992369,15,0
2020-02-19,Australia,AU,0,0,24992369,15,0
2020-02-20,Australia,AU,0,0,24992369,15,0
2020-02-21,Australia,AU,2,0,24992369,17,0
2020-02-22,Australia,AU,4,0,24992369,21,0
2020-02-23,Australia,AU,1,0,24992369,22,0
2020-02-24,Australia,AU,0,0,24992369,22,0
2020-02-25,Australia,AU,0,0,24992369,22,0
2020-02-26,Australia,AU,0,0,24992369,22,0
2020-02-27,Australia,AU,1,0,24992369,23,0
2020-02-28,Australia,AU,0,0,24992369,23,0
2020-02-29,Australia,AU,2,0,24992369,25,0
2020-03-01,Australia,AU,1,1,24992369,26,1
2020-03-02,Australia,AU,3,0,24992369,29,1
2020-03-03,Australia,AU,4,0,24992369,33,1
2020-03-04,Australia,AU,8,0,24992369,41,1
2020-03-05,Australia,AU,11,1,24992369,52,2
2020-03-06,Australia,AU,7,0,24992369,59,2
2020-03-07,Australia,AU,4,0,24992369,63,2
2020-03-08,Australia,AU,11,1,24992369,74,3
2020-03-09,Australia,AU,6,0,24992369,80,3
2020-03-10,Australia,AU,20,0,24992369,100,3
2020-03-11,Australia,AU,12,0,24992369,112,3
2020-03-12,Australia,AU,14,0,24992369,126,3
2020-03-13,Australia,AU,30,0,24992369,156,3
2020-03-14,Australia,AU,41,0,24992369,197,3
2020-03-15,Australia,AU,52,0,24992369,249,3
2020-03-16,Australia,AU,49,2,24992369,298,5
2020-03-17,Australia,AU,77,0,24992369,375,5
2020-03-18,Australia,AU,79,0,24992369,454,5
2020-03-19,Australia,AU,111,1,24992369,565,6
2020-03-20,Australia,AU,144,0,24992369,709,6
2020-03-21,Australia,AU,165,1,24992369,874,7
2020-03-22,Australia,AU,224,0,24992369,1098,7
2020-03-23,Australia,AU,611,0,24992369,1709,7
2020-03-24,Australia,AU,114,0,24992369,1823,7
2020-03-25,Australia,AU,600,1,24992369,2423,8
2020-03-26,Australia,AU,376,3,24992369,2799,11
2020-03-27,Australia,AU,367,2,24992369,3166,13
2020-03-28,Australia,AU,212,0,24992369,3378,13
2020-03-29,Australia,AU,431,1,24992369,3809,14
2020-03-30,Australia,AU,284,2,24992369,4093,16
2020-03-31,Australia,AU,464,3,24992369,4557,19
2020-04-01,Australia,AU,150,1,24992369,4707,20
2020-04-02,Australia,AU,269,1,24992369,4976,21
2020-04-03,Australia,AU,248,2,24992369,5224,23
2020-04-04,Australia,AU,324,7,24992369,5548,30
2020-04-05,Australia,AU,139,4,24992369,5687,34
2020-04-06,Australia,AU,57,2,24992369,5744,36
2020-04-07,Australia,AU,100,6,24992369,5844,42
2020-04-08,Australia,AU,112,3,24992369,5956,45
2020-04-09,Australia,AU,96,5,24992369,6052,50
2020-04-10,Australia,AU,100,2,24992369,6152,52
2020-04-11,Australia,AU,86,2,24992369,6238,54
2020-04-12,Australia,AU,51,3,24992369,6289,57
2020-04-13,Australia,AU,33,4,24992369,6322,61
2020-04-14,Australia,AU,44,0,24992369,6366,61
2020-04-15,Australia,AU,50,0,24992369,6416,61
2020-04-16,Australia,AU,42,2,24992369,6458,63
2020-04-17,Australia,AU,39,0,24992369,6497,63
2020-04-18,Australia,AU,36,4,24992369,6533,67
2020-04-19,Australia,AU,53,2,24992369,6586,69
2020-04-20,Australia,AU,26,1,24992369,6612,70
2020-04-21,Australia,AU,13,1,24992369,6625,71
2020-04-22,Australia,AU,22,3,24992369,6647,74
2020-04-23,Australia,AU,7,0,24992369,6654,74
2020-04-24,Australia,AU,13,1,24992369,6667,75
2020-04-25,Australia,AU,20,4,24992369,6687,79
2020-04-26,Australia,AU,16,2,24992369,6703,81
2020-04-27,Australia,AU,10,2,24992369,6713,83
2020-04-28,Australia,AU,12,1,24992369,6725,84
2020-04-29,Australia,AU,13,4,24992369,6738,88
2020-04-30,Australia,AU,8,2,24992369,6746,90
2020-05-01,Australia,AU,16,2,24992369,6762,92
2020-05-02,Australia,AU,5,1,24992369,6767,93
2020-05-03,Australia,AU,16,0,24992369,6783,93
2020-03-13,Aruba,AW,2,0,105845,2,0
2020-03-20,Aruba,AW,2,0,105845,4,0
2020-03-24,Aruba,AW,8,0,105845,12,0
2020-03-25,Aruba,AW,5,0,105845,17,0
2020-03-26,Aruba,AW,2,0,105845,19,0
2020-03-27,Aruba,AW,9,0,105845,28,0
2020-03-28,Aruba,AW,0,0,105845,28,0
2020-03-29,Aruba,AW,0,0,105845,28,0
2020-03-30,Aruba,AW,22,0,105845,50,0
2020-04-01,Aruba,AW,5,0,105845,55,0
2020-04-02,Aruba,AW,0,0,105845,55,0
2020-04-03,Aruba,AW,5,0,105845,60,0
2020-04-04,Aruba,AW,2,0,105845,62,0
2020-04-05,Aruba,AW,2,0,105845,64,0
2020-04-06,Aruba,AW,0,0,105845,64,0
2020-04-07,Aruba,AW,7,0,105845,71,0
2020-04-08,Aruba,AW,3,0,105845,74,0
2020-04-09,Aruba,AW,3,0,105845,77,0
2020-04-10,Aruba,AW,5,0,105845,82,0
2020-04-11,Aruba,AW,4,0,105845,86,0
2020-04-12,Aruba,AW,6,0,105845,92,0
2020-04-13,Aruba,AW,0,0,105845,92,0
2020-04-14,Aruba,AW,0,0,105845,92,0
2020-04-15,Aruba,AW,0,0,105845,92,0
2020-04-16,Aruba,AW,1,1,105845,93,1
2020-04-17,Aruba,AW,2,0,105845,95,1
2020-04-18,Aruba,AW,1,1,105845,96,2
2020-04-19,Aruba,AW,0,0,105845,96,2
2020-04-20,Aruba,AW,1,0,105845,97,2
2020-04-21,Aruba,AW,0,0,105845,97,2
2020-04-22,Aruba,AW,0,0,105845,97,2
2020-04-23,Aruba,AW,3,0,105845,100,2
2020-04-24,Aruba,AW,0,0,105845,100,2
2020-04-25,Aruba,AW,0,0,105845,100,2
2020-04-26,Aruba,AW,0,0,105845,100,2
2020-04-27,Aruba,AW,0,0,105845,100,2
2020-04-28,Aruba,AW,0,0,105845,100,2
2020-04-29,Aruba,AW,0,0,105845,100,2
2020-04-30,Aruba,AW,0,0,105845,100,2
2020-05-01,Aruba,AW,0,0,105845,100,2
2020-05-02,Aruba,AW,0,0,105845,100,2
2020-05-03,Aruba,AW,0,0,105845,100,2
2019-12-31,Azerbaijan,AZ,0,0,9942334,0,0
2020-01-01,Azerbaijan,AZ,0,0,9942334,0,0
2020-01-02,Azerbaijan,AZ,0,0,9942334,0,0
2020-01-03,Azerbaijan,AZ,0,0,9942334,0,0
2020-01-04,Azerbaijan,AZ,0,0,9942334,0,0
2020-01-05,Azerbaijan,AZ,0,0,9942334,0,0
2020-01-06,Azerbaijan,AZ,0,0,9942334,0,0
2020-01-07,Azerbaijan,AZ,0,0,9942334,0,0
2020-01-08,Azerbaijan,AZ,0,0,9942334,0,0
2020-01-09,Azerbaijan,AZ,0,0,9942334,0,0
2020-01-10,Azerbaijan,AZ,0,0,9942334,0,0
2020-01-11,Azerbaijan,AZ,0,0,9942334,0,0
2020-01-12,Azerbaijan,AZ,0,0,9942334,0,0
2020-01-13,Azerbaijan,AZ,0,0,9942334,0,0
2020-01-14,Azerbaijan,AZ,0,0,9942334,0,0
2020-01-15,Azerbaijan,AZ,0,0,9942334,0,0
2020-01-16,Azerbaijan,AZ,0,0,9942334,0,0
2020-01-17,Azerbaijan,AZ,0,0,9942334,0,0
2020-01-18,Azerbaijan,AZ,0,0,9942334,0,0
2020-01-19,Azerbaijan,AZ,0,0,9942334,0,0
2020-01-20,Azerbaijan,AZ,0,0,9942334,0,0
2020-01-21,Azerbaijan,AZ,0,0,9942334,0,0
2020-01-22,Azerbaijan,AZ,0,0,9942334,0,0
2020-01-23,Azerbaijan,AZ,0,0,9942334,0,0
2020-01-24,Azerbaijan,AZ,0,0,9942334,0,0
2020-01-25,Azerbaijan,AZ,0,0,9942334,0,0
2020-01-26,Azerbaijan,AZ,0,0,9942334,0,0
2020-01-27,Azerbaijan,AZ,0,0,9942334,0,0
2020-01-28,Azerbaijan,AZ,0,0,9942334,0,0
2020-01-29,Azerbaijan,AZ,0,0,9942334,0,0
2020-01-30,Azerbaijan,AZ,0,0,9942334,0,0
2020-01-31,Azerbaijan,AZ,0,0,9942334,0,0
2020-02-01,Azerbaijan,AZ,0,0,9942334,0,0
2020-02-02,Azerbaijan,AZ,0,0,9942334,0,0
2020-02-03,Azerbaijan,AZ,0,0,9942334,0,0
2020-02-04,Azerbaijan,AZ,0,0,9942334,0,0
2020-02-05,Azerbaijan,AZ,0,0,9942334,0,0
2020-02-06,Azerbaijan,AZ,0,0,9942334,0,0
2020-02-07,Azerbaijan,AZ,0,0,9942334,0,0
2020-02-08,Azerbaijan,AZ,0,0,9942334,0,0
2020-02-09,Azerbaijan,AZ,0,0,9942334,0,0
2020-02-10,Azerbaijan,AZ,0,0,9942334,0,0
2020-02-11,Azerbaijan,AZ,0,0,9942334,0,0
2020-02-12,Azerbaijan,AZ,0,0,9942334,0,0
2020-02-13,Azerbaijan,AZ,0,0,9942334,0,0
2020-02-14,Azerbaijan,AZ,0,0,9942334,0,0
2020-02-15,Azerbaijan,AZ,0,0,9942334,0,0
2020-02-16,Azerbaijan,AZ,0,0,9942334,0,0
2020-02-17,Azerbaijan,AZ,0,0,9942334,0,0
2020-02-18,Azerbaijan,AZ,0,0,9942334,0,0
2020-02-19,Azerbaijan,AZ,0,0,9942334,0,0
2020-02-20,Azerbaijan,AZ,0,0,9942334,0,0
2020-02-21,Azerbaijan,AZ,0,0,9942334,0,0
2020-02-22,Azerbaijan,AZ,0,0,9942334,0,0
2020-02-23,Azerbaijan,AZ,0,0,9942334,0,0
2020-02-24,Azerbaijan,AZ,0,0,9942334,0,0
2020-02-25,Azerbaijan,AZ,0,0,9942334,0,0
2020-02-26,Azerbaijan,AZ,0,0,9942334,0,0
2020-02-27,Azerbaijan,AZ,0,0,9942334,0,0
2020-02-28,Azerbaijan,AZ,0,0,9942334,0,0
2020-02-29,Azerbaijan,AZ,1,0,9942334,1,0
2020-03-01,Azerbaijan,AZ,0,0,9942334,1,0
2020-03-02,Azerbaijan,AZ,2,0,9942334,3,0
2020-03-06,Azerbaijan,AZ,3,0,9942334,6,0
2020-03-07,Azerbaijan,AZ,3,0,9942334,9,0
2020-03-11,Azerbaijan,AZ,2,0,9942334,11,0
2020-03-12,Azerbaijan,AZ,2,0,9942334,13,0
2020-03-13,Azerbaijan,AZ,0,0,9942334,13,0
2020-03-15,Azerbaijan,AZ,6,0,9942334,19,0
2020-03-16,Azerbaijan,AZ,0,0,9942334,19,0
2020-03-17,Azerbaijan,AZ,0,0,9942334,19,0
2020-03-18,Azerbaijan,AZ,9,0,9942334,28,0
2020-03-19,Azerbaijan,AZ,6,0,9942334,34,0
2020-03-20,Azerbaijan,AZ,10,0,9942334,44,0
2020-03-21,Azerbaijan,AZ,0,1,9942334,44,1
2020-03-22,Azerbaijan,AZ,9,0,9942334,53,1
2020-03-23,Azerbaijan,AZ,12,0,9942334,65,1
2020-03-24,Azerbaijan,AZ,7,0,9942334,72,1
2020-03-25,Azerbaijan,AZ,15,0,9942334,87,1
2020-03-26,Azerbaijan,AZ,6,1,9942334,93,2
2020-03-27,Azerbaijan,AZ,29,1,9942334,122,3
2020-03-28,Azerbaijan,AZ,43,0,9942334,165,3
2020-03-29,Azerbaijan,AZ,17,1,9942334,182,4
2020-03-30,Azerbaijan,AZ,27,0,9942334,209,4
2020-03-31,Azerbaijan,AZ,64,0,9942334,273,4
2020-04-01,Azerbaijan,AZ,25,1,9942334,298,5
2020-04-02,Azerbaijan,AZ,61,0,9942334,359,5
2020-04-03,Azerbaijan,AZ,41,0,9942334,400,5
2020-04-04,Azerbaijan,AZ,43,0,9942334,443,5
2020-04-05,Azerbaijan,AZ,78,0,9942334,521,5
2020-04-06,Azerbaijan,AZ,63,2,9942334,584,7
2020-04-07,Azerbaijan,AZ,57,0,9942334,641,7
2020-04-08,Azerbaijan,AZ,76,1,9942334,717,8
2020-04-09,Azerbaijan,AZ,105,0,9942334,822,8
2020-04-10,Azerbaijan,AZ,104,1,9942334,926,9
2020-04-11,Azerbaijan,AZ,65,1,9942334,991,10
2020-04-12,Azerbaijan,AZ,67,1,9942334,1058,11
2020-04-13,Azerbaijan,AZ,40,0,9942334,1098,11
2020-04-14,Azerbaijan,AZ,50,1,9942334,1148,12
2020-04-15,Azerbaijan,AZ,49,1,9942334,1197,13
2020-04-16,Azerbaijan,AZ,56,0,9942334,1253,13
2020-04-17,Azerbaijan,AZ,30,2,9942334,1283,15
2020-04-18,Azerbaijan,AZ,57,0,9942334,1340,15
2020-04-19,Azerbaijan,AZ,33,3,9942334,1373,18
2020-04-20,Azerbaijan,AZ,25,1,9942334,1398,19
2020-04-21,Azerbaijan,AZ,38,0,9942334,1436,19
2020-04-22,Azerbaijan,AZ,44,1,9942334,1480,20
2020-04-23,Azerbaijan,AZ,38,0,9942334,1518,20
2020-04-24,Azerbaijan,AZ,30,0,9942334,1548,20
2020-04-25,Azerbaijan,AZ,44,1,9942334,1592,21
2020-04-26,Azerbaijan,AZ,25,0,9942334,1617,21
2020-04-27,Azerbaijan,AZ,28,0,9942334,1645,21
2020-04-28,Azerbaijan,AZ,33,1,9942334,1678,22
2020-04-29,Azerbaijan,AZ,39,0,9942334,1717,22
2020-04-30,Azerbaijan,AZ,49,1,9942334,1766,23
2020-05-01,Azerbaijan,AZ,38,1,9942334,1804,24
2020-05-02,Azerbaijan,AZ,50,1,9942334,1854,25
2020-05-03,Azerbaijan,AZ,40,0,9942334,1894,25
2020-03-06,Bosnia_and_Herzegovina,BA,2,0,3323929,2,0
2020-03-12,Bosnia_and_Herzegovina,BA,1,0,3323929,3,0
2020-03-13,Bosnia_and_Herzegovina,BA,0,0,3323929,3,0
2020-03-16,Bosnia_and_Herzegovina,BA,15,0,3323929,18,0
2020-03-17,Bosnia_and_Herzegovina,BA,3,0,3323929,21,0
2020-03-18,Bosnia_and_Herzegovina,BA,0,0,3323929,21,0
2020-03-19,Bosnia_and_Herzegovina,BA,15,0,3323929,36,0
2020-03-20,Bosnia_and_Herzegovina,BA,8,0,3323929,44,0
2020-03-21,Bosnia_and_Herzegovina,BA,0,0,3323929,44,0
2020-03-22,Bosnia_and_Herzegovina,BA,48,1,3323929,92,1
2020-03-23,Bosnia_and_Herzegovina,BA,33,0,3323929,125,1
2020-03-24,Bosnia_and_Herzegovina,BA,4,0,3323929,129,1
2020-03-25,Bosnia_and_Herzegovina,BA,33,1,3323929,162,2
2020-03-26,Bosnia_and_Herzegovina,BA,19,1,3323929,181,3
2020-03-27,Bosnia_and_Herzegovina,BA,0,0,3323929,181,3
2020-03-28,Bosnia_and_Herzegovina,BA,48,0,3323929,229,3
2020-03-29,Bosnia_and_Herzegovina,BA,28,2,3323929,257,5
2020-03-30,Bosnia_and_Herzegovina,BA,66,1,3323929,323,6
2020-03-31,Bosnia_and_Herzegovina,BA,30,2,3323929,353,8
2020-04-01,Bosnia_and_Herzegovina,BA,60,4,3323929,413,12
2020-04-02,Bosnia_and_Herzegovina,BA,51,1,3323929,464,13
2020-04-03,Bosnia_and_Herzegovina,BA,68,4,3323929,532,17
2020-04-04,Bosnia_and_Herzegovina,BA,54,1,3323929,586,18
2020-04-05,Bosnia_and_Herzegovina,BA,46,3,3323929,632,21
2020-04-06,Bosnia_and_Herzegovina,BA,31,3,3323929,663,24
2020-04-07,Bosnia_and_Herzegovina,BA,32,4,3323929,695,28
2020-04-08,Bosnia_and_Herzegovina,BA,86,4,3323929,781,32
2020-04-09,Bosnia_and_Herzegovina,BA,35,3,3323929,816,35
2020-04-10,Bosnia_and_Herzegovina,BA,59,1,3323929,875,36
2020-04-11,Bosnia_and_Herzegovina,BA,26,1,3323929,901,37
2020-04-12,Bosnia_and_Herzegovina,BA,47,0,3323929,948,37
2020-04-13,Bosnia_and_Herzegovina,BA,59,1,3323929,1007,38
2020-04-14,Bosnia_and_Herzegovina,BA,21,0,3323929,1028,38
2020-04-15,Bosnia_and_Herzegovina,BA,45,1,3323929,1073,39
2020-04-16,Bosnia_and_Herzegovina,BA,27,1,3323929,1100,40
2020-04-17,Bosnia_and_Herzegovina,BA,52,1,3323929,1152,41
2020-04-18,Bosnia_and_Herzegovina,BA,58,3,3323929,1210,44
2020-04-19,Bosnia_and_Herzegovina,BA,44,1,3323929,1254,45
2020-04-20,Bosnia_and_Herzegovina,BA,15,1,3323929,1269,46
2020-04-21,Bosnia_and_Herzegovina,BA,31,2,3323929,1300,48
2020-04-22,Bosnia_and_Herzegovina,BA,40,2,3323929,1340,50
2020-04-23,Bosnia_and_Herzegovina,BA,27,2,3323929,1367,52
2020-04-24,Bosnia_and_Herzegovina,BA,46,1,3323929,1413,53
2020-04-25,Bosnia_and_Herzegovina,BA,7,1,3323929,1420,54
2020-04-26,Bosnia_and_Herzegovina,BA,65,2,3323929,1485,56
2020-04-27,Bosnia_and_Herzegovina,BA,31,2,3323929,1516,58
2020-04-28,Bosnia_and_Herzegovina,BA,48,2,3323929,1564,60
2020-04-29,Bosnia_and_Herzegovina,BA,24,2,3323929,1588,62
2020-04-30,Bosnia_and_Herzegovina,BA,0,0,3323929,1588,62
2020-05-01,Bosnia_and_Herzegovina,BA,101,2,3323929,1689,64
2020-05-02,Bosnia_and_Herzegovina,BA,92,6,3323929,1781,70
2020-05-03,Bosnia_and_Herzegovina,BA,58,2,3323929,1839,72
2020-03-18,Barbados,BB,1,0,286641,1,0
2020-03-19,Barbados,BB,0,0,286641,1,0
2020-03-20,Barbados,BB,1,0,286641,2,0
2020-03-21,Barbados,BB,4,0,286641,6,0
2020-03-22,Barbados,BB,8,0,286641,14,0
2020-03-23,Barbados,BB,3,0,286641,17,0
2020-03-24,Barbados,BB,0,0,286641,17,0
2020-03-25,Barbados,BB,1,0,286641,18,0
2020-03-26,Barbados,BB,0,0,286641,18,0
2020-03-27,Barbados,BB,6,0,286641,24,0
2020-03-28,Barbados,BB,0,0,286641,24,0
2020-03-29,Barbados,BB,2,0,286641,26,0
2020-03-30,Barbados,BB,7,0,286641,33,0
2020-03-31,Barbados,BB,1,0,286641,34,0
2020-04-01,Barbados,BB,0,0,286641,34,0
2020-04-02,Barbados,BB,11,0,286641,45,0
2020-04-03,Barbados,BB,0,0,286641,45,0
2020-04-04,Barbados,BB,0,0,286641,45,0
2020-04-05,Barbados,BB,6,0,286641,51,0
2020-04-06,Barbados,BB,5,1,286641,56,1
2020-04-07,Barbados,BB,4,1,286641,60,2
2020-04-08,Barbados,BB,3,1,286641,63,3
2020-04-09,Barbados,BB,0,0,286641,63,3
2020-04-10,Barbados,BB,3,0,286641,66,3
2020-04-11,Barbados,BB,1,1,286641,67,4
2020-04-12,Barbados,BB,1,0,286641,68,4
2020-04-13,Barbados,BB,3,0,286641,71,4
2020-04-14,Barbados,BB,1,0,286641,72,4
2020-04-15,Barbados,BB,1,1,286641,73,5
2020-04-16,Barbados,BB,2,0,286641,75,5
2020-04-17,Barbados,BB,0,0,286641,75,5
2020-04-18,Barbados,BB,0,0,286641,75,5
2020-04-19,Barbados,BB,0,0,286641,75,5
2020-04-20,Barbados,BB,0,0,286641,75,5
2020-04-21,Barbados,BB,0,0,286641,75,5
2020-04-22,Barbados,BB,0,0,286641,75,5
2020-04-23,Barbados,BB,1,1,286641,76,6
2020-04-24,Barbados,BB,0,0,286641,76,6
2020-04-25,Barbados,BB,0,0,286641,76,6
2020-04-26,Barbados,BB,3,0,286641,79,6
2020-04-27,Barbados,BB,0,0,286641,79,6
2020-04-28,Barbados,BB,1,0,286641,80,6
2020-04-29,Barbados,BB,0,0,286641,80,6
2020-04-30,Barbados,BB,0,1,286641,80,7
2020-05-01,Barbados,BB,1,0,286641,81,7
2020-05-02,Barbados,BB,0,0,286641,81,7
2020-05-03,Barbados,BB,0,0,286641,81,7
2020-03-09,Bangladesh,BD,3,0,161356039,3,0
2020-03-15,Bangladesh,BD,0,0,161356039,3,0
2020-03-17,Bangladesh,BD,2,0,161356039,5,0
2020-03-18,Bangladesh,BD,3,0,161356039,8,0
2020-03-19,Bangladesh,BD,2,0,161356039,10,0
2020-03-20,Bangladesh,BD,0,0,161356039,10,0
2020-03-21,Bangladesh,BD,7,0,161356039,17,0
2020-03-22,Bangladesh,BD,7,2,161356039,24,2
2020-03-23,Bangladesh,BD,3,1,161356039,27,3
2020-03-24,Bangladesh,BD,6,0,161356039,33,3
2020-03-25,Bangladesh,BD,6,1,161356039,39,4
2020-03-26,Bangladesh,BD,0,1,161356039,39,5
2020-03-27,Bangladesh,BD,9,0,161356039,48,5
2020-03-28,Bangladesh,BD,0,0,161356039,48,5
2020-03-29,Bangladesh,BD,0,0,161356039,48,5
2020-03-30,Bangladesh,BD,1,0,161356039,49,5
2020-03-31,Bangladesh,BD,0,0,161356039,49,5
2020-04-01,Bangladesh,BD,2,0,161356039,51,5
2020-04-02,Bangladesh,BD,3,1,161356039,54,6
2020-04-03,Bangladesh,BD,2,0,161356039,56,6
2020-04-04,Bangladesh,BD,5,0,161356039,61,6
2020-04-05,Bangladesh,BD,9,2,161356039,70,8
2020-04-06,Bangladesh,BD,18,1,161356039,88,9
2020-04-07,Bangladesh,BD,35,3,161356039,123,12
2020-04-08,Bangladesh,BD,41,5,161356039,164,17
2020-04-09,Bangladesh,BD,54,3,161356039,218,20
2020-04-10,Bangladesh,BD,112,1,161356039,330,21
2020-04-11,Bangladesh,BD,94,6,161356039,424,27
2020-04-12,Bangladesh,BD,58,3,161356039,482,30
2020-04-13,Bangladesh,BD,139,4,161356039,621,34
2020-04-14,Bangladesh,BD,182,5,161356039,803,39
2020-04-15,Bangladesh,BD,209,7,161356039,1012,46
2020-04-16,Bangladesh,BD,219,4,161356039,1231,50
2020-04-17,Bangladesh,BD,341,10,161356039,1572,60
2020-04-18,Bangladesh,BD,266,15,161356039,1838,75
2020-04-19,Bangladesh,BD,306,9,161356039,2144,84
2020-04-20,Bangladesh,BD,312,7,161356039,2456,91
2020-04-21,Bangladesh,BD,492,10,161356039,2948,101
2020-04-22,Bangladesh,BD,434,9,161356039,3382,110
2020-04-23,Bangladesh,BD,390,10,161356039,3772,120
2020-04-24,Bangladesh,BD,414,7,161356039,4186,127
2020-04-25,Bangladesh,BD,503,4,161356039,4689,131
2020-04-26,Bangladesh,BD,309,9,161356039,4998,140
2020-04-27,Bangladesh,BD,418,5,161356039,5416,145
2020-04-28,Bangladesh,BD,497,7,161356039,5913,152
2020-04-29,Bangladesh,BD,549,3,161356039,6462,155
2020-04-30,Bangladesh,BD,641,8,161356039,7103,163
2020-05-01,Bangladesh,BD,564,5,161356039,7667,168
2020-05-02,Bangladesh,BD,571,2,161356039,8238,170
2020-05-03,Bangladesh,BD,552,5,161356039,8790,175
2019-12-31,Belgium,BE,0,0,11422068,0,0
2020-01-01,Belgium,BE,0,0,11422068,0,0
2020-01-02,Belgium,BE,0,0,11422068,0,0
2020-01-03,Belgium,BE,0,0,11422068,0,0
2020-01-04,Belgium,BE,0,0,11422068,0,0
2020-01-05,Belgium,BE,0,0,11422068,0,0
2020-01-06,Belgium,BE,0,0,11422068,0,0
2020-01-07,Belgium,BE,0,0,11422068,0,0
2020-01-08,Belgium,BE,0,0,11422068,0,0
2020-01-09,Belgium,BE,0,0,11422068,0,0
2020-01-10,Belgium,BE,0,0,11422068,0,0
2020-01-11,Belgium,BE,0,0,11422068,0,0
2020-01-12,Belgium,BE,0,0,11422068,0,0
2020-01-13,Belgium,BE,0,0,11422068,0,0
2020-01-14,Belgium,BE,0,0,11422068,0,0
2020-01-15,Belgium,BE,0,0,11422068,0,0
2020-01-16,Belgium,BE,0,0,11422068,0,0
2020-01-17,Belgium,BE,0,0,11422068,0,0
2020-01-18,Belgium,BE,0,0,11422068,0,0
2020-01-19,Belgium,BE,0,0,11422068,0,0
2020-01-20,Belgium,BE,0,0,11422068,0,0
2020-01-21,Belgium,BE,0,0,11422068,0,0
2020-01-22,Belgium,BE,0,0,11422068,0,0
2020-01-23,Belgium,BE,0,0,11422068,0,0
2020-01-24,Belgium,BE,0,0,11422068,0,0
2020-01-25,Belgium,BE,0,0,11422068,0,0
2020-01-26,Belgium,BE,0,0,11422068,0,0
2020-01-27,Belgium,BE,0,0,11422068,0,0
2020-01-28,Belgium,BE,0,0,11422068,0,0
2020-01-29,Belgium,BE,0,0,11422068,0,0
2020-01-30,Belgium,BE,0,0,11422068,0,0
2020-01-31,Belgium,BE,0,0,11422068,0,0
2020-02-01,Belgium,BE,0,0,11422068,0,0
2020-02-02,Belgium,BE,0,0,11422068,0,0
2020-02-03,Belgium,BE,0,0,11422068,0,0
2020-02-04,Belgium,BE,1,0,11422068,1,0
2020-02-05,Belgium,BE,0,0,11422068,1,0
2020-02-06,Belgium,BE,0,0,11422068,1,0
2020-02-07,Belgium,BE,0,0,11422068,1,0
2020-02-08,Belgium,BE,0,0,11422068,1,0
2020-02-09,Belgium,BE,0,0,11422068,1,0
2020-02-10,Belgium,BE,0,0,11422068,1,0
2020-02-11,Belgium,BE,0,0,11422068,1,0
2020-02-12,Belgium,BE,0,0,11422068,1,0
2020-02-13,Belgium,BE,0,0,11422068,1,0
2020-02-14,Belgium,BE,0,0,11422068,1,0
2020-02-15,Belgium,BE,0,0,11422068,1,0
2020-02-16,Belgium,BE,0,0,11422068,1,0
2020-02-17,Belgium,BE,0,0,11422068,1,0
2020-02-18,Belgium,BE,0,0,11422068,1,0
2020-02-19,Belgium,BE,0,0,11422068,1,0
2020-02-20,Belgium,BE,0,0,11422068,1,0
2020-02-21,Belgium,BE,0,0,11422068,1,0
2020-02-22,Belgium,BE,0,0,11422068,1,0
2020-02-23,Belgium,BE,0,0,11422068,1,0
2020-02-24,Belgium,BE,0,0,11422068,1,0
2020-02-25,Belgium,BE,0,0,11422068,1,0
2020-02-26,Belgium,BE,0,0,11422068,1,0
2020-02-27,Belgium,BE,0,0,11422068,1,0
2020-02-28,Belgium,BE,0,0,11422068,1,0
2020-02-29,Belgium,BE,0,0,11422068,1,0
2020-03-01,Belgium,BE,0,0,11422068,1,0
2020-03-02,Belgium,BE,1,0,11422068,2,0
2020-03-03,Belgium,BE,6,0,11422068,8,0
2020-03-04,Belgium,BE,5,0,11422068,13,0
2020-03-05,Belgium,BE,10,0,11422068,23,0
2020-03-06,Belgium,BE,27,0,11422068,50,0
2020-03-07,Belgium,BE,59,0,11422068,109,0
2020-03-08,Belgium,BE,60,0,11422068,169,0
2020-03-09,Belgium,BE,31,0,11422068,200,0
2020-03-10,Belgium,BE,39,0,11422068,239,0
2020-03-11,Belgium,BE,28,0,11422068,267,0
2020-03-12,Belgium,BE,47,3,11422068,314,3
2020-03-13,Belgium,BE,85,0,11422068,399,3
2020-03-14,Belgium,BE,160,0,11422068,559,3
2020-03-15,Belgium,BE,130,1,11422068,689,4
2020-03-16,Belgium,BE,197,0,11422068,886,4
2020-03-17,Belgium,BE,199,1,11422068,1085,5
2020-03-18,Belgium,BE,158,0,11422068,1243,5
2020-03-19,Belgium,BE,243,9,11422068,1486,14
2020-03-20,Belgium,BE,309,7,11422068,1795,21
2020-03-21,Belgium,BE,462,16,11422068,2257,37
2020-03-22,Belgium,BE,558,30,11422068,2815,67
2020-03-23,Belgium,BE,586,8,11422068,3401,75
2020-03-24,Belgium,BE,342,13,11422068,3743,88
2020-03-25,Belgium,BE,526,34,11422068,4269,122
2020-03-26,Belgium,BE,668,56,11422068,4937,178
2020-03-27,Belgium,BE,1298,42,11422068,6235,220
2020-03-28,Belgium,BE,1049,69,11422068,7284,289
2020-03-29,Belgium,BE,1850,64,11422068,9134,353
2020-03-30,Belgium,BE,1702,78,11422068,10836,431
2020-03-31,Belgium,BE,1063,82,11422068,11899,513
2020-04-01,Belgium,BE,876,192,11422068,12775,705
2020-04-02,Belgium,BE,1189,123,11422068,13964,828
2020-04-03,Belgium,BE,1384,183,11422068,15348,1011
2020-04-04,Belgium,BE,1422,132,11422068,16770,1143
2020-04-05,Belgium,BE,1661,140,11422068,18431,1283
2020-04-06,Belgium,BE,1260,164,11422068,19691,1447
2020-04-07,Belgium,BE,1123,185,11422068,20814,1632
2020-04-08,Belgium,BE,1380,403,11422068,22194,2035
2020-04-09,Belgium,BE,1209,205,11422068,23403,2240
2020-04-10,Belgium,BE,1580,283,11422068,24983,2523
2020-04-11,Belgium,BE,1684,496,11422068,26667,3019
2020-04-12,Belgium,BE,1351,327,11422068,28018,3346
2020-04-13,Belgium,BE,1629,254,11422068,29647,3600
2020-04-14,Belgium,BE,942,303,11422068,30589,3903
2020-04-15,Belgium,BE,530,254,11422068,31119,4157
2020-04-16,Belgium,BE,2454,283,11422068,33573,4440
2020-04-17,Belgium,BE,1236,417,11422068,34809,4857
2020-04-18,Belgium,BE,1329,306,11422068,36138,5163
2020-04-19,Belgium,BE,1045,290,11422068,37183,5453
2020-04-20,Belgium,BE,1313,230,11422068,38496,5683
2020-04-21,Belgium,BE,1487,145,11422068,39983,5828
2020-04-22,Belgium,BE,973,170,11422068,40956,5998
2020-04-23,Belgium,BE,933,264,11422068,41889,6262
2020-04-24,Belgium,BE,908,228,11422068,42797,6490
2020-04-25,Belgium,BE,1496,189,11422068,44293,6679
2020-04-26,Belgium,BE,1032,238,11422068,45325,6917
2020-04-27,Belgium,BE,809,177,11422068,46134,7094
2020-04-28,Belgium,BE,553,113,11422068,46687,7207
2020-04-29,Belgium,BE,647,124,11422068,47334,7331
2020-04-30,Belgium,BE,525,170,11422068,47859,7501
2020-05-01,Belgium,BE,660,93,11422068,48519,7594
2020-05-02,Belgium,BE,513,109,11422068,49032,7703
2020-05-03,Belgium,BE,485,62,11422068,49517,7765
2020-03-11,Burkina_Faso,BF,2,0,19751535,2,0
2020-03-12,Burkina_Faso,BF,0,0,19751535,2,0
2020-03-15,Burkina_Faso,BF,1,0,19751535,3,0
2020-03-16,Burkina_Faso,BF,0,0,19751535,3,0
2020-03-17,Burkina_Faso,BF,17,0,19751535,20,0
2020-03-18,Burkina_Faso,BF,0,0,19751535,20,0
2020-03-19,Burkina_Faso,BF,6,1,19751535,26,1
2020-03-20,Burkina_Faso,BF,7,0,19751535,33,1
2020-03-21,Burkina_Faso,BF,7,0,19751535,40,1
2020-03-22,Burkina_Faso,BF,24,2,19751535,64,3
2020-03-23,Burkina_Faso,BF,0,0,19751535,64,3
2020-03-24,Burkina_Faso,BF,11,0,19751535,75,3
2020-03-25,Burkina_Faso,BF,24,0,19751535,99,3
2020-03-26,Burkina_Faso,BF,15,0,19751535,114,3
2020-03-27,Burkina_Faso,BF,32,0,19751535,146,3
2020-03-28,Burkina_Faso,BF,0,0,19751535,146,3
2020-03-29,Burkina_Faso,BF,34,6,19751535,180,9
2020-03-30,Burkina_Faso,BF,0,0,19751535,180,9
2020-03-31,Burkina_Faso,BF,42,3,19751535,222,12
2020-04-01,Burkina_Faso,BF,24,0,19751535,246,12
2020-04-02,Burkina_Faso,BF,15,2,19751535,261,14
2020-04-03,Burkina_Faso,BF,27,2,19751535,288,16
2020-04-04,Burkina_Faso,BF,0,0,19751535,288,16
2020-04-05,Burkina_Faso,BF,14,0,19751535,302,16
2020-04-06,Burkina_Faso,BF,43,1,19751535,345,17
2020-04-07,Burkina_Faso,BF,19,0,19751535,364,17
2020-04-08,Burkina_Faso,BF,20,2,19751535,384,19
2020-04-09,Burkina_Faso,BF,30,4,19751535,414,23
2020-04-10,Burkina_Faso,BF,29,1,19751535,443,24
2020-04-11,Burkina_Faso,BF,5,2,19751535,448,26
2020-04-12,Burkina_Faso,BF,36,1,19751535,484,27
2020-04-13,Burkina_Faso,BF,13,0,19751535,497,27
2020-04-14,Burkina_Faso,BF,18,1,19751535,515,28
2020-04-15,Burkina_Faso,BF,13,2,19751535,528,30
2020-04-16,Burkina_Faso,BF,14,2,19751535,542,32
2020-04-17,Burkina_Faso,BF,1,0,19751535,543,32
2020-04-18,Burkina_Faso,BF,14,3,19751535,557,35
2020-04-19,Burkina_Faso,BF,8,1,19751535,565,36
2020-04-20,Burkina_Faso,BF,11,0,19751535,576,36
2020-04-21,Burkina_Faso,BF,5,2,19751535,581,38
2020-04-22,Burkina_Faso,BF,19,0,19751535,600,38
2020-04-23,Burkina_Faso,BF,9,1,19751535,609,39
2020-04-24,Burkina_Faso,BF,7,2,19751535,616,41
2020-04-25,Burkina_Faso,BF,10,0,19751535,626,41
2020-04-26,Burkina_Faso,BF,3,0,19751535,629,41
2020-04-27,Burkina_Faso,BF,3,1,19751535,632,42
2020-04-28,Burkina_Faso,BF,3,0,19751535,635,42
2020-04-29,Burkina_Faso,BF,3,0,19751535,638,42
2020-04-30,Burkina_Faso,BF,3,1,19751535,641,43
2020-05-01,Burkina_Faso,BF,4,0,19751535,645,43
2020-05-02,Burkina_Faso,BF,4,1,19751535,649,44
2020-05-03,Burkina_Faso,BF,3,0,19751535,652,44
2020-03-08,Bulgaria,BG,2,0,7024216,2,0
2020-03-09,Bulgaria,BG,2,0,7024216,4,0
2020-03-12,Bulgaria,BG,3,1,7024216,7,1
2020-03-13,Bulgaria,BG,16,0,7024216,23,1
2020-03-14,Bulgaria,BG,8,0,7024216,31,1
2020-03-15,Bulgaria,BG,10,1,7024216,41,2
2020-03-16,Bulgaria,BG,10,0,7024216,51,2
2020-03-17,Bulgaria,BG,11,0,7024216,62,2
2020-03-18,Bulgaria,BG,19,0,7024216,81,2
2020-03-19,Bulgaria,BG,11,0,7024216,92,2
2020-03-20,Bulgaria,BG,13,1,7024216,105,3
2020-03-21,Bulgaria,BG,22,0,7024216,127,3
2020-03-22,Bulgaria,BG,36,0,7024216,163,3
2020-03-23,Bulgaria,BG,22,0,7024216,185,3
2020-03-24,Bulgaria,BG,16,0,7024216,201,3
2020-03-25,Bulgaria,BG,19,0,7024216,220,3
2020-03-26,Bulgaria,BG,22,0,7024216,242,3
2020-03-27,Bulgaria,BG,22,0,7024216,264,3
2020-03-28,Bulgaria,BG,29,0,7024216,293,3
2020-03-29,Bulgaria,BG,38,4,7024216,331,7
2020-03-30,Bulgaria,BG,15,1,7024216,346,8
2020-03-31,Bulgaria,BG,13,0,7024216,359,8
2020-04-01,Bulgaria,BG,40,0,7024216,399,8
2020-04-02,Bulgaria,BG,23,2,7024216,422,10
2020-04-03,Bulgaria,BG,35,0,7024216,457,10
2020-04-04,Bulgaria,BG,28,4,7024216,485,14
2020-04-05,Bulgaria,BG,18,3,7024216,503,17
2020-04-06,Bulgaria,BG,28,3,7024216,531,20
2020-04-07,Bulgaria,BG,18,2,7024216,549,22
2020-04-08,Bulgaria,BG,28,1,7024216,577,23
2020-04-09,Bulgaria,BG,16,1,7024216,593,24
2020-04-10,Bulgaria,BG,31,0,7024216,624,24
2020-04-11,Bulgaria,BG,11,1,7024216,635,25
2020-04-12,Bulgaria,BG,26,3,7024216,661,28
2020-04-13,Bulgaria,BG,14,1,7024216,675,29
2020-04-14,Bulgaria,BG,10,3,7024216,685,32
2020-04-15,Bulgaria,BG,28,3,7024216,713,35
2020-04-16,Bulgaria,BG,34,1,7024216,747,36
2020-04-17,Bulgaria,BG,53,2,7024216,800,38
2020-04-18,Bulgaria,BG,46,3,7024216,846,41
2020-04-19,Bulgaria,BG,32,0,7024216,878,41
2020-04-20,Bulgaria,BG,37,2,7024216,915,43
2020-04-21,Bulgaria,BG,14,0,7024216,929,43
2020-04-22,Bulgaria,BG,46,2,7024216,975,45
2020-04-23,Bulgaria,BG,49,4,7024216,1024,49
2020-04-24,Bulgaria,BG,73,3,7024216,1097,52
2020-04-25,Bulgaria,BG,91,2,7024216,1188,54
2020-04-26,Bulgaria,BG,59,1,7024216,1247,55
2020-04-27,Bulgaria,BG,53,1,7024216,1300,56
2020-04-28,Bulgaria,BG,63,2,7024216,1363,58
2020-04-29,Bulgaria,BG,36,0,7024216,1399,58
2020-04-30,Bulgaria,BG,48,6,7024216,1447,64
2020-05-01,Bulgaria,BG,59,2,7024216,1506,66
2020-05-02,Bulgaria,BG,82,3,7024216,1588,69
2020-05-03,Bulgaria,BG,6,3,7024216,1594,72
2019-12-31,Bahrain,BH,0,0,1569439,0,0
2020-01-01,Bahrain,BH,0,0,1569439,0,0
2020-01-02,Bahrain,BH,0,0,1569439,0,0
2020-01-03,Bahrain,BH,0,0,1569439,0,0
2020-01-04,Bahrain,BH,0,0,1569439,0,0
2020-01-05,Bahrain,BH,0,0,1569439,0,0
2020-01-06,Bahrain,BH,0,0,1569439,0,0
2020-01-07,Bahrain,BH,0,0,1569439,0,0
2020-01-08,Bahrain,BH,0,0,1569439,0,0
2020-01-09,Bahrain,BH,0,0,1569439,0,0
2020-01-10,Bahrain,BH,0,0,1569439,0,0
2020-01-11,Bahrain,BH,0,0,1569439,0,0
2020-01-12,Bahrain,BH,0,0,1569439,0,0
2020-01-13,Bahrain,BH,0,0,1569439,0,0
2020-01-14,Bahrain,BH,0,0,1569439,0,0
2020-01-15,Bahrain,BH,0,0,1569439,0,0
2020-01-16,Bahrain,BH,0,0,1569439,0,0
2020-01-17,Bahrain,BH,0,0,1569439,0,0
2020-01-18,Bahrain,BH,0,0,1569439,0,0
2020-01-19,Bahrain,BH,0,0,1569439,0,0
2020-01-20,Bahrain,BH,0,0,1569439,0,0
2020-01-21,Bahrain,BH,0,0,1569439,0,0
2020-01-22,Bahrain,BH,0,0,1569439,0,0
2020-01-23,Bahrain,BH,0,0,1569439,0,0
2020-01-24,Bahrain,BH,0,0,1569439,0,0
2020-01-25,Bahrain,BH,0,0,1569439,0,0
2020-01-26,Bahrain,BH,0,0,1569439,0,0
2020-01-27,Bahrain,BH,0,0,1569439,0,0
2020-01-28,Bahrain,BH,0,0,1569439,0,0
2020-01-29,Bahrain,BH,0,0,1569439,0,0
2020-01-30,Bahrain,BH,0,0,1569439,0,0
2020-01-31,Bahrain,BH,0,0,1569439,0,0
2020-02-01,Bahrain,BH,0,0,1569439,0,0
2020-02-02,Bahrain,BH,0,0,1569439,0,0
2020-02-03,Bahrain,BH,0,0,1569439,0,0
2020-02-04,Bahrain,BH,0,0,1569439,0,0
2020-02-05,Bahrain,BH,0,0,1569439,0,0
2020-02-06,Bahrain,BH,0,0,1569439,0,0
2020-02-07,Bahrain,BH,0,0,1569439,0,0
2020-02-08,Bahrain,BH,0,0,1569439,0,0
2020-02-09,Bahrain,BH,0,0,1569439,0,0
2020-02-10,Bahrain,BH,0,0,1569439,0,0
2020-02-11,Bahrain,BH,0,0,1569439,0,0
2020-02-12,Bahrain,BH,0,0,1569439,0,0
2020-02-13,Bahrain,BH,0,0,1569439,0,0
2020-02-14,Bahrain,BH,0,0,1569439,0,0
2020-02-15,Bahrain,BH,0,0,1569439,0,0
2020-02-16,Bahrain,BH,0,0,1569439,0,0
2020-02-17,Bahrain,BH,0,0,1569439,0,0
2020-02-18,Bahrain,BH,0,0,1569439,0,0
2020-02-19,Bahrain,BH,0,0,1569439,0,0
2020-02-20,Bahrain,BH,0,0,1569439,0,0
2020-02-21,Bahrain,BH,0,0,1569439,0,0
2020-02-22,Bahrain,BH,0,0,1569439,0,0
2020-02-23,Bahrain,BH,0,0,1569439,0,0
2020-02-24,Bahrain,BH,1,0,1569439,1,0
2020-02-25,Bahrain,BH,1,0,1569439,2,0
2020-02-26,Bahrain,BH,21,0,1569439,23,0
2020-02-27,Bahrain,BH,10,0,1569439,33,0
2020-02-28,Bahrain,BH,0,0,1569439,33,0
2020-02-29,Bahrain,BH,5,0,1569439,38,0
2020-03-01,Bahrain,BH,3,0,1569439,41,0
2020-03-02,Bahrain,BH,6,0,1569439,47,0
2020-03-04,Bahrain,BH,2,0,1569439,49,0
2020-03-05,Bahrain,BH,3,0,1569439,52,0
2020-03-06,Bahrain,BH,0,0,1569439,52,0
2020-03-07,Bahrain,BH,4,0,1569439,56,0
2020-03-08,Bahrain,BH,7,0,1569439,63,0
2020-03-09,Bahrain,BH,16,0,1569439,79,0
2020-03-10,Bahrain,BH,30,0,1569439,109,0
2020-03-11,Bahrain,BH,1,0,1569439,110,0
2020-03-12,Bahrain,BH,52,0,1569439,162,0
2020-03-13,Bahrain,BH,0,0,1569439,162,0
2020-03-14,Bahrain,BH,48,0,1569439,210,0
2020-03-15,Bahrain,BH,1,0,1569439,211,0
2020-03-16,Bahrain,BH,3,0,1569439,214,0
2020-03-17,Bahrain,BH,7,1,1569439,221,1
2020-03-18,Bahrain,BH,16,0,1569439,237,1
2020-03-19,Bahrain,BH,19,0,1569439,256,1
2020-03-20,Bahrain,BH,13,0,1569439,269,1
2020-03-21,Bahrain,BH,16,0,1569439,285,1
2020-03-22,Bahrain,BH,21,0,1569439,306,1
2020-03-23,Bahrain,BH,28,1,1569439,334,2
2020-03-24,Bahrain,BH,5,0,1569439,339,2
2020-03-25,Bahrain,BH,51,1,1569439,390,3
2020-03-26,Bahrain,BH,29,0,1569439,419,3
2020-03-27,Bahrain,BH,39,1,1569439,458,4
2020-03-28,Bahrain,BH,8,0,1569439,466,4
2020-03-29,Bahrain,BH,7,0,1569439,473,4
2020-03-30,Bahrain,BH,27,0,1569439,500,4
2020-03-31,Bahrain,BH,15,0,1569439,515,4
2020-04-01,Bahrain,BH,52,0,1569439,567,4
2020-04-02,Bahrain,BH,2,0,1569439,569,4
2020-04-03,Bahrain,BH,74,0,1569439,643,4
2020-04-04,Bahrain,BH,0,0,1569439,643,4
2020-04-05,Bahrain,BH,45,0,1569439,688,4
2020-04-06,Bahrain,BH,12,0,1569439,700,4
2020-04-07,Bahrain,BH,56,0,1569439,756,4
2020-04-08,Bahrain,BH,55,1,1569439,811,5
2020-04-09,Bahrain,BH,12,0,1569439,823,5
2020-04-10,Bahrain,BH,64,0,1569439,887,5
2020-04-11,Bahrain,BH,111,1,1569439,998,6
2020-04-12,Bahrain,BH,42,0,1569439,1040,6
2020-04-13,Bahrain,BH,96,0,1569439,1136,6
2020-04-14,Bahrain,BH,225,1,1569439,1361,7
2020-04-15,Bahrain,BH,167,0,1569439,1528,7
2020-04-16,Bahrain,BH,145,0,1569439,1673,7
2020-04-17,Bahrain,BH,27,0,1569439,1700,7
2020-04-18,Bahrain,BH,44,0,1569439,1744,7
2020-04-19,Bahrain,BH,29,0,1569439,1773,7
2020-04-20,Bahrain,BH,100,0,1569439,1873,7
2020-04-21,Bahrain,BH,34,0,1569439,1907,7
2020-04-22,Bahrain,BH,66,0,1569439,1973,7
2020-04-23,Bahrain,BH,34,0,1569439,2007,7
2020-04-24,Bahrain,BH,210,1,1569439,2217,8
2020-04-25,Bahrain,BH,301,0,1569439,2518,8
2020-04-26,Bahrain,BH,71,0,1569439,2589,8
2020-04-27,Bahrain,BH,58,0,1569439,2647,8
2020-04-28,Bahrain,BH,76,0,1569439,2723,8
2020-04-29,Bahrain,BH,88,0,1569439,2811,8
2020-04-30,Bahrain,BH,110,0,1569439,2921,8
2020-05-01,Bahrain,BH,119,0,1569439,3040,8
2020-05-02,Bahrain,BH,130,0,1569439,3170,8
2020-05-03,Bahrain,BH,114,0,1569439,3284,8
2020-04-01,Burundi,BI,2,0,11175378,2,0
2020-04-02,Burundi,BI,0,0,11175378,2,0
2020-04-03,Burundi,BI,1,0,11175378,3,0
2020-04-04,Burundi,BI,0,0,11175378,3,0
2020-04-05,Burundi,BI,0,0,11175378,3,0
2020-04-06,Burundi,BI,0,0,11175378,3,0
2020-04-07,Burundi,BI,0,0,11175378,3,0
2020-04-08,Burundi,BI,0,0,11175378,3,0
2020-04-09,Burundi,BI,0,0,11175378,3,0
2020-04-10,Burundi,BI,0,0,11175378,3,0
2020-04-11,Burundi,BI,0,0,11175378,3,0
2020-04-12,Burundi,BI,2,0,11175378,5,0
2020-04-13,Burundi,BI,0,0,11175378,5,0
2020-04-14,Burundi,BI,0,0,11175378,5,0
2020-04-15,Burundi,BI,0,1,11175378,5,1
2020-04-16,Burundi,BI,0,0,11175378,5,1
2020-04-17,Burundi,BI,0,0,11175378,5,1
2020-04-18,Burundi,BI,1,0,11175378,6,1
2020-04-19,Burundi,BI,0,0,11175378,6,1
2020-04-20,Burundi,BI,0,0,11175378,6,1
2020-04-21,Burundi,BI,0,0,11175378,6,1
2020-04-22,Burundi,BI,0,0,11175378,6,1
2020-04-23,Burundi,BI,5,0,11175378,11,1
2020-04-24,Burundi,BI,0,0,11175378,11,1
2020-04-25,Burundi,BI,1,0,11175378,12,1
2020-04-26,Burundi,BI,3,0,11175378,15,1
2020-04-27,Burundi,BI,0,0,11175378,15,1
2020-04-28,Burundi,BI,0,0,11175378,15,1
2020-04-29,Burundi,BI,0,0,11175378,15,1
2020-04-30,Burundi,BI,0,0,11175378,15,1
2020-05-01,Burundi,BI,0,0,11175378,15,1
2020-05-02,Burundi,BI,0,0,11175378,15,1
2020-05-03,Burundi,BI,4,0,11175378,19,1
2020-03-17,Benin,BJ,1,0,11485048,1,0
2020-03-18,Benin,BJ,0,0,11485048,1,0
2020-03-19,Benin,BJ,0,0,11485048,1,0
2020-03-20,Benin,BJ,1,0,11485048,2,0
2020-03-21,Benin,BJ,0,0,11485048,2,0
2020-03-22,Benin,BJ,0,0,11485048,2,0
2020-03-23,Benin,BJ,0,0,11485048,2,0
2020-03-24,Benin,BJ,3,0,11485048,5,0
2020-03-25,Benin,BJ,0,0,11485048,5,0
2020-03-26,Benin,BJ,0,0,11485048,5,0
2020-03-27,Benin,BJ,1,0,11485048,6,0
2020-03-28,Benin,BJ,0,0,11485048,6,0
2020-03-29,Benin,BJ,0,0,11485048,6,0
2020-03-30,Benin,BJ,0,0,11485048,6,0
2020-03-31,Benin,BJ,0,0,11485048,6,0
2020-04-01,Benin,BJ,2,0,11485048,8,0
2020-04-02,Benin,BJ,5,0,11485048,13,0
2020-04-03,Benin,BJ,0,0,11485048,13,0
2020-04-04,Benin,BJ,3,0,11485048,16,0
2020-04-05,Benin,BJ,0,0,11485048,16,0
2020-04-06,Benin,BJ,6,0,11485048,22,0
2020-04-07,Benin,BJ,4,1,11485048,26,1
2020-04-08,Benin,BJ,0,0,11485048,26,1
2020-04-09,Benin,BJ,0,0,11485048,26,1
2020-04-10,Benin,BJ,4,0,11485048,30,1
2020-04-11,Benin,BJ,5,0,11485048,35,1
2020-04-12,Benin,BJ,0,0,11485048,35,1
2020-04-13,Benin,BJ,0,0,11485048,35,1
2020-04-14,Benin,BJ,0,0,11485048,35,1
2020-04-15,Benin,BJ,0,0,11485048,35,1
2020-04-16,Benin,BJ,0,0,11485048,35,1
2020-04-17,Benin,BJ,2,0,11485048,37,1
2020-04-18,Benin,BJ,0,0,11485048,37,1
2020-04-19,Benin,BJ,0,0,11485048,37,1
2020-04-20,Benin,BJ,0,0,11485048,37,1
2020-04-21,Benin,BJ,17,0,11485048,54,1
2020-04-22,Benin,BJ,0,0,11485048,54,1
2020-04-23,Benin,BJ,0,0,11485048,54,1
2020-04-24,Benin,BJ,4,0,11485048,58,1
2020-04-25,Benin,BJ,0,0,11485048,58,1
2020-04-26,Benin,BJ,0,0,11485048,58,1
2020-04-27,Benin,BJ,6,0,11485048,64,1
2020-04-28,Benin,BJ,0,0,11485048,64,1
2020-04-29,Benin,BJ,0,0,11485048,64,1
2020-04-30,Benin,BJ,5,1,11485048,69,2
2020-05-01,Benin,BJ,15,0,11485048,84,2
2020-05-02,Benin,BJ,6,0,11485048,90,2
2020-05-03,Benin,BJ,0,0,11485048,90,2
2020-03-20,Bermuda,BM,2,0,63968,2,0
2020-03-21,Bermuda,BM,0,0,63968,2,0
2020-03-22,Bermuda,BM,0,0,63968,2,0
2020-03-23,Bermuda,BM,4,0,63968,6,0
2020-03-24,Bermuda,BM,0,0,63968,6,0
2020-03-25,Bermuda,BM,0,0,63968,6,0
2020-03-26,Bermuda,BM,0,0,63968,6,0
2020-03-27,Bermuda,BM,9,0,63968,15,0
2020-03-28,Bermuda,BM,2,0,63968,17,0
2020-03-29,Bermuda,BM,5,0,63968,22,0
2020-03-30,Bermuda,BM,0,0,63968,22,0
2020-03-31,Bermuda,BM,5,0,63968,27,0
2020-04-01,Bermuda,BM,5,0,63968,32,0
2020-04-02,Bermuda,BM,0,0,63968,32,0
2020-04-03,Bermuda,BM,3,0,63968,35,0
2020-04-04,Bermuda,BM,0,0,63968,35,0
2020-04-05,Bermuda,BM,2,0,63968,37,0
2020-04-06,Bermuda,BM,0,0,63968,37,0
2020-04-07,Bermuda,BM,2,2,63968,39,2
2020-04-08,Bermuda,BM,0,0,63968,39,2
2020-04-09,Bermuda,BM,0,1,63968,39,3
2020-04-10,Bermuda,BM,9,1,63968,48,4
2020-04-11,Bermuda,BM,0,0,63968,48,4
2020-04-12,Bermuda,BM,2,0,63968,50,4
2020-04-13,Bermuda,BM,7,0,63968,57,4
2020-04-14,Bermuda,BM,0,0,63968,57,4
2020-04-15,Bermuda,BM,0,1,63968,57,5
2020-04-16,Bermuda,BM,24,0,63968,81,5
2020-04-17,Bermuda,BM,2,0,63968,83,5
2020-04-18,Bermuda,BM,0,0,63968,83,5
2020-04-19,Bermuda,BM,3,0,63968,86,5
2020-04-20,Bermuda,BM,0,0,63968,86,5
2020-04-21,Bermuda,BM,0,0,63968,86,5
2020-04-22,Bermuda,BM,12,0,63968,98,5
2020-04-23,Bermuda,BM,1,0,63968,99,5
2020-04-24,Bermuda,BM,0,0,63968,99,5
2020-04-25,Bermuda,BM,0,0,63968,99,5
2020-04-26,Bermuda,BM,0,0,63968,99,5
2020-04-27,Bermuda,BM,10,0,63968,109,5
2020-04-28,Bermuda,BM,1,1,63968,110,6
2020-04-29,Bermuda,BM,0,0,63968,110,6
2020-04-30,Bermuda,BM,1,0,63968,111,6
2020-05-01,Bermuda,BM,3,0,63968,114,6
2020-05-02,Bermuda,BM,0,0,63968,114,6
2020-05-03,Bermuda,BM,0,1,63968,114,7
2020-03-10,Brunei_Darussalam,BN,1,0,428962,1,0
2020-03-12,Brunei_Darussalam,BN,10,0,428962,11,0
2020-03-13,Brunei_Darussalam,BN,14,0,428962,25,0
2020-03-14,Brunei_Darussalam,BN,12,0,428962,37,0
2020-03-15,Brunei_Darussalam,BN,3,0,428962,40,0
2020-03-16,Brunei_Darussalam,BN,10,0,428962,50,0
2020-03-17,Brunei_Darussalam,BN,4,0,428962,54,0
2020-03-18,Brunei_Darussalam,BN,2,0,428962,56,0
2020-03-19,Brunei_Darussalam,BN,12,0,428962,68,0
2020-03-20,Brunei_Darussalam,BN,5,0,428962,73,0
2020-03-21,Brunei_Darussalam,BN,5,0,428962,78,0
2020-03-22,Brunei_Darussalam,BN,5,0,428962,83,0
2020-03-23,Brunei_Darussalam,BN,5,0,428962,88,0
2020-03-24,Brunei_Darussalam,BN,3,0,428962,91,0
2020-03-25,Brunei_Darussalam,BN,13,0,428962,104,0
2020-03-26,Brunei_Darussalam,BN,3,0,428962,107,0
2020-03-27,Brunei_Darussalam,BN,7,0,428962,114,0
2020-03-28,Brunei_Darussalam,BN,1,0,428962,115,0
2020-03-29,Brunei_Darussalam,BN,5,1,428962,120,1
2020-03-30,Brunei_Darussalam,BN,6,0,428962,126,1
2020-03-31,Brunei_Darussalam,BN,1,0,428962,127,1
2020-04-01,Brunei_Darussalam,BN,2,0,428962,129,1
2020-04-02,Brunei_Darussalam,BN,2,0,428962,131,1
2020-04-03,Brunei_Darussalam,BN,2,0,428962,133,1
2020-04-04,Brunei_Darussalam,BN,0,0,428962,133,1
2020-04-05,Brunei_Darussalam,BN,2,0,428962,135,1
2020-04-06,Brunei_Darussalam,BN,0,0,428962,135,1
2020-04-07,Brunei_Darussalam,BN,0,0,428962,135,1
2020-04-08,Brunei_Darussalam,BN,0,0,428962,135,1
2020-04-09,Brunei_Darussalam,BN,0,0,428962,135,1
2020-04-10,Brunei_Darussalam,BN,0,0,428962,135,1
2020-04-11,Brunei_Darussalam,BN,1,0,428962,136,1
2020-04-12,Brunei_Darussalam,BN,0,0,428962,136,1
2020-04-13,Brunei_Darussalam,BN,0,0,428962,136,1
2020-04-14,Brunei_Darussalam,BN,0,0,428962,136,1
2020-04-15,Brunei_Darussalam,BN,0,0,428962,136,1
2020-04-16,Brunei_Darussalam,BN,0,0,428962,136,1
2020-04-17,Brunei_Darussalam,BN,0,0,428962,136,1
2020-04-18,Brunei_Darussalam,BN,0,0,428962,136,1
2020-04-19,Brunei_Darussalam,BN,1,0,428962,137,1
2020-04-20,Brunei_Darussalam,BN,1,0,428962,138,1
2020-04-21,Brunei_Darussalam,BN,0,0,428962,138,1
2020-04-22,Brunei_Darussalam,BN,0,0,428962,138,1
2020-04-23,Brunei_Darussalam,BN,0,0,428962,138,1
2020-04-24,Brunei_Darussalam,BN,0,0,428962,138,1
2020-04-25,Brunei_Darussalam,BN,0,0,428962,138,1
2020-04-26,Brunei_Darussalam,BN,0,0,428962,138,1
2020-04-27,Brunei_Darussalam,BN,0,0,428962,138,1
2020-04-28,Brunei_Darussalam,BN,0,0,428962,138,1
2020-04-29,Brunei_Darussalam,BN,0,0,428962,138,1
2020-04-30,Brunei_Darussalam,BN,0,0,428962,138,1
2020-05-01,Brunei_Darussalam,BN,0,0,428962,138,1
2020-05-02,Brunei_Darussalam,BN,0,0,428962,138,1
2020-05-03,Brunei_Darussalam,BN,0,0,428962,138,1
2020-03-12,Bolivia,BO,2,0,11353142,2,0
2020-03-13,Bolivia,BO,1,0,11353142,3,0
2020-03-14,Bolivia,BO,7,0,11353142,10,0
2020-03-15,Bolivia,BO,0,0,11353142,10,0
2020-03-17,Bolivia,BO,1,0,11353142,11,0
2020-03-18,Bolivia,BO,1,0,11353142,12,0
2020-03-19,Bolivia,BO,0,0,11353142,12,0
2020-03-20,Bolivia,BO,3,0,11353142,15,0
2020-03-21,Bolivia,BO,4,0,11353142,19,0
2020-03-22,Bolivia,BO,1,0,11353142,20,0
2020-03-23,Bolivia,BO,7,0,11353142,27,0
2020-03-24,Bolivia,BO,1,0,11353142,28,0
2020-03-25,Bolivia,BO,4,0,11353142,32,0
2020-03-26,Bolivia,BO,7,0,11353142,39,0
2020-03-27,Bolivia,BO,22,0,11353142,61,0
2020-03-28,Bolivia,BO,13,0,11353142,74,0
2020-03-29,Bolivia,BO,7,0,11353142,81,0
2020-03-30,Bolivia,BO,15,3,11353142,96,3
2020-03-31,Bolivia,BO,11,3,11353142,107,6
2020-04-01,Bolivia,BO,8,1,11353142,115,7
2020-04-02,Bolivia,BO,8,1,11353142,123,8
2020-04-03,Bolivia,BO,9,1,11353142,132,9
2020-04-04,Bolivia,BO,7,1,11353142,139,10
2020-04-05,Bolivia,BO,18,0,11353142,157,10
2020-04-06,Bolivia,BO,26,1,11353142,183,11
2020-04-07,Bolivia,BO,11,3,11353142,194,14
2020-04-08,Bolivia,BO,16,1,11353142,210,15
2020-04-09,Bolivia,BO,54,3,11353142,264,18
2020-04-10,Bolivia,BO,4,1,11353142,268,19
2020-04-11,Bolivia,BO,8,1,11353142,276,20
2020-04-12,Bolivia,BO,24,4,11353142,300,24
2020-04-13,Bolivia,BO,30,3,11353142,330,27
2020-04-14,Bolivia,BO,24,1,11353142,354,28
2020-04-15,Bolivia,BO,43,0,11353142,397,28
2020-04-16,Bolivia,BO,44,1,11353142,441,29
2020-04-17,Bolivia,BO,24,2,11353142,465,31
2020-04-18,Bolivia,BO,28,0,11353142,493,31
2020-04-19,Bolivia,BO,27,1,11353142,520,32
2020-04-20,Bolivia,BO,44,1,11353142,564,33
2020-04-21,Bolivia,BO,34,1,11353142,598,34
2020-04-22,Bolivia,BO,11,3,11353142,609,37
2020-04-23,Bolivia,BO,63,3,11353142,672,40
2020-04-24,Bolivia,BO,31,3,11353142,703,43
2020-04-25,Bolivia,BO,104,1,11353142,807,44
2020-04-26,Bolivia,BO,59,2,11353142,866,46
2020-04-27,Bolivia,BO,84,4,11353142,950,50
2020-04-28,Bolivia,BO,64,3,11353142,1014,53
2020-04-29,Bolivia,BO,39,2,11353142,1053,55
2020-04-30,Bolivia,BO,57,4,11353142,1110,59
2020-05-01,Bolivia,BO,57,3,11353142,1167,62
2020-05-02,Bolivia,BO,62,4,11353142,1229,66
2020-05-03,Bolivia,BO,241,5,11353142,1470,71
2020-04-02,"Bonaire, Saint Eustatius and Saba",BQ,2,0,0,2,0
2020-04-03,"Bonaire, Saint Eustatius and Saba",BQ,0,0,0,2,0
2020-04-04,"Bonaire, Saint Eustatius and Saba",BQ,0,0,0,2,0
2020-04-05,"Bonaire, Saint Eustatius and Saba",BQ,0,0,0,2,0
2020-04-06,"Bonaire, Saint Eustatius and Saba",BQ,0,0,0,2,0
2020-04-07,"Bonaire, Saint Eustatius and Saba",BQ,0,0,0,2,0
2020-04-08,"Bonaire, Saint Eustatius and Saba",BQ,0,0,0,2,0
2020-04-09,"Bonaire, Saint Eustatius and Saba",BQ,0,0,0,2,0
2020-04-10,"Bonaire, Saint Eustatius and Saba",BQ,0,0,0,2,0
2020-04-11,"Bonaire, Saint Eustatius and Saba",BQ,0,0,0,2,0
2020-04-12,"Bonaire, Saint Eustatius and Saba",BQ,0,0,0,2,0
2020-04-13,"Bonaire, Saint Eustatius and Saba",BQ,1,0,0,3,0
2020-04-14,"Bonaire, Saint Eustatius and Saba",BQ,1,0,0,4,0
2020-04-15,"Bonaire, Saint Eustatius and Saba",BQ,0,0,0,4,0
2020-04-16,"Bonaire, Saint Eustatius and Saba",BQ,0,0,0,4,0
2020-04-17,"Bonaire, Saint Eustatius and Saba",BQ,0,0,0,4,0
2020-04-18,"Bonaire, Saint Eustatius and Saba",BQ,0,0,0,4,0
2020-04-19,"Bonaire, Saint Eustatius and Saba",BQ,0,0,0,4,0
2020-04-20,"Bonaire, Saint Eustatius and Saba",BQ,1,0,0,5,0
2020-04-21,"Bonaire, Saint Eustatius and Saba",BQ,0,0,0,5,0
2020-04-22,"Bonaire, Saint Eustatius and Saba",BQ,1,0,0,6,0
2020-04-23,"Bonaire, Saint Eustatius and Saba",BQ,0,0,0,6,0
2020-04-24,"Bonaire, Saint Eustatius and Saba",BQ,0,0,0,6,0
2020-04-25,"Bonaire, Saint Eustatius and Saba",BQ,0,0,0,6,0
2020-04-26,"Bonaire, Saint Eustatius and Saba",BQ,0,0,0,6,0
2020-04-27,"Bonaire, Saint Eustatius and Saba",BQ,0,0,0,6,0
2020-04-28,"Bonaire, Saint Eustatius and Saba",BQ,0,0,0,6,0
2020-04-29,"Bonaire, Saint Eustatius and Saba",BQ,0,0,0,6,0
2020-04-30,"Bonaire, Saint Eustatius and Saba",BQ,0,0,0,6,0
2020-05-01,"Bonaire, Saint Eustatius and Saba",BQ,0,0,0,6,0
2020-05-02,"Bonaire, Saint Eustatius and Saba",BQ,0,0,0,6,0
2020-05-03,"Bonaire, Saint Eustatius and Saba",BQ,0,0,0,6,0
2019-12-31,Brazil,BR,0,0,209469333,0,0
2020-01-01,Brazil,BR,0,0,209469333,0,0
2020-01-02,Brazil,BR,0,0,209469333,0,0
2020-01-03,Brazil,BR,0,0,209469333,0,0
2020-01-04,Brazil,BR,0,0,209469333,0,0
2020-01-05,Brazil,BR,0,0,209469333,0,0
2020-01-06,Brazil,BR,0,0,209469333,0,0
2020-01-07,Brazil,BR,0,0,209469333,0,0
2020-01-08,Brazil,BR,0,0,209469333,0,0
2020-01-09,Brazil,BR,0,0,209469333,0,0
2020-01-10,Brazil,BR,0,0,209469333,0,0
2020-01-11,Brazil,BR,0,0,209469333,0,0
2020-01-12,Brazil,BR,0,0,209469333,0,0
2020-01-13,Brazil,BR,0,0,209469333,0,0
2020-01-14,Brazil,BR,0,0,209469333,0,0
2020-01-15,Brazil,BR,0,0,209469333,0,0
2020-01-16,Brazil,BR,0,0,209469333,0,0
2020-01-17,Brazil,BR,0,0,209469333,0,0
2020-01-18,Brazil,BR,0,0,209469333,0,0
2020-01-19,Brazil,BR,0,0,209469333,0,0
2020-01-20,Brazil,BR,0,0,209469333,0,0
2020-01-21,Brazil,BR,0,0,209469333,0,0
2020-01-22,Brazil,BR,0,0,209469333,0,0
2020-01-23,Brazil,BR,0,0,209469333,0,0
2020-01-24,Brazil,BR,0,0,209469333,0,0
2020-01-25,Brazil,BR,0,0,209469333,0,0
2020-01-26,Brazil,BR,0,0,209469333,0,0
2020-01-27,Brazil,BR,0,0,209469333,0,0
2020-01-28,Brazil,BR,0,0,209469333,0,0
2020-01-29,Brazil,BR,0,0,209469333,0,0
2020-01-30,Brazil,BR,0,0,209469333,0,0
2020-01-31,Brazil,BR,0,0,209469333,0,0
2020-02-01,Brazil,BR,0,0,209469333,0,0
2020-02-02,Brazil,BR,0,0,209469333,0,0
2020-02-03,Brazil,BR,0,0,209469333,0,0
2020-02-04,Brazil,BR,0,0,209469333,0,0
2020-02-05,Brazil,BR,0,0,209469333,0,0
2020-02-06,Brazil,BR,0,0,209469333,0,0
2020-02-07,Brazil,BR,0,0,209469333,0,0
2020-02-08,Brazil,BR,0,0,209469333,0,0
2020-02-09,Brazil,BR,0,0,209469333,0,0
2020-02-10,Brazil,BR,0,0,209469333,0,0
2020-02-11,Brazil,BR,0,0,209469333,0,0
2020-02-12,Brazil,BR,0,0,209469333,0,0
2020-02-13,Brazil,BR,0,0,209469333,0,0
2020-02-14,Brazil,BR,0,0,209469333,0,0
2020-02-15,Brazil,BR,0,0,209469333,0,0
2020-02-16,Brazil,BR,0,0,209469333,0,0
2020-02-17,Brazil,BR,0,0,209469333,0,0
2020-02-18,Brazil,BR,0,0,209469333,0,0
2020-02-19,Brazil,BR,0,0,209469333,0,0
2020-02-20,Brazil,BR,0,0,209469333,0,0
2020-02-21,Brazil,BR,0,0,209469333,0,0
2020-02-22,Brazil,BR,0,0,209469333,0,0
2020-02-23,Brazil,BR,0,0,209469333,0,0
2020-02-24,Brazil,BR,0,0,209469333,0,0
2020-02-25,Brazil,BR,0,0,209469333,0,0
2020-02-26,Brazil,BR,1,0,209469333,1,0
2020-02-27,Brazil,BR,0,0,209469333,1,0
2020-02-28,Brazil,BR,0,0,209469333,1,0
2020-02-29,Brazil,BR,0,0,209469333,1,0
2020-03-01,Brazil,BR,1,0,209469333,2,0
2020-03-02,Brazil,BR,0,0,209469333,2,0
2020-03-03,Brazil,BR,0,0,209469333,2,0
2020-03-04,Brazil,BR,0,0,209469333,2,0
2020-03-05,Brazil,BR,1,0,209469333,3,0
2020-03-06,Brazil,BR,5,0,209469333,8,0
2020-03-07,Brazil,BR,5,0,209469333,13,0
2020-03-08,Brazil,BR,0,0,209469333,13,0
2020-03-09,Brazil,BR,12,0,209469333,25,0
2020-03-10,Brazil,BR,0,0,209469333,25,0
2020-03-11,Brazil,BR,9,0,209469333,34,0
2020-03-12,Brazil,BR,18,0,209469333,52,0
2020-03-13,Brazil,BR,25,0,209469333,77,0
2020-03-14,Brazil,BR,21,0,209469333,98,0
2020-03-15,Brazil,BR,23,0,209469333,121,0
2020-03-16,Brazil,BR,79,0,209469333,200,0
2020-03-17,Brazil,BR,34,0,209469333,234,0
2020-03-18,Brazil,BR,57,1,209469333,291,1
2020-03-19,Brazil,BR,137,3,209469333,428,4
2020-03-20,Brazil,BR,193,2,209469333,621,6
2020-03-21,Brazil,BR,283,5,209469333,904,11
2020-03-22,Brazil,BR,224,7,209469333,1128,18
2020-03-23,Brazil,BR,418,7,209469333,1546,25
2020-03-24,Brazil,BR,345,9,209469333,1891,34
2020-03-25,Brazil,BR,310,12,209469333,2201,46
2020-03-26,Brazil,BR,232,11,209469333,2433,57
2020-03-27,Brazil,BR,482,20,209469333,2915,77
2020-03-28,Brazil,BR,502,15,209469333,3417,92
2020-03-29,Brazil,BR,487,22,209469333,3904,114
2020-03-30,Brazil,BR,352,22,209469333,4256,136
2020-03-31,Brazil,BR,323,23,209469333,4579,159
2020-04-01,Brazil,BR,1138,42,209469333,5717,201
2020-04-02,Brazil,BR,1119,40,209469333,6836,241
2020-04-03,Brazil,BR,1074,58,209469333,7910,299
2020-04-04,Brazil,BR,1146,60,209469333,9056,359
2020-04-05,Brazil,BR,1222,73,209469333,10278,432
2020-04-06,Brazil,BR,852,54,209469333,11130,486
2020-04-07,Brazil,BR,926,67,209469333,12056,553
2020-04-08,Brazil,BR,1661,114,209469333,13717,667
2020-04-09,Brazil,BR,2210,133,209469333,15927,800
2020-04-10,Brazil,BR,1930,141,209469333,17857,941
2020-04-11,Brazil,BR,1781,115,209469333,19638,1056
2020-04-12,Brazil,BR,1089,68,209469333,20727,1124
2020-04-13,Brazil,BR,1442,99,209469333,22169,1223
2020-04-14,Brazil,BR,1261,105,209469333,23430,1328
2020-04-15,Brazil,BR,1832,204,209469333,25262,1532
2020-04-16,Brazil,BR,3058,204,209469333,28320,1736
2020-04-17,Brazil,BR,2105,188,209469333,30425,1924
2020-04-18,Brazil,BR,3257,217,209469333,33682,2141
2020-04-19,Brazil,BR,2917,206,209469333,36599,2347
2020-04-20,Brazil,BR,2055,115,209469333,38654,2462
2020-04-21,Brazil,BR,1927,113,209469333,40581,2575
2020-04-22,Brazil,BR,2498,166,209469333,43079,2741
2020-04-23,Brazil,BR,2678,165,209469333,45757,2906
2020-04-24,Brazil,BR,3735,407,209469333,49492,3313
2020-04-25,Brazil,BR,3503,357,209469333,52995,3670
2020-04-26,Brazil,BR,5514,346,209469333,58509,4016
2020-04-27,Brazil,BR,3379,189,209469333,61888,4205
2020-04-28,Brazil,BR,4613,338,209469333,66501,4543
2020-04-29,Brazil,BR,5385,474,209469333,71886,5017
2020-04-30,Brazil,BR,6276,449,209469333,78162,5466
2020-05-01,Brazil,BR,7218,435,209469333,85380,5901
2020-05-02,Brazil,BR,6209,428,209469333,91589,6329
2020-05-03,Brazil,BR,4970,421,209469333,96559,6750
2020-03-16,Bahamas,BS,1,0,385640,1,0
2020-03-17,Bahamas,BS,0,0,385640,1,0
2020-03-20,Bahamas,BS,2,0,385640,3,0
2020-03-21,Bahamas,BS,1,0,385640,4,0
2020-03-22,Bahamas,BS,0,0,385640,4,0
2020-03-23,Bahamas,BS,0,0,385640,4,0
2020-03-24,Bahamas,BS,0,0,385640,4,0
2020-03-25,Bahamas,BS,0,0,385640,4,0
2020-03-26,Bahamas,BS,1,0,385640,5,0
2020-03-27,Bahamas,BS,4,0,385640,9,0
2020-03-28,Bahamas,BS,0,0,385640,9,0
2020-03-29,Bahamas,BS,2,0,385640,11,0
2020-03-30,Bahamas,BS,3,0,385640,14,0
2020-03-31,Bahamas,BS,0,0,385640,14,0
2020-04-01,Bahamas,BS,1,0,385640,15,0
2020-04-02,Bahamas,BS,6,1,385640,21,1
2020-04-03,Bahamas,BS,3,0,385640,24,1
2020-04-04,Bahamas,BS,0,2,385640,24,3
2020-04-05,Bahamas,BS,4,1,385640,28,4
2020-04-06,Bahamas,BS,1,1,385640,29,5
2020-04-07,Bahamas,BS,4,0,385640,33,5
2020-04-08,Bahamas,BS,3,1,385640,36,6
2020-04-09,Bahamas,BS,4,1,385640,40,7
2020-04-10,Bahamas,BS,1,1,385640,41,8
2020-04-11,Bahamas,BS,1,0,385640,42,8
2020-04-12,Bahamas,BS,4,0,385640,46,8
2020-04-13,Bahamas,BS,1,0,385640,47,8
2020-04-14,Bahamas,BS,2,0,385640,49,8
2020-04-15,Bahamas,BS,0,0,385640,49,8
2020-04-16,Bahamas,BS,4,0,385640,53,8
2020-04-17,Bahamas,BS,1,1,385640,54,9
2020-04-18,Bahamas,BS,1,0,385640,55,9
2020-04-19,Bahamas,BS,3,0,385640,58,9
2020-04-20,Bahamas,BS,2,0,385640,60,9
2020-04-21,Bahamas,BS,4,0,385640,64,9
2020-04-22,Bahamas,BS,1,0,385640,65,9
2020-04-23,Bahamas,BS,5,0,385640,70,9
2020-04-24,Bahamas,BS,2,2,385640,72,11
2020-04-25,Bahamas,BS,1,0,385640,73,11
2020-04-26,Bahamas,BS,5,0,385640,78,11
2020-04-27,Bahamas,BS,2,0,385640,80,11
2020-04-28,Bahamas,BS,0,0,385640,80,11
2020-04-29,Bahamas,BS,0,0,385640,80,11
2020-04-30,Bahamas,BS,0,0,385640,80,11
2020-05-01,Bahamas,BS,1,0,385640,81,11
2020-05-02,Bahamas,BS,1,0,385640,82,11
2020-05-03,Bahamas,BS,1,0,385640,83,11
2020-03-06,Bhutan,BT,1,0,754394,1,0
2020-03-13,Bhutan,BT,0,0,754394,1,0
2020-03-15,Bhutan,BT,0,0,754394,1,0
2020-03-17,Bhutan,BT,0,0,754394,1,0
2020-03-18,Bhutan,BT,0,0,754394,1,0
2020-03-19,Bhutan,BT,0,0,754394,1,0
2020-03-20,Bhutan,BT,0,0,754394,1,0
2020-03-21,Bhutan,BT,1,0,754394,2,0
2020-03-22,Bhutan,BT,0,0,754394,2,0
2020-03-23,Bhutan,BT,0,0,754394,2,0
2020-03-24,Bhutan,BT,0,0,754394,2,0
2020-03-25,Bhutan,BT,0,0,754394,2,0
2020-03-26,Bhutan,BT,1,0,754394,3,0
2020-03-27,Bhutan,BT,0,0,754394,3,0
2020-03-28,Bhutan,BT,0,0,754394,3,0
2020-03-29,Bhutan,BT,1,0,754394,4,0
2020-03-30,Bhutan,BT,0,0,754394,4,0
2020-03-31,Bhutan,BT,0,0,754394,4,0
2020-04-01,Bhutan,BT,0,0,754394,4,0
2020-04-02,Bhutan,BT,1,0,754394,5,0
2020-04-03,Bhutan,BT,0,0,754394,5,0
2020-04-04,Bhutan,BT,0,0,754394,5,0
2020-04-05,Bhutan,BT,0,0,754394,5,0
2020-04-06,Bhutan,BT,0,0,754394,5,0
2020-04-07,Bhutan,BT,0,0,754394,5,0
2020-04-08,Bhutan,BT,0,0,754394,5,0
2020-04-09,Bhutan,BT,0,0,754394,5,0
2020-04-10,Bhutan,BT,0,0,754394,5,0
2020-04-11,Bhutan,BT,0,0,754394,5,0
2020-04-12,Bhutan,BT,0,0,754394,5,0
2020-04-13,Bhutan,BT,0,0,754394,5,0
2020-04-14,Bhutan,BT,0,0,754394,5,0
2020-04-15,Bhutan,BT,0,0,754394,5,0
2020-04-16,Bhutan,BT,0,0,754394,5,0
2020-04-17,Bhutan,BT,0,0,754394,5,0
2020-04-18,Bhutan,BT,0,0,754394,5,0
2020-04-19,Bhutan,BT,0,0,754394,5,0
2020-04-20,Bhutan,BT,0,0,754394,5,0
2020-04-21,Bhutan,BT,1,0,754394,6,0
2020-04-22,Bhutan,BT,0,0,754394,6,0
2020-04-23,Bhutan,BT,1,0,754394,7,0
2020-04-24,Bhutan,BT,0,0,754394,7,0
2020-04-25,Bhutan,BT,0,0,754394,7,0
2020-04-26,Bhutan,BT,0,0,754394,7,0
2020-04-27,Bhutan,BT,0,0,754394,7,0
2020-04-28,Bhutan,BT,0,0,754394,7,0
2020-04-29,Bhutan,BT,0,0,754394,7,0
2020-04-30,Bhutan,BT,0,0,754394,7,0
2020-05-01,Bhutan,BT,0,0,754394,7,0
2020-05-02,Bhutan,BT,0,0,754394,7,0
2020-05-03,Bhutan,BT,0,0,754394,7,0
2020-04-01,Botswana,BW,3,0,2254126,3,0
2020-04-02,Botswana,BW,1,1,2254126,4,1
2020-04-03,Botswana,BW,0,0,2254126,4,1
2020-04-04,Botswana,BW,0,0,2254126,4,1
2020-04-05,Botswana,BW,0,0,2254126,4,1
2020-04-06,Botswana,BW,2,0,2254126,6,1
2020-04-07,Botswana,BW,0,0,2254126,6,1
2020-04-08,Botswana,BW,0,0,2254126,6,1
2020-04-09,Botswana,BW,1,0,2254126,7,1
2020-04-10,Botswana,BW,6,0,2254126,13,1
2020-04-11,Botswana,BW,0,0,2254126,13,1
2020-04-12,Botswana,BW,0,0,2254126,13,1
2020-04-13,Botswana,BW,0,0,2254126,13,1
2020-04-14,Botswana,BW,0,0,2254126,13,1
2020-04-15,Botswana,BW,0,0,2254126,13,1
2020-04-16,Botswana,BW,0,0,2254126,13,1
2020-04-17,Botswana,BW,2,0,2254126,15,1
2020-04-18,Botswana,BW,0,0,2254126,15,1
2020-04-19,Botswana,BW,0,0,2254126,15,1
2020-04-20,Botswana,BW,5,0,2254126,20,1
2020-04-21,Botswana,BW,0,0,2254126,20,1
2020-04-22,Botswana,BW,0,0,2254126,20,1
2020-04-23,Botswana,BW,2,0,2254126,22,1
2020-04-24,Botswana,BW,0,0,2254126,22,1
2020-04-25,Botswana,BW,0,0,2254126,22,1
2020-04-26,Botswana,BW,0,0,2254126,22,1
2020-04-27,Botswana,BW,0,0,2254126,22,1
2020-04-28,Botswana,BW,0,0,2254126,22,1
2020-04-29,Botswana,BW,1,0,2254126,23,1
2020-04-30,Botswana,BW,0,0,2254126,23,1
2020-05-01,Botswana,BW,0,0,2254126,23,1
2020-05-02,Botswana,BW,0,0,2254126,23,1
2020-05-03,Botswana,BW,0,0,2254126,23,1
2019-12-31,Belarus,BY,0,0,9485386,0,0
2020-01-01,Belarus,BY,0,0,9485386,0,0
2020-01-02,Belarus,BY,0,0,9485386,0,0
2020-01-03,Belarus,BY,0,0,9485386,0,0
2020-01-04,Belarus,BY,0,0,9485386,0,0
2020-01-05,Belarus,BY,0,0,9485386,0,0
2020-01-06,Belarus,BY,0,0,9485386,0,0
2020-01-07,Belarus,BY,0,0,9485386,0,0
2020-01-08,Belarus,BY,0,0,9485386,0,0
2020-01-09,Belarus,BY,0,0,9485386,0,0
2020-01-10,Belarus,BY,0,0,9485386,0,0
2020-01-11,Belarus,BY,0,0,9485386,0,0
2020-01-12,Belarus,BY,0,0,9485386,0,0
2020-01-13,Belarus,BY,0,0,9485386,0,0
2020-01-14,Belarus,BY,0,0,9485386,0,0
2020-01-15,Belarus,BY,0,0,9485386,0,0
2020-01-16,Belarus,BY,0,0,9485386,0,0
2020-01-17,Belarus,BY,0,0,9485386,0,0
2020-01-18,Belarus,BY,0,0,9485386,0,0
2020-01-19,Belarus,BY,0,0,9485386,0,0
2020-01-20,Belarus,BY,0,0,9485386,0,0
2020-01-21,Belarus,BY,0,0,9485386,0,0
2020-01-22,Belarus,BY,0,0,9485386,0,0
2020-01-23,Belarus,BY,0,0,9485386,0,0
2020-01-24,Belarus,BY,0,0,9485386,0,0
2020-01-25,Belarus,BY,0,0,9485386,0,0
2020-01-26,Belarus,BY,0,0,9485386,0,0
2020-01-27,Belarus,BY,0,0,9485386,0,0
2020-01-28,Belarus,BY,0,0,9485386,0,0
2020-01-29,Belarus,BY,0,0,9485386,0,0
2020-01-30,Belarus,BY,0,0,9485386,0,0
2020-01-31,Belarus,BY,0,0,9485386,0,0
2020-02-01,Belarus,BY,0,0,9485386,0,0
2020-02-02,Belarus,BY,0,0,9485386,0,0
2020-02-03,Belarus,BY,0,0,9485386,0,0
2020-02-04,Belarus,BY,0,0,9485386,0,0
2020-02-05,Belarus,BY,0,0,9485386,0,0
2020-02-06,Belarus,BY,0,0,9485386,0,0
2020-02-07,Belarus,BY,0,0,9485386,0,0
2020-02-08,Belarus,BY,0,0,9485386,0,0
2020-02-09,Belarus,BY,0,0,9485386,0,0
2020-02-10,Belarus,BY,0,0,9485386,0,0
2020-02-11,Belarus,BY,0,0,9485386,0,0
2020-02-12,Belarus,BY,0,0,9485386,0,0
2020-02-13,Belarus,BY,0,0,9485386,0,0
2020-02-14,Belarus,BY,0,0,9485386,0,0
2020-02-15,Belarus,BY,0,0,9485386,0,0
2020-02-16,Belarus,BY,0,0,9485386,0,0
2020-02-17,Belarus,BY,0,0,9485386,0,0
2020-02-18,Belarus,BY,0,0,9485386,0,0
2020-02-19,Belarus,BY,0,0,9485386,0,0
2020-02-20,Belarus,BY,0,0,9485386,0,0
2020-02-21,Belarus,BY,0,0,9485386,0,0
2020-02-22,Belarus,BY,0,0,9485386,0,0
2020-02-23,Belarus,BY,0,0,9485386,0,0
2020-02-24,Belarus,BY,0,0,9485386,0,0
2020-02-25,Belarus,BY,0,0,9485386,0,0
2020-02-26,Belarus,BY,0,0,9485386,0,0
2020-02-27,Belarus,BY,0,0,9485386,0,0
2020-02-28,Belarus,BY,1,0,9485386,1,0
2020-02-29,Belarus,BY,0,0,9485386,1,0
2020-03-01,Belarus,BY,0,0,9485386,1,0
2020-03-02,Belarus,BY,0,0,9485386,1,0
2020-03-04,Belarus,BY,3,0,9485386,4,0
2020-03-05,Belarus,BY,2,0,9485386,6,0
2020-03-11,Belarus,BY,3,0,9485386,9,0
2020-03-12,Belarus,BY,3,0,9485386,12,0
2020-03-13,Belarus,BY,9,0,9485386,21,0
2020-03-16,Belarus,BY,6,0,9485386,27,0
2020-03-17,Belarus,BY,9,0,9485386,36,0
2020-03-18,Belarus,BY,0,0,9485386,36,0
2020-03-19,Belarus,BY,10,0,9485386,46,0
2020-03-20,Belarus,BY,11,0,9485386,57,0
2020-03-21,Belarus,BY,0,0,9485386,57,0
2020-03-22,Belarus,BY,19,0,9485386,76,0
2020-03-23,Belarus,BY,0,0,9485386,76,0
2020-03-24,Belarus,BY,5,0,9485386,81,0
2020-03-25,Belarus,BY,0,0,9485386,81,0
2020-03-26,Belarus,BY,5,0,9485386,86,0
2020-03-27,Belarus,BY,0,0,9485386,86,0
2020-03-28,Belarus,BY,8,0,9485386,94,0
2020-03-29,Belarus,BY,0,0,9485386,94,0
2020-03-30,Belarus,BY,0,0,9485386,94,0
2020-03-31,Belarus,BY,11,0,9485386,105,0
2020-04-01,Belarus,BY,47,0,9485386,152,0
2020-04-02,Belarus,BY,0,0,9485386,152,0
2020-04-03,Belarus,BY,102,4,9485386,254,4
2020-04-04,Belarus,BY,97,0,9485386,351,4
2020-04-05,Belarus,BY,43,1,9485386,394,5
2020-04-06,Belarus,BY,170,3,9485386,564,8
2020-04-07,Belarus,BY,136,5,9485386,700,13
2020-04-08,Belarus,BY,161,0,9485386,861,13
2020-04-09,Belarus,BY,205,0,9485386,1066,13
2020-04-10,Belarus,BY,420,3,9485386,1486,16
2020-04-11,Belarus,BY,495,3,9485386,1981,19
2020-04-12,Belarus,BY,245,4,9485386,2226,23
2020-04-13,Belarus,BY,352,3,9485386,2578,26
2020-04-14,Belarus,BY,341,3,9485386,2919,29
2020-04-15,Belarus,BY,362,4,9485386,3281,33
2020-04-16,Belarus,BY,447,3,9485386,3728,36
2020-04-17,Belarus,BY,476,4,9485386,4204,40
2020-04-18,Belarus,BY,575,2,9485386,4779,42
2020-04-19,Belarus,BY,0,3,9485386,4779,45
2020-04-20,Belarus,BY,0,2,9485386,4779,47
2020-04-21,Belarus,BY,1485,4,9485386,6264,51
2020-04-22,Belarus,BY,459,4,9485386,6723,55
2020-04-23,Belarus,BY,558,3,9485386,7281,58
2020-04-24,Belarus,BY,741,2,9485386,8022,60
2020-04-25,Belarus,BY,751,3,9485386,8773,63
2020-04-26,Belarus,BY,817,4,9485386,9590,67
2020-04-27,Belarus,BY,873,5,9485386,10463,72
2020-04-28,Belarus,BY,826,3,9485386,11289,75
2020-04-29,Belarus,BY,919,4,9485386,12208,79
2020-04-30,Belarus,BY,973,5,9485386,13181,84
2020-05-01,Belarus,BY,846,5,9485386,14027,89
2020-05-02,Belarus,BY,890,4,9485386,14917,93
2020-05-03,Belarus,BY,911,4,9485386,15828,97
2020-03-24,Belize,BZ,1,0,383071,1,0
2020-03-25,Belize,BZ,0,0,383071,1,0
2020-03-26,Belize,BZ,1,0,383071,2,0
2020-03-27,Belize,BZ,0,0,383071,2,0
2020-03-28,Belize,BZ,0,0,383071,2,0
2020-03-29,Belize,BZ,0,0,383071,2,0
2020-03-30,Belize,BZ,0,0,383071,2,0
2020-03-31,Belize,BZ,1,0,383071,3,0
2020-04-01,Belize,BZ,0,0,383071,3,0
2020-04-02,Belize,BZ,0,0,383071,3,0
2020-04-03,Belize,BZ,0,0,383071,3,0
2020-04-04,Belize,BZ,1,0,383071,4,0
2020-04-05,Belize,BZ,0,0,383071,4,0
2020-04-06,Belize,BZ,1,1,383071,5,1
2020-04-07,Belize,BZ,2,0,383071,7,1
2020-04-08,Belize,BZ,0,0,383071,7,1
2020-04-09,Belize,BZ,1,0,383071,8,1
2020-04-10,Belize,BZ,1,0,383071,9,1
2020-04-11,Belize,BZ,1,1,383071,10,2
2020-04-12,Belize,BZ,3,0,383071,13,2
2020-04-13,Belize,BZ,1,0,383071,14,2
2020-04-14,Belize,BZ,4,0,383071,18,2
2020-04-15,Belize,BZ,0,0,383071,18,2
2020-04-16,Belize,BZ,0,0,383071,18,2
2020-04-17,Belize,BZ,0,0,383071,18,2
2020-04-18,Belize,BZ,0,0,383071,18,2
2020-04-19,Belize,BZ,0,0,383071,18,2
2020-04-20,Belize,BZ,0,0,383071,18,2
2020-04-21,Belize,BZ,0,0,383071,18,2
2020-04-22,Belize,BZ,0,0,383071,18,2
2020-04-23,Belize,BZ,0,0,383071,18,2
2020-04-24,Belize,BZ,0,0,383071,18,2
2020-04-25,Belize,BZ,0,0,383071,18,2
2020-04-26,Belize,BZ,0,0,383071,18,2
2020-04-27,Belize,BZ,0,0,383071,18,2
2020-04-28,Belize,BZ,0,0,383071,18,2
2020-04-29,Belize,BZ,0,0,383071,18,2
2020-04-30,Belize,BZ,0,0,383071,18,2
2020-05-01,Belize,BZ,0,0,383071,18,2
2020-05-02,Belize,BZ,0,0,383071,18,2
2020-05-03,Belize,BZ,0,0,383071,18,2
2019-12-31,Canada,CA,0,0,37058856,0,0
2020-01-01,Canada,CA,0,0,37058856,0,0
2020-01-02,Canada,CA,0,0,37058856,0,0
2020-01-03,Canada,CA,0,0,37058856,0,0
2020-01-04,Canada,CA,0,0,37058856,0,0
2020-01-05,Canada,CA,0,0,37058856,0,0
2020-01-06,Canada,CA,0,0,37058856,0,0
2020-01-07,Canada,CA,0,0,37058856,0,0
2020-01-08,Canada,CA,0,0,37058856,0,0
2020-01-09,Canada,CA,0,0,37058856,0,0
2020-01-10,Canada,CA,0,0,37058856,0,0
2020-01-11,Canada,CA,0,0,37058856,0,0
2020-01-12,Canada,CA,0,0,37058856,0,0
2020-01-13,Canada,CA,0,0,37058856,0,0
2020-01-14,Canada,CA,0,0,37058856,0,0
2020-01-15,Canada,CA,0,0,37058856,0,0
2020-01-16,Canada,CA,0,0,37058856,0,0
2020-01-17,Canada,CA,0,0,37058856,0,0
2020-01-18,Canada,CA,0,0,37058856,0,0
2020-01-19,Canada,CA,0,0,37058856,0,0
2020-01-20,Canada,CA,0,0,37058856,0,0
2020-01-21,Canada,CA,0,0,37058856,0,0
2020-01-22,Canada,CA,0,0,37058856,0,0
2020-01-23,Canada,CA,0,0,37058856,0,0
2020-01-24,Canada,CA,0,0,37058856,0,0
2020-01-25,Canada,CA,0,0,37058856,0,0
2020-01-26,Canada,CA,1,0,37058856,1,0
2020-01-27,Canada,CA,0,0,37058856,1,0
2020-01-28,Canada,CA,1,0,37058856,2,0
2020-01-29,Canada,CA,1,0,37058856,3,0
2020-01-30,Canada,CA,0,0,37058856,3,0
2020-01-31,Canada,CA,0,0,37058856,3,0
2020-02-01,Canada,CA,1,0,37058856,4,0
2020-02-02,Canada,CA,0,0,37058856,4,0
2020-02-03,Canada,CA,0,0,37058856,4,0
2020-02-04,Canada,CA,0,0,37058856,4,0
2020-02-05,Canada,CA,1,0,37058856,5,0
2020-02-06,Canada,CA,0,0,37058856,5,0
2020-02-07,Canada,CA,2,0,37058856,7,0
2020-02-08,Canada,CA,0,0,37058856,7,0
2020-02-09,Canada,CA,0,0,37058856,7,0
2020-02-10,Canada,CA,0,0,37058856,7,0
2020-02-11,Canada,CA,0,0,37058856,7,0
2020-02-12,Canada,CA,0,0,37058856,7,0
2020-02-13,Canada,CA,0,0,37058856,7,0
2020-02-14,Canada,CA,0,0,37058856,7,0
2020-02-15,Canada,CA,1,0,37058856,8,0
2020-02-16,Canada,CA,0,0,37058856,8,0
2020-02-17,Canada,CA,0,0,37058856,8,0
2020-02-18,Canada,CA,0,0,37058856,8,0
2020-02-19,Canada,CA,0,0,37058856,8,0
2020-02-20,Canada,CA,0,0,37058856,8,0
2020-02-21,Canada,CA,1,0,37058856,9,0
2020-02-22,Canada,CA,0,0,37058856,9,0
2020-02-23,Canada,CA,0,0,37058856,9,0
2020-02-24,Canada,CA,0,0,37058856,9,0
2020-02-25,Canada,CA,2,0,37058856,11,0
2020-02-26,Canada,CA,0,0,37058856,11,0
2020-02-27,Canada,CA,1,0,37058856,12,0
2020-02-28,Canada,CA,2,0,37058856,14,0
2020-02-29,Canada,CA,2,0,37058856,16,0
2020-03-01,Canada,CA,4,0,37058856,20,0
2020-03-02,Canada,CA,4,0,37058856,24,0
2020-03-03,Canada,CA,3,0,37058856,27,0
2020-03-04,Canada,CA,3,0,37058856,30,0
2020-03-05,Canada,CA,3,0,37058856,33,0
2020-03-06,Canada,CA,12,0,37058856,45,0
2020-03-07,Canada,CA,6,0,37058856,51,0
2020-03-08,Canada,CA,6,0,37058856,57,0
2020-03-09,Canada,CA,5,0,37058856,62,0
2020-03-10,Canada,CA,15,1,37058856,77,1
2020-03-11,Canada,CA,16,0,37058856,93,1
2020-03-12,Canada,CA,10,0,37058856,103,1
2020-03-13,Canada,CA,35,0,37058856,138,1
2020-03-14,Canada,CA,38,0,37058856,176,1
2020-03-15,Canada,CA,68,0,37058856,244,1
2020-03-16,Canada,CA,60,0,37058856,304,1
2020-03-17,Canada,CA,120,3,37058856,424,4
2020-03-18,Canada,CA,145,4,37058856,569,8
2020-03-19,Canada,CA,121,1,37058856,690,9
2020-03-20,Canada,CA,156,1,37058856,846,10
2020-03-21,Canada,CA,125,2,37058856,971,12
2020-03-22,Canada,CA,331,6,37058856,1302,18
2020-03-23,Canada,CA,128,2,37058856,1430,20
2020-03-24,Canada,CA,216,4,37058856,1646,24
2020-03-25,Canada,CA,313,3,37058856,1959,27
2020-03-26,Canada,CA,1426,8,37058856,3385,35
2020-03-27,Canada,CA,633,4,37058856,4018,39
2020-03-28,Canada,CA,657,14,37058856,4675,53
2020-03-29,Canada,CA,711,7,37058856,5386,60
2020-03-30,Canada,CA,869,1,37058856,6255,61
2020-03-31,Canada,CA,1169,28,37058856,7424,89
2020-04-01,Canada,CA,1112,7,37058856,8536,96
2020-04-02,Canada,CA,1059,13,37058856,9595,109
2020-04-03,Canada,CA,1673,29,37058856,11268,138
2020-04-04,Canada,CA,1251,49,37058856,12519,187
2020-04-05,Canada,CA,1363,44,37058856,13882,231
2020-04-06,Canada,CA,1614,49,37058856,15496,280
2020-04-07,Canada,CA,1157,43,37058856,16653,323
2020-04-08,Canada,CA,1230,57,37058856,17883,380
2020-04-09,Canada,CA,1391,55,37058856,19274,435
2020-04-10,Canada,CA,1474,74,37058856,20748,509
2020-04-11,Canada,CA,1385,60,37058856,22133,569
2020-04-12,Canada,CA,1168,84,37058856,23301,653
2020-04-13,Canada,CA,1064,64,37058856,24365,717
2020-04-14,Canada,CA,1298,63,37058856,25663,780
2020-04-15,Canada,CA,1383,123,37058856,27046,903
2020-04-16,Canada,CA,1318,107,37058856,28364,1010
2020-04-17,Canada,CA,1717,183,37058856,30081,1193
2020-04-18,Canada,CA,1791,116,37058856,31872,1309
2020-04-19,Canada,CA,1469,158,37058856,33341,1467
2020-04-20,Canada,CA,1436,113,37058856,34777,1580
2020-04-21,Canada,CA,2046,110,37058856,36823,1690
2020-04-22,Canada,CA,1590,144,37058856,38413,1834
2020-04-23,Canada,CA,1766,140,37058856,40179,1974
2020-04-24,Canada,CA,1920,172,37058856,42099,2146
2020-04-25,Canada,CA,1778,156,37058856,43877,2302
2020-04-26,Canada,CA,1464,163,37058856,45341,2465
2020-04-27,Canada,CA,1543,95,37058856,46884,2560
2020-04-28,Canada,CA,1605,147,37058856,48489,2707
2020-04-29,Canada,CA,1526,152,37058856,50015,2859
2020-04-30,Canada,CA,1572,137,37058856,51587,2996
2020-05-01,Canada,CA,1649,188,37058856,53236,3184
2020-05-02,Canada,CA,1825,207,37058856,55061,3391
2020-05-03,Canada,CA,1653,175,37058856,56714,3566
2020-03-11,Democratic_Republic_of_the_Congo,CD,1,0,84068091,1,0
2020-03-14,Democratic_Republic_of_the_Congo,CD,1,0,84068091,2,0
2020-03-15,Democratic_Republic_of_the_Congo,CD,0,0,84068091,2,0
2020-03-16,Democratic_Republic_of_the_Congo,CD,0,0,84068091,2,0
2020-03-17,Democratic_Republic_of_the_Congo,CD,1,0,84068091,3,0
2020-03-18,Democratic_Republic_of_the_Congo,CD,0,0,84068091,3,0
2020-03-19,Democratic_Republic_of_the_Congo,CD,11,0,84068091,14,0
2020-03-20,Democratic_Republic_of_the_Congo,CD,0,0,84068091,14,0
2020-03-21,Democratic_Republic_of_the_Congo,CD,0,0,84068091,14,0
2020-03-22,Democratic_Republic_of_the_Congo,CD,9,1,84068091,23,1
2020-03-23,Democratic_Republic_of_the_Congo,CD,3,1,84068091,26,2
2020-03-24,Democratic_Republic_of_the_Congo,CD,0,0,84068091,26,2
2020-03-25,Democratic_Republic_of_the_Congo,CD,19,1,84068091,45,3
2020-03-26,Democratic_Republic_of_the_Congo,CD,0,0,84068091,45,3
2020-03-27,Democratic_Republic_of_the_Congo,CD,9,1,84068091,54,4
2020-03-28,Democratic_Republic_of_the_Congo,CD,4,0,84068091,58,4
2020-03-29,Democratic_Republic_of_the_Congo,CD,0,2,84068091,58,6
2020-03-30,Democratic_Republic_of_the_Congo,CD,23,2,84068091,81,8
2020-03-31,Democratic_Republic_of_the_Congo,CD,17,0,84068091,98,8
2020-04-01,Democratic_Republic_of_the_Congo,CD,0,0,84068091,98,8
2020-04-02,Democratic_Republic_of_the_Congo,CD,25,3,84068091,123,11
2020-04-03,Democratic_Republic_of_the_Congo,CD,0,0,84068091,123,11
2020-04-04,Democratic_Republic_of_the_Congo,CD,11,2,84068091,134,13
2020-04-05,Democratic_Republic_of_the_Congo,CD,20,5,84068091,154,18
2020-04-06,Democratic_Republic_of_the_Congo,CD,0,0,84068091,154,18
2020-04-07,Democratic_Republic_of_the_Congo,CD,7,0,84068091,161,18
2020-04-08,Democratic_Republic_of_the_Congo,CD,19,0,84068091,180,18
2020-04-09,Democratic_Republic_of_the_Congo,CD,3,2,84068091,183,20
2020-04-10,Democratic_Republic_of_the_Congo,CD,32,0,84068091,215,20
2020-04-11,Democratic_Republic_of_the_Congo,CD,8,0,84068091,223,20
2020-04-12,Democratic_Republic_of_the_Congo,CD,11,0,84068091,234,20
2020-04-13,Democratic_Republic_of_the_Congo,CD,0,0,84068091,234,20
2020-04-14,Democratic_Republic_of_the_Congo,CD,1,0,84068091,235,20
2020-04-15,Democratic_Republic_of_the_Congo,CD,19,1,84068091,254,21
2020-04-16,Democratic_Republic_of_the_Congo,CD,13,1,84068091,267,22
2020-04-17,Democratic_Republic_of_the_Congo,CD,20,1,84068091,287,23
2020-04-18,Democratic_Republic_of_the_Congo,CD,20,2,84068091,307,25
2020-04-19,Democratic_Republic_of_the_Congo,CD,20,0,84068091,327,25
2020-04-20,Democratic_Republic_of_the_Congo,CD,5,0,84068091,332,25
2020-04-21,Democratic_Republic_of_the_Congo,CD,18,0,84068091,350,25
2020-04-22,Democratic_Republic_of_the_Congo,CD,9,0,84068091,359,25
2020-04-23,Democratic_Republic_of_the_Congo,CD,18,0,84068091,377,25
2020-04-24,Democratic_Republic_of_the_Congo,CD,17,0,84068091,394,25
2020-04-25,Democratic_Republic_of_the_Congo,CD,22,3,84068091,416,28
2020-04-26,Democratic_Republic_of_the_Congo,CD,26,0,84068091,442,28
2020-04-27,Democratic_Republic_of_the_Congo,CD,17,0,84068091,459,28
2020-04-28,Democratic_Republic_of_the_Congo,CD,12,2,84068091,471,30
2020-04-29,Democratic_Republic_of_the_Congo,CD,20,0,84068091,491,30
2020-04-30,Democratic_Republic_of_the_Congo,CD,9,1,84068091,500,31
2020-05-01,Democratic_Republic_of_the_Congo,CD,72,0,84068091,572,31
2020-05-02,Democratic_Republic_of_the_Congo,CD,32,1,84068091,604,32
2020-05-03,Democratic_Republic_of_the_Congo,CD,70,1,84068091,674,33
2020-03-16,Central_African_Republic,CF,1,0,4666377,1,0
2020-03-17,Central_African_Republic,CF,0,0,4666377,1,0
2020-03-18,Central_African_Republic,CF,0,0,4666377,1,0
2020-03-19,Central_African_Republic,CF,0,0,4666377,1,0
2020-03-20,Central_African_Republic,CF,0,0,4666377,1,0
2020-03-21,Central_African_Republic,CF,0,0,4666377,1,0
2020-03-22,Central_African_Republic,CF,2,0,4666377,3,0
2020-03-23,Central_African_Republic,CF,1,0,4666377,4,0
2020-03-24,Central_African_Republic,CF,0,0,4666377,4,0
2020-03-25,Central_African_Republic,CF,0,0,4666377,4,0
2020-03-26,Central_African_Republic,CF,0,0,4666377,4,0
2020-03-27,Central_African_Republic,CF,1,0,4666377,5,0
2020-03-28,Central_African_Republic,CF,0,0,4666377,5,0
2020-03-29,Central_African_Republic,CF,1,0,4666377,6,0
2020-03-30,Central_African_Republic,CF,0,0,4666377,6,0
2020-03-31,Central_African_Republic,CF,0,0,4666377,6,0
2020-04-01,Central_African_Republic,CF,0,0,4666377,6,0
2020-04-02,Central_African_Republic,CF,2,0,4666377,8,0
2020-04-03,Central_African_Republic,CF,0,0,4666377,8,0
2020-04-04,Central_African_Republic,CF,0,0,4666377,8,0
2020-04-05,Central_African_Republic,CF,1,0,4666377,9,0
2020-04-06,Central_African_Republic,CF,0,0,4666377,9,0
2020-04-07,Central_African_Republic,CF,0,0,4666377,9,0
2020-04-08,Central_African_Republic,CF,0,0,4666377,9,0
2020-04-09,Central_African_Republic,CF,1,0,4666377,10,0
2020-04-10,Central_African_Republic,CF,1,0,4666377,11,0
2020-04-11,Central_African_Republic,CF,0,0,4666377,11,0
2020-04-12,Central_African_Republic,CF,0,0,4666377,11,0
2020-04-13,Central_African_Republic,CF,0,0,4666377,11,0
2020-04-14,Central_African_Republic,CF,0,0,4666377,11,0
2020-04-15,Central_African_Republic,CF,0,0,4666377,11,0
2020-04-16,Central_African_Republic,CF,0,0,4666377,11,0
2020-04-17,Central_African_Republic,CF,1,0,4666377,12,0
2020-04-18,Central_African_Republic,CF,0,0,4666377,12,0
2020-04-19,Central_African_Republic,CF,0,0,4666377,12,0
2020-04-20,Central_African_Republic,CF,0,0,4666377,12,0
2020-04-21,Central_African_Republic,CF,0,0,4666377,12,0
2020-04-22,Central_African_Republic,CF,2,0,4666377,14,0
2020-04-23,Central_African_Republic,CF,2,0,4666377,16,0
2020-04-24,Central_African_Republic,CF,1,0,4666377,17,0
2020-04-25,Central_African_Republic,CF,2,0,4666377,19,0
2020-04-26,Central_African_Republic,CF,0,0,4666377,19,0
2020-04-27,Central_African_Republic,CF,0,0,4666377,19,0
2020-04-28,Central_African_Republic,CF,31,0,4666377,50,0
2020-04-29,Central_African_Republic,CF,0,0,4666377,50,0
2020-04-30,Central_African_Republic,CF,0,0,4666377,50,0
2020-05-01,Central_African_Republic,CF,0,0,4666377,50,0
2020-05-02,Central_African_Republic,CF,22,0,4666377,72,0
2020-05-03,Central_African_Republic,CF,0,0,4666377,72,0
2020-03-16,Congo,CG,1,0,5244363,1,0
2020-03-17,Congo,CG,0,0,5244363,1,0
2020-03-18,Congo,CG,0,0,5244363,1,0
2020-03-19,Congo,CG,2,0,5244363,3,0
2020-03-20,Congo,CG,0,0,5244363,3,0
2020-03-21,Congo,CG,0,0,5244363,3,0
2020-03-22,Congo,CG,1,0,5244363,4,0
2020-03-23,Congo,CG,0,0,5244363,4,0
2020-03-24,Congo,CG,0,0,5244363,4,0
2020-03-25,Congo,CG,0,0,5244363,4,0
2020-03-26,Congo,CG,0,0,5244363,4,0
2020-03-27,Congo,CG,0,0,5244363,4,0
2020-03-28,Congo,CG,0,0,5244363,4,0
2020-03-29,Congo,CG,15,0,5244363,19,0
2020-03-30,Congo,CG,0,0,5244363,19,0
2020-03-31,Congo,CG,0,0,5244363,19,0
2020-04-01,Congo,CG,3,2,5244363,22,2
2020-04-02,Congo,CG,0,0,5244363,22,2
2020-04-03,Congo,CG,19,1,5244363,41,3
2020-04-04,Congo,CG,0,0,5244363,41,3
2020-04-05,Congo,CG,4,2,5244363,45,5
2020-04-06,Congo,CG,0,0,5244363,45,5
2020-04-07,Congo,CG,0,0,5244363,45,5
2020-04-08,Congo,CG,0,0,5244363,45,5
2020-04-09,Congo,CG,15,0,5244363,60,5
2020-04-10,Congo,CG,0,0,5244363,60,5
2020-04-11,Congo,CG,0,0,5244363,60,5
2020-04-12,Congo,CG,0,0,5244363,60,5
2020-04-13,Congo,CG,10,0,5244363,70,5
2020-04-14,Congo,CG,0,0,5244363,70,5
2020-04-15,Congo,CG,4,0,5244363,74,5
2020-04-16,Congo,CG,43,0,5244363,117,5
2020-04-17,Congo,CG,0,0,5244363,117,5
2020-04-18,Congo,CG,26,1,5244363,143,6
2020-04-19,Congo,CG,0,0,5244363,143,6
2020-04-20,Congo,CG,17,0,5244363,160,6
2020-04-21,Congo,CG,0,0,5244363,160,6
2020-04-22,Congo,CG,5,0,5244363,165,6
2020-04-23,Congo,CG,21,0,5244363,186,6
2020-04-24,Congo,CG,0,0,5244363,186,6
2020-04-25,Congo,CG,14,0,5244363,200,6
2020-04-26,Congo,CG,0,2,5244363,200,8
2020-04-27,Congo,CG,0,0,5244363,200,8
2020-04-28,Congo,CG,7,0,5244363,207,8
2020-04-29,Congo,CG,0,0,5244363,207,8
2020-04-30,Congo,CG,13,1,5244363,220,9
2020-05-01,Congo,CG,0,0,5244363,220,9
2020-05-02,Congo,CG,9,1,5244363,229,10
2020-05-03,Congo,CG,0,0,5244363,229,10
2019-12-31,Switzerland,CH,0,0,8516543,0,0
2020-01-01,Switzerland,CH,0,0,8516543,0,0
2020-01-02,Switzerland,CH,0,0,8516543,0,0
2020-01-03,Switzerland,CH,0,0,8516543,0,0
2020-01-04,Switzerland,CH,0,0,8516543,0,0
2020-01-05,Switzerland,CH,0,0,8516543,0,0
2020-01-06,Switzerland,CH,0,0,8516543,0,0
2020-01-07,Switzerland,CH,0,0,8516543,0,0
2020-01-08,Switzerland,CH,0,0,8516543,0,0
2020-01-09,Switzerland,CH,0,0,8516543,0,0
2020-01-10,Switzerland,CH,0,0,8516543,0,0
2020-01-11,Switzerland,CH,0,0,8516543,0,0
2020-01-12,Switzerland,CH,0,0,8516543,0,0
2020-01-13,Switzerland,CH,0,0,8516543,0,0
2020-01-14,Switzerland,CH,0,0,8516543,0,0
2020-01-15,Switzerland,CH,0,0,8516543,0,0
2020-01-16,Switzerland,CH,0,0,8516543,0,0
2020-01-17,Switzerland,CH,0,0,8516543,0,0
2020-01-18,Switzerland,CH,0,0,8516543,0,0
2020-01-19,Switzerland,CH,0,0,8516543,0,0
2020-01-20,Switzerland,CH,0,0,8516543,0,0
2020-01-21,Switzerland,CH,0,0,8516543,0,0
2020-01-22,Switzerland,CH,0,0,8516543,0,0
2020-01-23,Switzerland,CH,0,0,8516543,0,0
2020-01-24,Switzerland,CH,0,0,8516543,0,0
2020-01-25,Switzerland,CH,0,0,8516543,0,0
2020-01-26,Switzerland,CH,0,0,8516543,0,0
2020-01-27,Switzerland,CH,0,0,8516543,0,0
2020-01-28,Switzerland,CH,0,0,8516543,0,0
2020-01-29,Switzerland,CH,0,0,8516543,0,0
2020-01-30,Switzerland,CH,0,0,8516543,0,0
2020-01-31,Switzerland,CH,0,0,8516543,0,0
2020-02-01,Switzerland,CH,0,0,8516543,0,0
2020-02-02,Switzerland,CH,0,0,8516543,0,0
2020-02-03,Switzerland,CH,0,0,8516543,0,0
2020-02-04,Switzerland,CH,0,0,8516543,0,0
2020-02-05,Switzerland,CH,0,0,8516543,0,0
2020-02-06,Switzerland,CH,0,0,8516543,0,0
2020-02-07,Switzerland,CH,0,0,8516543,0,0
2020-02-08,Switzerland,CH,0,0,8516543,0,0
2020-02-09,Switzerland,CH,0,0,8516543,0,0
2020-02-10,Switzerland,CH,0,0,8516543,0,0
2020-02-11,Switzerland,CH,0,0,8516543,0,0
2020-02-12,Switzerland,CH,0,0,8516543,0,0
2020-02-13,Switzerland,CH,0,0,8516543,0,0
2020-02-14,Switzerland,CH,0,0,8516543,0,0
2020-02-15,Switzerland,CH,0,0,8516543,0,0
2020-02-16,Switzerland,CH,0,0,8516543,0,0
2020-02-17,Switzerland,CH,0,0,8516543,0,0
2020-02-18,Switzerland,CH,0,0,8516543,0,0
2020-02-19,Switzerland,CH,0,0,8516543,0,0
2020-02-20,Switzerland,CH,0,0,8516543,0,0
2020-02-21,Switzerland,CH,0,0,8516543,0,0
2020-02-22,Switzerland,CH,0,0,8516543,0,0
2020-02-23,Switzerland,CH,0,0,8516543,0,0
2020-02-24,Switzerland,CH,0,0,8516543,0,0
2020-02-25,Switzerland,CH,0,0,8516543,0,0
2020-02-26,Switzerland,CH,1,0,8516543,1,0
2020-02-27,Switzerland,CH,0,0,8516543,1,0
2020-02-28,Switzerland,CH,7,0,8516543,8,0
2020-02-29,Switzerland,CH,4,0,8516543,12,0
2020-03-01,Switzerland,CH,6,0,8516543,18,0
2020-03-02,Switzerland,CH,6,0,8516543,24,0
2020-03-03,Switzerland,CH,6,0,8516543,30,0
2020-03-04,Switzerland,CH,7,0,8516543,37,0
2020-03-05,Switzerland,CH,20,0,8516543,57,0
2020-03-06,Switzerland,CH,30,1,8516543,87,1
2020-03-07,Switzerland,CH,122,0,8516543,209,1
2020-03-08,Switzerland,CH,55,0,8516543,264,1
2020-03-09,Switzerland,CH,68,1,8516543,332,2
2020-03-10,Switzerland,CH,42,0,8516543,374,2
2020-03-11,Switzerland,CH,116,1,8516543,490,3
2020-03-12,Switzerland,CH,152,1,8516543,642,4
2020-03-13,Switzerland,CH,212,0,8516543,854,4
2020-03-14,Switzerland,CH,267,3,8516543,1121,7
2020-03-15,Switzerland,CH,238,4,8516543,1359,11
2020-03-16,Switzerland,CH,841,2,8516543,2200,13
2020-03-17,Switzerland,CH,0,1,8516543,2200,14
2020-03-18,Switzerland,CH,450,5,8516543,2650,19
2020-03-19,Switzerland,CH,360,2,8516543,3010,21
2020-03-20,Switzerland,CH,878,12,8516543,3888,33
2020-03-21,Switzerland,CH,952,10,8516543,4840,43
2020-03-22,Switzerland,CH,1237,13,8516543,6077,56
2020-03-23,Switzerland,CH,894,4,8516543,6971,60
2020-03-24,Switzerland,CH,1044,6,8516543,8015,66
2020-03-25,Switzerland,CH,774,20,8516543,8789,86
2020-03-26,Switzerland,CH,925,17,8516543,9714,103
2020-03-27,Switzerland,CH,1000,58,8516543,10714,161
2020-03-28,Switzerland,CH,1390,36,8516543,12104,197
2020-03-29,Switzerland,CH,1048,38,8516543,13152,235
2020-03-30,Switzerland,CH,1122,22,8516543,14274,257
2020-03-31,Switzerland,CH,1138,38,8516543,15412,295
2020-04-01,Switzerland,CH,696,78,8516543,16108,373
2020-04-02,Switzerland,CH,962,5,8516543,17070,378
2020-04-03,Switzerland,CH,1124,54,8516543,18194,432
2020-04-04,Switzerland,CH,1033,52,8516543,19227,484
2020-04-05,Switzerland,CH,974,56,8516543,20201,540
2020-04-06,Switzerland,CH,821,19,8516543,21022,559
2020-04-07,Switzerland,CH,552,25,8516543,21574,584
2020-04-08,Switzerland,CH,590,57,8516543,22164,641
2020-04-09,Switzerland,CH,546,64,8516543,22710,705
2020-04-10,Switzerland,CH,785,51,8516543,23495,756
2020-04-11,Switzerland,CH,733,49,8516543,24228,805
2020-04-12,Switzerland,CH,592,26,8516543,24820,831
2020-04-13,Switzerland,CH,400,27,8516543,25220,858
2020-04-14,Switzerland,CH,279,0,8516543,25499,858
2020-04-15,Switzerland,CH,254,42,8516543,25753,900
2020-04-16,Switzerland,CH,583,73,8516543,26336,973
2020-04-17,Switzerland,CH,315,43,8516543,26651,1016
2020-04-18,Switzerland,CH,346,42,8516543,26997,1058
2020-04-19,Switzerland,CH,325,52,8516543,27322,1110
2020-04-20,Switzerland,CH,336,24,8516543,27658,1134
2020-04-21,Switzerland,CH,168,7,8516543,27826,1141
2020-04-22,Switzerland,CH,155,45,8516543,27981,1186
2020-04-23,Switzerland,CH,205,30,8516543,28186,1216
2020-04-24,Switzerland,CH,228,51,8516543,28414,1267
2020-04-25,Switzerland,CH,181,41,8516543,28595,1308
2020-04-26,Switzerland,CH,216,20,8516543,28811,1328
2020-04-27,Switzerland,CH,167,8,8516543,28978,1336
2020-04-28,Switzerland,CH,103,16,8516543,29081,1352
2020-04-29,Switzerland,CH,100,27,8516543,29181,1379
2020-04-30,Switzerland,CH,143,28,8516543,29324,1407
2020-05-01,Switzerland,CH,179,15,8516543,29503,1422
2020-05-02,Switzerland,CH,119,12,8516543,29622,1434
2020-05-03,Switzerland,CH,112,32,8516543,29734,1466
2020-03-12,Cote_dIvoire,CI,1,0,25069229,1,0
2020-03-15,Cote_dIvoire,CI,3,0,25069229,4,0
2020-03-16,Cote_dIvoire,CI,0,0,25069229,4,0
2020-03-17,Cote_dIvoire,CI,1,0,25069229,5,0
2020-03-18,Cote_dIvoire,CI,0,0,25069229,5,0
2020-03-19,Cote_dIvoire,CI,1,0,25069229,6,0
2020-03-20,Cote_dIvoire,CI,3,0,25069229,9,0
2020-03-21,Cote_dIvoire,CI,5,0,25069229,14,0
2020-03-22,Cote_dIvoire,CI,3,0,25069229,17,0
2020-03-23,Cote_dIvoire,CI,8,0,25069229,25,0
2020-03-24,Cote_dIvoire,CI,0,0,25069229,25,0
2020-03-25,Cote_dIvoire,CI,48,0,25069229,73,0
2020-03-26,Cote_dIvoire,CI,7,0,25069229,80,0
2020-03-27,Cote_dIvoire,CI,16,0,25069229,96,0
2020-03-28,Cote_dIvoire,CI,5,0,25069229,101,0
2020-03-29,Cote_dIvoire,CI,39,0,25069229,140,0
2020-03-30,Cote_dIvoire,CI,25,1,25069229,165,1
2020-03-31,Cote_dIvoire,CI,3,0,25069229,168,1
2020-04-01,Cote_dIvoire,CI,0,0,25069229,168,1
2020-04-02,Cote_dIvoire,CI,22,0,25069229,190,1
2020-04-03,Cote_dIvoire,CI,4,0,25069229,194,1
2020-04-04,Cote_dIvoire,CI,24,0,25069229,218,1
2020-04-05,Cote_dIvoire,CI,27,1,25069229,245,2
2020-04-06,Cote_dIvoire,CI,16,1,25069229,261,3
2020-04-07,Cote_dIvoire,CI,62,0,25069229,323,3
2020-04-08,Cote_dIvoire,CI,26,0,25069229,349,3
2020-04-09,Cote_dIvoire,CI,35,0,25069229,384,3
2020-04-10,Cote_dIvoire,CI,60,0,25069229,444,3
2020-04-11,Cote_dIvoire,CI,36,0,25069229,480,3
2020-04-12,Cote_dIvoire,CI,53,1,25069229,533,4
2020-04-13,Cote_dIvoire,CI,41,1,25069229,574,5
2020-04-14,Cote_dIvoire,CI,52,1,25069229,626,6
2020-04-15,Cote_dIvoire,CI,0,0,25069229,626,6
2020-04-16,Cote_dIvoire,CI,28,0,25069229,654,6
2020-04-17,Cote_dIvoire,CI,34,0,25069229,688,6
2020-04-18,Cote_dIvoire,CI,54,0,25069229,742,6
2020-04-19,Cote_dIvoire,CI,59,2,25069229,801,8
2020-04-20,Cote_dIvoire,CI,46,1,25069229,847,9
2020-04-21,Cote_dIvoire,CI,32,1,25069229,879,10
2020-04-22,Cote_dIvoire,CI,37,3,25069229,916,13
2020-04-23,Cote_dIvoire,CI,36,1,25069229,952,14
2020-04-24,Cote_dIvoire,CI,52,0,25069229,1004,14
2020-04-25,Cote_dIvoire,CI,73,0,25069229,1077,14
2020-04-26,Cote_dIvoire,CI,34,0,25069229,1111,14
2020-04-27,Cote_dIvoire,CI,39,0,25069229,1150,14
2020-04-28,Cote_dIvoire,CI,14,0,25069229,1164,14
2020-04-29,Cote_dIvoire,CI,19,0,25069229,1183,14
2020-04-30,Cote_dIvoire,CI,55,0,25069229,1238,14
2020-05-01,Cote_dIvoire,CI,37,0,25069229,1275,14
2020-05-02,Cote_dIvoire,CI,58,1,25069229,1333,15
2020-05-03,Cote_dIvoire,CI,29,0,25069229,1362,15
2020-03-04,Chile,CL,1,0,18729160,1,0
2020-03-05,Chile,CL,2,0,18729160,3,0
2020-03-06,Chile,CL,1,0,18729160,4,0
2020-03-07,Chile,CL,1,0,18729160,5,0
2020-03-09,Chile,CL,5,0,18729160,10,0
2020-03-10,Chile,CL,3,0,18729160,13,0
2020-03-11,Chile,CL,4,0,18729160,17,0
2020-03-12,Chile,CL,6,0,18729160,23,0
2020-03-13,Chile,CL,10,0,18729160,33,0
2020-03-14,Chile,CL,10,0,18729160,43,0
2020-03-15,Chile,CL,18,0,18729160,61,0
2020-03-16,Chile,CL,14,0,18729160,75,0
2020-03-17,Chile,CL,81,0,18729160,156,0
2020-03-18,Chile,CL,45,0,18729160,201,0
2020-03-19,Chile,CL,37,0,18729160,238,0
2020-03-20,Chile,CL,104,0,18729160,342,0
2020-03-21,Chile,CL,92,0,18729160,434,0
2020-03-22,Chile,CL,103,0,18729160,537,0
2020-03-23,Chile,CL,95,1,18729160,632,1
2020-03-24,Chile,CL,114,1,18729160,746,2
2020-03-25,Chile,CL,176,0,18729160,922,2
2020-03-26,Chile,CL,220,1,18729160,1142,3
2020-03-27,Chile,CL,164,1,18729160,1306,4
2020-03-28,Chile,CL,304,1,18729160,1610,5
2020-03-29,Chile,CL,299,1,18729160,1909,6
2020-03-30,Chile,CL,230,1,18729160,2139,7
2020-03-31,Chile,CL,310,1,18729160,2449,8
2020-04-01,Chile,CL,289,4,18729160,2738,12
2020-04-02,Chile,CL,293,4,18729160,3031,16
2020-04-03,Chile,CL,373,2,18729160,3404,18
2020-04-04,Chile,CL,333,4,18729160,3737,22
2020-04-05,Chile,CL,424,5,18729160,4161,27
2020-04-06,Chile,CL,310,7,18729160,4471,34
2020-04-07,Chile,CL,344,3,18729160,4815,37
2020-04-08,Chile,CL,301,6,18729160,5116,43
2020-04-09,Chile,CL,430,5,18729160,5546,48
2020-04-10,Chile,CL,426,9,18729160,5972,57
2020-04-11,Chile,CL,529,8,18729160,6501,65
2020-04-12,Chile,CL,426,8,18729160,6927,73
2020-04-13,Chile,CL,286,7,18729160,7213,80
2020-04-14,Chile,CL,312,2,18729160,7525,82
2020-04-15,Chile,CL,392,10,18729160,7917,92
2020-04-16,Chile,CL,356,2,18729160,8273,94
2020-04-17,Chile,CL,534,11,18729160,8807,105
2020-04-18,Chile,CL,445,11,18729160,9252,116
2020-04-19,Chile,CL,478,10,18729160,9730,126
2020-04-20,Chile,CL,358,7,18729160,10088,133
2020-04-21,Chile,CL,419,6,18729160,10507,139
2020-04-22,Chile,CL,325,8,18729160,10832,147
2020-04-23,Chile,CL,464,13,18729160,11296,160
2020-04-24,Chile,CL,516,8,18729160,11812,168
2020-04-25,Chile,CL,494,6,18729160,12306,174
2020-04-26,Chile,CL,552,7,18729160,12858,181
2020-04-27,Chile,CL,473,8,18729160,13331,189
2020-04-28,Chile,CL,482,9,18729160,13813,198
2020-04-29,Chile,CL,552,9,18729160,14365,207
2020-04-30,Chile,CL,520,9,18729160,14885,216
2020-05-01,Chile,CL,1138,11,18729160,16023,227
2020-05-02,Chile,CL,985,7,18729160,17008,234
2020-05-03,Chile,CL,1427,13,18729160,18435,247
2020-03-07,Cameroon,CM,1,0,25216237,1,0
2020-03-09,Cameroon,CM,1,0,25216237,2,0
2020-03-15,Cameroon,CM,1,0,25216237,3,0
2020-03-16,Cameroon,CM,1,0,25216237,4,0
2020-03-17,Cameroon,CM,0,0,25216237,4,0
2020-03-18,Cameroon,CM,6,0,25216237,10,0
2020-03-19,Cameroon,CM,0,0,25216237,10,0
2020-03-20,Cameroon,CM,4,0,25216237,14,0
2020-03-21,Cameroon,CM,13,0,25216237,27,0
2020-03-22,Cameroon,CM,0,0,25216237,27,0
2020-03-23,Cameroon,CM,0,0,25216237,27,0
2020-03-24,Cameroon,CM,29,0,25216237,56,0
2020-03-25,Cameroon,CM,16,1,25216237,72,1
2020-03-26,Cameroon,CM,0,0,25216237,72,1
2020-03-27,Cameroon,CM,16,0,25216237,88,1
2020-03-28,Cameroon,CM,0,0,25216237,88,1
2020-03-29,Cameroon,CM,11,1,25216237,99,2
2020-03-30,Cameroon,CM,0,0,25216237,99,2
2020-03-31,Cameroon,CM,43,0,25216237,142,2
2020-04-01,Cameroon,CM,51,4,25216237,193,6
2020-04-02,Cameroon,CM,40,0,25216237,233,6
2020-04-03,Cameroon,CM,38,1,25216237,271,7
2020-04-04,Cameroon,CM,238,1,25216237,509,8
2020-04-05,Cameroon,CM,46,1,25216237,555,9
2020-04-06,Cameroon,CM,95,0,25216237,650,9
2020-04-07,Cameroon,CM,8,0,25216237,658,9
2020-04-08,Cameroon,CM,27,0,25216237,685,9
2020-04-09,Cameroon,CM,45,1,25216237,730,10
2020-04-10,Cameroon,CM,0,0,25216237,730,10
2020-04-11,Cameroon,CM,73,0,25216237,803,10
2020-04-12,Cameroon,CM,17,1,25216237,820,11
2020-04-13,Cameroon,CM,0,1,25216237,820,12
2020-04-14,Cameroon,CM,0,0,25216237,820,12
2020-04-15,Cameroon,CM,35,5,25216237,855,17
2020-04-16,Cameroon,CM,0,0,25216237,855,17
2020-04-17,Cameroon,CM,0,4,25216237,855,21
2020-04-18,Cameroon,CM,161,0,25216237,1016,21
2020-04-19,Cameroon,CM,0,0,25216237,1016,21
2020-04-20,Cameroon,CM,0,21,25216237,1016,42
2020-04-21,Cameroon,CM,1,0,25216237,1017,42
2020-04-22,Cameroon,CM,146,0,25216237,1163,42
2020-04-23,Cameroon,CM,0,1,25216237,1163,43
2020-04-24,Cameroon,CM,238,6,25216237,1401,49
2020-04-25,Cameroon,CM,2,0,25216237,1403,49
2020-04-26,Cameroon,CM,115,4,25216237,1518,53
2020-04-27,Cameroon,CM,103,3,25216237,1621,56
2020-04-28,Cameroon,CM,0,2,25216237,1621,58
2020-04-29,Cameroon,CM,185,1,25216237,1806,59
2020-04-30,Cameroon,CM,26,2,25216237,1832,61
2020-05-01,Cameroon,CM,0,0,25216237,1832,61
2020-05-02,Cameroon,CM,237,0,25216237,2069,61
2020-05-03,Cameroon,CM,8,3,25216237,2077,64
2019-12-31,China,CN,27,0,1392730000,27,0
2020-01-01,China,CN,0,0,1392730000,27,0
2020-01-02,China,CN,0,0,1392730000,27,0
2020-01-03,China,CN,17,0,1392730000,44,0
2020-01-04,China,CN,0,0,1392730000,44,0
2020-01-05,China,CN,15,0,1392730000,59,0
2020-01-06,China,CN,0,0,1392730000,59,0
2020-01-07,China,CN,0,0,1392730000,59,0
2020-01-08,China,CN,0,0,1392730000,59,0
2020-01-09,China,CN,0,0,1392730000,59,0
2020-01-10,China,CN,0,0,1392730000,59,0
2020-01-11,China,CN,0,1,1392730000,59,1
2020-01-12,China,CN,0,0,1392730000,59,1
2020-01-13,China,CN,0,0,1392730000,59,1
2020-01-14,China,CN,0,0,1392730000,59,1
2020-01-15,China,CN,0,1,1392730000,59,2
2020-01-16,China,CN,0,0,1392730000,59,2
2020-01-17,China,CN,4,0,1392730000,63,2
2020-01-18,China,CN,17,0,1392730000,80,2
2020-01-19,China,CN,136,1,1392730000,216,3
2020-01-20,China,CN,19,0,1392730000,235,3
2020-01-21,China,CN,151,3,1392730000,386,6
2020-01-22,China,CN,140,11,1392730000,526,17
2020-01-23,China,CN,97,0,1392730000,623,17
2020-01-24,China,CN,259,9,1392730000,882,26
2020-01-25,China,CN,441,15,1392730000,1323,41
2020-01-26,China,CN,665,15,1392730000,1988,56
2020-01-27,China,CN,787,25,1392730000,2775,81
2020-01-28,China,CN,1753,25,1392730000,4528,106
2020-01-29,China,CN,1466,26,1392730000,5994,132
2020-01-30,China,CN,1740,38,1392730000,7734,170
2020-01-31,China,CN,1980,43,1392730000,9714,213
2020-02-01,China,CN,2095,46,1392730000,11809,259
2020-02-02,China,CN,2590,45,1392730000,14399,304
2020-02-03,China,CN,2812,57,1392730000,17211,361
2020-02-04,China,CN,3237,65,1392730000,20448,426
2020-02-05,China,CN,3872,66,1392730000,24320,492
2020-02-06,China,CN,3727,72,1392730000,28047,564
2020-02-07,China,CN,3160,73,1392730000,31207,637
2020-02-08,China,CN,3418,86,1392730000,34625,723
2020-02-09,China,CN,2607,89,1392730000,37232,812
2020-02-10,China,CN,2974,97,1392730000,40206,909
2020-02-11,China,CN,2490,108,1392730000,42696,1017
2020-02-12,China,CN,2028,97,1392730000,44724,1114
2020-02-13,China,CN,15141,254,1392730000,59865,1368
2020-02-14,China,CN,4156,13,1392730000,64021,1381
2020-02-15,China,CN,2538,143,1392730000,66559,1524
2020-02-16,China,CN,2007,142,1392730000,68566,1666
2020-02-17,China,CN,2052,105,1392730000,70618,1771
2020-02-18,China,CN,1890,98,1392730000,72508,1869
2020-02-19,China,CN,1750,139,1392730000,74258,2008
2020-02-20,China,CN,394,112,1392730000,74652,2120
2020-02-21,China,CN,891,118,1392730000,75543,2238
2020-02-22,China,CN,826,109,1392730000,76369,2347
2020-02-23,China,CN,647,98,1392730000,77016,2445
2020-02-24,China,CN,218,150,1392730000,77234,2595
2020-02-25,China,CN,515,70,1392730000,77749,2665
2020-02-26,China,CN,410,52,1392730000,78159,2717
2020-02-27,China,CN,439,29,1392730000,78598,2746
2020-02-28,China,CN,329,44,1392730000,78927,2790
2020-02-29,China,CN,428,47,1392730000,79355,2837
2020-03-01,China,CN,574,35,1392730000,79929,2872
2020-03-02,China,CN,205,42,1392730000,80134,2914
2020-03-03,China,CN,127,32,1392730000,80261,2946
2020-03-04,China,CN,119,37,1392730000,80380,2983
2020-03-05,China,CN,117,31,1392730000,80497,3014
2020-03-06,China,CN,170,30,1392730000,80667,3044
2020-03-07,China,CN,101,28,1392730000,80768,3072
2020-03-08,China,CN,46,27,1392730000,80814,3099
2020-03-09,China,CN,45,23,1392730000,80859,3122
2020-03-10,China,CN,20,17,1392730000,80879,3139
2020-03-11,China,CN,29,22,1392730000,80908,3161
2020-03-12,China,CN,24,11,1392730000,80932,3172
2020-03-13,China,CN,22,7,1392730000,80954,3179
2020-03-14,China,CN,19,15,1392730000,80973,3194
2020-03-15,China,CN,22,9,1392730000,80995,3203
2020-03-16,China,CN,25,13,1392730000,81020,3216
2020-03-17,China,CN,43,9,1392730000,81063,3225
2020-03-18,China,CN,23,16,1392730000,81086,3241
2020-03-19,China,CN,44,8,1392730000,81130,3249
2020-03-20,China,CN,99,4,1392730000,81229,3253
2020-03-21,China,CN,52,6,1392730000,81281,3259
2020-03-22,China,CN,65,6,1392730000,81346,3265
2020-03-23,China,CN,138,9,1392730000,81484,3274
2020-03-24,China,CN,69,7,1392730000,81553,3281
2020-03-25,China,CN,78,4,1392730000,81631,3285
2020-03-26,China,CN,102,6,1392730000,81733,3291
2020-03-27,China,CN,94,5,1392730000,81827,3296
2020-03-28,China,CN,119,3,1392730000,81946,3299
2020-03-29,China,CN,113,5,1392730000,82059,3304
2020-03-30,China,CN,98,2,1392730000,82157,3306
2020-03-31,China,CN,84,3,1392730000,82241,3309
2020-04-01,China,CN,54,1,1392730000,82295,3310
2020-04-02,China,CN,100,6,1392730000,82395,3316
2020-04-03,China,CN,70,10,1392730000,82465,3326
2020-04-04,China,CN,62,4,1392730000,82527,3330
2020-04-05,China,CN,48,3,1392730000,82575,3333
2020-04-06,China,CN,67,2,1392730000,82642,3335
2020-04-07,China,CN,56,0,1392730000,82698,3335
2020-04-08,China,CN,86,2,1392730000,82784,3337
2020-04-09,China,CN,86,2,1392730000,82870,3339
2020-04-10,China,CN,55,1,1392730000,82925,3340
2020-04-11,China,CN,79,3,1392730000,83004,3343
2020-04-12,China,CN,93,0,1392730000,83097,3343
2020-04-13,China,CN,112,2,1392730000,83209,3345
2020-04-14,China,CN,94,0,1392730000,83303,3345
2020-04-15,China,CN,49,1,1392730000,83352,3346
2020-04-16,China,CN,50,0,1392730000,83402,3346
2020-04-17,China,CN,352,1290,1392730000,83754,4636
2020-04-18,China,CN,31,0,1392730000,83785,4636
2020-04-19,China,CN,18,0,1392730000,83803,4636
2020-04-20,China,CN,14,0,1392730000,83817,4636
2020-04-21,China,CN,32,0,1392730000,83849,4636
2020-04-22,China,CN,15,0,1392730000,83864,4636
2020-04-23,China,CN,12,0,1392730000,83876,4636
2020-04-24,China,CN,8,0,1392730000,83884,4636
2020-04-25,China,CN,15,0,1392730000,83899,4636
2020-04-26,China,CN,10,0,1392730000,83909,4636
2020-04-27,China,CN,3,1,1392730000,83912,4637
2020-04-28,China,CN,26,0,1392730000,83938,4637
2020-04-29,China,CN,2,0,1392730000,83940,4637
2020-04-30,China,CN,4,0,1392730000,83944,4637
2020-05-01,China,CN,12,0,1392730000,83956,4637
2020-05-02,China,CN,3,0,1392730000,83959,4637
2020-05-03,China,CN,2,0,1392730000,83961,4637
2020-03-07,Colombia,CO,1,0,49648685,1,0
2020-03-10,Colombia,CO,2,0,49648685,3,0
2020-03-12,Colombia,CO,6,0,49648685,9,0
2020-03-14,Colombia,CO,7,0,49648685,16,0
2020-03-15,Colombia,CO,18,0,49648685,34,0
2020-03-16,Colombia,CO,11,0,49648685,45,0
2020-03-17,Colombia,CO,12,0,49648685,57,0
2020-03-18,Colombia,CO,8,0,49648685,65,0
2020-03-19,Colombia,CO,37,0,49648685,102,0
2020-03-20,Colombia,CO,26,0,49648685,128,0
2020-03-21,Colombia,CO,30,0,49648685,158,0
2020-03-22,Colombia,CO,52,1,49648685,210,1
2020-03-23,Colombia,CO,25,1,49648685,235,2
2020-03-24,Colombia,CO,71,1,49648685,306,3
2020-03-25,Colombia,CO,72,0,49648685,378,3
2020-03-26,Colombia,CO,92,1,49648685,470,4
2020-03-27,Colombia,CO,21,2,49648685,491,6
2020-03-28,Colombia,CO,48,0,49648685,539,6
2020-03-29,Colombia,CO,69,0,49648685,608,6
2020-03-30,Colombia,CO,94,4,49648685,702,10
2020-03-31,Colombia,CO,96,4,49648685,798,14
2020-04-01,Colombia,CO,108,2,49648685,906,16
2020-04-02,Colombia,CO,159,1,49648685,1065,17
2020-04-03,Colombia,CO,96,2,49648685,1161,19
2020-04-04,Colombia,CO,106,6,49648685,1267,25
2020-04-05,Colombia,CO,139,7,49648685,1406,32
2020-04-06,Colombia,CO,79,3,49648685,1485,35
2020-04-07,Colombia,CO,94,11,49648685,1579,46
2020-04-08,Colombia,CO,201,4,49648685,1780,50
2020-04-09,Colombia,CO,274,5,49648685,2054,55
2020-04-10,Colombia,CO,169,14,49648685,2223,69
2020-04-11,Colombia,CO,250,11,49648685,2473,80
2020-04-12,Colombia,CO,236,20,49648685,2709,100
2020-04-13,Colombia,CO,67,9,49648685,2776,109
2020-04-14,Colombia,CO,76,3,49648685,2852,112
2020-04-15,Colombia,CO,127,15,49648685,2979,127
2020-04-16,Colombia,CO,126,4,49648685,3105,131
2020-04-17,Colombia,CO,128,13,49648685,3233,144
2020-04-18,Colombia,CO,206,9,49648685,3439,153
2020-04-19,Colombia,CO,182,13,49648685,3621,166
2020-04-20,Colombia,CO,171,13,49648685,3792,179
2020-04-21,Colombia,CO,185,10,49648685,3977,189
2020-04-22,Colombia,CO,172,7,49648685,4149,196
2020-04-23,Colombia,CO,207,10,49648685,4356,206
2020-04-24,Colombia,CO,205,9,49648685,4561,215
2020-04-25,Colombia,CO,320,10,49648685,4881,225
2020-04-26,Colombia,CO,261,8,49648685,5142,233
2020-04-27,Colombia,CO,237,10,49648685,5379,243
2020-04-28,Colombia,CO,218,10,49648685,5597,253
2020-04-29,Colombia,CO,352,16,49648685,5949,269
2020-04-30,Colombia,CO,262,9,49648685,6211,278
2020-05-01,Colombia,CO,296,15,49648685,6507,293
2020-05-02,Colombia,CO,499,21,49648685,7006,314
2020-05-03,Colombia,CO,279,10,49648685,7285,324
2020-03-07,Costa_Rica,CR,1,0,4999441,1,0
2020-03-09,Costa_Rica,CR,4,0,4999441,5,0
2020-03-10,Costa_Rica,CR,4,0,4999441,9,0
2020-03-11,Costa_Rica,CR,4,0,4999441,13,0
2020-03-12,Costa_Rica,CR,9,0,4999441,22,0
2020-03-13,Costa_Rica,CR,1,0,4999441,23,0
2020-03-14,Costa_Rica,CR,3,0,4999441,26,0
2020-03-15,Costa_Rica,CR,1,0,4999441,27,0
2020-03-16,Costa_Rica,CR,8,0,4999441,35,0
2020-03-17,Costa_Rica,CR,6,0,4999441,41,0
2020-03-18,Costa_Rica,CR,9,0,4999441,50,0
2020-03-19,Costa_Rica,CR,19,1,4999441,69,1
2020-03-20,Costa_Rica,CR,18,0,4999441,87,1
2020-03-21,Costa_Rica,CR,26,1,4999441,113,2
2020-03-22,Costa_Rica,CR,4,0,4999441,117,2
2020-03-23,Costa_Rica,CR,17,0,4999441,134,2
2020-03-24,Costa_Rica,CR,24,0,4999441,158,2
2020-03-25,Costa_Rica,CR,19,0,4999441,177,2
2020-03-26,Costa_Rica,CR,24,0,4999441,201,2
2020-03-27,Costa_Rica,CR,30,0,4999441,231,2
2020-03-28,Costa_Rica,CR,32,0,4999441,263,2
2020-03-29,Costa_Rica,CR,32,0,4999441,295,2
2020-03-30,Costa_Rica,CR,19,0,4999441,314,2
2020-03-31,Costa_Rica,CR,16,0,4999441,330,2
2020-04-01,Costa_Rica,CR,17,0,4999441,347,2
2020-04-02,Costa_Rica,CR,28,0,4999441,375,2
2020-04-03,Costa_Rica,CR,21,0,4999441,396,2
2020-04-04,Costa_Rica,CR,20,0,4999441,416,2
2020-04-05,Costa_Rica,CR,19,0,4999441,435,2
2020-04-06,Costa_Rica,CR,19,0,4999441,454,2
2020-04-07,Costa_Rica,CR,13,0,4999441,467,2
2020-04-08,Costa_Rica,CR,16,0,4999441,483,2
2020-04-09,Costa_Rica,CR,19,0,4999441,502,2
2020-04-10,Costa_Rica,CR,37,1,4999441,539,3
2020-04-11,Costa_Rica,CR,19,0,4999441,558,3
2020-04-12,Costa_Rica,CR,19,0,4999441,577,3
2020-04-13,Costa_Rica,CR,18,0,4999441,595,3
2020-04-14,Costa_Rica,CR,17,0,4999441,612,3
2020-04-15,Costa_Rica,CR,6,0,4999441,618,3
2020-04-16,Costa_Rica,CR,8,1,4999441,626,4
2020-04-17,Costa_Rica,CR,16,0,4999441,642,4
2020-04-18,Costa_Rica,CR,7,0,4999441,649,4
2020-04-19,Costa_Rica,CR,6,0,4999441,655,4
2020-04-20,Costa_Rica,CR,5,0,4999441,660,4
2020-04-21,Costa_Rica,CR,2,2,4999441,662,6
2020-04-22,Costa_Rica,CR,7,0,4999441,669,6
2020-04-23,Costa_Rica,CR,12,0,4999441,681,6
2020-04-24,Costa_Rica,CR,6,0,4999441,687,6
2020-04-25,Costa_Rica,CR,0,0,4999441,687,6
2020-04-26,Costa_Rica,CR,6,0,4999441,693,6
2020-04-27,Costa_Rica,CR,2,0,4999441,695,6
2020-04-28,Costa_Rica,CR,2,0,4999441,697,6
2020-04-29,Costa_Rica,CR,8,0,4999441,705,6
2020-04-30,Costa_Rica,CR,8,0,4999441,713,6
2020-05-01,Costa_Rica,CR,6,0,4999441,719,6
2020-05-02,Costa_Rica,CR,6,0,4999441,725,6
2020-05-03,Costa_Rica,CR,8,0,4999441,733,6
2020-03-12,Cuba,CU,3,0,11338138,3,0
2020-03-14,Cuba,CU,1,0,11338138,4,0
2020-03-15,Cuba,CU,0,0,11338138,4,0
2020-03-18,Cuba,CU,3,0,11338138,7,0
2020-03-19,Cuba,CU,4,1,11338138,11,1
2020-03-20,Cuba,CU,5,0,11338138,16,1
2020-03-21,Cuba,CU,5,0,11338138,21,1
2020-03-22,Cuba,CU,4,0,11338138,25,1
2020-03-23,Cuba,CU,10,0,11338138,35,1
2020-03-24,Cuba,CU,5,0,11338138,40,1
2020-03-25,Cuba,CU,8,0,11338138,48,1
2020-03-26,Cuba,CU,9,0,11338138,57,1
2020-03-27,Cuba,CU,10,1,11338138,67,2
2020-03-28,Cuba,CU,13,0,11338138,80,2
2020-03-29,Cuba,CU,39,1,11338138,119,3
2020-03-30,Cuba,CU,20,0,11338138,139,3
2020-03-31,Cuba,CU,31,1,11338138,170,4
2020-04-01,Cuba,CU,16,2,11338138,186,6
2020-04-02,Cuba,CU,26,0,11338138,212,6
2020-04-03,Cuba,CU,21,0,11338138,233,6
2020-04-04,Cuba,CU,36,0,11338138,269,6
2020-04-05,Cuba,CU,19,0,11338138,288,6
2020-04-06,Cuba,CU,32,2,11338138,320,8
2020-04-07,Cuba,CU,30,1,11338138,350,9
2020-04-08,Cuba,CU,46,2,11338138,396,11
2020-04-09,Cuba,CU,61,1,11338138,457,12
2020-04-10,Cuba,CU,58,3,11338138,515,15
2020-04-11,Cuba,CU,49,0,11338138,564,15
2020-04-12,Cuba,CU,56,1,11338138,620,16
2020-04-13,Cuba,CU,49,2,11338138,669,18
2020-04-14,Cuba,CU,57,3,11338138,726,21
2020-04-15,Cuba,CU,40,0,11338138,766,21
2020-04-16,Cuba,CU,48,3,11338138,814,24
2020-04-17,Cuba,CU,48,3,11338138,862,27
2020-04-18,Cuba,CU,61,4,11338138,923,31
2020-04-19,Cuba,CU,63,1,11338138,986,32
2020-04-20,Cuba,CU,49,2,11338138,1035,34
2020-04-21,Cuba,CU,52,2,11338138,1087,36
2020-04-22,Cuba,CU,50,2,11338138,1137,38
2020-04-23,Cuba,CU,52,2,11338138,1189,40
2020-04-24,Cuba,CU,46,3,11338138,1235,43
2020-04-25,Cuba,CU,50,6,11338138,1285,49
2020-04-26,Cuba,CU,52,2,11338138,1337,51
2020-04-27,Cuba,CU,32,3,11338138,1369,54
2020-04-28,Cuba,CU,20,2,11338138,1389,56
2020-04-29,Cuba,CU,48,2,11338138,1437,58
2020-04-30,Cuba,CU,30,0,11338138,1467,58
2020-05-01,Cuba,CU,34,3,11338138,1501,61
2020-05-02,Cuba,CU,36,3,11338138,1537,64
2020-05-03,Cuba,CU,74,2,11338138,1611,66
2020-03-21,Cape_Verde,CV,2,0,543767,2,0
2020-03-22,Cape_Verde,CV,1,0,543767,3,0
2020-03-23,Cape_Verde,CV,0,0,543767,3,0
2020-03-24,Cape_Verde,CV,0,0,543767,3,0
2020-03-25,Cape_Verde,CV,0,1,543767,3,1
2020-03-26,Cape_Verde,CV,1,0,543767,4,1
2020-03-27,Cape_Verde,CV,1,0,543767,5,1
2020-03-28,Cape_Verde,CV,0,0,543767,5,1
2020-03-29,Cape_Verde,CV,0,0,543767,5,1
2020-03-30,Cape_Verde,CV,0,0,543767,5,1
2020-03-31,Cape_Verde,CV,0,0,543767,5,1
2020-04-01,Cape_Verde,CV,1,0,543767,6,1
2020-04-02,Cape_Verde,CV,0,0,543767,6,1
2020-04-03,Cape_Verde,CV,0,0,543767,6,1
2020-04-04,Cape_Verde,CV,0,0,543767,6,1
2020-04-05,Cape_Verde,CV,1,0,543767,7,1
2020-04-06,Cape_Verde,CV,0,0,543767,7,1
2020-04-07,Cape_Verde,CV,0,0,543767,7,1
2020-04-08,Cape_Verde,CV,0,0,543767,7,1
2020-04-09,Cape_Verde,CV,0,0,543767,7,1
2020-04-10,Cape_Verde,CV,0,0,543767,7,1
2020-04-11,Cape_Verde,CV,0,0,543767,7,1
2020-04-12,Cape_Verde,CV,1,0,543767,8,1
2020-04-13,Cape_Verde,CV,2,0,543767,10,1
2020-04-14,Cape_Verde,CV,0,0,543767,10,1
2020-04-15,Cape_Verde,CV,1,0,543767,11,1
2020-04-16,Cape_Verde,CV,44,0,543767,55,1
2020-04-17,Cape_Verde,CV,0,0,543767,55,1
2020-04-18,Cape_Verde,CV,1,0,543767,56,1
2020-04-19,Cape_Verde,CV,2,0,543767,58,1
2020-04-20,Cape_Verde,CV,3,0,543767,61,1
2020-04-21,Cape_Verde,CV,6,0,543767,67,1
2020-04-22,Cape_Verde,CV,0,0,543767,67,1
2020-04-23,Cape_Verde,CV,6,0,543767,73,1
2020-04-24,Cape_Verde,CV,9,0,543767,82,1
2020-04-25,Cape_Verde,CV,6,0,543767,88,1
2020-04-26,Cape_Verde,CV,2,0,543767,90,1
2020-04-27,Cape_Verde,CV,16,0,543767,106,1
2020-04-28,Cape_Verde,CV,3,0,543767,109,1
2020-04-29,Cape_Verde,CV,4,0,543767,113,1
2020-04-30,Cape_Verde,CV,0,0,543767,113,1
2020-05-01,Cape_Verde,CV,8,0,543767,121,1
2020-05-02,Cape_Verde,CV,2,1,543767,123,2
2020-05-03,Cape_Verde,CV,29,0,543767,152,2
2020-03-13,CuraÃ§ao,CW,1,0,159849,1,0
2020-03-20,CuraÃ§ao,CW,2,0,159849,3,0
2020-03-24,CuraÃ§ao,CW,3,0,159849,6,0
2020-03-26,CuraÃ§ao,CW,0,1,159849,6,1
2020-03-27,CuraÃ§ao,CW,1,0,159849,7,1
2020-03-28,CuraÃ§ao,CW,1,0,159849,8,1
2020-03-29,CuraÃ§ao,CW,0,0,159849,8,1
2020-03-30,CuraÃ§ao,CW,1,0,159849,9,1
2020-04-01,CuraÃ§ao,CW,2,0,159849,11,1
2020-04-02,CuraÃ§ao,CW,0,0,159849,11,1
2020-04-03,CuraÃ§ao,CW,0,0,159849,11,1
2020-04-04,CuraÃ§ao,CW,0,0,159849,11,1
2020-04-05,CuraÃ§ao,CW,0,0,159849,11,1
2020-04-06,CuraÃ§ao,CW,0,0,159849,11,1
2020-04-07,CuraÃ§ao,CW,2,0,159849,13,1
2020-04-08,CuraÃ§ao,CW,0,0,159849,13,1
2020-04-09,CuraÃ§ao,CW,1,0,159849,14,1
2020-04-10,CuraÃ§ao,CW,0,0,159849,14,1
2020-04-11,CuraÃ§ao,CW,0,0,159849,14,1
2020-04-12,CuraÃ§ao,CW,0,0,159849,14,1
2020-04-13,CuraÃ§ao,CW,0,0,159849,14,1
2020-04-14,CuraÃ§ao,CW,0,0,159849,14,1
2020-04-15,CuraÃ§ao,CW,0,0,159849,14,1
2020-04-16,CuraÃ§ao,CW,0,0,159849,14,1
2020-04-17,CuraÃ§ao,CW,0,0,159849,14,1
2020-04-18,CuraÃ§ao,CW,0,0,159849,14,1
2020-04-19,CuraÃ§ao,CW,0,0,159849,14,1
2020-04-20,CuraÃ§ao,CW,0,0,159849,14,1
2020-04-21,CuraÃ§ao,CW,0,0,159849,14,1
2020-04-22,CuraÃ§ao,CW,0,0,159849,14,1
2020-04-23,CuraÃ§ao,CW,0,0,159849,14,1
2020-04-24,CuraÃ§ao,CW,0,0,159849,14,1
2020-04-25,CuraÃ§ao,CW,2,0,159849,16,1
2020-04-26,CuraÃ§ao,CW,0,0,159849,16,1
2020-04-27,CuraÃ§ao,CW,0,0,159849,16,1
2020-04-28,CuraÃ§ao,CW,0,0,159849,16,1
2020-04-29,CuraÃ§ao,CW,0,0,159849,16,1
2020-04-30,CuraÃ§ao,CW,0,0,159849,16,1
2020-05-01,CuraÃ§ao,CW,0,0,159849,16,1
2020-05-02,CuraÃ§ao,CW,0,0,159849,16,1
2020-05-03,CuraÃ§ao,CW,0,0,159849,16,1
2020-03-10,Cyprus,CY,2,0,1189265,2,0
2020-03-12,Cyprus,CY,4,0,1189265,6,0
2020-03-14,Cyprus,CY,8,0,1189265,14,0
2020-03-15,Cyprus,CY,7,0,1189265,21,0
2020-03-16,Cyprus,CY,9,0,1189265,30,0
2020-03-17,Cyprus,CY,10,0,1189265,40,0
2020-03-18,Cyprus,CY,0,0,1189265,40,0
2020-03-19,Cyprus,CY,18,0,1189265,58,0
2020-03-20,Cyprus,CY,0,0,1189265,58,0
2020-03-21,Cyprus,CY,9,0,1189265,67,0
2020-03-22,Cyprus,CY,17,0,1189265,84,0
2020-03-23,Cyprus,CY,11,0,1189265,95,0
2020-03-24,Cyprus,CY,21,0,1189265,116,0
2020-03-25,Cyprus,CY,8,3,1189265,124,3
2020-03-26,Cyprus,CY,8,0,1189265,132,3
2020-03-27,Cyprus,CY,14,0,1189265,146,3
2020-03-28,Cyprus,CY,16,2,1189265,162,5
2020-03-29,Cyprus,CY,17,0,1189265,179,5
2020-03-30,Cyprus,CY,35,1,1189265,214,6
2020-03-31,Cyprus,CY,16,1,1189265,230,7
2020-04-01,Cyprus,CY,32,1,1189265,262,8
2020-04-02,Cyprus,CY,58,1,1189265,320,9
2020-04-03,Cyprus,CY,36,0,1189265,356,9
2020-04-04,Cyprus,CY,40,2,1189265,396,11
2020-04-05,Cyprus,CY,30,0,1189265,426,11
2020-04-06,Cyprus,CY,20,3,1189265,446,14
2020-04-07,Cyprus,CY,19,0,1189265,465,14
2020-04-08,Cyprus,CY,29,0,1189265,494,14
2020-04-09,Cyprus,CY,32,0,1189265,526,14
2020-04-10,Cyprus,CY,38,1,1189265,564,15
2020-04-11,Cyprus,CY,31,0,1189265,595,15
2020-04-12,Cyprus,CY,21,0,1189265,616,15
2020-04-13,Cyprus,CY,17,1,1189265,633,16
2020-04-14,Cyprus,CY,29,1,1189265,662,17
2020-04-15,Cyprus,CY,33,0,1189265,695,17
2020-04-16,Cyprus,CY,20,0,1189265,715,17
2020-04-17,Cyprus,CY,20,0,1189265,735,17
2020-04-18,Cyprus,CY,0,0,1189265,735,17
2020-04-19,Cyprus,CY,26,0,1189265,761,17
2020-04-20,Cyprus,CY,6,0,1189265,767,17
2020-04-21,Cyprus,CY,5,0,1189265,772,17
2020-04-22,Cyprus,CY,12,0,1189265,784,17
2020-04-23,Cyprus,CY,6,0,1189265,790,17
2020-04-24,Cyprus,CY,5,0,1189265,795,17
2020-04-25,Cyprus,CY,9,0,1189265,804,17
2020-04-26,Cyprus,CY,6,0,1189265,810,17
2020-04-27,Cyprus,CY,7,0,1189265,817,17
2020-04-28,Cyprus,CY,5,3,1189265,822,20
2020-04-29,Cyprus,CY,15,0,1189265,837,20
2020-04-30,Cyprus,CY,6,0,1189265,843,20
2020-05-01,Cyprus,CY,7,0,1189265,850,20
2020-05-02,Cyprus,CY,7,0,1189265,857,20
2020-05-03,Cyprus,CY,7,0,1189265,864,20
2019-12-31,Czechia,CZ,0,0,10625695,0,0
2020-01-01,Czechia,CZ,0,0,10625695,0,0
2020-01-02,Czechia,CZ,0,0,10625695,0,0
2020-01-03,Czechia,CZ,0,0,10625695,0,0
2020-01-04,Czechia,CZ,0,0,10625695,0,0
2020-01-05,Czechia,CZ,0,0,10625695,0,0
2020-01-06,Czechia,CZ,0,0,10625695,0,0
2020-01-07,Czechia,CZ,0,0,10625695,0,0
2020-01-08,Czechia,CZ,0,0,10625695,0,0
2020-01-09,Czechia,CZ,0,0,10625695,0,0
2020-01-10,Czechia,CZ,0,0,10625695,0,0
2020-01-11,Czechia,CZ,0,0,10625695,0,0
2020-01-12,Czechia,CZ,0,0,10625695,0,0
2020-01-13,Czechia,CZ,0,0,10625695,0,0
2020-01-14,Czechia,CZ,0,0,10625695,0,0
2020-01-15,Czechia,CZ,0,0,10625695,0,0
2020-01-16,Czechia,CZ,0,0,10625695,0,0
2020-01-17,Czechia,CZ,0,0,10625695,0,0
2020-01-18,Czechia,CZ,0,0,10625695,0,0
2020-01-19,Czechia,CZ,0,0,10625695,0,0
2020-01-20,Czechia,CZ,0,0,10625695,0,0
2020-01-21,Czechia,CZ,0,0,10625695,0,0
2020-01-22,Czechia,CZ,0,0,10625695,0,0
2020-01-23,Czechia,CZ,0,0,10625695,0,0
2020-01-24,Czechia,CZ,0,0,10625695,0,0
2020-01-25,Czechia,CZ,0,0,10625695,0,0
2020-01-26,Czechia,CZ,0,0,10625695,0,0
2020-01-27,Czechia,CZ,0,0,10625695,0,0
2020-01-28,Czechia,CZ,0,0,10625695,0,0
2020-01-29,Czechia,CZ,0,0,10625695,0,0
2020-01-30,Czechia,CZ,0,0,10625695,0,0
2020-01-31,Czechia,CZ,0,0,10625695,0,0
2020-02-01,Czechia,CZ,0,0,10625695,0,0
2020-02-02,Czechia,CZ,0,0,10625695,0,0
2020-02-03,Czechia,CZ,0,0,10625695,0,0
2020-02-04,Czechia,CZ,0,0,10625695,0,0
2020-02-05,Czechia,CZ,0,0,10625695,0,0
2020-02-06,Czechia,CZ,0,0,10625695,0,0
2020-02-07,Czechia,CZ,0,0,10625695,0,0
2020-02-08,Czechia,CZ,0,0,10625695,0,0
2020-02-09,Czechia,CZ,0,0,10625695,0,0
2020-02-10,Czechia,CZ,0,0,10625695,0,0
2020-02-11,Czechia,CZ,0,0,10625695,0,0
2020-02-12,Czechia,CZ,0,0,10625695,0,0
2020-02-13,Czechia,CZ,0,0,10625695,0,0
2020-02-14,Czechia,CZ,0,0,10625695,0,0
2020-02-15,Czechia,CZ,0,0,10625695,0,0
2020-02-16,Czechia,CZ,0,0,10625695,0,0
2020-02-17,Czechia,CZ,0,0,10625695,0,0
2020-02-18,Czechia,CZ,0,0,10625695,0,0
2020-02-19,Czechia,CZ,0,0,10625695,0,0
2020-02-20,Czechia,CZ,0,0,10625695,0,0
2020-02-21,Czechia,CZ,0,0,10625695,0,0
2020-02-22,Czechia,CZ,0,0,10625695,0,0
2020-02-23,Czechia,CZ,0,0,10625695,0,0
2020-02-24,Czechia,CZ,0,0,10625695,0,0
2020-02-25,Czechia,CZ,0,0,10625695,0,0
2020-02-26,Czechia,CZ,0,0,10625695,0,0
2020-02-27,Czechia,CZ,0,0,10625695,0,0
2020-02-28,Czechia,CZ,0,0,10625695,0,0
2020-02-29,Czechia,CZ,0,0,10625695,0,0
2020-03-01,Czechia,CZ,0,0,10625695,0,0
2020-03-02,Czechia,CZ,3,0,10625695,3,0
2020-03-03,Czechia,CZ,2,0,10625695,5,0
2020-03-04,Czechia,CZ,0,0,10625695,5,0
2020-03-05,Czechia,CZ,3,0,10625695,8,0
2020-03-06,Czechia,CZ,4,0,10625695,12,0
2020-03-07,Czechia,CZ,7,0,10625695,19,0
2020-03-08,Czechia,CZ,7,0,10625695,26,0
2020-03-09,Czechia,CZ,6,0,10625695,32,0
2020-03-10,Czechia,CZ,8,0,10625695,40,0
2020-03-11,Czechia,CZ,23,0,10625695,63,0
2020-03-12,Czechia,CZ,31,0,10625695,94,0
2020-03-13,Czechia,CZ,22,0,10625695,116,0
2020-03-14,Czechia,CZ,34,0,10625695,150,0
2020-03-15,Czechia,CZ,64,0,10625695,214,0
2020-03-16,Czechia,CZ,84,0,10625695,298,0
2020-03-17,Czechia,CZ,46,0,10625695,344,0
2020-03-18,Czechia,CZ,90,0,10625695,434,0
2020-03-19,Czechia,CZ,88,0,10625695,522,0
2020-03-20,Czechia,CZ,172,0,10625695,694,0
2020-03-21,Czechia,CZ,210,0,10625695,904,0
2020-03-22,Czechia,CZ,91,0,10625695,995,0
2020-03-23,Czechia,CZ,170,1,10625695,1165,1
2020-03-24,Czechia,CZ,71,0,10625695,1236,1
2020-03-25,Czechia,CZ,158,2,10625695,1394,3
2020-03-26,Czechia,CZ,260,3,10625695,1654,6
2020-03-27,Czechia,CZ,408,3,10625695,2062,9
2020-03-28,Czechia,CZ,217,0,10625695,2279,9
2020-03-29,Czechia,CZ,384,2,10625695,2663,11
2020-03-30,Czechia,CZ,166,5,10625695,2829,16
2020-03-31,Czechia,CZ,173,8,10625695,3002,24
2020-04-01,Czechia,CZ,306,7,10625695,3308,31
2020-04-02,Czechia,CZ,281,8,10625695,3589,39
2020-04-03,Czechia,CZ,269,5,10625695,3858,44
2020-04-04,Czechia,CZ,332,9,10625695,4190,53
2020-04-05,Czechia,CZ,282,6,10625695,4472,59
2020-04-06,Czechia,CZ,115,8,10625695,4587,67
2020-04-07,Czechia,CZ,235,11,10625695,4822,78
2020-04-08,Czechia,CZ,195,10,10625695,5017,88
2020-04-09,Czechia,CZ,295,11,10625695,5312,99
2020-04-10,Czechia,CZ,257,13,10625695,5569,112
2020-04-11,Czechia,CZ,163,7,10625695,5732,119
2020-04-12,Czechia,CZ,170,10,10625695,5902,129
2020-04-13,Czechia,CZ,89,9,10625695,5991,138
2020-04-14,Czechia,CZ,68,5,10625695,6059,143
2020-04-15,Czechia,CZ,82,18,10625695,6141,161
2020-04-16,Czechia,CZ,162,5,10625695,6303,166
2020-04-17,Czechia,CZ,130,3,10625695,6433,169
2020-04-18,Czechia,CZ,116,4,10625695,6549,173
2020-04-19,Czechia,CZ,105,8,10625695,6654,181
2020-04-20,Czechia,CZ,133,7,10625695,6787,188
2020-04-21,Czechia,CZ,127,8,10625695,6914,196
2020-04-22,Czechia,CZ,127,5,10625695,7041,201
2020-04-23,Czechia,CZ,95,9,10625695,7136,210
2020-04-24,Czechia,CZ,52,3,10625695,7188,213
2020-04-25,Czechia,CZ,85,2,10625695,7273,215
2020-04-26,Czechia,CZ,79,3,10625695,7352,218
2020-04-27,Czechia,CZ,52,3,10625695,7404,221
2020-04-28,Czechia,CZ,45,2,10625695,7449,223
2020-04-29,Czechia,CZ,55,4,10625695,7504,227
2020-04-30,Czechia,CZ,75,0,10625695,7579,227
2020-05-01,Czechia,CZ,103,9,10625695,7682,236
2020-05-02,Czechia,CZ,55,4,10625695,7737,240
2020-05-03,Czechia,CZ,18,5,10625695,7755,245
2019-12-31,Germany,DE,0,0,82927922,0,0
2020-01-01,Germany,DE,0,0,82927922,0,0
2020-01-02,Germany,DE,0,0,82927922,0,0
2020-01-03,Germany,DE,0,0,82927922,0,0
2020-01-04,Germany,DE,0,0,82927922,0,0
2020-01-05,Germany,DE,0,0,82927922,0,0
2020-01-06,Germany,DE,0,0,82927922,0,0
2020-01-07,Germany,DE,0,0,82927922,0,0
2020-01-08,Germany,DE,0,0,82927922,0,0
2020-01-09,Germany,DE,0,0,82927922,0,0
2020-01-10,Germany,DE,0,0,82927922,0,0
2020-01-11,Germany,DE,0,0,82927922,0,0
2020-01-12,Germany,DE,0,0,82927922,0,0
2020-01-13,Germany,DE,0,0,82927922,0,0
2020-01-14,Germany,DE,0,0,82927922,0,0
2020-01-15,Germany,DE,0,0,82927922,0,0
2020-01-16,Germany,DE,0,0,82927922,0,0
2020-01-17,Germany,DE,0,0,82927922,0,0
2020-01-18,Germany,DE,0,0,82927922,0,0
2020-01-19,Germany,DE,0,0,82927922,0,0
2020-01-20,Germany,DE,0,0,82927922,0,0
2020-01-21,Germany,DE,0,0,82927922,0,0
2020-01-22,Germany,DE,0,0,82927922,0,0
2020-01-23,Germany,DE,0,0,82927922,0,0
2020-01-24,Germany,DE,0,0,82927922,0,0
2020-01-25,Germany,DE,0,0,82927922,0,0
2020-01-26,Germany,DE,0,0,82927922,0,0
2020-01-27,Germany,DE,0,0,82927922,0,0
2020-01-28,Germany,DE,1,0,82927922,1,0
2020-01-29,Germany,DE,3,0,82927922,4,0
2020-01-30,Germany,DE,0,0,82927922,4,0
2020-01-31,Germany,DE,1,0,82927922,5,0
2020-02-01,Germany,DE,2,0,82927922,7,0
2020-02-02,Germany,DE,1,0,82927922,8,0
2020-02-03,Germany,DE,1,0,82927922,9,0
2020-02-04,Germany,DE,2,0,82927922,11,0
2020-02-05,Germany,DE,0,0,82927922,11,0
2020-02-06,Germany,DE,0,0,82927922,11,0
2020-02-07,Germany,DE,1,0,82927922,12,0
2020-02-08,Germany,DE,1,0,82927922,13,0
2020-02-09,Germany,DE,0,0,82927922,13,0
2020-02-10,Germany,DE,0,0,82927922,13,0
2020-02-11,Germany,DE,0,0,82927922,13,0
2020-02-12,Germany,DE,2,0,82927922,15,0
2020-02-13,Germany,DE,0,0,82927922,15,0
2020-02-14,Germany,DE,0,0,82927922,15,0
2020-02-15,Germany,DE,0,0,82927922,15,0
2020-02-16,Germany,DE,0,0,82927922,15,0
2020-02-17,Germany,DE,0,0,82927922,15,0
2020-02-18,Germany,DE,0,0,82927922,15,0
2020-02-19,Germany,DE,0,0,82927922,15,0
2020-02-20,Germany,DE,0,0,82927922,15,0
2020-02-21,Germany,DE,0,0,82927922,15,0
2020-02-22,Germany,DE,0,0,82927922,15,0
2020-02-23,Germany,DE,0,0,82927922,15,0
2020-02-24,Germany,DE,0,0,82927922,15,0
2020-02-25,Germany,DE,0,0,82927922,15,0
2020-02-26,Germany,DE,2,0,82927922,17,0
2020-02-27,Germany,DE,4,0,82927922,21,0
2020-02-28,Germany,DE,26,0,82927922,47,0
2020-02-29,Germany,DE,10,0,82927922,57,0
2020-03-01,Germany,DE,54,0,82927922,111,0
2020-03-02,Germany,DE,18,0,82927922,129,0
2020-03-03,Germany,DE,28,0,82927922,157,0
2020-03-04,Germany,DE,39,0,82927922,196,0
2020-03-05,Germany,DE,66,0,82927922,262,0
2020-03-06,Germany,DE,138,0,82927922,400,0
2020-03-07,Germany,DE,284,0,82927922,684,0
2020-03-08,Germany,DE,163,0,82927922,847,0
2020-03-09,Germany,DE,55,0,82927922,902,0
2020-03-10,Germany,DE,237,2,82927922,1139,2
2020-03-11,Germany,DE,157,0,82927922,1296,2
2020-03-12,Germany,DE,271,1,82927922,1567,3
2020-03-13,Germany,DE,802,2,82927922,2369,5
2020-03-14,Germany,DE,693,0,82927922,3062,5
2020-03-15,Germany,DE,733,3,82927922,3795,8
2020-03-16,Germany,DE,1043,4,82927922,4838,12
2020-03-17,Germany,DE,1174,1,82927922,6012,13
2020-03-18,Germany,DE,1144,0,82927922,7156,13
2020-03-19,Germany,DE,1042,0,82927922,8198,13
2020-03-20,Germany,DE,5940,30,82927922,14138,43
2020-03-21,Germany,DE,4049,2,82927922,18187,45
2020-03-22,Germany,DE,3276,22,82927922,21463,67
2020-03-23,Germany,DE,3311,27,82927922,24774,94
2020-03-24,Germany,DE,4438,32,82927922,29212,126
2020-03-25,Germany,DE,2342,23,82927922,31554,149
2020-03-26,Germany,DE,4954,49,82927922,36508,198
2020-03-27,Germany,DE,5780,55,82927922,42288,253
2020-03-28,Germany,DE,6294,72,82927922,48582,325
2020-03-29,Germany,DE,3965,64,82927922,52547,389
2020-03-30,Germany,DE,4751,66,82927922,57298,455
2020-03-31,Germany,DE,4615,128,82927922,61913,583
2020-04-01,Germany,DE,5453,149,82927922,67366,732
2020-04-02,Germany,DE,6156,140,82927922,73522,872
2020-04-03,Germany,DE,6174,145,82927922,79696,1017
2020-04-04,Germany,DE,6082,141,82927922,85778,1158
2020-04-05,Germany,DE,5936,184,82927922,91714,1342
2020-04-06,Germany,DE,3677,92,82927922,95391,1434
2020-04-07,Germany,DE,3834,173,82927922,99225,1607
2020-04-08,Germany,DE,4003,254,82927922,103228,1861
2020-04-09,Germany,DE,4974,246,82927922,108202,2107
2020-04-10,Germany,DE,5323,266,82927922,113525,2373
2020-04-11,Germany,DE,4133,171,82927922,117658,2544
2020-04-12,Germany,DE,2821,129,82927922,120479,2673
2020-04-13,Germany,DE,2537,126,82927922,123016,2799
2020-04-14,Germany,DE,2082,170,82927922,125098,2969
2020-04-15,Germany,DE,2486,285,82927922,127584,3254
2020-04-16,Germany,DE,2866,315,82927922,130450,3569
2020-04-17,Germany,DE,3380,299,82927922,133830,3868
2020-04-18,Germany,DE,3609,242,82927922,137439,4110
2020-04-19,Germany,DE,2458,184,82927922,139897,4294
2020-04-20,Germany,DE,1775,110,82927922,141672,4404
2020-04-21,Germany,DE,1785,194,82927922,143457,4598
2020-04-22,Germany,DE,2237,281,82927922,145694,4879
2020-04-23,Germany,DE,2352,215,82927922,148046,5094
2020-04-24,Germany,DE,2337,227,82927922,150383,5321
2020-04-25,Germany,DE,2055,179,82927922,152438,5500
2020-04-26,Germany,DE,1737,140,82927922,154175,5640
2020-04-27,Germany,DE,1018,110,82927922,155193,5750
2020-04-28,Germany,DE,1144,163,82927922,156337,5913
2020-04-29,Germany,DE,1304,202,82927922,157641,6115
2020-04-30,Germany,DE,1478,173,82927922,159119,6288
2020-05-01,Germany,DE,0,0,82927922,159119,6288
2020-05-02,Germany,DE,2584,287,82927922,161703,6575
2020-05-03,Germany,DE,793,74,82927922,162496,6649
2020-03-19,Djibouti,DJ,1,0,958920,1,0
2020-03-20,Djibouti,DJ,0,0,958920,1,0
2020-03-21,Djibouti,DJ,0,0,958920,1,0
2020-03-22,Djibouti,DJ,0,0,958920,1,0
2020-03-23,Djibouti,DJ,0,0,958920,1,0
2020-03-24,Djibouti,DJ,2,0,958920,3,0
2020-03-25,Djibouti,DJ,0,0,958920,3,0
2020-03-26,Djibouti,DJ,9,0,958920,12,0
2020-03-27,Djibouti,DJ,0,0,958920,12,0
2020-03-28,Djibouti,DJ,1,0,958920,13,0
2020-03-29,Djibouti,DJ,2,0,958920,15,0
2020-03-30,Djibouti,DJ,4,0,958920,19,0
2020-03-31,Djibouti,DJ,7,0,958920,26,0
2020-04-01,Djibouti,DJ,5,0,958920,31,0
2020-04-02,Djibouti,DJ,3,0,958920,34,0
2020-04-03,Djibouti,DJ,7,0,958920,41,0
2020-04-04,Djibouti,DJ,0,0,958920,41,0
2020-04-05,Djibouti,DJ,10,0,958920,51,0
2020-04-06,Djibouti,DJ,8,0,958920,59,0
2020-04-07,Djibouti,DJ,31,0,958920,90,0
2020-04-08,Djibouti,DJ,31,0,958920,121,0
2020-04-09,Djibouti,DJ,14,0,958920,135,0
2020-04-10,Djibouti,DJ,5,1,958920,140,1
2020-04-11,Djibouti,DJ,10,0,958920,150,1
2020-04-12,Djibouti,DJ,37,1,958920,187,2
2020-04-13,Djibouti,DJ,27,0,958920,214,2
2020-04-14,Djibouti,DJ,84,0,958920,298,2
2020-04-15,Djibouti,DJ,65,0,958920,363,2
2020-04-16,Djibouti,DJ,72,0,958920,435,2
2020-04-17,Djibouti,DJ,156,0,958920,591,2
2020-04-18,Djibouti,DJ,141,0,958920,732,2
2020-04-19,Djibouti,DJ,0,0,958920,732,2
2020-04-20,Djibouti,DJ,114,0,958920,846,2
2020-04-21,Djibouti,DJ,0,0,958920,846,2
2020-04-22,Djibouti,DJ,99,0,958920,945,2
2020-04-23,Djibouti,DJ,29,0,958920,974,2
2020-04-24,Djibouti,DJ,12,0,958920,986,2
2020-04-25,Djibouti,DJ,13,0,958920,999,2
2020-04-26,Djibouti,DJ,9,0,958920,1008,2
2020-04-27,Djibouti,DJ,15,0,958920,1023,2
2020-04-28,Djibouti,DJ,12,0,958920,1035,2
2020-04-29,Djibouti,DJ,37,0,958920,1072,2
2020-04-30,Djibouti,DJ,5,0,958920,1077,2
2020-05-01,Djibouti,DJ,12,0,958920,1089,2
2020-05-02,Djibouti,DJ,8,0,958920,1097,2
2020-05-03,Djibouti,DJ,15,0,958920,1112,2
2019-12-31,Denmark,DK,0,0,5797446,0,0
2020-01-01,Denmark,DK,0,0,5797446,0,0
2020-01-02,Denmark,DK,0,0,5797446,0,0
2020-01-03,Denmark,DK,0,0,5797446,0,0
2020-01-04,Denmark,DK,0,0,5797446,0,0
2020-01-05,Denmark,DK,0,0,5797446,0,0
2020-01-06,Denmark,DK,0,0,5797446,0,0
2020-01-07,Denmark,DK,0,0,5797446,0,0
2020-01-08,Denmark,DK,0,0,5797446,0,0
2020-01-09,Denmark,DK,0,0,5797446,0,0
2020-01-10,Denmark,DK,0,0,5797446,0,0
2020-01-11,Denmark,DK,0,0,5797446,0,0
2020-01-12,Denmark,DK,0,0,5797446,0,0
2020-01-13,Denmark,DK,0,0,5797446,0,0
2020-01-14,Denmark,DK,0,0,5797446,0,0
2020-01-15,Denmark,DK,0,0,5797446,0,0
2020-01-16,Denmark,DK,0,0,5797446,0,0
2020-01-17,Denmark,DK,0,0,5797446,0,0
2020-01-18,Denmark,DK,0,0,5797446,0,0
2020-01-19,Denmark,DK,0,0,5797446,0,0
2020-01-20,Denmark,DK,0,0,5797446,0,0
2020-01-21,Denmark,DK,0,0,5797446,0,0
2020-01-22,Denmark,DK,0,0,5797446,0,0
2020-01-23,Denmark,DK,0,0,5797446,0,0
2020-01-24,Denmark,DK,0,0,5797446,0,0
2020-01-25,Denmark,DK,0,0,5797446,0,0
2020-01-26,Denmark,DK,0,0,5797446,0,0
2020-01-27,Denmark,DK,0,0,5797446,0,0
2020-01-28,Denmark,DK,0,0,5797446,0,0
2020-01-29,Denmark,DK,0,0,5797446,0,0
2020-01-30,Denmark,DK,0,0,5797446,0,0
2020-01-31,Denmark,DK,0,0,5797446,0,0
2020-02-01,Denmark,DK,0,0,5797446,0,0
2020-02-02,Denmark,DK,0,0,5797446,0,0
2020-02-03,Denmark,DK,0,0,5797446,0,0
2020-02-04,Denmark,DK,0,0,5797446,0,0
2020-02-05,Denmark,DK,0,0,5797446,0,0
2020-02-06,Denmark,DK,0,0,5797446,0,0
2020-02-07,Denmark,DK,0,0,5797446,0,0
2020-02-08,Denmark,DK,0,0,5797446,0,0
2020-02-09,Denmark,DK,0,0,5797446,0,0
2020-02-10,Denmark,DK,0,0,5797446,0,0
2020-02-11,Denmark,DK,0,0,5797446,0,0
2020-02-12,Denmark,DK,0,0,5797446,0,0
2020-02-13,Denmark,DK,0,0,5797446,0,0
2020-02-14,Denmark,DK,0,0,5797446,0,0
2020-02-15,Denmark,DK,0,0,5797446,0,0
2020-02-16,Denmark,DK,0,0,5797446,0,0
2020-02-17,Denmark,DK,0,0,5797446,0,0
2020-02-18,Denmark,DK,0,0,5797446,0,0
2020-02-19,Denmark,DK,0,0,5797446,0,0
2020-02-20,Denmark,DK,0,0,5797446,0,0
2020-02-21,Denmark,DK,0,0,5797446,0,0
2020-02-22,Denmark,DK,0,0,5797446,0,0
2020-02-23,Denmark,DK,0,0,5797446,0,0
2020-02-24,Denmark,DK,0,0,5797446,0,0
2020-02-25,Denmark,DK,0,0,5797446,0,0
2020-02-26,Denmark,DK,0,0,5797446,0,0
2020-02-27,Denmark,DK,1,0,5797446,1,0
2020-02-28,Denmark,DK,0,0,5797446,1,0
2020-02-29,Denmark,DK,1,0,5797446,2,0
2020-03-01,Denmark,DK,1,0,5797446,3,0
2020-03-02,Denmark,DK,1,0,5797446,4,0
2020-03-03,Denmark,DK,1,0,5797446,5,0
2020-03-04,Denmark,DK,3,0,5797446,8,0
2020-03-05,Denmark,DK,2,0,5797446,10,0
2020-03-06,Denmark,DK,10,0,5797446,20,0
2020-03-07,Denmark,DK,3,0,5797446,23,0
2020-03-08,Denmark,DK,8,0,5797446,31,0
2020-03-09,Denmark,DK,7,0,5797446,38,0
2020-03-10,Denmark,DK,75,0,5797446,113,0
2020-03-11,Denmark,DK,151,0,5797446,264,0
2020-03-12,Denmark,DK,252,0,5797446,516,0
2020-03-13,Denmark,DK,160,0,5797446,676,0
2020-03-14,Denmark,DK,128,0,5797446,804,0
2020-03-15,Denmark,DK,23,0,5797446,827,0
2020-03-16,Denmark,DK,48,1,5797446,875,1
2020-03-17,Denmark,DK,57,0,5797446,932,1
2020-03-18,Denmark,DK,92,3,5797446,1024,4
2020-03-19,Denmark,DK,91,0,5797446,1115,4
2020-03-20,Denmark,DK,36,2,5797446,1151,6
2020-03-21,Denmark,DK,104,3,5797446,1255,9
2020-03-22,Denmark,DK,71,4,5797446,1326,13
2020-03-23,Denmark,DK,69,0,5797446,1395,13
2020-03-24,Denmark,DK,65,11,5797446,1460,24
2020-03-25,Denmark,DK,131,8,5797446,1591,32
2020-03-26,Denmark,DK,133,2,5797446,1724,34
2020-03-27,Denmark,DK,153,7,5797446,1877,41
2020-03-28,Denmark,DK,169,11,5797446,2046,52
2020-03-29,Denmark,DK,155,13,5797446,2201,65
2020-03-30,Denmark,DK,194,7,5797446,2395,72
2020-03-31,Denmark,DK,182,5,5797446,2577,77
2020-04-01,Denmark,DK,283,13,5797446,2860,90
2020-04-02,Denmark,DK,247,14,5797446,3107,104
2020-04-03,Denmark,DK,279,19,5797446,3386,123
2020-04-04,Denmark,DK,371,16,5797446,3757,139
2020-04-05,Denmark,DK,320,22,5797446,4077,161
2020-04-06,Denmark,DK,292,18,5797446,4369,179
2020-04-07,Denmark,DK,312,8,5797446,4681,187
2020-04-08,Denmark,DK,390,16,5797446,5071,203
2020-04-09,Denmark,DK,331,15,5797446,5402,218
2020-04-10,Denmark,DK,233,19,5797446,5635,237
2020-04-11,Denmark,DK,184,10,5797446,5819,247
2020-04-12,Denmark,DK,177,13,5797446,5996,260
2020-04-13,Denmark,DK,178,13,5797446,6174,273
2020-04-14,Denmark,DK,144,12,5797446,6318,285
2020-04-15,Denmark,DK,193,14,5797446,6511,299
2020-04-16,Denmark,DK,170,10,5797446,6681,309
2020-04-17,Denmark,DK,198,12,5797446,6879,321
2020-04-18,Denmark,DK,194,15,5797446,7073,336
2020-04-19,Denmark,DK,169,10,5797446,7242,346
2020-04-20,Denmark,DK,142,9,5797446,7384,355
2020-04-21,Denmark,DK,131,9,5797446,7515,364
2020-04-22,Denmark,DK,180,6,5797446,7695,370
2020-04-23,Denmark,DK,217,14,5797446,7912,384
2020-04-24,Denmark,DK,161,10,5797446,8073,394
2020-04-25,Denmark,DK,137,9,5797446,8210,403
2020-04-26,Denmark,DK,235,15,5797446,8445,418
2020-04-27,Denmark,DK,130,4,5797446,8575,422
2020-04-28,Denmark,DK,123,5,5797446,8698,427
2020-04-29,Denmark,DK,153,7,5797446,8851,434
2020-04-30,Denmark,DK,157,9,5797446,9008,443
2020-05-01,Denmark,DK,150,9,5797446,9158,452
2020-05-02,Denmark,DK,153,8,5797446,9311,460
2020-05-03,Denmark,DK,96,15,5797446,9407,475
2020-03-23,Dominica,DM,1,0,71625,1,0
2020-03-24,Dominica,DM,0,0,71625,1,0
2020-03-25,Dominica,DM,1,0,71625,2,0
2020-03-26,Dominica,DM,5,0,71625,7,0
2020-03-27,Dominica,DM,4,0,71625,11,0
2020-03-28,Dominica,DM,0,0,71625,11,0
2020-03-29,Dominica,DM,0,0,71625,11,0
2020-03-30,Dominica,DM,0,0,71625,11,0
2020-03-31,Dominica,DM,0,0,71625,11,0
2020-04-01,Dominica,DM,0,0,71625,11,0
2020-04-02,Dominica,DM,1,0,71625,12,0
2020-04-03,Dominica,DM,0,0,71625,12,0
2020-04-04,Dominica,DM,2,0,71625,14,0
2020-04-05,Dominica,DM,0,0,71625,14,0
2020-04-06,Dominica,DM,0,0,71625,14,0
2020-04-07,Dominica,DM,1,0,71625,15,0
2020-04-08,Dominica,DM,0,0,71625,15,0
2020-04-09,Dominica,DM,0,0,71625,15,0
2020-04-10,Dominica,DM,1,0,71625,16,0
2020-04-11,Dominica,DM,0,0,71625,16,0
2020-04-12,Dominica,DM,0,0,71625,16,0
2020-04-13,Dominica,DM,0,0,71625,16,0
2020-04-14,Dominica,DM,0,0,71625,16,0
2020-04-15,Dominica,DM,0,0,71625,16,0
2020-04-16,Dominica,DM,0,0,71625,16,0
2020-04-17,Dominica,DM,0,0,71625,16,0
2020-04-18,Dominica,DM,0,0,71625,16,0
2020-04-19,Dominica,DM,0,0,71625,16,0
2020-04-20,Dominica,DM,0,0,71625,16,0
2020-04-21,Dominica,DM,0,0,71625,16,0
2020-04-22,Dominica,DM,0,0,71625,16,0
2020-04-23,Dominica,DM,0,0,71625,16,0
2020-04-24,Dominica,DM,0,0,71625,16,0
2020-04-25,Dominica,DM,0,0,71625,16,0
2020-04-26,Dominica,DM,0,0,71625,16,0
2020-04-27,Dominica,DM,0,0,71625,16,0
2020-04-28,Dominica,DM,0,0,71625,16,0
2020-04-29,Dominica,DM,0,0,71625,16,0
2020-04-30,Dominica,DM,0,0,71625,16,0
2020-05-01,Dominica,DM,0,0,71625,16,0
2020-05-02,Dominica,DM,0,0,71625,16,0
2020-05-03,Dominica,DM,0,0,71625,16,0
2019-12-31,Dominican_Republic,DO,0,0,10627165,0,0
2020-01-01,Dominican_Republic,DO,0,0,10627165,0,0
2020-01-02,Dominican_Republic,DO,0,0,10627165,0,0
2020-01-03,Dominican_Republic,DO,0,0,10627165,0,0
2020-01-04,Dominican_Republic,DO,0,0,10627165,0,0
2020-01-05,Dominican_Republic,DO,0,0,10627165,0,0
2020-01-06,Dominican_Republic,DO,0,0,10627165,0,0
2020-01-07,Dominican_Republic,DO,0,0,10627165,0,0
2020-01-08,Dominican_Republic,DO,0,0,10627165,0,0
2020-01-09,Dominican_Republic,DO,0,0,10627165,0,0
2020-01-10,Dominican_Republic,DO,0,0,10627165,0,0
2020-01-11,Dominican_Republic,DO,0,0,10627165,0,0
2020-01-12,Dominican_Republic,DO,0,0,10627165,0,0
2020-01-13,Dominican_Republic,DO,0,0,10627165,0,0
2020-01-14,Dominican_Republic,DO,0,0,10627165,0,0
2020-01-15,Dominican_Republic,DO,0,0,10627165,0,0
2020-01-16,Dominican_Republic,DO,0,0,10627165,0,0
2020-01-17,Dominican_Republic,DO,0,0,10627165,0,0
2020-01-18,Dominican_Republic,DO,0,0,10627165,0,0
2020-01-19,Dominican_Republic,DO,0,0,10627165,0,0
2020-01-20,Dominican_Republic,DO,0,0,10627165,0,0
2020-01-21,Dominican_Republic,DO,0,0,10627165,0,0
2020-01-22,Dominican_Republic,DO,0,0,10627165,0,0
2020-01-23,Dominican_Republic,DO,0,0,10627165,0,0
2020-01-24,Dominican_Republic,DO,0,0,10627165,0,0
2020-01-25,Dominican_Republic,DO,0,0,10627165,0,0
2020-01-26,Dominican_Republic,DO,0,0,10627165,0,0
2020-01-27,Dominican_Republic,DO,0,0,10627165,0,0
2020-01-28,Dominican_Republic,DO,0,0,10627165,0,0
2020-01-29,Dominican_Republic,DO,0,0,10627165,0,0
2020-01-30,Dominican_Republic,DO,0,0,10627165,0,0
2020-01-31,Dominican_Republic,DO,0,0,10627165,0,0
2020-02-01,Dominican_Republic,DO,0,0,10627165,0,0
2020-02-02,Dominican_Republic,DO,0,0,10627165,0,0
2020-02-03,Dominican_Republic,DO,0,0,10627165,0,0
2020-02-04,Dominican_Republic,DO,0,0,10627165,0,0
2020-02-05,Dominican_Republic,DO,0,0,10627165,0,0
2020-02-06,Dominican_Republic,DO,0,0,10627165,0,0
2020-02-07,Dominican_Republic,DO,0,0,10627165,0,0
2020-02-08,Dominican_Republic,DO,0,0,10627165,0,0
2020-02-09,Dominican_Republic,DO,0,0,10627165,0,0
2020-02-10,Dominican_Republic,DO,0,0,10627165,0,0
2020-02-11,Dominican_Republic,DO,0,0,10627165,0,0
2020-02-12,Dominican_Republic,DO,0,0,10627165,0,0
2020-02-13,Dominican_Republic,DO,0,0,10627165,0,0
2020-02-14,Dominican_Republic,DO,0,0,10627165,0,0
2020-02-15,Dominican_Republic,DO,0,0,10627165,0,0
2020-02-16,Dominican_Republic,DO,0,0,10627165,0,0
2020-02-17,Dominican_Republic,DO,0,0,10627165,0,0
2020-02-18,Dominican_Republic,DO,0,0,10627165,0,0
2020-02-19,Dominican_Republic,DO,0,0,10627165,0,0
2020-02-20,Dominican_Republic,DO,0,0,10627165,0,0
2020-02-21,Dominican_Republic,DO,0,0,10627165,0,0
2020-02-22,Dominican_Republic,DO,0,0,10627165,0,0
2020-02-23,Dominican_Republic,DO,0,0,10627165,0,0
2020-02-24,Dominican_Republic,DO,0,0,10627165,0,0
2020-02-25,Dominican_Republic,DO,0,0,10627165,0,0
2020-02-26,Dominican_Republic,DO,0,0,10627165,0,0
2020-02-27,Dominican_Republic,DO,0,0,10627165,0,0
2020-02-28,Dominican_Republic,DO,0,0,10627165,0,0
2020-02-29,Dominican_Republic,DO,0,0,10627165,0,0
2020-03-01,Dominican_Republic,DO,0,0,10627165,0,0
2020-03-02,Dominican_Republic,DO,1,0,10627165,1,0
2020-03-07,Dominican_Republic,DO,1,0,10627165,2,0
2020-03-10,Dominican_Republic,DO,3,0,10627165,5,0
2020-03-14,Dominican_Republic,DO,6,0,10627165,11,0
2020-03-15,Dominican_Republic,DO,0,0,10627165,11,0
2020-03-16,Dominican_Republic,DO,0,0,10627165,11,0
2020-03-17,Dominican_Republic,DO,0,0,10627165,11,0
2020-03-18,Dominican_Republic,DO,0,0,10627165,11,0
2020-03-19,Dominican_Republic,DO,10,0,10627165,21,0
2020-03-20,Dominican_Republic,DO,0,0,10627165,21,0
2020-03-21,Dominican_Republic,DO,13,2,10627165,34,2
2020-03-22,Dominican_Republic,DO,78,1,10627165,112,3
2020-03-23,Dominican_Republic,DO,90,0,10627165,202,3
2020-03-24,Dominican_Republic,DO,43,0,10627165,245,3
2020-03-25,Dominican_Republic,DO,67,3,10627165,312,6
2020-03-26,Dominican_Republic,DO,80,4,10627165,392,10
2020-03-27,Dominican_Republic,DO,96,0,10627165,488,10
2020-03-28,Dominican_Republic,DO,93,10,10627165,581,20
2020-03-29,Dominican_Republic,DO,138,8,10627165,719,28
2020-03-30,Dominican_Republic,DO,140,11,10627165,859,39
2020-03-31,Dominican_Republic,DO,42,3,10627165,901,42
2020-04-01,Dominican_Republic,DO,208,9,10627165,1109,51
2020-04-02,Dominican_Republic,DO,175,6,10627165,1284,57
2020-04-03,Dominican_Republic,DO,96,3,10627165,1380,60
2020-04-04,Dominican_Republic,DO,108,8,10627165,1488,68
2020-04-05,Dominican_Republic,DO,90,9,10627165,1578,77
2020-04-06,Dominican_Republic,DO,167,5,10627165,1745,82
2020-04-07,Dominican_Republic,DO,83,4,10627165,1828,86
2020-04-08,Dominican_Republic,DO,128,12,10627165,1956,98
2020-04-09,Dominican_Republic,DO,155,10,10627165,2111,108
2020-04-10,Dominican_Republic,DO,238,10,10627165,2349,118
2020-04-11,Dominican_Republic,DO,271,8,10627165,2620,126
2020-04-12,Dominican_Republic,DO,139,9,10627165,2759,135
2020-04-13,Dominican_Republic,DO,208,38,10627165,2967,173
2020-04-14,Dominican_Republic,DO,200,4,10627165,3167,177
2020-04-15,Dominican_Republic,DO,119,6,10627165,3286,183
2020-04-16,Dominican_Republic,DO,328,6,10627165,3614,189
2020-04-17,Dominican_Republic,DO,141,7,10627165,3755,196
2020-04-18,Dominican_Republic,DO,371,4,10627165,4126,200
2020-04-19,Dominican_Republic,DO,209,17,10627165,4335,217
2020-04-20,Dominican_Republic,DO,345,9,10627165,4680,226
2020-04-21,Dominican_Republic,DO,284,9,10627165,4964,235
2020-04-22,Dominican_Republic,DO,80,10,10627165,5044,245
2020-04-23,Dominican_Republic,DO,256,15,10627165,5300,260
2020-04-24,Dominican_Republic,DO,243,5,10627165,5543,265
2020-04-25,Dominican_Republic,DO,206,2,10627165,5749,267
2020-04-26,Dominican_Republic,DO,177,6,10627165,5926,273
2020-04-27,Dominican_Republic,DO,209,5,10627165,6135,278
2020-04-28,Dominican_Republic,DO,0,0,10627165,6135,278
2020-04-29,Dominican_Republic,DO,281,8,10627165,6416,286
2020-04-30,Dominican_Republic,DO,236,7,10627165,6652,293
2020-05-01,Dominican_Republic,DO,320,8,10627165,6972,301
2020-05-02,Dominican_Republic,DO,316,12,10627165,7288,313
2020-05-03,Dominican_Republic,DO,290,13,10627165,7578,326
2019-12-31,Algeria,DZ,0,0,42228429,0,0
2020-01-01,Algeria,DZ,0,0,42228429,0,0
2020-01-02,Algeria,DZ,0,0,42228429,0,0
2020-01-03,Algeria,DZ,0,0,42228429,0,0
2020-01-04,Algeria,DZ,0,0,42228429,0,0
2020-01-05,Algeria,DZ,0,0,42228429,0,0
2020-01-06,Algeria,DZ,0,0,42228429,0,0
2020-01-07,Algeria,DZ,0,0,42228429,0,0
2020-01-08,Algeria,DZ,0,0,42228429,0,0
2020-01-09,Algeria,DZ,0,0,42228429,0,0
2020-01-10,Algeria,DZ,0,0,42228429,0,0
2020-01-11,Algeria,DZ,0,0,42228429,0,0
2020-01-12,Algeria,DZ,0,0,42228429,0,0
2020-01-13,Algeria,DZ,0,0,42228429,0,0
2020-01-14,Algeria,DZ,0,0,42228429,0,0
2020-01-15,Algeria,DZ,0,0,42228429,0,0
2020-01-16,Algeria,DZ,0,0,42228429,0,0
2020-01-17,Algeria,DZ,0,0,42228429,0,0
2020-01-18,Algeria,DZ,0,0,42228429,0,0
2020-01-19,Algeria,DZ,0,0,42228429,0,0
2020-01-20,Algeria,DZ,0,0,42228429,0,0
2020-01-21,Algeria,DZ,0,0,42228429,0,0
2020-01-22,Algeria,DZ,0,0,42228429,0,0
2020-01-23,Algeria,DZ,0,0,42228429,0,0
2020-01-24,Algeria,DZ,0,0,42228429,0,0
2020-01-25,Algeria,DZ,0,0,42228429,0,0
2020-01-26,Algeria,DZ,0,0,42228429,0,0
2020-01-27,Algeria,DZ,0,0,42228429,0,0
2020-01-28,Algeria,DZ,0,0,42228429,0,0
2020-01-29,Algeria,DZ,0,0,42228429,0,0
2020-01-30,Algeria,DZ,0,0,42228429,0,0
2020-01-31,Algeria,DZ,0,0,42228429,0,0
2020-02-01,Algeria,DZ,0,0,42228429,0,0
2020-02-02,Algeria,DZ,0,0,42228429,0,0
2020-02-03,Algeria,DZ,0,0,42228429,0,0
2020-02-04,Algeria,DZ,0,0,42228429,0,0
2020-02-05,Algeria,DZ,0,0,42228429,0,0
2020-02-06,Algeria,DZ,0,0,42228429,0,0
2020-02-07,Algeria,DZ,0,0,42228429,0,0
2020-02-08,Algeria,DZ,0,0,42228429,0,0
2020-02-09,Algeria,DZ,0,0,42228429,0,0
2020-02-10,Algeria,DZ,0,0,42228429,0,0
2020-02-11,Algeria,DZ,0,0,42228429,0,0
2020-02-12,Algeria,DZ,0,0,42228429,0,0
2020-02-13,Algeria,DZ,0,0,42228429,0,0
2020-02-14,Algeria,DZ,0,0,42228429,0,0
2020-02-15,Algeria,DZ,0,0,42228429,0,0
2020-02-16,Algeria,DZ,0,0,42228429,0,0
2020-02-17,Algeria,DZ,0,0,42228429,0,0
2020-02-18,Algeria,DZ,0,0,42228429,0,0
2020-02-19,Algeria,DZ,0,0,42228429,0,0
2020-02-20,Algeria,DZ,0,0,42228429,0,0
2020-02-21,Algeria,DZ,0,0,42228429,0,0
2020-02-22,Algeria,DZ,0,0,42228429,0,0
2020-02-23,Algeria,DZ,0,0,42228429,0,0
2020-02-24,Algeria,DZ,0,0,42228429,0,0
2020-02-25,Algeria,DZ,0,0,42228429,0,0
2020-02-26,Algeria,DZ,1,0,42228429,1,0
2020-02-27,Algeria,DZ,0,0,42228429,1,0
2020-02-28,Algeria,DZ,0,0,42228429,1,0
2020-02-29,Algeria,DZ,0,0,42228429,1,0
2020-03-01,Algeria,DZ,2,0,42228429,3,0
2020-03-02,Algeria,DZ,0,0,42228429,3,0
2020-03-04,Algeria,DZ,2,0,42228429,5,0
2020-03-05,Algeria,DZ,7,0,42228429,12,0
2020-03-06,Algeria,DZ,5,0,42228429,17,0
2020-03-09,Algeria,DZ,3,0,42228429,20,0
2020-03-12,Algeria,DZ,0,0,42228429,20,0
2020-03-13,Algeria,DZ,5,1,42228429,25,1
2020-03-14,Algeria,DZ,1,1,42228429,26,2
2020-03-15,Algeria,DZ,11,0,42228429,37,2
2020-03-16,Algeria,DZ,11,2,42228429,48,4
2020-03-17,Algeria,DZ,10,0,42228429,58,4
2020-03-18,Algeria,DZ,2,1,42228429,60,5
2020-03-19,Algeria,DZ,12,1,42228429,72,6
2020-03-20,Algeria,DZ,18,1,42228429,90,7
2020-03-21,Algeria,DZ,12,3,42228429,102,10
2020-03-22,Algeria,DZ,37,5,42228429,139,15
2020-03-23,Algeria,DZ,62,2,42228429,201,17
2020-03-24,Algeria,DZ,29,0,42228429,230,17
2020-03-25,Algeria,DZ,34,2,42228429,264,19
2020-03-26,Algeria,DZ,38,2,42228429,302,21
2020-03-27,Algeria,DZ,65,4,42228429,367,25
2020-03-28,Algeria,DZ,42,1,42228429,409,26
2020-03-29,Algeria,DZ,45,3,42228429,454,29
2020-03-30,Algeria,DZ,57,2,42228429,511,31
2020-03-31,Algeria,DZ,73,4,42228429,584,35
2020-04-01,Algeria,DZ,132,9,42228429,716,44
2020-04-02,Algeria,DZ,131,14,42228429,847,58
2020-04-03,Algeria,DZ,139,5,42228429,986,63
2020-04-04,Algeria,DZ,185,42,42228429,1171,105
2020-04-05,Algeria,DZ,80,25,42228429,1251,130
2020-04-06,Algeria,DZ,69,22,42228429,1320,152
2020-04-07,Algeria,DZ,103,21,42228429,1423,173
2020-04-08,Algeria,DZ,45,20,42228429,1468,193
2020-04-09,Algeria,DZ,104,12,42228429,1572,205
2020-04-10,Algeria,DZ,94,30,42228429,1666,235
2020-04-11,Algeria,DZ,95,21,42228429,1761,256
2020-04-12,Algeria,DZ,64,19,42228429,1825,275
2020-04-13,Algeria,DZ,89,18,42228429,1914,293
2020-04-14,Algeria,DZ,69,20,42228429,1983,313
2020-04-15,Algeria,DZ,87,12,42228429,2070,325
2020-04-16,Algeria,DZ,90,11,42228429,2160,336
2020-04-17,Algeria,DZ,108,12,42228429,2268,348
2020-04-18,Algeria,DZ,150,16,42228429,2418,364
2020-04-19,Algeria,DZ,117,3,42228429,2535,367
2020-04-20,Algeria,DZ,94,8,42228429,2629,375
2020-04-21,Algeria,DZ,89,9,42228429,2718,384
2020-04-22,Algeria,DZ,93,8,42228429,2811,392
2020-04-23,Algeria,DZ,99,10,42228429,2910,402
2020-04-24,Algeria,DZ,97,5,42228429,3007,407
2020-04-25,Algeria,DZ,120,8,42228429,3127,415
2020-04-26,Algeria,DZ,129,4,42228429,3256,419
2020-04-27,Algeria,DZ,126,6,42228429,3382,425
2020-04-28,Algeria,DZ,135,7,42228429,3517,432
2020-04-29,Algeria,DZ,132,5,42228429,3649,437
2020-04-30,Algeria,DZ,199,7,42228429,3848,444
2020-05-01,Algeria,DZ,158,6,42228429,4006,450
2020-05-02,Algeria,DZ,148,3,42228429,4154,453
2020-05-03,Algeria,DZ,141,6,42228429,4295,459
2019-12-31,Ecuador,EC,0,0,17084357,0,0
2020-01-01,Ecuador,EC,0,0,17084357,0,0
2020-01-02,Ecuador,EC,0,0,17084357,0,0
2020-01-03,Ecuador,EC,0,0,17084357,0,0
2020-01-04,Ecuador,EC,0,0,17084357,0,0
2020-01-05,Ecuador,EC,0,0,17084357,0,0
2020-01-06,Ecuador,EC,0,0,17084357,0,0
2020-01-07,Ecuador,EC,0,0,17084357,0,0
2020-01-08,Ecuador,EC,0,0,17084357,0,0
2020-01-09,Ecuador,EC,0,0,17084357,0,0
2020-01-10,Ecuador,EC,0,0,17084357,0,0
2020-01-11,Ecuador,EC,0,0,17084357,0,0
2020-01-12,Ecuador,EC,0,0,17084357,0,0
2020-01-13,Ecuador,EC,0,0,17084357,0,0
2020-01-14,Ecuador,EC,0,0,17084357,0,0
2020-01-15,Ecuador,EC,0,0,17084357,0,0
2020-01-16,Ecuador,EC,0,0,17084357,0,0
2020-01-17,Ecuador,EC,0,0,17084357,0,0
2020-01-18,Ecuador,EC,0,0,17084357,0,0
2020-01-19,Ecuador,EC,0,0,17084357,0,0
2020-01-20,Ecuador,EC,0,0,17084357,0,0
2020-01-21,Ecuador,EC,0,0,17084357,0,0
2020-01-22,Ecuador,EC,0,0,17084357,0,0
2020-01-23,Ecuador,EC,0,0,17084357,0,0
2020-01-24,Ecuador,EC,0,0,17084357,0,0
2020-01-25,Ecuador,EC,0,0,17084357,0,0
2020-01-26,Ecuador,EC,0,0,17084357,0,0
2020-01-27,Ecuador,EC,0,0,17084357,0,0
2020-01-28,Ecuador,EC,0,0,17084357,0,0
2020-01-29,Ecuador,EC,0,0,17084357,0,0
2020-01-30,Ecuador,EC,0,0,17084357,0,0
2020-01-31,Ecuador,EC,0,0,17084357,0,0
2020-02-01,Ecuador,EC,0,0,17084357,0,0
2020-02-02,Ecuador,EC,0,0,17084357,0,0
2020-02-03,Ecuador,EC,0,0,17084357,0,0
2020-02-04,Ecuador,EC,0,0,17084357,0,0
2020-02-05,Ecuador,EC,0,0,17084357,0,0
2020-02-06,Ecuador,EC,0,0,17084357,0,0
2020-02-07,Ecuador,EC,0,0,17084357,0,0
2020-02-08,Ecuador,EC,0,0,17084357,0,0
2020-02-09,Ecuador,EC,0,0,17084357,0,0
2020-02-10,Ecuador,EC,0,0,17084357,0,0
2020-02-11,Ecuador,EC,0,0,17084357,0,0
2020-02-12,Ecuador,EC,0,0,17084357,0,0
2020-02-13,Ecuador,EC,0,0,17084357,0,0
2020-02-14,Ecuador,EC,0,0,17084357,0,0
2020-02-15,Ecuador,EC,0,0,17084357,0,0
2020-02-16,Ecuador,EC,0,0,17084357,0,0
2020-02-17,Ecuador,EC,0,0,17084357,0,0
2020-02-18,Ecuador,EC,0,0,17084357,0,0
2020-02-19,Ecuador,EC,0,0,17084357,0,0
2020-02-20,Ecuador,EC,0,0,17084357,0,0
2020-02-21,Ecuador,EC,0,0,17084357,0,0
2020-02-22,Ecuador,EC,0,0,17084357,0,0
2020-02-23,Ecuador,EC,0,0,17084357,0,0
2020-02-24,Ecuador,EC,0,0,17084357,0,0
2020-02-25,Ecuador,EC,0,0,17084357,0,0
2020-02-26,Ecuador,EC,0,0,17084357,0,0
2020-02-27,Ecuador,EC,0,0,17084357,0,0
2020-02-28,Ecuador,EC,0,0,17084357,0,0
2020-02-29,Ecuador,EC,0,0,17084357,0,0
2020-03-01,Ecuador,EC,1,0,17084357,1,0
2020-03-02,Ecuador,EC,5,0,17084357,6,0
2020-03-03,Ecuador,EC,1,0,17084357,7,0
2020-03-05,Ecuador,EC,3,0,17084357,10,0
2020-03-06,Ecuador,EC,3,0,17084357,13,0
2020-03-09,Ecuador,EC,1,0,17084357,14,0
2020-03-10,Ecuador,EC,1,0,17084357,15,0
2020-03-11,Ecuador,EC,2,0,17084357,17,0
2020-03-14,Ecuador,EC,6,1,17084357,23,1
2020-03-15,Ecuador,EC,5,1,17084357,28,2
2020-03-16,Ecuador,EC,9,0,17084357,37,2
2020-03-17,Ecuador,EC,21,0,17084357,58,2
2020-03-18,Ecuador,EC,53,0,17084357,111,2
2020-03-19,Ecuador,EC,57,1,17084357,168,3
2020-03-20,Ecuador,EC,31,0,17084357,199,3
2020-03-21,Ecuador,EC,227,4,17084357,426,7
2020-03-22,Ecuador,EC,106,0,17084357,532,7
2020-03-23,Ecuador,EC,257,7,17084357,789,14
2020-03-24,Ecuador,EC,192,4,17084357,981,18
2020-03-25,Ecuador,EC,101,9,17084357,1082,27
2020-03-26,Ecuador,EC,129,2,17084357,1211,29
2020-03-27,Ecuador,EC,192,5,17084357,1403,34
2020-03-28,Ecuador,EC,224,7,17084357,1627,41
2020-03-29,Ecuador,EC,208,7,17084357,1835,48
2020-03-30,Ecuador,EC,55,10,17084357,1890,58
2020-03-31,Ecuador,EC,76,4,17084357,1966,62
2020-04-01,Ecuador,EC,336,17,17084357,2302,79
2020-04-02,Ecuador,EC,456,41,17084357,2758,120
2020-04-03,Ecuador,EC,405,0,17084357,3163,120
2020-04-04,Ecuador,EC,205,25,17084357,3368,145
2020-04-05,Ecuador,EC,97,27,17084357,3465,172
2020-04-06,Ecuador,EC,181,8,17084357,3646,180
2020-04-07,Ecuador,EC,101,11,17084357,3747,191
2020-04-08,Ecuador,EC,248,29,17084357,3995,220
2020-04-09,Ecuador,EC,455,22,17084357,4450,242
2020-04-10,Ecuador,EC,515,30,17084357,4965,272
2020-04-11,Ecuador,EC,2196,25,17084357,7161,297
2020-04-12,Ecuador,EC,96,18,17084357,7257,315
2020-04-13,Ecuador,EC,209,18,17084357,7466,333
2020-04-14,Ecuador,EC,63,22,17084357,7529,355
2020-04-15,Ecuador,EC,74,0,17084357,7603,355
2020-04-16,Ecuador,EC,255,33,17084357,7858,388
2020-04-17,Ecuador,EC,367,15,17084357,8225,403
2020-04-18,Ecuador,EC,225,18,17084357,8450,421
2020-04-19,Ecuador,EC,572,35,17084357,9022,456
2020-04-20,Ecuador,EC,446,18,17084357,9468,474
2020-04-21,Ecuador,EC,660,33,17084357,10128,507
2020-04-22,Ecuador,EC,270,13,17084357,10398,520
2020-04-23,Ecuador,EC,452,17,17084357,10850,537
2020-04-24,Ecuador,EC,333,23,17084357,11183,560
2020-04-25,Ecuador,EC,0,16,17084357,11183,576
2020-04-26,Ecuador,EC,0,0,17084357,11183,576
2020-04-27,Ecuador,EC,11536,0,17084357,22719,576
2020-04-28,Ecuador,EC,521,87,17084357,23240,663
2020-04-29,Ecuador,EC,1018,208,17084357,24258,871
2020-04-30,Ecuador,EC,417,12,17084357,24675,883
2020-05-01,Ecuador,EC,259,17,17084357,24934,900
2020-05-02,Ecuador,EC,1402,163,17084357,26336,1063
2020-05-03,Ecuador,EC,1128,308,17084357,27464,1371
2019-12-31,Estonia,EE,0,0,1320884,0,0
2020-01-01,Estonia,EE,0,0,1320884,0,0
2020-01-02,Estonia,EE,0,0,1320884,0,0
2020-01-03,Estonia,EE,0,0,1320884,0,0
2020-01-04,Estonia,EE,0,0,1320884,0,0
2020-01-05,Estonia,EE,0,0,1320884,0,0
2020-01-06,Estonia,EE,0,0,1320884,0,0
2020-01-07,Estonia,EE,0,0,1320884,0,0
2020-01-08,Estonia,EE,0,0,1320884,0,0
2020-01-09,Estonia,EE,0,0,1320884,0,0
2020-01-10,Estonia,EE,0,0,1320884,0,0
2020-01-11,Estonia,EE,0,0,1320884,0,0
2020-01-12,Estonia,EE,0,0,1320884,0,0
2020-01-13,Estonia,EE,0,0,1320884,0,0
2020-01-14,Estonia,EE,0,0,1320884,0,0
2020-01-15,Estonia,EE,0,0,1320884,0,0
2020-01-16,Estonia,EE,0,0,1320884,0,0
2020-01-17,Estonia,EE,0,0,1320884,0,0
2020-01-18,Estonia,EE,0,0,1320884,0,0
2020-01-19,Estonia,EE,0,0,1320884,0,0
2020-01-20,Estonia,EE,0,0,1320884,0,0
2020-01-21,Estonia,EE,0,0,1320884,0,0
2020-01-22,Estonia,EE,0,0,1320884,0,0
2020-01-23,Estonia,EE,0,0,1320884,0,0
2020-01-24,Estonia,EE,0,0,1320884,0,0
2020-01-25,Estonia,EE,0,0,1320884,0,0
2020-01-26,Estonia,EE,0,0,1320884,0,0
2020-01-27,Estonia,EE,0,0,1320884,0,0
2020-01-28,Estonia,EE,0,0,1320884,0,0
2020-01-29,Estonia,EE,0,0,1320884,0,0
2020-01-30,Estonia,EE,0,0,1320884,0,0
2020-01-31,Estonia,EE,0,0,1320884,0,0
2020-02-01,Estonia,EE,0,0,1320884,0,0
2020-02-02,Estonia,EE,0,0,1320884,0,0
2020-02-03,Estonia,EE,0,0,1320884,0,0
2020-02-04,Estonia,EE,0,0,1320884,0,0
2020-02-05,Estonia,EE,0,0,1320884,0,0
2020-02-06,Estonia,EE,0,0,1320884,0,0
2020-02-07,Estonia,EE,0,0,1320884,0,0
2020-02-08,Estonia,EE,0,0,1320884,0,0
2020-02-09,Estonia,EE,0,0,1320884,0,0
2020-02-10,Estonia,EE,0,0,1320884,0,0
2020-02-11,Estonia,EE,0,0,1320884,0,0
2020-02-12,Estonia,EE,0,0,1320884,0,0
2020-02-13,Estonia,EE,0,0,1320884,0,0
2020-02-14,Estonia,EE,0,0,1320884,0,0
2020-02-15,Estonia,EE,0,0,1320884,0,0
2020-02-16,Estonia,EE,0,0,1320884,0,0
2020-02-17,Estonia,EE,0,0,1320884,0,0
2020-02-18,Estonia,EE,0,0,1320884,0,0
2020-02-19,Estonia,EE,0,0,1320884,0,0
2020-02-20,Estonia,EE,0,0,1320884,0,0
2020-02-21,Estonia,EE,0,0,1320884,0,0
2020-02-22,Estonia,EE,0,0,1320884,0,0
2020-02-23,Estonia,EE,0,0,1320884,0,0
2020-02-24,Estonia,EE,0,0,1320884,0,0
2020-02-25,Estonia,EE,0,0,1320884,0,0
2020-02-26,Estonia,EE,0,0,1320884,0,0
2020-02-27,Estonia,EE,0,0,1320884,0,0
2020-02-28,Estonia,EE,1,0,1320884,1,0
2020-02-29,Estonia,EE,0,0,1320884,1,0
2020-03-01,Estonia,EE,0,0,1320884,1,0
2020-03-02,Estonia,EE,0,0,1320884,1,0
2020-03-04,Estonia,EE,1,0,1320884,2,0
2020-03-06,Estonia,EE,3,0,1320884,5,0
2020-03-07,Estonia,EE,5,0,1320884,10,0
2020-03-11,Estonia,EE,3,0,1320884,13,0
2020-03-12,Estonia,EE,3,0,1320884,16,0
2020-03-13,Estonia,EE,11,0,1320884,27,0
2020-03-14,Estonia,EE,52,0,1320884,79,0
2020-03-15,Estonia,EE,36,0,1320884,115,0
2020-03-16,Estonia,EE,56,0,1320884,171,0
2020-03-17,Estonia,EE,34,0,1320884,205,0
2020-03-18,Estonia,EE,20,0,1320884,225,0
2020-03-19,Estonia,EE,33,0,1320884,258,0
2020-03-20,Estonia,EE,9,0,1320884,267,0
2020-03-21,Estonia,EE,16,0,1320884,283,0
2020-03-22,Estonia,EE,23,0,1320884,306,0
2020-03-23,Estonia,EE,20,0,1320884,326,0
2020-03-24,Estonia,EE,26,0,1320884,352,0
2020-03-25,Estonia,EE,17,0,1320884,369,0
2020-03-26,Estonia,EE,35,1,1320884,404,1
2020-03-27,Estonia,EE,134,0,1320884,538,1
2020-03-28,Estonia,EE,37,0,1320884,575,1
2020-03-29,Estonia,EE,65,0,1320884,640,1
2020-03-30,Estonia,EE,39,2,1320884,679,3
2020-03-31,Estonia,EE,36,0,1320884,715,3
2020-04-01,Estonia,EE,30,1,1320884,745,4
2020-04-02,Estonia,EE,34,1,1320884,779,5
2020-04-03,Estonia,EE,79,6,1320884,858,11
2020-04-04,Estonia,EE,103,1,1320884,961,12
2020-04-05,Estonia,EE,57,1,1320884,1018,13
2020-04-06,Estonia,EE,79,2,1320884,1097,15
2020-04-07,Estonia,EE,11,4,1320884,1108,19
2020-04-08,Estonia,EE,41,2,1320884,1149,21
2020-04-09,Estonia,EE,36,3,1320884,1185,24
2020-04-10,Estonia,EE,22,0,1320884,1207,24
2020-04-11,Estonia,EE,51,0,1320884,1258,24
2020-04-12,Estonia,EE,46,0,1320884,1304,24
2020-04-13,Estonia,EE,5,1,1320884,1309,25
2020-04-14,Estonia,EE,23,3,1320884,1332,28
2020-04-15,Estonia,EE,41,3,1320884,1373,31
2020-04-16,Estonia,EE,29,4,1320884,1402,35
2020-04-17,Estonia,EE,32,1,1320884,1434,36
2020-04-18,Estonia,EE,25,2,1320884,1459,38
2020-04-19,Estonia,EE,53,0,1320884,1512,38
2020-04-20,Estonia,EE,16,2,1320884,1528,40
2020-04-21,Estonia,EE,7,0,1320884,1535,40
2020-04-22,Estonia,EE,17,3,1320884,1552,43
2020-04-23,Estonia,EE,7,1,1320884,1559,44
2020-04-24,Estonia,EE,33,1,1320884,1592,45
2020-04-25,Estonia,EE,13,1,1320884,1605,46
2020-04-26,Estonia,EE,30,0,1320884,1635,46
2020-04-27,Estonia,EE,8,3,1320884,1643,49
2020-04-28,Estonia,EE,4,1,1320884,1647,50
2020-04-29,Estonia,EE,13,0,1320884,1660,50
2020-04-30,Estonia,EE,6,0,1320884,1666,50
2020-05-01,Estonia,EE,23,2,1320884,1689,52
2020-05-02,Estonia,EE,5,0,1320884,1694,52
2020-05-03,Estonia,EE,5,1,1320884,1699,53
2019-12-31,Egypt,EG,0,0,98423595,0,0
2020-01-01,Egypt,EG,0,0,98423595,0,0
2020-01-02,Egypt,EG,0,0,98423595,0,0
2020-01-03,Egypt,EG,0,0,98423595,0,0
2020-01-04,Egypt,EG,0,0,98423595,0,0
2020-01-05,Egypt,EG,0,0,98423595,0,0
2020-01-06,Egypt,EG,0,0,98423595,0,0
2020-01-07,Egypt,EG,0,0,98423595,0,0
2020-01-08,Egypt,EG,0,0,98423595,0,0
2020-01-09,Egypt,EG,0,0,98423595,0,0
2020-01-10,Egypt,EG,0,0,98423595,0,0
2020-01-11,Egypt,EG,0,0,98423595,0,0
2020-01-12,Egypt,EG,0,0,98423595,0,0
2020-01-13,Egypt,EG,0,0,98423595,0,0
2020-01-14,Egypt,EG,0,0,98423595,0,0
2020-01-15,Egypt,EG,0,0,98423595,0,0
2020-01-16,Egypt,EG,0,0,98423595,0,0
2020-01-17,Egypt,EG,0,0,98423595,0,0
2020-01-18,Egypt,EG,0,0,98423595,0,0
2020-01-19,Egypt,EG,0,0,98423595,0,0
2020-01-20,Egypt,EG,0,0,98423595,0,0
2020-01-21,Egypt,EG,0,0,98423595,0,0
2020-01-22,Egypt,EG,0,0,98423595,0,0
2020-01-23,Egypt,EG,0,0,98423595,0,0
2020-01-24,Egypt,EG,0,0,98423595,0,0
2020-01-25,Egypt,EG,0,0,98423595,0,0
2020-01-26,Egypt,EG,0,0,98423595,0,0
2020-01-27,Egypt,EG,0,0,98423595,0,0
2020-01-28,Egypt,EG,0,0,98423595,0,0
2020-01-29,Egypt,EG,0,0,98423595,0,0
2020-01-30,Egypt,EG,0,0,98423595,0,0
2020-01-31,Egypt,EG,0,0,98423595,0,0
2020-02-01,Egypt,EG,0,0,98423595,0,0
2020-02-02,Egypt,EG,0,0,98423595,0,0
2020-02-03,Egypt,EG,0,0,98423595,0,0
2020-02-04,Egypt,EG,0,0,98423595,0,0
2020-02-05,Egypt,EG,0,0,98423595,0,0
2020-02-06,Egypt,EG,0,0,98423595,0,0
2020-02-07,Egypt,EG,0,0,98423595,0,0
2020-02-08,Egypt,EG,0,0,98423595,0,0
2020-02-09,Egypt,EG,0,0,98423595,0,0
2020-02-10,Egypt,EG,0,0,98423595,0,0
2020-02-11,Egypt,EG,0,0,98423595,0,0
2020-02-12,Egypt,EG,0,0,98423595,0,0
2020-02-13,Egypt,EG,0,0,98423595,0,0
2020-02-14,Egypt,EG,0,0,98423595,0,0
2020-02-15,Egypt,EG,1,0,98423595,1,0
2020-02-16,Egypt,EG,0,0,98423595,1,0
2020-02-17,Egypt,EG,0,0,98423595,1,0
2020-02-18,Egypt,EG,0,0,98423595,1,0
2020-02-19,Egypt,EG,0,0,98423595,1,0
2020-02-20,Egypt,EG,0,0,98423595,1,0
2020-02-21,Egypt,EG,0,0,98423595,1,0
2020-02-22,Egypt,EG,0,0,98423595,1,0
2020-02-23,Egypt,EG,0,0,98423595,1,0
2020-02-24,Egypt,EG,0,0,98423595,1,0
2020-02-25,Egypt,EG,0,0,98423595,1,0
2020-02-26,Egypt,EG,0,0,98423595,1,0
2020-02-27,Egypt,EG,0,0,98423595,1,0
2020-02-28,Egypt,EG,0,0,98423595,1,0
2020-02-29,Egypt,EG,0,0,98423595,1,0
2020-03-01,Egypt,EG,0,0,98423595,1,0
2020-03-02,Egypt,EG,1,0,98423595,2,0
2020-03-06,Egypt,EG,1,0,98423595,3,0
2020-03-07,Egypt,EG,12,0,98423595,15,0
2020-03-09,Egypt,EG,34,1,98423595,49,1
2020-03-10,Egypt,EG,6,0,98423595,55,1
2020-03-11,Egypt,EG,4,0,98423595,59,1
2020-03-12,Egypt,EG,1,0,98423595,60,1
2020-03-13,Egypt,EG,20,1,98423595,80,2
2020-03-14,Egypt,EG,13,0,98423595,93,2
2020-03-15,Egypt,EG,0,0,98423595,93,2
2020-03-16,Egypt,EG,17,0,98423595,110,2
2020-03-17,Egypt,EG,16,0,98423595,126,2
2020-03-18,Egypt,EG,40,2,98423595,166,4
2020-03-19,Egypt,EG,30,2,98423595,196,6
2020-03-20,Egypt,EG,14,0,98423595,210,6
2020-03-21,Egypt,EG,46,1,98423595,256,7
2020-03-22,Egypt,EG,29,1,98423595,285,8
2020-03-23,Egypt,EG,9,2,98423595,294,10
2020-03-24,Egypt,EG,33,4,98423595,327,14
2020-03-25,Egypt,EG,39,5,98423595,366,19
2020-03-26,Egypt,EG,76,2,98423595,442,21
2020-03-27,Egypt,EG,14,0,98423595,456,21
2020-03-28,Egypt,EG,39,3,98423595,495,24
2020-03-29,Egypt,EG,41,6,98423595,536,30
2020-03-30,Egypt,EG,40,6,98423595,576,36
2020-03-31,Egypt,EG,33,4,98423595,609,40
2020-04-01,Egypt,EG,47,1,98423595,656,41
2020-04-02,Egypt,EG,54,5,98423595,710,46
2020-04-03,Egypt,EG,69,6,98423595,779,52
2020-04-04,Egypt,EG,0,0,98423595,779,52
2020-04-05,Egypt,EG,206,14,98423595,985,66
2020-04-06,Egypt,EG,85,5,98423595,1070,71
2020-04-07,Egypt,EG,3,7,98423595,1073,78
2020-04-08,Egypt,EG,249,7,98423595,1322,85
2020-04-09,Egypt,EG,238,18,98423595,1560,103
2020-04-10,Egypt,EG,139,15,98423595,1699,118
2020-04-11,Egypt,EG,95,17,98423595,1794,135
2020-04-12,Egypt,EG,145,11,98423595,1939,146
2020-04-13,Egypt,EG,126,13,98423595,2065,159
2020-04-14,Egypt,EG,125,5,98423595,2190,164
2020-04-15,Egypt,EG,160,14,98423595,2350,178
2020-04-16,Egypt,EG,155,5,98423595,2505,183
2020-04-17,Egypt,EG,168,13,98423595,2673,196
2020-04-18,Egypt,EG,171,9,98423595,2844,205
2020-04-19,Egypt,EG,188,19,98423595,3032,224
2020-04-20,Egypt,EG,112,15,98423595,3144,239
2020-04-21,Egypt,EG,189,11,98423595,3333,250
2020-04-22,Egypt,EG,157,14,98423595,3490,264
2020-04-23,Egypt,EG,0,0,98423595,3490,264
2020-04-24,Egypt,EG,169,12,98423595,3659,276
2020-04-25,Egypt,EG,433,18,98423595,4092,294
2020-04-26,Egypt,EG,227,13,98423595,4319,307
2020-04-27,Egypt,EG,0,0,98423595,4319,307
2020-04-28,Egypt,EG,463,30,98423595,4782,337
2020-04-29,Egypt,EG,260,22,98423595,5042,359
2020-04-30,Egypt,EG,226,21,98423595,5268,380
2020-05-01,Egypt,EG,269,12,98423595,5537,392
2020-05-02,Egypt,EG,358,14,98423595,5895,406
2020-05-03,Egypt,EG,298,9,98423595,6193,415
2020-04-26,Western_Sahara,EH,6,0,0,6,0
2020-04-27,Western_Sahara,EH,0,0,0,6,0
2020-04-28,Western_Sahara,EH,0,0,0,6,0
2020-04-29,Western_Sahara,EH,0,0,0,6,0
2020-04-30,Western_Sahara,EH,0,0,0,6,0
2020-05-01,Western_Sahara,EH,0,0,0,6,0
2020-05-02,Western_Sahara,EH,0,0,0,6,0
2020-05-03,Western_Sahara,EH,0,0,0,6,0
2019-12-31,Greece,EL,0,0,10727668,0,0
2020-01-01,Greece,EL,0,0,10727668,0,0
2020-01-02,Greece,EL,0,0,10727668,0,0
2020-01-03,Greece,EL,0,0,10727668,0,0
2020-01-04,Greece,EL,0,0,10727668,0,0
2020-01-05,Greece,EL,0,0,10727668,0,0
2020-01-06,Greece,EL,0,0,10727668,0,0
2020-01-07,Greece,EL,0,0,10727668,0,0
2020-01-08,Greece,EL,0,0,10727668,0,0
2020-01-09,Greece,EL,0,0,10727668,0,0
2020-01-10,Greece,EL,0,0,10727668,0,0
2020-01-11,Greece,EL,0,0,10727668,0,0
2020-01-12,Greece,EL,0,0,10727668,0,0
2020-01-13,Greece,EL,0,0,10727668,0,0
2020-01-14,Greece,EL,0,0,10727668,0,0
2020-01-15,Greece,EL,0,0,10727668,0,0
2020-01-16,Greece,EL,0,0,10727668,0,0
2020-01-17,Greece,EL,0,0,10727668,0,0
2020-01-18,Greece,EL,0,0,10727668,0,0
2020-01-19,Greece,EL,0,0,10727668,0,0
2020-01-20,Greece,EL,0,0,10727668,0,0
2020-01-21,Greece,EL,0,0,10727668,0,0
2020-01-22,Greece,EL,0,0,10727668,0,0
2020-01-23,Greece,EL,0,0,10727668,0,0
2020-01-24,Greece,EL,0,0,10727668,0,0
2020-01-25,Greece,EL,0,0,10727668,0,0
2020-01-26,Greece,EL,0,0,10727668,0,0
2020-01-27,Greece,EL,0,0,10727668,0,0
2020-01-28,Greece,EL,0,0,10727668,0,0
2020-01-29,Greece,EL,0,0,10727668,0,0
2020-01-30,Greece,EL,0,0,10727668,0,0
2020-01-31,Greece,EL,0,0,10727668,0,0
2020-02-01,Greece,EL,0,0,10727668,0,0
2020-02-02,Greece,EL,0,0,10727668,0,0
2020-02-03,Greece,EL,0,0,10727668,0,0
2020-02-04,Greece,EL,0,0,10727668,0,0
2020-02-05,Greece,EL,0,0,10727668,0,0
2020-02-06,Greece,EL,0,0,10727668,0,0
2020-02-07,Greece,EL,0,0,10727668,0,0
2020-02-08,Greece,EL,0,0,10727668,0,0
2020-02-09,Greece,EL,0,0,10727668,0,0
2020-02-10,Greece,EL,0,0,10727668,0,0
2020-02-11,Greece,EL,0,0,10727668,0,0
2020-02-12,Greece,EL,0,0,10727668,0,0
2020-02-13,Greece,EL,0,0,10727668,0,0
2020-02-14,Greece,EL,0,0,10727668,0,0
2020-02-15,Greece,EL,0,0,10727668,0,0
2020-02-16,Greece,EL,0,0,10727668,0,0
2020-02-17,Greece,EL,0,0,10727668,0,0
2020-02-18,Greece,EL,0,0,10727668,0,0
2020-02-19,Greece,EL,0,0,10727668,0,0
2020-02-20,Greece,EL,0,0,10727668,0,0
2020-02-21,Greece,EL,0,0,10727668,0,0
2020-02-22,Greece,EL,0,0,10727668,0,0
2020-02-23,Greece,EL,0,0,10727668,0,0
2020-02-24,Greece,EL,0,0,10727668,0,0
2020-02-25,Greece,EL,0,0,10727668,0,0
2020-02-26,Greece,EL,0,0,10727668,0,0
2020-02-27,Greece,EL,1,0,10727668,1,0
2020-02-28,Greece,EL,2,0,10727668,3,0
2020-02-29,Greece,EL,1,0,10727668,4,0
2020-03-01,Greece,EL,3,0,10727668,7,0
2020-03-02,Greece,EL,0,0,10727668,7,0
2020-03-05,Greece,EL,3,0,10727668,10,0
2020-03-06,Greece,EL,22,0,10727668,32,0
2020-03-07,Greece,EL,13,0,10727668,45,0
2020-03-08,Greece,EL,21,0,10727668,66,0
2020-03-09,Greece,EL,7,0,10727668,73,0
2020-03-10,Greece,EL,11,0,10727668,84,0
2020-03-11,Greece,EL,6,0,10727668,90,0
2020-03-12,Greece,EL,9,1,10727668,99,1
2020-03-13,Greece,EL,34,0,10727668,133,1
2020-03-14,Greece,EL,57,0,10727668,190,1
2020-03-15,Greece,EL,38,2,10727668,228,3
2020-03-16,Greece,EL,103,1,10727668,331,4
2020-03-17,Greece,EL,21,0,10727668,352,4
2020-03-18,Greece,EL,35,1,10727668,387,5
2020-03-19,Greece,EL,31,0,10727668,418,5
2020-03-20,Greece,EL,46,0,10727668,464,5
2020-03-21,Greece,EL,31,3,10727668,495,8
2020-03-22,Greece,EL,35,5,10727668,530,13
2020-03-23,Greece,EL,94,2,10727668,624,15
2020-03-24,Greece,EL,71,2,10727668,695,17
2020-03-25,Greece,EL,48,3,10727668,743,20
2020-03-26,Greece,EL,78,2,10727668,821,22
2020-03-27,Greece,EL,71,4,10727668,892,26
2020-03-28,Greece,EL,74,2,10727668,966,28
2020-03-29,Greece,EL,95,4,10727668,1061,32
2020-03-30,Greece,EL,95,6,10727668,1156,38
2020-03-31,Greece,EL,56,5,10727668,1212,43
2020-04-01,Greece,EL,102,6,10727668,1314,49
2020-04-02,Greece,EL,61,1,10727668,1375,50
2020-04-03,Greece,EL,139,3,10727668,1514,53
2020-04-04,Greece,EL,99,6,10727668,1613,59
2020-04-05,Greece,EL,60,9,10727668,1673,68
2020-04-06,Greece,EL,62,5,10727668,1735,73
2020-04-07,Greece,EL,20,6,10727668,1755,79
2020-04-08,Greece,EL,77,2,10727668,1832,81
2020-04-09,Greece,EL,52,2,10727668,1884,83
2020-04-10,Greece,EL,71,3,10727668,1955,86
2020-04-11,Greece,EL,56,4,10727668,2011,90
2020-04-12,Greece,EL,70,3,10727668,2081,93
2020-04-13,Greece,EL,33,5,10727668,2114,98
2020-04-14,Greece,EL,31,1,10727668,2145,99
2020-04-15,Greece,EL,25,2,10727668,2170,101
2020-04-16,Greece,EL,22,1,10727668,2192,102
2020-04-17,Greece,EL,15,3,10727668,2207,105
2020-04-18,Greece,EL,0,0,10727668,2207,105
2020-04-19,Greece,EL,0,0,10727668,2207,105
2020-04-20,Greece,EL,28,5,10727668,2235,110
2020-04-21,Greece,EL,10,6,10727668,2245,116
2020-04-22,Greece,EL,156,5,10727668,2401,121
2020-04-23,Greece,EL,7,0,10727668,2408,121
2020-04-24,Greece,EL,55,4,10727668,2463,125
2020-04-25,Greece,EL,27,5,10727668,2490,130
2020-04-26,Greece,EL,16,0,10727668,2506,130
2020-04-27,Greece,EL,0,0,10727668,2506,130
2020-04-28,Greece,EL,28,6,10727668,2534,136
2020-04-29,Greece,EL,0,0,10727668,2534,136
2020-04-30,Greece,EL,42,3,10727668,2576,139
2020-05-01,Greece,EL,15,1,10727668,2591,140
2020-05-02,Greece,EL,0,0,10727668,2591,140
2020-05-03,Greece,EL,29,3,10727668,2620,143
2020-03-22,Eritrea,ER,1,0,0,1,0
2020-03-23,Eritrea,ER,0,0,0,1,0
2020-03-24,Eritrea,ER,0,0,0,1,0
2020-03-25,Eritrea,ER,0,0,0,1,0
2020-03-26,Eritrea,ER,3,0,0,4,0
2020-03-27,Eritrea,ER,2,0,0,6,0
2020-03-28,Eritrea,ER,0,0,0,6,0
2020-03-29,Eritrea,ER,0,0,0,6,0
2020-03-30,Eritrea,ER,6,0,0,12,0
2020-03-31,Eritrea,ER,0,0,0,12,0
2020-04-01,Eritrea,ER,3,0,0,15,0
2020-04-02,Eritrea,ER,3,0,0,18,0
2020-04-03,Eritrea,ER,4,0,0,22,0
2020-04-04,Eritrea,ER,0,0,0,22,0
2020-04-05,Eritrea,ER,7,0,0,29,0
2020-04-06,Eritrea,ER,0,0,0,29,0
2020-04-07,Eritrea,ER,2,0,0,31,0
2020-04-08,Eritrea,ER,0,0,0,31,0
2020-04-09,Eritrea,ER,2,0,0,33,0
2020-04-10,Eritrea,ER,0,0,0,33,0
2020-04-11,Eritrea,ER,1,0,0,34,0
2020-04-12,Eritrea,ER,0,0,0,34,0
2020-04-13,Eritrea,ER,0,0,0,34,0
2020-04-14,Eritrea,ER,0,0,0,34,0
2020-04-15,Eritrea,ER,1,0,0,35,0
2020-04-16,Eritrea,ER,0,0,0,35,0
2020-04-17,Eritrea,ER,0,0,0,35,0
2020-04-18,Eritrea,ER,0,0,0,35,0
2020-04-19,Eritrea,ER,0,0,0,35,0
2020-04-20,Eritrea,ER,4,0,0,39,0
2020-04-21,Eritrea,ER,0,0,0,39,0
2020-04-22,Eritrea,ER,0,0,0,39,0
2020-04-23,Eritrea,ER,0,0,0,39,0
2020-04-24,Eritrea,ER,0,0,0,39,0
2020-04-25,Eritrea,ER,0,0,0,39,0
2020-04-26,Eritrea,ER,0,0,0,39,0
2020-04-27,Eritrea,ER,0,0,0,39,0
2020-04-28,Eritrea,ER,0,0,0,39,0
2020-04-29,Eritrea,ER,0,0,0,39,0
2020-04-30,Eritrea,ER,0,0,0,39,0
2020-05-01,Eritrea,ER,0,0,0,39,0
2020-05-02,Eritrea,ER,0,0,0,39,0
2020-05-03,Eritrea,ER,0,0,0,39,0
2019-12-31,Spain,ES,0,0,46723749,0,0
2020-01-01,Spain,ES,0,0,46723749,0,0
2020-01-02,Spain,ES,0,0,46723749,0,0
2020-01-03,Spain,ES,0,0,46723749,0,0
2020-01-04,Spain,ES,0,0,46723749,0,0
2020-01-05,Spain,ES,0,0,46723749,0,0
2020-01-06,Spain,ES,0,0,46723749,0,0
2020-01-07,Spain,ES,0,0,46723749,0,0
2020-01-08,Spain,ES,0,0,46723749,0,0
2020-01-09,Spain,ES,0,0,46723749,0,0
2020-01-10,Spain,ES,0,0,46723749,0,0
2020-01-11,Spain,ES,0,0,46723749,0,0
2020-01-12,Spain,ES,0,0,46723749,0,0
2020-01-13,Spain,ES,0,0,46723749,0,0
2020-01-14,Spain,ES,0,0,46723749,0,0
2020-01-15,Spain,ES,0,0,46723749,0,0
2020-01-16,Spain,ES,0,0,46723749,0,0
2020-01-17,Spain,ES,0,0,46723749,0,0
2020-01-18,Spain,ES,0,0,46723749,0,0
2020-01-19,Spain,ES,0,0,46723749,0,0
2020-01-20,Spain,ES,0,0,46723749,0,0
2020-01-21,Spain,ES,0,0,46723749,0,0
2020-01-22,Spain,ES,0,0,46723749,0,0
2020-01-23,Spain,ES,0,0,46723749,0,0
2020-01-24,Spain,ES,0,0,46723749,0,0
2020-01-25,Spain,ES,0,0,46723749,0,0
2020-01-26,Spain,ES,0,0,46723749,0,0
2020-01-27,Spain,ES,0,0,46723749,0,0
2020-01-28,Spain,ES,0,0,46723749,0,0
2020-01-29,Spain,ES,0,0,46723749,0,0
2020-01-30,Spain,ES,0,0,46723749,0,0
2020-01-31,Spain,ES,0,0,46723749,0,0
2020-02-01,Spain,ES,1,0,46723749,1,0
2020-02-02,Spain,ES,0,0,46723749,1,0
2020-02-03,Spain,ES,0,0,46723749,1,0
2020-02-04,Spain,ES,0,0,46723749,1,0
2020-02-05,Spain,ES,0,0,46723749,1,0
2020-02-06,Spain,ES,0,0,46723749,1,0
2020-02-07,Spain,ES,0,0,46723749,1,0
2020-02-08,Spain,ES,0,0,46723749,1,0
2020-02-09,Spain,ES,0,0,46723749,1,0
2020-02-10,Spain,ES,1,0,46723749,2,0
2020-02-11,Spain,ES,0,0,46723749,2,0
2020-02-12,Spain,ES,0,0,46723749,2,0
2020-02-13,Spain,ES,0,0,46723749,2,0
2020-02-14,Spain,ES,0,0,46723749,2,0
2020-02-15,Spain,ES,0,0,46723749,2,0
2020-02-16,Spain,ES,0,0,46723749,2,0
2020-02-17,Spain,ES,0,0,46723749,2,0
2020-02-18,Spain,ES,0,0,46723749,2,0
2020-02-19,Spain,ES,0,0,46723749,2,0
2020-02-20,Spain,ES,0,0,46723749,2,0
2020-02-21,Spain,ES,0,0,46723749,2,0
2020-02-22,Spain,ES,0,0,46723749,2,0
2020-02-23,Spain,ES,0,0,46723749,2,0
2020-02-24,Spain,ES,0,0,46723749,2,0
2020-02-25,Spain,ES,1,0,46723749,3,0
2020-02-26,Spain,ES,4,0,46723749,7,0
2020-02-27,Spain,ES,5,0,46723749,12,0
2020-02-28,Spain,ES,13,0,46723749,25,0
2020-02-29,Spain,ES,9,0,46723749,34,0
2020-03-01,Spain,ES,32,0,46723749,66,0
2020-03-02,Spain,ES,17,0,46723749,83,0
2020-03-03,Spain,ES,31,0,46723749,114,0
2020-03-04,Spain,ES,37,0,46723749,151,0
2020-03-05,Spain,ES,49,1,46723749,200,1
2020-03-06,Spain,ES,61,2,46723749,261,3
2020-03-07,Spain,ES,113,2,46723749,374,5
2020-03-08,Spain,ES,56,0,46723749,430,5
2020-03-09,Spain,ES,159,0,46723749,589,5
2020-03-10,Spain,ES,615,23,46723749,1204,28
2020-03-11,Spain,ES,435,7,46723749,1639,35
2020-03-12,Spain,ES,501,12,46723749,2140,47
2020-03-13,Spain,ES,864,37,46723749,3004,84
2020-03-14,Spain,ES,1227,37,46723749,4231,121
2020-03-15,Spain,ES,1522,15,46723749,5753,136
2020-03-16,Spain,ES,2000,152,46723749,7753,288
2020-03-17,Spain,ES,1438,21,46723749,9191,309
2020-03-18,Spain,ES,1987,182,46723749,11178,491
2020-03-19,Spain,ES,2538,107,46723749,13716,598
2020-03-20,Spain,ES,3431,169,46723749,17147,767
2020-03-21,Spain,ES,2833,235,46723749,19980,1002
2020-03-22,Spain,ES,4946,324,46723749,24926,1326
2020-03-23,Spain,ES,3646,394,46723749,28572,1720
2020-03-24,Spain,ES,4517,462,46723749,33089,2182
2020-03-25,Spain,ES,6584,514,46723749,39673,2696
2020-03-26,Spain,ES,7937,738,46723749,47610,3434
2020-03-27,Spain,ES,8578,655,46723749,56188,4089
2020-03-28,Spain,ES,7871,769,46723749,64059,4858
2020-03-29,Spain,ES,8189,832,46723749,72248,5690
2020-03-30,Spain,ES,6549,838,46723749,78797,6528
2020-03-31,Spain,ES,6398,812,46723749,85195,7340
2020-04-01,Spain,ES,9222,849,46723749,94417,8189
2020-04-02,Spain,ES,7719,864,46723749,102136,9053
2020-04-03,Spain,ES,8102,950,46723749,110238,10003
2020-04-04,Spain,ES,7472,932,46723749,117710,10935
2020-04-05,Spain,ES,7026,809,46723749,124736,11744
2020-04-06,Spain,ES,6023,674,46723749,130759,12418
2020-04-07,Spain,ES,4273,637,46723749,135032,13055
2020-04-08,Spain,ES,5478,743,46723749,140510,13798
2020-04-09,Spain,ES,6180,757,46723749,146690,14555
2020-04-10,Spain,ES,5756,683,46723749,152446,15238
2020-04-11,Spain,ES,4576,605,46723749,157022,15843
2020-04-12,Spain,ES,4830,510,46723749,161852,16353
2020-04-13,Spain,ES,4167,619,46723749,166019,16972
2020-04-14,Spain,ES,3477,517,46723749,169496,17489
2020-04-15,Spain,ES,7968,787,46723749,177464,18276
2020-04-16,Spain,ES,4040,617,46723749,181504,18893
2020-04-17,Spain,ES,4400,585,46723749,185904,19478
2020-04-18,Spain,ES,4104,565,46723749,190008,20043
2020-04-19,Spain,ES,-1430,410,46723749,188578,20453
2020-04-20,Spain,ES,2585,399,46723749,191163,20852
2020-04-21,Spain,ES,3352,430,46723749,194515,21282
2020-04-22,Spain,ES,2627,435,46723749,197142,21717
2020-04-23,Spain,ES,3052,440,46723749,200194,22157
2020-04-24,Spain,ES,2767,367,46723749,202961,22524
2020-04-25,Spain,ES,2944,378,46723749,205905,22902
2020-04-26,Spain,ES,1729,288,46723749,207634,23190
2020-04-27,Spain,ES,1831,0,46723749,209465,23190
2020-04-28,Spain,ES,1308,632,46723749,210773,23822
2020-04-29,Spain,ES,2144,453,46723749,212917,24275
2020-04-30,Spain,ES,518,268,46723749,213435,24543
2020-05-01,Spain,ES,1781,281,46723749,215216,24824
2020-05-03,Spain,ES,1366,276,46723749,216582,25100
2020-03-14,Ethiopia,ET,1,0,109224559,1,0
2020-03-15,Ethiopia,ET,0,0,109224559,1,0
2020-03-16,Ethiopia,ET,3,0,109224559,4,0
2020-03-17,Ethiopia,ET,1,0,109224559,5,0
2020-03-18,Ethiopia,ET,0,0,109224559,5,0
2020-03-19,Ethiopia,ET,1,0,109224559,6,0
2020-03-20,Ethiopia,ET,1,0,109224559,7,0
2020-03-21,Ethiopia,ET,2,0,109224559,9,0
2020-03-22,Ethiopia,ET,0,0,109224559,9,0
2020-03-23,Ethiopia,ET,2,0,109224559,11,0
2020-03-24,Ethiopia,ET,0,0,109224559,11,0
2020-03-25,Ethiopia,ET,0,0,109224559,11,0
2020-03-26,Ethiopia,ET,1,0,109224559,12,0
2020-03-27,Ethiopia,ET,0,0,109224559,12,0
2020-03-28,Ethiopia,ET,4,0,109224559,16,0
2020-03-29,Ethiopia,ET,0,0,109224559,16,0
2020-03-30,Ethiopia,ET,0,0,109224559,16,0
2020-03-31,Ethiopia,ET,7,0,109224559,23,0
2020-04-01,Ethiopia,ET,2,0,109224559,25,0
2020-04-02,Ethiopia,ET,4,0,109224559,29,0
2020-04-03,Ethiopia,ET,0,0,109224559,29,0
2020-04-04,Ethiopia,ET,6,0,109224559,35,0
2020-04-05,Ethiopia,ET,3,0,109224559,38,0
2020-04-06,Ethiopia,ET,5,2,109224559,43,2
2020-04-07,Ethiopia,ET,1,0,109224559,44,2
2020-04-08,Ethiopia,ET,8,0,109224559,52,2
2020-04-09,Ethiopia,ET,3,0,109224559,55,2
2020-04-10,Ethiopia,ET,1,0,109224559,56,2
2020-04-11,Ethiopia,ET,9,0,109224559,65,2
2020-04-12,Ethiopia,ET,4,1,109224559,69,3
2020-04-13,Ethiopia,ET,2,0,109224559,71,3
2020-04-14,Ethiopia,ET,3,0,109224559,74,3
2020-04-15,Ethiopia,ET,8,0,109224559,82,3
2020-04-16,Ethiopia,ET,3,0,109224559,85,3
2020-04-17,Ethiopia,ET,7,0,109224559,92,3
2020-04-18,Ethiopia,ET,4,0,109224559,96,3
2020-04-19,Ethiopia,ET,9,0,109224559,105,3
2020-04-20,Ethiopia,ET,3,0,109224559,108,3
2020-04-21,Ethiopia,ET,3,0,109224559,111,3
2020-04-22,Ethiopia,ET,3,0,109224559,114,3
2020-04-23,Ethiopia,ET,2,0,109224559,116,3
2020-04-24,Ethiopia,ET,0,0,109224559,116,3
2020-04-25,Ethiopia,ET,1,0,109224559,117,3
2020-04-26,Ethiopia,ET,5,0,109224559,122,3
2020-04-27,Ethiopia,ET,1,0,109224559,123,3
2020-04-28,Ethiopia,ET,1,0,109224559,124,3
2020-04-29,Ethiopia,ET,2,0,109224559,126,3
2020-04-30,Ethiopia,ET,4,0,109224559,130,3
2020-05-01,Ethiopia,ET,1,0,109224559,131,3
2020-05-02,Ethiopia,ET,2,0,109224559,133,3
2020-05-03,Ethiopia,ET,0,0,109224559,133,3
2019-12-31,Finland,FI,0,0,5518050,0,0
2020-01-01,Finland,FI,0,0,5518050,0,0
2020-01-02,Finland,FI,0,0,5518050,0,0
2020-01-03,Finland,FI,0,0,5518050,0,0
2020-01-04,Finland,FI,0,0,5518050,0,0
2020-01-05,Finland,FI,0,0,5518050,0,0
2020-01-06,Finland,FI,0,0,5518050,0,0
2020-01-07,Finland,FI,0,0,5518050,0,0
2020-01-08,Finland,FI,0,0,5518050,0,0
2020-01-09,Finland,FI,0,0,5518050,0,0
2020-01-10,Finland,FI,0,0,5518050,0,0
2020-01-11,Finland,FI,0,0,5518050,0,0
2020-01-12,Finland,FI,0,0,5518050,0,0
2020-01-13,Finland,FI,0,0,5518050,0,0
2020-01-14,Finland,FI,0,0,5518050,0,0
2020-01-15,Finland,FI,0,0,5518050,0,0
2020-01-16,Finland,FI,0,0,5518050,0,0
2020-01-17,Finland,FI,0,0,5518050,0,0
2020-01-18,Finland,FI,0,0,5518050,0,0
2020-01-19,Finland,FI,0,0,5518050,0,0
2020-01-20,Finland,FI,0,0,5518050,0,0
2020-01-21,Finland,FI,0,0,5518050,0,0
2020-01-22,Finland,FI,0,0,5518050,0,0
2020-01-23,Finland,FI,0,0,5518050,0,0
2020-01-24,Finland,FI,0,0,5518050,0,0
2020-01-25,Finland,FI,0,0,5518050,0,0
2020-01-26,Finland,FI,0,0,5518050,0,0
2020-01-27,Finland,FI,0,0,5518050,0,0
2020-01-28,Finland,FI,0,0,5518050,0,0
2020-01-29,Finland,FI,0,0,5518050,0,0
2020-01-30,Finland,FI,1,0,5518050,1,0
2020-01-31,Finland,FI,0,0,5518050,1,0
2020-02-01,Finland,FI,0,0,5518050,1,0
2020-02-02,Finland,FI,0,0,5518050,1,0
2020-02-03,Finland,FI,0,0,5518050,1,0
2020-02-04,Finland,FI,0,0,5518050,1,0
2020-02-05,Finland,FI,0,0,5518050,1,0
2020-02-06,Finland,FI,0,0,5518050,1,0
2020-02-07,Finland,FI,0,0,5518050,1,0
2020-02-08,Finland,FI,0,0,5518050,1,0
2020-02-09,Finland,FI,0,0,5518050,1,0
2020-02-10,Finland,FI,0,0,5518050,1,0
2020-02-11,Finland,FI,0,0,5518050,1,0
2020-02-12,Finland,FI,0,0,5518050,1,0
2020-02-13,Finland,FI,0,0,5518050,1,0
2020-02-14,Finland,FI,0,0,5518050,1,0
2020-02-15,Finland,FI,0,0,5518050,1,0
2020-02-16,Finland,FI,0,0,5518050,1,0
2020-02-17,Finland,FI,0,0,5518050,1,0
2020-02-18,Finland,FI,0,0,5518050,1,0
2020-02-19,Finland,FI,0,0,5518050,1,0
2020-02-20,Finland,FI,0,0,5518050,1,0
2020-02-21,Finland,FI,0,0,5518050,1,0
2020-02-22,Finland,FI,0,0,5518050,1,0
2020-02-23,Finland,FI,0,0,5518050,1,0
2020-02-24,Finland,FI,0,0,5518050,1,0
2020-02-25,Finland,FI,0,0,5518050,1,0
2020-02-26,Finland,FI,0,0,5518050,1,0
2020-02-27,Finland,FI,1,0,5518050,2,0
2020-02-28,Finland,FI,0,0,5518050,2,0
2020-02-29,Finland,FI,1,0,5518050,3,0
2020-03-01,Finland,FI,0,0,5518050,3,0
2020-03-02,Finland,FI,3,0,5518050,6,0
2020-03-04,Finland,FI,1,0,5518050,7,0
2020-03-06,Finland,FI,5,0,5518050,12,0
2020-03-07,Finland,FI,7,0,5518050,19,0
2020-03-09,Finland,FI,11,0,5518050,30,0
2020-03-10,Finland,FI,10,0,5518050,40,0
2020-03-12,Finland,FI,19,0,5518050,59,0
2020-03-13,Finland,FI,96,0,5518050,155,0
2020-03-14,Finland,FI,28,0,5518050,183,0
2020-03-15,Finland,FI,27,0,5518050,210,0
2020-03-16,Finland,FI,57,0,5518050,267,0
2020-03-17,Finland,FI,5,0,5518050,272,0
2020-03-18,Finland,FI,47,0,5518050,319,0
2020-03-19,Finland,FI,50,0,5518050,369,0
2020-03-20,Finland,FI,31,0,5518050,400,0
2020-03-21,Finland,FI,50,0,5518050,450,0
2020-03-22,Finland,FI,71,1,5518050,521,1
2020-03-23,Finland,FI,105,0,5518050,626,1
2020-03-24,Finland,FI,74,0,5518050,700,1
2020-03-25,Finland,FI,92,0,5518050,792,1
2020-03-26,Finland,FI,88,2,5518050,880,3
2020-03-27,Finland,FI,78,1,5518050,958,4
2020-03-28,Finland,FI,67,3,5518050,1025,7
2020-03-29,Finland,FI,193,2,5518050,1218,9
2020-03-30,Finland,FI,0,2,5518050,1218,11
2020-03-31,Finland,FI,95,2,5518050,1313,13
2020-04-01,Finland,FI,71,4,5518050,1384,17
2020-04-02,Finland,FI,62,0,5518050,1446,17
2020-04-03,Finland,FI,72,2,5518050,1518,19
2020-04-04,Finland,FI,97,1,5518050,1615,20
2020-04-05,Finland,FI,267,5,5518050,1882,25
2020-04-06,Finland,FI,45,2,5518050,1927,27
2020-04-07,Finland,FI,249,0,5518050,2176,27
2020-04-08,Finland,FI,132,7,5518050,2308,34
2020-04-09,Finland,FI,179,6,5518050,2487,40
2020-04-10,Finland,FI,118,2,5518050,2605,42
2020-04-11,Finland,FI,164,6,5518050,2769,48
2020-04-12,Finland,FI,136,1,5518050,2905,49
2020-04-13,Finland,FI,69,7,5518050,2974,56
2020-04-14,Finland,FI,90,3,5518050,3064,59
2020-04-15,Finland,FI,97,5,5518050,3161,64
2020-04-16,Finland,FI,76,8,5518050,3237,72
2020-04-17,Finland,FI,132,3,5518050,3369,75
2020-04-18,Finland,FI,120,7,5518050,3489,82
2020-04-19,Finland,FI,192,8,5518050,3681,90
2020-04-20,Finland,FI,102,4,5518050,3783,94
2020-04-21,Finland,FI,85,4,5518050,3868,98
2020-04-22,Finland,FI,146,43,5518050,4014,141
2020-04-23,Finland,FI,115,8,5518050,4129,149
2020-04-24,Finland,FI,155,23,5518050,4284,172
2020-04-25,Finland,FI,111,5,5518050,4395,177
2020-04-26,Finland,FI,80,9,5518050,4475,186
2020-04-27,Finland,FI,101,4,5518050,4576,190
2020-04-28,Finland,FI,119,3,5518050,4695,193
2020-04-29,Finland,FI,45,6,5518050,4740,199
2020-04-30,Finland,FI,166,7,5518050,4906,206
2020-05-01,Finland,FI,89,5,5518050,4995,211
2020-05-02,Finland,FI,56,7,5518050,5051,218
2020-05-03,Finland,FI,128,2,5518050,5179,220
2020-03-20,Fiji,FJ,1,0,883483,1,0
2020-03-21,Fiji,FJ,0,0,883483,1,0
2020-03-22,Fiji,FJ,1,0,883483,2,0
2020-03-23,Fiji,FJ,1,0,883483,3,0
2020-03-24,Fiji,FJ,1,0,883483,4,0
2020-03-25,Fiji,FJ,1,0,883483,5,0
2020-03-26,Fiji,FJ,0,0,883483,5,0
2020-03-27,Fiji,FJ,0,0,883483,5,0
2020-03-28,Fiji,FJ,0,0,883483,5,0
2020-03-29,Fiji,FJ,0,0,883483,5,0
2020-03-30,Fiji,FJ,0,0,883483,5,0
2020-03-31,Fiji,FJ,0,0,883483,5,0
2020-04-01,Fiji,FJ,0,0,883483,5,0
2020-04-02,Fiji,FJ,2,0,883483,7,0
2020-04-03,Fiji,FJ,0,0,883483,7,0
2020-04-04,Fiji,FJ,5,0,883483,12,0
2020-04-05,Fiji,FJ,0,0,883483,12,0
2020-04-06,Fiji,FJ,2,0,883483,14,0
2020-04-07,Fiji,FJ,0,0,883483,14,0
2020-04-08,Fiji,FJ,1,0,883483,15,0
2020-04-09,Fiji,FJ,0,0,883483,15,0
2020-04-10,Fiji,FJ,0,0,883483,15,0
2020-04-11,Fiji,FJ,1,0,883483,16,0
2020-04-12,Fiji,FJ,0,0,883483,16,0
2020-04-13,Fiji,FJ,0,0,883483,16,0
2020-04-14,Fiji,FJ,0,0,883483,16,0
2020-04-15,Fiji,FJ,0,0,883483,16,0
2020-04-16,Fiji,FJ,0,0,883483,16,0
2020-04-17,Fiji,FJ,1,0,883483,17,0
2020-04-18,Fiji,FJ,0,0,883483,17,0
2020-04-19,Fiji,FJ,0,0,883483,17,0
2020-04-20,Fiji,FJ,0,0,883483,17,0
2020-04-21,Fiji,FJ,1,0,883483,18,0
2020-04-22,Fiji,FJ,0,0,883483,18,0
2020-04-23,Fiji,FJ,0,0,883483,18,0
2020-04-24,Fiji,FJ,0,0,883483,18,0
2020-04-25,Fiji,FJ,0,0,883483,18,0
2020-04-26,Fiji,FJ,0,0,883483,18,0
2020-04-27,Fiji,FJ,0,0,883483,18,0
2020-04-28,Fiji,FJ,0,0,883483,18,0
2020-04-29,Fiji,FJ,0,0,883483,18,0
2020-04-30,Fiji,FJ,0,0,883483,18,0
2020-05-01,Fiji,FJ,0,0,883483,18,0
2020-05-02,Fiji,FJ,0,0,883483,18,0
2020-05-03,Fiji,FJ,0,0,883483,18,0
2020-04-04,Falkland_Islands_(Malvinas),FK,1,0,0,1,0
2020-04-05,Falkland_Islands_(Malvinas),FK,0,0,0,1,0
2020-04-06,Falkland_Islands_(Malvinas),FK,1,0,0,2,0
2020-04-07,Falkland_Islands_(Malvinas),FK,0,0,0,2,0
2020-04-08,Falkland_Islands_(Malvinas),FK,3,0,0,5,0
2020-04-09,Falkland_Islands_(Malvinas),FK,0,0,0,5,0
2020-04-10,Falkland_Islands_(Malvinas),FK,0,0,0,5,0
2020-04-11,Falkland_Islands_(Malvinas),FK,0,0,0,5,0
2020-04-12,Falkland_Islands_(Malvinas),FK,0,0,0,5,0
2020-04-13,Falkland_Islands_(Malvinas),FK,0,0,0,5,0
2020-04-14,Falkland_Islands_(Malvinas),FK,0,0,0,5,0
2020-04-15,Falkland_Islands_(Malvinas),FK,6,0,0,11,0
2020-04-16,Falkland_Islands_(Malvinas),FK,0,0,0,11,0
2020-04-17,Falkland_Islands_(Malvinas),FK,0,0,0,11,0
2020-04-18,Falkland_Islands_(Malvinas),FK,0,0,0,11,0
2020-04-19,Falkland_Islands_(Malvinas),FK,0,0,0,11,0
2020-04-20,Falkland_Islands_(Malvinas),FK,0,0,0,11,0
2020-04-21,Falkland_Islands_(Malvinas),FK,0,0,0,11,0
2020-04-22,Falkland_Islands_(Malvinas),FK,1,0,0,12,0
2020-04-23,Falkland_Islands_(Malvinas),FK,0,0,0,12,0
2020-04-24,Falkland_Islands_(Malvinas),FK,0,0,0,12,0
2020-04-25,Falkland_Islands_(Malvinas),FK,0,0,0,12,0
2020-04-26,Falkland_Islands_(Malvinas),FK,1,0,0,13,0
2020-04-27,Falkland_Islands_(Malvinas),FK,0,0,0,13,0
2020-04-28,Falkland_Islands_(Malvinas),FK,0,0,0,13,0
2020-04-29,Falkland_Islands_(Malvinas),FK,0,0,0,13,0
2020-04-30,Falkland_Islands_(Malvinas),FK,0,0,0,13,0
2020-05-01,Falkland_Islands_(Malvinas),FK,0,0,0,13,0
2020-05-02,Falkland_Islands_(Malvinas),FK,0,0,0,13,0
2020-05-03,Falkland_Islands_(Malvinas),FK,0,0,0,13,0
2020-03-20,Faroe_Islands,FO,72,0,48497,72,0
2020-03-21,Faroe_Islands,FO,8,0,48497,80,0
2020-03-22,Faroe_Islands,FO,12,0,48497,92,0
2020-03-23,Faroe_Islands,FO,23,0,48497,115,0
2020-03-24,Faroe_Islands,FO,3,0,48497,118,0
2020-03-25,Faroe_Islands,FO,4,0,48497,122,0
2020-03-26,Faroe_Islands,FO,10,0,48497,132,0
2020-03-27,Faroe_Islands,FO,8,0,48497,140,0
2020-03-28,Faroe_Islands,FO,4,0,48497,144,0
2020-03-29,Faroe_Islands,FO,11,0,48497,155,0
2020-03-30,Faroe_Islands,FO,4,0,48497,159,0
2020-03-31,Faroe_Islands,FO,9,0,48497,168,0
2020-04-01,Faroe_Islands,FO,1,0,48497,169,0
2020-04-02,Faroe_Islands,FO,4,0,48497,173,0
2020-04-03,Faroe_Islands,FO,4,0,48497,177,0
2020-04-04,Faroe_Islands,FO,2,0,48497,179,0
2020-04-05,Faroe_Islands,FO,2,0,48497,181,0
2020-04-06,Faroe_Islands,FO,0,0,48497,181,0
2020-04-07,Faroe_Islands,FO,2,0,48497,183,0
2020-04-08,Faroe_Islands,FO,1,0,48497,184,0
2020-04-09,Faroe_Islands,FO,0,0,48497,184,0
2020-04-10,Faroe_Islands,FO,0,0,48497,184,0
2020-04-11,Faroe_Islands,FO,0,0,48497,184,0
2020-04-12,Faroe_Islands,FO,0,0,48497,184,0
2020-04-13,Faroe_Islands,FO,0,0,48497,184,0
2020-04-14,Faroe_Islands,FO,0,0,48497,184,0
2020-04-15,Faroe_Islands,FO,0,0,48497,184,0
2020-04-16,Faroe_Islands,FO,0,0,48497,184,0
2020-04-17,Faroe_Islands,FO,0,0,48497,184,0
2020-04-18,Faroe_Islands,FO,0,0,48497,184,0
2020-04-19,Faroe_Islands,FO,0,0,48497,184,0
2020-04-20,Faroe_Islands,FO,1,0,48497,185,0
2020-04-21,Faroe_Islands,FO,0,0,48497,185,0
2020-04-22,Faroe_Islands,FO,0,0,48497,185,0
2020-04-23,Faroe_Islands,FO,0,0,48497,185,0
2020-04-24,Faroe_Islands,FO,2,0,48497,187,0
2020-04-25,Faroe_Islands,FO,0,0,48497,187,0
2020-04-26,Faroe_Islands,FO,0,0,48497,187,0
2020-04-27,Faroe_Islands,FO,0,0,48497,187,0
2020-04-28,Faroe_Islands,FO,0,0,48497,187,0
2020-04-29,Faroe_Islands,FO,0,0,48497,187,0
2020-04-30,Faroe_Islands,FO,0,0,48497,187,0
2020-05-01,Faroe_Islands,FO,0,0,48497,187,0
2020-05-02,Faroe_Islands,FO,0,0,48497,187,0
2020-05-03,Faroe_Islands,FO,0,0,48497,187,0
2019-12-31,France,FR,0,0,66987244,0,0
2020-01-01,France,FR,0,0,66987244,0,0
2020-01-02,France,FR,0,0,66987244,0,0
2020-01-03,France,FR,0,0,66987244,0,0
2020-01-04,France,FR,0,0,66987244,0,0
2020-01-05,France,FR,0,0,66987244,0,0
2020-01-06,France,FR,0,0,66987244,0,0
2020-01-07,France,FR,0,0,66987244,0,0
2020-01-08,France,FR,0,0,66987244,0,0
2020-01-09,France,FR,0,0,66987244,0,0
2020-01-10,France,FR,0,0,66987244,0,0
2020-01-11,France,FR,0,0,66987244,0,0
2020-01-12,France,FR,0,0,66987244,0,0
2020-01-13,France,FR,0,0,66987244,0,0
2020-01-14,France,FR,0,0,66987244,0,0
2020-01-15,France,FR,0,0,66987244,0,0
2020-01-16,France,FR,0,0,66987244,0,0
2020-01-17,France,FR,0,0,66987244,0,0
2020-01-18,France,FR,0,0,66987244,0,0
2020-01-19,France,FR,0,0,66987244,0,0
2020-01-20,France,FR,0,0,66987244,0,0
2020-01-21,France,FR,0,0,66987244,0,0
2020-01-22,France,FR,0,0,66987244,0,0
2020-01-23,France,FR,0,0,66987244,0,0
2020-01-24,France,FR,0,0,66987244,0,0
2020-01-25,France,FR,3,0,66987244,3,0
2020-01-26,France,FR,0,0,66987244,3,0
2020-01-27,France,FR,0,0,66987244,3,0
2020-01-28,France,FR,0,0,66987244,3,0
2020-01-29,France,FR,1,0,66987244,4,0
2020-01-30,France,FR,1,0,66987244,5,0
2020-01-31,France,FR,1,0,66987244,6,0
2020-02-01,France,FR,0,0,66987244,6,0
2020-02-02,France,FR,0,0,66987244,6,0
2020-02-03,France,FR,0,0,66987244,6,0
2020-02-04,France,FR,0,0,66987244,6,0
2020-02-05,France,FR,0,0,66987244,6,0
2020-02-06,France,FR,0,0,66987244,6,0
2020-02-07,France,FR,0,0,66987244,6,0
2020-02-08,France,FR,5,0,66987244,11,0
2020-02-09,France,FR,0,0,66987244,11,0
2020-02-10,France,FR,0,0,66987244,11,0
2020-02-11,France,FR,0,0,66987244,11,0
2020-02-12,France,FR,0,0,66987244,11,0
2020-02-13,France,FR,0,0,66987244,11,0
2020-02-14,France,FR,0,0,66987244,11,0
2020-02-15,France,FR,0,1,66987244,11,1
2020-02-16,France,FR,0,0,66987244,11,1
2020-02-17,France,FR,1,0,66987244,12,1
2020-02-18,France,FR,0,0,66987244,12,1
2020-02-19,France,FR,0,0,66987244,12,1
2020-02-20,France,FR,0,0,66987244,12,1
2020-02-21,France,FR,0,0,66987244,12,1
2020-02-22,France,FR,0,0,66987244,12,1
2020-02-23,France,FR,0,0,66987244,12,1
2020-02-24,France,FR,0,0,66987244,12,1
2020-02-25,France,FR,0,0,66987244,12,1
2020-02-26,France,FR,2,0,66987244,14,1
2020-02-27,France,FR,3,1,66987244,17,2
2020-02-28,France,FR,21,0,66987244,38,2
2020-02-29,France,FR,19,0,66987244,57,2
2020-03-01,France,FR,43,0,66987244,100,2
2020-03-02,France,FR,30,0,66987244,130,2
2020-03-03,France,FR,48,1,66987244,178,3
2020-03-04,France,FR,34,1,66987244,212,4
2020-03-05,France,FR,73,0,66987244,285,4
2020-03-06,France,FR,138,3,66987244,423,7
2020-03-07,France,FR,190,2,66987244,613,9
2020-03-08,France,FR,103,1,66987244,716,10
2020-03-09,France,FR,410,9,66987244,1126,19
2020-03-10,France,FR,286,11,66987244,1412,30
2020-03-11,France,FR,372,3,66987244,1784,33
2020-03-12,France,FR,497,15,66987244,2281,48
2020-03-13,France,FR,595,13,66987244,2876,61
2020-03-14,France,FR,785,18,66987244,3661,79
2020-03-15,France,FR,838,12,66987244,4499,91
2020-03-16,France,FR,924,36,66987244,5423,127
2020-03-17,France,FR,1210,21,66987244,6633,148
2020-03-18,France,FR,1097,27,66987244,7730,175
2020-03-19,France,FR,1404,69,66987244,9134,244
2020-03-20,France,FR,1861,128,66987244,10995,372
2020-03-21,France,FR,1617,78,66987244,12612,450
2020-03-22,France,FR,1847,112,66987244,14459,562
2020-03-23,France,FR,1559,112,66987244,16018,674
2020-03-24,France,FR,3838,186,66987244,19856,860
2020-03-25,France,FR,2446,240,66987244,22302,1100
2020-03-26,France,FR,2931,231,66987244,25233,1331
2020-03-27,France,FR,3922,365,66987244,29155,1696
2020-03-28,France,FR,3809,299,66987244,32964,1995
2020-03-29,France,FR,4611,319,66987244,37575,2314
2020-03-30,France,FR,2599,292,66987244,40174,2606
2020-03-31,France,FR,4376,418,66987244,44550,3024
2020-04-01,France,FR,7578,499,66987244,52128,3523
2020-04-02,France,FR,4861,509,66987244,56989,4032
2020-04-03,France,FR,2116,471,66987244,59105,4503
2020-04-04,France,FR,5233,2004,66987244,64338,6507
2020-04-05,France,FR,4267,1053,66987244,68605,7560
2020-04-06,France,FR,1873,518,66987244,70478,8078
2020-04-07,France,FR,3912,833,66987244,74390,8911
2020-04-08,France,FR,3777,1417,66987244,78167,10328
2020-04-09,France,FR,3881,541,66987244,82048,10869
2020-04-10,France,FR,4286,1341,66987244,86334,12210
2020-04-11,France,FR,4342,987,66987244,90676,13197
2020-04-12,France,FR,3114,635,66987244,93790,13832
2020-04-13,France,FR,1613,561,66987244,95403,14393
2020-04-14,France,FR,2673,574,66987244,98076,14967
2020-04-15,France,FR,5497,762,66987244,103573,15729
2020-04-16,France,FR,2633,1438,66987244,106206,17167
2020-04-17,France,FR,2641,753,66987244,108847,17920
2020-04-18,France,FR,405,761,66987244,109252,18681
2020-04-19,France,FR,2569,642,66987244,111821,19323
2020-04-20,France,FR,785,395,66987244,112606,19718
2020-04-21,France,FR,2051,547,66987244,114657,20265
2020-04-22,France,FR,2667,531,66987244,117324,20796
2020-04-23,France,FR,1827,544,66987244,119151,21340
2020-04-24,France,FR,1653,516,66987244,120804,21856
2020-04-25,France,FR,1773,389,66987244,122577,22245
2020-04-26,France,FR,1537,369,66987244,124114,22614
2020-04-27,France,FR,461,242,66987244,124575,22856
2020-04-28,France,FR,1195,437,66987244,125770,23293
2020-04-29,France,FR,1065,367,66987244,126835,23660
2020-04-30,France,FR,1607,427,66987244,128442,24087
2020-05-01,France,FR,1139,289,66987244,129581,24376
2020-05-02,France,FR,604,218,66987244,130185,24594
2020-05-03,France,FR,794,166,66987244,130979,24760
2020-03-13,Gabon,GA,1,0,2119275,1,0
2020-03-15,Gabon,GA,0,0,2119275,1,0
2020-03-16,Gabon,GA,0,0,2119275,1,0
2020-03-17,Gabon,GA,0,0,2119275,1,0
2020-03-18,Gabon,GA,0,0,2119275,1,0
2020-03-19,Gabon,GA,2,0,2119275,3,0
2020-03-20,Gabon,GA,0,0,2119275,3,0
2020-03-21,Gabon,GA,0,1,2119275,3,1
2020-03-22,Gabon,GA,0,0,2119275,3,1
2020-03-23,Gabon,GA,3,0,2119275,6,1
2020-03-24,Gabon,GA,0,0,2119275,6,1
2020-03-25,Gabon,GA,0,0,2119275,6,1
2020-03-26,Gabon,GA,0,0,2119275,6,1
2020-03-27,Gabon,GA,1,0,2119275,7,1
2020-03-28,Gabon,GA,0,0,2119275,7,1
2020-03-29,Gabon,GA,0,0,2119275,7,1
2020-03-30,Gabon,GA,0,0,2119275,7,1
2020-03-31,Gabon,GA,0,0,2119275,7,1
2020-04-01,Gabon,GA,9,0,2119275,16,1
2020-04-02,Gabon,GA,2,0,2119275,18,1
2020-04-03,Gabon,GA,0,0,2119275,18,1
2020-04-04,Gabon,GA,3,0,2119275,21,1
2020-04-05,Gabon,GA,0,0,2119275,21,1
2020-04-06,Gabon,GA,0,0,2119275,21,1
2020-04-07,Gabon,GA,0,0,2119275,21,1
2020-04-08,Gabon,GA,9,0,2119275,30,1
2020-04-09,Gabon,GA,3,0,2119275,33,1
2020-04-10,Gabon,GA,11,0,2119275,44,1
2020-04-11,Gabon,GA,2,0,2119275,46,1
2020-04-12,Gabon,GA,3,0,2119275,49,1
2020-04-13,Gabon,GA,8,0,2119275,57,1
2020-04-14,Gabon,GA,0,0,2119275,57,1
2020-04-15,Gabon,GA,18,0,2119275,75,1
2020-04-16,Gabon,GA,12,0,2119275,87,1
2020-04-17,Gabon,GA,8,0,2119275,95,1
2020-04-18,Gabon,GA,13,0,2119275,108,1
2020-04-19,Gabon,GA,1,0,2119275,109,1
2020-04-20,Gabon,GA,0,0,2119275,109,1
2020-04-21,Gabon,GA,11,0,2119275,120,1
2020-04-22,Gabon,GA,36,0,2119275,156,1
2020-04-23,Gabon,GA,10,0,2119275,166,1
2020-04-24,Gabon,GA,1,1,2119275,167,2
2020-04-25,Gabon,GA,5,1,2119275,172,3
2020-04-26,Gabon,GA,4,0,2119275,176,3
2020-04-27,Gabon,GA,0,0,2119275,176,3
2020-04-28,Gabon,GA,35,0,2119275,211,3
2020-04-29,Gabon,GA,27,0,2119275,238,3
2020-04-30,Gabon,GA,38,0,2119275,276,3
2020-05-01,Gabon,GA,0,0,2119275,276,3
2020-05-02,Gabon,GA,32,1,2119275,308,4
2020-05-03,Gabon,GA,27,1,2119275,335,5
2020-03-23,Grenada,GD,1,0,111454,1,0
2020-03-24,Grenada,GD,0,0,111454,1,0
2020-03-25,Grenada,GD,0,0,111454,1,0
2020-03-26,Grenada,GD,0,0,111454,1,0
2020-03-27,Grenada,GD,6,0,111454,7,0
2020-03-28,Grenada,GD,0,0,111454,7,0
2020-03-29,Grenada,GD,2,0,111454,9,0
2020-03-30,Grenada,GD,0,0,111454,9,0
2020-03-31,Grenada,GD,0,0,111454,9,0
2020-04-01,Grenada,GD,0,0,111454,9,0
2020-04-02,Grenada,GD,1,0,111454,10,0
2020-04-03,Grenada,GD,0,0,111454,10,0
2020-04-04,Grenada,GD,2,0,111454,12,0
2020-04-05,Grenada,GD,0,0,111454,12,0
2020-04-06,Grenada,GD,0,0,111454,12,0
2020-04-07,Grenada,GD,0,0,111454,12,0
2020-04-08,Grenada,GD,0,0,111454,12,0
2020-04-09,Grenada,GD,0,0,111454,12,0
2020-04-10,Grenada,GD,0,0,111454,12,0
2020-04-11,Grenada,GD,2,0,111454,14,0
2020-04-12,Grenada,GD,0,0,111454,14,0
2020-04-13,Grenada,GD,0,0,111454,14,0
2020-04-14,Grenada,GD,0,0,111454,14,0
2020-04-15,Grenada,GD,0,0,111454,14,0
2020-04-16,Grenada,GD,0,0,111454,14,0
2020-04-17,Grenada,GD,0,0,111454,14,0
2020-04-18,Grenada,GD,0,0,111454,14,0
2020-04-19,Grenada,GD,0,0,111454,14,0
2020-04-20,Grenada,GD,0,0,111454,14,0
2020-04-21,Grenada,GD,0,0,111454,14,0
2020-04-22,Grenada,GD,0,0,111454,14,0
2020-04-23,Grenada,GD,1,0,111454,15,0
2020-04-24,Grenada,GD,0,0,111454,15,0
2020-04-25,Grenada,GD,0,0,111454,15,0
2020-04-26,Grenada,GD,3,0,111454,18,0
2020-04-27,Grenada,GD,0,0,111454,18,0
2020-04-28,Grenada,GD,0,0,111454,18,0
2020-04-29,Grenada,GD,0,0,111454,18,0
2020-04-30,Grenada,GD,2,0,111454,20,0
2020-05-01,Grenada,GD,0,0,111454,20,0
2020-05-02,Grenada,GD,0,0,111454,20,0
2020-05-03,Grenada,GD,1,0,111454,21,0
2019-12-31,Georgia,GE,0,0,3731000,0,0
2020-01-01,Georgia,GE,0,0,3731000,0,0
2020-01-02,Georgia,GE,0,0,3731000,0,0
2020-01-03,Georgia,GE,0,0,3731000,0,0
2020-01-04,Georgia,GE,0,0,3731000,0,0
2020-01-05,Georgia,GE,0,0,3731000,0,0
2020-01-06,Georgia,GE,0,0,3731000,0,0
2020-01-07,Georgia,GE,0,0,3731000,0,0
2020-01-08,Georgia,GE,0,0,3731000,0,0
2020-01-09,Georgia,GE,0,0,3731000,0,0
2020-01-10,Georgia,GE,0,0,3731000,0,0
2020-01-11,Georgia,GE,0,0,3731000,0,0
2020-01-12,Georgia,GE,0,0,3731000,0,0
2020-01-13,Georgia,GE,0,0,3731000,0,0
2020-01-14,Georgia,GE,0,0,3731000,0,0
2020-01-15,Georgia,GE,0,0,3731000,0,0
2020-01-16,Georgia,GE,0,0,3731000,0,0
2020-01-17,Georgia,GE,0,0,3731000,0,0
2020-01-18,Georgia,GE,0,0,3731000,0,0
2020-01-19,Georgia,GE,0,0,3731000,0,0
2020-01-20,Georgia,GE,0,0,3731000,0,0
2020-01-21,Georgia,GE,0,0,3731000,0,0
2020-01-22,Georgia,GE,0,0,3731000,0,0
2020-01-23,Georgia,GE,0,0,3731000,0,0
2020-01-24,Georgia,GE,0,0,3731000,0,0
2020-01-25,Georgia,GE,0,0,3731000,0,0
2020-01-26,Georgia,GE,0,0,3731000,0,0
2020-01-27,Georgia,GE,0,0,3731000,0,0
2020-01-28,Georgia,GE,0,0,3731000,0,0
2020-01-29,Georgia,GE,0,0,3731000,0,0
2020-01-30,Georgia,GE,0,0,3731000,0,0
2020-01-31,Georgia,GE,0,0,3731000,0,0
2020-02-01,Georgia,GE,0,0,3731000,0,0
2020-02-02,Georgia,GE,0,0,3731000,0,0
2020-02-03,Georgia,GE,0,0,3731000,0,0
2020-02-04,Georgia,GE,0,0,3731000,0,0
2020-02-05,Georgia,GE,0,0,3731000,0,0
2020-02-06,Georgia,GE,0,0,3731000,0,0
2020-02-07,Georgia,GE,0,0,3731000,0,0
2020-02-08,Georgia,GE,0,0,3731000,0,0
2020-02-09,Georgia,GE,0,0,3731000,0,0
2020-02-10,Georgia,GE,0,0,3731000,0,0
2020-02-11,Georgia,GE,0,0,3731000,0,0
2020-02-12,Georgia,GE,0,0,3731000,0,0
2020-02-13,Georgia,GE,0,0,3731000,0,0
2020-02-14,Georgia,GE,0,0,3731000,0,0
2020-02-15,Georgia,GE,0,0,3731000,0,0
2020-02-16,Georgia,GE,0,0,3731000,0,0
2020-02-17,Georgia,GE,0,0,3731000,0,0
2020-02-18,Georgia,GE,0,0,3731000,0,0
2020-02-19,Georgia,GE,0,0,3731000,0,0
2020-02-20,Georgia,GE,0,0,3731000,0,0
2020-02-21,Georgia,GE,0,0,3731000,0,0
2020-02-22,Georgia,GE,0,0,3731000,0,0
2020-02-23,Georgia,GE,0,0,3731000,0,0
2020-02-24,Georgia,GE,0,0,3731000,0,0
2020-02-25,Georgia,GE,0,0,3731000,0,0
2020-02-26,Georgia,GE,0,0,3731000,0,0
2020-02-27,Georgia,GE,1,0,3731000,1,0
2020-02-28,Georgia,GE,0,0,3731000,1,0
2020-02-29,Georgia,GE,1,0,3731000,2,0
2020-03-01,Georgia,GE,1,0,3731000,3,0
2020-03-02,Georgia,GE,0,0,3731000,3,0
2020-03-05,Georgia,GE,0,0,3731000,3,0
2020-03-06,Georgia,GE,6,0,3731000,9,0
2020-03-08,Georgia,GE,3,0,3731000,12,0
2020-03-09,Georgia,GE,1,0,3731000,13,0
2020-03-10,Georgia,GE,2,0,3731000,15,0
2020-03-11,Georgia,GE,8,0,3731000,23,0
2020-03-12,Georgia,GE,1,0,3731000,24,0
2020-03-13,Georgia,GE,1,0,3731000,25,0
2020-03-14,Georgia,GE,5,0,3731000,30,0
2020-03-15,Georgia,GE,0,0,3731000,30,0
2020-03-16,Georgia,GE,0,0,3731000,30,0
2020-03-17,Georgia,GE,3,0,3731000,33,0
2020-03-18,Georgia,GE,1,0,3731000,34,0
2020-03-19,Georgia,GE,0,0,3731000,34,0
2020-03-20,Georgia,GE,6,0,3731000,40,0
2020-03-21,Georgia,GE,3,0,3731000,43,0
2020-03-22,Georgia,GE,6,0,3731000,49,0
2020-03-23,Georgia,GE,5,0,3731000,54,0
2020-03-24,Georgia,GE,7,0,3731000,61,0
2020-03-25,Georgia,GE,9,0,3731000,70,0
2020-03-26,Georgia,GE,3,0,3731000,73,0
2020-03-27,Georgia,GE,6,0,3731000,79,0
2020-03-28,Georgia,GE,2,0,3731000,81,0
2020-03-29,Georgia,GE,4,0,3731000,85,0
2020-03-30,Georgia,GE,5,0,3731000,90,0
2020-03-31,Georgia,GE,8,0,3731000,98,0
2020-04-01,Georgia,GE,12,0,3731000,110,0
2020-04-02,Georgia,GE,5,0,3731000,115,0
2020-04-03,Georgia,GE,6,0,3731000,121,0
2020-04-04,Georgia,GE,27,0,3731000,148,0
2020-04-05,Georgia,GE,9,0,3731000,157,0
2020-04-06,Georgia,GE,17,2,3731000,174,2
2020-04-07,Georgia,GE,14,0,3731000,188,2
2020-04-08,Georgia,GE,8,1,3731000,196,3
2020-04-09,Georgia,GE,15,0,3731000,211,3
2020-04-10,Georgia,GE,7,0,3731000,218,3
2020-04-11,Georgia,GE,16,0,3731000,234,3
2020-04-12,Georgia,GE,8,0,3731000,242,3
2020-04-13,Georgia,GE,15,0,3731000,257,3
2020-04-14,Georgia,GE,15,0,3731000,272,3
2020-04-15,Georgia,GE,28,0,3731000,300,3
2020-04-16,Georgia,GE,6,0,3731000,306,3
2020-04-17,Georgia,GE,42,0,3731000,348,3
2020-04-18,Georgia,GE,22,0,3731000,370,3
2020-04-19,Georgia,GE,18,1,3731000,388,4
2020-04-20,Georgia,GE,6,0,3731000,394,4
2020-04-21,Georgia,GE,8,0,3731000,402,4
2020-04-22,Georgia,GE,6,0,3731000,408,4
2020-04-23,Georgia,GE,8,1,3731000,416,5
2020-04-24,Georgia,GE,9,0,3731000,425,5
2020-04-25,Georgia,GE,19,0,3731000,444,5
2020-04-26,Georgia,GE,12,0,3731000,456,5
2020-04-27,Georgia,GE,30,1,3731000,486,6
2020-04-28,Georgia,GE,11,0,3731000,497,6
2020-04-29,Georgia,GE,14,0,3731000,511,6
2020-04-30,Georgia,GE,6,0,3731000,517,6
2020-05-01,Georgia,GE,22,0,3731000,539,6
2020-05-02,Georgia,GE,43,2,3731000,582,8
2020-05-03,Georgia,GE,0,0,3731000,582,8
2020-03-20,Guernsey,GG,1,0,63026,1,0
2020-03-21,Guernsey,GG,0,0,63026,1,0
2020-03-22,Guernsey,GG,0,0,63026,1,0
2020-03-23,Guernsey,GG,16,0,63026,17,0
2020-03-24,Guernsey,GG,3,0,63026,20,0
2020-03-25,Guernsey,GG,3,0,63026,23,0
2020-03-26,Guernsey,GG,7,0,63026,30,0
2020-03-27,Guernsey,GG,4,0,63026,34,0
2020-03-28,Guernsey,GG,2,0,63026,36,0
2020-03-29,Guernsey,GG,3,0,63026,39,0
2020-03-30,Guernsey,GG,6,0,63026,45,0
2020-03-31,Guernsey,GG,0,0,63026,45,0
2020-04-01,Guernsey,GG,15,0,63026,60,0
2020-04-02,Guernsey,GG,18,0,63026,78,0
2020-04-03,Guernsey,GG,13,0,63026,91,0
2020-04-04,Guernsey,GG,23,2,63026,114,2
2020-04-05,Guernsey,GG,22,0,63026,136,2
2020-04-06,Guernsey,GG,18,1,63026,154,3
2020-04-07,Guernsey,GG,11,1,63026,165,4
2020-04-08,Guernsey,GG,1,0,63026,166,4
2020-04-09,Guernsey,GG,15,1,63026,181,5
2020-04-10,Guernsey,GG,10,0,63026,191,5
2020-04-11,Guernsey,GG,9,1,63026,200,6
2020-04-12,Guernsey,GG,9,0,63026,209,6
2020-04-13,Guernsey,GG,9,0,63026,218,6
2020-04-14,Guernsey,GG,1,0,63026,219,6
2020-04-15,Guernsey,GG,4,1,63026,223,7
2020-04-16,Guernsey,GG,0,0,63026,223,7
2020-04-17,Guernsey,GG,11,2,63026,234,9
2020-04-18,Guernsey,GG,0,0,63026,234,9
2020-04-19,Guernsey,GG,5,0,63026,239,9
2020-04-20,Guernsey,GG,0,0,63026,239,9
2020-04-21,Guernsey,GG,0,1,63026,239,10
2020-04-22,Guernsey,GG,0,0,63026,239,10
2020-04-23,Guernsey,GG,4,0,63026,243,10
2020-04-24,Guernsey,GG,2,0,63026,245,10
2020-04-25,Guernsey,GG,0,1,63026,245,11
2020-04-26,Guernsey,GG,0,1,63026,245,12
2020-04-27,Guernsey,GG,2,1,63026,247,13
2020-04-28,Guernsey,GG,0,0,63026,247,13
2020-04-29,Guernsey,GG,0,0,63026,247,13
2020-04-30,Guernsey,GG,4,0,63026,251,13
2020-05-01,Guernsey,GG,0,0,63026,251,13
2020-05-02,Guernsey,GG,1,0,63026,252,13
2020-05-03,Guernsey,GG,0,0,63026,252,13
2020-03-13,Ghana,GH,2,0,29767108,2,0
2020-03-15,Ghana,GH,0,0,29767108,2,0
2020-03-16,Ghana,GH,0,0,29767108,2,0
2020-03-17,Ghana,GH,4,0,29767108,6,0
2020-03-18,Ghana,GH,0,0,29767108,6,0
2020-03-19,Ghana,GH,1,0,29767108,7,0
2020-03-20,Ghana,GH,4,0,29767108,11,0
2020-03-21,Ghana,GH,5,0,29767108,16,0
2020-03-22,Ghana,GH,5,1,29767108,21,1
2020-03-23,Ghana,GH,3,0,29767108,24,1
2020-03-24,Ghana,GH,3,1,29767108,27,2
2020-03-25,Ghana,GH,26,0,29767108,53,2
2020-03-26,Ghana,GH,15,1,29767108,68,3
2020-03-27,Ghana,GH,64,0,29767108,132,3
2020-03-28,Ghana,GH,5,0,29767108,137,3
2020-03-29,Ghana,GH,4,2,29767108,141,5
2020-03-30,Ghana,GH,11,0,29767108,152,5
2020-03-31,Ghana,GH,0,0,29767108,152,5
2020-04-01,Ghana,GH,0,0,29767108,152,5
2020-04-02,Ghana,GH,43,0,29767108,195,5
2020-04-03,Ghana,GH,9,0,29767108,204,5
2020-04-04,Ghana,GH,1,0,29767108,205,5
2020-04-05,Ghana,GH,9,0,29767108,214,5
2020-04-06,Ghana,GH,0,0,29767108,214,5
2020-04-07,Ghana,GH,73,0,29767108,287,5
2020-04-08,Ghana,GH,0,0,29767108,287,5
2020-04-09,Ghana,GH,26,1,29767108,313,6
2020-04-10,Ghana,GH,65,0,29767108,378,6
2020-04-11,Ghana,GH,0,0,29767108,378,6
2020-04-12,Ghana,GH,30,2,29767108,408,8
2020-04-13,Ghana,GH,158,0,29767108,566,8
2020-04-14,Ghana,GH,0,0,29767108,566,8
2020-04-15,Ghana,GH,70,0,29767108,636,8
2020-04-16,Ghana,GH,5,0,29767108,641,8
2020-04-17,Ghana,GH,0,0,29767108,641,8
2020-04-18,Ghana,GH,0,0,29767108,641,8
2020-04-19,Ghana,GH,193,1,29767108,834,9
2020-04-20,Ghana,GH,208,0,29767108,1042,9
2020-04-21,Ghana,GH,0,0,29767108,1042,9
2020-04-22,Ghana,GH,0,0,29767108,1042,9
2020-04-23,Ghana,GH,112,0,29767108,1154,9
2020-04-24,Ghana,GH,0,0,29767108,1154,9
2020-04-25,Ghana,GH,125,1,29767108,1279,10
2020-04-26,Ghana,GH,0,0,29767108,1279,10
2020-04-27,Ghana,GH,271,1,29767108,1550,11
2020-04-28,Ghana,GH,0,0,29767108,1550,11
2020-04-29,Ghana,GH,121,5,29767108,1671,16
2020-04-30,Ghana,GH,0,0,29767108,1671,16
2020-05-01,Ghana,GH,403,1,29767108,2074,17
2020-05-02,Ghana,GH,0,0,29767108,2074,17
2020-05-03,Ghana,GH,95,1,29767108,2169,18
2020-03-20,Gibraltar,GI,10,0,33718,10,0
2020-03-21,Gibraltar,GI,0,0,33718,10,0
2020-03-22,Gibraltar,GI,0,0,33718,10,0
2020-03-23,Gibraltar,GI,5,0,33718,15,0
2020-03-24,Gibraltar,GI,0,0,33718,15,0
2020-03-25,Gibraltar,GI,0,0,33718,15,0
2020-03-26,Gibraltar,GI,11,0,33718,26,0
2020-03-27,Gibraltar,GI,9,0,33718,35,0
2020-03-28,Gibraltar,GI,20,0,33718,55,0
2020-03-29,Gibraltar,GI,1,0,33718,56,0
2020-03-30,Gibraltar,GI,9,0,33718,65,0
2020-03-31,Gibraltar,GI,4,0,33718,69,0
2020-04-01,Gibraltar,GI,0,0,33718,69,0
2020-04-02,Gibraltar,GI,0,0,33718,69,0
2020-04-03,Gibraltar,GI,19,0,33718,88,0
2020-04-04,Gibraltar,GI,7,0,33718,95,0
2020-04-05,Gibraltar,GI,3,0,33718,98,0
2020-04-06,Gibraltar,GI,5,0,33718,103,0
2020-04-07,Gibraltar,GI,6,0,33718,109,0
2020-04-08,Gibraltar,GI,4,0,33718,113,0
2020-04-09,Gibraltar,GI,7,0,33718,120,0
2020-04-10,Gibraltar,GI,3,0,33718,123,0
2020-04-11,Gibraltar,GI,4,0,33718,127,0
2020-04-12,Gibraltar,GI,2,0,33718,129,0
2020-04-13,Gibraltar,GI,0,0,33718,129,0
2020-04-14,Gibraltar,GI,0,0,33718,129,0
2020-04-15,Gibraltar,GI,0,0,33718,129,0
2020-04-16,Gibraltar,GI,2,0,33718,131,0
2020-04-17,Gibraltar,GI,2,0,33718,133,0
2020-04-18,Gibraltar,GI,0,0,33718,133,0
2020-04-19,Gibraltar,GI,0,0,33718,133,0
2020-04-20,Gibraltar,GI,0,0,33718,133,0
2020-04-21,Gibraltar,GI,0,0,33718,133,0
2020-04-22,Gibraltar,GI,0,0,33718,133,0
2020-04-23,Gibraltar,GI,0,0,33718,133,0
2020-04-24,Gibraltar,GI,0,0,33718,133,0
2020-04-25,Gibraltar,GI,0,0,33718,133,0
2020-04-26,Gibraltar,GI,3,0,33718,136,0
2020-04-27,Gibraltar,GI,5,0,33718,141,0
2020-04-28,Gibraltar,GI,0,0,33718,141,0
2020-04-29,Gibraltar,GI,0,0,33718,141,0
2020-04-30,Gibraltar,GI,0,0,33718,141,0
2020-05-01,Gibraltar,GI,3,0,33718,144,0
2020-05-02,Gibraltar,GI,0,0,33718,144,0
2020-05-03,Gibraltar,GI,0,0,33718,144,0
2020-03-20,Greenland,GL,2,0,56025,2,0
2020-03-21,Greenland,GL,0,0,56025,2,0
2020-03-22,Greenland,GL,0,0,56025,2,0
2020-03-23,Greenland,GL,0,0,56025,2,0
2020-03-24,Greenland,GL,2,0,56025,4,0
2020-03-25,Greenland,GL,0,0,56025,4,0
2020-03-26,Greenland,GL,1,0,56025,5,0
2020-03-27,Greenland,GL,1,0,56025,6,0
2020-03-28,Greenland,GL,3,0,56025,9,0
2020-03-29,Greenland,GL,1,0,56025,10,0
2020-03-30,Greenland,GL,0,0,56025,10,0
2020-03-31,Greenland,GL,0,0,56025,10,0
2020-04-01,Greenland,GL,0,0,56025,10,0
2020-04-02,Greenland,GL,0,0,56025,10,0
2020-04-03,Greenland,GL,0,0,56025,10,0
2020-04-04,Greenland,GL,0,0,56025,10,0
2020-04-05,Greenland,GL,0,0,56025,10,0
2020-04-06,Greenland,GL,1,0,56025,11,0
2020-04-07,Greenland,GL,0,0,56025,11,0
2020-04-08,Greenland,GL,0,0,56025,11,0
2020-04-09,Greenland,GL,0,0,56025,11,0
2020-04-10,Greenland,GL,0,0,56025,11,0
2020-04-11,Greenland,GL,0,0,56025,11,0
2020-04-12,Greenland,GL,0,0,56025,11,0
2020-04-13,Greenland,GL,0,0,56025,11,0
2020-04-14,Greenland,GL,0,0,56025,11,0
2020-04-15,Greenland,GL,0,0,56025,11,0
2020-04-16,Greenland,GL,0,0,56025,11,0
2020-04-17,Greenland,GL,0,0,56025,11,0
2020-04-18,Greenland,GL,0,0,56025,11,0
2020-04-19,Greenland,GL,0,0,56025,11,0
2020-04-20,Greenland,GL,0,0,56025,11,0
2020-04-21,Greenland,GL,0,0,56025,11,0
2020-04-22,Greenland,GL,0,0,56025,11,0
2020-04-23,Greenland,GL,0,0,56025,11,0
2020-04-24,Greenland,GL,0,0,56025,11,0
2020-04-25,Greenland,GL,0,0,56025,11,0
2020-04-26,Greenland,GL,0,0,56025,11,0
2020-04-27,Greenland,GL,0,0,56025,11,0
2020-04-28,Greenland,GL,0,0,56025,11,0
2020-04-29,Greenland,GL,0,0,56025,11,0
2020-04-30,Greenland,GL,0,0,56025,11,0
2020-05-01,Greenland,GL,0,0,56025,11,0
2020-05-02,Greenland,GL,0,0,56025,11,0
2020-05-03,Greenland,GL,0,0,56025,11,0
2020-03-18,Gambia,GM,1,0,2280102,1,0
2020-03-19,Gambia,GM,0,0,2280102,1,0
2020-03-20,Gambia,GM,0,0,2280102,1,0
2020-03-21,Gambia,GM,0,0,2280102,1,0
2020-03-22,Gambia,GM,0,0,2280102,1,0
2020-03-23,Gambia,GM,0,0,2280102,1,0
2020-03-24,Gambia,GM,1,1,2280102,2,1
2020-03-25,Gambia,GM,1,0,2280102,3,1
2020-03-26,Gambia,GM,0,0,2280102,3,1
2020-03-27,Gambia,GM,0,0,2280102,3,1
2020-03-28,Gambia,GM,0,0,2280102,3,1
2020-03-29,Gambia,GM,0,0,2280102,3,1
2020-03-30,Gambia,GM,0,0,2280102,3,1
2020-03-31,Gambia,GM,1,0,2280102,4,1
2020-04-01,Gambia,GM,0,0,2280102,4,1
2020-04-02,Gambia,GM,0,0,2280102,4,1
2020-04-03,Gambia,GM,0,0,2280102,4,1
2020-04-04,Gambia,GM,0,0,2280102,4,1
2020-04-05,Gambia,GM,0,0,2280102,4,1
2020-04-06,Gambia,GM,0,0,2280102,4,1
2020-04-07,Gambia,GM,0,0,2280102,4,1
2020-04-08,Gambia,GM,0,0,2280102,4,1
2020-04-09,Gambia,GM,0,0,2280102,4,1
2020-04-10,Gambia,GM,0,0,2280102,4,1
2020-04-11,Gambia,GM,0,0,2280102,4,1
2020-04-12,Gambia,GM,5,0,2280102,9,1
2020-04-13,Gambia,GM,0,0,2280102,9,1
2020-04-14,Gambia,GM,0,0,2280102,9,1
2020-04-15,Gambia,GM,0,0,2280102,9,1
2020-04-16,Gambia,GM,0,0,2280102,9,1
2020-04-17,Gambia,GM,0,0,2280102,9,1
2020-04-18,Gambia,GM,0,0,2280102,9,1
2020-04-19,Gambia,GM,0,0,2280102,9,1
2020-04-20,Gambia,GM,1,0,2280102,10,1
2020-04-21,Gambia,GM,0,0,2280102,10,1
2020-04-22,Gambia,GM,0,0,2280102,10,1
2020-04-23,Gambia,GM,0,0,2280102,10,1
2020-04-24,Gambia,GM,0,0,2280102,10,1
2020-04-25,Gambia,GM,0,0,2280102,10,1
2020-04-26,Gambia,GM,0,0,2280102,10,1
2020-04-27,Gambia,GM,0,0,2280102,10,1
2020-04-28,Gambia,GM,0,0,2280102,10,1
2020-04-29,Gambia,GM,0,0,2280102,10,1
2020-04-30,Gambia,GM,1,0,2280102,11,1
2020-05-01,Gambia,GM,1,0,2280102,12,1
2020-05-02,Gambia,GM,0,0,2280102,12,1
2020-05-03,Gambia,GM,5,0,2280102,17,1
2020-03-14,Guinea,GN,1,0,12414318,1,0
2020-03-15,Guinea,GN,0,0,12414318,1,0
2020-03-17,Guinea,GN,0,0,12414318,1,0
2020-03-18,Guinea,GN,0,0,12414318,1,0
2020-03-19,Guinea,GN,0,0,12414318,1,0
2020-03-20,Guinea,GN,0,0,12414318,1,0
2020-03-21,Guinea,GN,1,0,12414318,2,0
2020-03-22,Guinea,GN,0,0,12414318,2,0
2020-03-23,Guinea,GN,0,0,12414318,2,0
2020-03-24,Guinea,GN,0,0,12414318,2,0
2020-03-25,Guinea,GN,2,0,12414318,4,0
2020-03-26,Guinea,GN,0,0,12414318,4,0
2020-03-27,Guinea,GN,1,0,12414318,5,0
2020-03-28,Guinea,GN,0,0,12414318,5,0
2020-03-29,Guinea,GN,3,0,12414318,8,0
2020-03-30,Guinea,GN,0,0,12414318,8,0
2020-03-31,Guinea,GN,8,0,12414318,16,0
2020-04-01,Guinea,GN,0,0,12414318,16,0
2020-04-02,Guinea,GN,14,0,12414318,30,0
2020-04-03,Guinea,GN,22,0,12414318,52,0
2020-04-04,Guinea,GN,0,0,12414318,52,0
2020-04-05,Guinea,GN,59,0,12414318,111,0
2020-04-06,Guinea,GN,10,0,12414318,121,0
2020-04-07,Guinea,GN,7,0,12414318,128,0
2020-04-08,Guinea,GN,16,0,12414318,144,0
2020-04-09,Guinea,GN,20,0,12414318,164,0
2020-04-10,Guinea,GN,30,0,12414318,194,0
2020-04-11,Guinea,GN,18,0,12414318,212,0
2020-04-12,Guinea,GN,38,0,12414318,250,0
2020-04-13,Guinea,GN,0,0,12414318,250,0
2020-04-14,Guinea,GN,69,0,12414318,319,0
2020-04-15,Guinea,GN,44,0,12414318,363,0
2020-04-16,Guinea,GN,41,1,12414318,404,1
2020-04-17,Guinea,GN,34,0,12414318,438,1
2020-04-18,Guinea,GN,39,2,12414318,477,3
2020-04-19,Guinea,GN,0,0,12414318,477,3
2020-04-20,Guinea,GN,102,2,12414318,579,5
2020-04-21,Guinea,GN,43,0,12414318,622,5
2020-04-22,Guinea,GN,66,1,12414318,688,6
2020-04-23,Guinea,GN,73,0,12414318,761,6
2020-04-24,Guinea,GN,101,0,12414318,862,6
2020-04-25,Guinea,GN,92,0,12414318,954,6
2020-04-26,Guinea,GN,42,1,12414318,996,7
2020-04-27,Guinea,GN,98,0,12414318,1094,7
2020-04-28,Guinea,GN,69,0,12414318,1163,7
2020-04-29,Guinea,GN,77,0,12414318,1240,7
2020-04-30,Guinea,GN,111,0,12414318,1351,7
2020-05-01,Guinea,GN,144,0,12414318,1495,7
2020-05-02,Guinea,GN,42,0,12414318,1537,7
2020-05-03,Guinea,GN,49,0,12414318,1586,7
2020-03-15,Equatorial_Guinea,GQ,1,0,1308974,1,0
2020-03-16,Equatorial_Guinea,GQ,0,0,1308974,1,0
2020-03-17,Equatorial_Guinea,GQ,0,0,1308974,1,0
2020-03-18,Equatorial_Guinea,GQ,0,0,1308974,1,0
2020-03-19,Equatorial_Guinea,GQ,2,0,1308974,3,0
2020-03-20,Equatorial_Guinea,GQ,1,0,1308974,4,0
2020-03-21,Equatorial_Guinea,GQ,0,0,1308974,4,0
2020-03-22,Equatorial_Guinea,GQ,2,0,1308974,6,0
2020-03-23,Equatorial_Guinea,GQ,0,0,1308974,6,0
2020-03-24,Equatorial_Guinea,GQ,3,0,1308974,9,0
2020-03-25,Equatorial_Guinea,GQ,0,0,1308974,9,0
2020-03-26,Equatorial_Guinea,GQ,2,0,1308974,11,0
2020-03-27,Equatorial_Guinea,GQ,1,0,1308974,12,0
2020-03-28,Equatorial_Guinea,GQ,1,0,1308974,13,0
2020-03-29,Equatorial_Guinea,GQ,0,0,1308974,13,0
2020-03-30,Equatorial_Guinea,GQ,1,0,1308974,14,0
2020-03-31,Equatorial_Guinea,GQ,0,0,1308974,14,0
2020-04-01,Equatorial_Guinea,GQ,1,0,1308974,15,0
2020-04-02,Equatorial_Guinea,GQ,0,0,1308974,15,0
2020-04-03,Equatorial_Guinea,GQ,0,0,1308974,15,0
2020-04-04,Equatorial_Guinea,GQ,1,0,1308974,16,0
2020-04-05,Equatorial_Guinea,GQ,0,0,1308974,16,0
2020-04-06,Equatorial_Guinea,GQ,0,0,1308974,16,0
2020-04-07,Equatorial_Guinea,GQ,0,0,1308974,16,0
2020-04-08,Equatorial_Guinea,GQ,0,0,1308974,16,0
2020-04-09,Equatorial_Guinea,GQ,2,0,1308974,18,0
2020-04-10,Equatorial_Guinea,GQ,0,0,1308974,18,0
2020-04-11,Equatorial_Guinea,GQ,0,0,1308974,18,0
2020-04-12,Equatorial_Guinea,GQ,0,0,1308974,18,0
2020-04-13,Equatorial_Guinea,GQ,3,0,1308974,21,0
2020-04-14,Equatorial_Guinea,GQ,0,0,1308974,21,0
2020-04-15,Equatorial_Guinea,GQ,20,0,1308974,41,0
2020-04-16,Equatorial_Guinea,GQ,10,0,1308974,51,0
2020-04-17,Equatorial_Guinea,GQ,0,0,1308974,51,0
2020-04-18,Equatorial_Guinea,GQ,28,0,1308974,79,0
2020-04-19,Equatorial_Guinea,GQ,0,0,1308974,79,0
2020-04-20,Equatorial_Guinea,GQ,0,0,1308974,79,0
2020-04-21,Equatorial_Guinea,GQ,0,0,1308974,79,0
2020-04-22,Equatorial_Guinea,GQ,0,0,1308974,79,0
2020-04-23,Equatorial_Guinea,GQ,4,0,1308974,83,0
2020-04-24,Equatorial_Guinea,GQ,1,1,1308974,84,1
2020-04-25,Equatorial_Guinea,GQ,128,0,1308974,212,1
2020-04-26,Equatorial_Guinea,GQ,2,0,1308974,214,1
2020-04-27,Equatorial_Guinea,GQ,44,0,1308974,258,1
2020-04-28,Equatorial_Guinea,GQ,0,0,1308974,258,1
2020-04-29,Equatorial_Guinea,GQ,57,0,1308974,315,1
2020-04-30,Equatorial_Guinea,GQ,0,0,1308974,315,1
2020-05-01,Equatorial_Guinea,GQ,0,0,1308974,315,1
2020-05-02,Equatorial_Guinea,GQ,0,0,1308974,315,1
2020-05-03,Equatorial_Guinea,GQ,0,0,1308974,315,1
2020-03-15,Guatemala,GT,1,0,17247807,1,0
2020-03-16,Guatemala,GT,0,1,17247807,1,1
2020-03-17,Guatemala,GT,5,0,17247807,6,1
2020-03-18,Guatemala,GT,0,0,17247807,6,1
2020-03-19,Guatemala,GT,2,0,17247807,8,1
2020-03-20,Guatemala,GT,1,0,17247807,9,1
2020-03-21,Guatemala,GT,4,0,17247807,13,1
2020-03-22,Guatemala,GT,4,0,17247807,17,1
2020-03-23,Guatemala,GT,2,0,17247807,19,1
2020-03-24,Guatemala,GT,1,0,17247807,20,1
2020-03-25,Guatemala,GT,1,0,17247807,21,1
2020-03-26,Guatemala,GT,3,0,17247807,24,1
2020-03-27,Guatemala,GT,1,0,17247807,25,1
2020-03-28,Guatemala,GT,7,0,17247807,32,1
2020-03-29,Guatemala,GT,2,0,17247807,34,1
2020-03-30,Guatemala,GT,2,0,17247807,36,1
2020-03-31,Guatemala,GT,0,0,17247807,36,1
2020-04-01,Guatemala,GT,2,0,17247807,38,1
2020-04-02,Guatemala,GT,8,0,17247807,46,1
2020-04-03,Guatemala,GT,1,0,17247807,47,1
2020-04-04,Guatemala,GT,3,0,17247807,50,1
2020-04-05,Guatemala,GT,11,1,17247807,61,2
2020-04-06,Guatemala,GT,9,1,17247807,70,3
2020-04-07,Guatemala,GT,4,0,17247807,74,3
2020-04-08,Guatemala,GT,6,0,17247807,80,3
2020-04-09,Guatemala,GT,7,0,17247807,87,3
2020-04-10,Guatemala,GT,39,0,17247807,126,3
2020-04-11,Guatemala,GT,11,0,17247807,137,3
2020-04-12,Guatemala,GT,16,0,17247807,153,3
2020-04-13,Guatemala,GT,3,2,17247807,156,5
2020-04-14,Guatemala,GT,11,0,17247807,167,5
2020-04-15,Guatemala,GT,13,0,17247807,180,5
2020-04-16,Guatemala,GT,16,0,17247807,196,5
2020-04-17,Guatemala,GT,18,2,17247807,214,7
2020-04-18,Guatemala,GT,21,0,17247807,235,7
2020-04-19,Guatemala,GT,22,0,17247807,257,7
2020-04-20,Guatemala,GT,32,0,17247807,289,7
2020-04-21,Guatemala,GT,5,0,17247807,294,7
2020-04-22,Guatemala,GT,22,1,17247807,316,8
2020-04-23,Guatemala,GT,26,2,17247807,342,10
2020-04-24,Guatemala,GT,42,1,17247807,384,11
2020-04-25,Guatemala,GT,46,0,17247807,430,11
2020-04-26,Guatemala,GT,43,2,17247807,473,13
2020-04-27,Guatemala,GT,27,2,17247807,500,15
2020-04-28,Guatemala,GT,30,0,17247807,530,15
2020-04-29,Guatemala,GT,27,1,17247807,557,16
2020-04-30,Guatemala,GT,28,0,17247807,585,16
2020-05-01,Guatemala,GT,14,0,17247807,599,16
2020-05-02,Guatemala,GT,45,0,17247807,644,16
2020-05-03,Guatemala,GT,44,1,17247807,688,17
2020-03-19,Guam,GU,3,0,165768,3,0
2020-03-20,Guam,GU,9,0,165768,12,0
2020-03-21,Guam,GU,2,0,165768,14,0
2020-03-22,Guam,GU,1,1,165768,15,1
2020-03-23,Guam,GU,12,0,165768,27,1
2020-03-24,Guam,GU,2,0,165768,29,1
2020-03-25,Guam,GU,3,0,165768,32,1
2020-03-26,Guam,GU,5,0,165768,37,1
2020-03-27,Guam,GU,12,0,165768,49,1
2020-03-28,Guam,GU,2,0,165768,51,1
2020-03-29,Guam,GU,4,0,165768,55,1
2020-03-30,Guam,GU,1,0,165768,56,1
2020-03-31,Guam,GU,4,0,165768,60,1
2020-04-01,Guam,GU,9,2,165768,69,3
2020-04-02,Guam,GU,8,0,165768,77,3
2020-04-03,Guam,GU,5,0,165768,82,3
2020-04-04,Guam,GU,5,1,165768,87,4
2020-04-05,Guam,GU,6,0,165768,93,4
2020-04-06,Guam,GU,17,0,165768,110,4
2020-04-07,Guam,GU,2,0,165768,112,4
2020-04-08,Guam,GU,9,0,165768,121,4
2020-04-09,Guam,GU,4,0,165768,125,4
2020-04-10,Guam,GU,3,0,165768,128,4
2020-04-11,Guam,GU,2,0,165768,130,4
2020-04-12,Guam,GU,3,1,165768,133,5
2020-04-13,Guam,GU,0,0,165768,133,5
2020-04-14,Guam,GU,1,0,165768,134,5
2020-04-15,Guam,GU,1,0,165768,135,5
2020-04-16,Guam,GU,0,0,165768,135,5
2020-04-17,Guam,GU,0,0,165768,135,5
2020-04-18,Guam,GU,1,0,165768,136,5
2020-04-19,Guam,GU,0,0,165768,136,5
2020-04-20,Guam,GU,0,0,165768,136,5
2020-04-21,Guam,GU,0,0,165768,136,5
2020-04-22,Guam,GU,0,0,165768,136,5
2020-04-23,Guam,GU,1,0,165768,137,5
2020-04-24,Guam,GU,3,0,165768,140,5
2020-04-25,Guam,GU,1,0,165768,141,5
2020-04-26,Guam,GU,0,0,165768,141,5
2020-04-27,Guam,GU,1,0,165768,142,5
2020-04-28,Guam,GU,2,0,165768,144,5
2020-04-29,Guam,GU,1,0,165768,145,5
2020-04-30,Guam,GU,0,0,165768,145,5
2020-05-01,Guam,GU,1,0,165768,146,5
2020-05-02,Guam,GU,0,0,165768,146,5
2020-05-03,Guam,GU,2,0,165768,148,5
2020-03-27,Guinea_Bissau,GW,2,0,1874309,2,0
2020-03-28,Guinea_Bissau,GW,0,0,1874309,2,0
2020-03-29,Guinea_Bissau,GW,0,0,1874309,2,0
2020-03-30,Guinea_Bissau,GW,0,0,1874309,2,0
2020-03-31,Guinea_Bissau,GW,0,0,1874309,2,0
2020-04-01,Guinea_Bissau,GW,6,0,1874309,8,0
2020-04-02,Guinea_Bissau,GW,1,0,1874309,9,0
2020-04-03,Guinea_Bissau,GW,0,0,1874309,9,0
2020-04-04,Guinea_Bissau,GW,6,0,1874309,15,0
2020-04-05,Guinea_Bissau,GW,3,0,1874309,18,0
2020-04-06,Guinea_Bissau,GW,0,0,1874309,18,0
2020-04-07,Guinea_Bissau,GW,15,0,1874309,33,0
2020-04-08,Guinea_Bissau,GW,0,0,1874309,33,0
2020-04-09,Guinea_Bissau,GW,0,0,1874309,33,0
2020-04-10,Guinea_Bissau,GW,2,0,1874309,35,0
2020-04-11,Guinea_Bissau,GW,0,0,1874309,35,0
2020-04-12,Guinea_Bissau,GW,3,0,1874309,38,0
2020-04-13,Guinea_Bissau,GW,1,0,1874309,39,0
2020-04-14,Guinea_Bissau,GW,0,0,1874309,39,0
2020-04-15,Guinea_Bissau,GW,1,0,1874309,40,0
2020-04-16,Guinea_Bissau,GW,3,0,1874309,43,0
2020-04-17,Guinea_Bissau,GW,3,0,1874309,46,0
2020-04-18,Guinea_Bissau,GW,4,0,1874309,50,0
2020-04-19,Guinea_Bissau,GW,0,0,1874309,50,0
2020-04-20,Guinea_Bissau,GW,0,0,1874309,50,0
2020-04-21,Guinea_Bissau,GW,0,0,1874309,50,0
2020-04-22,Guinea_Bissau,GW,0,0,1874309,50,0
2020-04-23,Guinea_Bissau,GW,0,0,1874309,50,0
2020-04-24,Guinea_Bissau,GW,2,0,1874309,52,0
2020-04-25,Guinea_Bissau,GW,0,0,1874309,52,0
2020-04-26,Guinea_Bissau,GW,0,0,1874309,52,0
2020-04-27,Guinea_Bissau,GW,1,1,1874309,53,1
2020-04-28,Guinea_Bissau,GW,20,0,1874309,73,1
2020-04-29,Guinea_Bissau,GW,0,0,1874309,73,1
2020-04-30,Guinea_Bissau,GW,4,0,1874309,77,1
2020-05-01,Guinea_Bissau,GW,128,0,1874309,205,1
2020-05-02,Guinea_Bissau,GW,52,0,1874309,257,1
2020-05-03,Guinea_Bissau,GW,0,0,1874309,257,1
2020-03-13,Guyana,GY,1,1,779004,1,1
2020-03-16,Guyana,GY,3,0,779004,4,1
2020-03-17,Guyana,GY,0,0,779004,4,1
2020-03-18,Guyana,GY,0,0,779004,4,1
2020-03-19,Guyana,GY,1,0,779004,5,1
2020-03-20,Guyana,GY,0,0,779004,5,1
2020-03-21,Guyana,GY,0,0,779004,5,1
2020-03-22,Guyana,GY,0,0,779004,5,1
2020-03-23,Guyana,GY,0,0,779004,5,1
2020-03-24,Guyana,GY,0,0,779004,5,1
2020-03-25,Guyana,GY,0,0,779004,5,1
2020-03-26,Guyana,GY,0,0,779004,5,1
2020-03-27,Guyana,GY,0,0,779004,5,1
2020-03-28,Guyana,GY,0,0,779004,5,1
2020-03-29,Guyana,GY,3,0,779004,8,1
2020-03-30,Guyana,GY,0,0,779004,8,1
2020-03-31,Guyana,GY,0,0,779004,8,1
2020-04-01,Guyana,GY,4,1,779004,12,2
2020-04-02,Guyana,GY,7,2,779004,19,4
2020-04-03,Guyana,GY,0,0,779004,19,4
2020-04-04,Guyana,GY,4,0,779004,23,4
2020-04-05,Guyana,GY,1,0,779004,24,4
2020-04-06,Guyana,GY,5,0,779004,29,4
2020-04-07,Guyana,GY,2,1,779004,31,5
2020-04-08,Guyana,GY,2,0,779004,33,5
2020-04-09,Guyana,GY,4,1,779004,37,6
2020-04-10,Guyana,GY,0,0,779004,37,6
2020-04-11,Guyana,GY,3,0,779004,40,6
2020-04-12,Guyana,GY,5,0,779004,45,6
2020-04-13,Guyana,GY,0,0,779004,45,6
2020-04-14,Guyana,GY,2,0,779004,47,6
2020-04-15,Guyana,GY,1,0,779004,48,6
2020-04-16,Guyana,GY,7,0,779004,55,6
2020-04-17,Guyana,GY,2,0,779004,57,6
2020-04-18,Guyana,GY,6,0,779004,63,6
2020-04-19,Guyana,GY,0,1,779004,63,7
2020-04-20,Guyana,GY,2,0,779004,65,7
2020-04-21,Guyana,GY,1,0,779004,66,7
2020-04-22,Guyana,GY,1,0,779004,67,7
2020-04-23,Guyana,GY,0,0,779004,67,7
2020-04-24,Guyana,GY,3,0,779004,70,7
2020-04-25,Guyana,GY,3,1,779004,73,8
2020-04-26,Guyana,GY,1,0,779004,74,8
2020-04-27,Guyana,GY,0,0,779004,74,8
2020-04-28,Guyana,GY,0,0,779004,74,8
2020-04-29,Guyana,GY,1,0,779004,75,8
2020-04-30,Guyana,GY,3,0,779004,78,8
2020-05-01,Guyana,GY,4,1,779004,82,9
2020-05-02,Guyana,GY,0,0,779004,82,9
2020-05-03,Guyana,GY,0,0,779004,82,9
2020-03-12,Honduras,HN,2,0,9587522,2,0
2020-03-14,Honduras,HN,1,0,9587522,3,0
2020-03-16,Honduras,HN,3,0,9587522,6,0
2020-03-17,Honduras,HN,2,0,9587522,8,0
2020-03-18,Honduras,HN,1,0,9587522,9,0
2020-03-19,Honduras,HN,3,0,9587522,12,0
2020-03-20,Honduras,HN,12,0,9587522,24,0
2020-03-21,Honduras,HN,0,0,9587522,24,0
2020-03-22,Honduras,HN,2,0,9587522,26,0
2020-03-23,Honduras,HN,1,0,9587522,27,0
2020-03-24,Honduras,HN,3,0,9587522,30,0
2020-03-25,Honduras,HN,6,0,9587522,36,0
2020-03-26,Honduras,HN,16,0,9587522,52,0
2020-03-27,Honduras,HN,15,1,9587522,67,1
2020-03-28,Honduras,HN,28,0,9587522,95,1
2020-03-29,Honduras,HN,15,1,9587522,110,2
2020-03-30,Honduras,HN,29,1,9587522,139,3
2020-03-31,Honduras,HN,2,4,9587522,141,7
2020-04-01,Honduras,HN,31,3,9587522,172,10
2020-04-02,Honduras,HN,47,4,9587522,219,14
2020-04-03,Honduras,HN,3,1,9587522,222,15
2020-04-04,Honduras,HN,42,0,9587522,264,15
2020-04-05,Honduras,HN,4,7,9587522,268,22
2020-04-06,Honduras,HN,30,0,9587522,298,22
2020-04-07,Honduras,HN,7,0,9587522,305,22
2020-04-08,Honduras,HN,7,0,9587522,312,22
2020-04-09,Honduras,HN,31,1,9587522,343,23
2020-04-10,Honduras,HN,39,0,9587522,382,23
2020-04-11,Honduras,HN,10,1,9587522,392,24
2020-04-12,Honduras,HN,1,1,9587522,393,25
2020-04-13,Honduras,HN,4,0,9587522,397,25
2020-04-14,Honduras,HN,10,1,9587522,407,26
2020-04-15,Honduras,HN,12,5,9587522,419,31
2020-04-16,Honduras,HN,7,4,9587522,426,35
2020-04-17,Honduras,HN,16,6,9587522,442,41
2020-04-18,Honduras,HN,15,5,9587522,457,46
2020-04-19,Honduras,HN,15,0,9587522,472,46
2020-04-20,Honduras,HN,5,0,9587522,477,46
2020-04-21,Honduras,HN,17,0,9587522,494,46
2020-04-22,Honduras,HN,16,0,9587522,510,46
2020-04-23,Honduras,HN,9,1,9587522,519,47
2020-04-24,Honduras,HN,0,0,9587522,519,47
2020-04-25,Honduras,HN,72,0,9587522,591,47
2020-04-26,Honduras,HN,36,12,9587522,627,59
2020-04-27,Honduras,HN,34,2,9587522,661,61
2020-04-28,Honduras,HN,32,0,9587522,693,61
2020-04-29,Honduras,HN,45,5,9587522,738,66
2020-04-30,Honduras,HN,33,5,9587522,771,71
2020-05-01,Honduras,HN,33,4,9587522,804,75
2020-05-02,Honduras,HN,95,0,9587522,899,75
2020-05-03,Honduras,HN,111,1,9587522,1010,76
2019-12-31,Croatia,HR,0,0,4089400,0,0
2020-01-01,Croatia,HR,0,0,4089400,0,0
2020-01-02,Croatia,HR,0,0,4089400,0,0
2020-01-03,Croatia,HR,0,0,4089400,0,0
2020-01-04,Croatia,HR,0,0,4089400,0,0
2020-01-05,Croatia,HR,0,0,4089400,0,0
2020-01-06,Croatia,HR,0,0,4089400,0,0
2020-01-07,Croatia,HR,0,0,4089400,0,0
2020-01-08,Croatia,HR,0,0,4089400,0,0
2020-01-09,Croatia,HR,0,0,4089400,0,0
2020-01-10,Croatia,HR,0,0,4089400,0,0
2020-01-11,Croatia,HR,0,0,4089400,0,0
2020-01-12,Croatia,HR,0,0,4089400,0,0
2020-01-13,Croatia,HR,0,0,4089400,0,0
2020-01-14,Croatia,HR,0,0,4089400,0,0
2020-01-15,Croatia,HR,0,0,4089400,0,0
2020-01-16,Croatia,HR,0,0,4089400,0,0
2020-01-17,Croatia,HR,0,0,4089400,0,0
2020-01-18,Croatia,HR,0,0,4089400,0,0
2020-01-19,Croatia,HR,0,0,4089400,0,0
2020-01-20,Croatia,HR,0,0,4089400,0,0
2020-01-21,Croatia,HR,0,0,4089400,0,0
2020-01-22,Croatia,HR,0,0,4089400,0,0
2020-01-23,Croatia,HR,0,0,4089400,0,0
2020-01-24,Croatia,HR,0,0,4089400,0,0
2020-01-25,Croatia,HR,0,0,4089400,0,0
2020-01-26,Croatia,HR,0,0,4089400,0,0
2020-01-27,Croatia,HR,0,0,4089400,0,0
2020-01-28,Croatia,HR,0,0,4089400,0,0
2020-01-29,Croatia,HR,0,0,4089400,0,0
2020-01-30,Croatia,HR,0,0,4089400,0,0
2020-01-31,Croatia,HR,0,0,4089400,0,0
2020-02-01,Croatia,HR,0,0,4089400,0,0
2020-02-02,Croatia,HR,0,0,4089400,0,0
2020-02-03,Croatia,HR,0,0,4089400,0,0
2020-02-04,Croatia,HR,0,0,4089400,0,0
2020-02-05,Croatia,HR,0,0,4089400,0,0
2020-02-06,Croatia,HR,0,0,4089400,0,0
2020-02-07,Croatia,HR,0,0,4089400,0,0
2020-02-08,Croatia,HR,0,0,4089400,0,0
2020-02-09,Croatia,HR,0,0,4089400,0,0
2020-02-10,Croatia,HR,0,0,4089400,0,0
2020-02-11,Croatia,HR,0,0,4089400,0,0
2020-02-12,Croatia,HR,0,0,4089400,0,0
2020-02-13,Croatia,HR,0,0,4089400,0,0
2020-02-14,Croatia,HR,0,0,4089400,0,0
2020-02-15,Croatia,HR,0,0,4089400,0,0
2020-02-16,Croatia,HR,0,0,4089400,0,0
2020-02-17,Croatia,HR,0,0,4089400,0,0
2020-02-18,Croatia,HR,0,0,4089400,0,0
2020-02-19,Croatia,HR,0,0,4089400,0,0
2020-02-20,Croatia,HR,0,0,4089400,0,0
2020-02-21,Croatia,HR,0,0,4089400,0,0
2020-02-22,Croatia,HR,0,0,4089400,0,0
2020-02-23,Croatia,HR,0,0,4089400,0,0
2020-02-24,Croatia,HR,0,0,4089400,0,0
2020-02-25,Croatia,HR,0,0,4089400,0,0
2020-02-26,Croatia,HR,1,0,4089400,1,0
2020-02-27,Croatia,HR,1,0,4089400,2,0
2020-02-28,Croatia,HR,1,0,4089400,3,0
2020-02-29,Croatia,HR,2,0,4089400,5,0
2020-03-01,Croatia,HR,0,0,4089400,5,0
2020-03-02,Croatia,HR,2,0,4089400,7,0
2020-03-03,Croatia,HR,1,0,4089400,8,0
2020-03-04,Croatia,HR,1,0,4089400,9,0
2020-03-06,Croatia,HR,1,0,4089400,10,0
2020-03-07,Croatia,HR,1,0,4089400,11,0
2020-03-08,Croatia,HR,1,0,4089400,12,0
2020-03-11,Croatia,HR,1,0,4089400,13,0
2020-03-12,Croatia,HR,3,0,4089400,16,0
2020-03-13,Croatia,HR,9,0,4089400,25,0
2020-03-14,Croatia,HR,6,0,4089400,31,0
2020-03-15,Croatia,HR,6,0,4089400,37,0
2020-03-16,Croatia,HR,11,0,4089400,48,0
2020-03-17,Croatia,HR,8,0,4089400,56,0
2020-03-18,Croatia,HR,13,0,4089400,69,0
2020-03-19,Croatia,HR,12,0,4089400,81,0
2020-03-20,Croatia,HR,23,0,4089400,104,0
2020-03-21,Croatia,HR,22,0,4089400,126,0
2020-03-22,Croatia,HR,80,0,4089400,206,0
2020-03-23,Croatia,HR,29,0,4089400,235,0
2020-03-24,Croatia,HR,71,0,4089400,306,0
2020-03-25,Croatia,HR,76,1,4089400,382,1
2020-03-26,Croatia,HR,36,0,4089400,418,1
2020-03-27,Croatia,HR,77,1,4089400,495,2
2020-03-28,Croatia,HR,91,1,4089400,586,3
2020-03-29,Croatia,HR,71,2,4089400,657,5
2020-03-30,Croatia,HR,56,1,4089400,713,6
2020-03-31,Croatia,HR,77,0,4089400,790,6
2020-04-01,Croatia,HR,77,0,4089400,867,6
2020-04-02,Croatia,HR,96,0,4089400,963,6
2020-04-03,Croatia,HR,48,1,4089400,1011,7
2020-04-04,Croatia,HR,68,1,4089400,1079,8
2020-04-05,Croatia,HR,47,4,4089400,1126,12
2020-04-06,Croatia,HR,56,3,4089400,1182,15
2020-04-07,Croatia,HR,40,1,4089400,1222,16
2020-04-08,Croatia,HR,60,2,4089400,1282,18
2020-04-09,Croatia,HR,61,1,4089400,1343,19
2020-04-10,Croatia,HR,64,1,4089400,1407,20
2020-04-11,Croatia,HR,88,1,4089400,1495,21
2020-04-12,Croatia,HR,39,0,4089400,1534,21
2020-04-13,Croatia,HR,66,2,4089400,1600,23
2020-04-14,Croatia,HR,50,2,4089400,1650,25
2020-04-15,Croatia,HR,54,6,4089400,1704,31
2020-04-16,Croatia,HR,37,3,4089400,1741,34
2020-04-17,Croatia,HR,50,1,4089400,1791,35
2020-04-18,Croatia,HR,23,1,4089400,1814,36
2020-04-19,Croatia,HR,18,3,4089400,1832,39
2020-04-20,Croatia,HR,39,8,4089400,1871,47
2020-04-21,Croatia,HR,10,0,4089400,1881,47
2020-04-22,Croatia,HR,27,1,4089400,1908,48
2020-04-23,Croatia,HR,42,0,4089400,1950,48
2020-04-24,Croatia,HR,31,2,4089400,1981,50
2020-04-25,Croatia,HR,28,1,4089400,2009,51
2020-04-26,Croatia,HR,7,3,4089400,2016,54
2020-04-27,Croatia,HR,14,1,4089400,2030,55
2020-04-28,Croatia,HR,9,4,4089400,2039,59
2020-04-29,Croatia,HR,8,4,4089400,2047,63
2020-04-30,Croatia,HR,15,4,4089400,2062,67
2020-05-01,Croatia,HR,14,2,4089400,2076,69
2020-05-02,Croatia,HR,9,6,4089400,2085,75
2020-05-03,Croatia,HR,3,2,4089400,2088,77
2020-03-20,Haiti,HT,2,0,11123176,2,0
2020-03-21,Haiti,HT,0,0,11123176,2,0
2020-03-22,Haiti,HT,0,0,11123176,2,0
2020-03-23,Haiti,HT,0,0,11123176,2,0
2020-03-24,Haiti,HT,3,0,11123176,5,0
2020-03-25,Haiti,HT,2,0,11123176,7,0
2020-03-26,Haiti,HT,1,0,11123176,8,0
2020-03-27,Haiti,HT,0,0,11123176,8,0
2020-03-28,Haiti,HT,0,0,11123176,8,0
2020-03-29,Haiti,HT,0,0,11123176,8,0
2020-03-30,Haiti,HT,7,0,11123176,15,0
2020-03-31,Haiti,HT,0,0,11123176,15,0
2020-04-01,Haiti,HT,0,0,11123176,15,0
2020-04-02,Haiti,HT,1,0,11123176,16,0
2020-04-03,Haiti,HT,2,0,11123176,18,0
2020-04-04,Haiti,HT,0,0,11123176,18,0
2020-04-05,Haiti,HT,3,0,11123176,21,0
2020-04-06,Haiti,HT,0,0,11123176,21,0
2020-04-07,Haiti,HT,3,1,11123176,24,1
2020-04-08,Haiti,HT,1,0,11123176,25,1
2020-04-09,Haiti,HT,2,0,11123176,27,1
2020-04-10,Haiti,HT,3,1,11123176,30,2
2020-04-11,Haiti,HT,1,0,11123176,31,2
2020-04-12,Haiti,HT,2,0,11123176,33,2
2020-04-13,Haiti,HT,0,1,11123176,33,3
2020-04-14,Haiti,HT,7,0,11123176,40,3
2020-04-15,Haiti,HT,0,0,11123176,40,3
2020-04-16,Haiti,HT,1,0,11123176,41,3
2020-04-17,Haiti,HT,2,0,11123176,43,3
2020-04-18,Haiti,HT,1,0,11123176,44,3
2020-04-19,Haiti,HT,0,0,11123176,44,3
2020-04-20,Haiti,HT,3,0,11123176,47,3
2020-04-21,Haiti,HT,10,0,11123176,57,3
2020-04-22,Haiti,HT,1,1,11123176,58,4
2020-04-23,Haiti,HT,4,0,11123176,62,4
2020-04-24,Haiti,HT,10,1,11123176,72,5
2020-04-25,Haiti,HT,0,0,11123176,72,5
2020-04-26,Haiti,HT,0,1,11123176,72,6
2020-04-27,Haiti,HT,0,0,11123176,72,6
2020-04-28,Haiti,HT,4,0,11123176,76,6
2020-04-29,Haiti,HT,0,0,11123176,76,6
2020-04-30,Haiti,HT,0,0,11123176,76,6
2020-05-01,Haiti,HT,5,2,11123176,81,8
2020-05-02,Haiti,HT,4,0,11123176,85,8
2020-05-03,Haiti,HT,0,0,11123176,85,8
2020-03-05,Hungary,HU,2,0,9768785,2,0
2020-03-07,Hungary,HU,2,0,9768785,4,0
2020-03-08,Hungary,HU,3,0,9768785,7,0
2020-03-09,Hungary,HU,1,0,9768785,8,0
2020-03-10,Hungary,HU,1,0,9768785,9,0
2020-03-11,Hungary,HU,3,0,9768785,12,0
2020-03-12,Hungary,HU,1,0,9768785,13,0
2020-03-13,Hungary,HU,3,0,9768785,16,0
2020-03-14,Hungary,HU,9,0,9768785,25,0
2020-03-15,Hungary,HU,6,0,9768785,31,0
2020-03-16,Hungary,HU,8,1,9768785,39,1
2020-03-17,Hungary,HU,11,0,9768785,50,1
2020-03-18,Hungary,HU,0,0,9768785,50,1
2020-03-19,Hungary,HU,23,0,9768785,73,1
2020-03-20,Hungary,HU,12,0,9768785,85,1
2020-03-21,Hungary,HU,18,3,9768785,103,4
2020-03-22,Hungary,HU,28,0,9768785,131,4
2020-03-23,Hungary,HU,36,3,9768785,167,7
2020-03-24,Hungary,HU,20,1,9768785,187,8
2020-03-25,Hungary,HU,39,2,9768785,226,10
2020-03-26,Hungary,HU,35,0,9768785,261,10
2020-03-27,Hungary,HU,39,0,9768785,300,10
2020-03-28,Hungary,HU,43,1,9768785,343,11
2020-03-29,Hungary,HU,65,2,9768785,408,13
2020-03-30,Hungary,HU,39,2,9768785,447,15
2020-03-31,Hungary,HU,45,1,9768785,492,16
2020-04-01,Hungary,HU,33,4,9768785,525,20
2020-04-02,Hungary,HU,60,1,9768785,585,21
2020-04-03,Hungary,HU,38,5,9768785,623,26
2020-04-04,Hungary,HU,55,6,9768785,678,32
2020-04-05,Hungary,HU,55,2,9768785,733,34
2020-04-06,Hungary,HU,11,4,9768785,744,38
2020-04-07,Hungary,HU,73,9,9768785,817,47
2020-04-08,Hungary,HU,78,11,9768785,895,58
2020-04-09,Hungary,HU,85,8,9768785,980,66
2020-04-10,Hungary,HU,210,11,9768785,1190,77
2020-04-11,Hungary,HU,120,8,9768785,1310,85
2020-04-12,Hungary,HU,100,14,9768785,1410,99
2020-04-13,Hungary,HU,48,10,9768785,1458,109
2020-04-14,Hungary,HU,54,13,9768785,1512,122
2020-04-15,Hungary,HU,67,12,9768785,1579,134
2020-04-16,Hungary,HU,73,8,9768785,1652,142
2020-04-17,Hungary,HU,111,14,9768785,1763,156
2020-04-18,Hungary,HU,71,16,9768785,1834,172
2020-04-19,Hungary,HU,82,17,9768785,1916,189
2020-04-20,Hungary,HU,68,10,9768785,1984,199
2020-04-21,Hungary,HU,114,14,9768785,2098,213
2020-04-22,Hungary,HU,70,12,9768785,2168,225
2020-04-23,Hungary,HU,116,0,9768785,2284,225
2020-04-24,Hungary,HU,99,25,9768785,2383,250
2020-04-25,Hungary,HU,60,12,9768785,2443,262
2020-04-26,Hungary,HU,57,10,9768785,2500,272
2020-04-27,Hungary,HU,83,8,9768785,2583,280
2020-04-28,Hungary,HU,66,11,9768785,2649,291
2020-04-29,Hungary,HU,78,9,9768785,2727,300
2020-04-30,Hungary,HU,48,12,9768785,2775,312
2020-05-01,Hungary,HU,88,11,9768785,2863,323
2020-05-02,Hungary,HU,79,12,9768785,2942,335
2020-05-03,Hungary,HU,56,5,9768785,2998,340
2019-12-31,Indonesia,ID,0,0,267663435,0,0
2020-01-01,Indonesia,ID,0,0,267663435,0,0
2020-01-02,Indonesia,ID,0,0,267663435,0,0
2020-01-03,Indonesia,ID,0,0,267663435,0,0
2020-01-04,Indonesia,ID,0,0,267663435,0,0
2020-01-05,Indonesia,ID,0,0,267663435,0,0
2020-01-06,Indonesia,ID,0,0,267663435,0,0
2020-01-07,Indonesia,ID,0,0,267663435,0,0
2020-01-08,Indonesia,ID,0,0,267663435,0,0
2020-01-09,Indonesia,ID,0,0,267663435,0,0
2020-01-10,Indonesia,ID,0,0,267663435,0,0
2020-01-11,Indonesia,ID,0,0,267663435,0,0
2020-01-12,Indonesia,ID,0,0,267663435,0,0
2020-01-13,Indonesia,ID,0,0,267663435,0,0
2020-01-14,Indonesia,ID,0,0,267663435,0,0
2020-01-15,Indonesia,ID,0,0,267663435,0,0
2020-01-16,Indonesia,ID,0,0,267663435,0,0
2020-01-17,Indonesia,ID,0,0,267663435,0,0
2020-01-18,Indonesia,ID,0,0,267663435,0,0
2020-01-19,Indonesia,ID,0,0,267663435,0,0
2020-01-20,Indonesia,ID,0,0,267663435,0,0
2020-01-21,Indonesia,ID,0,0,267663435,0,0
2020-01-22,Indonesia,ID,0,0,267663435,0,0
2020-01-23,Indonesia,ID,0,0,267663435,0,0
2020-01-24,Indonesia,ID,0,0,267663435,0,0
2020-01-25,Indonesia,ID,0,0,267663435,0,0
2020-01-26,Indonesia,ID,0,0,267663435,0,0
2020-01-27,Indonesia,ID,0,0,267663435,0,0
2020-01-28,Indonesia,ID,0,0,267663435,0,0
2020-01-29,Indonesia,ID,0,0,267663435,0,0
2020-01-30,Indonesia,ID,0,0,267663435,0,0
2020-01-31,Indonesia,ID,0,0,267663435,0,0
2020-02-01,Indonesia,ID,0,0,267663435,0,0
2020-02-02,Indonesia,ID,0,0,267663435,0,0
2020-02-03,Indonesia,ID,0,0,267663435,0,0
2020-02-04,Indonesia,ID,0,0,267663435,0,0
2020-02-05,Indonesia,ID,0,0,267663435,0,0
2020-02-06,Indonesia,ID,0,0,267663435,0,0
2020-02-07,Indonesia,ID,0,0,267663435,0,0
2020-02-08,Indonesia,ID,0,0,267663435,0,0
2020-02-09,Indonesia,ID,0,0,267663435,0,0
2020-02-10,Indonesia,ID,0,0,267663435,0,0
2020-02-11,Indonesia,ID,0,0,267663435,0,0
2020-02-12,Indonesia,ID,0,0,267663435,0,0
2020-02-13,Indonesia,ID,0,0,267663435,0,0
2020-02-14,Indonesia,ID,0,0,267663435,0,0
2020-02-15,Indonesia,ID,0,0,267663435,0,0
2020-02-16,Indonesia,ID,0,0,267663435,0,0
2020-02-17,Indonesia,ID,0,0,267663435,0,0
2020-02-18,Indonesia,ID,0,0,267663435,0,0
2020-02-19,Indonesia,ID,0,0,267663435,0,0
2020-02-20,Indonesia,ID,0,0,267663435,0,0
2020-02-21,Indonesia,ID,0,0,267663435,0,0
2020-02-22,Indonesia,ID,0,0,267663435,0,0
2020-02-23,Indonesia,ID,0,0,267663435,0,0
2020-02-24,Indonesia,ID,0,0,267663435,0,0
2020-02-25,Indonesia,ID,0,0,267663435,0,0
2020-02-26,Indonesia,ID,0,0,267663435,0,0
2020-02-27,Indonesia,ID,0,0,267663435,0,0
2020-02-28,Indonesia,ID,0,0,267663435,0,0
2020-02-29,Indonesia,ID,0,0,267663435,0,0
2020-03-01,Indonesia,ID,0,0,267663435,0,0
2020-03-02,Indonesia,ID,2,0,267663435,2,0
2020-03-07,Indonesia,ID,2,0,267663435,4,0
2020-03-09,Indonesia,ID,2,0,267663435,6,0
2020-03-11,Indonesia,ID,13,0,267663435,19,0
2020-03-12,Indonesia,ID,15,1,267663435,34,1
2020-03-14,Indonesia,ID,35,3,267663435,69,4
2020-03-15,Indonesia,ID,27,0,267663435,96,4
2020-03-16,Indonesia,ID,21,1,267663435,117,5
2020-03-17,Indonesia,ID,17,0,267663435,134,5
2020-03-18,Indonesia,ID,38,0,267663435,172,5
2020-03-19,Indonesia,ID,0,0,267663435,172,5
2020-03-20,Indonesia,ID,55,14,267663435,227,19
2020-03-21,Indonesia,ID,82,6,267663435,309,25
2020-03-22,Indonesia,ID,141,13,267663435,450,38
2020-03-23,Indonesia,ID,64,10,267663435,514,48
2020-03-24,Indonesia,ID,65,1,267663435,579,49
2020-03-25,Indonesia,ID,107,6,267663435,686,55
2020-03-26,Indonesia,ID,104,3,267663435,790,58
2020-03-27,Indonesia,ID,103,20,267663435,893,78
2020-03-28,Indonesia,ID,153,9,267663435,1046,87
2020-03-29,Indonesia,ID,109,15,267663435,1155,102
2020-03-30,Indonesia,ID,130,12,267663435,1285,114
2020-03-31,Indonesia,ID,129,8,267663435,1414,122
2020-04-01,Indonesia,ID,114,14,267663435,1528,136
2020-04-02,Indonesia,ID,149,21,267663435,1677,157
2020-04-03,Indonesia,ID,113,13,267663435,1790,170
2020-04-04,Indonesia,ID,196,11,267663435,1986,181
2020-04-05,Indonesia,ID,106,10,267663435,2092,191
2020-04-06,Indonesia,ID,181,7,267663435,2273,198
2020-04-07,Indonesia,ID,218,11,267663435,2491,209
2020-04-08,Indonesia,ID,247,12,267663435,2738,221
2020-04-09,Indonesia,ID,218,19,267663435,2956,240
2020-04-10,Indonesia,ID,337,40,267663435,3293,280
2020-04-11,Indonesia,ID,219,26,267663435,3512,306
2020-04-12,Indonesia,ID,330,21,267663435,3842,327
2020-04-13,Indonesia,ID,399,46,267663435,4241,373
2020-04-14,Indonesia,ID,316,26,267663435,4557,399
2020-04-15,Indonesia,ID,282,60,267663435,4839,459
2020-04-16,Indonesia,ID,297,10,267663435,5136,469
2020-04-17,Indonesia,ID,380,27,267663435,5516,496
2020-04-18,Indonesia,ID,407,24,267663435,5923,520
2020-04-19,Indonesia,ID,325,15,267663435,6248,535
2020-04-20,Indonesia,ID,327,47,267663435,6575,582
2020-04-21,Indonesia,ID,185,8,267663435,6760,590
2020-04-22,Indonesia,ID,375,26,267663435,7135,616
2020-04-23,Indonesia,ID,283,19,267663435,7418,635
2020-04-24,Indonesia,ID,357,12,267663435,7775,647
2020-04-25,Indonesia,ID,436,42,267663435,8211,689
2020-04-26,Indonesia,ID,396,31,267663435,8607,720
2020-04-27,Indonesia,ID,275,23,267663435,8882,743
2020-04-28,Indonesia,ID,214,22,267663435,9096,765
2020-04-29,Indonesia,ID,415,8,267663435,9511,773
2020-04-30,Indonesia,ID,260,11,267663435,9771,784
2020-05-01,Indonesia,ID,347,8,267663435,10118,792
2020-05-02,Indonesia,ID,433,8,267663435,10551,800
2020-05-03,Indonesia,ID,292,31,267663435,10843,831
2019-12-31,Ireland,IE,0,0,4853506,0,0
2020-01-01,Ireland,IE,0,0,4853506,0,0
2020-01-02,Ireland,IE,0,0,4853506,0,0
2020-01-03,Ireland,IE,0,0,4853506,0,0
2020-01-04,Ireland,IE,0,0,4853506,0,0
2020-01-05,Ireland,IE,0,0,4853506,0,0
2020-01-06,Ireland,IE,0,0,4853506,0,0
2020-01-07,Ireland,IE,0,0,4853506,0,0
2020-01-08,Ireland,IE,0,0,4853506,0,0
2020-01-09,Ireland,IE,0,0,4853506,0,0
2020-01-10,Ireland,IE,0,0,4853506,0,0
2020-01-11,Ireland,IE,0,0,4853506,0,0
2020-01-12,Ireland,IE,0,0,4853506,0,0
2020-01-13,Ireland,IE,0,0,4853506,0,0
2020-01-14,Ireland,IE,0,0,4853506,0,0
2020-01-15,Ireland,IE,0,0,4853506,0,0
2020-01-16,Ireland,IE,0,0,4853506,0,0
2020-01-17,Ireland,IE,0,0,4853506,0,0
2020-01-18,Ireland,IE,0,0,4853506,0,0
2020-01-19,Ireland,IE,0,0,4853506,0,0
2020-01-20,Ireland,IE,0,0,4853506,0,0
2020-01-21,Ireland,IE,0,0,4853506,0,0
2020-01-22,Ireland,IE,0,0,4853506,0,0
2020-01-23,Ireland,IE,0,0,4853506,0,0
2020-01-24,Ireland,IE,0,0,4853506,0,0
2020-01-25,Ireland,IE,0,0,4853506,0,0
2020-01-26,Ireland,IE,0,0,4853506,0,0
2020-01-27,Ireland,IE,0,0,4853506,0,0
2020-01-28,Ireland,IE,0,0,4853506,0,0
2020-01-29,Ireland,IE,0,0,4853506,0,0
2020-01-30,Ireland,IE,0,0,4853506,0,0
2020-01-31,Ireland,IE,0,0,4853506,0,0
2020-02-01,Ireland,IE,0,0,4853506,0,0
2020-02-02,Ireland,IE,0,0,4853506,0,0
2020-02-03,Ireland,IE,0,0,4853506,0,0
2020-02-04,Ireland,IE,0,0,4853506,0,0
2020-02-05,Ireland,IE,0,0,4853506,0,0
2020-02-06,Ireland,IE,0,0,4853506,0,0
2020-02-07,Ireland,IE,0,0,4853506,0,0
2020-02-08,Ireland,IE,0,0,4853506,0,0
2020-02-09,Ireland,IE,0,0,4853506,0,0
2020-02-10,Ireland,IE,0,0,4853506,0,0
2020-02-11,Ireland,IE,0,0,4853506,0,0
2020-02-12,Ireland,IE,0,0,4853506,0,0
2020-02-13,Ireland,IE,0,0,4853506,0,0
2020-02-14,Ireland,IE,0,0,4853506,0,0
2020-02-15,Ireland,IE,0,0,4853506,0,0
2020-02-16,Ireland,IE,0,0,4853506,0,0
2020-02-17,Ireland,IE,0,0,4853506,0,0
2020-02-18,Ireland,IE,0,0,4853506,0,0
2020-02-19,Ireland,IE,0,0,4853506,0,0
2020-02-20,Ireland,IE,0,0,4853506,0,0
2020-02-21,Ireland,IE,0,0,4853506,0,0
2020-02-22,Ireland,IE,0,0,4853506,0,0
2020-02-23,Ireland,IE,0,0,4853506,0,0
2020-02-24,Ireland,IE,0,0,4853506,0,0
2020-02-25,Ireland,IE,0,0,4853506,0,0
2020-02-26,Ireland,IE,0,0,4853506,0,0
2020-02-27,Ireland,IE,0,0,4853506,0,0
2020-02-28,Ireland,IE,0,0,4853506,0,0
2020-02-29,Ireland,IE,0,0,4853506,0,0
2020-03-01,Ireland,IE,1,0,4853506,1,0
2020-03-02,Ireland,IE,0,0,4853506,1,0
2020-03-04,Ireland,IE,1,0,4853506,2,0
2020-03-05,Ireland,IE,4,0,4853506,6,0
2020-03-06,Ireland,IE,7,0,4853506,13,0
2020-03-07,Ireland,IE,5,0,4853506,18,0
2020-03-08,Ireland,IE,1,0,4853506,19,0
2020-03-09,Ireland,IE,2,0,4853506,21,0
2020-03-11,Ireland,IE,14,0,4853506,35,0
2020-03-12,Ireland,IE,8,1,4853506,43,1
2020-03-13,Ireland,IE,27,0,4853506,70,1
2020-03-14,Ireland,IE,21,0,4853506,91,1
2020-03-15,Ireland,IE,38,1,4853506,129,2
2020-03-16,Ireland,IE,40,0,4853506,169,2
2020-03-17,Ireland,IE,54,0,4853506,223,2
2020-03-18,Ireland,IE,69,0,4853506,292,2
2020-03-19,Ireland,IE,74,0,4853506,366,2
2020-03-20,Ireland,IE,191,1,4853506,557,3
2020-03-21,Ireland,IE,126,0,4853506,683,3
2020-03-22,Ireland,IE,102,0,4853506,785,3
2020-03-23,Ireland,IE,121,1,4853506,906,4
2020-03-24,Ireland,IE,219,2,4853506,1125,6
2020-03-25,Ireland,IE,204,1,4853506,1329,7
2020-03-26,Ireland,IE,235,2,4853506,1564,9
2020-03-27,Ireland,IE,255,10,4853506,1819,19
2020-03-28,Ireland,IE,302,3,4853506,2121,22
2020-03-29,Ireland,IE,294,14,4853506,2415,36
2020-03-30,Ireland,IE,200,10,4853506,2615,46
2020-03-31,Ireland,IE,295,8,4853506,2910,54
2020-04-01,Ireland,IE,325,17,4853506,3235,71
2020-04-02,Ireland,IE,212,14,4853506,3447,85
2020-04-03,Ireland,IE,402,13,4853506,3849,98
2020-04-04,Ireland,IE,424,22,4853506,4273,120
2020-04-05,Ireland,IE,331,17,4853506,4604,137
2020-04-06,Ireland,IE,507,21,4853506,5111,158
2020-04-07,Ireland,IE,253,16,4853506,5364,174
2020-04-08,Ireland,IE,345,36,4853506,5709,210
2020-04-09,Ireland,IE,515,25,4853506,6224,235
2020-04-10,Ireland,IE,1169,28,4853506,7393,263
2020-04-11,Ireland,IE,696,24,4853506,8089,287
2020-04-12,Ireland,IE,839,33,4853506,8928,320
2020-04-13,Ireland,IE,727,14,4853506,9655,334
2020-04-14,Ireland,IE,992,31,4853506,10647,365
2020-04-15,Ireland,IE,832,41,4853506,11479,406
2020-04-16,Ireland,IE,1068,38,4853506,12547,444
2020-04-17,Ireland,IE,724,42,4853506,13271,486
2020-04-18,Ireland,IE,709,44,4853506,13980,530
2020-04-19,Ireland,IE,778,41,4853506,14758,571
2020-04-20,Ireland,IE,493,39,4853506,15251,610
2020-04-21,Ireland,IE,401,77,4853506,15652,687
2020-04-22,Ireland,IE,388,43,4853506,16040,730
2020-04-23,Ireland,IE,631,39,4853506,16671,769
2020-04-24,Ireland,IE,936,25,4853506,17607,794
2020-04-25,Ireland,IE,577,35,4853506,18184,829
2020-04-26,Ireland,IE,377,234,4853506,18561,1063
2020-04-27,Ireland,IE,701,24,4853506,19262,1087
2020-04-28,Ireland,IE,386,15,4853506,19648,1102
2020-04-29,Ireland,IE,229,57,4853506,19877,1159
2020-04-30,Ireland,IE,376,31,4853506,20253,1190
2020-05-01,Ireland,IE,359,42,4853506,20612,1232
2020-05-02,Ireland,IE,221,33,4853506,20833,1265
2020-05-03,Ireland,IE,343,0,4853506,21176,1265
2019-12-31,Israel,IL,0,0,8883800,0,0
2020-01-01,Israel,IL,0,0,8883800,0,0
2020-01-02,Israel,IL,0,0,8883800,0,0
2020-01-03,Israel,IL,0,0,8883800,0,0
2020-01-04,Israel,IL,0,0,8883800,0,0
2020-01-05,Israel,IL,0,0,8883800,0,0
2020-01-06,Israel,IL,0,0,8883800,0,0
2020-01-07,Israel,IL,0,0,8883800,0,0
2020-01-08,Israel,IL,0,0,8883800,0,0
2020-01-09,Israel,IL,0,0,8883800,0,0
2020-01-10,Israel,IL,0,0,8883800,0,0
2020-01-11,Israel,IL,0,0,8883800,0,0
2020-01-12,Israel,IL,0,0,8883800,0,0
2020-01-13,Israel,IL,0,0,8883800,0,0
2020-01-14,Israel,IL,0,0,8883800,0,0
2020-01-15,Israel,IL,0,0,8883800,0,0
2020-01-16,Israel,IL,0,0,8883800,0,0
2020-01-17,Israel,IL,0,0,8883800,0,0
2020-01-18,Israel,IL,0,0,8883800,0,0
2020-01-19,Israel,IL,0,0,8883800,0,0
2020-01-20,Israel,IL,0,0,8883800,0,0
2020-01-21,Israel,IL,0,0,8883800,0,0
2020-01-22,Israel,IL,0,0,8883800,0,0
2020-01-23,Israel,IL,0,0,8883800,0,0
2020-01-24,Israel,IL,0,0,8883800,0,0
2020-01-25,Israel,IL,0,0,8883800,0,0
2020-01-26,Israel,IL,0,0,8883800,0,0
2020-01-27,Israel,IL,0,0,8883800,0,0
2020-01-28,Israel,IL,0,0,8883800,0,0
2020-01-29,Israel,IL,0,0,8883800,0,0
2020-01-30,Israel,IL,0,0,8883800,0,0
2020-01-31,Israel,IL,0,0,8883800,0,0
2020-02-01,Israel,IL,0,0,8883800,0,0
2020-02-02,Israel,IL,0,0,8883800,0,0
2020-02-03,Israel,IL,0,0,8883800,0,0
2020-02-04,Israel,IL,0,0,8883800,0,0
2020-02-05,Israel,IL,0,0,8883800,0,0
2020-02-06,Israel,IL,0,0,8883800,0,0
2020-02-07,Israel,IL,0,0,8883800,0,0
2020-02-08,Israel,IL,0,0,8883800,0,0
2020-02-09,Israel,IL,0,0,8883800,0,0
2020-02-10,Israel,IL,0,0,8883800,0,0
2020-02-11,Israel,IL,0,0,8883800,0,0
2020-02-12,Israel,IL,0,0,8883800,0,0
2020-02-13,Israel,IL,0,0,8883800,0,0
2020-02-14,Israel,IL,0,0,8883800,0,0
2020-02-15,Israel,IL,0,0,8883800,0,0
2020-02-16,Israel,IL,0,0,8883800,0,0
2020-02-17,Israel,IL,0,0,8883800,0,0
2020-02-18,Israel,IL,0,0,8883800,0,0
2020-02-19,Israel,IL,0,0,8883800,0,0
2020-02-20,Israel,IL,0,0,8883800,0,0
2020-02-21,Israel,IL,0,0,8883800,0,0
2020-02-22,Israel,IL,1,0,8883800,1,0
2020-02-23,Israel,IL,0,0,8883800,1,0
2020-02-24,Israel,IL,1,0,8883800,2,0
2020-02-25,Israel,IL,0,0,8883800,2,0
2020-02-26,Israel,IL,0,0,8883800,2,0
2020-02-27,Israel,IL,0,0,8883800,2,0
2020-02-28,Israel,IL,1,0,8883800,3,0
2020-02-29,Israel,IL,4,0,8883800,7,0
2020-03-01,Israel,IL,0,0,8883800,7,0
2020-03-02,Israel,IL,3,0,8883800,10,0
2020-03-05,Israel,IL,5,0,8883800,15,0
2020-03-06,Israel,IL,2,0,8883800,17,0
2020-03-07,Israel,IL,2,0,8883800,19,0
2020-03-08,Israel,IL,6,0,8883800,25,0
2020-03-09,Israel,IL,14,0,8883800,39,0
2020-03-11,Israel,IL,31,0,8883800,70,0
2020-03-12,Israel,IL,12,0,8883800,82,0
2020-03-13,Israel,IL,14,0,8883800,96,0
2020-03-14,Israel,IL,20,0,8883800,116,0
2020-03-15,Israel,IL,62,0,8883800,178,0
2020-03-16,Israel,IL,72,0,8883800,250,0
2020-03-17,Israel,IL,10,0,8883800,260,0
2020-03-18,Israel,IL,167,0,8883800,427,0
2020-03-19,Israel,IL,6,0,8883800,433,0
2020-03-20,Israel,IL,244,0,8883800,677,0
2020-03-21,Israel,IL,35,1,8883800,712,1
2020-03-22,Israel,IL,171,0,8883800,883,1
2020-03-23,Israel,IL,188,0,8883800,1071,1
2020-03-24,Israel,IL,371,0,8883800,1442,1
2020-03-25,Israel,IL,488,2,8883800,1930,3
2020-03-26,Israel,IL,439,2,8883800,2369,5
2020-03-27,Israel,IL,297,3,8883800,2666,8
2020-03-28,Israel,IL,369,2,8883800,3035,10
2020-03-29,Israel,IL,584,2,8883800,3619,12
2020-03-30,Israel,IL,628,3,8883800,4247,15
2020-03-31,Israel,IL,226,2,8883800,4473,17
2020-04-01,Israel,IL,443,3,8883800,4916,20
2020-04-02,Israel,IL,675,1,8883800,5591,21
2020-04-03,Israel,IL,661,13,8883800,6252,34
2020-04-04,Israel,IL,1176,5,8883800,7428,39
2020-04-05,Israel,IL,590,7,8883800,8018,46
2020-04-06,Israel,IL,412,3,8883800,8430,49
2020-04-07,Israel,IL,474,8,8883800,8904,57
2020-04-08,Israel,IL,344,8,8883800,9248,65
2020-04-09,Israel,IL,156,6,8883800,9404,71
2020-04-10,Israel,IL,564,15,8883800,9968,86
2020-04-11,Israel,IL,440,9,8883800,10408,95
2020-04-12,Israel,IL,335,6,8883800,10743,101
2020-04-13,Israel,IL,402,2,8883800,11145,103
2020-04-14,Israel,IL,441,13,8883800,11586,116
2020-04-15,Israel,IL,460,7,8883800,12046,123
2020-04-16,Israel,IL,455,7,8883800,12501,130
2020-04-17,Israel,IL,257,12,8883800,12758,142
2020-04-18,Israel,IL,224,9,8883800,12982,151
2020-04-19,Israel,IL,283,13,8883800,13265,164
2020-04-20,Israel,IL,226,8,8883800,13491,172
2020-04-21,Israel,IL,222,5,8883800,13713,177
2020-04-22,Israel,IL,229,7,8883800,13942,184
2020-04-23,Israel,IL,650,7,8883800,14592,191
2020-04-24,Israel,IL,290,2,8883800,14882,193
2020-04-25,Israel,IL,176,1,8883800,15058,194
2020-04-26,Israel,IL,240,5,8883800,15298,199
2020-04-27,Israel,IL,100,0,8883800,15398,199
2020-04-28,Israel,IL,68,3,8883800,15466,202
2020-04-29,Israel,IL,123,6,8883800,15589,208
2020-04-30,Israel,IL,245,7,8883800,15834,215
2020-05-01,Israel,IL,112,7,8883800,15946,222
2020-05-02,Israel,IL,155,3,8883800,16101,225
2020-05-03,Israel,IL,84,4,8883800,16185,229
2020-03-21,Isle_of_Man,IM,1,0,84077,1,0
2020-03-22,Isle_of_Man,IM,1,0,84077,2,0
2020-03-23,Isle_of_Man,IM,0,0,84077,2,0
2020-03-24,Isle_of_Man,IM,11,0,84077,13,0
2020-03-25,Isle_of_Man,IM,10,0,84077,23,0
2020-03-26,Isle_of_Man,IM,0,0,84077,23,0
2020-03-27,Isle_of_Man,IM,3,0,84077,26,0
2020-03-28,Isle_of_Man,IM,3,0,84077,29,0
2020-03-29,Isle_of_Man,IM,3,0,84077,32,0
2020-03-30,Isle_of_Man,IM,10,0,84077,42,0
2020-03-31,Isle_of_Man,IM,0,0,84077,42,0
2020-04-01,Isle_of_Man,IM,10,0,84077,52,0
2020-04-02,Isle_of_Man,IM,13,0,84077,65,0
2020-04-03,Isle_of_Man,IM,6,1,84077,71,1
2020-04-04,Isle_of_Man,IM,43,0,84077,114,1
2020-04-05,Isle_of_Man,IM,12,0,84077,126,1
2020-04-06,Isle_of_Man,IM,1,0,84077,127,1
2020-04-07,Isle_of_Man,IM,12,0,84077,139,1
2020-04-08,Isle_of_Man,IM,11,0,84077,150,1
2020-04-09,Isle_of_Man,IM,8,0,84077,158,1
2020-04-10,Isle_of_Man,IM,32,0,84077,190,1
2020-04-11,Isle_of_Man,IM,11,0,84077,201,1
2020-04-12,Isle_of_Man,IM,25,0,84077,226,1
2020-04-13,Isle_of_Man,IM,2,1,84077,228,2
2020-04-14,Isle_of_Man,IM,14,0,84077,242,2
2020-04-15,Isle_of_Man,IM,0,0,84077,242,2
2020-04-16,Isle_of_Man,IM,12,0,84077,254,2
2020-04-17,Isle_of_Man,IM,30,2,84077,284,4
2020-04-18,Isle_of_Man,IM,5,0,84077,289,4
2020-04-19,Isle_of_Man,IM,8,2,84077,297,6
2020-04-20,Isle_of_Man,IM,1,0,84077,298,6
2020-04-21,Isle_of_Man,IM,2,3,84077,300,9
2020-04-22,Isle_of_Man,IM,7,1,84077,307,10
2020-04-23,Isle_of_Man,IM,0,5,84077,307,15
2020-04-24,Isle_of_Man,IM,0,1,84077,307,16
2020-04-25,Isle_of_Man,IM,1,2,84077,308,18
2020-04-26,Isle_of_Man,IM,0,0,84077,308,18
2020-04-27,Isle_of_Man,IM,0,0,84077,308,18
2020-04-28,Isle_of_Man,IM,0,0,84077,308,18
2020-04-29,Isle_of_Man,IM,1,3,84077,309,21
2020-04-30,Isle_of_Man,IM,4,0,84077,313,21
2020-05-01,Isle_of_Man,IM,2,0,84077,315,21
2020-05-02,Isle_of_Man,IM,1,1,84077,316,22
2020-05-03,Isle_of_Man,IM,4,0,84077,320,22
2019-12-31,India,IN,0,0,1352617328,0,0
2020-01-01,India,IN,0,0,1352617328,0,0
2020-01-02,India,IN,0,0,1352617328,0,0
2020-01-03,India,IN,0,0,1352617328,0,0
2020-01-04,India,IN,0,0,1352617328,0,0
2020-01-05,India,IN,0,0,1352617328,0,0
2020-01-06,India,IN,0,0,1352617328,0,0
2020-01-07,India,IN,0,0,1352617328,0,0
2020-01-08,India,IN,0,0,1352617328,0,0
2020-01-09,India,IN,0,0,1352617328,0,0
2020-01-10,India,IN,0,0,1352617328,0,0
2020-01-11,India,IN,0,0,1352617328,0,0
2020-01-12,India,IN,0,0,1352617328,0,0
2020-01-13,India,IN,0,0,1352617328,0,0
2020-01-14,India,IN,0,0,1352617328,0,0
2020-01-15,India,IN,0,0,1352617328,0,0
2020-01-16,India,IN,0,0,1352617328,0,0
2020-01-17,India,IN,0,0,1352617328,0,0
2020-01-18,India,IN,0,0,1352617328,0,0
2020-01-19,India,IN,0,0,1352617328,0,0
2020-01-20,India,IN,0,0,1352617328,0,0
2020-01-21,India,IN,0,0,1352617328,0,0
2020-01-22,India,IN,0,0,1352617328,0,0
2020-01-23,India,IN,0,0,1352617328,0,0
2020-01-24,India,IN,0,0,1352617328,0,0
2020-01-25,India,IN,0,0,1352617328,0,0
2020-01-26,India,IN,0,0,1352617328,0,0
2020-01-27,India,IN,0,0,1352617328,0,0
2020-01-28,India,IN,0,0,1352617328,0,0
2020-01-29,India,IN,0,0,1352617328,0,0
2020-01-30,India,IN,1,0,1352617328,1,0
2020-01-31,India,IN,0,0,1352617328,1,0
2020-02-01,India,IN,0,0,1352617328,1,0
2020-02-02,India,IN,1,0,1352617328,2,0
2020-02-03,India,IN,0,0,1352617328,2,0
2020-02-04,India,IN,1,0,1352617328,3,0
2020-02-05,India,IN,0,0,1352617328,3,0
2020-02-06,India,IN,0,0,1352617328,3,0
2020-02-07,India,IN,0,0,1352617328,3,0
2020-02-08,India,IN,0,0,1352617328,3,0
2020-02-09,India,IN,0,0,1352617328,3,0
2020-02-10,India,IN,0,0,1352617328,3,0
2020-02-11,India,IN,0,0,1352617328,3,0
2020-02-12,India,IN,0,0,1352617328,3,0
2020-02-13,India,IN,0,0,1352617328,3,0
2020-02-14,India,IN,0,0,1352617328,3,0
2020-02-15,India,IN,0,0,1352617328,3,0
2020-02-16,India,IN,0,0,1352617328,3,0
2020-02-17,India,IN,0,0,1352617328,3,0
2020-02-18,India,IN,0,0,1352617328,3,0
2020-02-19,India,IN,0,0,1352617328,3,0
2020-02-20,India,IN,0,0,1352617328,3,0
2020-02-21,India,IN,0,0,1352617328,3,0
2020-02-22,India,IN,0,0,1352617328,3,0
2020-02-23,India,IN,0,0,1352617328,3,0
2020-02-24,India,IN,0,0,1352617328,3,0
2020-02-25,India,IN,0,0,1352617328,3,0
2020-02-26,India,IN,0,0,1352617328,3,0
2020-02-27,India,IN,0,0,1352617328,3,0
2020-02-28,India,IN,0,0,1352617328,3,0
2020-02-29,India,IN,0,0,1352617328,3,0
2020-03-01,India,IN,0,0,1352617328,3,0
2020-03-02,India,IN,0,0,1352617328,3,0
2020-03-03,India,IN,2,0,1352617328,5,0
2020-03-04,India,IN,1,0,1352617328,6,0
2020-03-05,India,IN,22,0,1352617328,28,0
2020-03-06,India,IN,1,0,1352617328,29,0
2020-03-07,India,IN,2,0,1352617328,31,0
2020-03-08,India,IN,3,0,1352617328,34,0
2020-03-10,India,IN,10,0,1352617328,44,0
2020-03-11,India,IN,6,0,1352617328,50,0
2020-03-12,India,IN,23,0,1352617328,73,0
2020-03-13,India,IN,2,1,1352617328,75,1
2020-03-14,India,IN,8,1,1352617328,83,2
2020-03-15,India,IN,7,0,1352617328,90,2
2020-03-16,India,IN,3,0,1352617328,93,2
2020-03-17,India,IN,32,1,1352617328,125,3
2020-03-18,India,IN,12,0,1352617328,137,3
2020-03-19,India,IN,28,0,1352617328,165,3
2020-03-20,India,IN,26,1,1352617328,191,4
2020-03-21,India,IN,40,0,1352617328,231,4
2020-03-22,India,IN,89,0,1352617328,320,4
2020-03-23,India,IN,119,3,1352617328,439,7
2020-03-24,India,IN,53,2,1352617328,492,9
2020-03-25,India,IN,70,0,1352617328,562,9
2020-03-26,India,IN,87,4,1352617328,649,13
2020-03-27,India,IN,75,4,1352617328,724,17
2020-03-28,India,IN,149,2,1352617328,873,19
2020-03-29,India,IN,106,6,1352617328,979,25
2020-03-30,India,IN,92,4,1352617328,1071,29
2020-03-31,India,IN,180,3,1352617328,1251,32
2020-04-01,India,IN,146,3,1352617328,1397,35
2020-04-02,India,IN,568,15,1352617328,1965,50
2020-04-03,India,IN,336,6,1352617328,2301,56
2020-04-04,India,IN,601,12,1352617328,2902,68
2020-04-05,India,IN,472,9,1352617328,3374,77
2020-04-06,India,IN,693,32,1352617328,4067,109
2020-04-07,India,IN,354,5,1352617328,4421,114
2020-04-08,India,IN,773,35,1352617328,5194,149
2020-04-09,India,IN,540,17,1352617328,5734,166
2020-04-10,India,IN,678,33,1352617328,6412,199
2020-04-11,India,IN,1035,40,1352617328,7447,239
2020-04-12,India,IN,909,34,1352617328,8356,273
2020-04-13,India,IN,796,35,1352617328,9152,308
2020-04-14,India,IN,1211,31,1352617328,10363,339
2020-04-15,India,IN,1075,38,1352617328,11438,377
2020-04-16,India,IN,942,37,1352617328,12380,414
2020-04-17,India,IN,1007,23,1352617328,13387,437
2020-04-18,India,IN,991,43,1352617328,14378,480
2020-04-19,India,IN,1334,27,1352617328,15712,507
2020-04-20,India,IN,1553,36,1352617328,17265,543
2020-04-21,India,IN,1335,47,1352617328,18600,590
2020-04-22,India,IN,1384,50,1352617328,19984,640
2020-04-23,India,IN,1409,41,1352617328,21393,681
2020-04-24,India,IN,1684,37,1352617328,23077,718
2020-04-25,India,IN,1429,57,1352617328,24506,775
2020-04-26,India,IN,1990,49,1352617328,26496,824
2020-04-27,India,IN,1396,48,1352617328,27892,872
2020-04-28,India,IN,1543,62,1352617328,29435,934
2020-04-29,India,IN,1897,73,1352617328,31332,1007
2020-04-30,India,IN,1718,67,1352617328,33050,1074
2020-05-01,India,IN,1993,73,1352617328,35043,1147
2020-05-02,India,IN,2293,71,1352617328,37336,1218
2020-05-03,India,IN,2644,83,1352617328,39980,1301
2019-12-31,Iraq,IQ,0,0,38433600,0,0
2020-01-01,Iraq,IQ,0,0,38433600,0,0
2020-01-02,Iraq,IQ,0,0,38433600,0,0
2020-01-03,Iraq,IQ,0,0,38433600,0,0
2020-01-04,Iraq,IQ,0,0,38433600,0,0
2020-01-05,Iraq,IQ,0,0,38433600,0,0
2020-01-06,Iraq,IQ,0,0,38433600,0,0
2020-01-07,Iraq,IQ,0,0,38433600,0,0
2020-01-08,Iraq,IQ,0,0,38433600,0,0
2020-01-09,Iraq,IQ,0,0,38433600,0,0
2020-01-10,Iraq,IQ,0,0,38433600,0,0
2020-01-11,Iraq,IQ,0,0,38433600,0,0
2020-01-12,Iraq,IQ,0,0,38433600,0,0
2020-01-13,Iraq,IQ,0,0,38433600,0,0
2020-01-14,Iraq,IQ,0,0,38433600,0,0
2020-01-15,Iraq,IQ,0,0,38433600,0,0
2020-01-16,Iraq,IQ,0,0,38433600,0,0
2020-01-17,Iraq,IQ,0,0,38433600,0,0
2020-01-18,Iraq,IQ,0,0,38433600,0,0
2020-01-19,Iraq,IQ,0,0,38433600,0,0
2020-01-20,Iraq,IQ,0,0,38433600,0,0
2020-01-21,Iraq,IQ,0,0,38433600,0,0
2020-01-22,Iraq,IQ,0,0,38433600,0,0
2020-01-23,Iraq,IQ,0,0,38433600,0,0
2020-01-24,Iraq,IQ,0,0,38433600,0,0
2020-01-25,Iraq,IQ,0,0,38433600,0,0
2020-01-26,Iraq,IQ,0,0,38433600,0,0
2020-01-27,Iraq,IQ,0,0,38433600,0,0
2020-01-28,Iraq,IQ,0,0,38433600,0,0
2020-01-29,Iraq,IQ,0,0,38433600,0,0
2020-01-30,Iraq,IQ,0,0,38433600,0,0
2020-01-31,Iraq,IQ,0,0,38433600,0,0
2020-02-01,Iraq,IQ,0,0,38433600,0,0
2020-02-02,Iraq,IQ,0,0,38433600,0,0
2020-02-03,Iraq,IQ,0,0,38433600,0,0
2020-02-04,Iraq,IQ,0,0,38433600,0,0
2020-02-05,Iraq,IQ,0,0,38433600,0,0
2020-02-06,Iraq,IQ,0,0,38433600,0,0
2020-02-07,Iraq,IQ,0,0,38433600,0,0
2020-02-08,Iraq,IQ,0,0,38433600,0,0
2020-02-09,Iraq,IQ,0,0,38433600,0,0
2020-02-10,Iraq,IQ,0,0,38433600,0,0
2020-02-11,Iraq,IQ,0,0,38433600,0,0
2020-02-12,Iraq,IQ,0,0,38433600,0,0
2020-02-13,Iraq,IQ,0,0,38433600,0,0
2020-02-14,Iraq,IQ,0,0,38433600,0,0
2020-02-15,Iraq,IQ,0,0,38433600,0,0
2020-02-16,Iraq,IQ,0,0,38433600,0,0
2020-02-17,Iraq,IQ,0,0,38433600,0,0
2020-02-18,Iraq,IQ,0,0,38433600,0,0
2020-02-19,Iraq,IQ,0,0,38433600,0,0
2020-02-20,Iraq,IQ,0,0,38433600,0,0
2020-02-21,Iraq,IQ,0,0,38433600,0,0
2020-02-22,Iraq,IQ,0,0,38433600,0,0
2020-02-23,Iraq,IQ,0,0,38433600,0,0
2020-02-24,Iraq,IQ,0,0,38433600,0,0
2020-02-25,Iraq,IQ,1,0,38433600,1,0
2020-02-26,Iraq,IQ,4,0,38433600,5,0
2020-02-27,Iraq,IQ,0,0,38433600,5,0
2020-02-28,Iraq,IQ,1,0,38433600,6,0
2020-02-29,Iraq,IQ,1,0,38433600,7,0
2020-03-01,Iraq,IQ,6,0,38433600,13,0
2020-03-02,Iraq,IQ,6,0,38433600,19,0
2020-03-03,Iraq,IQ,2,0,38433600,21,0
2020-03-04,Iraq,IQ,5,0,38433600,26,0
2020-03-05,Iraq,IQ,5,0,38433600,31,0
2020-03-06,Iraq,IQ,7,2,38433600,38,2
2020-03-08,Iraq,IQ,16,0,38433600,54,2
2020-03-09,Iraq,IQ,7,4,38433600,61,6
2020-03-11,Iraq,IQ,0,0,38433600,61,6
2020-03-12,Iraq,IQ,9,2,38433600,70,8
2020-03-13,Iraq,IQ,4,0,38433600,74,8
2020-03-14,Iraq,IQ,11,1,38433600,85,9
2020-03-15,Iraq,IQ,0,0,38433600,85,9
2020-03-16,Iraq,IQ,39,0,38433600,124,9
2020-03-17,Iraq,IQ,0,0,38433600,124,9
2020-03-18,Iraq,IQ,30,2,38433600,154,11
2020-03-19,Iraq,IQ,10,1,38433600,164,12
2020-03-20,Iraq,IQ,13,0,38433600,177,12
2020-03-21,Iraq,IQ,16,2,38433600,193,14
2020-03-22,Iraq,IQ,21,3,38433600,214,17
2020-03-23,Iraq,IQ,19,3,38433600,233,20
2020-03-24,Iraq,IQ,33,3,38433600,266,23
2020-03-25,Iraq,IQ,50,4,38433600,316,27
2020-03-26,Iraq,IQ,30,2,38433600,346,29
2020-03-27,Iraq,IQ,36,7,38433600,382,36
2020-03-28,Iraq,IQ,76,4,38433600,458,40
2020-03-29,Iraq,IQ,48,2,38433600,506,42
2020-03-30,Iraq,IQ,41,0,38433600,547,42
2020-03-31,Iraq,IQ,83,4,38433600,630,46
2020-04-01,Iraq,IQ,64,4,38433600,694,50
2020-04-02,Iraq,IQ,0,0,38433600,694,50
2020-04-03,Iraq,IQ,78,4,38433600,772,54
2020-04-04,Iraq,IQ,0,0,38433600,772,54
2020-04-05,Iraq,IQ,106,2,38433600,878,56
2020-04-06,Iraq,IQ,83,5,38433600,961,61
2020-04-07,Iraq,IQ,70,3,38433600,1031,64
2020-04-08,Iraq,IQ,0,0,38433600,1031,64
2020-04-09,Iraq,IQ,171,5,38433600,1202,69
2020-04-10,Iraq,IQ,30,0,38433600,1232,69
2020-04-11,Iraq,IQ,47,1,38433600,1279,70
2020-04-12,Iraq,IQ,39,2,38433600,1318,72
2020-04-13,Iraq,IQ,34,4,38433600,1352,76
2020-04-14,Iraq,IQ,26,2,38433600,1378,78
2020-04-15,Iraq,IQ,22,0,38433600,1400,78
2020-04-16,Iraq,IQ,15,1,38433600,1415,79
2020-04-17,Iraq,IQ,19,1,38433600,1434,80
2020-04-18,Iraq,IQ,48,1,38433600,1482,81
2020-04-19,Iraq,IQ,0,0,38433600,1482,81
2020-04-20,Iraq,IQ,57,1,38433600,1539,82
2020-04-21,Iraq,IQ,35,0,38433600,1574,82
2020-04-22,Iraq,IQ,28,1,38433600,1602,83
2020-04-23,Iraq,IQ,0,0,38433600,1602,83
2020-04-24,Iraq,IQ,75,0,38433600,1677,83
2020-04-25,Iraq,IQ,31,3,38433600,1708,86
2020-04-26,Iraq,IQ,55,0,38433600,1763,86
2020-04-27,Iraq,IQ,57,1,38433600,1820,87
2020-04-28,Iraq,IQ,27,1,38433600,1847,88
2020-04-29,Iraq,IQ,0,0,38433600,1847,88
2020-04-30,Iraq,IQ,156,4,38433600,2003,92
2020-05-01,Iraq,IQ,82,1,38433600,2085,93
2020-05-02,Iraq,IQ,68,1,38433600,2153,94
2020-05-03,Iraq,IQ,66,1,38433600,2219,95
2019-12-31,Iran,IR,0,0,81800269,0,0
2020-01-01,Iran,IR,0,0,81800269,0,0
2020-01-02,Iran,IR,0,0,81800269,0,0
2020-01-03,Iran,IR,0,0,81800269,0,0
2020-01-04,Iran,IR,0,0,81800269,0,0
2020-01-05,Iran,IR,0,0,81800269,0,0
2020-01-06,Iran,IR,0,0,81800269,0,0
2020-01-07,Iran,IR,0,0,81800269,0,0
2020-01-08,Iran,IR,0,0,81800269,0,0
2020-01-09,Iran,IR,0,0,81800269,0,0
2020-01-10,Iran,IR,0,0,81800269,0,0
2020-01-11,Iran,IR,0,0,81800269,0,0
2020-01-12,Iran,IR,0,0,81800269,0,0
2020-01-13,Iran,IR,0,0,81800269,0,0
2020-01-14,Iran,IR,0,0,81800269,0,0
2020-01-15,Iran,IR,0,0,81800269,0,0
2020-01-16,Iran,IR,0,0,81800269,0,0
2020-01-17,Iran,IR,0,0,81800269,0,0
2020-01-18,Iran,IR,0,0,81800269,0,0
2020-01-19,Iran,IR,0,0,81800269,0,0
2020-01-20,Iran,IR,0,0,81800269,0,0
2020-01-21,Iran,IR,0,0,81800269,0,0
2020-01-22,Iran,IR,0,0,81800269,0,0
2020-01-23,Iran,IR,0,0,81800269,0,0
2020-01-24,Iran,IR,0,0,81800269,0,0
2020-01-25,Iran,IR,0,0,81800269,0,0
2020-01-26,Iran,IR,0,0,81800269,0,0
2020-01-27,Iran,IR,0,0,81800269,0,0
2020-01-28,Iran,IR,0,0,81800269,0,0
2020-01-29,Iran,IR,0,0,81800269,0,0
2020-01-30,Iran,IR,0,0,81800269,0,0
2020-01-31,Iran,IR,0,0,81800269,0,0
2020-02-01,Iran,IR,0,0,81800269,0,0
2020-02-02,Iran,IR,0,0,81800269,0,0
2020-02-03,Iran,IR,0,0,81800269,0,0
2020-02-04,Iran,IR,0,0,81800269,0,0
2020-02-05,Iran,IR,0,0,81800269,0,0
2020-02-06,Iran,IR,0,0,81800269,0,0
2020-02-07,Iran,IR,0,0,81800269,0,0
2020-02-08,Iran,IR,0,0,81800269,0,0
2020-02-09,Iran,IR,0,0,81800269,0,0
2020-02-10,Iran,IR,0,0,81800269,0,0
2020-02-11,Iran,IR,0,0,81800269,0,0
2020-02-12,Iran,IR,0,0,81800269,0,0
2020-02-13,Iran,IR,0,0,81800269,0,0
2020-02-14,Iran,IR,0,0,81800269,0,0
2020-02-15,Iran,IR,0,0,81800269,0,0
2020-02-16,Iran,IR,0,0,81800269,0,0
2020-02-17,Iran,IR,0,0,81800269,0,0
2020-02-18,Iran,IR,0,0,81800269,0,0
2020-02-19,Iran,IR,0,0,81800269,0,0
2020-02-20,Iran,IR,2,2,81800269,2,2
2020-02-21,Iran,IR,3,0,81800269,5,2
2020-02-22,Iran,IR,13,2,81800269,18,4
2020-02-23,Iran,IR,10,1,81800269,28,5
2020-02-24,Iran,IR,15,3,81800269,43,8
2020-02-25,Iran,IR,18,4,81800269,61,12
2020-02-26,Iran,IR,34,3,81800269,95,15
2020-02-27,Iran,IR,44,4,81800269,139,19
2020-02-28,Iran,IR,106,7,81800269,245,26
2020-02-29,Iran,IR,143,8,81800269,388,34
2020-03-01,Iran,IR,205,9,81800269,593,43
2020-03-02,Iran,IR,385,11,81800269,978,54
2020-03-03,Iran,IR,523,12,81800269,1501,66
2020-03-04,Iran,IR,835,11,81800269,2336,77
2020-03-05,Iran,IR,586,15,81800269,2922,92
2020-03-06,Iran,IR,591,15,81800269,3513,107
2020-03-07,Iran,IR,1234,17,81800269,4747,124
2020-03-08,Iran,IR,1076,21,81800269,5823,145
2020-03-09,Iran,IR,743,49,81800269,6566,194
2020-03-10,Iran,IR,595,43,81800269,7161,237
2020-03-11,Iran,IR,881,54,81800269,8042,291
2020-03-12,Iran,IR,958,63,81800269,9000,354
2020-03-13,Iran,IR,1075,75,81800269,10075,429
2020-03-14,Iran,IR,1289,85,81800269,11364,514
2020-03-15,Iran,IR,1365,97,81800269,12729,611
2020-03-16,Iran,IR,1209,113,81800269,13938,724
2020-03-17,Iran,IR,1053,129,81800269,14991,853
2020-03-18,Iran,IR,1178,135,81800269,16169,988
2020-03-19,Iran,IR,1192,147,81800269,17361,1135
2020-03-20,Iran,IR,1046,149,81800269,18407,1284
2020-03-21,Iran,IR,1237,149,81800269,19644,1433
2020-03-22,Iran,IR,966,123,81800269,20610,1556
2020-03-23,Iran,IR,1028,129,81800269,21638,1685
2020-03-24,Iran,IR,1411,127,81800269,23049,1812
2020-03-25,Iran,IR,1762,122,81800269,24811,1934
2020-03-26,Iran,IR,2206,143,81800269,27017,2077
2020-03-27,Iran,IR,2389,157,81800269,29406,2234
2020-03-28,Iran,IR,2926,144,81800269,32332,2378
2020-03-29,Iran,IR,3076,139,81800269,35408,2517
2020-03-30,Iran,IR,2901,123,81800269,38309,2640
2020-03-31,Iran,IR,3186,117,81800269,41495,2757
2020-04-01,Iran,IR,3111,141,81800269,44606,2898
2020-04-02,Iran,IR,2987,138,81800269,47593,3036
2020-04-03,Iran,IR,2875,124,81800269,50468,3160
2020-04-04,Iran,IR,0,0,81800269,50468,3160
2020-04-05,Iran,IR,5275,292,81800269,55743,3452
2020-04-06,Iran,IR,2483,151,81800269,58226,3603
2020-04-07,Iran,IR,2274,136,81800269,60500,3739
2020-04-08,Iran,IR,2089,133,81800269,62589,3872
2020-04-09,Iran,IR,1997,121,81800269,64586,3993
2020-04-10,Iran,IR,1634,117,81800269,66220,4110
2020-04-11,Iran,IR,1972,122,81800269,68192,4232
2020-04-12,Iran,IR,1837,125,81800269,70029,4357
2020-04-13,Iran,IR,1657,117,81800269,71686,4474
2020-04-14,Iran,IR,1617,111,81800269,73303,4585
2020-04-15,Iran,IR,1574,98,81800269,74877,4683
2020-04-16,Iran,IR,1512,94,81800269,76389,4777
2020-04-17,Iran,IR,1606,92,81800269,77995,4869
2020-04-18,Iran,IR,1499,89,81800269,79494,4958
2020-04-19,Iran,IR,1374,73,81800269,80868,5031
2020-04-20,Iran,IR,1343,87,81800269,82211,5118
2020-04-21,Iran,IR,1294,91,81800269,83505,5209
2020-04-22,Iran,IR,1297,88,81800269,84802,5297
2020-04-23,Iran,IR,1194,94,81800269,85996,5391
2020-04-24,Iran,IR,1030,90,81800269,87026,5481
2020-04-25,Iran,IR,1168,93,81800269,88194,5574
2020-04-26,Iran,IR,1134,76,81800269,89328,5650
2020-04-27,Iran,IR,1153,60,81800269,90481,5710
2020-04-28,Iran,IR,991,96,81800269,91472,5806
2020-04-29,Iran,IR,1112,71,81800269,92584,5877
2020-04-30,Iran,IR,1073,80,81800269,93657,5957
2020-05-01,Iran,IR,983,71,81800269,94640,6028
2020-05-02,Iran,IR,1006,63,81800269,95646,6091
2020-05-03,Iran,IR,802,65,81800269,96448,6156
2019-12-31,Iceland,IS,0,0,353574,0,0
2020-01-01,Iceland,IS,0,0,353574,0,0
2020-01-02,Iceland,IS,0,0,353574,0,0
2020-01-03,Iceland,IS,0,0,353574,0,0
2020-01-04,Iceland,IS,0,0,353574,0,0
2020-01-05,Iceland,IS,0,0,353574,0,0
2020-01-06,Iceland,IS,0,0,353574,0,0
2020-01-07,Iceland,IS,0,0,353574,0,0
2020-01-08,Iceland,IS,0,0,353574,0,0
2020-01-09,Iceland,IS,0,0,353574,0,0
2020-01-10,Iceland,IS,0,0,353574,0,0
2020-01-11,Iceland,IS,0,0,353574,0,0
2020-01-12,Iceland,IS,0,0,353574,0,0
2020-01-13,Iceland,IS,0,0,353574,0,0
2020-01-14,Iceland,IS,0,0,353574,0,0
2020-01-15,Iceland,IS,0,0,353574,0,0
2020-01-16,Iceland,IS,0,0,353574,0,0
2020-01-17,Iceland,IS,0,0,353574,0,0
2020-01-18,Iceland,IS,0,0,353574,0,0
2020-01-19,Iceland,IS,0,0,353574,0,0
2020-01-20,Iceland,IS,0,0,353574,0,0
2020-01-21,Iceland,IS,0,0,353574,0,0
2020-01-22,Iceland,IS,0,0,353574,0,0
2020-01-23,Iceland,IS,0,0,353574,0,0
2020-01-24,Iceland,IS,0,0,353574,0,0
2020-01-25,Iceland,IS,0,0,353574,0,0
2020-01-26,Iceland,IS,0,0,353574,0,0
2020-01-27,Iceland,IS,0,0,353574,0,0
2020-01-28,Iceland,IS,0,0,353574,0,0
2020-01-29,Iceland,IS,0,0,353574,0,0
2020-01-30,Iceland,IS,0,0,353574,0,0
2020-01-31,Iceland,IS,0,0,353574,0,0
2020-02-01,Iceland,IS,0,0,353574,0,0
2020-02-02,Iceland,IS,0,0,353574,0,0
2020-02-03,Iceland,IS,0,0,353574,0,0
2020-02-04,Iceland,IS,0,0,353574,0,0
2020-02-05,Iceland,IS,0,0,353574,0,0
2020-02-06,Iceland,IS,0,0,353574,0,0
2020-02-07,Iceland,IS,0,0,353574,0,0
2020-02-08,Iceland,IS,0,0,353574,0,0
2020-02-09,Iceland,IS,0,0,353574,0,0
2020-02-10,Iceland,IS,0,0,353574,0,0
2020-02-11,Iceland,IS,0,0,353574,0,0
2020-02-12,Iceland,IS,0,0,353574,0,0
2020-02-13,Iceland,IS,0,0,353574,0,0
2020-02-14,Iceland,IS,0,0,353574,0,0
2020-02-15,Iceland,IS,0,0,353574,0,0
2020-02-16,Iceland,IS,0,0,353574,0,0
2020-02-17,Iceland,IS,0,0,353574,0,0
2020-02-18,Iceland,IS,0,0,353574,0,0
2020-02-19,Iceland,IS,0,0,353574,0,0
2020-02-20,Iceland,IS,0,0,353574,0,0
2020-02-21,Iceland,IS,0,0,353574,0,0
2020-02-22,Iceland,IS,0,0,353574,0,0
2020-02-23,Iceland,IS,0,0,353574,0,0
2020-02-24,Iceland,IS,0,0,353574,0,0
2020-02-25,Iceland,IS,0,0,353574,0,0
2020-02-26,Iceland,IS,0,0,353574,0,0
2020-02-27,Iceland,IS,0,0,353574,0,0
2020-02-28,Iceland,IS,0,0,353574,0,0
2020-02-29,Iceland,IS,1,0,353574,1,0
2020-03-01,Iceland,IS,0,0,353574,1,0
2020-03-02,Iceland,IS,2,0,353574,3,0
2020-03-03,Iceland,IS,3,0,353574,6,0
2020-03-04,Iceland,IS,10,0,353574,16,0
2020-03-05,Iceland,IS,10,0,353574,26,0
2020-03-06,Iceland,IS,9,0,353574,35,0
2020-03-07,Iceland,IS,8,0,353574,43,0
2020-03-08,Iceland,IS,10,0,353574,53,0
2020-03-09,Iceland,IS,2,0,353574,55,0
2020-03-10,Iceland,IS,10,0,353574,65,0
2020-03-11,Iceland,IS,5,0,353574,70,0
2020-03-12,Iceland,IS,15,0,353574,85,0
2020-03-13,Iceland,IS,32,0,353574,117,0
2020-03-14,Iceland,IS,0,0,353574,117,0
2020-03-15,Iceland,IS,21,0,353574,138,0
2020-03-16,Iceland,IS,40,0,353574,178,0
2020-03-17,Iceland,IS,21,0,353574,199,0
2020-03-18,Iceland,IS,48,0,353574,247,0
2020-03-19,Iceland,IS,3,0,353574,250,0
2020-03-20,Iceland,IS,80,1,353574,330,1
2020-03-21,Iceland,IS,79,0,353574,409,1
2020-03-22,Iceland,IS,64,0,353574,473,1
2020-03-23,Iceland,IS,95,0,353574,568,1
2020-03-24,Iceland,IS,20,1,353574,588,2
2020-03-25,Iceland,IS,60,0,353574,648,2
2020-03-26,Iceland,IS,89,0,353574,737,2
2020-03-27,Iceland,IS,65,0,353574,802,2
2020-03-28,Iceland,IS,88,0,353574,890,2
2020-03-29,Iceland,IS,73,0,353574,963,2
2020-03-30,Iceland,IS,57,0,353574,1020,2
2020-03-31,Iceland,IS,66,0,353574,1086,2
2020-04-01,Iceland,IS,49,0,353574,1135,2
2020-04-02,Iceland,IS,85,0,353574,1220,2
2020-04-03,Iceland,IS,99,2,353574,1319,4
2020-04-04,Iceland,IS,45,0,353574,1364,4
2020-04-05,Iceland,IS,53,0,353574,1417,4
2020-04-06,Iceland,IS,69,0,353574,1486,4
2020-04-07,Iceland,IS,76,2,353574,1562,6
2020-04-08,Iceland,IS,24,0,353574,1586,6
2020-04-09,Iceland,IS,30,0,353574,1616,6
2020-04-10,Iceland,IS,32,0,353574,1648,6
2020-04-11,Iceland,IS,27,1,353574,1675,7
2020-04-12,Iceland,IS,14,1,353574,1689,8
2020-04-13,Iceland,IS,12,0,353574,1701,8
2020-04-14,Iceland,IS,10,0,353574,1711,8
2020-04-15,Iceland,IS,9,0,353574,1720,8
2020-04-16,Iceland,IS,7,0,353574,1727,8
2020-04-17,Iceland,IS,12,0,353574,1739,8
2020-04-18,Iceland,IS,15,0,353574,1754,8
2020-04-19,Iceland,IS,6,1,353574,1760,9
2020-04-20,Iceland,IS,11,0,353574,1771,9
2020-04-21,Iceland,IS,2,1,353574,1773,10
2020-04-22,Iceland,IS,5,0,353574,1778,10
2020-04-23,Iceland,IS,7,0,353574,1785,10
2020-04-24,Iceland,IS,4,0,353574,1789,10
2020-04-25,Iceland,IS,0,0,353574,1789,10
2020-04-26,Iceland,IS,1,0,353574,1790,10
2020-04-27,Iceland,IS,2,0,353574,1792,10
2020-04-28,Iceland,IS,0,0,353574,1792,10
2020-04-29,Iceland,IS,3,0,353574,1795,10
2020-04-30,Iceland,IS,2,0,353574,1797,10
2020-05-01,Iceland,IS,0,0,353574,1797,10
2020-05-02,Iceland,IS,1,0,353574,1798,10
2020-05-03,Iceland,IS,0,0,353574,1798,10
2019-12-31,Italy,IT,0,0,60431283,0,0
2020-01-01,Italy,IT,0,0,60431283,0,0
2020-01-02,Italy,IT,0,0,60431283,0,0
2020-01-03,Italy,IT,0,0,60431283,0,0
2020-01-04,Italy,IT,0,0,60431283,0,0
2020-01-05,Italy,IT,0,0,60431283,0,0
2020-01-06,Italy,IT,0,0,60431283,0,0
2020-01-07,Italy,IT,0,0,60431283,0,0
2020-01-08,Italy,IT,0,0,60431283,0,0
2020-01-09,Italy,IT,0,0,60431283,0,0
2020-01-10,Italy,IT,0,0,60431283,0,0
2020-01-11,Italy,IT,0,0,60431283,0,0
2020-01-12,Italy,IT,0,0,60431283,0,0
2020-01-13,Italy,IT,0,0,60431283,0,0
2020-01-14,Italy,IT,0,0,60431283,0,0
2020-01-15,Italy,IT,0,0,60431283,0,0
2020-01-16,Italy,IT,0,0,60431283,0,0
2020-01-17,Italy,IT,0,0,60431283,0,0
2020-01-18,Italy,IT,0,0,60431283,0,0
2020-01-19,Italy,IT,0,0,60431283,0,0
2020-01-20,Italy,IT,0,0,60431283,0,0
2020-01-21,Italy,IT,0,0,60431283,0,0
2020-01-22,Italy,IT,0,0,60431283,0,0
2020-01-23,Italy,IT,0,0,60431283,0,0
2020-01-24,Italy,IT,0,0,60431283,0,0
2020-01-25,Italy,IT,0,0,60431283,0,0
2020-01-26,Italy,IT,0,0,60431283,0,0
2020-01-27,Italy,IT,0,0,60431283,0,0
2020-01-28,Italy,IT,0,0,60431283,0,0
2020-01-29,Italy,IT,0,0,60431283,0,0
2020-01-30,Italy,IT,0,0,60431283,0,0
2020-01-31,Italy,IT,3,0,60431283,3,0
2020-02-01,Italy,IT,0,0,60431283,3,0
2020-02-02,Italy,IT,0,0,60431283,3,0
2020-02-03,Italy,IT,0,0,60431283,3,0
2020-02-04,Italy,IT,0,0,60431283,3,0
2020-02-05,Italy,IT,0,0,60431283,3,0
2020-02-06,Italy,IT,0,0,60431283,3,0
2020-02-07,Italy,IT,0,0,60431283,3,0
2020-02-08,Italy,IT,0,0,60431283,3,0
2020-02-09,Italy,IT,0,0,60431283,3,0
2020-02-10,Italy,IT,0,0,60431283,3,0
2020-02-11,Italy,IT,0,0,60431283,3,0
2020-02-12,Italy,IT,0,0,60431283,3,0
2020-02-13,Italy,IT,0,0,60431283,3,0
2020-02-14,Italy,IT,0,0,60431283,3,0
2020-02-15,Italy,IT,0,0,60431283,3,0
2020-02-16,Italy,IT,0,0,60431283,3,0
2020-02-17,Italy,IT,0,0,60431283,3,0
2020-02-18,Italy,IT,0,0,60431283,3,0
2020-02-19,Italy,IT,0,0,60431283,3,0
2020-02-20,Italy,IT,0,0,60431283,3,0
2020-02-21,Italy,IT,0,0,60431283,3,0
2020-02-22,Italy,IT,14,0,60431283,17,0
2020-02-23,Italy,IT,62,2,60431283,79,2
2020-02-24,Italy,IT,53,0,60431283,132,2
2020-02-25,Italy,IT,97,4,60431283,229,6
2020-02-26,Italy,IT,93,5,60431283,322,11
2020-02-27,Italy,IT,78,1,60431283,400,12
2020-02-28,Italy,IT,250,5,60431283,650,17
2020-02-29,Italy,IT,238,4,60431283,888,21
2020-03-01,Italy,IT,240,8,60431283,1128,29
2020-03-02,Italy,IT,561,6,60431283,1689,35
2020-03-03,Italy,IT,347,17,60431283,2036,52
2020-03-04,Italy,IT,466,28,60431283,2502,80
2020-03-05,Italy,IT,587,27,60431283,3089,107
2020-03-06,Italy,IT,769,41,60431283,3858,148
2020-03-07,Italy,IT,778,49,60431283,4636,197
2020-03-08,Italy,IT,1247,36,60431283,5883,233
2020-03-09,Italy,IT,1492,133,60431283,7375,366
2020-03-10,Italy,IT,1797,98,60431283,9172,464
2020-03-11,Italy,IT,977,167,60431283,10149,631
2020-03-12,Italy,IT,2313,196,60431283,12462,827
2020-03-13,Italy,IT,2651,189,60431283,15113,1016
2020-03-14,Italy,IT,2547,252,60431283,17660,1268
2020-03-15,Italy,IT,3497,173,60431283,21157,1441
2020-03-16,Italy,IT,2823,370,60431283,23980,1811
2020-03-17,Italy,IT,4000,347,60431283,27980,2158
2020-03-18,Italy,IT,3526,347,60431283,31506,2505
2020-03-19,Italy,IT,4207,473,60431283,35713,2978
2020-03-20,Italy,IT,5322,429,60431283,41035,3407
2020-03-21,Italy,IT,5986,625,60431283,47021,4032
2020-03-22,Italy,IT,6557,795,60431283,53578,4827
2020-03-23,Italy,IT,5560,649,60431283,59138,5476
2020-03-24,Italy,IT,4789,601,60431283,63927,6077
2020-03-25,Italy,IT,5249,743,60431283,69176,6820
2020-03-26,Italy,IT,5210,685,60431283,74386,7505
2020-03-27,Italy,IT,6153,660,60431283,80539,8165
2020-03-28,Italy,IT,5959,971,60431283,86498,9136
2020-03-29,Italy,IT,5974,887,60431283,92472,10023
2020-03-30,Italy,IT,5217,758,60431283,97689,10781
2020-03-31,Italy,IT,4050,810,60431283,101739,11591
2020-04-01,Italy,IT,4053,839,60431283,105792,12430
2020-04-02,Italy,IT,4782,727,60431283,110574,13157
2020-04-03,Italy,IT,4668,760,60431283,115242,13917
2020-04-04,Italy,IT,4585,764,60431283,119827,14681
2020-04-05,Italy,IT,4805,681,60431283,124632,15362
2020-04-06,Italy,IT,4316,527,60431283,128948,15889
2020-04-07,Italy,IT,3599,636,60431283,132547,16525
2020-04-08,Italy,IT,3039,604,60431283,135586,17129
2020-04-09,Italy,IT,3836,540,60431283,139422,17669
2020-04-10,Italy,IT,4204,612,60431283,143626,18281
2020-04-11,Italy,IT,3951,570,60431283,147577,18851
2020-04-12,Italy,IT,4694,619,60431283,152271,19470
2020-04-13,Italy,IT,4092,431,60431283,156363,19901
2020-04-14,Italy,IT,3153,564,60431283,159516,20465
2020-04-15,Italy,IT,2972,604,60431283,162488,21069
2020-04-16,Italy,IT,2667,578,60431283,165155,21647
2020-04-17,Italy,IT,3786,525,60431283,168941,22172
2020-04-18,Italy,IT,3493,575,60431283,172434,22747
2020-04-19,Italy,IT,3491,480,60431283,175925,23227
2020-04-20,Italy,IT,3047,433,60431283,178972,23660
2020-04-21,Italy,IT,2256,454,60431283,181228,24114
2020-04-22,Italy,IT,2729,534,60431283,183957,24648
2020-04-23,Italy,IT,3370,437,60431283,187327,25085
2020-04-24,Italy,IT,2646,464,60431283,189973,25549
2020-04-25,Italy,IT,3021,420,60431283,192994,25969
2020-04-26,Italy,IT,2357,415,60431283,195351,26384
2020-04-27,Italy,IT,2324,260,60431283,197675,26644
2020-04-28,Italy,IT,1739,333,60431283,199414,26977
2020-04-29,Italy,IT,2091,382,60431283,201505,27359
2020-04-30,Italy,IT,2086,323,60431283,203591,27682
2020-05-01,Italy,IT,1872,285,60431283,205463,27967
2020-05-02,Italy,IT,1965,269,60431283,207428,28236
2020-05-03,Italy,IT,1900,474,60431283,209328,28710
2020-03-20,Jersey,JE,5,0,106800,5,0
2020-03-21,Jersey,JE,7,0,106800,12,0
2020-03-22,Jersey,JE,0,0,106800,12,0
2020-03-23,Jersey,JE,3,0,106800,15,0
2020-03-24,Jersey,JE,3,0,106800,18,0
2020-03-25,Jersey,JE,0,0,106800,18,0
2020-03-26,Jersey,JE,0,0,106800,18,0
2020-03-27,Jersey,JE,14,1,106800,32,1
2020-03-28,Jersey,JE,20,0,106800,52,1
2020-03-29,Jersey,JE,9,0,106800,61,1
2020-03-30,Jersey,JE,2,1,106800,63,2
2020-03-31,Jersey,JE,0,0,106800,63,2
2020-04-01,Jersey,JE,18,0,106800,81,2
2020-04-02,Jersey,JE,0,0,106800,81,2
2020-04-03,Jersey,JE,0,0,106800,81,2
2020-04-04,Jersey,JE,37,0,106800,118,2
2020-04-05,Jersey,JE,5,1,106800,123,3
2020-04-06,Jersey,JE,32,0,106800,155,3
2020-04-07,Jersey,JE,14,0,106800,169,3
2020-04-08,Jersey,JE,1,0,106800,170,3
2020-04-09,Jersey,JE,0,0,106800,170,3
2020-04-10,Jersey,JE,13,0,106800,183,3
2020-04-11,Jersey,JE,15,1,106800,198,4
2020-04-12,Jersey,JE,0,0,106800,198,4
2020-04-13,Jersey,JE,15,0,106800,213,4
2020-04-14,Jersey,JE,4,0,106800,217,4
2020-04-15,Jersey,JE,0,0,106800,217,4
2020-04-16,Jersey,JE,0,2,106800,217,6
2020-04-17,Jersey,JE,6,4,106800,223,10
2020-04-18,Jersey,JE,1,1,106800,224,11
2020-04-19,Jersey,JE,21,1,106800,245,12
2020-04-20,Jersey,JE,4,0,106800,249,12
2020-04-21,Jersey,JE,0,2,106800,249,14
2020-04-22,Jersey,JE,6,0,106800,255,14
2020-04-23,Jersey,JE,0,4,106800,255,18
2020-04-24,Jersey,JE,21,1,106800,276,19
2020-04-25,Jersey,JE,2,0,106800,278,19
2020-04-26,Jersey,JE,2,0,106800,280,19
2020-04-27,Jersey,JE,1,0,106800,281,19
2020-04-28,Jersey,JE,2,0,106800,283,19
2020-04-29,Jersey,JE,1,1,106800,284,20
2020-04-30,Jersey,JE,2,1,106800,286,21
2020-05-01,Jersey,JE,0,2,106800,286,23
2020-05-02,Jersey,JE,0,1,106800,286,24
2020-05-03,Jersey,JE,5,0,106800,291,24
2020-03-12,Jamaica,JM,2,0,2934855,2,0
2020-03-13,Jamaica,JM,4,0,2934855,6,0
2020-03-14,Jamaica,JM,2,0,2934855,8,0
2020-03-16,Jamaica,JM,2,0,2934855,10,0
2020-03-17,Jamaica,JM,0,0,2934855,10,0
2020-03-18,Jamaica,JM,3,0,2934855,13,0
2020-03-19,Jamaica,JM,2,0,2934855,15,0
2020-03-20,Jamaica,JM,1,0,2934855,16,0
2020-03-21,Jamaica,JM,3,0,2934855,19,0
2020-03-22,Jamaica,JM,0,0,2934855,19,0
2020-03-23,Jamaica,JM,0,0,2934855,19,0
2020-03-24,Jamaica,JM,0,0,2934855,19,0
2020-03-25,Jamaica,JM,2,1,2934855,21,1
2020-03-26,Jamaica,JM,4,0,2934855,25,1
2020-03-27,Jamaica,JM,1,0,2934855,26,1
2020-03-28,Jamaica,JM,0,0,2934855,26,1
2020-03-29,Jamaica,JM,6,0,2934855,32,1
2020-03-30,Jamaica,JM,2,0,2934855,34,1
2020-03-31,Jamaica,JM,4,0,2934855,38,1
2020-04-01,Jamaica,JM,0,0,2934855,38,1
2020-04-02,Jamaica,JM,6,2,2934855,44,3
2020-04-03,Jamaica,JM,3,0,2934855,47,3
2020-04-04,Jamaica,JM,6,0,2934855,53,3
2020-04-05,Jamaica,JM,2,0,2934855,55,3
2020-04-06,Jamaica,JM,3,0,2934855,58,3
2020-04-07,Jamaica,JM,1,0,2934855,59,3
2020-04-08,Jamaica,JM,4,0,2934855,63,3
2020-04-09,Jamaica,JM,0,1,2934855,63,4
2020-04-10,Jamaica,JM,0,0,2934855,63,4
2020-04-11,Jamaica,JM,2,0,2934855,65,4
2020-04-12,Jamaica,JM,4,0,2934855,69,4
2020-04-13,Jamaica,JM,3,0,2934855,72,4
2020-04-14,Jamaica,JM,1,0,2934855,73,4
2020-04-15,Jamaica,JM,32,1,2934855,105,5
2020-04-16,Jamaica,JM,20,0,2934855,125,5
2020-04-17,Jamaica,JM,18,0,2934855,143,5
2020-04-18,Jamaica,JM,20,0,2934855,163,5
2020-04-19,Jamaica,JM,10,0,2934855,173,5
2020-04-20,Jamaica,JM,23,0,2934855,196,5
2020-04-21,Jamaica,JM,27,1,2934855,223,6
2020-04-22,Jamaica,JM,10,0,2934855,233,6
2020-04-23,Jamaica,JM,19,0,2934855,252,6
2020-04-24,Jamaica,JM,0,0,2934855,252,6
2020-04-25,Jamaica,JM,36,1,2934855,288,7
2020-04-26,Jamaica,JM,17,0,2934855,305,7
2020-04-27,Jamaica,JM,45,0,2934855,350,7
2020-04-28,Jamaica,JM,14,0,2934855,364,7
2020-04-29,Jamaica,JM,17,0,2934855,381,7
2020-04-30,Jamaica,JM,15,0,2934855,396,7
2020-05-01,Jamaica,JM,26,1,2934855,422,8
2020-05-02,Jamaica,JM,10,0,2934855,432,8
2020-05-03,Jamaica,JM,31,0,2934855,463,8
2020-03-03,Jordan,JO,1,0,9956011,1,0
2020-03-08,Jordan,JO,0,0,9956011,1,0
2020-03-15,Jordan,JO,0,0,9956011,1,0
2020-03-16,Jordan,JO,14,0,9956011,15,0
2020-03-17,Jordan,JO,1,0,9956011,16,0
2020-03-18,Jordan,JO,19,0,9956011,35,0
2020-03-19,Jordan,JO,17,0,9956011,52,0
2020-03-20,Jordan,JO,4,0,9956011,56,0
2020-03-21,Jordan,JO,13,0,9956011,69,0
2020-03-22,Jordan,JO,15,0,9956011,84,0
2020-03-23,Jordan,JO,15,0,9956011,99,0
2020-03-24,Jordan,JO,13,0,9956011,112,0
2020-03-25,Jordan,JO,15,0,9956011,127,0
2020-03-26,Jordan,JO,26,0,9956011,153,0
2020-03-27,Jordan,JO,19,0,9956011,172,0
2020-03-28,Jordan,JO,40,0,9956011,212,0
2020-03-29,Jordan,JO,23,1,9956011,235,1
2020-03-30,Jordan,JO,24,0,9956011,259,1
2020-03-31,Jordan,JO,9,4,9956011,268,5
2020-04-01,Jordan,JO,6,0,9956011,274,5
2020-04-02,Jordan,JO,4,0,9956011,278,5
2020-04-03,Jordan,JO,21,0,9956011,299,5
2020-04-04,Jordan,JO,0,0,9956011,299,5
2020-04-05,Jordan,JO,24,0,9956011,323,5
2020-04-06,Jordan,JO,22,0,9956011,345,5
2020-04-07,Jordan,JO,4,1,9956011,349,6
2020-04-08,Jordan,JO,0,0,9956011,349,6
2020-04-09,Jordan,JO,9,0,9956011,358,6
2020-04-10,Jordan,JO,14,1,9956011,372,7
2020-04-11,Jordan,JO,0,0,9956011,372,7
2020-04-12,Jordan,JO,9,0,9956011,381,7
2020-04-13,Jordan,JO,8,0,9956011,389,7
2020-04-14,Jordan,JO,2,0,9956011,391,7
2020-04-15,Jordan,JO,6,0,9956011,397,7
2020-04-16,Jordan,JO,4,0,9956011,401,7
2020-04-17,Jordan,JO,1,0,9956011,402,7
2020-04-18,Jordan,JO,5,0,9956011,407,7
2020-04-19,Jordan,JO,6,0,9956011,413,7
2020-04-20,Jordan,JO,4,0,9956011,417,7
2020-04-21,Jordan,JO,8,0,9956011,425,7
2020-04-22,Jordan,JO,0,0,9956011,425,7
2020-04-23,Jordan,JO,3,0,9956011,428,7
2020-04-24,Jordan,JO,9,0,9956011,437,7
2020-04-25,Jordan,JO,4,0,9956011,441,7
2020-04-26,Jordan,JO,3,0,9956011,444,7
2020-04-27,Jordan,JO,3,0,9956011,447,7
2020-04-28,Jordan,JO,2,0,9956011,449,7
2020-04-29,Jordan,JO,0,1,9956011,449,8
2020-04-30,Jordan,JO,2,0,9956011,451,8
2020-05-01,Jordan,JO,2,0,9956011,453,8
2020-05-02,Jordan,JO,6,0,9956011,459,8
2020-05-03,Jordan,JO,1,1,9956011,460,9
2019-12-31,Japan,JP,0,0,126529100,0,0
2020-01-01,Japan,JP,0,0,126529100,0,0
2020-01-02,Japan,JP,0,0,126529100,0,0
2020-01-03,Japan,JP,0,0,126529100,0,0
2020-01-04,Japan,JP,0,0,126529100,0,0
2020-01-05,Japan,JP,0,0,126529100,0,0
2020-01-06,Japan,JP,0,0,126529100,0,0
2020-01-07,Japan,JP,0,0,126529100,0,0
2020-01-08,Japan,JP,0,0,126529100,0,0
2020-01-09,Japan,JP,0,0,126529100,0,0
2020-01-10,Japan,JP,0,0,126529100,0,0
2020-01-11,Japan,JP,0,0,126529100,0,0
2020-01-12,Japan,JP,0,0,126529100,0,0
2020-01-13,Japan,JP,0,0,126529100,0,0
2020-01-14,Japan,JP,0,0,126529100,0,0
2020-01-15,Japan,JP,1,0,126529100,1,0
2020-01-16,Japan,JP,0,0,126529100,1,0
2020-01-17,Japan,JP,0,0,126529100,1,0
2020-01-18,Japan,JP,0,0,126529100,1,0
2020-01-19,Japan,JP,0,0,126529100,1,0
2020-01-20,Japan,JP,0,0,126529100,1,0
2020-01-21,Japan,JP,0,0,126529100,1,0
2020-01-22,Japan,JP,0,0,126529100,1,0
2020-01-23,Japan,JP,0,0,126529100,1,0
2020-01-24,Japan,JP,1,0,126529100,2,0
2020-01-25,Japan,JP,0,0,126529100,2,0
2020-01-26,Japan,JP,1,0,126529100,3,0
2020-01-27,Japan,JP,0,0,126529100,3,0
2020-01-28,Japan,JP,1,0,126529100,4,0
2020-01-29,Japan,JP,3,0,126529100,7,0
2020-01-30,Japan,JP,4,0,126529100,11,0
2020-01-31,Japan,JP,3,0,126529100,14,0
2020-02-01,Japan,JP,1,0,126529100,15,0
2020-02-02,Japan,JP,4,0,126529100,19,0
2020-02-03,Japan,JP,1,0,126529100,20,0
2020-02-04,Japan,JP,0,0,126529100,20,0
2020-02-05,Japan,JP,5,0,126529100,25,0
2020-02-06,Japan,JP,0,0,126529100,25,0
2020-02-07,Japan,JP,0,0,126529100,25,0
2020-02-08,Japan,JP,0,0,126529100,25,0
2020-02-09,Japan,JP,0,0,126529100,25,0
2020-02-10,Japan,JP,0,0,126529100,25,0
2020-02-11,Japan,JP,0,0,126529100,25,0
2020-02-12,Japan,JP,0,0,126529100,25,0
2020-02-13,Japan,JP,4,1,126529100,29,1
2020-02-14,Japan,JP,1,0,126529100,30,1
2020-02-15,Japan,JP,8,0,126529100,38,1
2020-02-16,Japan,JP,14,0,126529100,52,1
2020-02-17,Japan,JP,7,0,126529100,59,1
2020-02-18,Japan,JP,0,0,126529100,59,1
2020-02-19,Japan,JP,7,0,126529100,66,1
2020-02-20,Japan,JP,18,0,126529100,84,1
2020-02-21,Japan,JP,9,0,126529100,93,1
2020-02-22,Japan,JP,12,0,126529100,105,1
2020-02-23,Japan,JP,27,0,126529100,132,1
2020-02-24,Japan,JP,12,0,126529100,144,1
2020-02-25,Japan,JP,0,0,126529100,144,1
2020-02-26,Japan,JP,20,0,126529100,164,1
2020-02-27,Japan,JP,22,2,126529100,186,3
2020-02-28,Japan,JP,24,0,126529100,210,3
2020-02-29,Japan,JP,20,0,126529100,230,3
2020-03-01,Japan,JP,9,2,126529100,239,5
2020-03-02,Japan,JP,15,1,126529100,254,6
2020-03-03,Japan,JP,0,0,126529100,254,6
2020-03-04,Japan,JP,14,0,126529100,268,6
2020-03-05,Japan,JP,49,0,126529100,317,6
2020-03-06,Japan,JP,32,0,126529100,349,6
2020-03-07,Japan,JP,59,0,126529100,408,6
2020-03-08,Japan,JP,47,0,126529100,455,6
2020-03-09,Japan,JP,33,1,126529100,488,7
2020-03-10,Japan,JP,26,2,126529100,514,9
2020-03-11,Japan,JP,54,3,126529100,568,12
2020-03-12,Japan,JP,51,3,126529100,619,15
2020-03-13,Japan,JP,56,4,126529100,675,19
2020-03-14,Japan,JP,62,2,126529100,737,21
2020-03-15,Japan,JP,43,1,126529100,780,22
2020-03-16,Japan,JP,34,2,126529100,814,24
2020-03-17,Japan,JP,10,4,126529100,824,28
2020-03-18,Japan,JP,5,0,126529100,829,28
2020-03-19,Japan,JP,44,1,126529100,873,29
2020-03-20,Japan,JP,77,4,126529100,950,33
2020-03-21,Japan,JP,57,2,126529100,1007,35
2020-03-22,Japan,JP,39,1,126529100,1046,36
2020-03-23,Japan,JP,43,5,126529100,1089,41
2020-03-24,Japan,JP,39,1,126529100,1128,42
2020-03-25,Japan,JP,65,1,126529100,1193,43
2020-03-26,Japan,JP,75,2,126529100,1268,45
2020-03-27,Japan,JP,96,1,126529100,1364,46
2020-03-28,Japan,JP,135,3,126529100,1499,49
2020-03-29,Japan,JP,194,3,126529100,1693,52
2020-03-30,Japan,JP,173,2,126529100,1866,54
2020-03-31,Japan,JP,87,2,126529100,1953,56
2020-04-01,Japan,JP,0,0,126529100,1953,56
2020-04-02,Japan,JP,225,1,126529100,2178,57
2020-04-03,Japan,JP,439,6,126529100,2617,63
2020-04-04,Japan,JP,318,6,126529100,2935,69
2020-04-05,Japan,JP,336,1,126529100,3271,70
2020-04-06,Japan,JP,383,3,126529100,3654,73
2020-04-07,Japan,JP,163,7,126529100,3817,80
2020-04-08,Japan,JP,89,0,126529100,3906,80
2020-04-09,Japan,JP,351,1,126529100,4257,81
2020-04-10,Japan,JP,410,4,126529100,4667,85
2020-04-11,Japan,JP,680,3,126529100,5347,88
2020-04-12,Japan,JP,1401,10,126529100,6748,98
2020-04-13,Japan,JP,507,4,126529100,7255,102
2020-04-14,Japan,JP,390,7,126529100,7645,109
2020-04-15,Japan,JP,455,10,126529100,8100,119
2020-04-16,Japan,JP,482,17,126529100,8582,136
2020-04-17,Japan,JP,585,12,126529100,9167,148
2020-04-18,Japan,JP,628,6,126529100,9795,154
2020-04-19,Japan,JP,566,7,126529100,10361,161
2020-04-20,Japan,JP,390,10,126529100,10751,171
2020-04-21,Japan,JP,367,15,126529100,11118,186
2020-04-22,Japan,JP,378,0,126529100,11496,186
2020-04-23,Japan,JP,276,101,126529100,11772,287
2020-04-24,Japan,JP,468,30,126529100,12240,317
2020-04-25,Japan,JP,652,17,126529100,12892,334
2020-04-26,Japan,JP,290,14,126529100,13182,348
2020-04-27,Japan,JP,203,3,126529100,13385,351
2020-04-28,Japan,JP,191,25,126529100,13576,376
2020-04-29,Japan,JP,276,13,126529100,13852,389
2020-04-30,Japan,JP,236,26,126529100,14088,415
2020-05-01,Japan,JP,193,17,126529100,14281,432
2020-05-02,Japan,JP,263,26,126529100,14544,458
2020-05-03,Japan,JP,295,34,126529100,14839,492
2019-12-31,Cases_on_an_international_conveyance_Japan,JPG11668,0,0,3000,0,0
2020-01-01,Cases_on_an_international_conveyance_Japan,JPG11668,0,0,3000,0,0
2020-01-02,Cases_on_an_international_conveyance_Japan,JPG11668,0,0,3000,0,0
2020-01-03,Cases_on_an_international_conveyance_Japan,JPG11668,0,0,3000,0,0
2020-01-04,Cases_on_an_international_conveyance_Japan,JPG11668,0,0,3000,0,0
2020-01-05,Cases_on_an_international_conveyance_Japan,JPG11668,0,0,3000,0,0
2020-01-06,Cases_on_an_international_conveyance_Japan,JPG11668,0,0,3000,0,0
2020-01-07,Cases_on_an_international_conveyance_Japan,JPG11668,0,0,3000,0,0
2020-01-08,Cases_on_an_international_conveyance_Japan,JPG11668,0,0,3000,0,0
2020-01-09,Cases_on_an_international_conveyance_Japan,JPG11668,0,0,3000,0,0
2020-01-10,Cases_on_an_international_conveyance_Japan,JPG11668,0,0,3000,0,0
2020-01-11,Cases_on_an_international_conveyance_Japan,JPG11668,0,0,3000,0,0
2020-01-12,Cases_on_an_international_conveyance_Japan,JPG11668,0,0,3000,0,0
2020-01-13,Cases_on_an_international_conveyance_Japan,JPG11668,0,0,3000,0,0
2020-01-14,Cases_on_an_international_conveyance_Japan,JPG11668,0,0,3000,0,0
2020-01-15,Cases_on_an_international_conveyance_Japan,JPG11668,0,0,3000,0,0
2020-01-16,Cases_on_an_international_conveyance_Japan,JPG11668,0,0,3000,0,0
2020-01-17,Cases_on_an_international_conveyance_Japan,JPG11668,0,0,3000,0,0
2020-01-18,Cases_on_an_international_conveyance_Japan,JPG11668,0,0,3000,0,0
2020-01-19,Cases_on_an_international_conveyance_Japan,JPG11668,0,0,3000,0,0
2020-01-20,Cases_on_an_international_conveyance_Japan,JPG11668,0,0,3000,0,0
2020-01-21,Cases_on_an_international_conveyance_Japan,JPG11668,0,0,3000,0,0
2020-01-22,Cases_on_an_international_conveyance_Japan,JPG11668,0,0,3000,0,0
2020-01-23,Cases_on_an_international_conveyance_Japan,JPG11668,0,0,3000,0,0
2020-01-24,Cases_on_an_international_conveyance_Japan,JPG11668,0,0,3000,0,0
2020-01-25,Cases_on_an_international_conveyance_Japan,JPG11668,0,0,3000,0,0
2020-01-26,Cases_on_an_international_conveyance_Japan,JPG11668,0,0,3000,0,0
2020-01-27,Cases_on_an_international_conveyance_Japan,JPG11668,0,0,3000,0,0
2020-01-28,Cases_on_an_international_conveyance_Japan,JPG11668,0,0,3000,0,0
2020-01-29,Cases_on_an_international_conveyance_Japan,JPG11668,0,0,3000,0,0
2020-01-30,Cases_on_an_international_conveyance_Japan,JPG11668,0,0,3000,0,0
2020-01-31,Cases_on_an_international_conveyance_Japan,JPG11668,0,0,3000,0,0
2020-02-01,Cases_on_an_international_conveyance_Japan,JPG11668,0,0,3000,0,0
2020-02-02,Cases_on_an_international_conveyance_Japan,JPG11668,0,0,3000,0,0
2020-02-03,Cases_on_an_international_conveyance_Japan,JPG11668,0,0,3000,0,0
2020-02-04,Cases_on_an_international_conveyance_Japan,JPG11668,0,0,3000,0,0
2020-02-05,Cases_on_an_international_conveyance_Japan,JPG11668,10,0,3000,10,0
2020-02-06,Cases_on_an_international_conveyance_Japan,JPG11668,10,0,3000,20,0
2020-02-07,Cases_on_an_international_conveyance_Japan,JPG11668,41,0,3000,61,0
2020-02-08,Cases_on_an_international_conveyance_Japan,JPG11668,3,0,3000,64,0
2020-02-09,Cases_on_an_international_conveyance_Japan,JPG11668,0,0,3000,64,0
2020-02-10,Cases_on_an_international_conveyance_Japan,JPG11668,6,0,3000,70,0
2020-02-11,Cases_on_an_international_conveyance_Japan,JPG11668,65,0,3000,135,0
2020-02-12,Cases_on_an_international_conveyance_Japan,JPG11668,39,0,3000,174,0
2020-02-13,Cases_on_an_international_conveyance_Japan,JPG11668,0,0,3000,174,0
2020-02-14,Cases_on_an_international_conveyance_Japan,JPG11668,47,0,3000,221,0
2020-02-15,Cases_on_an_international_conveyance_Japan,JPG11668,0,0,3000,221,0
2020-02-16,Cases_on_an_international_conveyance_Japan,JPG11668,134,0,3000,355,0
2020-02-17,Cases_on_an_international_conveyance_Japan,JPG11668,0,0,3000,355,0
2020-02-18,Cases_on_an_international_conveyance_Japan,JPG11668,99,0,3000,454,0
2020-02-19,Cases_on_an_international_conveyance_Japan,JPG11668,88,0,3000,542,0
2020-02-20,Cases_on_an_international_conveyance_Japan,JPG11668,79,2,3000,621,2
2020-02-21,Cases_on_an_international_conveyance_Japan,JPG11668,13,0,3000,634,2
2020-02-22,Cases_on_an_international_conveyance_Japan,JPG11668,0,0,3000,634,2
2020-02-23,Cases_on_an_international_conveyance_Japan,JPG11668,0,0,3000,634,2
2020-02-24,Cases_on_an_international_conveyance_Japan,JPG11668,57,1,3000,691,3
2020-02-25,Cases_on_an_international_conveyance_Japan,JPG11668,0,0,3000,691,3
2020-02-26,Cases_on_an_international_conveyance_Japan,JPG11668,0,1,3000,691,4
2020-02-27,Cases_on_an_international_conveyance_Japan,JPG11668,14,0,3000,705,4
2020-02-28,Cases_on_an_international_conveyance_Japan,JPG11668,0,0,3000,705,4
2020-02-29,Cases_on_an_international_conveyance_Japan,JPG11668,0,2,3000,705,6
2020-03-01,Cases_on_an_international_conveyance_Japan,JPG11668,0,0,3000,705,6
2020-03-02,Cases_on_an_international_conveyance_Japan,JPG11668,0,0,3000,705,6
2020-03-10,Cases_on_an_international_conveyance_Japan,JPG11668,-9,1,3000,696,7
2020-03-14,Kenya,KE,1,0,51393010,1,0
2020-03-15,Kenya,KE,0,0,51393010,1,0
2020-03-16,Kenya,KE,2,0,51393010,3,0
2020-03-17,Kenya,KE,0,0,51393010,3,0
2020-03-18,Kenya,KE,1,0,51393010,4,0
2020-03-19,Kenya,KE,3,0,51393010,7,0
2020-03-20,Kenya,KE,0,0,51393010,7,0
2020-03-21,Kenya,KE,0,0,51393010,7,0
2020-03-22,Kenya,KE,0,0,51393010,7,0
2020-03-23,Kenya,KE,8,0,51393010,15,0
2020-03-24,Kenya,KE,1,0,51393010,16,0
2020-03-25,Kenya,KE,9,0,51393010,25,0
2020-03-26,Kenya,KE,0,0,51393010,25,0
2020-03-27,Kenya,KE,6,1,51393010,31,1
2020-03-28,Kenya,KE,0,0,51393010,31,1
2020-03-29,Kenya,KE,7,0,51393010,38,1
2020-03-30,Kenya,KE,4,0,51393010,42,1
2020-03-31,Kenya,KE,8,0,51393010,50,1
2020-04-01,Kenya,KE,9,0,51393010,59,1
2020-04-02,Kenya,KE,22,0,51393010,81,1
2020-04-03,Kenya,KE,29,2,51393010,110,3
2020-04-04,Kenya,KE,12,1,51393010,122,4
2020-04-05,Kenya,KE,4,0,51393010,126,4
2020-04-06,Kenya,KE,16,0,51393010,142,4
2020-04-07,Kenya,KE,16,0,51393010,158,4
2020-04-08,Kenya,KE,14,2,51393010,172,6
2020-04-09,Kenya,KE,7,0,51393010,179,6
2020-04-10,Kenya,KE,5,1,51393010,184,7
2020-04-11,Kenya,KE,5,0,51393010,189,7
2020-04-12,Kenya,KE,2,0,51393010,191,7
2020-04-13,Kenya,KE,6,1,51393010,197,8
2020-04-14,Kenya,KE,11,1,51393010,208,9
2020-04-15,Kenya,KE,8,0,51393010,216,9
2020-04-16,Kenya,KE,9,1,51393010,225,10
2020-04-17,Kenya,KE,9,1,51393010,234,11
2020-04-18,Kenya,KE,12,0,51393010,246,11
2020-04-19,Kenya,KE,16,1,51393010,262,12
2020-04-20,Kenya,KE,8,2,51393010,270,14
2020-04-21,Kenya,KE,11,0,51393010,281,14
2020-04-22,Kenya,KE,0,0,51393010,281,14
2020-04-23,Kenya,KE,22,0,51393010,303,14
2020-04-24,Kenya,KE,17,0,51393010,320,14
2020-04-25,Kenya,KE,16,0,51393010,336,14
2020-04-26,Kenya,KE,7,0,51393010,343,14
2020-04-27,Kenya,KE,12,0,51393010,355,14
2020-04-28,Kenya,KE,8,0,51393010,363,14
2020-04-29,Kenya,KE,11,0,51393010,374,14
2020-04-30,Kenya,KE,10,1,51393010,384,15
2020-05-01,Kenya,KE,12,2,51393010,396,17
2020-05-02,Kenya,KE,15,4,51393010,411,21
2020-05-03,Kenya,KE,24,1,51393010,435,22
2020-03-19,Kyrgyzstan,KG,3,0,6315800,3,0
2020-03-20,Kyrgyzstan,KG,3,0,6315800,6,0
2020-03-21,Kyrgyzstan,KG,0,0,6315800,6,0
2020-03-22,Kyrgyzstan,KG,8,0,6315800,14,0
2020-03-23,Kyrgyzstan,KG,0,0,6315800,14,0
2020-03-24,Kyrgyzstan,KG,2,0,6315800,16,0
2020-03-25,Kyrgyzstan,KG,26,0,6315800,42,0
2020-03-26,Kyrgyzstan,KG,2,0,6315800,44,0
2020-03-27,Kyrgyzstan,KG,0,0,6315800,44,0
2020-03-28,Kyrgyzstan,KG,14,0,6315800,58,0
2020-03-29,Kyrgyzstan,KG,26,0,6315800,84,0
2020-03-30,Kyrgyzstan,KG,0,0,6315800,84,0
2020-03-31,Kyrgyzstan,KG,0,0,6315800,84,0
2020-04-01,Kyrgyzstan,KG,23,0,6315800,107,0
2020-04-02,Kyrgyzstan,KG,5,1,6315800,112,1
2020-04-03,Kyrgyzstan,KG,13,0,6315800,125,1
2020-04-04,Kyrgyzstan,KG,19,0,6315800,144,1
2020-04-05,Kyrgyzstan,KG,0,0,6315800,144,1
2020-04-06,Kyrgyzstan,KG,72,3,6315800,216,4
2020-04-07,Kyrgyzstan,KG,12,0,6315800,228,4
2020-04-08,Kyrgyzstan,KG,42,0,6315800,270,4
2020-04-09,Kyrgyzstan,KG,10,0,6315800,280,4
2020-04-10,Kyrgyzstan,KG,18,1,6315800,298,5
2020-04-11,Kyrgyzstan,KG,41,0,6315800,339,5
2020-04-12,Kyrgyzstan,KG,38,0,6315800,377,5
2020-04-13,Kyrgyzstan,KG,42,0,6315800,419,5
2020-04-14,Kyrgyzstan,KG,11,0,6315800,430,5
2020-04-15,Kyrgyzstan,KG,19,0,6315800,449,5
2020-04-16,Kyrgyzstan,KG,17,0,6315800,466,5
2020-04-17,Kyrgyzstan,KG,23,0,6315800,489,5
2020-04-18,Kyrgyzstan,KG,17,0,6315800,506,5
2020-04-19,Kyrgyzstan,KG,48,0,6315800,554,5
2020-04-20,Kyrgyzstan,KG,14,2,6315800,568,7
2020-04-21,Kyrgyzstan,KG,22,0,6315800,590,7
2020-04-22,Kyrgyzstan,KG,22,0,6315800,612,7
2020-04-23,Kyrgyzstan,KG,19,1,6315800,631,8
2020-04-24,Kyrgyzstan,KG,25,0,6315800,656,8
2020-04-25,Kyrgyzstan,KG,9,0,6315800,665,8
2020-04-26,Kyrgyzstan,KG,17,0,6315800,682,8
2020-04-27,Kyrgyzstan,KG,13,0,6315800,695,8
2020-04-28,Kyrgyzstan,KG,13,0,6315800,708,8
2020-04-29,Kyrgyzstan,KG,21,0,6315800,729,8
2020-04-30,Kyrgyzstan,KG,17,0,6315800,746,8
2020-05-01,Kyrgyzstan,KG,0,0,6315800,746,8
2020-05-02,Kyrgyzstan,KG,23,0,6315800,769,8
2020-05-03,Kyrgyzstan,KG,26,2,6315800,795,10
2019-12-31,Cambodia,KH,0,0,16249798,0,0
2020-01-01,Cambodia,KH,0,0,16249798,0,0
2020-01-02,Cambodia,KH,0,0,16249798,0,0
2020-01-03,Cambodia,KH,0,0,16249798,0,0
2020-01-04,Cambodia,KH,0,0,16249798,0,0
2020-01-05,Cambodia,KH,0,0,16249798,0,0
2020-01-06,Cambodia,KH,0,0,16249798,0,0
2020-01-07,Cambodia,KH,0,0,16249798,0,0
2020-01-08,Cambodia,KH,0,0,16249798,0,0
2020-01-09,Cambodia,KH,0,0,16249798,0,0
2020-01-10,Cambodia,KH,0,0,16249798,0,0
2020-01-11,Cambodia,KH,0,0,16249798,0,0
2020-01-12,Cambodia,KH,0,0,16249798,0,0
2020-01-13,Cambodia,KH,0,0,16249798,0,0
2020-01-14,Cambodia,KH,0,0,16249798,0,0
2020-01-15,Cambodia,KH,0,0,16249798,0,0
2020-01-16,Cambodia,KH,0,0,16249798,0,0
2020-01-17,Cambodia,KH,0,0,16249798,0,0
2020-01-18,Cambodia,KH,0,0,16249798,0,0
2020-01-19,Cambodia,KH,0,0,16249798,0,0
2020-01-20,Cambodia,KH,0,0,16249798,0,0
2020-01-21,Cambodia,KH,0,0,16249798,0,0
2020-01-22,Cambodia,KH,0,0,16249798,0,0
2020-01-23,Cambodia,KH,0,0,16249798,0,0
2020-01-24,Cambodia,KH,0,0,16249798,0,0
2020-01-25,Cambodia,KH,0,0,16249798,0,0
2020-01-26,Cambodia,KH,0,0,16249798,0,0
2020-01-27,Cambodia,KH,0,0,16249798,0,0
2020-01-28,Cambodia,KH,1,0,16249798,1,0
2020-01-29,Cambodia,KH,0,0,16249798,1,0
2020-01-30,Cambodia,KH,0,0,16249798,1,0
2020-01-31,Cambodia,KH,0,0,16249798,1,0
2020-02-01,Cambodia,KH,0,0,16249798,1,0
2020-02-02,Cambodia,KH,0,0,16249798,1,0
2020-02-03,Cambodia,KH,0,0,16249798,1,0
2020-02-04,Cambodia,KH,0,0,16249798,1,0
2020-02-05,Cambodia,KH,0,0,16249798,1,0
2020-02-06,Cambodia,KH,0,0,16249798,1,0
2020-02-07,Cambodia,KH,0,0,16249798,1,0
2020-02-08,Cambodia,KH,0,0,16249798,1,0
2020-02-09,Cambodia,KH,0,0,16249798,1,0
2020-02-10,Cambodia,KH,0,0,16249798,1,0
2020-02-11,Cambodia,KH,0,0,16249798,1,0
2020-02-12,Cambodia,KH,0,0,16249798,1,0
2020-02-13,Cambodia,KH,0,0,16249798,1,0
2020-02-14,Cambodia,KH,0,0,16249798,1,0
2020-02-15,Cambodia,KH,0,0,16249798,1,0
2020-02-16,Cambodia,KH,0,0,16249798,1,0
2020-02-17,Cambodia,KH,0,0,16249798,1,0
2020-02-18,Cambodia,KH,0,0,16249798,1,0
2020-02-19,Cambodia,KH,0,0,16249798,1,0
2020-02-20,Cambodia,KH,0,0,16249798,1,0
2020-02-21,Cambodia,KH,0,0,16249798,1,0
2020-02-22,Cambodia,KH,0,0,16249798,1,0
2020-02-23,Cambodia,KH,0,0,16249798,1,0
2020-02-24,Cambodia,KH,0,0,16249798,1,0
2020-02-25,Cambodia,KH,0,0,16249798,1,0
2020-02-26,Cambodia,KH,0,0,16249798,1,0
2020-02-27,Cambodia,KH,0,0,16249798,1,0
2020-02-28,Cambodia,KH,0,0,16249798,1,0
2020-02-29,Cambodia,KH,0,0,16249798,1,0
2020-03-01,Cambodia,KH,0,0,16249798,1,0
2020-03-02,Cambodia,KH,0,0,16249798,1,0
2020-03-08,Cambodia,KH,1,0,16249798,2,0
2020-03-12,Cambodia,KH,1,0,16249798,3,0
2020-03-13,Cambodia,KH,2,0,16249798,5,0
2020-03-15,Cambodia,KH,2,0,16249798,7,0
2020-03-16,Cambodia,KH,5,0,16249798,12,0
2020-03-17,Cambodia,KH,12,0,16249798,24,0
2020-03-18,Cambodia,KH,0,0,16249798,24,0
2020-03-19,Cambodia,KH,0,0,16249798,24,0
2020-03-20,Cambodia,KH,0,0,16249798,24,0
2020-03-21,Cambodia,KH,23,0,16249798,47,0
2020-03-22,Cambodia,KH,4,0,16249798,51,0
2020-03-23,Cambodia,KH,35,0,16249798,86,0
2020-03-24,Cambodia,KH,1,0,16249798,87,0
2020-03-25,Cambodia,KH,4,0,16249798,91,0
2020-03-26,Cambodia,KH,5,0,16249798,96,0
2020-03-27,Cambodia,KH,2,0,16249798,98,0
2020-03-28,Cambodia,KH,4,0,16249798,102,0
2020-03-29,Cambodia,KH,1,0,16249798,103,0
2020-03-30,Cambodia,KH,4,0,16249798,107,0
2020-03-31,Cambodia,KH,2,0,16249798,109,0
2020-04-01,Cambodia,KH,0,0,16249798,109,0
2020-04-02,Cambodia,KH,1,0,16249798,110,0
2020-04-03,Cambodia,KH,4,0,16249798,114,0
2020-04-04,Cambodia,KH,0,0,16249798,114,0
2020-04-05,Cambodia,KH,0,0,16249798,114,0
2020-04-06,Cambodia,KH,0,0,16249798,114,0
2020-04-07,Cambodia,KH,1,0,16249798,115,0
2020-04-08,Cambodia,KH,2,0,16249798,117,0
2020-04-09,Cambodia,KH,1,0,16249798,118,0
2020-04-10,Cambodia,KH,1,0,16249798,119,0
2020-04-11,Cambodia,KH,1,0,16249798,120,0
2020-04-12,Cambodia,KH,2,0,16249798,122,0
2020-04-13,Cambodia,KH,0,0,16249798,122,0
2020-04-14,Cambodia,KH,0,0,16249798,122,0
2020-04-15,Cambodia,KH,0,0,16249798,122,0
2020-04-16,Cambodia,KH,0,0,16249798,122,0
2020-04-17,Cambodia,KH,0,0,16249798,122,0
2020-04-18,Cambodia,KH,0,0,16249798,122,0
2020-04-19,Cambodia,KH,0,0,16249798,122,0
2020-04-20,Cambodia,KH,0,0,16249798,122,0
2020-04-21,Cambodia,KH,0,0,16249798,122,0
2020-04-22,Cambodia,KH,0,0,16249798,122,0
2020-04-23,Cambodia,KH,0,0,16249798,122,0
2020-04-24,Cambodia,KH,0,0,16249798,122,0
2020-04-25,Cambodia,KH,0,0,16249798,122,0
2020-04-26,Cambodia,KH,0,0,16249798,122,0
2020-04-27,Cambodia,KH,0,0,16249798,122,0
2020-04-28,Cambodia,KH,0,0,16249798,122,0
2020-04-29,Cambodia,KH,0,0,16249798,122,0
2020-04-30,Cambodia,KH,0,0,16249798,122,0
2020-05-01,Cambodia,KH,0,0,16249798,122,0
2020-05-02,Cambodia,KH,0,0,16249798,122,0
2020-05-03,Cambodia,KH,0,0,16249798,122,0
2020-05-02,Comoros,KM,1,0,832322,1,0
2020-05-03,Comoros,KM,0,0,832322,1,0
2020-03-26,Saint_Kitts_and_Nevis,KN,2,0,52441,2,0
2020-03-27,Saint_Kitts_and_Nevis,KN,0,0,52441,2,0
2020-03-28,Saint_Kitts_and_Nevis,KN,0,0,52441,2,0
2020-03-29,Saint_Kitts_and_Nevis,KN,0,0,52441,2,0
2020-03-30,Saint_Kitts_and_Nevis,KN,5,0,52441,7,0
2020-03-31,Saint_Kitts_and_Nevis,KN,0,0,52441,7,0
2020-04-01,Saint_Kitts_and_Nevis,KN,1,0,52441,8,0
2020-04-02,Saint_Kitts_and_Nevis,KN,0,0,52441,8,0
2020-04-03,Saint_Kitts_and_Nevis,KN,0,0,52441,8,0
2020-04-04,Saint_Kitts_and_Nevis,KN,1,0,52441,9,0
2020-04-05,Saint_Kitts_and_Nevis,KN,1,0,52441,10,0
2020-04-06,Saint_Kitts_and_Nevis,KN,0,0,52441,10,0
2020-04-07,Saint_Kitts_and_Nevis,KN,1,0,52441,11,0
2020-04-08,Saint_Kitts_and_Nevis,KN,0,0,52441,11,0
2020-04-09,Saint_Kitts_and_Nevis,KN,0,0,52441,11,0
2020-04-10,Saint_Kitts_and_Nevis,KN,0,0,52441,11,0
2020-04-11,Saint_Kitts_and_Nevis,KN,1,0,52441,12,0
2020-04-12,Saint_Kitts_and_Nevis,KN,0,0,52441,12,0
2020-04-13,Saint_Kitts_and_Nevis,KN,0,0,52441,12,0
2020-04-14,Saint_Kitts_and_Nevis,KN,0,0,52441,12,0
2020-04-15,Saint_Kitts_and_Nevis,KN,2,0,52441,14,0
2020-04-16,Saint_Kitts_and_Nevis,KN,0,0,52441,14,0
2020-04-17,Saint_Kitts_and_Nevis,KN,0,0,52441,14,0
2020-04-18,Saint_Kitts_and_Nevis,KN,0,0,52441,14,0
2020-04-19,Saint_Kitts_and_Nevis,KN,0,0,52441,14,0
2020-04-20,Saint_Kitts_and_Nevis,KN,1,0,52441,15,0
2020-04-21,Saint_Kitts_and_Nevis,KN,0,0,52441,15,0
2020-04-22,Saint_Kitts_and_Nevis,KN,0,0,52441,15,0
2020-04-23,Saint_Kitts_and_Nevis,KN,0,0,52441,15,0
2020-04-24,Saint_Kitts_and_Nevis,KN,0,0,52441,15,0
2020-04-25,Saint_Kitts_and_Nevis,KN,0,0,52441,15,0
2020-04-26,Saint_Kitts_and_Nevis,KN,0,0,52441,15,0
2020-04-27,Saint_Kitts_and_Nevis,KN,0,0,52441,15,0
2020-04-28,Saint_Kitts_and_Nevis,KN,0,0,52441,15,0
2020-04-29,Saint_Kitts_and_Nevis,KN,0,0,52441,15,0
2020-04-30,Saint_Kitts_and_Nevis,KN,0,0,52441,15,0
2020-05-01,Saint_Kitts_and_Nevis,KN,0,0,52441,15,0
2020-05-02,Saint_Kitts_and_Nevis,KN,0,0,52441,15,0
2020-05-03,Saint_Kitts_and_Nevis,KN,0,0,52441,15,0
2019-12-31,South_Korea,KR,0,0,51635256,0,0
2020-01-01,South_Korea,KR,0,0,51635256,0,0
2020-01-02,South_Korea,KR,0,0,51635256,0,0
2020-01-03,South_Korea,KR,0,0,51635256,0,0
2020-01-04,South_Korea,KR,0,0,51635256,0,0
2020-01-05,South_Korea,KR,0,0,51635256,0,0
2020-01-06,South_Korea,KR,0,0,51635256,0,0
2020-01-07,South_Korea,KR,0,0,51635256,0,0
2020-01-08,South_Korea,KR,0,0,51635256,0,0
2020-01-09,South_Korea,KR,0,0,51635256,0,0
2020-01-10,South_Korea,KR,0,0,51635256,0,0
2020-01-11,South_Korea,KR,0,0,51635256,0,0
2020-01-12,South_Korea,KR,0,0,51635256,0,0
2020-01-13,South_Korea,KR,0,0,51635256,0,0
2020-01-14,South_Korea,KR,0,0,51635256,0,0
2020-01-15,South_Korea,KR,0,0,51635256,0,0
2020-01-16,South_Korea,KR,0,0,51635256,0,0
2020-01-17,South_Korea,KR,0,0,51635256,0,0
2020-01-18,South_Korea,KR,0,0,51635256,0,0
2020-01-19,South_Korea,KR,0,0,51635256,0,0
2020-01-20,South_Korea,KR,1,0,51635256,1,0
2020-01-21,South_Korea,KR,0,0,51635256,1,0
2020-01-22,South_Korea,KR,0,0,51635256,1,0
2020-01-23,South_Korea,KR,0,0,51635256,1,0
2020-01-24,South_Korea,KR,1,0,51635256,2,0
2020-01-25,South_Korea,KR,0,0,51635256,2,0
2020-01-26,South_Korea,KR,1,0,51635256,3,0
2020-01-27,South_Korea,KR,1,0,51635256,4,0
2020-01-28,South_Korea,KR,0,0,51635256,4,0
2020-01-29,South_Korea,KR,0,0,51635256,4,0
2020-01-30,South_Korea,KR,0,0,51635256,4,0
2020-01-31,South_Korea,KR,3,0,51635256,7,0
2020-02-01,South_Korea,KR,5,0,51635256,12,0
2020-02-02,South_Korea,KR,3,0,51635256,15,0
2020-02-03,South_Korea,KR,0,0,51635256,15,0
2020-02-04,South_Korea,KR,1,0,51635256,16,0
2020-02-05,South_Korea,KR,2,0,51635256,18,0
2020-02-06,South_Korea,KR,5,0,51635256,23,0
2020-02-07,South_Korea,KR,1,0,51635256,24,0
2020-02-08,South_Korea,KR,0,0,51635256,24,0
2020-02-09,South_Korea,KR,1,0,51635256,25,0
2020-02-10,South_Korea,KR,2,0,51635256,27,0
2020-02-11,South_Korea,KR,1,0,51635256,28,0
2020-02-12,South_Korea,KR,0,0,51635256,28,0
2020-02-13,South_Korea,KR,0,0,51635256,28,0
2020-02-14,South_Korea,KR,0,0,51635256,28,0
2020-02-15,South_Korea,KR,0,0,51635256,28,0
2020-02-16,South_Korea,KR,1,0,51635256,29,0
2020-02-17,South_Korea,KR,1,0,51635256,30,0
2020-02-18,South_Korea,KR,1,0,51635256,31,0
2020-02-19,South_Korea,KR,15,0,51635256,46,0
2020-02-20,South_Korea,KR,34,0,51635256,80,0
2020-02-21,South_Korea,KR,75,1,51635256,155,1
2020-02-22,South_Korea,KR,190,1,51635256,345,2
2020-02-23,South_Korea,KR,256,3,51635256,601,5
2020-02-24,South_Korea,KR,161,2,51635256,762,7
2020-02-25,South_Korea,KR,130,1,51635256,892,8
2020-02-26,South_Korea,KR,254,3,51635256,1146,11
2020-02-27,South_Korea,KR,449,1,51635256,1595,12
2020-02-28,South_Korea,KR,427,1,51635256,2022,13
2020-02-29,South_Korea,KR,909,3,51635256,2931,16
2020-03-01,South_Korea,KR,595,1,51635256,3526,17
2020-03-02,South_Korea,KR,686,5,51635256,4212,22
2020-03-03,South_Korea,KR,600,6,51635256,4812,28
2020-03-04,South_Korea,KR,516,4,51635256,5328,32
2020-03-05,South_Korea,KR,438,3,51635256,5766,35
2020-03-06,South_Korea,KR,518,7,51635256,6284,42
2020-03-07,South_Korea,KR,483,2,51635256,6767,44
2020-03-08,South_Korea,KR,367,6,51635256,7134,50
2020-03-09,South_Korea,KR,248,1,51635256,7382,51
2020-03-10,South_Korea,KR,131,3,51635256,7513,54
2020-03-11,South_Korea,KR,242,6,51635256,7755,60
2020-03-12,South_Korea,KR,114,6,51635256,7869,66
2020-03-13,South_Korea,KR,110,1,51635256,7979,67
2020-03-14,South_Korea,KR,107,5,51635256,8086,72
2020-03-15,South_Korea,KR,76,3,51635256,8162,75
2020-03-16,South_Korea,KR,74,0,51635256,8236,75
2020-03-17,South_Korea,KR,84,6,51635256,8320,81
2020-03-18,South_Korea,KR,93,5,51635256,8413,86
2020-03-19,South_Korea,KR,152,5,51635256,8565,91
2020-03-20,South_Korea,KR,87,9,51635256,8652,100
2020-03-21,South_Korea,KR,147,3,51635256,8799,103
2020-03-22,South_Korea,KR,98,1,51635256,8897,104
2020-03-23,South_Korea,KR,64,9,51635256,8961,113
2020-03-24,South_Korea,KR,76,7,51635256,9037,120
2020-03-25,South_Korea,KR,100,6,51635256,9137,126
2020-03-26,South_Korea,KR,104,5,51635256,9241,131
2020-03-27,South_Korea,KR,91,8,51635256,9332,139
2020-03-28,South_Korea,KR,146,5,51635256,9478,144
2020-03-29,South_Korea,KR,105,8,51635256,9583,152
2020-03-30,South_Korea,KR,78,6,51635256,9661,158
2020-03-31,South_Korea,KR,125,5,51635256,9786,163
2020-04-01,South_Korea,KR,0,0,51635256,9786,163
2020-04-02,South_Korea,KR,190,6,51635256,9976,169
2020-04-03,South_Korea,KR,86,5,51635256,10062,174
2020-04-04,South_Korea,KR,94,3,51635256,10156,177
2020-04-05,South_Korea,KR,81,6,51635256,10237,183
2020-04-06,South_Korea,KR,47,3,51635256,10284,186
2020-04-07,South_Korea,KR,47,6,51635256,10331,192
2020-04-08,South_Korea,KR,53,8,51635256,10384,200
2020-04-09,South_Korea,KR,39,4,51635256,10423,204
2020-04-10,South_Korea,KR,27,4,51635256,10450,208
2020-04-11,South_Korea,KR,0,0,51635256,10450,208
2020-04-12,South_Korea,KR,62,6,51635256,10512,214
2020-04-13,South_Korea,KR,25,3,51635256,10537,217
2020-04-14,South_Korea,KR,27,5,51635256,10564,222
2020-04-15,South_Korea,KR,27,3,51635256,10591,225
2020-04-16,South_Korea,KR,22,4,51635256,10613,229
2020-04-17,South_Korea,KR,22,1,51635256,10635,230
2020-04-18,South_Korea,KR,18,2,51635256,10653,232
2020-04-19,South_Korea,KR,8,2,51635256,10661,234
2020-04-20,South_Korea,KR,13,2,51635256,10674,236
2020-04-21,South_Korea,KR,9,1,51635256,10683,237
2020-04-22,South_Korea,KR,11,1,51635256,10694,238
2020-04-23,South_Korea,KR,8,2,51635256,10702,240
2020-04-24,South_Korea,KR,6,0,51635256,10708,240
2020-04-25,South_Korea,KR,10,0,51635256,10718,240
2020-04-26,South_Korea,KR,10,2,51635256,10728,242
2020-04-27,South_Korea,KR,10,1,51635256,10738,243
2020-04-28,South_Korea,KR,14,1,51635256,10752,244
2020-04-29,South_Korea,KR,9,2,51635256,10761,246
2020-04-30,South_Korea,KR,4,1,51635256,10765,247
2020-05-01,South_Korea,KR,9,1,51635256,10774,248
2020-05-02,South_Korea,KR,6,2,51635256,10780,250
2020-05-03,South_Korea,KR,13,0,51635256,10793,250
2019-12-31,Kuwait,KW,0,0,4137309,0,0
2020-01-01,Kuwait,KW,0,0,4137309,0,0
2020-01-02,Kuwait,KW,0,0,4137309,0,0
2020-01-03,Kuwait,KW,0,0,4137309,0,0
2020-01-04,Kuwait,KW,0,0,4137309,0,0
2020-01-05,Kuwait,KW,0,0,4137309,0,0
2020-01-06,Kuwait,KW,0,0,4137309,0,0
2020-01-07,Kuwait,KW,0,0,4137309,0,0
2020-01-08,Kuwait,KW,0,0,4137309,0,0
2020-01-09,Kuwait,KW,0,0,4137309,0,0
2020-01-10,Kuwait,KW,0,0,4137309,0,0
2020-01-11,Kuwait,KW,0,0,4137309,0,0
2020-01-12,Kuwait,KW,0,0,4137309,0,0
2020-01-13,Kuwait,KW,0,0,4137309,0,0
2020-01-14,Kuwait,KW,0,0,4137309,0,0
2020-01-15,Kuwait,KW,0,0,4137309,0,0
2020-01-16,Kuwait,KW,0,0,4137309,0,0
2020-01-17,Kuwait,KW,0,0,4137309,0,0
2020-01-18,Kuwait,KW,0,0,4137309,0,0
2020-01-19,Kuwait,KW,0,0,4137309,0,0
2020-01-20,Kuwait,KW,0,0,4137309,0,0
2020-01-21,Kuwait,KW,0,0,4137309,0,0
2020-01-22,Kuwait,KW,0,0,4137309,0,0
2020-01-23,Kuwait,KW,0,0,4137309,0,0
2020-01-24,Kuwait,KW,0,0,4137309,0,0
2020-01-25,Kuwait,KW,0,0,4137309,0,0
2020-01-26,Kuwait,KW,0,0,4137309,0,0
2020-01-27,Kuwait,KW,0,0,4137309,0,0
2020-01-28,Kuwait,KW,0,0,4137309,0,0
2020-01-29,Kuwait,KW,0,0,4137309,0,0
2020-01-30,Kuwait,KW,0,0,4137309,0,0
2020-01-31,Kuwait,KW,0,0,4137309,0,0
2020-02-01,Kuwait,KW,0,0,4137309,0,0
2020-02-02,Kuwait,KW,0,0,4137309,0,0
2020-02-03,Kuwait,KW,0,0,4137309,0,0
2020-02-04,Kuwait,KW,0,0,4137309,0,0
2020-02-05,Kuwait,KW,0,0,4137309,0,0
2020-02-06,Kuwait,KW,0,0,4137309,0,0
2020-02-07,Kuwait,KW,0,0,4137309,0,0
2020-02-08,Kuwait,KW,0,0,4137309,0,0
2020-02-09,Kuwait,KW,0,0,4137309,0,0
2020-02-10,Kuwait,KW,0,0,4137309,0,0
2020-02-11,Kuwait,KW,0,0,4137309,0,0
2020-02-12,Kuwait,KW,0,0,4137309,0,0
2020-02-13,Kuwait,KW,0,0,4137309,0,0
2020-02-14,Kuwait,KW,0,0,4137309,0,0
2020-02-15,Kuwait,KW,0,0,4137309,0,0
2020-02-16,Kuwait,KW,0,0,4137309,0,0
2020-02-17,Kuwait,KW,0,0,4137309,0,0
2020-02-18,Kuwait,KW,0,0,4137309,0,0
2020-02-19,Kuwait,KW,0,0,4137309,0,0
2020-02-20,Kuwait,KW,0,0,4137309,0,0
2020-02-21,Kuwait,KW,0,0,4137309,0,0
2020-02-22,Kuwait,KW,0,0,4137309,0,0
2020-02-23,Kuwait,KW,0,0,4137309,0,0
2020-02-24,Kuwait,KW,3,0,4137309,3,0
2020-02-25,Kuwait,KW,2,0,4137309,5,0
2020-02-26,Kuwait,KW,6,0,4137309,11,0
2020-02-27,Kuwait,KW,15,0,4137309,26,0
2020-02-28,Kuwait,KW,17,0,4137309,43,0
2020-02-29,Kuwait,KW,2,0,4137309,45,0
2020-03-01,Kuwait,KW,0,0,4137309,45,0
2020-03-02,Kuwait,KW,1,0,4137309,46,0
2020-03-03,Kuwait,KW,10,0,4137309,56,0
2020-03-06,Kuwait,KW,2,0,4137309,58,0
2020-03-08,Kuwait,KW,3,0,4137309,61,0
2020-03-09,Kuwait,KW,3,0,4137309,64,0
2020-03-10,Kuwait,KW,1,0,4137309,65,0
2020-03-11,Kuwait,KW,4,0,4137309,69,0
2020-03-12,Kuwait,KW,3,0,4137309,72,0
2020-03-13,Kuwait,KW,8,0,4137309,80,0
2020-03-14,Kuwait,KW,20,0,4137309,100,0
2020-03-15,Kuwait,KW,4,0,4137309,104,0
2020-03-16,Kuwait,KW,8,0,4137309,112,0
2020-03-17,Kuwait,KW,11,0,4137309,123,0
2020-03-18,Kuwait,KW,7,0,4137309,130,0
2020-03-19,Kuwait,KW,12,0,4137309,142,0
2020-03-20,Kuwait,KW,6,0,4137309,148,0
2020-03-21,Kuwait,KW,11,0,4137309,159,0
2020-03-22,Kuwait,KW,17,0,4137309,176,0
2020-03-23,Kuwait,KW,12,0,4137309,188,0
2020-03-24,Kuwait,KW,1,0,4137309,189,0
2020-03-25,Kuwait,KW,2,0,4137309,191,0
2020-03-26,Kuwait,KW,4,0,4137309,195,0
2020-03-27,Kuwait,KW,13,0,4137309,208,0
2020-03-28,Kuwait,KW,17,0,4137309,225,0
2020-03-29,Kuwait,KW,10,0,4137309,235,0
2020-03-30,Kuwait,KW,20,0,4137309,255,0
2020-03-31,Kuwait,KW,11,0,4137309,266,0
2020-04-01,Kuwait,KW,23,0,4137309,289,0
2020-04-02,Kuwait,KW,28,0,4137309,317,0
2020-04-03,Kuwait,KW,25,0,4137309,342,0
2020-04-04,Kuwait,KW,0,0,4137309,342,0
2020-04-05,Kuwait,KW,137,1,4137309,479,1
2020-04-06,Kuwait,KW,77,0,4137309,556,1
2020-04-07,Kuwait,KW,109,0,4137309,665,1
2020-04-08,Kuwait,KW,78,0,4137309,743,1
2020-04-09,Kuwait,KW,112,0,4137309,855,1
2020-04-10,Kuwait,KW,55,0,4137309,910,1
2020-04-11,Kuwait,KW,83,0,4137309,993,1
2020-04-12,Kuwait,KW,161,0,4137309,1154,1
2020-04-13,Kuwait,KW,80,0,4137309,1234,1
2020-04-14,Kuwait,KW,66,1,4137309,1300,2
2020-04-15,Kuwait,KW,55,1,4137309,1355,3
2020-04-16,Kuwait,KW,50,0,4137309,1405,3
2020-04-17,Kuwait,KW,119,0,4137309,1524,3
2020-04-18,Kuwait,KW,134,2,4137309,1658,5
2020-04-19,Kuwait,KW,94,1,4137309,1752,6
2020-04-20,Kuwait,KW,163,1,4137309,1915,7
2020-04-21,Kuwait,KW,80,2,4137309,1995,9
2020-04-22,Kuwait,KW,85,2,4137309,2080,11
2020-04-23,Kuwait,KW,168,2,4137309,2248,13
2020-04-24,Kuwait,KW,151,1,4137309,2399,14
2020-04-25,Kuwait,KW,215,1,4137309,2614,15
2020-04-26,Kuwait,KW,278,4,4137309,2892,19
2020-04-27,Kuwait,KW,183,1,4137309,3075,20
2020-04-28,Kuwait,KW,213,2,4137309,3288,22
2020-04-29,Kuwait,KW,152,1,4137309,3440,23
2020-04-30,Kuwait,KW,300,1,4137309,3740,24
2020-05-01,Kuwait,KW,284,2,4137309,4024,26
2020-05-02,Kuwait,KW,353,4,4137309,4377,30
2020-05-03,Kuwait,KW,242,3,4137309,4619,33
2020-03-20,Cayman_Islands,KY,1,0,64174,1,0
2020-03-21,Cayman_Islands,KY,2,1,64174,3,1
2020-03-22,Cayman_Islands,KY,0,0,64174,3,1
2020-03-23,Cayman_Islands,KY,0,0,64174,3,1
2020-03-24,Cayman_Islands,KY,0,0,64174,3,1
2020-03-25,Cayman_Islands,KY,0,0,64174,3,1
2020-03-26,Cayman_Islands,KY,0,0,64174,3,1
2020-03-27,Cayman_Islands,KY,3,0,64174,6,1
2020-03-28,Cayman_Islands,KY,2,0,64174,8,1
2020-03-29,Cayman_Islands,KY,0,0,64174,8,1
2020-03-30,Cayman_Islands,KY,0,0,64174,8,1
2020-03-31,Cayman_Islands,KY,4,0,64174,12,1
2020-04-01,Cayman_Islands,KY,2,0,64174,14,1
2020-04-02,Cayman_Islands,KY,8,0,64174,22,1
2020-04-03,Cayman_Islands,KY,6,0,64174,28,1
2020-04-04,Cayman_Islands,KY,1,0,64174,29,1
2020-04-05,Cayman_Islands,KY,6,0,64174,35,1
2020-04-06,Cayman_Islands,KY,4,0,64174,39,1
2020-04-07,Cayman_Islands,KY,0,0,64174,39,1
2020-04-08,Cayman_Islands,KY,6,0,64174,45,1
2020-04-09,Cayman_Islands,KY,0,0,64174,45,1
2020-04-10,Cayman_Islands,KY,0,0,64174,45,1
2020-04-11,Cayman_Islands,KY,0,0,64174,45,1
2020-04-12,Cayman_Islands,KY,8,0,64174,53,1
2020-04-13,Cayman_Islands,KY,0,0,64174,53,1
2020-04-14,Cayman_Islands,KY,0,0,64174,53,1
2020-04-15,Cayman_Islands,KY,1,0,64174,54,1
2020-04-16,Cayman_Islands,KY,6,0,64174,60,1
2020-04-17,Cayman_Islands,KY,1,0,64174,61,1
2020-04-18,Cayman_Islands,KY,0,0,64174,61,1
2020-04-19,Cayman_Islands,KY,0,0,64174,61,1
2020-04-20,Cayman_Islands,KY,0,0,64174,61,1
2020-04-21,Cayman_Islands,KY,5,0,64174,66,1
2020-04-22,Cayman_Islands,KY,0,0,64174,66,1
2020-04-23,Cayman_Islands,KY,0,0,64174,66,1
2020-04-24,Cayman_Islands,KY,0,0,64174,66,1
2020-04-25,Cayman_Islands,KY,0,0,64174,66,1
2020-04-26,Cayman_Islands,KY,4,0,64174,70,1
2020-04-27,Cayman_Islands,KY,0,0,64174,70,1
2020-04-28,Cayman_Islands,KY,0,0,64174,70,1
2020-04-29,Cayman_Islands,KY,0,0,64174,70,1
2020-04-30,Cayman_Islands,KY,3,0,64174,73,1
2020-05-01,Cayman_Islands,KY,0,0,64174,73,1
2020-05-02,Cayman_Islands,KY,1,0,64174,74,1
2020-05-03,Cayman_Islands,KY,0,0,64174,74,1
2020-03-15,Kazakhstan,KZ,6,0,18276499,6,0
2020-03-16,Kazakhstan,KZ,3,0,18276499,9,0
2020-03-17,Kazakhstan,KZ,2,0,18276499,11,0
2020-03-18,Kazakhstan,KZ,22,0,18276499,33,0
2020-03-19,Kazakhstan,KZ,4,0,18276499,37,0
2020-03-20,Kazakhstan,KZ,12,0,18276499,49,0
2020-03-21,Kazakhstan,KZ,4,0,18276499,53,0
2020-03-22,Kazakhstan,KZ,3,0,18276499,56,0
2020-03-23,Kazakhstan,KZ,4,0,18276499,60,0
2020-03-24,Kazakhstan,KZ,2,0,18276499,62,0
2020-03-25,Kazakhstan,KZ,17,0,18276499,79,0
2020-03-26,Kazakhstan,KZ,9,0,18276499,88,0
2020-03-27,Kazakhstan,KZ,32,0,18276499,120,0
2020-03-28,Kazakhstan,KZ,73,0,18276499,193,0
2020-03-29,Kazakhstan,KZ,36,0,18276499,229,0
2020-03-30,Kazakhstan,KZ,55,1,18276499,284,1
2020-03-31,Kazakhstan,KZ,41,0,18276499,325,1
2020-04-01,Kazakhstan,KZ,15,0,18276499,340,1
2020-04-02,Kazakhstan,KZ,8,1,18276499,348,2
2020-04-03,Kazakhstan,KZ,38,1,18276499,386,3
2020-04-04,Kazakhstan,KZ,74,0,18276499,460,3
2020-04-05,Kazakhstan,KZ,0,0,18276499,460,3
2020-04-06,Kazakhstan,KZ,71,2,18276499,531,5
2020-04-07,Kazakhstan,KZ,139,1,18276499,670,6
2020-04-08,Kazakhstan,KZ,34,0,18276499,704,6
2020-04-09,Kazakhstan,KZ,55,1,18276499,759,7
2020-04-10,Kazakhstan,KZ,43,2,18276499,802,9
2020-04-11,Kazakhstan,KZ,38,1,18276499,840,10
2020-04-12,Kazakhstan,KZ,40,0,18276499,880,10
2020-04-13,Kazakhstan,KZ,81,0,18276499,961,10
2020-04-14,Kazakhstan,KZ,218,4,18276499,1179,14
2020-04-15,Kazakhstan,KZ,88,0,18276499,1267,14
2020-04-16,Kazakhstan,KZ,64,2,18276499,1331,16
2020-04-17,Kazakhstan,KZ,139,1,18276499,1470,17
2020-04-18,Kazakhstan,KZ,121,0,18276499,1591,17
2020-04-19,Kazakhstan,KZ,63,0,18276499,1654,17
2020-04-20,Kazakhstan,KZ,81,2,18276499,1735,19
2020-04-21,Kazakhstan,KZ,214,0,18276499,1949,19
2020-04-22,Kazakhstan,KZ,76,0,18276499,2025,19
2020-04-23,Kazakhstan,KZ,166,0,18276499,2191,19
2020-04-24,Kazakhstan,KZ,143,3,18276499,2334,22
2020-04-25,Kazakhstan,KZ,148,3,18276499,2482,25
2020-04-26,Kazakhstan,KZ,170,0,18276499,2652,25
2020-04-27,Kazakhstan,KZ,65,0,18276499,2717,25
2020-04-28,Kazakhstan,KZ,143,0,18276499,2860,25
2020-04-29,Kazakhstan,KZ,203,0,18276499,3063,25
2020-04-30,Kazakhstan,KZ,142,0,18276499,3205,25
2020-05-01,Kazakhstan,KZ,299,0,18276499,3504,25
2020-05-02,Kazakhstan,KZ,167,0,18276499,3671,25
2020-05-03,Kazakhstan,KZ,206,0,18276499,3877,25
2020-03-25,Laos,LA,2,0,7061507,2,0
2020-03-26,Laos,LA,0,0,7061507,2,0
2020-03-27,Laos,LA,4,0,7061507,6,0
2020-03-28,Laos,LA,0,0,7061507,6,0
2020-03-29,Laos,LA,0,0,7061507,6,0
2020-03-30,Laos,LA,0,0,7061507,6,0
2020-03-31,Laos,LA,3,0,7061507,9,0
2020-04-01,Laos,LA,0,0,7061507,9,0
2020-04-02,Laos,LA,1,0,7061507,10,0
2020-04-03,Laos,LA,0,0,7061507,10,0
2020-04-04,Laos,LA,0,0,7061507,10,0
2020-04-05,Laos,LA,0,0,7061507,10,0
2020-04-06,Laos,LA,1,0,7061507,11,0
2020-04-07,Laos,LA,1,0,7061507,12,0
2020-04-08,Laos,LA,0,0,7061507,12,0
2020-04-09,Laos,LA,3,0,7061507,15,0
2020-04-10,Laos,LA,1,0,7061507,16,0
2020-04-11,Laos,LA,0,0,7061507,16,0
2020-04-12,Laos,LA,2,0,7061507,18,0
2020-04-13,Laos,LA,1,0,7061507,19,0
2020-04-14,Laos,LA,0,0,7061507,19,0
2020-04-15,Laos,LA,0,0,7061507,19,0
2020-04-16,Laos,LA,0,0,7061507,19,0
2020-04-17,Laos,LA,0,0,7061507,19,0
2020-04-18,Laos,LA,0,0,7061507,19,0
2020-04-19,Laos,LA,0,0,7061507,19,0
2020-04-20,Laos,LA,0,0,7061507,19,0
2020-04-21,Laos,LA,0,0,7061507,19,0
2020-04-22,Laos,LA,0,0,7061507,19,0
2020-04-23,Laos,LA,0,0,7061507,19,0
2020-04-24,Laos,LA,0,0,7061507,19,0
2020-04-25,Laos,LA,0,0,7061507,19,0
2020-04-26,Laos,LA,0,0,7061507,19,0
2020-04-27,Laos,LA,0,0,7061507,19,0
2020-04-28,Laos,LA,0,0,7061507,19,0
2020-04-29,Laos,LA,0,0,7061507,19,0
2020-04-30,Laos,LA,0,0,7061507,19,0
2020-05-01,Laos,LA,0,0,7061507,19,0
2020-05-02,Laos,LA,0,0,7061507,19,0
2020-05-03,Laos,LA,0,0,7061507,19,0
2019-12-31,Lebanon,LB,0,0,6848925,0,0
2020-01-01,Lebanon,LB,0,0,6848925,0,0
2020-01-02,Lebanon,LB,0,0,6848925,0,0
2020-01-03,Lebanon,LB,0,0,6848925,0,0
2020-01-04,Lebanon,LB,0,0,6848925,0,0
2020-01-05,Lebanon,LB,0,0,6848925,0,0
2020-01-06,Lebanon,LB,0,0,6848925,0,0
2020-01-07,Lebanon,LB,0,0,6848925,0,0
2020-01-08,Lebanon,LB,0,0,6848925,0,0
2020-01-09,Lebanon,LB,0,0,6848925,0,0
2020-01-10,Lebanon,LB,0,0,6848925,0,0
2020-01-11,Lebanon,LB,0,0,6848925,0,0
2020-01-12,Lebanon,LB,0,0,6848925,0,0
2020-01-13,Lebanon,LB,0,0,6848925,0,0
2020-01-14,Lebanon,LB,0,0,6848925,0,0
2020-01-15,Lebanon,LB,0,0,6848925,0,0
2020-01-16,Lebanon,LB,0,0,6848925,0,0
2020-01-17,Lebanon,LB,0,0,6848925,0,0
2020-01-18,Lebanon,LB,0,0,6848925,0,0
2020-01-19,Lebanon,LB,0,0,6848925,0,0
2020-01-20,Lebanon,LB,0,0,6848925,0,0
2020-01-21,Lebanon,LB,0,0,6848925,0,0
2020-01-22,Lebanon,LB,0,0,6848925,0,0
2020-01-23,Lebanon,LB,0,0,6848925,0,0
2020-01-24,Lebanon,LB,0,0,6848925,0,0
2020-01-25,Lebanon,LB,0,0,6848925,0,0
2020-01-26,Lebanon,LB,0,0,6848925,0,0
2020-01-27,Lebanon,LB,0,0,6848925,0,0
2020-01-28,Lebanon,LB,0,0,6848925,0,0
2020-01-29,Lebanon,LB,0,0,6848925,0,0
2020-01-30,Lebanon,LB,0,0,6848925,0,0
2020-01-31,Lebanon,LB,0,0,6848925,0,0
2020-02-01,Lebanon,LB,0,0,6848925,0,0
2020-02-02,Lebanon,LB,0,0,6848925,0,0
2020-02-03,Lebanon,LB,0,0,6848925,0,0
2020-02-04,Lebanon,LB,0,0,6848925,0,0
2020-02-05,Lebanon,LB,0,0,6848925,0,0
2020-02-06,Lebanon,LB,0,0,6848925,0,0
2020-02-07,Lebanon,LB,0,0,6848925,0,0
2020-02-08,Lebanon,LB,0,0,6848925,0,0
2020-02-09,Lebanon,LB,0,0,6848925,0,0
2020-02-10,Lebanon,LB,0,0,6848925,0,0
2020-02-11,Lebanon,LB,0,0,6848925,0,0
2020-02-12,Lebanon,LB,0,0,6848925,0,0
2020-02-13,Lebanon,LB,0,0,6848925,0,0
2020-02-14,Lebanon,LB,0,0,6848925,0,0
2020-02-15,Lebanon,LB,0,0,6848925,0,0
2020-02-16,Lebanon,LB,0,0,6848925,0,0
2020-02-17,Lebanon,LB,0,0,6848925,0,0
2020-02-18,Lebanon,LB,0,0,6848925,0,0
2020-02-19,Lebanon,LB,0,0,6848925,0,0
2020-02-20,Lebanon,LB,0,0,6848925,0,0
2020-02-21,Lebanon,LB,0,0,6848925,0,0
2020-02-22,Lebanon,LB,1,0,6848925,1,0
2020-02-23,Lebanon,LB,0,0,6848925,1,0
2020-02-24,Lebanon,LB,0,0,6848925,1,0
2020-02-25,Lebanon,LB,0,0,6848925,1,0
2020-02-26,Lebanon,LB,0,0,6848925,1,0
2020-02-27,Lebanon,LB,1,0,6848925,2,0
2020-02-28,Lebanon,LB,1,0,6848925,3,0
2020-02-29,Lebanon,LB,0,0,6848925,3,0
2020-03-01,Lebanon,LB,1,0,6848925,4,0
2020-03-02,Lebanon,LB,6,0,6848925,10,0
2020-03-03,Lebanon,LB,3,0,6848925,13,0
2020-03-06,Lebanon,LB,3,0,6848925,16,0
2020-03-07,Lebanon,LB,6,0,6848925,22,0
2020-03-09,Lebanon,LB,10,0,6848925,32,0
2020-03-10,Lebanon,LB,9,0,6848925,41,0
2020-03-11,Lebanon,LB,0,1,6848925,41,1
2020-03-12,Lebanon,LB,20,1,6848925,61,2
2020-03-13,Lebanon,LB,5,0,6848925,66,2
2020-03-15,Lebanon,LB,27,1,6848925,93,3
2020-03-16,Lebanon,LB,6,0,6848925,99,3
2020-03-17,Lebanon,LB,21,0,6848925,120,3
2020-03-18,Lebanon,LB,0,0,6848925,120,3
2020-03-19,Lebanon,LB,13,1,6848925,133,4
2020-03-20,Lebanon,LB,16,0,6848925,149,4
2020-03-21,Lebanon,LB,14,0,6848925,163,4
2020-03-22,Lebanon,LB,67,0,6848925,230,4
2020-03-23,Lebanon,LB,18,0,6848925,248,4
2020-03-24,Lebanon,LB,19,0,6848925,267,4
2020-03-25,Lebanon,LB,37,0,6848925,304,4
2020-03-26,Lebanon,LB,29,0,6848925,333,4
2020-03-27,Lebanon,LB,35,2,6848925,368,6
2020-03-28,Lebanon,LB,23,1,6848925,391,7
2020-03-29,Lebanon,LB,21,1,6848925,412,8
2020-03-30,Lebanon,LB,26,2,6848925,438,10
2020-03-31,Lebanon,LB,8,1,6848925,446,11
2020-04-01,Lebanon,LB,17,1,6848925,463,12
2020-04-02,Lebanon,LB,16,0,6848925,479,12
2020-04-03,Lebanon,LB,15,4,6848925,494,16
2020-04-04,Lebanon,LB,0,0,6848925,494,16
2020-04-05,Lebanon,LB,26,1,6848925,520,17
2020-04-06,Lebanon,LB,7,1,6848925,527,18
2020-04-07,Lebanon,LB,14,1,6848925,541,19
2020-04-08,Lebanon,LB,7,0,6848925,548,19
2020-04-09,Lebanon,LB,27,0,6848925,575,19
2020-04-10,Lebanon,LB,7,0,6848925,582,19
2020-04-11,Lebanon,LB,27,1,6848925,609,20
2020-04-12,Lebanon,LB,10,0,6848925,619,20
2020-04-13,Lebanon,LB,11,0,6848925,630,20
2020-04-14,Lebanon,LB,2,0,6848925,632,20
2020-04-15,Lebanon,LB,9,1,6848925,641,21
2020-04-16,Lebanon,LB,17,0,6848925,658,21
2020-04-17,Lebanon,LB,5,0,6848925,663,21
2020-04-18,Lebanon,LB,5,0,6848925,668,21
2020-04-19,Lebanon,LB,4,0,6848925,672,21
2020-04-20,Lebanon,LB,1,0,6848925,673,21
2020-04-21,Lebanon,LB,4,0,6848925,677,21
2020-04-22,Lebanon,LB,0,0,6848925,677,21
2020-04-23,Lebanon,LB,5,1,6848925,682,22
2020-04-24,Lebanon,LB,6,0,6848925,688,22
2020-04-25,Lebanon,LB,8,0,6848925,696,22
2020-04-26,Lebanon,LB,8,2,6848925,704,24
2020-04-27,Lebanon,LB,3,0,6848925,707,24
2020-04-28,Lebanon,LB,3,0,6848925,710,24
2020-04-29,Lebanon,LB,7,0,6848925,717,24
2020-04-30,Lebanon,LB,4,0,6848925,721,24
2020-05-01,Lebanon,LB,4,0,6848925,725,24
2020-05-02,Lebanon,LB,4,0,6848925,729,24
2020-05-03,Lebanon,LB,4,1,6848925,733,25
2020-03-15,Saint_Lucia,LC,2,0,181889,2,0
2020-03-16,Saint_Lucia,LC,0,0,181889,2,0
2020-03-17,Saint_Lucia,LC,0,0,181889,2,0
2020-03-18,Saint_Lucia,LC,0,0,181889,2,0
2020-03-19,Saint_Lucia,LC,0,0,181889,2,0
2020-03-20,Saint_Lucia,LC,0,0,181889,2,0
2020-03-21,Saint_Lucia,LC,0,0,181889,2,0
2020-03-22,Saint_Lucia,LC,0,0,181889,2,0
2020-03-23,Saint_Lucia,LC,0,0,181889,2,0
2020-03-24,Saint_Lucia,LC,0,0,181889,2,0
2020-03-25,Saint_Lucia,LC,0,0,181889,2,0
2020-03-26,Saint_Lucia,LC,1,0,181889,3,0
2020-03-27,Saint_Lucia,LC,0,0,181889,3,0
2020-03-28,Saint_Lucia,LC,0,0,181889,3,0
2020-03-29,Saint_Lucia,LC,1,0,181889,4,0
2020-03-30,Saint_Lucia,LC,5,0,181889,9,0
2020-03-31,Saint_Lucia,LC,0,0,181889,9,0
2020-04-01,Saint_Lucia,LC,4,0,181889,13,0
2020-04-02,Saint_Lucia,LC,0,0,181889,13,0
2020-04-03,Saint_Lucia,LC,0,0,181889,13,0
2020-04-04,Saint_Lucia,LC,0,0,181889,13,0
2020-04-05,Saint_Lucia,LC,1,0,181889,14,0
2020-04-06,Saint_Lucia,LC,0,0,181889,14,0
2020-04-07,Saint_Lucia,LC,0,0,181889,14,0
2020-04-08,Saint_Lucia,LC,0,0,181889,14,0
2020-04-09,Saint_Lucia,LC,0,0,181889,14,0
2020-04-10,Saint_Lucia,LC,0,0,181889,14,0
2020-04-11,Saint_Lucia,LC,1,0,181889,15,0
2020-04-12,Saint_Lucia,LC,0,0,181889,15,0
2020-04-13,Saint_Lucia,LC,0,0,181889,15,0
2020-04-14,Saint_Lucia,LC,0,0,181889,15,0
2020-04-15,Saint_Lucia,LC,0,0,181889,15,0
2020-04-16,Saint_Lucia,LC,0,0,181889,15,0
2020-04-17,Saint_Lucia,LC,0,0,181889,15,0
2020-04-18,Saint_Lucia,LC,0,0,181889,15,0
2020-04-19,Saint_Lucia,LC,0,0,181889,15,0
2020-04-20,Saint_Lucia,LC,0,0,181889,15,0
2020-04-21,Saint_Lucia,LC,0,0,181889,15,0
2020-04-22,Saint_Lucia,LC,0,0,181889,15,0
2020-04-23,Saint_Lucia,LC,0,0,181889,15,0
2020-04-24,Saint_Lucia,LC,0,0,181889,15,0
2020-04-25,Saint_Lucia,LC,0,0,181889,15,0
2020-04-26,Saint_Lucia,LC,0,0,181889,15,0
2020-04-27,Saint_Lucia,LC,0,0,181889,15,0
2020-04-28,Saint_Lucia,LC,0,0,181889,15,0
2020-04-29,Saint_Lucia,LC,0,0,181889,15,0
2020-04-30,Saint_Lucia,LC,2,0,181889,17,0
2020-05-01,Saint_Lucia,LC,0,0,181889,17,0
2020-05-02,Saint_Lucia,LC,0,0,181889,17,0
2020-05-03,Saint_Lucia,LC,0,0,181889,17,0
2020-03-05,Liechtenstein,LI,1,0,37910,1,0
2020-03-12,Liechtenstein,LI,2,0,37910,3,0
2020-03-13,Liechtenstein,LI,1,0,37910,4,0
2020-03-14,Liechtenstein,LI,0,0,37910,4,0
2020-03-15,Liechtenstein,LI,0,0,37910,4,0
2020-03-16,Liechtenstein,LI,3,0,37910,7,0
2020-03-17,Liechtenstein,LI,0,0,37910,7,0
2020-03-18,Liechtenstein,LI,0,0,37910,7,0
2020-03-19,Liechtenstein,LI,18,0,37910,25,0
2020-03-20,Liechtenstein,LI,0,0,37910,25,0
2020-03-21,Liechtenstein,LI,9,0,37910,34,0
2020-03-22,Liechtenstein,LI,2,0,37910,36,0
2020-03-23,Liechtenstein,LI,10,0,37910,46,0
2020-03-24,Liechtenstein,LI,0,0,37910,46,0
2020-03-25,Liechtenstein,LI,1,0,37910,47,0
2020-03-26,Liechtenstein,LI,4,0,37910,51,0
2020-03-27,Liechtenstein,LI,5,0,37910,56,0
2020-03-28,Liechtenstein,LI,4,0,37910,60,0
2020-03-29,Liechtenstein,LI,1,0,37910,61,0
2020-03-30,Liechtenstein,LI,1,0,37910,62,0
2020-03-31,Liechtenstein,LI,2,0,37910,64,0
2020-04-01,Liechtenstein,LI,4,0,37910,68,0
2020-04-02,Liechtenstein,LI,4,0,37910,72,0
2020-04-03,Liechtenstein,LI,3,0,37910,75,0
2020-04-04,Liechtenstein,LI,0,0,37910,75,0
2020-04-05,Liechtenstein,LI,2,1,37910,77,1
2020-04-06,Liechtenstein,LI,1,0,37910,78,1
2020-04-07,Liechtenstein,LI,0,0,37910,78,1
2020-04-08,Liechtenstein,LI,0,0,37910,78,1
2020-04-09,Liechtenstein,LI,1,0,37910,79,1
2020-04-10,Liechtenstein,LI,0,0,37910,79,1
2020-04-11,Liechtenstein,LI,1,0,37910,80,1
2020-04-12,Liechtenstein,LI,0,0,37910,80,1
2020-04-13,Liechtenstein,LI,0,0,37910,80,1
2020-04-14,Liechtenstein,LI,1,0,37910,81,1
2020-04-15,Liechtenstein,LI,0,0,37910,81,1
2020-04-16,Liechtenstein,LI,0,0,37910,81,1
2020-04-17,Liechtenstein,LI,0,0,37910,81,1
2020-04-18,Liechtenstein,LI,0,0,37910,81,1
2020-04-19,Liechtenstein,LI,1,0,37910,82,1
2020-04-20,Liechtenstein,LI,0,0,37910,82,1
2020-04-21,Liechtenstein,LI,0,0,37910,82,1
2020-04-22,Liechtenstein,LI,0,0,37910,82,1
2020-04-23,Liechtenstein,LI,0,0,37910,82,1
2020-04-24,Liechtenstein,LI,0,0,37910,82,1
2020-04-25,Liechtenstein,LI,0,0,37910,82,1
2020-04-26,Liechtenstein,LI,1,0,37910,83,1
2020-04-27,Liechtenstein,LI,0,0,37910,83,1
2020-04-28,Liechtenstein,LI,0,0,37910,83,1
2020-04-29,Liechtenstein,LI,0,0,37910,83,1
2020-04-30,Liechtenstein,LI,0,0,37910,83,1
2020-05-01,Liechtenstein,LI,0,0,37910,83,1
2020-05-02,Liechtenstein,LI,0,0,37910,83,1
2020-05-03,Liechtenstein,LI,0,0,37910,83,1
2019-12-31,Sri_Lanka,LK,0,0,21670000,0,0
2020-01-01,Sri_Lanka,LK,0,0,21670000,0,0
2020-01-02,Sri_Lanka,LK,0,0,21670000,0,0
2020-01-03,Sri_Lanka,LK,0,0,21670000,0,0
2020-01-04,Sri_Lanka,LK,0,0,21670000,0,0
2020-01-05,Sri_Lanka,LK,0,0,21670000,0,0
2020-01-06,Sri_Lanka,LK,0,0,21670000,0,0
2020-01-07,Sri_Lanka,LK,0,0,21670000,0,0
2020-01-08,Sri_Lanka,LK,0,0,21670000,0,0
2020-01-09,Sri_Lanka,LK,0,0,21670000,0,0
2020-01-10,Sri_Lanka,LK,0,0,21670000,0,0
2020-01-11,Sri_Lanka,LK,0,0,21670000,0,0
2020-01-12,Sri_Lanka,LK,0,0,21670000,0,0
2020-01-13,Sri_Lanka,LK,0,0,21670000,0,0
2020-01-14,Sri_Lanka,LK,0,0,21670000,0,0
2020-01-15,Sri_Lanka,LK,0,0,21670000,0,0
2020-01-16,Sri_Lanka,LK,0,0,21670000,0,0
2020-01-17,Sri_Lanka,LK,0,0,21670000,0,0
2020-01-18,Sri_Lanka,LK,0,0,21670000,0,0
2020-01-19,Sri_Lanka,LK,0,0,21670000,0,0
2020-01-20,Sri_Lanka,LK,0,0,21670000,0,0
2020-01-21,Sri_Lanka,LK,0,0,21670000,0,0
2020-01-22,Sri_Lanka,LK,0,0,21670000,0,0
2020-01-23,Sri_Lanka,LK,0,0,21670000,0,0
2020-01-24,Sri_Lanka,LK,0,0,21670000,0,0
2020-01-25,Sri_Lanka,LK,0,0,21670000,0,0
2020-01-26,Sri_Lanka,LK,0,0,21670000,0,0
2020-01-27,Sri_Lanka,LK,0,0,21670000,0,0
2020-01-28,Sri_Lanka,LK,1,0,21670000,1,0
2020-01-29,Sri_Lanka,LK,0,0,21670000,1,0
2020-01-30,Sri_Lanka,LK,0,0,21670000,1,0
2020-01-31,Sri_Lanka,LK,0,0,21670000,1,0
2020-02-01,Sri_Lanka,LK,0,0,21670000,1,0
2020-02-02,Sri_Lanka,LK,0,0,21670000,1,0
2020-02-03,Sri_Lanka,LK,0,0,21670000,1,0
2020-02-04,Sri_Lanka,LK,0,0,21670000,1,0
2020-02-05,Sri_Lanka,LK,0,0,21670000,1,0
2020-02-06,Sri_Lanka,LK,0,0,21670000,1,0
2020-02-07,Sri_Lanka,LK,0,0,21670000,1,0
2020-02-08,Sri_Lanka,LK,0,0,21670000,1,0
2020-02-09,Sri_Lanka,LK,0,0,21670000,1,0
2020-02-10,Sri_Lanka,LK,0,0,21670000,1,0
2020-02-11,Sri_Lanka,LK,0,0,21670000,1,0
2020-02-12,Sri_Lanka,LK,0,0,21670000,1,0
2020-02-13,Sri_Lanka,LK,0,0,21670000,1,0
2020-02-14,Sri_Lanka,LK,0,0,21670000,1,0
2020-02-15,Sri_Lanka,LK,0,0,21670000,1,0
2020-02-16,Sri_Lanka,LK,0,0,21670000,1,0
2020-02-17,Sri_Lanka,LK,0,0,21670000,1,0
2020-02-18,Sri_Lanka,LK,0,0,21670000,1,0
2020-02-19,Sri_Lanka,LK,0,0,21670000,1,0
2020-02-20,Sri_Lanka,LK,0,0,21670000,1,0
2020-02-21,Sri_Lanka,LK,0,0,21670000,1,0
2020-02-22,Sri_Lanka,LK,0,0,21670000,1,0
2020-02-23,Sri_Lanka,LK,0,0,21670000,1,0
2020-02-24,Sri_Lanka,LK,0,0,21670000,1,0
2020-02-25,Sri_Lanka,LK,0,0,21670000,1,0
2020-02-26,Sri_Lanka,LK,0,0,21670000,1,0
2020-02-27,Sri_Lanka,LK,0,0,21670000,1,0
2020-02-28,Sri_Lanka,LK,0,0,21670000,1,0
2020-02-29,Sri_Lanka,LK,0,0,21670000,1,0
2020-03-01,Sri_Lanka,LK,0,0,21670000,1,0
2020-03-02,Sri_Lanka,LK,0,0,21670000,1,0
2020-03-12,Sri_Lanka,LK,1,0,21670000,2,0
2020-03-13,Sri_Lanka,LK,1,0,21670000,3,0
2020-03-14,Sri_Lanka,LK,3,0,21670000,6,0
2020-03-15,Sri_Lanka,LK,5,0,21670000,11,0
2020-03-16,Sri_Lanka,LK,8,0,21670000,19,0
2020-03-17,Sri_Lanka,LK,10,0,21670000,29,0
2020-03-18,Sri_Lanka,LK,13,0,21670000,42,0
2020-03-19,Sri_Lanka,LK,0,0,21670000,42,0
2020-03-20,Sri_Lanka,LK,11,0,21670000,53,0
2020-03-21,Sri_Lanka,LK,13,0,21670000,66,0
2020-03-22,Sri_Lanka,LK,12,0,21670000,78,0
2020-03-23,Sri_Lanka,LK,9,0,21670000,87,0
2020-03-24,Sri_Lanka,LK,10,0,21670000,97,0
2020-03-25,Sri_Lanka,LK,5,0,21670000,102,0
2020-03-26,Sri_Lanka,LK,0,0,21670000,102,0
2020-03-27,Sri_Lanka,LK,4,0,21670000,106,0
2020-03-28,Sri_Lanka,LK,0,0,21670000,106,0
2020-03-29,Sri_Lanka,LK,9,1,21670000,115,1
2020-03-30,Sri_Lanka,LK,5,0,21670000,120,1
2020-03-31,Sri_Lanka,LK,0,0,21670000,120,1
2020-04-01,Sri_Lanka,LK,2,1,21670000,122,2
2020-04-02,Sri_Lanka,LK,21,0,21670000,143,2
2020-04-03,Sri_Lanka,LK,5,1,21670000,148,3
2020-04-04,Sri_Lanka,LK,3,1,21670000,151,4
2020-04-05,Sri_Lanka,LK,8,1,21670000,159,5
2020-04-06,Sri_Lanka,LK,7,0,21670000,166,5
2020-04-07,Sri_Lanka,LK,12,0,21670000,178,5
2020-04-08,Sri_Lanka,LK,7,1,21670000,185,6
2020-04-09,Sri_Lanka,LK,4,1,21670000,189,7
2020-04-10,Sri_Lanka,LK,1,0,21670000,190,7
2020-04-11,Sri_Lanka,LK,7,0,21670000,197,7
2020-04-12,Sri_Lanka,LK,2,0,21670000,199,7
2020-04-13,Sri_Lanka,LK,11,0,21670000,210,7
2020-04-14,Sri_Lanka,LK,8,0,21670000,218,7
2020-04-15,Sri_Lanka,LK,15,0,21670000,233,7
2020-04-16,Sri_Lanka,LK,4,0,21670000,237,7
2020-04-17,Sri_Lanka,LK,1,0,21670000,238,7
2020-04-18,Sri_Lanka,LK,6,0,21670000,244,7
2020-04-19,Sri_Lanka,LK,10,0,21670000,254,7
2020-04-20,Sri_Lanka,LK,41,0,21670000,295,7
2020-04-21,Sri_Lanka,LK,9,0,21670000,304,7
2020-04-22,Sri_Lanka,LK,6,0,21670000,310,7
2020-04-23,Sri_Lanka,LK,20,0,21670000,330,7
2020-04-24,Sri_Lanka,LK,38,0,21670000,368,7
2020-04-25,Sri_Lanka,LK,52,0,21670000,420,7
2020-04-26,Sri_Lanka,LK,42,0,21670000,462,7
2020-04-27,Sri_Lanka,LK,61,0,21670000,523,7
2020-04-28,Sri_Lanka,LK,65,0,21670000,588,7
2020-04-29,Sri_Lanka,LK,31,0,21670000,619,7
2020-04-30,Sri_Lanka,LK,30,0,21670000,649,7
2020-05-01,Sri_Lanka,LK,16,0,21670000,665,7
2020-05-02,Sri_Lanka,LK,25,0,21670000,690,7
2020-05-03,Sri_Lanka,LK,15,0,21670000,705,7
2020-03-17,Liberia,LR,1,0,4818977,1,0
2020-03-18,Liberia,LR,1,0,4818977,2,0
2020-03-19,Liberia,LR,0,0,4818977,2,0
2020-03-20,Liberia,LR,0,0,4818977,2,0
2020-03-21,Liberia,LR,0,0,4818977,2,0
2020-03-22,Liberia,LR,1,0,4818977,3,0
2020-03-23,Liberia,LR,0,0,4818977,3,0
2020-03-24,Liberia,LR,0,0,4818977,3,0
2020-03-25,Liberia,LR,0,0,4818977,3,0
2020-03-26,Liberia,LR,0,0,4818977,3,0
2020-03-27,Liberia,LR,0,0,4818977,3,0
2020-03-28,Liberia,LR,0,0,4818977,3,0
2020-03-29,Liberia,LR,0,0,4818977,3,0
2020-03-30,Liberia,LR,0,0,4818977,3,0
2020-03-31,Liberia,LR,0,0,4818977,3,0
2020-04-01,Liberia,LR,0,0,4818977,3,0
2020-04-02,Liberia,LR,3,0,4818977,6,0
2020-04-03,Liberia,LR,0,0,4818977,6,0
2020-04-04,Liberia,LR,1,0,4818977,7,0
2020-04-05,Liberia,LR,3,1,4818977,10,1
2020-04-06,Liberia,LR,3,2,4818977,13,3
2020-04-07,Liberia,LR,1,0,4818977,14,3
2020-04-08,Liberia,LR,0,0,4818977,14,3
2020-04-09,Liberia,LR,17,1,4818977,31,4
2020-04-10,Liberia,LR,0,0,4818977,31,4
2020-04-11,Liberia,LR,6,0,4818977,37,4
2020-04-12,Liberia,LR,11,1,4818977,48,5
2020-04-13,Liberia,LR,2,0,4818977,50,5
2020-04-14,Liberia,LR,9,1,4818977,59,6
2020-04-15,Liberia,LR,0,0,4818977,59,6
2020-04-16,Liberia,LR,0,0,4818977,59,6
2020-04-17,Liberia,LR,14,0,4818977,73,6
2020-04-18,Liberia,LR,3,1,4818977,76,7
2020-04-19,Liberia,LR,5,0,4818977,81,7
2020-04-20,Liberia,LR,10,1,4818977,91,8
2020-04-21,Liberia,LR,8,0,4818977,99,8
2020-04-22,Liberia,LR,2,0,4818977,101,8
2020-04-23,Liberia,LR,0,0,4818977,101,8
2020-04-24,Liberia,LR,0,0,4818977,101,8
2020-04-25,Liberia,LR,16,0,4818977,117,8
2020-04-26,Liberia,LR,3,3,4818977,120,11
2020-04-27,Liberia,LR,4,1,4818977,124,12
2020-04-28,Liberia,LR,9,4,4818977,133,16
2020-04-29,Liberia,LR,8,0,4818977,141,16
2020-04-30,Liberia,LR,0,0,4818977,141,16
2020-05-01,Liberia,LR,0,0,4818977,141,16
2020-05-02,Liberia,LR,11,2,4818977,152,18
2020-05-03,Liberia,LR,2,0,4818977,154,18
2019-12-31,Lithuania,LT,0,0,2789533,0,0
2020-01-01,Lithuania,LT,0,0,2789533,0,0
2020-01-02,Lithuania,LT,0,0,2789533,0,0
2020-01-03,Lithuania,LT,0,0,2789533,0,0
2020-01-04,Lithuania,LT,0,0,2789533,0,0
2020-01-05,Lithuania,LT,0,0,2789533,0,0
2020-01-06,Lithuania,LT,0,0,2789533,0,0
2020-01-07,Lithuania,LT,0,0,2789533,0,0
2020-01-08,Lithuania,LT,0,0,2789533,0,0
2020-01-09,Lithuania,LT,0,0,2789533,0,0
2020-01-10,Lithuania,LT,0,0,2789533,0,0
2020-01-11,Lithuania,LT,0,0,2789533,0,0
2020-01-12,Lithuania,LT,0,0,2789533,0,0
2020-01-13,Lithuania,LT,0,0,2789533,0,0
2020-01-14,Lithuania,LT,0,0,2789533,0,0
2020-01-15,Lithuania,LT,0,0,2789533,0,0
2020-01-16,Lithuania,LT,0,0,2789533,0,0
2020-01-17,Lithuania,LT,0,0,2789533,0,0
2020-01-18,Lithuania,LT,0,0,2789533,0,0
2020-01-19,Lithuania,LT,0,0,2789533,0,0
2020-01-20,Lithuania,LT,0,0,2789533,0,0
2020-01-21,Lithuania,LT,0,0,2789533,0,0
2020-01-22,Lithuania,LT,0,0,2789533,0,0
2020-01-23,Lithuania,LT,0,0,2789533,0,0
2020-01-24,Lithuania,LT,0,0,2789533,0,0
2020-01-25,Lithuania,LT,0,0,2789533,0,0
2020-01-26,Lithuania,LT,0,0,2789533,0,0
2020-01-27,Lithuania,LT,0,0,2789533,0,0
2020-01-28,Lithuania,LT,0,0,2789533,0,0
2020-01-29,Lithuania,LT,0,0,2789533,0,0
2020-01-30,Lithuania,LT,0,0,2789533,0,0
2020-01-31,Lithuania,LT,0,0,2789533,0,0
2020-02-01,Lithuania,LT,0,0,2789533,0,0
2020-02-02,Lithuania,LT,0,0,2789533,0,0
2020-02-03,Lithuania,LT,0,0,2789533,0,0
2020-02-04,Lithuania,LT,0,0,2789533,0,0
2020-02-05,Lithuania,LT,0,0,2789533,0,0
2020-02-06,Lithuania,LT,0,0,2789533,0,0
2020-02-07,Lithuania,LT,0,0,2789533,0,0
2020-02-08,Lithuania,LT,0,0,2789533,0,0
2020-02-09,Lithuania,LT,0,0,2789533,0,0
2020-02-10,Lithuania,LT,0,0,2789533,0,0
2020-02-11,Lithuania,LT,0,0,2789533,0,0
2020-02-12,Lithuania,LT,0,0,2789533,0,0
2020-02-13,Lithuania,LT,0,0,2789533,0,0
2020-02-14,Lithuania,LT,0,0,2789533,0,0
2020-02-15,Lithuania,LT,0,0,2789533,0,0
2020-02-16,Lithuania,LT,0,0,2789533,0,0
2020-02-17,Lithuania,LT,0,0,2789533,0,0
2020-02-18,Lithuania,LT,0,0,2789533,0,0
2020-02-19,Lithuania,LT,0,0,2789533,0,0
2020-02-20,Lithuania,LT,0,0,2789533,0,0
2020-02-21,Lithuania,LT,0,0,2789533,0,0
2020-02-22,Lithuania,LT,0,0,2789533,0,0
2020-02-23,Lithuania,LT,0,0,2789533,0,0
2020-02-24,Lithuania,LT,0,0,2789533,0,0
2020-02-25,Lithuania,LT,0,0,2789533,0,0
2020-02-26,Lithuania,LT,0,0,2789533,0,0
2020-02-27,Lithuania,LT,0,0,2789533,0,0
2020-02-28,Lithuania,LT,1,0,2789533,1,0
2020-02-29,Lithuania,LT,0,0,2789533,1,0
2020-03-01,Lithuania,LT,0,0,2789533,1,0
2020-03-02,Lithuania,LT,0,0,2789533,1,0
2020-03-11,Lithuania,LT,2,0,2789533,3,0
2020-03-12,Lithuania,LT,0,0,2789533,3,0
2020-03-14,Lithuania,LT,3,0,2789533,6,0
2020-03-15,Lithuania,LT,3,0,2789533,9,0
2020-03-16,Lithuania,LT,5,0,2789533,14,0
2020-03-17,Lithuania,LT,3,0,2789533,17,0
2020-03-18,Lithuania,LT,8,0,2789533,25,0
2020-03-19,Lithuania,LT,8,0,2789533,33,0
2020-03-20,Lithuania,LT,15,0,2789533,48,0
2020-03-21,Lithuania,LT,21,1,2789533,69,1
2020-03-22,Lithuania,LT,36,0,2789533,105,1
2020-03-23,Lithuania,LT,38,0,2789533,143,1
2020-03-24,Lithuania,LT,36,0,2789533,179,1
2020-03-25,Lithuania,LT,30,1,2789533,209,2
2020-03-26,Lithuania,LT,65,2,2789533,274,4
2020-03-27,Lithuania,LT,25,0,2789533,299,4
2020-03-28,Lithuania,LT,59,1,2789533,358,5
2020-03-29,Lithuania,LT,36,2,2789533,394,7
2020-03-30,Lithuania,LT,90,0,2789533,484,7
2020-03-31,Lithuania,LT,0,0,2789533,484,7
2020-04-01,Lithuania,LT,49,0,2789533,533,7
2020-04-02,Lithuania,LT,48,1,2789533,581,8
2020-04-03,Lithuania,LT,68,1,2789533,649,9
2020-04-04,Lithuania,LT,122,0,2789533,771,9
2020-04-05,Lithuania,LT,0,0,2789533,771,9
2020-04-06,Lithuania,LT,40,4,2789533,811,13
2020-04-07,Lithuania,LT,32,1,2789533,843,14
2020-04-08,Lithuania,LT,37,1,2789533,880,15
2020-04-09,Lithuania,LT,32,0,2789533,912,15
2020-04-10,Lithuania,LT,43,0,2789533,955,15
2020-04-11,Lithuania,LT,44,2,2789533,999,17
2020-04-12,Lithuania,LT,54,6,2789533,1053,23
2020-04-13,Lithuania,LT,9,1,2789533,1062,24
2020-04-14,Lithuania,LT,8,0,2789533,1070,24
2020-04-15,Lithuania,LT,0,0,2789533,1070,24
2020-04-16,Lithuania,LT,21,5,2789533,1091,29
2020-04-17,Lithuania,LT,58,3,2789533,1149,32
2020-04-18,Lithuania,LT,90,1,2789533,1239,33
2020-04-19,Lithuania,LT,59,0,2789533,1298,33
2020-04-20,Lithuania,LT,28,3,2789533,1326,36
2020-04-21,Lithuania,LT,24,1,2789533,1350,37
2020-04-22,Lithuania,LT,20,1,2789533,1370,38
2020-04-23,Lithuania,LT,28,0,2789533,1398,38
2020-04-24,Lithuania,LT,12,2,2789533,1410,40
2020-04-25,Lithuania,LT,0,0,2789533,1410,40
2020-04-26,Lithuania,LT,16,1,2789533,1426,41
2020-04-27,Lithuania,LT,12,0,2789533,1438,41
2020-04-28,Lithuania,LT,11,0,2789533,1449,41
2020-04-29,Lithuania,LT,-105,3,2789533,1344,44
2020-04-30,Lithuania,LT,31,1,2789533,1375,45
2020-05-01,Lithuania,LT,10,0,2789533,1385,45
2020-05-02,Lithuania,LT,14,0,2789533,1399,45
2020-05-03,Lithuania,LT,7,1,2789533,1406,46
2019-12-31,Luxembourg,LU,0,0,607728,0,0
2020-01-01,Luxembourg,LU,0,0,607728,0,0
2020-01-02,Luxembourg,LU,0,0,607728,0,0
2020-01-03,Luxembourg,LU,0,0,607728,0,0
2020-01-04,Luxembourg,LU,0,0,607728,0,0
2020-01-05,Luxembourg,LU,0,0,607728,0,0
2020-01-06,Luxembourg,LU,0,0,607728,0,0
2020-01-07,Luxembourg,LU,0,0,607728,0,0
2020-01-08,Luxembourg,LU,0,0,607728,0,0
2020-01-09,Luxembourg,LU,0,0,607728,0,0
2020-01-10,Luxembourg,LU,0,0,607728,0,0
2020-01-11,Luxembourg,LU,0,0,607728,0,0
2020-01-12,Luxembourg,LU,0,0,607728,0,0
2020-01-13,Luxembourg,LU,0,0,607728,0,0
2020-01-14,Luxembourg,LU,0,0,607728,0,0
2020-01-15,Luxembourg,LU,0,0,607728,0,0
2020-01-16,Luxembourg,LU,0,0,607728,0,0
2020-01-17,Luxembourg,LU,0,0,607728,0,0
2020-01-18,Luxembourg,LU,0,0,607728,0,0
2020-01-19,Luxembourg,LU,0,0,607728,0,0
2020-01-20,Luxembourg,LU,0,0,607728,0,0
2020-01-21,Luxembourg,LU,0,0,607728,0,0
2020-01-22,Luxembourg,LU,0,0,607728,0,0
2020-01-23,Luxembourg,LU,0,0,607728,0,0
2020-01-24,Luxembourg,LU,0,0,607728,0,0
2020-01-25,Luxembourg,LU,0,0,607728,0,0
2020-01-26,Luxembourg,LU,0,0,607728,0,0
2020-01-27,Luxembourg,LU,0,0,607728,0,0
2020-01-28,Luxembourg,LU,0,0,607728,0,0
2020-01-29,Luxembourg,LU,0,0,607728,0,0
2020-01-30,Luxembourg,LU,0,0,607728,0,0
2020-01-31,Luxembourg,LU,0,0,607728,0,0
2020-02-01,Luxembourg,LU,0,0,607728,0,0
2020-02-02,Luxembourg,LU,0,0,607728,0,0
2020-02-03,Luxembourg,LU,0,0,607728,0,0
2020-02-04,Luxembourg,LU,0,0,607728,0,0
2020-02-05,Luxembourg,LU,0,0,607728,0,0
2020-02-06,Luxembourg,LU,0,0,607728,0,0
2020-02-07,Luxembourg,LU,0,0,607728,0,0
2020-02-08,Luxembourg,LU,0,0,607728,0,0
2020-02-09,Luxembourg,LU,0,0,607728,0,0
2020-02-10,Luxembourg,LU,0,0,607728,0,0
2020-02-11,Luxembourg,LU,0,0,607728,0,0
2020-02-12,Luxembourg,LU,0,0,607728,0,0
2020-02-13,Luxembourg,LU,0,0,607728,0,0
2020-02-14,Luxembourg,LU,0,0,607728,0,0
2020-02-15,Luxembourg,LU,0,0,607728,0,0
2020-02-16,Luxembourg,LU,0,0,607728,0,0
2020-02-17,Luxembourg,LU,0,0,607728,0,0
2020-02-18,Luxembourg,LU,0,0,607728,0,0
2020-02-19,Luxembourg,LU,0,0,607728,0,0
2020-02-20,Luxembourg,LU,0,0,607728,0,0
2020-02-21,Luxembourg,LU,0,0,607728,0,0
2020-02-22,Luxembourg,LU,0,0,607728,0,0
2020-02-23,Luxembourg,LU,0,0,607728,0,0
2020-02-24,Luxembourg,LU,0,0,607728,0,0
2020-02-25,Luxembourg,LU,0,0,607728,0,0
2020-02-26,Luxembourg,LU,0,0,607728,0,0
2020-02-27,Luxembourg,LU,0,0,607728,0,0
2020-02-28,Luxembourg,LU,0,0,607728,0,0
2020-02-29,Luxembourg,LU,0,0,607728,0,0
2020-03-01,Luxembourg,LU,1,0,607728,1,0
2020-03-02,Luxembourg,LU,0,0,607728,1,0
2020-03-07,Luxembourg,LU,2,0,607728,3,0
2020-03-09,Luxembourg,LU,2,0,607728,5,0
2020-03-11,Luxembourg,LU,2,0,607728,7,0
2020-03-12,Luxembourg,LU,0,0,607728,7,0
2020-03-13,Luxembourg,LU,19,0,607728,26,0
2020-03-14,Luxembourg,LU,12,1,607728,38,1
2020-03-16,Luxembourg,LU,39,0,607728,77,1
2020-03-17,Luxembourg,LU,4,0,607728,81,1
2020-03-18,Luxembourg,LU,59,0,607728,140,1
2020-03-19,Luxembourg,LU,70,1,607728,210,2
2020-03-20,Luxembourg,LU,135,2,607728,345,4
2020-03-21,Luxembourg,LU,139,1,607728,484,5
2020-03-22,Luxembourg,LU,186,3,607728,670,8
2020-03-23,Luxembourg,LU,128,0,607728,798,8
2020-03-24,Luxembourg,LU,77,0,607728,875,8
2020-03-25,Luxembourg,LU,224,0,607728,1099,8
2020-03-26,Luxembourg,LU,234,0,607728,1333,8
2020-03-27,Luxembourg,LU,120,1,607728,1453,9
2020-03-28,Luxembourg,LU,152,6,607728,1605,15
2020-03-29,Luxembourg,LU,226,3,607728,1831,18
2020-03-30,Luxembourg,LU,119,3,607728,1950,21
2020-03-31,Luxembourg,LU,38,1,607728,1988,22
2020-04-01,Luxembourg,LU,190,1,607728,2178,23
2020-04-02,Luxembourg,LU,141,6,607728,2319,29
2020-04-03,Luxembourg,LU,168,1,607728,2487,30
2020-04-04,Luxembourg,LU,125,1,607728,2612,31
2020-04-05,Luxembourg,LU,117,0,607728,2729,31
2020-04-06,Luxembourg,LU,75,5,607728,2804,36
2020-04-07,Luxembourg,LU,39,5,607728,2843,41
2020-04-08,Luxembourg,LU,127,3,607728,2970,44
2020-04-09,Luxembourg,LU,64,2,607728,3034,46
2020-04-10,Luxembourg,LU,81,6,607728,3115,52
2020-04-11,Luxembourg,LU,108,2,607728,3223,54
2020-04-12,Luxembourg,LU,47,8,607728,3270,62
2020-04-13,Luxembourg,LU,11,4,607728,3281,66
2020-04-14,Luxembourg,LU,11,1,607728,3292,67
2020-04-15,Luxembourg,LU,15,0,607728,3307,67
2020-04-16,Luxembourg,LU,66,2,607728,3373,69
2020-04-17,Luxembourg,LU,71,0,607728,3444,69
2020-04-18,Luxembourg,LU,36,3,607728,3480,72
2020-04-19,Luxembourg,LU,57,0,607728,3537,72
2020-04-20,Luxembourg,LU,13,1,607728,3550,73
2020-04-21,Luxembourg,LU,8,2,607728,3558,75
2020-04-22,Luxembourg,LU,60,3,607728,3618,78
2020-04-23,Luxembourg,LU,36,2,607728,3654,80
2020-04-24,Luxembourg,LU,11,3,607728,3665,83
2020-04-25,Luxembourg,LU,30,2,607728,3695,85
2020-04-26,Luxembourg,LU,16,0,607728,3711,85
2020-04-27,Luxembourg,LU,12,3,607728,3723,88
2020-04-28,Luxembourg,LU,6,0,607728,3729,88
2020-04-29,Luxembourg,LU,12,1,607728,3741,89
2020-04-30,Luxembourg,LU,28,0,607728,3769,89
2020-05-01,Luxembourg,LU,15,1,607728,3784,90
2020-05-02,Luxembourg,LU,18,2,607728,3802,92
2020-05-03,Luxembourg,LU,10,0,607728,3812,92
2020-03-03,Latvia,LV,1,0,1926542,1,0
2020-03-08,Latvia,LV,1,0,1926542,2,0
2020-03-09,Latvia,LV,1,0,1926542,3,0
2020-03-10,Latvia,LV,3,0,1926542,6,0
2020-03-11,Latvia,LV,2,0,1926542,8,0
2020-03-12,Latvia,LV,2,0,1926542,10,0
2020-03-13,Latvia,LV,6,0,1926542,16,0
2020-03-14,Latvia,LV,3,0,1926542,19,0
2020-03-15,Latvia,LV,7,0,1926542,26,0
2020-03-16,Latvia,LV,5,0,1926542,31,0
2020-03-17,Latvia,LV,5,0,1926542,36,0
2020-03-18,Latvia,LV,25,0,1926542,61,0
2020-03-19,Latvia,LV,10,0,1926542,71,0
2020-03-20,Latvia,LV,15,0,1926542,86,0
2020-03-21,Latvia,LV,25,0,1926542,111,0
2020-03-22,Latvia,LV,13,0,1926542,124,0
2020-03-23,Latvia,LV,15,0,1926542,139,0
2020-03-24,Latvia,LV,41,0,1926542,180,0
2020-03-25,Latvia,LV,17,0,1926542,197,0
2020-03-26,Latvia,LV,24,0,1926542,221,0
2020-03-27,Latvia,LV,23,0,1926542,244,0
2020-03-28,Latvia,LV,36,0,1926542,280,0
2020-03-29,Latvia,LV,25,0,1926542,305,0
2020-03-30,Latvia,LV,71,0,1926542,376,0
2020-03-31,Latvia,LV,0,0,1926542,376,0
2020-04-01,Latvia,LV,22,0,1926542,398,0
2020-04-02,Latvia,LV,48,0,1926542,446,0
2020-04-03,Latvia,LV,12,0,1926542,458,0
2020-04-04,Latvia,LV,35,1,1926542,493,1
2020-04-05,Latvia,LV,16,0,1926542,509,1
2020-04-06,Latvia,LV,24,0,1926542,533,1
2020-04-07,Latvia,LV,9,0,1926542,542,1
2020-04-08,Latvia,LV,6,1,1926542,548,2
2020-04-09,Latvia,LV,29,0,1926542,577,2
2020-04-10,Latvia,LV,12,0,1926542,589,2
2020-04-11,Latvia,LV,23,0,1926542,612,2
2020-04-12,Latvia,LV,18,1,1926542,630,3
2020-04-13,Latvia,LV,21,2,1926542,651,5
2020-04-14,Latvia,LV,4,0,1926542,655,5
2020-04-15,Latvia,LV,2,0,1926542,657,5
2020-04-16,Latvia,LV,9,0,1926542,666,5
2020-04-17,Latvia,LV,9,0,1926542,675,5
2020-04-18,Latvia,LV,7,0,1926542,682,5
2020-04-19,Latvia,LV,30,0,1926542,712,5
2020-04-20,Latvia,LV,15,0,1926542,727,5
2020-04-21,Latvia,LV,12,0,1926542,739,5
2020-04-22,Latvia,LV,9,4,1926542,748,9
2020-04-23,Latvia,LV,13,2,1926542,761,11
2020-04-24,Latvia,LV,17,0,1926542,778,11
2020-04-25,Latvia,LV,6,1,1926542,784,12
2020-04-26,Latvia,LV,20,0,1926542,804,12
2020-04-27,Latvia,LV,8,0,1926542,812,12
2020-04-28,Latvia,LV,6,1,1926542,818,13
2020-04-29,Latvia,LV,18,0,1926542,836,13
2020-04-30,Latvia,LV,13,2,1926542,849,15
2020-05-01,Latvia,LV,9,0,1926542,858,15
2020-05-02,Latvia,LV,12,1,1926542,870,16
2020-05-03,Latvia,LV,1,0,1926542,871,16
2020-03-25,Libya,LY,1,0,6678567,1,0
2020-03-26,Libya,LY,0,0,6678567,1,0
2020-03-27,Libya,LY,0,0,6678567,1,0
2020-03-28,Libya,LY,0,0,6678567,1,0
2020-03-29,Libya,LY,0,0,6678567,1,0
2020-03-30,Libya,LY,7,0,6678567,8,0
2020-03-31,Libya,LY,0,0,6678567,8,0
2020-04-01,Libya,LY,2,0,6678567,10,0
2020-04-02,Libya,LY,0,0,6678567,10,0
2020-04-03,Libya,LY,1,1,6678567,11,1
2020-04-04,Libya,LY,0,0,6678567,11,1
2020-04-05,Libya,LY,7,0,6678567,18,1
2020-04-06,Libya,LY,0,0,6678567,18,1
2020-04-07,Libya,LY,0,0,6678567,18,1
2020-04-08,Libya,LY,1,0,6678567,19,1
2020-04-09,Libya,LY,2,0,6678567,21,1
2020-04-10,Libya,LY,3,0,6678567,24,1
2020-04-11,Libya,LY,0,0,6678567,24,1
2020-04-12,Libya,LY,1,0,6678567,25,1
2020-04-13,Libya,LY,0,0,6678567,25,1
2020-04-14,Libya,LY,1,0,6678567,26,1
2020-04-15,Libya,LY,9,0,6678567,35,1
2020-04-16,Libya,LY,13,0,6678567,48,1
2020-04-17,Libya,LY,1,0,6678567,49,1
2020-04-18,Libya,LY,0,0,6678567,49,1
2020-04-19,Libya,LY,0,0,6678567,49,1
2020-04-20,Libya,LY,0,0,6678567,49,1
2020-04-21,Libya,LY,2,0,6678567,51,1
2020-04-22,Libya,LY,0,0,6678567,51,1
2020-04-23,Libya,LY,8,0,6678567,59,1
2020-04-24,Libya,LY,1,1,6678567,60,2
2020-04-25,Libya,LY,1,0,6678567,61,2
2020-04-26,Libya,LY,0,0,6678567,61,2
2020-04-27,Libya,LY,0,0,6678567,61,2
2020-04-28,Libya,LY,0,0,6678567,61,2
2020-04-29,Libya,LY,0,0,6678567,61,2
2020-04-30,Libya,LY,0,0,6678567,61,2
2020-05-01,Libya,LY,0,1,6678567,61,3
2020-05-02,Libya,LY,2,0,6678567,63,3
2020-05-03,Libya,LY,0,0,6678567,63,3
2020-03-03,Morocco,MA,1,0,36029138,1,0
2020-03-06,Morocco,MA,1,0,36029138,2,0
2020-03-12,Morocco,MA,3,1,36029138,5,1
2020-03-13,Morocco,MA,1,0,36029138,6,1
2020-03-14,Morocco,MA,1,0,36029138,7,1
2020-03-15,Morocco,MA,11,0,36029138,18,1
2020-03-16,Morocco,MA,10,0,36029138,28,1
2020-03-17,Morocco,MA,9,0,36029138,37,1
2020-03-18,Morocco,MA,7,1,36029138,44,2
2020-03-19,Morocco,MA,10,0,36029138,54,2
2020-03-20,Morocco,MA,9,0,36029138,63,2
2020-03-21,Morocco,MA,23,1,36029138,86,3
2020-03-22,Morocco,MA,10,0,36029138,96,3
2020-03-23,Morocco,MA,19,1,36029138,115,4
2020-03-24,Morocco,MA,19,0,36029138,134,4
2020-03-25,Morocco,MA,36,1,36029138,170,5
2020-03-26,Morocco,MA,55,1,36029138,225,6
2020-03-27,Morocco,MA,50,4,36029138,275,10
2020-03-28,Morocco,MA,70,13,36029138,345,23
2020-03-29,Morocco,MA,13,0,36029138,358,23
2020-03-30,Morocco,MA,121,3,36029138,479,26
2020-03-31,Morocco,MA,77,7,36029138,556,33
2020-04-01,Morocco,MA,61,3,36029138,617,36
2020-04-02,Morocco,MA,37,3,36029138,654,39
2020-04-03,Morocco,MA,54,5,36029138,708,44
2020-04-04,Morocco,MA,0,0,36029138,708,44
2020-04-05,Morocco,MA,211,15,36029138,919,59
2020-04-06,Morocco,MA,102,11,36029138,1021,70
2020-04-07,Morocco,MA,99,10,36029138,1120,80
2020-04-08,Morocco,MA,64,10,36029138,1184,90
2020-04-09,Morocco,MA,91,3,36029138,1275,93
2020-04-10,Morocco,MA,99,4,36029138,1374,97
2020-04-11,Morocco,MA,74,10,36029138,1448,107
2020-04-12,Morocco,MA,97,4,36029138,1545,111
2020-04-13,Morocco,MA,116,7,36029138,1661,118
2020-04-14,Morocco,MA,102,8,36029138,1763,126
2020-04-15,Morocco,MA,125,0,36029138,1888,126
2020-04-16,Morocco,MA,136,1,36029138,2024,127
2020-04-17,Morocco,MA,259,3,36029138,2283,130
2020-04-18,Morocco,MA,281,5,36029138,2564,135
2020-04-19,Morocco,MA,121,2,36029138,2685,137
2020-04-20,Morocco,MA,170,4,36029138,2855,141
2020-04-21,Morocco,MA,191,2,36029138,3046,143
2020-04-22,Morocco,MA,163,2,36029138,3209,145
2020-04-23,Morocco,MA,168,4,36029138,3377,149
2020-04-24,Morocco,MA,191,6,36029138,3568,155
2020-04-25,Morocco,MA,190,3,36029138,3758,158
2020-04-26,Morocco,MA,139,1,36029138,3897,159
2020-04-27,Morocco,MA,168,2,36029138,4065,161
2020-04-28,Morocco,MA,55,1,36029138,4120,162
2020-04-29,Morocco,MA,132,3,36029138,4252,165
2020-04-30,Morocco,MA,69,3,36029138,4321,168
2020-05-01,Morocco,MA,102,2,36029138,4423,170
2020-05-02,Morocco,MA,146,1,36029138,4569,171
2020-05-03,Morocco,MA,160,2,36029138,4729,173
2019-12-31,Monaco,MC,0,0,38682,0,0
2020-01-01,Monaco,MC,0,0,38682,0,0
2020-01-02,Monaco,MC,0,0,38682,0,0
2020-01-03,Monaco,MC,0,0,38682,0,0
2020-01-04,Monaco,MC,0,0,38682,0,0
2020-01-05,Monaco,MC,0,0,38682,0,0
2020-01-06,Monaco,MC,0,0,38682,0,0
2020-01-07,Monaco,MC,0,0,38682,0,0
2020-01-08,Monaco,MC,0,0,38682,0,0
2020-01-09,Monaco,MC,0,0,38682,0,0
2020-01-10,Monaco,MC,0,0,38682,0,0
2020-01-11,Monaco,MC,0,0,38682,0,0
2020-01-12,Monaco,MC,0,0,38682,0,0
2020-01-13,Monaco,MC,0,0,38682,0,0
2020-01-14,Monaco,MC,0,0,38682,0,0
2020-01-15,Monaco,MC,0,0,38682,0,0
2020-01-16,Monaco,MC,0,0,38682,0,0
2020-01-17,Monaco,MC,0,0,38682,0,0
2020-01-18,Monaco,MC,0,0,38682,0,0
2020-01-19,Monaco,MC,0,0,38682,0,0
2020-01-20,Monaco,MC,0,0,38682,0,0
2020-01-21,Monaco,MC,0,0,38682,0,0
2020-01-22,Monaco,MC,0,0,38682,0,0
2020-01-23,Monaco,MC,0,0,38682,0,0
2020-01-24,Monaco,MC,0,0,38682,0,0
2020-01-25,Monaco,MC,0,0,38682,0,0
2020-01-26,Monaco,MC,0,0,38682,0,0
2020-01-27,Monaco,MC,0,0,38682,0,0
2020-01-28,Monaco,MC,0,0,38682,0,0
2020-01-29,Monaco,MC,0,0,38682,0,0
2020-01-30,Monaco,MC,0,0,38682,0,0
2020-01-31,Monaco,MC,0,0,38682,0,0
2020-02-01,Monaco,MC,0,0,38682,0,0
2020-02-02,Monaco,MC,0,0,38682,0,0
2020-02-03,Monaco,MC,0,0,38682,0,0
2020-02-04,Monaco,MC,0,0,38682,0,0
2020-02-05,Monaco,MC,0,0,38682,0,0
2020-02-06,Monaco,MC,0,0,38682,0,0
2020-02-07,Monaco,MC,0,0,38682,0,0
2020-02-08,Monaco,MC,0,0,38682,0,0
2020-02-09,Monaco,MC,0,0,38682,0,0
2020-02-10,Monaco,MC,0,0,38682,0,0
2020-02-11,Monaco,MC,0,0,38682,0,0
2020-02-12,Monaco,MC,0,0,38682,0,0
2020-02-13,Monaco,MC,0,0,38682,0,0
2020-02-14,Monaco,MC,0,0,38682,0,0
2020-02-15,Monaco,MC,0,0,38682,0,0
2020-02-16,Monaco,MC,0,0,38682,0,0
2020-02-17,Monaco,MC,0,0,38682,0,0
2020-02-18,Monaco,MC,0,0,38682,0,0
2020-02-19,Monaco,MC,0,0,38682,0,0
2020-02-20,Monaco,MC,0,0,38682,0,0
2020-02-21,Monaco,MC,0,0,38682,0,0
2020-02-22,Monaco,MC,0,0,38682,0,0
2020-02-23,Monaco,MC,0,0,38682,0,0
2020-02-24,Monaco,MC,0,0,38682,0,0
2020-02-25,Monaco,MC,0,0,38682,0,0
2020-02-26,Monaco,MC,0,0,38682,0,0
2020-02-27,Monaco,MC,0,0,38682,0,0
2020-02-28,Monaco,MC,0,0,38682,0,0
2020-02-29,Monaco,MC,1,0,38682,1,0
2020-03-01,Monaco,MC,0,0,38682,1,0
2020-03-02,Monaco,MC,0,0,38682,1,0
2020-03-15,Monaco,MC,2,0,38682,3,0
2020-03-16,Monaco,MC,4,0,38682,7,0
2020-03-17,Monaco,MC,2,0,38682,9,0
2020-03-18,Monaco,MC,0,0,38682,9,0
2020-03-19,Monaco,MC,0,0,38682,9,0
2020-03-20,Monaco,MC,2,0,38682,11,0
2020-03-21,Monaco,MC,1,0,38682,12,0
2020-03-22,Monaco,MC,6,0,38682,18,0
2020-03-23,Monaco,MC,5,0,38682,23,0
2020-03-24,Monaco,MC,0,0,38682,23,0
2020-03-25,Monaco,MC,4,0,38682,27,0
2020-03-26,Monaco,MC,4,0,38682,31,0
2020-03-27,Monaco,MC,2,0,38682,33,0
2020-03-28,Monaco,MC,9,0,38682,42,0
2020-03-29,Monaco,MC,1,0,38682,43,0
2020-03-30,Monaco,MC,3,0,38682,46,0
2020-03-31,Monaco,MC,3,0,38682,49,0
2020-04-01,Monaco,MC,3,0,38682,52,0
2020-04-02,Monaco,MC,3,0,38682,55,0
2020-04-03,Monaco,MC,5,0,38682,60,0
2020-04-04,Monaco,MC,4,0,38682,64,0
2020-04-05,Monaco,MC,2,2,38682,66,2
2020-04-06,Monaco,MC,7,0,38682,73,2
2020-04-07,Monaco,MC,4,0,38682,77,2
2020-04-08,Monaco,MC,2,0,38682,79,2
2020-04-09,Monaco,MC,2,0,38682,81,2
2020-04-10,Monaco,MC,3,0,38682,84,2
2020-04-11,Monaco,MC,6,0,38682,90,2
2020-04-12,Monaco,MC,2,0,38682,92,2
2020-04-13,Monaco,MC,1,0,38682,93,2
2020-04-14,Monaco,MC,0,0,38682,93,2
2020-04-15,Monaco,MC,0,0,38682,93,2
2020-04-16,Monaco,MC,0,1,38682,93,3
2020-04-17,Monaco,MC,0,0,38682,93,3
2020-04-18,Monaco,MC,1,0,38682,94,3
2020-04-19,Monaco,MC,0,0,38682,94,3
2020-04-20,Monaco,MC,0,0,38682,94,3
2020-04-21,Monaco,MC,0,0,38682,94,3
2020-04-22,Monaco,MC,0,0,38682,94,3
2020-04-23,Monaco,MC,0,0,38682,94,3
2020-04-24,Monaco,MC,0,1,38682,94,4
2020-04-25,Monaco,MC,0,0,38682,94,4
2020-04-26,Monaco,MC,0,0,38682,94,4
2020-04-27,Monaco,MC,0,0,38682,94,4
2020-04-28,Monaco,MC,1,0,38682,95,4
2020-04-29,Monaco,MC,0,0,38682,95,4
2020-04-30,Monaco,MC,0,0,38682,95,4
2020-05-01,Monaco,MC,0,0,38682,95,4
2020-05-02,Monaco,MC,0,0,38682,95,4
2020-05-03,Monaco,MC,0,0,38682,95,4
2020-03-08,Moldova,MD,1,0,3545883,1,0
2020-03-11,Moldova,MD,2,0,3545883,3,0
2020-03-12,Moldova,MD,1,0,3545883,4,0
2020-03-13,Moldova,MD,2,0,3545883,6,0
2020-03-14,Moldova,MD,2,0,3545883,8,0
2020-03-15,Moldova,MD,12,0,3545883,20,0
2020-03-16,Moldova,MD,3,0,3545883,23,0
2020-03-17,Moldova,MD,6,0,3545883,29,0
2020-03-18,Moldova,MD,1,0,3545883,30,0
2020-03-19,Moldova,MD,6,1,3545883,36,1
2020-03-20,Moldova,MD,13,0,3545883,49,1
2020-03-21,Moldova,MD,17,0,3545883,66,1
2020-03-22,Moldova,MD,14,0,3545883,80,1
2020-03-23,Moldova,MD,14,0,3545883,94,1
2020-03-24,Moldova,MD,15,0,3545883,109,1
2020-03-25,Moldova,MD,16,0,3545883,125,1
2020-03-26,Moldova,MD,24,0,3545883,149,1
2020-03-27,Moldova,MD,28,0,3545883,177,1
2020-03-28,Moldova,MD,22,1,3545883,199,2
2020-03-29,Moldova,MD,32,0,3545883,231,2
2020-03-30,Moldova,MD,32,0,3545883,263,2
2020-03-31,Moldova,MD,35,0,3545883,298,2
2020-04-01,Moldova,MD,55,2,3545883,353,4
2020-04-02,Moldova,MD,70,1,3545883,423,5
2020-04-03,Moldova,MD,82,1,3545883,505,6
2020-04-04,Moldova,MD,86,2,3545883,591,8
2020-04-05,Moldova,MD,161,4,3545883,752,12
2020-04-06,Moldova,MD,112,3,3545883,864,15
2020-04-07,Moldova,MD,101,4,3545883,965,19
2020-04-08,Moldova,MD,91,3,3545883,1056,22
2020-04-09,Moldova,MD,118,5,3545883,1174,27
2020-04-10,Moldova,MD,115,2,3545883,1289,29
2020-04-11,Moldova,MD,149,0,3545883,1438,29
2020-04-12,Moldova,MD,122,1,3545883,1560,30
2020-04-13,Moldova,MD,102,2,3545883,1662,32
2020-04-14,Moldova,MD,50,4,3545883,1712,36
2020-04-15,Moldova,MD,222,4,3545883,1934,40
2020-04-16,Moldova,MD,115,6,3545883,2049,46
2020-04-17,Moldova,MD,105,8,3545883,2154,54
2020-04-18,Moldova,MD,110,2,3545883,2264,56
2020-04-19,Moldova,MD,87,4,3545883,2351,60
2020-04-20,Moldova,MD,121,7,3545883,2472,67
2020-04-21,Moldova,MD,76,3,3545883,2548,70
2020-04-22,Moldova,MD,66,3,3545883,2614,73
2020-04-23,Moldova,MD,164,3,3545883,2778,76
2020-04-24,Moldova,MD,148,4,3545883,2926,80
2020-04-25,Moldova,MD,184,7,3545883,3110,87
2020-04-26,Moldova,MD,194,7,3545883,3304,94
2020-04-27,Moldova,MD,104,2,3545883,3408,96
2020-04-28,Moldova,MD,73,6,3545883,3481,102
2020-04-29,Moldova,MD,157,5,3545883,3638,107
2020-04-30,Moldova,MD,133,4,3545883,3771,111
2020-05-01,Moldova,MD,126,8,3545883,3897,119
2020-05-02,Moldova,MD,83,3,3545883,3980,122
2020-05-03,Moldova,MD,72,2,3545883,4052,124
2020-03-18,Montenegro,ME,2,0,622345,2,0
2020-03-19,Montenegro,ME,6,0,622345,8,0
2020-03-20,Montenegro,ME,5,0,622345,13,0
2020-03-21,Montenegro,ME,1,0,622345,14,0
2020-03-22,Montenegro,ME,0,0,622345,14,0
2020-03-23,Montenegro,ME,7,0,622345,21,0
2020-03-24,Montenegro,ME,6,0,622345,27,0
2020-03-25,Montenegro,ME,20,0,622345,47,0
2020-03-26,Montenegro,ME,6,0,622345,53,0
2020-03-27,Montenegro,ME,14,1,622345,67,1
2020-03-28,Montenegro,ME,8,0,622345,75,1
2020-03-29,Montenegro,ME,9,0,622345,84,1
2020-03-30,Montenegro,ME,1,0,622345,85,1
2020-03-31,Montenegro,ME,6,0,622345,91,1
2020-04-01,Montenegro,ME,18,0,622345,109,1
2020-04-02,Montenegro,ME,14,0,622345,123,1
2020-04-03,Montenegro,ME,21,1,622345,144,2
2020-04-04,Montenegro,ME,30,0,622345,174,2
2020-04-05,Montenegro,ME,27,0,622345,201,2
2020-04-06,Montenegro,ME,13,0,622345,214,2
2020-04-07,Montenegro,ME,19,0,622345,233,2
2020-04-08,Montenegro,ME,8,0,622345,241,2
2020-04-09,Montenegro,ME,8,0,622345,249,2
2020-04-10,Montenegro,ME,3,0,622345,252,2
2020-04-11,Montenegro,ME,5,0,622345,257,2
2020-04-12,Montenegro,ME,6,0,622345,263,2
2020-04-13,Montenegro,ME,9,1,622345,272,3
2020-04-14,Montenegro,ME,2,0,622345,274,3
2020-04-15,Montenegro,ME,9,1,622345,283,4
2020-04-16,Montenegro,ME,5,0,622345,288,4
2020-04-17,Montenegro,ME,15,0,622345,303,4
2020-04-18,Montenegro,ME,0,0,622345,303,4
2020-04-19,Montenegro,ME,4,1,622345,307,5
2020-04-20,Montenegro,ME,1,0,622345,308,5
2020-04-21,Montenegro,ME,4,0,622345,312,5
2020-04-22,Montenegro,ME,1,0,622345,313,5
2020-04-23,Montenegro,ME,2,0,622345,315,5
2020-04-24,Montenegro,ME,4,0,622345,319,5
2020-04-25,Montenegro,ME,0,1,622345,319,6
2020-04-26,Montenegro,ME,1,0,622345,320,6
2020-04-27,Montenegro,ME,1,1,622345,321,7
2020-04-28,Montenegro,ME,0,0,622345,321,7
2020-04-29,Montenegro,ME,0,0,622345,321,7
2020-04-30,Montenegro,ME,1,0,622345,322,7
2020-05-01,Montenegro,ME,0,0,622345,322,7
2020-05-02,Montenegro,ME,0,0,622345,322,7
2020-05-03,Montenegro,ME,0,0,622345,322,7
2020-03-21,Madagascar,MG,3,0,26262368,3,0
2020-03-22,Madagascar,MG,0,0,26262368,3,0
2020-03-23,Madagascar,MG,0,0,26262368,3,0
2020-03-24,Madagascar,MG,14,0,26262368,17,0
2020-03-25,Madagascar,MG,2,0,26262368,19,0
2020-03-26,Madagascar,MG,0,0,26262368,19,0
2020-03-27,Madagascar,MG,4,0,26262368,23,0
2020-03-28,Madagascar,MG,1,0,26262368,24,0
2020-03-29,Madagascar,MG,4,0,26262368,28,0
2020-03-30,Madagascar,MG,9,0,26262368,37,0
2020-03-31,Madagascar,MG,7,0,26262368,44,0
2020-04-01,Madagascar,MG,2,0,26262368,46,0
2020-04-02,Madagascar,MG,8,0,26262368,54,0
2020-04-03,Madagascar,MG,5,0,26262368,59,0
2020-04-04,Madagascar,MG,6,0,26262368,65,0
2020-04-05,Madagascar,MG,6,0,26262368,71,0
2020-04-06,Madagascar,MG,1,0,26262368,72,0
2020-04-07,Madagascar,MG,5,0,26262368,77,0
2020-04-08,Madagascar,MG,8,0,26262368,85,0
2020-04-09,Madagascar,MG,8,0,26262368,93,0
2020-04-10,Madagascar,MG,0,0,26262368,93,0
2020-04-11,Madagascar,MG,9,0,26262368,102,0
2020-04-12,Madagascar,MG,0,0,26262368,102,0
2020-04-13,Madagascar,MG,4,0,26262368,106,0
2020-04-14,Madagascar,MG,0,0,26262368,106,0
2020-04-15,Madagascar,MG,2,0,26262368,108,0
2020-04-16,Madagascar,MG,2,0,26262368,110,0
2020-04-17,Madagascar,MG,1,0,26262368,111,0
2020-04-18,Madagascar,MG,6,0,26262368,117,0
2020-04-19,Madagascar,MG,0,0,26262368,117,0
2020-04-20,Madagascar,MG,4,0,26262368,121,0
2020-04-21,Madagascar,MG,0,0,26262368,121,0
2020-04-22,Madagascar,MG,0,0,26262368,121,0
2020-04-23,Madagascar,MG,0,0,26262368,121,0
2020-04-24,Madagascar,MG,0,0,26262368,121,0
2020-04-25,Madagascar,MG,1,0,26262368,122,0
2020-04-26,Madagascar,MG,2,0,26262368,124,0
2020-04-27,Madagascar,MG,0,0,26262368,124,0
2020-04-28,Madagascar,MG,4,0,26262368,128,0
2020-04-29,Madagascar,MG,0,0,26262368,128,0
2020-04-30,Madagascar,MG,0,0,26262368,128,0
2020-05-01,Madagascar,MG,4,0,26262368,132,0
2020-05-02,Madagascar,MG,3,0,26262368,135,0
2020-05-03,Madagascar,MG,0,0,26262368,135,0
2019-12-31,North_Macedonia,MK,0,0,2082958,0,0
2020-01-01,North_Macedonia,MK,0,0,2082958,0,0
2020-01-02,North_Macedonia,MK,0,0,2082958,0,0
2020-01-03,North_Macedonia,MK,0,0,2082958,0,0
2020-01-04,North_Macedonia,MK,0,0,2082958,0,0
2020-01-05,North_Macedonia,MK,0,0,2082958,0,0
2020-01-06,North_Macedonia,MK,0,0,2082958,0,0
2020-01-07,North_Macedonia,MK,0,0,2082958,0,0
2020-01-08,North_Macedonia,MK,0,0,2082958,0,0
2020-01-09,North_Macedonia,MK,0,0,2082958,0,0
2020-01-10,North_Macedonia,MK,0,0,2082958,0,0
2020-01-11,North_Macedonia,MK,0,0,2082958,0,0
2020-01-12,North_Macedonia,MK,0,0,2082958,0,0
2020-01-13,North_Macedonia,MK,0,0,2082958,0,0
2020-01-14,North_Macedonia,MK,0,0,2082958,0,0
2020-01-15,North_Macedonia,MK,0,0,2082958,0,0
2020-01-16,North_Macedonia,MK,0,0,2082958,0,0
2020-01-17,North_Macedonia,MK,0,0,2082958,0,0
2020-01-18,North_Macedonia,MK,0,0,2082958,0,0
2020-01-19,North_Macedonia,MK,0,0,2082958,0,0
2020-01-20,North_Macedonia,MK,0,0,2082958,0,0
2020-01-21,North_Macedonia,MK,0,0,2082958,0,0
2020-01-22,North_Macedonia,MK,0,0,2082958,0,0
2020-01-23,North_Macedonia,MK,0,0,2082958,0,0
2020-01-24,North_Macedonia,MK,0,0,2082958,0,0
2020-01-25,North_Macedonia,MK,0,0,2082958,0,0
2020-01-26,North_Macedonia,MK,0,0,2082958,0,0
2020-01-27,North_Macedonia,MK,0,0,2082958,0,0
2020-01-28,North_Macedonia,MK,0,0,2082958,0,0
2020-01-29,North_Macedonia,MK,0,0,2082958,0,0
2020-01-30,North_Macedonia,MK,0,0,2082958,0,0
2020-01-31,North_Macedonia,MK,0,0,2082958,0,0
2020-02-01,North_Macedonia,MK,0,0,2082958,0,0
2020-02-02,North_Macedonia,MK,0,0,2082958,0,0
2020-02-03,North_Macedonia,MK,0,0,2082958,0,0
2020-02-04,North_Macedonia,MK,0,0,2082958,0,0
2020-02-05,North_Macedonia,MK,0,0,2082958,0,0
2020-02-06,North_Macedonia,MK,0,0,2082958,0,0
2020-02-07,North_Macedonia,MK,0,0,2082958,0,0
2020-02-08,North_Macedonia,MK,0,0,2082958,0,0
2020-02-09,North_Macedonia,MK,0,0,2082958,0,0
2020-02-10,North_Macedonia,MK,0,0,2082958,0,0
2020-02-11,North_Macedonia,MK,0,0,2082958,0,0
2020-02-12,North_Macedonia,MK,0,0,2082958,0,0
2020-02-13,North_Macedonia,MK,0,0,2082958,0,0
2020-02-14,North_Macedonia,MK,0,0,2082958,0,0
2020-02-15,North_Macedonia,MK,0,0,2082958,0,0
2020-02-16,North_Macedonia,MK,0,0,2082958,0,0
2020-02-17,North_Macedonia,MK,0,0,2082958,0,0
2020-02-18,North_Macedonia,MK,0,0,2082958,0,0
2020-02-19,North_Macedonia,MK,0,0,2082958,0,0
2020-02-20,North_Macedonia,MK,0,0,2082958,0,0
2020-02-21,North_Macedonia,MK,0,0,2082958,0,0
2020-02-22,North_Macedonia,MK,0,0,2082958,0,0
2020-02-23,North_Macedonia,MK,0,0,2082958,0,0
2020-02-24,North_Macedonia,MK,0,0,2082958,0,0
2020-02-25,North_Macedonia,MK,0,0,2082958,0,0
2020-02-26,North_Macedonia,MK,0,0,2082958,0,0
2020-02-27,North_Macedonia,MK,1,0,2082958,1,0
2020-02-28,North_Macedonia,MK,0,0,2082958,1,0
2020-02-29,North_Macedonia,MK,0,0,2082958,1,0
2020-03-01,North_Macedonia,MK,0,0,2082958,1,0
2020-03-02,North_Macedonia,MK,0,0,2082958,1,0
2020-03-07,North_Macedonia,MK,2,0,2082958,3,0
2020-03-11,North_Macedonia,MK,4,0,2082958,7,0
2020-03-13,North_Macedonia,MK,2,0,2082958,9,0
2020-03-14,North_Macedonia,MK,4,0,2082958,13,0
2020-03-16,North_Macedonia,MK,0,0,2082958,13,0
2020-03-17,North_Macedonia,MK,6,0,2082958,19,0
2020-03-18,North_Macedonia,MK,12,0,2082958,31,0
2020-03-19,North_Macedonia,MK,11,0,2082958,42,0
2020-03-20,North_Macedonia,MK,6,0,2082958,48,0
2020-03-21,North_Macedonia,MK,22,0,2082958,70,0
2020-03-22,North_Macedonia,MK,15,0,2082958,85,0
2020-03-23,North_Macedonia,MK,29,1,2082958,114,1
2020-03-24,North_Macedonia,MK,22,1,2082958,136,2
2020-03-25,North_Macedonia,MK,12,0,2082958,148,2
2020-03-26,North_Macedonia,MK,29,0,2082958,177,2
2020-03-27,North_Macedonia,MK,24,1,2082958,201,3
2020-03-28,North_Macedonia,MK,18,0,2082958,219,3
2020-03-29,North_Macedonia,MK,22,1,2082958,241,4
2020-03-30,North_Macedonia,MK,18,2,2082958,259,6
2020-03-31,North_Macedonia,MK,26,1,2082958,285,7
2020-04-01,North_Macedonia,MK,44,2,2082958,329,9
2020-04-02,North_Macedonia,MK,25,1,2082958,354,10
2020-04-03,North_Macedonia,MK,0,1,2082958,354,11
2020-04-04,North_Macedonia,MK,76,1,2082958,430,12
2020-04-05,North_Macedonia,MK,53,5,2082958,483,17
2020-04-06,North_Macedonia,MK,0,0,2082958,483,17
2020-04-07,North_Macedonia,MK,87,4,2082958,570,21
2020-04-08,North_Macedonia,MK,29,5,2082958,599,26
2020-04-09,North_Macedonia,MK,18,4,2082958,617,30
2020-04-10,North_Macedonia,MK,46,2,2082958,663,32
2020-04-11,North_Macedonia,MK,48,0,2082958,711,32
2020-04-12,North_Macedonia,MK,49,2,2082958,760,34
2020-04-13,North_Macedonia,MK,68,0,2082958,828,34
2020-04-14,North_Macedonia,MK,26,4,2082958,854,38
2020-04-15,North_Macedonia,MK,54,6,2082958,908,44
2020-04-16,North_Macedonia,MK,66,1,2082958,974,45
2020-04-17,North_Macedonia,MK,107,1,2082958,1081,46
2020-04-18,North_Macedonia,MK,36,3,2082958,1117,49
2020-04-19,North_Macedonia,MK,53,0,2082958,1170,49
2020-04-20,North_Macedonia,MK,37,2,2082958,1207,51
2020-04-21,North_Macedonia,MK,18,3,2082958,1225,54
2020-04-22,North_Macedonia,MK,6,1,2082958,1231,55
2020-04-23,North_Macedonia,MK,28,1,2082958,1259,56
2020-04-24,North_Macedonia,MK,41,0,2082958,1300,56
2020-04-25,North_Macedonia,MK,26,1,2082958,1326,57
2020-04-26,North_Macedonia,MK,41,2,2082958,1367,59
2020-04-27,North_Macedonia,MK,19,2,2082958,1386,61
2020-04-28,North_Macedonia,MK,13,4,2082958,1399,65
2020-04-29,North_Macedonia,MK,22,6,2082958,1421,71
2020-04-30,North_Macedonia,MK,21,2,2082958,1442,73
2020-05-01,North_Macedonia,MK,23,4,2082958,1465,77
2020-05-02,North_Macedonia,MK,29,4,2082958,1494,81
2020-05-03,North_Macedonia,MK,12,1,2082958,1506,82
2020-03-26,Mali,ML,2,0,19077690,2,0
2020-03-27,Mali,ML,2,0,19077690,4,0
2020-03-28,Mali,ML,0,0,19077690,4,0
2020-03-29,Mali,ML,5,0,19077690,9,0
2020-03-30,Mali,ML,9,0,19077690,18,0
2020-03-31,Mali,ML,0,0,19077690,18,0
2020-04-01,Mali,ML,0,1,19077690,18,1
2020-04-02,Mali,ML,10,0,19077690,28,1
2020-04-03,Mali,ML,8,2,19077690,36,3
2020-04-04,Mali,ML,3,0,19077690,39,3
2020-04-05,Mali,ML,2,0,19077690,41,3
2020-04-06,Mali,ML,4,2,19077690,45,5
2020-04-07,Mali,ML,2,0,19077690,47,5
2020-04-08,Mali,ML,9,0,19077690,56,5
2020-04-09,Mali,ML,3,2,19077690,59,7
2020-04-10,Mali,ML,0,0,19077690,59,7
2020-04-11,Mali,ML,28,0,19077690,87,7
2020-04-12,Mali,ML,18,2,19077690,105,9
2020-04-13,Mali,ML,11,0,19077690,116,9
2020-04-14,Mali,ML,7,1,19077690,123,10
2020-04-15,Mali,ML,21,3,19077690,144,13
2020-04-16,Mali,ML,4,0,19077690,148,13
2020-04-17,Mali,ML,23,0,19077690,171,13
2020-04-18,Mali,ML,19,0,19077690,190,13
2020-04-19,Mali,ML,26,0,19077690,216,13
2020-04-20,Mali,ML,8,1,19077690,224,14
2020-04-21,Mali,ML,22,0,19077690,246,14
2020-04-22,Mali,ML,12,0,19077690,258,14
2020-04-23,Mali,ML,35,3,19077690,293,17
2020-04-24,Mali,ML,16,4,19077690,309,21
2020-04-25,Mali,ML,16,0,19077690,325,21
2020-04-26,Mali,ML,45,0,19077690,370,21
2020-04-27,Mali,ML,19,2,19077690,389,23
2020-04-28,Mali,ML,19,0,19077690,408,23
2020-04-29,Mali,ML,16,1,19077690,424,24
2020-04-30,Mali,ML,58,1,19077690,482,25
2020-05-01,Mali,ML,8,1,19077690,490,26
2020-05-02,Mali,ML,18,0,19077690,508,26
2020-05-03,Mali,ML,36,0,19077690,544,26
2020-03-17,Myanmar,MM,0,0,53708395,0,0
2020-03-24,Myanmar,MM,2,0,53708395,2,0
2020-03-25,Myanmar,MM,1,0,53708395,3,0
2020-03-26,Myanmar,MM,0,0,53708395,3,0
2020-03-27,Myanmar,MM,2,0,53708395,5,0
2020-03-28,Myanmar,MM,0,0,53708395,5,0
2020-03-29,Myanmar,MM,3,0,53708395,8,0
2020-03-30,Myanmar,MM,0,0,53708395,8,0
2020-03-31,Myanmar,MM,6,0,53708395,14,0
2020-04-01,Myanmar,MM,1,1,53708395,15,1
2020-04-02,Myanmar,MM,1,0,53708395,16,1
2020-04-03,Myanmar,MM,4,0,53708395,20,1
2020-04-04,Myanmar,MM,0,0,53708395,20,1
2020-04-05,Myanmar,MM,1,0,53708395,21,1
2020-04-06,Myanmar,MM,0,0,53708395,21,1
2020-04-07,Myanmar,MM,1,0,53708395,22,1
2020-04-08,Myanmar,MM,0,0,53708395,22,1
2020-04-09,Myanmar,MM,0,2,53708395,22,3
2020-04-10,Myanmar,MM,5,0,53708395,27,3
2020-04-11,Myanmar,MM,1,0,53708395,28,3
2020-04-12,Myanmar,MM,3,0,53708395,31,3
2020-04-13,Myanmar,MM,10,1,53708395,41,4
2020-04-14,Myanmar,MM,21,0,53708395,62,4
2020-04-15,Myanmar,MM,12,0,53708395,74,4
2020-04-16,Myanmar,MM,0,0,53708395,74,4
2020-04-17,Myanmar,MM,11,0,53708395,85,4
2020-04-18,Myanmar,MM,9,1,53708395,94,5
2020-04-19,Myanmar,MM,13,0,53708395,107,5
2020-04-20,Myanmar,MM,4,0,53708395,111,5
2020-04-21,Myanmar,MM,8,0,53708395,119,5
2020-04-22,Myanmar,MM,2,0,53708395,121,5
2020-04-23,Myanmar,MM,6,0,53708395,127,5
2020-04-24,Myanmar,MM,5,0,53708395,132,5
2020-04-25,Myanmar,MM,12,0,53708395,144,5
2020-04-26,Myanmar,MM,2,0,53708395,146,5
2020-04-27,Myanmar,MM,0,0,53708395,146,5
2020-04-28,Myanmar,MM,0,0,53708395,146,5
2020-04-29,Myanmar,MM,4,0,53708395,150,5
2020-04-30,Myanmar,MM,0,1,53708395,150,6
2020-05-01,Myanmar,MM,1,0,53708395,151,6
2020-05-02,Myanmar,MM,0,0,53708395,151,6
2020-05-03,Myanmar,MM,0,0,53708395,151,6
2020-03-10,Mongolia,MN,1,0,3170208,1,0
2020-03-15,Mongolia,MN,0,0,3170208,1,0
2020-03-18,Mongolia,MN,3,0,3170208,4,0
2020-03-19,Mongolia,MN,1,0,3170208,5,0
2020-03-20,Mongolia,MN,0,0,3170208,5,0
2020-03-21,Mongolia,MN,1,0,3170208,6,0
2020-03-22,Mongolia,MN,4,0,3170208,10,0
2020-03-23,Mongolia,MN,0,0,3170208,10,0
2020-03-24,Mongolia,MN,0,0,3170208,10,0
2020-03-25,Mongolia,MN,0,0,3170208,10,0
2020-03-26,Mongolia,MN,0,0,3170208,10,0
2020-03-27,Mongolia,MN,1,0,3170208,11,0
2020-03-28,Mongolia,MN,0,0,3170208,11,0
2020-03-29,Mongolia,MN,1,0,3170208,12,0
2020-03-30,Mongolia,MN,0,0,3170208,12,0
2020-03-31,Mongolia,MN,0,0,3170208,12,0
2020-04-01,Mongolia,MN,0,0,3170208,12,0
2020-04-02,Mongolia,MN,2,0,3170208,14,0
2020-04-03,Mongolia,MN,0,0,3170208,14,0
2020-04-04,Mongolia,MN,0,0,3170208,14,0
2020-04-05,Mongolia,MN,0,0,3170208,14,0
2020-04-06,Mongolia,MN,0,0,3170208,14,0
2020-04-07,Mongolia,MN,1,0,3170208,15,0
2020-04-08,Mongolia,MN,0,0,3170208,15,0
2020-04-09,Mongolia,MN,1,0,3170208,16,0
2020-04-10,Mongolia,MN,0,0,3170208,16,0
2020-04-11,Mongolia,MN,0,0,3170208,16,0
2020-04-12,Mongolia,MN,0,0,3170208,16,0
2020-04-13,Mongolia,MN,0,0,3170208,16,0
2020-04-14,Mongolia,MN,0,0,3170208,16,0
2020-04-15,Mongolia,MN,14,0,3170208,30,0
2020-04-16,Mongolia,MN,0,0,3170208,30,0
2020-04-17,Mongolia,MN,1,0,3170208,31,0
2020-04-18,Mongolia,MN,0,0,3170208,31,0
2020-04-19,Mongolia,MN,0,0,3170208,31,0
2020-04-20,Mongolia,MN,1,0,3170208,32,0
2020-04-21,Mongolia,MN,2,0,3170208,34,0
2020-04-22,Mongolia,MN,1,0,3170208,35,0
2020-04-23,Mongolia,MN,0,0,3170208,35,0
2020-04-24,Mongolia,MN,1,0,3170208,36,0
2020-04-25,Mongolia,MN,0,0,3170208,36,0
2020-04-26,Mongolia,MN,2,0,3170208,38,0
2020-04-27,Mongolia,MN,0,0,3170208,38,0
2020-04-28,Mongolia,MN,0,0,3170208,38,0
2020-04-29,Mongolia,MN,0,0,3170208,38,0
2020-04-30,Mongolia,MN,0,0,3170208,38,0
2020-05-01,Mongolia,MN,0,0,3170208,38,0
2020-05-02,Mongolia,MN,1,0,3170208,39,0
2020-05-03,Mongolia,MN,0,0,3170208,39,0
2020-03-31,Northern_Mariana_Islands,MP,2,0,56882,2,0
2020-04-01,Northern_Mariana_Islands,MP,4,0,56882,6,0
2020-04-02,Northern_Mariana_Islands,MP,0,1,56882,6,1
2020-04-03,Northern_Mariana_Islands,MP,2,0,56882,8,1
2020-04-04,Northern_Mariana_Islands,MP,0,0,56882,8,1
2020-04-05,Northern_Mariana_Islands,MP,0,0,56882,8,1
2020-04-06,Northern_Mariana_Islands,MP,0,0,56882,8,1
2020-04-07,Northern_Mariana_Islands,MP,0,0,56882,8,1
2020-04-08,Northern_Mariana_Islands,MP,0,1,56882,8,2
2020-04-09,Northern_Mariana_Islands,MP,3,0,56882,11,2
2020-04-10,Northern_Mariana_Islands,MP,0,0,56882,11,2
2020-04-11,Northern_Mariana_Islands,MP,0,0,56882,11,2
2020-04-12,Northern_Mariana_Islands,MP,0,0,56882,11,2
2020-04-13,Northern_Mariana_Islands,MP,0,0,56882,11,2
2020-04-14,Northern_Mariana_Islands,MP,0,0,56882,11,2
2020-04-15,Northern_Mariana_Islands,MP,2,0,56882,13,2
2020-04-16,Northern_Mariana_Islands,MP,0,0,56882,13,2
2020-04-17,Northern_Mariana_Islands,MP,0,0,56882,13,2
2020-04-18,Northern_Mariana_Islands,MP,1,0,56882,14,2
2020-04-19,Northern_Mariana_Islands,MP,0,0,56882,14,2
2020-04-20,Northern_Mariana_Islands,MP,0,0,56882,14,2
2020-04-21,Northern_Mariana_Islands,MP,0,0,56882,14,2
2020-04-22,Northern_Mariana_Islands,MP,0,0,56882,14,2
2020-04-23,Northern_Mariana_Islands,MP,0,0,56882,14,2
2020-04-24,Northern_Mariana_Islands,MP,0,0,56882,14,2
2020-04-25,Northern_Mariana_Islands,MP,0,0,56882,14,2
2020-04-26,Northern_Mariana_Islands,MP,0,0,56882,14,2
2020-04-27,Northern_Mariana_Islands,MP,0,0,56882,14,2
2020-04-28,Northern_Mariana_Islands,MP,0,0,56882,14,2
2020-04-29,Northern_Mariana_Islands,MP,0,0,56882,14,2
2020-04-30,Northern_Mariana_Islands,MP,0,0,56882,14,2
2020-05-01,Northern_Mariana_Islands,MP,0,0,56882,14,2
2020-05-02,Northern_Mariana_Islands,MP,0,0,56882,14,2
2020-05-03,Northern_Mariana_Islands,MP,0,0,56882,14,2
2020-03-15,Mauritania,MR,1,0,4403319,1,0
2020-03-16,Mauritania,MR,0,0,4403319,1,0
2020-03-17,Mauritania,MR,0,0,4403319,1,0
2020-03-18,Mauritania,MR,0,0,4403319,1,0
2020-03-19,Mauritania,MR,0,0,4403319,1,0
2020-03-20,Mauritania,MR,1,0,4403319,2,0
2020-03-21,Mauritania,MR,0,0,4403319,2,0
2020-03-22,Mauritania,MR,0,0,4403319,2,0
2020-03-23,Mauritania,MR,0,0,4403319,2,0
2020-03-24,Mauritania,MR,0,0,4403319,2,0
2020-03-25,Mauritania,MR,0,0,4403319,2,0
2020-03-26,Mauritania,MR,0,0,4403319,2,0
2020-03-27,Mauritania,MR,1,0,4403319,3,0
2020-03-28,Mauritania,MR,0,0,4403319,3,0
2020-03-29,Mauritania,MR,2,0,4403319,5,0
2020-03-30,Mauritania,MR,0,0,4403319,5,0
2020-03-31,Mauritania,MR,0,0,4403319,5,0
2020-04-01,Mauritania,MR,0,0,4403319,5,0
2020-04-02,Mauritania,MR,0,0,4403319,5,0
2020-04-03,Mauritania,MR,1,1,4403319,6,1
2020-04-04,Mauritania,MR,0,0,4403319,6,1
2020-04-05,Mauritania,MR,0,0,4403319,6,1
2020-04-06,Mauritania,MR,0,0,4403319,6,1
2020-04-07,Mauritania,MR,0,0,4403319,6,1
2020-04-08,Mauritania,MR,0,0,4403319,6,1
2020-04-09,Mauritania,MR,0,0,4403319,6,1
2020-04-10,Mauritania,MR,1,0,4403319,7,1
2020-04-11,Mauritania,MR,0,0,4403319,7,1
2020-04-12,Mauritania,MR,0,0,4403319,7,1
2020-04-13,Mauritania,MR,0,0,4403319,7,1
2020-04-14,Mauritania,MR,0,0,4403319,7,1
2020-04-15,Mauritania,MR,0,0,4403319,7,1
2020-04-16,Mauritania,MR,0,0,4403319,7,1
2020-04-17,Mauritania,MR,0,0,4403319,7,1
2020-04-18,Mauritania,MR,0,0,4403319,7,1
2020-04-19,Mauritania,MR,0,0,4403319,7,1
2020-04-20,Mauritania,MR,0,0,4403319,7,1
2020-04-21,Mauritania,MR,0,0,4403319,7,1
2020-04-22,Mauritania,MR,0,0,4403319,7,1
2020-04-23,Mauritania,MR,0,0,4403319,7,1
2020-04-24,Mauritania,MR,0,0,4403319,7,1
2020-04-25,Mauritania,MR,0,0,4403319,7,1
2020-04-26,Mauritania,MR,0,0,4403319,7,1
2020-04-27,Mauritania,MR,0,0,4403319,7,1
2020-04-28,Mauritania,MR,0,0,4403319,7,1
2020-04-29,Mauritania,MR,0,0,4403319,7,1
2020-04-30,Mauritania,MR,0,0,4403319,7,1
2020-05-01,Mauritania,MR,1,0,4403319,8,1
2020-05-02,Mauritania,MR,0,0,4403319,8,1
2020-05-03,Mauritania,MR,0,0,4403319,8,1
2020-03-21,Montserrat,MS,1,0,5900,1,0
2020-03-22,Montserrat,MS,0,0,5900,1,0
2020-03-23,Montserrat,MS,0,0,5900,1,0
2020-03-24,Montserrat,MS,0,0,5900,1,0
2020-03-25,Montserrat,MS,0,0,5900,1,0
2020-03-26,Montserrat,MS,0,0,5900,1,0
2020-03-27,Montserrat,MS,4,0,5900,5,0
2020-03-28,Montserrat,MS,0,0,5900,5,0
2020-03-29,Montserrat,MS,0,0,5900,5,0
2020-03-30,Montserrat,MS,0,0,5900,5,0
2020-03-31,Montserrat,MS,0,0,5900,5,0
2020-04-02,Montserrat,MS,0,0,5900,5,0
2020-04-03,Montserrat,MS,0,0,5900,5,0
2020-04-04,Montserrat,MS,0,0,5900,5,0
2020-04-05,Montserrat,MS,1,0,5900,6,0
2020-04-06,Montserrat,MS,0,0,5900,6,0
2020-04-07,Montserrat,MS,0,0,5900,6,0
2020-04-08,Montserrat,MS,0,0,5900,6,0
2020-04-09,Montserrat,MS,3,0,5900,9,0
2020-04-10,Montserrat,MS,0,0,5900,9,0
2020-04-11,Montserrat,MS,0,0,5900,9,0
2020-04-12,Montserrat,MS,0,0,5900,9,0
2020-04-13,Montserrat,MS,2,0,5900,11,0
2020-04-14,Montserrat,MS,0,0,5900,11,0
2020-04-15,Montserrat,MS,0,0,5900,11,0
2020-04-16,Montserrat,MS,0,0,5900,11,0
2020-04-17,Montserrat,MS,0,0,5900,11,0
2020-04-18,Montserrat,MS,0,0,5900,11,0
2020-04-19,Montserrat,MS,0,0,5900,11,0
2020-04-20,Montserrat,MS,0,0,5900,11,0
2020-04-21,Montserrat,MS,0,0,5900,11,0
2020-04-22,Montserrat,MS,0,0,5900,11,0
2020-04-23,Montserrat,MS,0,0,5900,11,0
2020-04-24,Montserrat,MS,0,0,5900,11,0
2020-04-25,Montserrat,MS,0,0,5900,11,0
2020-04-26,Montserrat,MS,0,1,5900,11,1
2020-04-27,Montserrat,MS,0,0,5900,11,1
2020-04-28,Montserrat,MS,0,0,5900,11,1
2020-04-29,Montserrat,MS,0,0,5900,11,1
2020-04-30,Montserrat,MS,0,0,5900,11,1
2020-05-01,Montserrat,MS,0,0,5900,11,1
2020-05-02,Montserrat,MS,0,0,5900,11,1
2020-05-03,Montserrat,MS,0,0,5900,11,1
2020-03-08,Malta,MT,3,0,483530,3,0
2020-03-10,Malta,MT,1,0,483530,4,0
2020-03-12,Malta,MT,2,0,483530,6,0
2020-03-13,Malta,MT,3,0,483530,9,0
2020-03-14,Malta,MT,3,0,483530,12,0
2020-03-15,Malta,MT,6,0,483530,18,0
2020-03-16,Malta,MT,3,0,483530,21,0
2020-03-17,Malta,MT,9,0,483530,30,0
2020-03-18,Malta,MT,8,0,483530,38,0
2020-03-19,Malta,MT,10,0,483530,48,0
2020-03-20,Malta,MT,5,0,483530,53,0
2020-03-21,Malta,MT,11,0,483530,64,0
2020-03-22,Malta,MT,9,0,483530,73,0
2020-03-23,Malta,MT,17,0,483530,90,0
2020-03-24,Malta,MT,17,0,483530,107,0
2020-03-25,Malta,MT,13,0,483530,120,0
2020-03-26,Malta,MT,9,0,483530,129,0
2020-03-27,Malta,MT,5,0,483530,134,0
2020-03-28,Malta,MT,5,0,483530,139,0
2020-03-29,Malta,MT,10,0,483530,149,0
2020-03-30,Malta,MT,2,0,483530,151,0
2020-03-31,Malta,MT,5,0,483530,156,0
2020-04-01,Malta,MT,11,0,483530,167,0
2020-04-02,Malta,MT,21,0,483530,188,0
2020-04-03,Malta,MT,7,0,483530,195,0
2020-04-04,Malta,MT,7,0,483530,202,0
2020-04-05,Malta,MT,11,0,483530,213,0
2020-04-06,Malta,MT,21,0,483530,234,0
2020-04-07,Malta,MT,7,0,483530,241,0
2020-04-08,Malta,MT,52,0,483530,293,0
2020-04-09,Malta,MT,6,1,483530,299,1
2020-04-10,Malta,MT,38,1,483530,337,2
2020-04-11,Malta,MT,13,0,483530,350,2
2020-04-12,Malta,MT,20,1,483530,370,3
2020-04-13,Malta,MT,8,0,483530,378,3
2020-04-14,Malta,MT,6,0,483530,384,3
2020-04-15,Malta,MT,9,0,483530,393,3
2020-04-16,Malta,MT,6,0,483530,399,3
2020-04-17,Malta,MT,13,0,483530,412,3
2020-04-18,Malta,MT,10,0,483530,422,3
2020-04-19,Malta,MT,4,0,483530,426,3
2020-04-20,Malta,MT,1,0,483530,427,3
2020-04-21,Malta,MT,4,0,483530,431,3
2020-04-22,Malta,MT,12,0,483530,443,3
2020-04-23,Malta,MT,1,0,483530,444,3
2020-04-24,Malta,MT,1,0,483530,445,3
2020-04-25,Malta,MT,2,0,483530,447,3
2020-04-26,Malta,MT,1,1,483530,448,4
2020-04-27,Malta,MT,0,0,483530,448,4
2020-04-28,Malta,MT,2,0,483530,450,4
2020-04-29,Malta,MT,0,0,483530,450,4
2020-04-30,Malta,MT,13,0,483530,463,4
2020-05-01,Malta,MT,2,0,483530,465,4
2020-05-02,Malta,MT,2,0,483530,467,4
2020-05-03,Malta,MT,0,0,483530,467,4
2020-03-20,Mauritius,MU,3,0,1265303,3,0
2020-03-21,Mauritius,MU,9,0,1265303,12,0
2020-03-22,Mauritius,MU,2,1,1265303,14,1
2020-03-23,Mauritius,MU,14,1,1265303,28,2
2020-03-24,Mauritius,MU,8,0,1265303,36,2
2020-03-25,Mauritius,MU,6,0,1265303,42,2
2020-03-26,Mauritius,MU,6,0,1265303,48,2
2020-03-27,Mauritius,MU,33,0,1265303,81,2
2020-03-28,Mauritius,MU,13,0,1265303,94,2
2020-03-29,Mauritius,MU,8,0,1265303,102,2
2020-03-30,Mauritius,MU,8,1,1265303,110,3
2020-03-31,Mauritius,MU,18,0,1265303,128,3
2020-04-01,Mauritius,MU,15,0,1265303,143,3
2020-04-02,Mauritius,MU,11,2,1265303,154,5
2020-04-03,Mauritius,MU,15,2,1265303,169,7
2020-04-04,Mauritius,MU,17,0,1265303,186,7
2020-04-05,Mauritius,MU,10,0,1265303,196,7
2020-04-06,Mauritius,MU,31,0,1265303,227,7
2020-04-07,Mauritius,MU,17,0,1265303,244,7
2020-04-08,Mauritius,MU,24,0,1265303,268,7
2020-04-09,Mauritius,MU,5,0,1265303,273,7
2020-04-10,Mauritius,MU,41,0,1265303,314,7
2020-04-11,Mauritius,MU,4,2,1265303,318,9
2020-04-12,Mauritius,MU,1,0,1265303,319,9
2020-04-13,Mauritius,MU,5,0,1265303,324,9
2020-04-14,Mauritius,MU,0,0,1265303,324,9
2020-04-15,Mauritius,MU,0,0,1265303,324,9
2020-04-16,Mauritius,MU,0,0,1265303,324,9
2020-04-17,Mauritius,MU,0,0,1265303,324,9
2020-04-18,Mauritius,MU,0,0,1265303,324,9
2020-04-19,Mauritius,MU,1,0,1265303,325,9
2020-04-20,Mauritius,MU,3,0,1265303,328,9
2020-04-21,Mauritius,MU,0,0,1265303,328,9
2020-04-22,Mauritius,MU,0,0,1265303,328,9
2020-04-23,Mauritius,MU,1,0,1265303,329,9
2020-04-24,Mauritius,MU,2,0,1265303,331,9
2020-04-25,Mauritius,MU,0,0,1265303,331,9
2020-04-26,Mauritius,MU,0,0,1265303,331,9
2020-04-27,Mauritius,MU,1,0,1265303,332,9
2020-04-28,Mauritius,MU,2,1,1265303,334,10
2020-04-29,Mauritius,MU,0,0,1265303,334,10
2020-04-30,Mauritius,MU,0,0,1265303,334,10
2020-05-01,Mauritius,MU,0,0,1265303,334,10
2020-05-02,Mauritius,MU,0,0,1265303,334,10
2020-05-03,Mauritius,MU,0,0,1265303,334,10
2020-03-08,Maldives,MV,2,0,515696,2,0
2020-03-09,Maldives,MV,2,0,515696,4,0
2020-03-11,Maldives,MV,2,0,515696,6,0
2020-03-12,Maldives,MV,2,0,515696,8,0
2020-03-14,Maldives,MV,1,0,515696,9,0
2020-03-15,Maldives,MV,0,0,515696,9,0
2020-03-16,Maldives,MV,4,0,515696,13,0
2020-03-17,Maldives,MV,0,0,515696,13,0
2020-03-18,Maldives,MV,0,0,515696,13,0
2020-03-19,Maldives,MV,0,0,515696,13,0
2020-03-20,Maldives,MV,0,0,515696,13,0
2020-03-21,Maldives,MV,0,0,515696,13,0
2020-03-22,Maldives,MV,0,0,515696,13,0
2020-03-23,Maldives,MV,0,0,515696,13,0
2020-03-24,Maldives,MV,0,0,515696,13,0
2020-03-25,Maldives,MV,0,0,515696,13,0
2020-03-26,Maldives,MV,0,0,515696,13,0
2020-03-27,Maldives,MV,0,0,515696,13,0
2020-03-28,Maldives,MV,1,0,515696,14,0
2020-03-29,Maldives,MV,2,0,515696,16,0
2020-03-30,Maldives,MV,1,0,515696,17,0
2020-03-31,Maldives,MV,0,0,515696,17,0
2020-04-01,Maldives,MV,1,0,515696,18,0
2020-04-02,Maldives,MV,1,0,515696,19,0
2020-04-03,Maldives,MV,0,0,515696,19,0
2020-04-04,Maldives,MV,0,0,515696,19,0
2020-04-05,Maldives,MV,0,0,515696,19,0
2020-04-06,Maldives,MV,0,0,515696,19,0
2020-04-07,Maldives,MV,0,0,515696,19,0
2020-04-08,Maldives,MV,0,0,515696,19,0
2020-04-09,Maldives,MV,0,0,515696,19,0
2020-04-10,Maldives,MV,0,0,515696,19,0
2020-04-11,Maldives,MV,0,0,515696,19,0
2020-04-12,Maldives,MV,0,0,515696,19,0
2020-04-13,Maldives,MV,1,0,515696,20,0
2020-04-14,Maldives,MV,0,0,515696,20,0
2020-04-15,Maldives,MV,1,0,515696,21,0
2020-04-16,Maldives,MV,0,0,515696,21,0
2020-04-17,Maldives,MV,4,0,515696,25,0
2020-04-18,Maldives,MV,4,0,515696,29,0
2020-04-19,Maldives,MV,6,0,515696,35,0
2020-04-20,Maldives,MV,17,0,515696,52,0
2020-04-21,Maldives,MV,17,0,515696,69,0
2020-04-22,Maldives,MV,16,0,515696,85,0
2020-04-23,Maldives,MV,0,0,515696,85,0
2020-04-24,Maldives,MV,25,0,515696,110,0
2020-04-25,Maldives,MV,18,0,515696,128,0
2020-04-26,Maldives,MV,9,0,515696,137,0
2020-04-27,Maldives,MV,77,0,515696,214,0
2020-04-28,Maldives,MV,0,0,515696,214,0
2020-04-29,Maldives,MV,31,0,515696,245,0
2020-04-30,Maldives,MV,32,0,515696,277,0
2020-05-01,Maldives,MV,191,1,515696,468,1
2020-05-02,Maldives,MV,23,0,515696,491,1
2020-05-03,Maldives,MV,28,0,515696,519,1
2020-04-03,Malawi,MW,3,0,18143315,3,0
2020-04-04,Malawi,MW,0,0,18143315,3,0
2020-04-05,Malawi,MW,1,0,18143315,4,0
2020-04-06,Malawi,MW,0,0,18143315,4,0
2020-04-07,Malawi,MW,1,0,18143315,5,0
2020-04-08,Malawi,MW,3,1,18143315,8,1
2020-04-09,Malawi,MW,0,0,18143315,8,1
2020-04-10,Malawi,MW,0,0,18143315,8,1
2020-04-11,Malawi,MW,1,0,18143315,9,1
2020-04-12,Malawi,MW,3,1,18143315,12,2
2020-04-13,Malawi,MW,1,0,18143315,13,2
2020-04-14,Malawi,MW,3,0,18143315,16,2
2020-04-15,Malawi,MW,0,0,18143315,16,2
2020-04-16,Malawi,MW,0,0,18143315,16,2
2020-04-17,Malawi,MW,0,0,18143315,16,2
2020-04-18,Malawi,MW,1,0,18143315,17,2
2020-04-19,Malawi,MW,0,0,18143315,17,2
2020-04-20,Malawi,MW,0,0,18143315,17,2
2020-04-21,Malawi,MW,0,0,18143315,17,2
2020-04-22,Malawi,MW,1,0,18143315,18,2
2020-04-23,Malawi,MW,5,1,18143315,23,3
2020-04-24,Malawi,MW,10,0,18143315,33,3
2020-04-25,Malawi,MW,0,0,18143315,33,3
2020-04-26,Malawi,MW,0,0,18143315,33,3
2020-04-27,Malawi,MW,1,0,18143315,34,3
2020-04-28,Malawi,MW,2,0,18143315,36,3
2020-04-29,Malawi,MW,0,0,18143315,36,3
2020-04-30,Malawi,MW,0,0,18143315,36,3
2020-05-01,Malawi,MW,1,0,18143315,37,3
2020-05-02,Malawi,MW,0,0,18143315,37,3
2020-05-03,Malawi,MW,1,0,18143315,38,3
2019-12-31,Mexico,MX,0,0,126190788,0,0
2020-01-01,Mexico,MX,0,0,126190788,0,0
2020-01-02,Mexico,MX,0,0,126190788,0,0
2020-01-03,Mexico,MX,0,0,126190788,0,0
2020-01-04,Mexico,MX,0,0,126190788,0,0
2020-01-05,Mexico,MX,0,0,126190788,0,0
2020-01-06,Mexico,MX,0,0,126190788,0,0
2020-01-07,Mexico,MX,0,0,126190788,0,0
2020-01-08,Mexico,MX,0,0,126190788,0,0
2020-01-09,Mexico,MX,0,0,126190788,0,0
2020-01-10,Mexico,MX,0,0,126190788,0,0
2020-01-11,Mexico,MX,0,0,126190788,0,0
2020-01-12,Mexico,MX,0,0,126190788,0,0
2020-01-13,Mexico,MX,0,0,126190788,0,0
2020-01-14,Mexico,MX,0,0,126190788,0,0
2020-01-15,Mexico,MX,0,0,126190788,0,0
2020-01-16,Mexico,MX,0,0,126190788,0,0
2020-01-17,Mexico,MX,0,0,126190788,0,0
2020-01-18,Mexico,MX,0,0,126190788,0,0
2020-01-19,Mexico,MX,0,0,126190788,0,0
2020-01-20,Mexico,MX,0,0,126190788,0,0
2020-01-21,Mexico,MX,0,0,126190788,0,0
2020-01-22,Mexico,MX,0,0,126190788,0,0
2020-01-23,Mexico,MX,0,0,126190788,0,0
2020-01-24,Mexico,MX,0,0,126190788,0,0
2020-01-25,Mexico,MX,0,0,126190788,0,0
2020-01-26,Mexico,MX,0,0,126190788,0,0
2020-01-27,Mexico,MX,0,0,126190788,0,0
2020-01-28,Mexico,MX,0,0,126190788,0,0
2020-01-29,Mexico,MX,0,0,126190788,0,0
2020-01-30,Mexico,MX,0,0,126190788,0,0
2020-01-31,Mexico,MX,0,0,126190788,0,0
2020-02-01,Mexico,MX,0,0,126190788,0,0
2020-02-02,Mexico,MX,0,0,126190788,0,0
2020-02-03,Mexico,MX,0,0,126190788,0,0
2020-02-04,Mexico,MX,0,0,126190788,0,0
2020-02-05,Mexico,MX,0,0,126190788,0,0
2020-02-06,Mexico,MX,0,0,126190788,0,0
2020-02-07,Mexico,MX,0,0,126190788,0,0
2020-02-08,Mexico,MX,0,0,126190788,0,0
2020-02-09,Mexico,MX,0,0,126190788,0,0
2020-02-10,Mexico,MX,0,0,126190788,0,0
2020-02-11,Mexico,MX,0,0,126190788,0,0
2020-02-12,Mexico,MX,0,0,126190788,0,0
2020-02-13,Mexico,MX,0,0,126190788,0,0
2020-02-14,Mexico,MX,0,0,126190788,0,0
2020-02-15,Mexico,MX,0,0,126190788,0,0
2020-02-16,Mexico,MX,0,0,126190788,0,0
2020-02-17,Mexico,MX,0,0,126190788,0,0
2020-02-18,Mexico,MX,0,0,126190788,0,0
2020-02-19,Mexico,MX,0,0,126190788,0,0
2020-02-20,Mexico,MX,0,0,126190788,0,0
2020-02-21,Mexico,MX,0,0,126190788,0,0
2020-02-22,Mexico,MX,0,0,126190788,0,0
2020-02-23,Mexico,MX,0,0,126190788,0,0
2020-02-24,Mexico,MX,0,0,126190788,0,0
2020-02-25,Mexico,MX,0,0,126190788,0,0
2020-02-26,Mexico,MX,0,0,126190788,0,0
2020-02-27,Mexico,MX,0,0,126190788,0,0
2020-02-28,Mexico,MX,0,0,126190788,0,0
2020-02-29,Mexico,MX,2,0,126190788,2,0
2020-03-01,Mexico,MX,2,0,126190788,4,0
2020-03-02,Mexico,MX,1,0,126190788,5,0
2020-03-09,Mexico,MX,2,0,126190788,7,0
2020-03-12,Mexico,MX,4,0,126190788,11,0
2020-03-13,Mexico,MX,5,0,126190788,16,0
2020-03-14,Mexico,MX,10,0,126190788,26,0
2020-03-15,Mexico,MX,15,0,126190788,41,0
2020-03-16,Mexico,MX,12,0,126190788,53,0
2020-03-17,Mexico,MX,29,0,126190788,82,0
2020-03-18,Mexico,MX,11,0,126190788,93,0
2020-03-19,Mexico,MX,25,0,126190788,118,0
2020-03-20,Mexico,MX,46,0,126190788,164,0
2020-03-21,Mexico,MX,39,2,126190788,203,2
2020-03-22,Mexico,MX,48,0,126190788,251,2
2020-03-23,Mexico,MX,65,0,126190788,316,2
2020-03-24,Mexico,MX,51,2,126190788,367,4
2020-03-25,Mexico,MX,38,1,126190788,405,5
2020-03-26,Mexico,MX,70,0,126190788,475,5
2020-03-27,Mexico,MX,110,3,126190788,585,8
2020-03-28,Mexico,MX,132,4,126190788,717,12
2020-03-29,Mexico,MX,131,4,126190788,848,16
2020-03-30,Mexico,MX,145,4,126190788,993,20
2020-03-31,Mexico,MX,101,8,126190788,1094,28
2020-04-01,Mexico,MX,121,1,126190788,1215,29
2020-04-02,Mexico,MX,163,8,126190788,1378,37
2020-04-03,Mexico,MX,132,13,126190788,1510,50
2020-04-04,Mexico,MX,178,10,126190788,1688,60
2020-04-05,Mexico,MX,202,19,126190788,1890,79
2020-04-06,Mexico,MX,253,15,126190788,2143,94
2020-04-07,Mexico,MX,296,31,126190788,2439,125
2020-04-08,Mexico,MX,346,16,126190788,2785,141
2020-04-09,Mexico,MX,396,33,126190788,3181,174
2020-04-10,Mexico,MX,260,20,126190788,3441,194
2020-04-11,Mexico,MX,403,39,126190788,3844,233
2020-04-12,Mexico,MX,375,40,126190788,4219,273
2020-04-13,Mexico,MX,442,23,126190788,4661,296
2020-04-14,Mexico,MX,353,36,126190788,5014,332
2020-04-15,Mexico,MX,385,74,126190788,5399,406
2020-04-16,Mexico,MX,448,43,126190788,5847,449
2020-04-17,Mexico,MX,450,37,126190788,6297,486
2020-04-18,Mexico,MX,578,60,126190788,6875,546
2020-04-19,Mexico,MX,622,104,126190788,7497,650
2020-04-20,Mexico,MX,764,36,126190788,8261,686
2020-04-21,Mexico,MX,511,26,126190788,8772,712
2020-04-22,Mexico,MX,729,145,126190788,9501,857
2020-04-23,Mexico,MX,1043,113,126190788,10544,970
2020-04-24,Mexico,MX,1089,99,126190788,11633,1069
2020-04-25,Mexico,MX,1239,152,126190788,12872,1221
2020-04-26,Mexico,MX,970,84,126190788,13842,1305
2020-04-27,Mexico,MX,835,46,126190788,14677,1351
2020-04-28,Mexico,MX,852,83,126190788,15529,1434
2020-04-29,Mexico,MX,1223,135,126190788,16752,1569
2020-04-30,Mexico,MX,1047,163,126190788,17799,1732
2020-05-01,Mexico,MX,1425,127,126190788,19224,1859
2020-05-02,Mexico,MX,1515,113,126190788,20739,1972
2020-05-03,Mexico,MX,1349,89,126190788,22088,2061
2019-12-31,Malaysia,MY,0,0,31528585,0,0
2020-01-01,Malaysia,MY,0,0,31528585,0,0
2020-01-02,Malaysia,MY,0,0,31528585,0,0
2020-01-03,Malaysia,MY,0,0,31528585,0,0
2020-01-04,Malaysia,MY,0,0,31528585,0,0
2020-01-05,Malaysia,MY,0,0,31528585,0,0
2020-01-06,Malaysia,MY,0,0,31528585,0,0
2020-01-07,Malaysia,MY,0,0,31528585,0,0
2020-01-08,Malaysia,MY,0,0,31528585,0,0
2020-01-09,Malaysia,MY,0,0,31528585,0,0
2020-01-10,Malaysia,MY,0,0,31528585,0,0
2020-01-11,Malaysia,MY,0,0,31528585,0,0
2020-01-12,Malaysia,MY,0,0,31528585,0,0
2020-01-13,Malaysia,MY,0,0,31528585,0,0
2020-01-14,Malaysia,MY,0,0,31528585,0,0
2020-01-15,Malaysia,MY,0,0,31528585,0,0
2020-01-16,Malaysia,MY,0,0,31528585,0,0
2020-01-17,Malaysia,MY,0,0,31528585,0,0
2020-01-18,Malaysia,MY,0,0,31528585,0,0
2020-01-19,Malaysia,MY,0,0,31528585,0,0
2020-01-20,Malaysia,MY,0,0,31528585,0,0
2020-01-21,Malaysia,MY,0,0,31528585,0,0
2020-01-22,Malaysia,MY,0,0,31528585,0,0
2020-01-23,Malaysia,MY,0,0,31528585,0,0
2020-01-24,Malaysia,MY,0,0,31528585,0,0
2020-01-25,Malaysia,MY,3,0,31528585,3,0
2020-01-26,Malaysia,MY,1,0,31528585,4,0
2020-01-27,Malaysia,MY,0,0,31528585,4,0
2020-01-28,Malaysia,MY,0,0,31528585,4,0
2020-01-29,Malaysia,MY,3,0,31528585,7,0
2020-01-30,Malaysia,MY,0,0,31528585,7,0
2020-01-31,Malaysia,MY,1,0,31528585,8,0
2020-02-01,Malaysia,MY,0,0,31528585,8,0
2020-02-02,Malaysia,MY,0,0,31528585,8,0
2020-02-03,Malaysia,MY,0,0,31528585,8,0
2020-02-04,Malaysia,MY,0,0,31528585,8,0
2020-02-05,Malaysia,MY,2,0,31528585,10,0
2020-02-06,Malaysia,MY,2,0,31528585,12,0
2020-02-07,Malaysia,MY,2,0,31528585,14,0
2020-02-08,Malaysia,MY,1,0,31528585,15,0
2020-02-09,Malaysia,MY,1,0,31528585,16,0
2020-02-10,Malaysia,MY,2,0,31528585,18,0
2020-02-11,Malaysia,MY,0,0,31528585,18,0
2020-02-12,Malaysia,MY,0,0,31528585,18,0
2020-02-13,Malaysia,MY,0,0,31528585,18,0
2020-02-14,Malaysia,MY,1,0,31528585,19,0
2020-02-15,Malaysia,MY,2,0,31528585,21,0
2020-02-16,Malaysia,MY,1,0,31528585,22,0
2020-02-17,Malaysia,MY,0,0,31528585,22,0
2020-02-18,Malaysia,MY,0,0,31528585,22,0
2020-02-19,Malaysia,MY,0,0,31528585,22,0
2020-02-20,Malaysia,MY,0,0,31528585,22,0
2020-02-21,Malaysia,MY,0,0,31528585,22,0
2020-02-22,Malaysia,MY,0,0,31528585,22,0
2020-02-23,Malaysia,MY,0,0,31528585,22,0
2020-02-24,Malaysia,MY,0,0,31528585,22,0
2020-02-25,Malaysia,MY,0,0,31528585,22,0
2020-02-26,Malaysia,MY,0,0,31528585,22,0
2020-02-27,Malaysia,MY,0,0,31528585,22,0
2020-02-28,Malaysia,MY,1,0,31528585,23,0
2020-02-29,Malaysia,MY,2,0,31528585,25,0
2020-03-01,Malaysia,MY,0,0,31528585,25,0
2020-03-02,Malaysia,MY,4,0,31528585,29,0
2020-03-04,Malaysia,MY,7,0,31528585,36,0
2020-03-05,Malaysia,MY,14,0,31528585,50,0
2020-03-06,Malaysia,MY,0,0,31528585,50,0
2020-03-07,Malaysia,MY,33,0,31528585,83,0
2020-03-08,Malaysia,MY,10,0,31528585,93,0
2020-03-09,Malaysia,MY,6,0,31528585,99,0
2020-03-10,Malaysia,MY,18,0,31528585,117,0
2020-03-11,Malaysia,MY,12,0,31528585,129,0
2020-03-12,Malaysia,MY,20,0,31528585,149,0
2020-03-13,Malaysia,MY,9,0,31528585,158,0
2020-03-14,Malaysia,MY,39,0,31528585,197,0
2020-03-15,Malaysia,MY,41,0,31528585,238,0
2020-03-16,Malaysia,MY,190,0,31528585,428,0
2020-03-17,Malaysia,MY,125,0,31528585,553,0
2020-03-18,Malaysia,MY,120,2,31528585,673,2
2020-03-19,Malaysia,MY,117,0,31528585,790,2
2020-03-20,Malaysia,MY,110,0,31528585,900,2
2020-03-21,Malaysia,MY,130,0,31528585,1030,2
2020-03-22,Malaysia,MY,153,2,31528585,1183,4
2020-03-23,Malaysia,MY,123,6,31528585,1306,10
2020-03-24,Malaysia,MY,212,4,31528585,1518,14
2020-03-25,Malaysia,MY,106,1,31528585,1624,15
2020-03-26,Malaysia,MY,172,4,31528585,1796,19
2020-03-27,Malaysia,MY,235,4,31528585,2031,23
2020-03-28,Malaysia,MY,130,3,31528585,2161,26
2020-03-29,Malaysia,MY,159,1,31528585,2320,27
2020-03-30,Malaysia,MY,150,7,31528585,2470,34
2020-03-31,Malaysia,MY,156,3,31528585,2626,37
2020-04-01,Malaysia,MY,140,6,31528585,2766,43
2020-04-02,Malaysia,MY,142,2,31528585,2908,45
2020-04-03,Malaysia,MY,208,5,31528585,3116,50
2020-04-04,Malaysia,MY,217,3,31528585,3333,53
2020-04-05,Malaysia,MY,150,4,31528585,3483,57
2020-04-06,Malaysia,MY,179,4,31528585,3662,61
2020-04-07,Malaysia,MY,131,1,31528585,3793,62
2020-04-08,Malaysia,MY,170,1,31528585,3963,63
2020-04-09,Malaysia,MY,156,2,31528585,4119,65
2020-04-10,Malaysia,MY,109,2,31528585,4228,67
2020-04-11,Malaysia,MY,118,3,31528585,4346,70
2020-04-12,Malaysia,MY,184,3,31528585,4530,73
2020-04-13,Malaysia,MY,153,3,31528585,4683,76
2020-04-14,Malaysia,MY,134,1,31528585,4817,77
2020-04-15,Malaysia,MY,170,5,31528585,4987,82
2020-04-16,Malaysia,MY,85,1,31528585,5072,83
2020-04-17,Malaysia,MY,110,1,31528585,5182,84
2020-04-18,Malaysia,MY,69,2,31528585,5251,86
2020-04-19,Malaysia,MY,54,2,31528585,5305,88
2020-04-20,Malaysia,MY,84,1,31528585,5389,89
2020-04-21,Malaysia,MY,36,0,31528585,5425,89
2020-04-22,Malaysia,MY,57,3,31528585,5482,92
2020-04-23,Malaysia,MY,50,1,31528585,5532,93
2020-04-24,Malaysia,MY,71,2,31528585,5603,95
2020-04-25,Malaysia,MY,88,1,31528585,5691,96
2020-04-26,Malaysia,MY,51,2,31528585,5742,98
2020-04-27,Malaysia,MY,38,0,31528585,5780,98
2020-04-28,Malaysia,MY,40,1,31528585,5820,99
2020-04-29,Malaysia,MY,31,1,31528585,5851,100
2020-04-30,Malaysia,MY,94,0,31528585,5945,100
2020-05-01,Malaysia,MY,57,2,31528585,6002,102
2020-05-02,Malaysia,MY,69,1,31528585,6071,103
2020-05-03,Malaysia,MY,105,0,31528585,6176,103
2020-03-23,Mozambique,MZ,1,0,29495962,1,0
2020-03-24,Mozambique,MZ,0,0,29495962,1,0
2020-03-25,Mozambique,MZ,0,0,29495962,1,0
2020-03-26,Mozambique,MZ,4,0,29495962,5,0
2020-03-27,Mozambique,MZ,2,0,29495962,7,0
2020-03-28,Mozambique,MZ,0,0,29495962,7,0
2020-03-29,Mozambique,MZ,1,0,29495962,8,0
2020-03-30,Mozambique,MZ,0,0,29495962,8,0
2020-03-31,Mozambique,MZ,0,0,29495962,8,0
2020-04-01,Mozambique,MZ,0,0,29495962,8,0
2020-04-02,Mozambique,MZ,2,0,29495962,10,0
2020-04-03,Mozambique,MZ,0,0,29495962,10,0
2020-04-04,Mozambique,MZ,0,0,29495962,10,0
2020-04-05,Mozambique,MZ,0,0,29495962,10,0
2020-04-06,Mozambique,MZ,0,0,29495962,10,0
2020-04-07,Mozambique,MZ,0,0,29495962,10,0
2020-04-08,Mozambique,MZ,0,0,29495962,10,0
2020-04-09,Mozambique,MZ,7,0,29495962,17,0
2020-04-10,Mozambique,MZ,0,0,29495962,17,0
2020-04-11,Mozambique,MZ,3,0,29495962,20,0
2020-04-12,Mozambique,MZ,0,0,29495962,20,0
2020-04-13,Mozambique,MZ,1,0,29495962,21,0
2020-04-14,Mozambique,MZ,6,0,29495962,27,0
2020-04-15,Mozambique,MZ,1,0,29495962,28,0
2020-04-16,Mozambique,MZ,1,0,29495962,29,0
2020-04-17,Mozambique,MZ,2,0,29495962,31,0
2020-04-18,Mozambique,MZ,3,0,29495962,34,0
2020-04-19,Mozambique,MZ,1,0,29495962,35,0
2020-04-20,Mozambique,MZ,4,0,29495962,39,0
2020-04-21,Mozambique,MZ,0,0,29495962,39,0
2020-04-22,Mozambique,MZ,0,0,29495962,39,0
2020-04-23,Mozambique,MZ,2,0,29495962,41,0
2020-04-24,Mozambique,MZ,5,0,29495962,46,0
2020-04-25,Mozambique,MZ,19,0,29495962,65,0
2020-04-26,Mozambique,MZ,5,0,29495962,70,0
2020-04-27,Mozambique,MZ,6,0,29495962,76,0
2020-04-28,Mozambique,MZ,0,0,29495962,76,0
2020-04-29,Mozambique,MZ,0,0,29495962,76,0
2020-04-30,Mozambique,MZ,0,0,29495962,76,0
2020-05-01,Mozambique,MZ,0,0,29495962,76,0
2020-05-02,Mozambique,MZ,3,0,29495962,79,0
2020-05-03,Mozambique,MZ,0,0,29495962,79,0
2020-03-15,Namibia,NA,2,0,2448255,2,0
2020-03-16,Namibia,NA,0,0,2448255,2,0
2020-03-17,Namibia,NA,0,0,2448255,2,0
2020-03-18,Namibia,NA,0,0,2448255,2,0
2020-03-19,Namibia,NA,0,0,2448255,2,0
2020-03-20,Namibia,NA,0,0,2448255,2,0
2020-03-21,Namibia,NA,1,0,2448255,3,0
2020-03-22,Namibia,NA,0,0,2448255,3,0
2020-03-23,Namibia,NA,0,0,2448255,3,0
2020-03-24,Namibia,NA,0,0,2448255,3,0
2020-03-25,Namibia,NA,0,0,2448255,3,0
2020-03-26,Namibia,NA,1,0,2448255,4,0
2020-03-27,Namibia,NA,4,0,2448255,8,0
2020-03-28,Namibia,NA,0,0,2448255,8,0
2020-03-29,Namibia,NA,0,0,2448255,8,0
2020-03-30,Namibia,NA,3,0,2448255,11,0
2020-03-31,Namibia,NA,0,0,2448255,11,0
2020-04-01,Namibia,NA,0,0,2448255,11,0
2020-04-02,Namibia,NA,2,0,2448255,13,0
2020-04-03,Namibia,NA,0,0,2448255,13,0
2020-04-04,Namibia,NA,1,0,2448255,14,0
2020-04-05,Namibia,NA,0,0,2448255,14,0
2020-04-06,Namibia,NA,2,0,2448255,16,0
2020-04-07,Namibia,NA,0,0,2448255,16,0
2020-04-08,Namibia,NA,0,0,2448255,16,0
2020-04-09,Namibia,NA,0,0,2448255,16,0
2020-04-10,Namibia,NA,0,0,2448255,16,0
2020-04-11,Namibia,NA,0,0,2448255,16,0
2020-04-12,Namibia,NA,0,0,2448255,16,0
2020-04-13,Namibia,NA,0,0,2448255,16,0
2020-04-14,Namibia,NA,0,0,2448255,16,0
2020-04-15,Namibia,NA,0,0,2448255,16,0
2020-04-16,Namibia,NA,0,0,2448255,16,0
2020-04-17,Namibia,NA,0,0,2448255,16,0
2020-04-18,Namibia,NA,0,0,2448255,16,0
2020-04-19,Namibia,NA,0,0,2448255,16,0
2020-04-20,Namibia,NA,0,0,2448255,16,0
2020-04-21,Namibia,NA,0,0,2448255,16,0
2020-04-22,Namibia,NA,0,0,2448255,16,0
2020-04-23,Namibia,NA,0,0,2448255,16,0
2020-04-24,Namibia,NA,0,0,2448255,16,0
2020-04-25,Namibia,NA,0,0,2448255,16,0
2020-04-26,Namibia,NA,0,0,2448255,16,0
2020-04-27,Namibia,NA,0,0,2448255,16,0
2020-04-28,Namibia,NA,0,0,2448255,16,0
2020-04-29,Namibia,NA,0,0,2448255,16,0
2020-04-30,Namibia,NA,0,0,2448255,16,0
2020-05-01,Namibia,NA,0,0,2448255,16,0
2020-05-02,Namibia,NA,0,0,2448255,16,0
2020-05-03,Namibia,NA,0,0,2448255,16,0
2020-03-21,New_Caledonia,NC,2,0,284060,2,0
2020-03-22,New_Caledonia,NC,2,0,284060,4,0
2020-03-23,New_Caledonia,NC,1,0,284060,5,0
2020-03-24,New_Caledonia,NC,2,0,284060,7,0
2020-03-25,New_Caledonia,NC,2,0,284060,9,0
2020-03-26,New_Caledonia,NC,5,0,284060,14,0
2020-03-27,New_Caledonia,NC,1,0,284060,15,0
2020-03-28,New_Caledonia,NC,0,0,284060,15,0
2020-03-29,New_Caledonia,NC,0,0,284060,15,0
2020-03-30,New_Caledonia,NC,0,0,284060,15,0
2020-03-31,New_Caledonia,NC,1,0,284060,16,0
2020-04-01,New_Caledonia,NC,0,0,284060,16,0
2020-04-02,New_Caledonia,NC,0,0,284060,16,0
2020-04-03,New_Caledonia,NC,0,0,284060,16,0
2020-04-04,New_Caledonia,NC,2,0,284060,18,0
2020-04-05,New_Caledonia,NC,0,0,284060,18,0
2020-04-06,New_Caledonia,NC,0,0,284060,18,0
2020-04-07,New_Caledonia,NC,0,0,284060,18,0
2020-04-08,New_Caledonia,NC,0,0,284060,18,0
2020-04-09,New_Caledonia,NC,0,0,284060,18,0
2020-04-10,New_Caledonia,NC,0,0,284060,18,0
2020-04-11,New_Caledonia,NC,0,0,284060,18,0
2020-04-12,New_Caledonia,NC,0,0,284060,18,0
2020-04-13,New_Caledonia,NC,0,0,284060,18,0
2020-04-14,New_Caledonia,NC,0,0,284060,18,0
2020-04-15,New_Caledonia,NC,0,0,284060,18,0
2020-04-16,New_Caledonia,NC,0,0,284060,18,0
2020-04-17,New_Caledonia,NC,0,0,284060,18,0
2020-04-18,New_Caledonia,NC,0,0,284060,18,0
2020-04-19,New_Caledonia,NC,0,0,284060,18,0
2020-04-20,New_Caledonia,NC,0,0,284060,18,0
2020-04-21,New_Caledonia,NC,0,0,284060,18,0
2020-04-22,New_Caledonia,NC,0,0,284060,18,0
2020-04-23,New_Caledonia,NC,0,0,284060,18,0
2020-04-24,New_Caledonia,NC,0,0,284060,18,0
2020-04-25,New_Caledonia,NC,0,0,284060,18,0
2020-04-26,New_Caledonia,NC,0,0,284060,18,0
2020-04-27,New_Caledonia,NC,0,0,284060,18,0
2020-04-28,New_Caledonia,NC,0,0,284060,18,0
2020-04-29,New_Caledonia,NC,0,0,284060,18,0
2020-04-30,New_Caledonia,NC,0,0,284060,18,0
2020-05-01,New_Caledonia,NC,0,0,284060,18,0
2020-05-02,New_Caledonia,NC,0,0,284060,18,0
2020-05-03,New_Caledonia,NC,0,0,284060,18,0
2020-03-21,Niger,NE,1,0,22442948,1,0
2020-03-22,Niger,NE,0,0,22442948,1,0
2020-03-23,Niger,NE,0,0,22442948,1,0
2020-03-24,Niger,NE,1,0,22442948,2,0
2020-03-25,Niger,NE,5,1,22442948,7,1
2020-03-26,Niger,NE,0,0,22442948,7,1
2020-03-27,Niger,NE,3,0,22442948,10,1
2020-03-28,Niger,NE,0,0,22442948,10,1
2020-03-29,Niger,NE,0,0,22442948,10,1
2020-03-30,Niger,NE,0,0,22442948,10,1
2020-03-31,Niger,NE,10,2,22442948,20,3
2020-04-01,Niger,NE,0,0,22442948,20,3
2020-04-02,Niger,NE,54,2,22442948,74,5
2020-04-03,Niger,NE,0,0,22442948,74,5
2020-04-04,Niger,NE,24,0,22442948,98,5
2020-04-05,Niger,NE,22,0,22442948,120,5
2020-04-06,Niger,NE,64,5,22442948,184,10
2020-04-07,Niger,NE,69,0,22442948,253,10
2020-04-08,Niger,NE,25,1,22442948,278,11
2020-04-09,Niger,NE,64,0,22442948,342,11
2020-04-10,Niger,NE,68,0,22442948,410,11
2020-04-11,Niger,NE,28,0,22442948,438,11
2020-04-12,Niger,NE,53,0,22442948,491,11
2020-04-13,Niger,NE,38,1,22442948,529,12
2020-04-14,Niger,NE,19,1,22442948,548,13
2020-04-15,Niger,NE,22,1,22442948,570,14
2020-04-16,Niger,NE,14,0,22442948,584,14
2020-04-17,Niger,NE,25,1,22442948,609,15
2020-04-18,Niger,NE,18,3,22442948,627,18
2020-04-19,Niger,NE,12,1,22442948,639,19
2020-04-20,Niger,NE,9,1,22442948,648,20
2020-04-21,Niger,NE,7,0,22442948,655,20
2020-04-22,Niger,NE,0,0,22442948,655,20
2020-04-23,Niger,NE,7,2,22442948,662,22
2020-04-24,Niger,NE,9,2,22442948,671,24
2020-04-25,Niger,NE,10,0,22442948,681,24
2020-04-26,Niger,NE,3,3,22442948,684,27
2020-04-27,Niger,NE,12,2,22442948,696,29
2020-04-28,Niger,NE,5,0,22442948,701,29
2020-04-29,Niger,NE,8,2,22442948,709,31
2020-04-30,Niger,NE,4,1,22442948,713,32
2020-05-01,Niger,NE,6,0,22442948,719,32
2020-05-02,Niger,NE,9,1,22442948,728,33
2020-05-03,Niger,NE,8,2,22442948,736,35
2019-12-31,Nigeria,NG,0,0,195874740,0,0
2020-01-01,Nigeria,NG,0,0,195874740,0,0
2020-01-02,Nigeria,NG,0,0,195874740,0,0
2020-01-03,Nigeria,NG,0,0,195874740,0,0
2020-01-04,Nigeria,NG,0,0,195874740,0,0
2020-01-05,Nigeria,NG,0,0,195874740,0,0
2020-01-06,Nigeria,NG,0,0,195874740,0,0
2020-01-07,Nigeria,NG,0,0,195874740,0,0
2020-01-08,Nigeria,NG,0,0,195874740,0,0
2020-01-09,Nigeria,NG,0,0,195874740,0,0
2020-01-10,Nigeria,NG,0,0,195874740,0,0
2020-01-11,Nigeria,NG,0,0,195874740,0,0
2020-01-12,Nigeria,NG,0,0,195874740,0,0
2020-01-13,Nigeria,NG,0,0,195874740,0,0
2020-01-14,Nigeria,NG,0,0,195874740,0,0
2020-01-15,Nigeria,NG,0,0,195874740,0,0
2020-01-16,Nigeria,NG,0,0,195874740,0,0
2020-01-17,Nigeria,NG,0,0,195874740,0,0
2020-01-18,Nigeria,NG,0,0,195874740,0,0
2020-01-19,Nigeria,NG,0,0,195874740,0,0
2020-01-20,Nigeria,NG,0,0,195874740,0,0
2020-01-21,Nigeria,NG,0,0,195874740,0,0
2020-01-22,Nigeria,NG,0,0,195874740,0,0
2020-01-23,Nigeria,NG,0,0,195874740,0,0
2020-01-24,Nigeria,NG,0,0,195874740,0,0
2020-01-25,Nigeria,NG,0,0,195874740,0,0
2020-01-26,Nigeria,NG,0,0,195874740,0,0
2020-01-27,Nigeria,NG,0,0,195874740,0,0
2020-01-28,Nigeria,NG,0,0,195874740,0,0
2020-01-29,Nigeria,NG,0,0,195874740,0,0
2020-01-30,Nigeria,NG,0,0,195874740,0,0
2020-01-31,Nigeria,NG,0,0,195874740,0,0
2020-02-01,Nigeria,NG,0,0,195874740,0,0
2020-02-02,Nigeria,NG,0,0,195874740,0,0
2020-02-03,Nigeria,NG,0,0,195874740,0,0
2020-02-04,Nigeria,NG,0,0,195874740,0,0
2020-02-05,Nigeria,NG,0,0,195874740,0,0
2020-02-06,Nigeria,NG,0,0,195874740,0,0
2020-02-07,Nigeria,NG,0,0,195874740,0,0
2020-02-08,Nigeria,NG,0,0,195874740,0,0
2020-02-09,Nigeria,NG,0,0,195874740,0,0
2020-02-10,Nigeria,NG,0,0,195874740,0,0
2020-02-11,Nigeria,NG,0,0,195874740,0,0
2020-02-12,Nigeria,NG,0,0,195874740,0,0
2020-02-13,Nigeria,NG,0,0,195874740,0,0
2020-02-14,Nigeria,NG,0,0,195874740,0,0
2020-02-15,Nigeria,NG,0,0,195874740,0,0
2020-02-16,Nigeria,NG,0,0,195874740,0,0
2020-02-17,Nigeria,NG,0,0,195874740,0,0
2020-02-18,Nigeria,NG,0,0,195874740,0,0
2020-02-19,Nigeria,NG,0,0,195874740,0,0
2020-02-20,Nigeria,NG,0,0,195874740,0,0
2020-02-21,Nigeria,NG,0,0,195874740,0,0
2020-02-22,Nigeria,NG,0,0,195874740,0,0
2020-02-23,Nigeria,NG,0,0,195874740,0,0
2020-02-24,Nigeria,NG,0,0,195874740,0,0
2020-02-25,Nigeria,NG,0,0,195874740,0,0
2020-02-26,Nigeria,NG,0,0,195874740,0,0
2020-02-27,Nigeria,NG,0,0,195874740,0,0
2020-02-28,Nigeria,NG,1,0,195874740,1,0
2020-02-29,Nigeria,NG,0,0,195874740,1,0
2020-03-01,Nigeria,NG,0,0,195874740,1,0
2020-03-02,Nigeria,NG,0,0,195874740,1,0
2020-03-10,Nigeria,NG,1,0,195874740,2,0
2020-03-15,Nigeria,NG,0,0,195874740,2,0
2020-03-16,Nigeria,NG,0,0,195874740,2,0
2020-03-17,Nigeria,NG,0,0,195874740,2,0
2020-03-18,Nigeria,NG,1,0,195874740,3,0
2020-03-19,Nigeria,NG,5,0,195874740,8,0
2020-03-20,Nigeria,NG,0,0,195874740,8,0
2020-03-21,Nigeria,NG,4,0,195874740,12,0
2020-03-22,Nigeria,NG,10,0,195874740,22,0
2020-03-23,Nigeria,NG,8,0,195874740,30,0
2020-03-24,Nigeria,NG,10,1,195874740,40,1
2020-03-25,Nigeria,NG,4,0,195874740,44,1
2020-03-26,Nigeria,NG,7,0,195874740,51,1
2020-03-27,Nigeria,NG,14,0,195874740,65,1
2020-03-28,Nigeria,NG,16,0,195874740,81,1
2020-03-29,Nigeria,NG,16,0,195874740,97,1
2020-03-30,Nigeria,NG,0,0,195874740,97,1
2020-03-31,Nigeria,NG,34,1,195874740,131,2
2020-04-01,Nigeria,NG,0,0,195874740,131,2
2020-04-02,Nigeria,NG,20,0,195874740,151,2
2020-04-03,Nigeria,NG,23,0,195874740,174,2
2020-04-04,Nigeria,NG,16,0,195874740,190,2
2020-04-05,Nigeria,NG,20,2,195874740,210,4
2020-04-06,Nigeria,NG,22,1,195874740,232,5
2020-04-07,Nigeria,NG,6,0,195874740,238,5
2020-04-08,Nigeria,NG,16,1,195874740,254,6
2020-04-09,Nigeria,NG,22,0,195874740,276,6
2020-04-10,Nigeria,NG,12,1,195874740,288,7
2020-04-11,Nigeria,NG,17,0,195874740,305,7
2020-04-12,Nigeria,NG,13,3,195874740,318,10
2020-04-13,Nigeria,NG,5,0,195874740,323,10
2020-04-14,Nigeria,NG,20,0,195874740,343,10
2020-04-15,Nigeria,NG,30,1,195874740,373,11
2020-04-16,Nigeria,NG,34,1,195874740,407,12
2020-04-17,Nigeria,NG,35,1,195874740,442,13
2020-04-18,Nigeria,NG,51,4,195874740,493,17
2020-04-19,Nigeria,NG,49,2,195874740,542,19
2020-04-20,Nigeria,NG,85,2,195874740,627,21
2020-04-21,Nigeria,NG,38,1,195874740,665,22
2020-04-22,Nigeria,NG,117,3,195874740,782,25
2020-04-23,Nigeria,NG,91,3,195874740,873,28
2020-04-24,Nigeria,NG,108,3,195874740,981,31
2020-04-25,Nigeria,NG,114,1,195874740,1095,32
2020-04-26,Nigeria,NG,87,3,195874740,1182,35
2020-04-27,Nigeria,NG,91,5,195874740,1273,40
2020-04-28,Nigeria,NG,64,0,195874740,1337,40
2020-04-29,Nigeria,NG,195,4,195874740,1532,44
2020-04-30,Nigeria,NG,196,7,195874740,1728,51
2020-05-01,Nigeria,NG,204,7,195874740,1932,58
2020-05-02,Nigeria,NG,238,10,195874740,2170,68
2020-05-03,Nigeria,NG,218,17,195874740,2388,85
2020-03-19,Nicaragua,NI,1,0,6465513,1,0
2020-03-20,Nicaragua,NI,0,0,6465513,1,0
2020-03-21,Nicaragua,NI,1,0,6465513,2,0
2020-03-22,Nicaragua,NI,0,0,6465513,2,0
2020-03-23,Nicaragua,NI,0,0,6465513,2,0
2020-03-24,Nicaragua,NI,0,0,6465513,2,0
2020-03-25,Nicaragua,NI,0,0,6465513,2,0
2020-03-26,Nicaragua,NI,0,0,6465513,2,0
2020-03-27,Nicaragua,NI,0,0,6465513,2,0
2020-03-28,Nicaragua,NI,0,1,6465513,2,1
2020-03-29,Nicaragua,NI,2,0,6465513,4,1
2020-03-30,Nicaragua,NI,0,0,6465513,4,1
2020-03-31,Nicaragua,NI,0,0,6465513,4,1
2020-04-01,Nicaragua,NI,0,0,6465513,4,1
2020-04-02,Nicaragua,NI,1,0,6465513,5,1
2020-04-03,Nicaragua,NI,0,0,6465513,5,1
2020-04-04,Nicaragua,NI,0,0,6465513,5,1
2020-04-05,Nicaragua,NI,0,0,6465513,5,1
2020-04-06,Nicaragua,NI,0,0,6465513,5,1
2020-04-07,Nicaragua,NI,1,0,6465513,6,1
2020-04-08,Nicaragua,NI,0,0,6465513,6,1
2020-04-09,Nicaragua,NI,0,0,6465513,6,1
2020-04-10,Nicaragua,NI,0,0,6465513,6,1
2020-04-11,Nicaragua,NI,1,0,6465513,7,1
2020-04-12,Nicaragua,NI,0,0,6465513,7,1
2020-04-13,Nicaragua,NI,2,0,6465513,9,1
2020-04-14,Nicaragua,NI,0,0,6465513,9,1
2020-04-15,Nicaragua,NI,0,0,6465513,9,1
2020-04-16,Nicaragua,NI,0,0,6465513,9,1
2020-04-17,Nicaragua,NI,0,0,6465513,9,1
2020-04-18,Nicaragua,NI,0,0,6465513,9,1
2020-04-19,Nicaragua,NI,0,0,6465513,9,1
2020-04-20,Nicaragua,NI,0,0,6465513,9,1
2020-04-21,Nicaragua,NI,0,1,6465513,9,2
2020-04-22,Nicaragua,NI,1,0,6465513,10,2
2020-04-23,Nicaragua,NI,0,0,6465513,10,2
2020-04-24,Nicaragua,NI,0,0,6465513,10,2
2020-04-25,Nicaragua,NI,1,1,6465513,11,3
2020-04-26,Nicaragua,NI,1,0,6465513,12,3
2020-04-27,Nicaragua,NI,1,0,6465513,13,3
2020-04-28,Nicaragua,NI,0,0,6465513,13,3
2020-04-29,Nicaragua,NI,0,0,6465513,13,3
2020-04-30,Nicaragua,NI,1,1,6465513,14,4
2020-05-01,Nicaragua,NI,0,0,6465513,14,4
2020-05-02,Nicaragua,NI,0,0,6465513,14,4
2020-05-03,Nicaragua,NI,0,0,6465513,14,4
2019-12-31,Netherlands,NL,0,0,17231017,0,0
2020-01-01,Netherlands,NL,0,0,17231017,0,0
2020-01-02,Netherlands,NL,0,0,17231017,0,0
2020-01-03,Netherlands,NL,0,0,17231017,0,0
2020-01-04,Netherlands,NL,0,0,17231017,0,0
2020-01-05,Netherlands,NL,0,0,17231017,0,0
2020-01-06,Netherlands,NL,0,0,17231017,0,0
2020-01-07,Netherlands,NL,0,0,17231017,0,0
2020-01-08,Netherlands,NL,0,0,17231017,0,0
2020-01-09,Netherlands,NL,0,0,17231017,0,0
2020-01-10,Netherlands,NL,0,0,17231017,0,0
2020-01-11,Netherlands,NL,0,0,17231017,0,0
2020-01-12,Netherlands,NL,0,0,17231017,0,0
2020-01-13,Netherlands,NL,0,0,17231017,0,0
2020-01-14,Netherlands,NL,0,0,17231017,0,0
2020-01-15,Netherlands,NL,0,0,17231017,0,0
2020-01-16,Netherlands,NL,0,0,17231017,0,0
2020-01-17,Netherlands,NL,0,0,17231017,0,0
2020-01-18,Netherlands,NL,0,0,17231017,0,0
2020-01-19,Netherlands,NL,0,0,17231017,0,0
2020-01-20,Netherlands,NL,0,0,17231017,0,0
2020-01-21,Netherlands,NL,0,0,17231017,0,0
2020-01-22,Netherlands,NL,0,0,17231017,0,0
2020-01-23,Netherlands,NL,0,0,17231017,0,0
2020-01-24,Netherlands,NL,0,0,17231017,0,0
2020-01-25,Netherlands,NL,0,0,17231017,0,0
2020-01-26,Netherlands,NL,0,0,17231017,0,0
2020-01-27,Netherlands,NL,0,0,17231017,0,0
2020-01-28,Netherlands,NL,0,0,17231017,0,0
2020-01-29,Netherlands,NL,0,0,17231017,0,0
2020-01-30,Netherlands,NL,0,0,17231017,0,0
2020-01-31,Netherlands,NL,0,0,17231017,0,0
2020-02-01,Netherlands,NL,0,0,17231017,0,0
2020-02-02,Netherlands,NL,0,0,17231017,0,0
2020-02-03,Netherlands,NL,0,0,17231017,0,0
2020-02-04,Netherlands,NL,0,0,17231017,0,0
2020-02-05,Netherlands,NL,0,0,17231017,0,0
2020-02-06,Netherlands,NL,0,0,17231017,0,0
2020-02-07,Netherlands,NL,0,0,17231017,0,0
2020-02-08,Netherlands,NL,0,0,17231017,0,0
2020-02-09,Netherlands,NL,0,0,17231017,0,0
2020-02-10,Netherlands,NL,0,0,17231017,0,0
2020-02-11,Netherlands,NL,0,0,17231017,0,0
2020-02-12,Netherlands,NL,0,0,17231017,0,0
2020-02-13,Netherlands,NL,0,0,17231017,0,0
2020-02-14,Netherlands,NL,0,0,17231017,0,0
2020-02-15,Netherlands,NL,0,0,17231017,0,0
2020-02-16,Netherlands,NL,0,0,17231017,0,0
2020-02-17,Netherlands,NL,0,0,17231017,0,0
2020-02-18,Netherlands,NL,0,0,17231017,0,0
2020-02-19,Netherlands,NL,0,0,17231017,0,0
2020-02-20,Netherlands,NL,0,0,17231017,0,0
2020-02-21,Netherlands,NL,0,0,17231017,0,0
2020-02-22,Netherlands,NL,0,0,17231017,0,0
2020-02-23,Netherlands,NL,0,0,17231017,0,0
2020-02-24,Netherlands,NL,0,0,17231017,0,0
2020-02-25,Netherlands,NL,0,0,17231017,0,0
2020-02-26,Netherlands,NL,0,0,17231017,0,0
2020-02-27,Netherlands,NL,0,0,17231017,0,0
2020-02-28,Netherlands,NL,1,0,17231017,1,0
2020-02-29,Netherlands,NL,1,0,17231017,2,0
2020-03-01,Netherlands,NL,5,0,17231017,7,0
2020-03-02,Netherlands,NL,6,0,17231017,13,0
2020-03-03,Netherlands,NL,5,0,17231017,18,0
2020-03-04,Netherlands,NL,10,0,17231017,28,0
2020-03-05,Netherlands,NL,10,0,17231017,38,0
2020-03-06,Netherlands,NL,44,0,17231017,82,0
2020-03-07,Netherlands,NL,46,1,17231017,128,1
2020-03-08,Netherlands,NL,60,0,17231017,188,1
2020-03-09,Netherlands,NL,77,2,17231017,265,3
2020-03-10,Netherlands,NL,56,0,17231017,321,3
2020-03-11,Netherlands,NL,61,1,17231017,382,4
2020-03-12,Netherlands,NL,121,1,17231017,503,5
2020-03-13,Netherlands,NL,111,0,17231017,614,5
2020-03-14,Netherlands,NL,190,0,17231017,804,5
2020-03-15,Netherlands,NL,155,7,17231017,959,12
2020-03-16,Netherlands,NL,176,8,17231017,1135,20
2020-03-17,Netherlands,NL,278,4,17231017,1413,24
2020-03-18,Netherlands,NL,292,19,17231017,1705,43
2020-03-19,Netherlands,NL,346,15,17231017,2051,58
2020-03-20,Netherlands,NL,409,18,17231017,2460,76
2020-03-21,Netherlands,NL,534,30,17231017,2994,106
2020-03-22,Netherlands,NL,637,30,17231017,3631,136
2020-03-23,Netherlands,NL,573,43,17231017,4204,179
2020-03-24,Netherlands,NL,545,34,17231017,4749,213
2020-03-25,Netherlands,NL,811,63,17231017,5560,276
2020-03-26,Netherlands,NL,852,80,17231017,6412,356
2020-03-27,Netherlands,NL,1019,78,17231017,7431,434
2020-03-28,Netherlands,NL,1172,112,17231017,8603,546
2020-03-29,Netherlands,NL,1159,93,17231017,9762,639
2020-03-30,Netherlands,NL,1104,132,17231017,10866,771
2020-03-31,Netherlands,NL,884,93,17231017,11750,864
2020-04-01,Netherlands,NL,845,175,17231017,12595,1039
2020-04-02,Netherlands,NL,1019,134,17231017,13614,1173
2020-04-03,Netherlands,NL,1083,166,17231017,14697,1339
2020-04-04,Netherlands,NL,1026,148,17231017,15723,1487
2020-04-05,Netherlands,NL,904,164,17231017,16627,1651
2020-04-06,Netherlands,NL,1224,115,17231017,17851,1766
2020-04-07,Netherlands,NL,952,101,17231017,18803,1867
2020-04-08,Netherlands,NL,777,234,17231017,19580,2101
2020-04-09,Netherlands,NL,969,147,17231017,20549,2248
2020-04-10,Netherlands,NL,1213,148,17231017,21762,2396
2020-04-11,Netherlands,NL,1335,115,17231017,23097,2511
2020-04-12,Netherlands,NL,1316,132,17231017,24413,2643
2020-04-13,Netherlands,NL,1174,94,17231017,25587,2737
2020-04-14,Netherlands,NL,964,86,17231017,26551,2823
2020-04-15,Netherlands,NL,868,122,17231017,27419,2945
2020-04-16,Netherlands,NL,734,189,17231017,28153,3134
2020-04-17,Netherlands,NL,1061,181,17231017,29214,3315
2020-04-18,Netherlands,NL,1235,144,17231017,30449,3459
2020-04-19,Netherlands,NL,1140,142,17231017,31589,3601
2020-04-20,Netherlands,NL,1066,83,17231017,32655,3684
2020-04-21,Netherlands,NL,750,67,17231017,33405,3751
2020-04-22,Netherlands,NL,729,165,17231017,34134,3916
2020-04-23,Netherlands,NL,708,138,17231017,34842,4054
2020-04-24,Netherlands,NL,887,123,17231017,35729,4177
2020-04-25,Netherlands,NL,806,112,17231017,36535,4289
2020-04-26,Netherlands,NL,655,120,17231017,37190,4409
2020-04-27,Netherlands,NL,655,66,17231017,37845,4475
2020-04-28,Netherlands,NL,400,43,17231017,38245,4518
2020-04-29,Netherlands,NL,171,48,17231017,38416,4566
2020-04-30,Netherlands,NL,386,145,17231017,38802,4711
2020-05-01,Netherlands,NL,514,84,17231017,39316,4795
2020-05-02,Netherlands,NL,475,98,17231017,39791,4893
2020-05-03,Netherlands,NL,445,94,17231017,40236,4987
2019-12-31,Norway,NO,0,0,5314336,0,0
2020-01-01,Norway,NO,0,0,5314336,0,0
2020-01-02,Norway,NO,0,0,5314336,0,0
2020-01-03,Norway,NO,0,0,5314336,0,0
2020-01-04,Norway,NO,0,0,5314336,0,0
2020-01-05,Norway,NO,0,0,5314336,0,0
2020-01-06,Norway,NO,0,0,5314336,0,0
2020-01-07,Norway,NO,0,0,5314336,0,0
2020-01-08,Norway,NO,0,0,5314336,0,0
2020-01-09,Norway,NO,0,0,5314336,0,0
2020-01-10,Norway,NO,0,0,5314336,0,0
2020-01-11,Norway,NO,0,0,5314336,0,0
2020-01-12,Norway,NO,0,0,5314336,0,0
2020-01-13,Norway,NO,0,0,5314336,0,0
2020-01-14,Norway,NO,0,0,5314336,0,0
2020-01-15,Norway,NO,0,0,5314336,0,0
2020-01-16,Norway,NO,0,0,5314336,0,0
2020-01-17,Norway,NO,0,0,5314336,0,0
2020-01-18,Norway,NO,0,0,5314336,0,0
2020-01-19,Norway,NO,0,0,5314336,0,0
2020-01-20,Norway,NO,0,0,5314336,0,0
2020-01-21,Norway,NO,0,0,5314336,0,0
2020-01-22,Norway,NO,0,0,5314336,0,0
2020-01-23,Norway,NO,0,0,5314336,0,0
2020-01-24,Norway,NO,0,0,5314336,0,0
2020-01-25,Norway,NO,0,0,5314336,0,0
2020-01-26,Norway,NO,0,0,5314336,0,0
2020-01-27,Norway,NO,0,0,5314336,0,0
2020-01-28,Norway,NO,0,0,5314336,0,0
2020-01-29,Norway,NO,0,0,5314336,0,0
2020-01-30,Norway,NO,0,0,5314336,0,0
2020-01-31,Norway,NO,0,0,5314336,0,0
2020-02-01,Norway,NO,0,0,5314336,0,0
2020-02-02,Norway,NO,0,0,5314336,0,0
2020-02-03,Norway,NO,0,0,5314336,0,0
2020-02-04,Norway,NO,0,0,5314336,0,0
2020-02-05,Norway,NO,0,0,5314336,0,0
2020-02-06,Norway,NO,0,0,5314336,0,0
2020-02-07,Norway,NO,0,0,5314336,0,0
2020-02-08,Norway,NO,0,0,5314336,0,0
2020-02-09,Norway,NO,0,0,5314336,0,0
2020-02-10,Norway,NO,0,0,5314336,0,0
2020-02-11,Norway,NO,0,0,5314336,0,0
2020-02-12,Norway,NO,0,0,5314336,0,0
2020-02-13,Norway,NO,0,0,5314336,0,0
2020-02-14,Norway,NO,0,0,5314336,0,0
2020-02-15,Norway,NO,0,0,5314336,0,0
2020-02-16,Norway,NO,0,0,5314336,0,0
2020-02-17,Norway,NO,0,0,5314336,0,0
2020-02-18,Norway,NO,0,0,5314336,0,0
2020-02-19,Norway,NO,0,0,5314336,0,0
2020-02-20,Norway,NO,0,0,5314336,0,0
2020-02-21,Norway,NO,0,0,5314336,0,0
2020-02-22,Norway,NO,0,0,5314336,0,0
2020-02-23,Norway,NO,0,0,5314336,0,0
2020-02-24,Norway,NO,0,0,5314336,0,0
2020-02-25,Norway,NO,0,0,5314336,0,0
2020-02-26,Norway,NO,0,0,5314336,0,0
2020-02-27,Norway,NO,1,0,5314336,1,0
2020-02-28,Norway,NO,3,0,5314336,4,0
2020-02-29,Norway,NO,2,0,5314336,6,0
2020-03-01,Norway,NO,9,0,5314336,15,0
2020-03-02,Norway,NO,4,0,5314336,19,0
2020-03-03,Norway,NO,6,0,5314336,25,0
2020-03-04,Norway,NO,8,0,5314336,33,0
2020-03-05,Norway,NO,23,0,5314336,56,0
2020-03-06,Norway,NO,30,0,5314336,86,0
2020-03-07,Norway,NO,27,0,5314336,113,0
2020-03-08,Norway,NO,34,0,5314336,147,0
2020-03-09,Norway,NO,22,0,5314336,169,0
2020-03-10,Norway,NO,23,0,5314336,192,0
2020-03-11,Norway,NO,85,0,5314336,277,0
2020-03-12,Norway,NO,212,0,5314336,489,0
2020-03-13,Norway,NO,132,1,5314336,621,1
2020-03-14,Norway,NO,0,0,5314336,621,1
2020-03-15,Norway,NO,286,0,5314336,907,1
2020-03-16,Norway,NO,170,0,5314336,1077,1
2020-03-17,Norway,NO,92,2,5314336,1169,3
2020-03-18,Norway,NO,139,0,5314336,1308,3
2020-03-19,Norway,NO,115,0,5314336,1423,3
2020-03-20,Norway,NO,129,3,5314336,1552,6
2020-03-21,Norway,NO,190,1,5314336,1742,7
2020-03-22,Norway,NO,184,0,5314336,1926,7
2020-03-23,Norway,NO,206,0,5314336,2132,7
2020-03-24,Norway,NO,239,1,5314336,2371,8
2020-03-25,Norway,NO,195,2,5314336,2566,10
2020-03-26,Norway,NO,350,2,5314336,2916,12
2020-03-27,Norway,NO,240,2,5314336,3156,14
2020-03-28,Norway,NO,425,2,5314336,3581,16
2020-03-29,Norway,NO,264,4,5314336,3845,20
2020-03-30,Norway,NO,257,2,5314336,4102,22
2020-03-31,Norway,NO,124,4,5314336,4226,26
2020-04-01,Norway,NO,221,2,5314336,4447,28
2020-04-02,Norway,NO,218,4,5314336,4665,32
2020-04-03,Norway,NO,270,10,5314336,4935,42
2020-04-04,Norway,NO,273,2,5314336,5208,44
2020-04-05,Norway,NO,302,6,5314336,5510,50
2020-04-06,Norway,NO,130,8,5314336,5640,58
2020-04-07,Norway,NO,115,1,5314336,5755,59
2020-04-08,Norway,NO,108,10,5314336,5863,69
2020-04-09,Norway,NO,147,11,5314336,6010,80
2020-04-10,Norway,NO,150,8,5314336,6160,88
2020-04-11,Norway,NO,84,4,5314336,6244,92
2020-04-12,Norway,NO,76,6,5314336,6320,98
2020-04-13,Norway,NO,95,5,5314336,6415,103
2020-04-14,Norway,NO,73,11,5314336,6488,114
2020-04-15,Norway,NO,78,13,5314336,6566,127
2020-04-16,Norway,NO,111,3,5314336,6677,130
2020-04-17,Norway,NO,114,6,5314336,6791,136
2020-04-18,Norway,NO,0,0,5314336,6791,136
2020-04-19,Norway,NO,193,12,5314336,6984,148
2020-04-20,Norway,NO,84,6,5314336,7068,154
2020-04-21,Norway,NO,45,0,5314336,7113,154
2020-04-22,Norway,NO,53,9,5314336,7166,163
2020-04-23,Norway,NO,84,6,5314336,7250,169
2020-04-24,Norway,NO,95,11,5314336,7345,180
2020-04-25,Norway,NO,63,11,5314336,7408,191
2020-04-26,Norway,NO,59,2,5314336,7467,193
2020-04-27,Norway,NO,38,0,5314336,7505,193
2020-04-28,Norway,NO,28,0,5314336,7533,193
2020-04-29,Norway,NO,72,2,5314336,7605,195
2020-04-30,Norway,NO,62,7,5314336,7667,202
2020-05-01,Norway,NO,43,2,5314336,7710,204
2020-05-02,Norway,NO,49,0,5314336,7759,204
2020-05-03,Norway,NO,0,0,5314336,7759,204
2019-12-31,Nepal,NP,0,0,28087871,0,0
2020-01-01,Nepal,NP,0,0,28087871,0,0
2020-01-02,Nepal,NP,0,0,28087871,0,0
2020-01-03,Nepal,NP,0,0,28087871,0,0
2020-01-04,Nepal,NP,0,0,28087871,0,0
2020-01-05,Nepal,NP,0,0,28087871,0,0
2020-01-06,Nepal,NP,0,0,28087871,0,0
2020-01-07,Nepal,NP,0,0,28087871,0,0
2020-01-08,Nepal,NP,0,0,28087871,0,0
2020-01-09,Nepal,NP,0,0,28087871,0,0
2020-01-10,Nepal,NP,0,0,28087871,0,0
2020-01-11,Nepal,NP,0,0,28087871,0,0
2020-01-12,Nepal,NP,0,0,28087871,0,0
2020-01-13,Nepal,NP,0,0,28087871,0,0
2020-01-14,Nepal,NP,0,0,28087871,0,0
2020-01-15,Nepal,NP,0,0,28087871,0,0
2020-01-16,Nepal,NP,0,0,28087871,0,0
2020-01-17,Nepal,NP,0,0,28087871,0,0
2020-01-18,Nepal,NP,0,0,28087871,0,0
2020-01-19,Nepal,NP,0,0,28087871,0,0
2020-01-20,Nepal,NP,0,0,28087871,0,0
2020-01-21,Nepal,NP,0,0,28087871,0,0
2020-01-22,Nepal,NP,0,0,28087871,0,0
2020-01-23,Nepal,NP,0,0,28087871,0,0
2020-01-24,Nepal,NP,0,0,28087871,0,0
2020-01-25,Nepal,NP,1,0,28087871,1,0
2020-01-26,Nepal,NP,0,0,28087871,1,0
2020-01-27,Nepal,NP,0,0,28087871,1,0
2020-01-28,Nepal,NP,0,0,28087871,1,0
2020-01-29,Nepal,NP,0,0,28087871,1,0
2020-01-30,Nepal,NP,0,0,28087871,1,0
2020-01-31,Nepal,NP,0,0,28087871,1,0
2020-02-01,Nepal,NP,0,0,28087871,1,0
2020-02-02,Nepal,NP,0,0,28087871,1,0
2020-02-03,Nepal,NP,0,0,28087871,1,0
2020-02-04,Nepal,NP,0,0,28087871,1,0
2020-02-05,Nepal,NP,0,0,28087871,1,0
2020-02-06,Nepal,NP,0,0,28087871,1,0
2020-02-07,Nepal,NP,0,0,28087871,1,0
2020-02-08,Nepal,NP,0,0,28087871,1,0
2020-02-09,Nepal,NP,0,0,28087871,1,0
2020-02-10,Nepal,NP,0,0,28087871,1,0
2020-02-11,Nepal,NP,0,0,28087871,1,0
2020-02-12,Nepal,NP,0,0,28087871,1,0
2020-02-13,Nepal,NP,0,0,28087871,1,0
2020-02-14,Nepal,NP,0,0,28087871,1,0
2020-02-15,Nepal,NP,0,0,28087871,1,0
2020-02-16,Nepal,NP,0,0,28087871,1,0
2020-02-17,Nepal,NP,0,0,28087871,1,0
2020-02-18,Nepal,NP,0,0,28087871,1,0
2020-02-19,Nepal,NP,0,0,28087871,1,0
2020-02-20,Nepal,NP,0,0,28087871,1,0
2020-02-21,Nepal,NP,0,0,28087871,1,0
2020-02-22,Nepal,NP,0,0,28087871,1,0
2020-02-23,Nepal,NP,0,0,28087871,1,0
2020-02-24,Nepal,NP,0,0,28087871,1,0
2020-02-25,Nepal,NP,0,0,28087871,1,0
2020-02-26,Nepal,NP,0,0,28087871,1,0
2020-02-27,Nepal,NP,0,0,28087871,1,0
2020-02-28,Nepal,NP,0,0,28087871,1,0
2020-02-29,Nepal,NP,0,0,28087871,1,0
2020-03-01,Nepal,NP,0,0,28087871,1,0
2020-03-02,Nepal,NP,0,0,28087871,1,0
2020-03-15,Nepal,NP,0,0,28087871,1,0
2020-03-17,Nepal,NP,0,0,28087871,1,0
2020-03-18,Nepal,NP,0,0,28087871,1,0
2020-03-19,Nepal,NP,0,0,28087871,1,0
2020-03-20,Nepal,NP,0,0,28087871,1,0
2020-03-21,Nepal,NP,0,0,28087871,1,0
2020-03-22,Nepal,NP,0,0,28087871,1,0
2020-03-23,Nepal,NP,0,0,28087871,1,0
2020-03-24,Nepal,NP,1,0,28087871,2,0
2020-03-25,Nepal,NP,1,0,28087871,3,0
2020-03-26,Nepal,NP,0,0,28087871,3,0
2020-03-27,Nepal,NP,0,0,28087871,3,0
2020-03-28,Nepal,NP,0,0,28087871,3,0
2020-03-29,Nepal,NP,2,0,28087871,5,0
2020-03-30,Nepal,NP,0,0,28087871,5,0
2020-03-31,Nepal,NP,0,0,28087871,5,0
2020-04-01,Nepal,NP,0,0,28087871,5,0
2020-04-02,Nepal,NP,0,0,28087871,5,0
2020-04-03,Nepal,NP,0,0,28087871,5,0
2020-04-04,Nepal,NP,1,0,28087871,6,0
2020-04-05,Nepal,NP,0,0,28087871,6,0
2020-04-06,Nepal,NP,3,0,28087871,9,0
2020-04-07,Nepal,NP,0,0,28087871,9,0
2020-04-08,Nepal,NP,0,0,28087871,9,0
2020-04-09,Nepal,NP,0,0,28087871,9,0
2020-04-10,Nepal,NP,0,0,28087871,9,0
2020-04-11,Nepal,NP,0,0,28087871,9,0
2020-04-12,Nepal,NP,0,0,28087871,9,0
2020-04-13,Nepal,NP,3,0,28087871,12,0
2020-04-14,Nepal,NP,2,0,28087871,14,0
2020-04-15,Nepal,NP,2,0,28087871,16,0
2020-04-16,Nepal,NP,0,0,28087871,16,0
2020-04-17,Nepal,NP,0,0,28087871,16,0
2020-04-18,Nepal,NP,14,0,28087871,30,0
2020-04-19,Nepal,NP,1,0,28087871,31,0
2020-04-20,Nepal,NP,0,0,28087871,31,0
2020-04-21,Nepal,NP,0,0,28087871,31,0
2020-04-22,Nepal,NP,11,0,28087871,42,0
2020-04-23,Nepal,NP,3,0,28087871,45,0
2020-04-24,Nepal,NP,3,0,28087871,48,0
2020-04-25,Nepal,NP,1,0,28087871,49,0
2020-04-26,Nepal,NP,0,0,28087871,49,0
2020-04-27,Nepal,NP,3,0,28087871,52,0
2020-04-28,Nepal,NP,0,0,28087871,52,0
2020-04-29,Nepal,NP,2,0,28087871,54,0
2020-04-30,Nepal,NP,3,0,28087871,57,0
2020-05-01,Nepal,NP,0,0,28087871,57,0
2020-05-02,Nepal,NP,2,0,28087871,59,0
2020-05-03,Nepal,NP,0,0,28087871,59,0
2019-12-31,New_Zealand,NZ,0,0,4885500,0,0
2020-01-01,New_Zealand,NZ,0,0,4885500,0,0
2020-01-02,New_Zealand,NZ,0,0,4885500,0,0
2020-01-03,New_Zealand,NZ,0,0,4885500,0,0
2020-01-04,New_Zealand,NZ,0,0,4885500,0,0
2020-01-05,New_Zealand,NZ,0,0,4885500,0,0
2020-01-06,New_Zealand,NZ,0,0,4885500,0,0
2020-01-07,New_Zealand,NZ,0,0,4885500,0,0
2020-01-08,New_Zealand,NZ,0,0,4885500,0,0
2020-01-09,New_Zealand,NZ,0,0,4885500,0,0
2020-01-10,New_Zealand,NZ,0,0,4885500,0,0
2020-01-11,New_Zealand,NZ,0,0,4885500,0,0
2020-01-12,New_Zealand,NZ,0,0,4885500,0,0
2020-01-13,New_Zealand,NZ,0,0,4885500,0,0
2020-01-14,New_Zealand,NZ,0,0,4885500,0,0
2020-01-15,New_Zealand,NZ,0,0,4885500,0,0
2020-01-16,New_Zealand,NZ,0,0,4885500,0,0
2020-01-17,New_Zealand,NZ,0,0,4885500,0,0
2020-01-18,New_Zealand,NZ,0,0,4885500,0,0
2020-01-19,New_Zealand,NZ,0,0,4885500,0,0
2020-01-20,New_Zealand,NZ,0,0,4885500,0,0
2020-01-21,New_Zealand,NZ,0,0,4885500,0,0
2020-01-22,New_Zealand,NZ,0,0,4885500,0,0
2020-01-23,New_Zealand,NZ,0,0,4885500,0,0
2020-01-24,New_Zealand,NZ,0,0,4885500,0,0
2020-01-25,New_Zealand,NZ,0,0,4885500,0,0
2020-01-26,New_Zealand,NZ,0,0,4885500,0,0
2020-01-27,New_Zealand,NZ,0,0,4885500,0,0
2020-01-28,New_Zealand,NZ,0,0,4885500,0,0
2020-01-29,New_Zealand,NZ,0,0,4885500,0,0
2020-01-30,New_Zealand,NZ,0,0,4885500,0,0
2020-01-31,New_Zealand,NZ,0,0,4885500,0,0
2020-02-01,New_Zealand,NZ,0,0,4885500,0,0
2020-02-02,New_Zealand,NZ,0,0,4885500,0,0
2020-02-03,New_Zealand,NZ,0,0,4885500,0,0
2020-02-04,New_Zealand,NZ,0,0,4885500,0,0
2020-02-05,New_Zealand,NZ,0,0,4885500,0,0
2020-02-06,New_Zealand,NZ,0,0,4885500,0,0
2020-02-07,New_Zealand,NZ,0,0,4885500,0,0
2020-02-08,New_Zealand,NZ,0,0,4885500,0,0
2020-02-09,New_Zealand,NZ,0,0,4885500,0,0
2020-02-10,New_Zealand,NZ,0,0,4885500,0,0
2020-02-11,New_Zealand,NZ,0,0,4885500,0,0
2020-02-12,New_Zealand,NZ,0,0,4885500,0,0
2020-02-13,New_Zealand,NZ,0,0,4885500,0,0
2020-02-14,New_Zealand,NZ,0,0,4885500,0,0
2020-02-15,New_Zealand,NZ,0,0,4885500,0,0
2020-02-16,New_Zealand,NZ,0,0,4885500,0,0
2020-02-17,New_Zealand,NZ,0,0,4885500,0,0
2020-02-18,New_Zealand,NZ,0,0,4885500,0,0
2020-02-19,New_Zealand,NZ,0,0,4885500,0,0
2020-02-20,New_Zealand,NZ,0,0,4885500,0,0
2020-02-21,New_Zealand,NZ,0,0,4885500,0,0
2020-02-22,New_Zealand,NZ,0,0,4885500,0,0
2020-02-23,New_Zealand,NZ,0,0,4885500,0,0
2020-02-24,New_Zealand,NZ,0,0,4885500,0,0
2020-02-25,New_Zealand,NZ,0,0,4885500,0,0
2020-02-26,New_Zealand,NZ,0,0,4885500,0,0
2020-02-27,New_Zealand,NZ,0,0,4885500,0,0
2020-02-28,New_Zealand,NZ,1,0,4885500,1,0
2020-02-29,New_Zealand,NZ,0,0,4885500,1,0
2020-03-01,New_Zealand,NZ,0,0,4885500,1,0
2020-03-02,New_Zealand,NZ,0,0,4885500,1,0
2020-03-04,New_Zealand,NZ,1,0,4885500,2,0
2020-03-05,New_Zealand,NZ,1,0,4885500,3,0
2020-03-06,New_Zealand,NZ,1,0,4885500,4,0
2020-03-07,New_Zealand,NZ,1,0,4885500,5,0
2020-03-14,New_Zealand,NZ,1,0,4885500,6,0
2020-03-15,New_Zealand,NZ,2,0,4885500,8,0
2020-03-18,New_Zealand,NZ,12,0,4885500,20,0
2020-03-19,New_Zealand,NZ,8,0,4885500,28,0
2020-03-20,New_Zealand,NZ,11,0,4885500,39,0
2020-03-21,New_Zealand,NZ,14,0,4885500,53,0
2020-03-22,New_Zealand,NZ,13,0,4885500,66,0
2020-03-23,New_Zealand,NZ,36,0,4885500,102,0
2020-03-24,New_Zealand,NZ,40,0,4885500,142,0
2020-03-25,New_Zealand,NZ,47,0,4885500,189,0
2020-03-26,New_Zealand,NZ,73,0,4885500,262,0
2020-03-27,New_Zealand,NZ,76,0,4885500,338,0
2020-03-28,New_Zealand,NZ,78,0,4885500,416,0
2020-03-29,New_Zealand,NZ,60,1,4885500,476,1
2020-03-30,New_Zealand,NZ,76,0,4885500,552,1
2020-03-31,New_Zealand,NZ,95,0,4885500,647,1
2020-04-01,New_Zealand,NZ,0,0,4885500,647,1
2020-04-02,New_Zealand,NZ,76,0,4885500,723,1
2020-04-03,New_Zealand,NZ,49,0,4885500,772,1
2020-04-04,New_Zealand,NZ,52,0,4885500,824,1
2020-04-05,New_Zealand,NZ,48,0,4885500,872,1
2020-04-06,New_Zealand,NZ,39,0,4885500,911,1
2020-04-07,New_Zealand,NZ,32,0,4885500,943,1
2020-04-08,New_Zealand,NZ,26,0,4885500,969,1
2020-04-09,New_Zealand,NZ,23,0,4885500,992,1
2020-04-10,New_Zealand,NZ,23,1,4885500,1015,2
2020-04-11,New_Zealand,NZ,20,2,4885500,1035,4
2020-04-12,New_Zealand,NZ,14,0,4885500,1049,4
2020-04-13,New_Zealand,NZ,15,1,4885500,1064,5
2020-04-14,New_Zealand,NZ,8,4,4885500,1072,9
2020-04-15,New_Zealand,NZ,6,0,4885500,1078,9
2020-04-16,New_Zealand,NZ,6,0,4885500,1084,9
2020-04-17,New_Zealand,NZ,2,2,4885500,1086,11
2020-04-18,New_Zealand,NZ,8,0,4885500,1094,11
2020-04-19,New_Zealand,NZ,4,1,4885500,1098,12
2020-04-20,New_Zealand,NZ,7,0,4885500,1105,12
2020-04-21,New_Zealand,NZ,2,1,4885500,1107,13
2020-04-22,New_Zealand,NZ,5,1,4885500,1112,14
2020-04-23,New_Zealand,NZ,0,2,4885500,1112,16
2020-04-24,New_Zealand,NZ,2,1,4885500,1114,17
2020-04-25,New_Zealand,NZ,3,1,4885500,1117,18
2020-04-26,New_Zealand,NZ,4,0,4885500,1121,18
2020-04-27,New_Zealand,NZ,1,1,4885500,1122,19
2020-04-28,New_Zealand,NZ,2,0,4885500,1124,19
2020-04-29,New_Zealand,NZ,2,0,4885500,1126,19
2020-04-30,New_Zealand,NZ,3,0,4885500,1129,19
2020-05-01,New_Zealand,NZ,3,0,4885500,1132,19
2020-05-02,New_Zealand,NZ,2,1,4885500,1134,20
2020-05-03,New_Zealand,NZ,2,0,4885500,1136,20
2019-12-31,Oman,OM,0,0,4829483,0,0
2020-01-01,Oman,OM,0,0,4829483,0,0
2020-01-02,Oman,OM,0,0,4829483,0,0
2020-01-03,Oman,OM,0,0,4829483,0,0
2020-01-04,Oman,OM,0,0,4829483,0,0
2020-01-05,Oman,OM,0,0,4829483,0,0
2020-01-06,Oman,OM,0,0,4829483,0,0
2020-01-07,Oman,OM,0,0,4829483,0,0
2020-01-08,Oman,OM,0,0,4829483,0,0
2020-01-09,Oman,OM,0,0,4829483,0,0
2020-01-10,Oman,OM,0,0,4829483,0,0
2020-01-11,Oman,OM,0,0,4829483,0,0
2020-01-12,Oman,OM,0,0,4829483,0,0
2020-01-13,Oman,OM,0,0,4829483,0,0
2020-01-14,Oman,OM,0,0,4829483,0,0
2020-01-15,Oman,OM,0,0,4829483,0,0
2020-01-16,Oman,OM,0,0,4829483,0,0
2020-01-17,Oman,OM,0,0,4829483,0,0
2020-01-18,Oman,OM,0,0,4829483,0,0
2020-01-19,Oman,OM,0,0,4829483,0,0
2020-01-20,Oman,OM,0,0,4829483,0,0
2020-01-21,Oman,OM,0,0,4829483,0,0
2020-01-22,Oman,OM,0,0,4829483,0,0
2020-01-23,Oman,OM,0,0,4829483,0,0
2020-01-24,Oman,OM,0,0,4829483,0,0
2020-01-25,Oman,OM,0,0,4829483,0,0
2020-01-26,Oman,OM,0,0,4829483,0,0
2020-01-27,Oman,OM,0,0,4829483,0,0
2020-01-28,Oman,OM,0,0,4829483,0,0
2020-01-29,Oman,OM,0,0,4829483,0,0
2020-01-30,Oman,OM,0,0,4829483,0,0
2020-01-31,Oman,OM,0,0,4829483,0,0
2020-02-01,Oman,OM,0,0,4829483,0,0
2020-02-02,Oman,OM,0,0,4829483,0,0
2020-02-03,Oman,OM,0,0,4829483,0,0
2020-02-04,Oman,OM,0,0,4829483,0,0
2020-02-05,Oman,OM,0,0,4829483,0,0
2020-02-06,Oman,OM,0,0,4829483,0,0
2020-02-07,Oman,OM,0,0,4829483,0,0
2020-02-08,Oman,OM,0,0,4829483,0,0
2020-02-09,Oman,OM,0,0,4829483,0,0
2020-02-10,Oman,OM,0,0,4829483,0,0
2020-02-11,Oman,OM,0,0,4829483,0,0
2020-02-12,Oman,OM,0,0,4829483,0,0
2020-02-13,Oman,OM,0,0,4829483,0,0
2020-02-14,Oman,OM,0,0,4829483,0,0
2020-02-15,Oman,OM,0,0,4829483,0,0
2020-02-16,Oman,OM,0,0,4829483,0,0
2020-02-17,Oman,OM,0,0,4829483,0,0
2020-02-18,Oman,OM,0,0,4829483,0,0
2020-02-19,Oman,OM,0,0,4829483,0,0
2020-02-20,Oman,OM,0,0,4829483,0,0
2020-02-21,Oman,OM,0,0,4829483,0,0
2020-02-22,Oman,OM,0,0,4829483,0,0
2020-02-23,Oman,OM,0,0,4829483,0,0
2020-02-24,Oman,OM,0,0,4829483,0,0
2020-02-25,Oman,OM,2,0,4829483,2,0
2020-02-26,Oman,OM,2,0,4829483,4,0
2020-02-27,Oman,OM,0,0,4829483,4,0
2020-02-28,Oman,OM,2,0,4829483,6,0
2020-02-29,Oman,OM,0,0,4829483,6,0
2020-03-01,Oman,OM,0,0,4829483,6,0
2020-03-02,Oman,OM,0,0,4829483,6,0
2020-03-03,Oman,OM,1,0,4829483,7,0
2020-03-05,Oman,OM,8,0,4829483,15,0
2020-03-06,Oman,OM,1,0,4829483,16,0
2020-03-10,Oman,OM,2,0,4829483,18,0
2020-03-11,Oman,OM,0,0,4829483,18,0
2020-03-14,Oman,OM,2,0,4829483,20,0
2020-03-15,Oman,OM,0,0,4829483,20,0
2020-03-16,Oman,OM,2,0,4829483,22,0
2020-03-17,Oman,OM,2,0,4829483,24,0
2020-03-18,Oman,OM,0,0,4829483,24,0
2020-03-19,Oman,OM,15,0,4829483,39,0
2020-03-20,Oman,OM,0,0,4829483,39,0
2020-03-21,Oman,OM,9,0,4829483,48,0
2020-03-22,Oman,OM,4,0,4829483,52,0
2020-03-23,Oman,OM,3,0,4829483,55,0
2020-03-24,Oman,OM,11,0,4829483,66,0
2020-03-25,Oman,OM,18,0,4829483,84,0
2020-03-26,Oman,OM,15,0,4829483,99,0
2020-03-27,Oman,OM,10,0,4829483,109,0
2020-03-28,Oman,OM,22,0,4829483,131,0
2020-03-29,Oman,OM,21,0,4829483,152,0
2020-03-30,Oman,OM,15,0,4829483,167,0
2020-03-31,Oman,OM,12,0,4829483,179,0
2020-04-01,Oman,OM,13,1,4829483,192,1
2020-04-02,Oman,OM,18,0,4829483,210,1
2020-04-03,Oman,OM,21,0,4829483,231,1
2020-04-04,Oman,OM,0,0,4829483,231,1
2020-04-05,Oman,OM,46,1,4829483,277,2
2020-04-06,Oman,OM,21,0,4829483,298,2
2020-04-07,Oman,OM,73,0,4829483,371,2
2020-04-08,Oman,OM,48,0,4829483,419,2
2020-04-09,Oman,OM,0,0,4829483,419,2
2020-04-10,Oman,OM,38,1,4829483,457,3
2020-04-11,Oman,OM,27,0,4829483,484,3
2020-04-12,Oman,OM,62,0,4829483,546,3
2020-04-13,Oman,OM,53,1,4829483,599,4
2020-04-14,Oman,OM,214,0,4829483,813,4
2020-04-15,Oman,OM,97,0,4829483,910,4
2020-04-16,Oman,OM,0,0,4829483,910,4
2020-04-17,Oman,OM,109,0,4829483,1019,4
2020-04-18,Oman,OM,50,2,4829483,1069,6
2020-04-19,Oman,OM,111,0,4829483,1180,6
2020-04-20,Oman,OM,86,1,4829483,1266,7
2020-04-21,Oman,OM,242,1,4829483,1508,8
2020-04-22,Oman,OM,0,0,4829483,1508,8
2020-04-23,Oman,OM,106,0,4829483,1614,8
2020-04-24,Oman,OM,102,1,4829483,1716,9
2020-04-25,Oman,OM,74,1,4829483,1790,10
2020-04-26,Oman,OM,115,0,4829483,1905,10
2020-04-27,Oman,OM,93,0,4829483,1998,10
2020-04-28,Oman,OM,51,0,4829483,2049,10
2020-04-29,Oman,OM,82,0,4829483,2131,10
2020-04-30,Oman,OM,143,0,4829483,2274,10
2020-05-01,Oman,OM,74,1,4829483,2348,11
2020-05-02,Oman,OM,99,0,4829483,2447,11
2020-05-03,Oman,OM,36,1,4829483,2483,12
2020-03-10,Panama,PA,1,0,4176873,1,0
2020-03-11,Panama,PA,6,1,4176873,7,1
2020-03-12,Panama,PA,7,0,4176873,14,1
2020-03-13,Panama,PA,13,0,4176873,27,1
2020-03-14,Panama,PA,9,0,4176873,36,1
2020-03-15,Panama,PA,7,0,4176873,43,1
2020-03-16,Panama,PA,0,0,4176873,43,1
2020-03-17,Panama,PA,26,0,4176873,69,1
2020-03-18,Panama,PA,17,0,4176873,86,1
2020-03-19,Panama,PA,23,0,4176873,109,1
2020-03-20,Panama,PA,28,0,4176873,137,1
2020-03-21,Panama,PA,63,0,4176873,200,1
2020-03-22,Panama,PA,45,2,4176873,245,3
2020-03-23,Panama,PA,68,0,4176873,313,3
2020-03-24,Panama,PA,32,3,4176873,345,6
2020-03-25,Panama,PA,98,0,4176873,443,6
2020-03-26,Panama,PA,145,0,4176873,588,6
2020-03-27,Panama,PA,86,3,4176873,674,9
2020-03-28,Panama,PA,112,5,4176873,786,14
2020-03-29,Panama,PA,115,3,4176873,901,17
2020-03-30,Panama,PA,88,7,4176873,989,24
2020-03-31,Panama,PA,86,2,4176873,1075,26
2020-04-01,Panama,PA,106,4,4176873,1181,30
2020-04-02,Panama,PA,136,2,4176873,1317,32
2020-04-03,Panama,PA,158,5,4176873,1475,37
2020-04-04,Panama,PA,198,4,4176873,1673,41
2020-04-05,Panama,PA,128,5,4176873,1801,46
2020-04-06,Panama,PA,187,8,4176873,1988,54
2020-04-07,Panama,PA,112,1,4176873,2100,55
2020-04-08,Panama,PA,149,4,4176873,2249,59
2020-04-09,Panama,PA,279,4,4176873,2528,63
2020-04-10,Panama,PA,224,3,4176873,2752,66
2020-04-11,Panama,PA,222,8,4176873,2974,74
2020-04-12,Panama,PA,260,5,4176873,3234,79
2020-04-13,Panama,PA,166,8,4176873,3400,87
2020-04-14,Panama,PA,72,7,4176873,3472,94
2020-04-15,Panama,PA,102,1,4176873,3574,95
2020-04-16,Panama,PA,177,8,4176873,3751,103
2020-04-17,Panama,PA,265,6,4176873,4016,109
2020-04-18,Panama,PA,194,7,4176873,4210,116
2020-04-19,Panama,PA,63,4,4176873,4273,120
2020-04-20,Panama,PA,194,6,4176873,4467,126
2020-04-21,Panama,PA,191,10,4176873,4658,136
2020-04-22,Panama,PA,163,5,4176873,4821,141
2020-04-23,Panama,PA,171,3,4176873,4992,144
2020-04-24,Panama,PA,174,2,4176873,5166,146
2020-04-25,Panama,PA,172,8,4176873,5338,154
2020-04-26,Panama,PA,200,5,4176873,5538,159
2020-04-27,Panama,PA,241,6,4176873,5779,165
2020-04-28,Panama,PA,242,2,4176873,6021,167
2020-04-29,Panama,PA,179,9,4176873,6200,176
2020-04-30,Panama,PA,178,2,4176873,6378,178
2020-05-01,Panama,PA,154,10,4176873,6532,188
2020-05-02,Panama,PA,188,4,4176873,6720,192
2020-05-03,Panama,PA,370,5,4176873,7090,197
2020-03-07,Peru,PE,1,0,31989256,1,0
2020-03-09,Peru,PE,6,0,31989256,7,0
2020-03-10,Peru,PE,2,0,31989256,9,0
2020-03-11,Peru,PE,2,0,31989256,11,0
2020-03-12,Peru,PE,6,0,31989256,17,0
2020-03-13,Peru,PE,5,0,31989256,22,0
2020-03-14,Peru,PE,16,0,31989256,38,0
2020-03-15,Peru,PE,5,0,31989256,43,0
2020-03-16,Peru,PE,28,0,31989256,71,0
2020-03-17,Peru,PE,15,0,31989256,86,0
2020-03-18,Peru,PE,31,0,31989256,117,0
2020-03-19,Peru,PE,28,0,31989256,145,0
2020-03-20,Peru,PE,89,2,31989256,234,2
2020-03-21,Peru,PE,29,1,31989256,263,3
2020-03-22,Peru,PE,55,2,31989256,318,5
2020-03-23,Peru,PE,45,0,31989256,363,5
2020-03-24,Peru,PE,32,0,31989256,395,5
2020-03-25,Peru,PE,21,2,31989256,416,7
2020-03-26,Peru,PE,142,1,31989256,558,8
2020-03-27,Peru,PE,22,1,31989256,580,9
2020-03-28,Peru,PE,55,2,31989256,635,11
2020-03-29,Peru,PE,36,5,31989256,671,16
2020-03-30,Peru,PE,181,2,31989256,852,18
2020-03-31,Peru,PE,98,6,31989256,950,24
2020-04-01,Peru,PE,115,6,31989256,1065,30
2020-04-02,Peru,PE,258,17,31989256,1323,47
2020-04-03,Peru,PE,91,8,31989256,1414,55
2020-04-04,Peru,PE,181,6,31989256,1595,61
2020-04-05,Peru,PE,151,12,31989256,1746,73
2020-04-06,Peru,PE,535,10,31989256,2281,83
2020-04-07,Peru,PE,280,9,31989256,2561,92
2020-04-08,Peru,PE,393,15,31989256,2954,107
2020-04-09,Peru,PE,1388,14,31989256,4342,121
2020-04-10,Peru,PE,914,17,31989256,5256,138
2020-04-11,Peru,PE,641,31,31989256,5897,169
2020-04-12,Peru,PE,951,12,31989256,6848,181
2020-04-13,Peru,PE,671,12,31989256,7519,193
2020-04-14,Peru,PE,0,0,31989256,7519,193
2020-04-15,Peru,PE,2784,37,31989256,10303,230
2020-04-16,Peru,PE,1172,24,31989256,11475,254
2020-04-17,Peru,PE,1016,20,31989256,12491,274
2020-04-18,Peru,PE,998,26,31989256,13489,300
2020-04-19,Peru,PE,931,48,31989256,14420,348
2020-04-20,Peru,PE,1208,52,31989256,15628,400
2020-04-21,Peru,PE,697,45,31989256,16325,445
2020-04-22,Peru,PE,1512,39,31989256,17837,484
2020-04-23,Peru,PE,1413,46,31989256,19250,530
2020-04-24,Peru,PE,1664,42,31989256,20914,572
2020-04-25,Peru,PE,734,62,31989256,21648,634
2020-04-26,Peru,PE,3683,66,31989256,25331,700
2020-04-27,Peru,PE,2186,28,31989256,27517,728
2020-04-28,Peru,PE,1182,54,31989256,28699,782
2020-04-29,Peru,PE,2491,72,31989256,31190,854
2020-04-30,Peru,PE,2741,89,31989256,33931,943
2020-05-01,Peru,PE,3045,108,31989256,36976,1051
2020-05-02,Peru,PE,3483,73,31989256,40459,1124
2020-05-03,Peru,PE,2075,76,31989256,42534,1200
2020-03-19,French_Polynesia,PF,3,0,277679,3,0
2020-03-20,French_Polynesia,PF,0,0,277679,3,0
2020-03-21,French_Polynesia,PF,12,0,277679,15,0
2020-03-22,French_Polynesia,PF,2,0,277679,17,0
2020-03-23,French_Polynesia,PF,1,0,277679,18,0
2020-03-24,French_Polynesia,PF,5,0,277679,23,0
2020-03-25,French_Polynesia,PF,2,0,277679,25,0
2020-03-26,French_Polynesia,PF,0,0,277679,25,0
2020-03-27,French_Polynesia,PF,5,0,277679,30,0
2020-03-28,French_Polynesia,PF,0,0,277679,30,0
2020-03-29,French_Polynesia,PF,4,0,277679,34,0
2020-03-30,French_Polynesia,PF,1,0,277679,35,0
2020-03-31,French_Polynesia,PF,1,0,277679,36,0
2020-04-01,French_Polynesia,PF,1,0,277679,37,0
2020-04-02,French_Polynesia,PF,0,0,277679,37,0
2020-04-03,French_Polynesia,PF,0,0,277679,37,0
2020-04-04,French_Polynesia,PF,2,0,277679,39,0
2020-04-05,French_Polynesia,PF,1,0,277679,40,0
2020-04-06,French_Polynesia,PF,1,0,277679,41,0
2020-04-07,French_Polynesia,PF,0,0,277679,41,0
2020-04-08,French_Polynesia,PF,6,0,277679,47,0
2020-04-09,French_Polynesia,PF,4,0,277679,51,0
2020-04-10,French_Polynesia,PF,0,0,277679,51,0
2020-04-11,French_Polynesia,PF,0,0,277679,51,0
2020-04-12,French_Polynesia,PF,0,0,277679,51,0
2020-04-13,French_Polynesia,PF,2,0,277679,53,0
2020-04-14,French_Polynesia,PF,2,0,277679,55,0
2020-04-15,French_Polynesia,PF,0,0,277679,55,0
2020-04-16,French_Polynesia,PF,0,0,277679,55,0
2020-04-17,French_Polynesia,PF,0,0,277679,55,0
2020-04-18,French_Polynesia,PF,0,0,277679,55,0
2020-04-19,French_Polynesia,PF,0,0,277679,55,0
2020-04-20,French_Polynesia,PF,0,0,277679,55,0
2020-04-21,French_Polynesia,PF,1,0,277679,56,0
2020-04-22,French_Polynesia,PF,1,0,277679,57,0
2020-04-23,French_Polynesia,PF,0,0,277679,57,0
2020-04-24,French_Polynesia,PF,0,0,277679,57,0
2020-04-25,French_Polynesia,PF,0,0,277679,57,0
2020-04-26,French_Polynesia,PF,0,0,277679,57,0
2020-04-27,French_Polynesia,PF,0,0,277679,57,0
2020-04-28,French_Polynesia,PF,1,0,277679,58,0
2020-04-29,French_Polynesia,PF,0,0,277679,58,0
2020-04-30,French_Polynesia,PF,0,0,277679,58,0
2020-05-01,French_Polynesia,PF,0,0,277679,58,0
2020-05-02,French_Polynesia,PF,0,0,277679,58,0
2020-05-03,French_Polynesia,PF,0,0,277679,58,0
2020-03-21,Papua_New_Guinea,PG,1,0,8606316,1,0
2020-03-22,Papua_New_Guinea,PG,0,0,8606316,1,0
2020-03-23,Papua_New_Guinea,PG,0,0,8606316,1,0
2020-03-24,Papua_New_Guinea,PG,0,0,8606316,1,0
2020-03-25,Papua_New_Guinea,PG,0,0,8606316,1,0
2020-03-26,Papua_New_Guinea,PG,0,0,8606316,1,0
2020-03-27,Papua_New_Guinea,PG,0,0,8606316,1,0
2020-03-28,Papua_New_Guinea,PG,0,0,8606316,1,0
2020-03-29,Papua_New_Guinea,PG,0,0,8606316,1,0
2020-03-30,Papua_New_Guinea,PG,0,0,8606316,1,0
2020-03-31,Papua_New_Guinea,PG,0,0,8606316,1,0
2020-04-01,Papua_New_Guinea,PG,0,0,8606316,1,0
2020-04-02,Papua_New_Guinea,PG,0,0,8606316,1,0
2020-04-03,Papua_New_Guinea,PG,0,0,8606316,1,0
2020-04-04,Papua_New_Guinea,PG,0,0,8606316,1,0
2020-04-05,Papua_New_Guinea,PG,0,0,8606316,1,0
2020-04-06,Papua_New_Guinea,PG,0,0,8606316,1,0
2020-04-07,Papua_New_Guinea,PG,0,0,8606316,1,0
2020-04-08,Papua_New_Guinea,PG,1,0,8606316,2,0
2020-04-09,Papua_New_Guinea,PG,0,0,8606316,2,0
2020-04-10,Papua_New_Guinea,PG,0,0,8606316,2,0
2020-04-11,Papua_New_Guinea,PG,0,0,8606316,2,0
2020-04-12,Papua_New_Guinea,PG,0,0,8606316,2,0
2020-04-13,Papua_New_Guinea,PG,0,0,8606316,2,0
2020-04-14,Papua_New_Guinea,PG,0,0,8606316,2,0
2020-04-15,Papua_New_Guinea,PG,0,0,8606316,2,0
2020-04-16,Papua_New_Guinea,PG,0,0,8606316,2,0
2020-04-17,Papua_New_Guinea,PG,5,0,8606316,7,0
2020-04-18,Papua_New_Guinea,PG,0,0,8606316,7,0
2020-04-19,Papua_New_Guinea,PG,0,0,8606316,7,0
2020-04-20,Papua_New_Guinea,PG,0,0,8606316,7,0
2020-04-21,Papua_New_Guinea,PG,0,0,8606316,7,0
2020-04-22,Papua_New_Guinea,PG,0,0,8606316,7,0
2020-04-23,Papua_New_Guinea,PG,1,0,8606316,8,0
2020-04-24,Papua_New_Guinea,PG,0,0,8606316,8,0
2020-04-25,Papua_New_Guinea,PG,0,0,8606316,8,0
2020-04-26,Papua_New_Guinea,PG,0,0,8606316,8,0
2020-04-27,Papua_New_Guinea,PG,0,0,8606316,8,0
2020-04-28,Papua_New_Guinea,PG,0,0,8606316,8,0
2020-04-29,Papua_New_Guinea,PG,0,0,8606316,8,0
2020-04-30,Papua_New_Guinea,PG,0,0,8606316,8,0
2020-05-01,Papua_New_Guinea,PG,0,0,8606316,8,0
2020-05-02,Papua_New_Guinea,PG,0,0,8606316,8,0
2020-05-03,Papua_New_Guinea,PG,0,0,8606316,8,0
2019-12-31,Philippines,PH,0,0,106651922,0,0
2020-01-01,Philippines,PH,0,0,106651922,0,0
2020-01-02,Philippines,PH,0,0,106651922,0,0
2020-01-03,Philippines,PH,0,0,106651922,0,0
2020-01-04,Philippines,PH,0,0,106651922,0,0
2020-01-05,Philippines,PH,0,0,106651922,0,0
2020-01-06,Philippines,PH,0,0,106651922,0,0
2020-01-07,Philippines,PH,0,0,106651922,0,0
2020-01-08,Philippines,PH,0,0,106651922,0,0
2020-01-09,Philippines,PH,0,0,106651922,0,0
2020-01-10,Philippines,PH,0,0,106651922,0,0
2020-01-11,Philippines,PH,0,0,106651922,0,0
2020-01-12,Philippines,PH,0,0,106651922,0,0
2020-01-13,Philippines,PH,0,0,106651922,0,0
2020-01-14,Philippines,PH,0,0,106651922,0,0
2020-01-15,Philippines,PH,0,0,106651922,0,0
2020-01-16,Philippines,PH,0,0,106651922,0,0
2020-01-17,Philippines,PH,0,0,106651922,0,0
2020-01-18,Philippines,PH,0,0,106651922,0,0
2020-01-19,Philippines,PH,0,0,106651922,0,0
2020-01-20,Philippines,PH,0,0,106651922,0,0
2020-01-21,Philippines,PH,0,0,106651922,0,0
2020-01-22,Philippines,PH,0,0,106651922,0,0
2020-01-23,Philippines,PH,0,0,106651922,0,0
2020-01-24,Philippines,PH,0,0,106651922,0,0
2020-01-25,Philippines,PH,0,0,106651922,0,0
2020-01-26,Philippines,PH,0,0,106651922,0,0
2020-01-27,Philippines,PH,0,0,106651922,0,0
2020-01-28,Philippines,PH,0,0,106651922,0,0
2020-01-29,Philippines,PH,0,0,106651922,0,0
2020-01-30,Philippines,PH,1,0,106651922,1,0
2020-01-31,Philippines,PH,0,0,106651922,1,0
2020-02-01,Philippines,PH,0,0,106651922,1,0
2020-02-02,Philippines,PH,1,1,106651922,2,1
2020-02-03,Philippines,PH,0,0,106651922,2,1
2020-02-04,Philippines,PH,0,0,106651922,2,1
2020-02-05,Philippines,PH,0,0,106651922,2,1
2020-02-06,Philippines,PH,1,0,106651922,3,1
2020-02-07,Philippines,PH,0,0,106651922,3,1
2020-02-08,Philippines,PH,0,0,106651922,3,1
2020-02-09,Philippines,PH,0,0,106651922,3,1
2020-02-10,Philippines,PH,0,0,106651922,3,1
2020-02-11,Philippines,PH,0,0,106651922,3,1
2020-02-12,Philippines,PH,0,0,106651922,3,1
2020-02-13,Philippines,PH,0,0,106651922,3,1
2020-02-14,Philippines,PH,0,0,106651922,3,1
2020-02-15,Philippines,PH,0,0,106651922,3,1
2020-02-16,Philippines,PH,0,0,106651922,3,1
2020-02-17,Philippines,PH,0,0,106651922,3,1
2020-02-18,Philippines,PH,0,0,106651922,3,1
2020-02-19,Philippines,PH,0,0,106651922,3,1
2020-02-20,Philippines,PH,0,0,106651922,3,1
2020-02-21,Philippines,PH,0,0,106651922,3,1
2020-02-22,Philippines,PH,0,0,106651922,3,1
2020-02-23,Philippines,PH,0,0,106651922,3,1
2020-02-24,Philippines,PH,0,0,106651922,3,1
2020-02-25,Philippines,PH,0,0,106651922,3,1
2020-02-26,Philippines,PH,0,0,106651922,3,1
2020-02-27,Philippines,PH,0,0,106651922,3,1
2020-02-28,Philippines,PH,0,0,106651922,3,1
2020-02-29,Philippines,PH,0,0,106651922,3,1
2020-03-01,Philippines,PH,0,0,106651922,3,1
2020-03-02,Philippines,PH,0,0,106651922,3,1
2020-03-07,Philippines,PH,2,0,106651922,5,1
2020-03-08,Philippines,PH,1,0,106651922,6,1
2020-03-09,Philippines,PH,4,0,106651922,10,1
2020-03-10,Philippines,PH,23,0,106651922,33,1
2020-03-11,Philippines,PH,0,0,106651922,33,1
2020-03-12,Philippines,PH,16,1,106651922,49,2
2020-03-13,Philippines,PH,3,0,106651922,52,2
2020-03-14,Philippines,PH,12,4,106651922,64,6
2020-03-15,Philippines,PH,47,0,106651922,111,6
2020-03-16,Philippines,PH,29,6,106651922,140,12
2020-03-17,Philippines,PH,2,0,106651922,142,12
2020-03-18,Philippines,PH,45,2,106651922,187,14
2020-03-19,Philippines,PH,15,3,106651922,202,17
2020-03-20,Philippines,PH,28,1,106651922,230,18
2020-03-21,Philippines,PH,0,0,106651922,230,18
2020-03-22,Philippines,PH,150,7,106651922,380,25
2020-03-23,Philippines,PH,0,0,106651922,380,25
2020-03-24,Philippines,PH,82,8,106651922,462,33
2020-03-25,Philippines,PH,90,2,106651922,552,35
2020-03-26,Philippines,PH,84,3,106651922,636,38
2020-03-27,Philippines,PH,71,7,106651922,707,45
2020-03-28,Philippines,PH,96,9,106651922,803,54
2020-03-29,Philippines,PH,272,14,106651922,1075,68
2020-03-30,Philippines,PH,343,3,106651922,1418,71
2020-03-31,Philippines,PH,666,17,106651922,2084,88
2020-04-01,Philippines,PH,0,0,106651922,2084,88
2020-04-02,Philippines,PH,227,8,106651922,2311,96
2020-04-03,Philippines,PH,322,11,106651922,2633,107
2020-04-04,Philippines,PH,385,29,106651922,3018,136
2020-04-05,Philippines,PH,76,8,106651922,3094,144
2020-04-06,Philippines,PH,152,8,106651922,3246,152
2020-04-07,Philippines,PH,414,11,106651922,3660,163
2020-04-08,Philippines,PH,104,14,106651922,3764,177
2020-04-09,Philippines,PH,106,5,106651922,3870,182
2020-04-10,Philippines,PH,206,21,106651922,4076,203
2020-04-11,Philippines,PH,0,0,106651922,4076,203
2020-04-12,Philippines,PH,352,44,106651922,4428,247
2020-04-13,Philippines,PH,220,50,106651922,4648,297
2020-04-14,Philippines,PH,284,18,106651922,4932,315
2020-04-15,Philippines,PH,291,20,106651922,5223,335
2020-04-16,Philippines,PH,230,14,106651922,5453,349
2020-04-17,Philippines,PH,207,13,106651922,5660,362
2020-04-18,Philippines,PH,218,25,106651922,5878,387
2020-04-19,Philippines,PH,209,10,106651922,6087,397
2020-04-20,Philippines,PH,172,12,106651922,6259,409
2020-04-21,Philippines,PH,200,19,106651922,6459,428
2020-04-22,Philippines,PH,140,9,106651922,6599,437
2020-04-23,Philippines,PH,111,9,106651922,6710,446
2020-04-24,Philippines,PH,271,16,106651922,6981,462
2020-04-25,Philippines,PH,211,15,106651922,7192,477
2020-04-26,Philippines,PH,102,17,106651922,7294,494
2020-04-27,Philippines,PH,285,7,106651922,7579,501
2020-04-28,Philippines,PH,198,10,106651922,7777,511
2020-04-29,Philippines,PH,181,19,106651922,7958,530
2020-04-30,Philippines,PH,254,28,106651922,8212,558
2020-05-01,Philippines,PH,276,10,106651922,8488,568
2020-05-02,Philippines,PH,284,11,106651922,8772,579
2020-05-03,Philippines,PH,156,24,106651922,8928,603
2019-12-31,Pakistan,PK,0,0,212215030,0,0
2020-01-01,Pakistan,PK,0,0,212215030,0,0
2020-01-02,Pakistan,PK,0,0,212215030,0,0
2020-01-03,Pakistan,PK,0,0,212215030,0,0
2020-01-04,Pakistan,PK,0,0,212215030,0,0
2020-01-05,Pakistan,PK,0,0,212215030,0,0
2020-01-06,Pakistan,PK,0,0,212215030,0,0
2020-01-07,Pakistan,PK,0,0,212215030,0,0
2020-01-08,Pakistan,PK,0,0,212215030,0,0
2020-01-09,Pakistan,PK,0,0,212215030,0,0
2020-01-10,Pakistan,PK,0,0,212215030,0,0
2020-01-11,Pakistan,PK,0,0,212215030,0,0
2020-01-12,Pakistan,PK,0,0,212215030,0,0
2020-01-13,Pakistan,PK,0,0,212215030,0,0
2020-01-14,Pakistan,PK,0,0,212215030,0,0
2020-01-15,Pakistan,PK,0,0,212215030,0,0
2020-01-16,Pakistan,PK,0,0,212215030,0,0
2020-01-17,Pakistan,PK,0,0,212215030,0,0
2020-01-18,Pakistan,PK,0,0,212215030,0,0
2020-01-19,Pakistan,PK,0,0,212215030,0,0
2020-01-20,Pakistan,PK,0,0,212215030,0,0
2020-01-21,Pakistan,PK,0,0,212215030,0,0
2020-01-22,Pakistan,PK,0,0,212215030,0,0
2020-01-23,Pakistan,PK,0,0,212215030,0,0
2020-01-24,Pakistan,PK,0,0,212215030,0,0
2020-01-25,Pakistan,PK,0,0,212215030,0,0
2020-01-26,Pakistan,PK,0,0,212215030,0,0
2020-01-27,Pakistan,PK,0,0,212215030,0,0
2020-01-28,Pakistan,PK,0,0,212215030,0,0
2020-01-29,Pakistan,PK,0,0,212215030,0,0
2020-01-30,Pakistan,PK,0,0,212215030,0,0
2020-01-31,Pakistan,PK,0,0,212215030,0,0
2020-02-01,Pakistan,PK,0,0,212215030,0,0
2020-02-02,Pakistan,PK,0,0,212215030,0,0
2020-02-03,Pakistan,PK,0,0,212215030,0,0
2020-02-04,Pakistan,PK,0,0,212215030,0,0
2020-02-05,Pakistan,PK,0,0,212215030,0,0
2020-02-06,Pakistan,PK,0,0,212215030,0,0
2020-02-07,Pakistan,PK,0,0,212215030,0,0
2020-02-08,Pakistan,PK,0,0,212215030,0,0
2020-02-09,Pakistan,PK,0,0,212215030,0,0
2020-02-10,Pakistan,PK,0,0,212215030,0,0
2020-02-11,Pakistan,PK,0,0,212215030,0,0
2020-02-12,Pakistan,PK,0,0,212215030,0,0
2020-02-13,Pakistan,PK,0,0,212215030,0,0
2020-02-14,Pakistan,PK,0,0,212215030,0,0
2020-02-15,Pakistan,PK,0,0,212215030,0,0
2020-02-16,Pakistan,PK,0,0,212215030,0,0
2020-02-17,Pakistan,PK,0,0,212215030,0,0
2020-02-18,Pakistan,PK,0,0,212215030,0,0
2020-02-19,Pakistan,PK,0,0,212215030,0,0
2020-02-20,Pakistan,PK,0,0,212215030,0,0
2020-02-21,Pakistan,PK,0,0,212215030,0,0
2020-02-22,Pakistan,PK,0,0,212215030,0,0
2020-02-23,Pakistan,PK,0,0,212215030,0,0
2020-02-24,Pakistan,PK,0,0,212215030,0,0
2020-02-25,Pakistan,PK,0,0,212215030,0,0
2020-02-26,Pakistan,PK,0,0,212215030,0,0
2020-02-27,Pakistan,PK,2,0,212215030,2,0
2020-02-28,Pakistan,PK,0,0,212215030,2,0
2020-02-29,Pakistan,PK,0,0,212215030,2,0
2020-03-01,Pakistan,PK,2,0,212215030,4,0
2020-03-02,Pakistan,PK,0,0,212215030,4,0
2020-03-04,Pakistan,PK,1,0,212215030,5,0
2020-03-07,Pakistan,PK,1,0,212215030,6,0
2020-03-10,Pakistan,PK,10,0,212215030,16,0
2020-03-11,Pakistan,PK,0,0,212215030,16,0
2020-03-12,Pakistan,PK,4,0,212215030,20,0
2020-03-13,Pakistan,PK,1,0,212215030,21,0
2020-03-14,Pakistan,PK,0,0,212215030,21,0
2020-03-15,Pakistan,PK,9,0,212215030,30,0
2020-03-16,Pakistan,PK,1,0,212215030,31,0
2020-03-17,Pakistan,PK,156,0,212215030,187,0
2020-03-18,Pakistan,PK,0,0,212215030,187,0
2020-03-19,Pakistan,PK,115,0,212215030,302,0
2020-03-20,Pakistan,PK,176,2,212215030,478,2
2020-03-21,Pakistan,PK,17,1,212215030,495,3
2020-03-22,Pakistan,PK,151,0,212215030,646,3
2020-03-23,Pakistan,PK,138,2,212215030,784,5
2020-03-24,Pakistan,PK,103,1,212215030,887,6
2020-03-25,Pakistan,PK,104,1,212215030,991,7
2020-03-26,Pakistan,PK,66,1,212215030,1057,8
2020-03-27,Pakistan,PK,140,1,212215030,1197,9
2020-03-28,Pakistan,PK,0,0,212215030,1197,9
2020-03-29,Pakistan,PK,211,2,212215030,1408,11
2020-03-30,Pakistan,PK,118,2,212215030,1526,13
2020-03-31,Pakistan,PK,99,5,212215030,1625,18
2020-04-01,Pakistan,PK,414,8,212215030,2039,26
2020-04-02,Pakistan,PK,252,5,212215030,2291,31
2020-04-03,Pakistan,PK,0,0,212215030,2291,31
2020-04-04,Pakistan,PK,0,0,212215030,2291,31
2020-04-05,Pakistan,PK,159,4,212215030,2450,35
2020-04-06,Pakistan,PK,827,15,212215030,3277,50
2020-04-07,Pakistan,PK,587,4,212215030,3864,54
2020-04-08,Pakistan,PK,208,4,212215030,4072,58
2020-04-09,Pakistan,PK,250,5,212215030,4322,63
2020-04-10,Pakistan,PK,279,3,212215030,4601,66
2020-04-11,Pakistan,PK,187,5,212215030,4788,71
2020-04-12,Pakistan,PK,250,15,212215030,5038,86
2020-04-13,Pakistan,PK,336,7,212215030,5374,93
2020-04-14,Pakistan,PK,342,3,212215030,5716,96
2020-04-15,Pakistan,PK,272,11,212215030,5988,107
2020-04-16,Pakistan,PK,517,17,212215030,6505,124
2020-04-17,Pakistan,PK,520,11,212215030,7025,135
2020-04-18,Pakistan,PK,456,8,212215030,7481,143
2020-04-19,Pakistan,PK,512,16,212215030,7993,159
2020-04-20,Pakistan,PK,425,17,212215030,8418,176
2020-04-21,Pakistan,PK,798,16,212215030,9216,192
2020-04-22,Pakistan,PK,533,17,212215030,9749,209
2020-04-23,Pakistan,PK,0,0,212215030,9749,209
2020-04-24,Pakistan,PK,1406,28,212215030,11155,237
2020-04-25,Pakistan,PK,785,16,212215030,11940,253
2020-04-26,Pakistan,PK,783,16,212215030,12723,269
2020-04-27,Pakistan,PK,605,12,212215030,13328,281
2020-04-28,Pakistan,PK,751,20,212215030,14079,301
2020-04-29,Pakistan,PK,806,26,212215030,14885,327
2020-04-30,Pakistan,PK,874,19,212215030,15759,346
2020-05-01,Pakistan,PK,1058,39,212215030,16817,385
2020-05-02,Pakistan,PK,1297,32,212215030,18114,417
2020-05-03,Pakistan,PK,989,23,212215030,19103,440
2020-03-04,Poland,PL,1,0,37978548,1,0
2020-03-07,Poland,PL,4,0,37978548,5,0
2020-03-08,Poland,PL,1,0,37978548,6,0
2020-03-09,Poland,PL,5,0,37978548,11,0
2020-03-10,Poland,PL,6,0,37978548,17,0
2020-03-11,Poland,PL,5,0,37978548,22,0
2020-03-12,Poland,PL,9,0,37978548,31,0
2020-03-13,Poland,PL,18,1,37978548,49,1
2020-03-14,Poland,PL,19,1,37978548,68,2
2020-03-15,Poland,PL,36,1,37978548,104,3
2020-03-16,Poland,PL,21,0,37978548,125,3
2020-03-17,Poland,PL,52,1,37978548,177,4
2020-03-18,Poland,PL,61,1,37978548,238,5
2020-03-19,Poland,PL,49,0,37978548,287,5
2020-03-20,Poland,PL,68,0,37978548,355,5
2020-03-21,Poland,PL,70,0,37978548,425,5
2020-03-22,Poland,PL,111,0,37978548,536,5
2020-03-23,Poland,PL,98,2,37978548,634,7
2020-03-24,Poland,PL,115,1,37978548,749,8
2020-03-25,Poland,PL,152,2,37978548,901,10
2020-03-26,Poland,PL,150,4,37978548,1051,14
2020-03-27,Poland,PL,170,2,37978548,1221,16
2020-03-28,Poland,PL,168,0,37978548,1389,16
2020-03-29,Poland,PL,249,2,37978548,1638,18
2020-03-30,Poland,PL,224,4,37978548,1862,22
2020-03-31,Poland,PL,193,9,37978548,2055,31
2020-04-01,Poland,PL,256,2,37978548,2311,33
2020-04-02,Poland,PL,243,10,37978548,2554,43
2020-04-03,Poland,PL,392,14,37978548,2946,57
2020-04-04,Poland,PL,437,14,37978548,3383,71
2020-04-05,Poland,PL,244,8,37978548,3627,79
2020-04-06,Poland,PL,475,15,37978548,4102,94
2020-04-07,Poland,PL,311,13,37978548,4413,107
2020-04-08,Poland,PL,435,22,37978548,4848,129
2020-04-09,Poland,PL,357,30,37978548,5205,159
2020-04-10,Poland,PL,370,15,37978548,5575,174
2020-04-11,Poland,PL,380,7,37978548,5955,181
2020-04-12,Poland,PL,401,27,37978548,6356,208
2020-04-13,Poland,PL,318,24,37978548,6674,232
2020-04-14,Poland,PL,260,13,37978548,6934,245
2020-04-15,Poland,PL,268,18,37978548,7202,263
2020-04-16,Poland,PL,380,23,37978548,7582,286
2020-04-17,Poland,PL,336,28,37978548,7918,314
2020-04-18,Poland,PL,461,18,37978548,8379,332
2020-04-19,Poland,PL,363,15,37978548,8742,347
2020-04-20,Poland,PL,545,13,37978548,9287,360
2020-04-21,Poland,PL,306,20,37978548,9593,380
2020-04-22,Poland,PL,263,21,37978548,9856,401
2020-04-23,Poland,PL,313,25,37978548,10169,426
2020-04-24,Poland,PL,342,28,37978548,10511,454
2020-04-25,Poland,PL,381,40,37978548,10892,494
2020-04-26,Poland,PL,381,30,37978548,11273,524
2020-04-27,Poland,PL,344,11,37978548,11617,535
2020-04-28,Poland,PL,285,27,37978548,11902,562
2020-04-29,Poland,PL,316,34,37978548,12218,596
2020-04-30,Poland,PL,422,28,37978548,12640,624
2020-05-01,Poland,PL,237,20,37978548,12877,644
2020-05-02,Poland,PL,228,7,37978548,13105,651
2020-05-03,Poland,PL,270,13,37978548,13375,664
2020-03-28,Puerto_Rico,PR,64,2,3195153,64,2
2020-03-29,Puerto_Rico,PR,36,1,3195153,100,3
2020-03-30,Puerto_Rico,PR,27,2,3195153,127,5
2020-03-31,Puerto_Rico,PR,47,1,3195153,174,6
2020-04-01,Puerto_Rico,PR,65,2,3195153,239,8
2020-04-02,Puerto_Rico,PR,47,3,3195153,286,11
2020-04-03,Puerto_Rico,PR,30,1,3195153,316,12
2020-04-04,Puerto_Rico,PR,62,3,3195153,378,15
2020-04-05,Puerto_Rico,PR,74,3,3195153,452,18
2020-04-06,Puerto_Rico,PR,23,2,3195153,475,20
2020-04-07,Puerto_Rico,PR,38,1,3195153,513,21
2020-04-08,Puerto_Rico,PR,60,2,3195153,573,23
2020-04-09,Puerto_Rico,PR,47,1,3195153,620,24
2020-04-10,Puerto_Rico,PR,63,9,3195153,683,33
2020-04-11,Puerto_Rico,PR,42,6,3195153,725,39
2020-04-12,Puerto_Rico,PR,63,3,3195153,788,42
2020-04-13,Puerto_Rico,PR,109,2,3195153,897,44
2020-04-14,Puerto_Rico,PR,6,1,3195153,903,45
2020-04-15,Puerto_Rico,PR,20,0,3195153,923,45
2020-04-16,Puerto_Rico,PR,51,6,3195153,974,51
2020-04-17,Puerto_Rico,PR,69,5,3195153,1043,56
2020-04-18,Puerto_Rico,PR,25,2,3195153,1068,58
2020-04-19,Puerto_Rico,PR,50,2,3195153,1118,60
2020-04-20,Puerto_Rico,PR,95,2,3195153,1213,62
2020-04-21,Puerto_Rico,PR,39,1,3195153,1252,63
2020-04-22,Puerto_Rico,PR,0,0,3195153,1252,63
2020-04-23,Puerto_Rico,PR,0,1,3195153,1252,64
2020-04-24,Puerto_Rico,PR,0,5,3195153,1252,69
2020-04-25,Puerto_Rico,PR,24,8,3195153,1276,77
2020-04-26,Puerto_Rico,PR,31,6,3195153,1307,83
2020-04-27,Puerto_Rico,PR,64,1,3195153,1371,84
2020-04-28,Puerto_Rico,PR,18,0,3195153,1389,84
2020-04-29,Puerto_Rico,PR,11,2,3195153,1400,86
2020-04-30,Puerto_Rico,PR,33,0,3195153,1433,86
2020-05-01,Puerto_Rico,PR,106,6,3195153,1539,92
2020-05-02,Puerto_Rico,PR,36,2,3195153,1575,94
2020-05-03,Puerto_Rico,PR,182,1,3195153,1757,95
2020-03-06,Palestine,PS,7,0,4569087,7,0
2020-03-07,Palestine,PS,9,0,4569087,16,0
2020-03-08,Palestine,PS,3,0,4569087,19,0
2020-03-10,Palestine,PS,1,0,4569087,20,0
2020-03-11,Palestine,PS,9,0,4569087,29,0
2020-03-12,Palestine,PS,1,0,4569087,30,0
2020-03-14,Palestine,PS,5,0,4569087,35,0
2020-03-15,Palestine,PS,3,0,4569087,38,0
2020-03-16,Palestine,PS,0,0,4569087,38,0
2020-03-17,Palestine,PS,1,0,4569087,39,0
2020-03-18,Palestine,PS,2,0,4569087,41,0
2020-03-19,Palestine,PS,3,0,4569087,44,0
2020-03-20,Palestine,PS,3,0,4569087,47,0
2020-03-21,Palestine,PS,1,0,4569087,48,0
2020-03-22,Palestine,PS,4,0,4569087,52,0
2020-03-23,Palestine,PS,7,0,4569087,59,0
2020-03-24,Palestine,PS,0,0,4569087,59,0
2020-03-25,Palestine,PS,1,0,4569087,60,0
2020-03-26,Palestine,PS,2,0,4569087,62,0
2020-03-27,Palestine,PS,22,1,4569087,84,1
2020-03-28,Palestine,PS,7,0,4569087,91,1
2020-03-29,Palestine,PS,6,0,4569087,97,1
2020-03-30,Palestine,PS,9,0,4569087,106,1
2020-03-31,Palestine,PS,9,0,4569087,115,1
2020-04-01,Palestine,PS,2,0,4569087,117,1
2020-04-02,Palestine,PS,17,0,4569087,134,1
2020-04-03,Palestine,PS,21,0,4569087,155,1
2020-04-04,Palestine,PS,0,0,4569087,155,1
2020-04-06,Palestine,PS,62,0,4569087,217,1
2020-04-07,Palestine,PS,36,0,4569087,253,1
2020-04-08,Palestine,PS,7,0,4569087,260,1
2020-04-09,Palestine,PS,3,0,4569087,263,1
2020-04-10,Palestine,PS,0,0,4569087,263,1
2020-04-11,Palestine,PS,3,1,4569087,266,2
2020-04-12,Palestine,PS,2,0,4569087,268,2
2020-04-13,Palestine,PS,0,0,4569087,268,2
2020-04-14,Palestine,PS,0,0,4569087,268,2
2020-04-15,Palestine,PS,19,0,4569087,287,2
2020-04-16,Palestine,PS,4,0,4569087,291,2
2020-04-17,Palestine,PS,3,0,4569087,294,2
2020-04-18,Palestine,PS,13,0,4569087,307,2
2020-04-19,Palestine,PS,6,0,4569087,313,2
2020-04-20,Palestine,PS,9,0,4569087,322,2
2020-04-21,Palestine,PS,7,0,4569087,329,2
2020-04-22,Palestine,PS,0,0,4569087,329,2
2020-04-23,Palestine,PS,6,0,4569087,335,2
2020-04-24,Palestine,PS,1,0,4569087,336,2
2020-04-25,Palestine,PS,4,0,4569087,340,2
2020-04-26,Palestine,PS,2,0,4569087,342,2
2020-04-27,Palestine,PS,153,0,4569087,495,2
2020-04-28,Palestine,PS,0,0,4569087,495,2
2020-04-29,Palestine,PS,0,0,4569087,495,2
2020-04-30,Palestine,PS,12,0,4569087,507,2
2020-05-01,Palestine,PS,0,2,4569087,507,4
2020-05-02,Palestine,PS,10,0,4569087,517,4
2020-05-03,Palestine,PS,0,0,4569087,517,4
2020-03-03,Portugal,PT,2,0,10281762,2,0
2020-03-04,Portugal,PT,2,0,10281762,4,0
2020-03-05,Portugal,PT,1,0,10281762,5,0
2020-03-06,Portugal,PT,4,0,10281762,9,0
2020-03-07,Portugal,PT,4,0,10281762,13,0
2020-03-08,Portugal,PT,8,0,10281762,21,0
2020-03-09,Portugal,PT,9,0,10281762,30,0
2020-03-10,Portugal,PT,9,0,10281762,39,0
2020-03-11,Portugal,PT,2,0,10281762,41,0
2020-03-12,Portugal,PT,18,0,10281762,59,0
2020-03-13,Portugal,PT,19,0,10281762,78,0
2020-03-14,Portugal,PT,34,0,10281762,112,0
2020-03-15,Portugal,PT,57,0,10281762,169,0
2020-03-16,Portugal,PT,76,0,10281762,245,0
2020-03-17,Portugal,PT,86,0,10281762,331,0
2020-03-18,Portugal,PT,117,1,10281762,448,1
2020-03-19,Portugal,PT,194,1,10281762,642,2
2020-03-20,Portugal,PT,143,1,10281762,785,3
2020-03-21,Portugal,PT,235,3,10281762,1020,6
2020-03-22,Portugal,PT,260,6,10281762,1280,12
2020-03-23,Portugal,PT,320,2,10281762,1600,14
2020-03-24,Portugal,PT,460,9,10281762,2060,23
2020-03-25,Portugal,PT,302,10,10281762,2362,33
2020-03-26,Portugal,PT,633,10,10281762,2995,43
2020-03-27,Portugal,PT,549,17,10281762,3544,60
2020-03-28,Portugal,PT,724,16,10281762,4268,76
2020-03-29,Portugal,PT,902,24,10281762,5170,100
2020-03-30,Portugal,PT,792,19,10281762,5962,119
2020-03-31,Portugal,PT,446,21,10281762,6408,140
2020-04-01,Portugal,PT,1035,20,10281762,7443,160
2020-04-02,Portugal,PT,808,27,10281762,8251,187
2020-04-03,Portugal,PT,783,22,10281762,9034,209
2020-04-04,Portugal,PT,852,37,10281762,9886,246
2020-04-05,Portugal,PT,638,20,10281762,10524,266
2020-04-06,Portugal,PT,754,29,10281762,11278,295
2020-04-07,Portugal,PT,452,16,10281762,11730,311
2020-04-08,Portugal,PT,712,34,10281762,12442,345
2020-04-09,Portugal,PT,699,35,10281762,13141,380
2020-04-10,Portugal,PT,815,29,10281762,13956,409
2020-04-11,Portugal,PT,1516,26,10281762,15472,435
2020-04-12,Portugal,PT,515,35,10281762,15987,470
2020-04-13,Portugal,PT,598,34,10281762,16585,504
2020-04-14,Portugal,PT,349,31,10281762,16934,535
2020-04-15,Portugal,PT,514,32,10281762,17448,567
2020-04-16,Portugal,PT,643,32,10281762,18091,599
2020-04-17,Portugal,PT,750,30,10281762,18841,629
2020-04-18,Portugal,PT,181,28,10281762,19022,657
2020-04-19,Portugal,PT,663,30,10281762,19685,687
2020-04-20,Portugal,PT,521,27,10281762,20206,714
2020-04-21,Portugal,PT,657,21,10281762,20863,735
2020-04-22,Portugal,PT,516,27,10281762,21379,762
2020-04-23,Portugal,PT,603,23,10281762,21982,785
2020-04-24,Portugal,PT,371,35,10281762,22353,820
2020-04-25,Portugal,PT,444,34,10281762,22797,854
2020-04-26,Portugal,PT,595,26,10281762,23392,880
2020-04-27,Portugal,PT,472,23,10281762,23864,903
2020-04-28,Portugal,PT,163,25,10281762,24027,928
2020-04-29,Portugal,PT,295,20,10281762,24322,948
2020-04-30,Portugal,PT,183,25,10281762,24505,973
2020-05-01,Portugal,PT,551,16,10281762,25056,989
2020-05-02,Portugal,PT,295,18,10281762,25351,1007
2020-05-03,Portugal,PT,-161,16,10281762,25190,1023
2020-03-08,Paraguay,PY,1,0,6956071,1,0
2020-03-11,Paraguay,PY,4,0,6956071,5,0
2020-03-13,Paraguay,PY,1,0,6956071,6,0
2020-03-14,Paraguay,PY,1,0,6956071,7,0
2020-03-16,Paraguay,PY,1,0,6956071,8,0
2020-03-17,Paraguay,PY,1,0,6956071,9,0
2020-03-18,Paraguay,PY,2,0,6956071,11,0
2020-03-19,Paraguay,PY,0,0,6956071,11,0
2020-03-20,Paraguay,PY,2,0,6956071,13,0
2020-03-21,Paraguay,PY,5,1,6956071,18,1
2020-03-22,Paraguay,PY,4,0,6956071,22,1
2020-03-23,Paraguay,PY,0,0,6956071,22,1
2020-03-24,Paraguay,PY,5,0,6956071,27,1
2020-03-25,Paraguay,PY,10,2,6956071,37,3
2020-03-26,Paraguay,PY,4,0,6956071,41,3
2020-03-27,Paraguay,PY,11,0,6956071,52,3
2020-03-28,Paraguay,PY,4,0,6956071,56,3
2020-03-29,Paraguay,PY,3,0,6956071,59,3
2020-03-30,Paraguay,PY,5,0,6956071,64,3
2020-03-31,Paraguay,PY,1,0,6956071,65,3
2020-04-01,Paraguay,PY,4,0,6956071,69,3
2020-04-02,Paraguay,PY,0,0,6956071,69,3
2020-04-03,Paraguay,PY,8,0,6956071,77,3
2020-04-04,Paraguay,PY,19,0,6956071,96,3
2020-04-05,Paraguay,PY,8,0,6956071,104,3
2020-04-06,Paraguay,PY,9,2,6956071,113,5
2020-04-07,Paraguay,PY,0,0,6956071,113,5
2020-04-08,Paraguay,PY,2,0,6956071,115,5
2020-04-09,Paraguay,PY,9,0,6956071,124,5
2020-04-10,Paraguay,PY,5,1,6956071,129,6
2020-04-11,Paraguay,PY,4,0,6956071,133,6
2020-04-12,Paraguay,PY,1,0,6956071,134,6
2020-04-13,Paraguay,PY,13,0,6956071,147,6
2020-04-14,Paraguay,PY,12,1,6956071,159,7
2020-04-15,Paraguay,PY,2,1,6956071,161,8
2020-04-16,Paraguay,PY,13,0,6956071,174,8
2020-04-17,Paraguay,PY,0,0,6956071,174,8
2020-04-18,Paraguay,PY,28,0,6956071,202,8
2020-04-19,Paraguay,PY,0,0,6956071,202,8
2020-04-20,Paraguay,PY,4,0,6956071,206,8
2020-04-21,Paraguay,PY,2,0,6956071,208,8
2020-04-22,Paraguay,PY,5,1,6956071,213,9
2020-04-23,Paraguay,PY,0,0,6956071,213,9
2020-04-24,Paraguay,PY,7,0,6956071,220,9
2020-04-25,Paraguay,PY,3,0,6956071,223,9
2020-04-26,Paraguay,PY,5,0,6956071,228,9
2020-04-27,Paraguay,PY,0,0,6956071,228,9
2020-04-28,Paraguay,PY,2,0,6956071,230,9
2020-04-29,Paraguay,PY,9,0,6956071,239,9
2020-04-30,Paraguay,PY,10,0,6956071,249,9
2020-05-01,Paraguay,PY,17,1,6956071,266,10
2020-05-02,Paraguay,PY,67,0,6956071,333,10
2020-05-03,Paraguay,PY,37,0,6956071,370,10
2019-12-31,Qatar,QA,0,0,2781677,0,0
2020-01-01,Qatar,QA,0,0,2781677,0,0
2020-01-02,Qatar,QA,0,0,2781677,0,0
2020-01-03,Qatar,QA,0,0,2781677,0,0
2020-01-04,Qatar,QA,0,0,2781677,0,0
2020-01-05,Qatar,QA,0,0,2781677,0,0
2020-01-06,Qatar,QA,0,0,2781677,0,0
2020-01-07,Qatar,QA,0,0,2781677,0,0
2020-01-08,Qatar,QA,0,0,2781677,0,0
2020-01-09,Qatar,QA,0,0,2781677,0,0
2020-01-10,Qatar,QA,0,0,2781677,0,0
2020-01-11,Qatar,QA,0,0,2781677,0,0
2020-01-12,Qatar,QA,0,0,2781677,0,0
2020-01-13,Qatar,QA,0,0,2781677,0,0
2020-01-14,Qatar,QA,0,0,2781677,0,0
2020-01-15,Qatar,QA,0,0,2781677,0,0
2020-01-16,Qatar,QA,0,0,2781677,0,0
2020-01-17,Qatar,QA,0,0,2781677,0,0
2020-01-18,Qatar,QA,0,0,2781677,0,0
2020-01-19,Qatar,QA,0,0,2781677,0,0
2020-01-20,Qatar,QA,0,0,2781677,0,0
2020-01-21,Qatar,QA,0,0,2781677,0,0
2020-01-22,Qatar,QA,0,0,2781677,0,0
2020-01-23,Qatar,QA,0,0,2781677,0,0
2020-01-24,Qatar,QA,0,0,2781677,0,0
2020-01-25,Qatar,QA,0,0,2781677,0,0
2020-01-26,Qatar,QA,0,0,2781677,0,0
2020-01-27,Qatar,QA,0,0,2781677,0,0
2020-01-28,Qatar,QA,0,0,2781677,0,0
2020-01-29,Qatar,QA,0,0,2781677,0,0
2020-01-30,Qatar,QA,0,0,2781677,0,0
2020-01-31,Qatar,QA,0,0,2781677,0,0
2020-02-01,Qatar,QA,0,0,2781677,0,0
2020-02-02,Qatar,QA,0,0,2781677,0,0
2020-02-03,Qatar,QA,0,0,2781677,0,0
2020-02-04,Qatar,QA,0,0,2781677,0,0
2020-02-05,Qatar,QA,0,0,2781677,0,0
2020-02-06,Qatar,QA,0,0,2781677,0,0
2020-02-07,Qatar,QA,0,0,2781677,0,0
2020-02-08,Qatar,QA,0,0,2781677,0,0
2020-02-09,Qatar,QA,0,0,2781677,0,0
2020-02-10,Qatar,QA,0,0,2781677,0,0
2020-02-11,Qatar,QA,0,0,2781677,0,0
2020-02-12,Qatar,QA,0,0,2781677,0,0
2020-02-13,Qatar,QA,0,0,2781677,0,0
2020-02-14,Qatar,QA,0,0,2781677,0,0
2020-02-15,Qatar,QA,0,0,2781677,0,0
2020-02-16,Qatar,QA,0,0,2781677,0,0
2020-02-17,Qatar,QA,0,0,2781677,0,0
2020-02-18,Qatar,QA,0,0,2781677,0,0
2020-02-19,Qatar,QA,0,0,2781677,0,0
2020-02-20,Qatar,QA,0,0,2781677,0,0
2020-02-21,Qatar,QA,0,0,2781677,0,0
2020-02-22,Qatar,QA,0,0,2781677,0,0
2020-02-23,Qatar,QA,0,0,2781677,0,0
2020-02-24,Qatar,QA,0,0,2781677,0,0
2020-02-25,Qatar,QA,0,0,2781677,0,0
2020-02-26,Qatar,QA,0,0,2781677,0,0
2020-02-27,Qatar,QA,0,0,2781677,0,0
2020-02-28,Qatar,QA,0,0,2781677,0,0
2020-02-29,Qatar,QA,0,0,2781677,0,0
2020-03-01,Qatar,QA,1,0,2781677,1,0
2020-03-02,Qatar,QA,2,0,2781677,3,0
2020-03-04,Qatar,QA,5,0,2781677,8,0
2020-03-07,Qatar,QA,3,0,2781677,11,0
2020-03-08,Qatar,QA,1,0,2781677,12,0
2020-03-09,Qatar,QA,3,0,2781677,15,0
2020-03-10,Qatar,QA,3,0,2781677,18,0
2020-03-11,Qatar,QA,6,0,2781677,24,0
2020-03-12,Qatar,QA,238,0,2781677,262,0
2020-03-14,Qatar,QA,58,0,2781677,320,0
2020-03-15,Qatar,QA,17,0,2781677,337,0
2020-03-16,Qatar,QA,64,0,2781677,401,0
2020-03-17,Qatar,QA,38,0,2781677,439,0
2020-03-18,Qatar,QA,3,0,2781677,442,0
2020-03-19,Qatar,QA,10,0,2781677,452,0
2020-03-20,Qatar,QA,8,0,2781677,460,0
2020-03-21,Qatar,QA,10,0,2781677,470,0
2020-03-22,Qatar,QA,11,0,2781677,481,0
2020-03-23,Qatar,QA,13,0,2781677,494,0
2020-03-24,Qatar,QA,7,0,2781677,501,0
2020-03-25,Qatar,QA,25,0,2781677,526,0
2020-03-26,Qatar,QA,11,0,2781677,537,0
2020-03-27,Qatar,QA,12,0,2781677,549,0
2020-03-28,Qatar,QA,13,0,2781677,562,0
2020-03-29,Qatar,QA,28,1,2781677,590,1
2020-03-30,Qatar,QA,44,0,2781677,634,1
2020-03-31,Qatar,QA,59,0,2781677,693,1
2020-04-01,Qatar,QA,88,1,2781677,781,2
2020-04-02,Qatar,QA,54,0,2781677,835,2
2020-04-03,Qatar,QA,114,1,2781677,949,3
2020-04-04,Qatar,QA,0,0,2781677,949,3
2020-04-05,Qatar,QA,376,0,2781677,1325,3
2020-04-06,Qatar,QA,279,1,2781677,1604,4
2020-04-07,Qatar,QA,228,0,2781677,1832,4
2020-04-08,Qatar,QA,225,2,2781677,2057,6
2020-04-09,Qatar,QA,153,0,2781677,2210,6
2020-04-10,Qatar,QA,166,0,2781677,2376,6
2020-04-11,Qatar,QA,136,0,2781677,2512,6
2020-04-12,Qatar,QA,216,0,2781677,2728,6
2020-04-13,Qatar,QA,251,1,2781677,2979,7
2020-04-14,Qatar,QA,252,0,2781677,3231,7
2020-04-15,Qatar,QA,197,0,2781677,3428,7
2020-04-16,Qatar,QA,283,0,2781677,3711,7
2020-04-17,Qatar,QA,392,0,2781677,4103,7
2020-04-18,Qatar,QA,560,0,2781677,4663,7
2020-04-19,Qatar,QA,345,1,2781677,5008,8
2020-04-20,Qatar,QA,440,0,2781677,5448,8
2020-04-21,Qatar,QA,567,1,2781677,6015,9
2020-04-22,Qatar,QA,518,0,2781677,6533,9
2020-04-23,Qatar,QA,608,1,2781677,7141,10
2020-04-24,Qatar,QA,623,0,2781677,7764,10
2020-04-25,Qatar,QA,761,0,2781677,8525,10
2020-04-26,Qatar,QA,833,0,2781677,9358,10
2020-04-27,Qatar,QA,929,0,2781677,10287,10
2020-04-28,Qatar,QA,957,0,2781677,11244,10
2020-04-29,Qatar,QA,677,0,2781677,11921,10
2020-04-30,Qatar,QA,643,0,2781677,12564,10
2020-05-01,Qatar,QA,845,0,2781677,13409,10
2020-05-02,Qatar,QA,687,2,2781677,14096,12
2020-05-03,Qatar,QA,776,0,2781677,14872,12
2019-12-31,Romania,RO,0,0,19473936,0,0
2020-01-01,Romania,RO,0,0,19473936,0,0
2020-01-02,Romania,RO,0,0,19473936,0,0
2020-01-03,Romania,RO,0,0,19473936,0,0
2020-01-04,Romania,RO,0,0,19473936,0,0
2020-01-05,Romania,RO,0,0,19473936,0,0
2020-01-06,Romania,RO,0,0,19473936,0,0
2020-01-07,Romania,RO,0,0,19473936,0,0
2020-01-08,Romania,RO,0,0,19473936,0,0
2020-01-09,Romania,RO,0,0,19473936,0,0
2020-01-10,Romania,RO,0,0,19473936,0,0
2020-01-11,Romania,RO,0,0,19473936,0,0
2020-01-12,Romania,RO,0,0,19473936,0,0
2020-01-13,Romania,RO,0,0,19473936,0,0
2020-01-14,Romania,RO,0,0,19473936,0,0
2020-01-15,Romania,RO,0,0,19473936,0,0
2020-01-16,Romania,RO,0,0,19473936,0,0
2020-01-17,Romania,RO,0,0,19473936,0,0
2020-01-18,Romania,RO,0,0,19473936,0,0
2020-01-19,Romania,RO,0,0,19473936,0,0
2020-01-20,Romania,RO,0,0,19473936,0,0
2020-01-21,Romania,RO,0,0,19473936,0,0
2020-01-22,Romania,RO,0,0,19473936,0,0
2020-01-23,Romania,RO,0,0,19473936,0,0
2020-01-24,Romania,RO,0,0,19473936,0,0
2020-01-25,Romania,RO,0,0,19473936,0,0
2020-01-26,Romania,RO,0,0,19473936,0,0
2020-01-27,Romania,RO,0,0,19473936,0,0
2020-01-28,Romania,RO,0,0,19473936,0,0
2020-01-29,Romania,RO,0,0,19473936,0,0
2020-01-30,Romania,RO,0,0,19473936,0,0
2020-01-31,Romania,RO,0,0,19473936,0,0
2020-02-01,Romania,RO,0,0,19473936,0,0
2020-02-02,Romania,RO,0,0,19473936,0,0
2020-02-03,Romania,RO,0,0,19473936,0,0
2020-02-04,Romania,RO,0,0,19473936,0,0
2020-02-05,Romania,RO,0,0,19473936,0,0
2020-02-06,Romania,RO,0,0,19473936,0,0
2020-02-07,Romania,RO,0,0,19473936,0,0
2020-02-08,Romania,RO,0,0,19473936,0,0
2020-02-09,Romania,RO,0,0,19473936,0,0
2020-02-10,Romania,RO,0,0,19473936,0,0
2020-02-11,Romania,RO,0,0,19473936,0,0
2020-02-12,Romania,RO,0,0,19473936,0,0
2020-02-13,Romania,RO,0,0,19473936,0,0
2020-02-14,Romania,RO,0,0,19473936,0,0
2020-02-15,Romania,RO,0,0,19473936,0,0
2020-02-16,Romania,RO,0,0,19473936,0,0
2020-02-17,Romania,RO,0,0,19473936,0,0
2020-02-18,Romania,RO,0,0,19473936,0,0
2020-02-19,Romania,RO,0,0,19473936,0,0
2020-02-20,Romania,RO,0,0,19473936,0,0
2020-02-21,Romania,RO,0,0,19473936,0,0
2020-02-22,Romania,RO,0,0,19473936,0,0
2020-02-23,Romania,RO,0,0,19473936,0,0
2020-02-24,Romania,RO,0,0,19473936,0,0
2020-02-25,Romania,RO,0,0,19473936,0,0
2020-02-26,Romania,RO,0,0,19473936,0,0
2020-02-27,Romania,RO,1,0,19473936,1,0
2020-02-28,Romania,RO,0,0,19473936,1,0
2020-02-29,Romania,RO,2,0,19473936,3,0
2020-03-01,Romania,RO,0,0,19473936,3,0
2020-03-02,Romania,RO,0,0,19473936,3,0
2020-03-04,Romania,RO,1,0,19473936,4,0
2020-03-06,Romania,RO,2,0,19473936,6,0
2020-03-07,Romania,RO,1,0,19473936,7,0
2020-03-08,Romania,RO,6,0,19473936,13,0
2020-03-09,Romania,RO,2,0,19473936,15,0
2020-03-10,Romania,RO,2,0,19473936,17,0
2020-03-11,Romania,RO,8,0,19473936,25,0
2020-03-12,Romania,RO,20,0,19473936,45,0
2020-03-13,Romania,RO,19,0,19473936,64,0
2020-03-14,Romania,RO,25,0,19473936,89,0
2020-03-15,Romania,RO,24,0,19473936,113,0
2020-03-16,Romania,RO,26,0,19473936,139,0
2020-03-17,Romania,RO,45,0,19473936,184,0
2020-03-18,Romania,RO,33,0,19473936,217,0
2020-03-19,Romania,RO,43,0,19473936,260,0
2020-03-20,Romania,RO,17,0,19473936,277,0
2020-03-21,Romania,RO,31,0,19473936,308,0
2020-03-22,Romania,RO,59,0,19473936,367,0
2020-03-23,Romania,RO,66,2,19473936,433,2
2020-03-24,Romania,RO,143,5,19473936,576,7
2020-03-25,Romania,RO,186,4,19473936,762,11
2020-03-26,Romania,RO,144,2,19473936,906,13
2020-03-27,Romania,RO,123,4,19473936,1029,17
2020-03-28,Romania,RO,263,7,19473936,1292,24
2020-03-29,Romania,RO,160,5,19473936,1452,29
2020-03-30,Romania,RO,308,11,19473936,1760,40
2020-03-31,Romania,RO,192,4,19473936,1952,44
2020-04-01,Romania,RO,293,25,19473936,2245,69
2020-04-02,Romania,RO,215,16,19473936,2460,85
2020-04-03,Romania,RO,278,9,19473936,2738,94
2020-04-04,Romania,RO,445,39,19473936,3183,133
2020-04-05,Romania,RO,430,8,19473936,3613,141
2020-04-06,Romania,RO,251,7,19473936,3864,148
2020-04-07,Romania,RO,193,9,19473936,4057,157
2020-04-08,Romania,RO,360,25,19473936,4417,182
2020-04-09,Romania,RO,344,27,19473936,4761,209
2020-04-10,Romania,RO,441,20,19473936,5202,229
2020-04-11,Romania,RO,265,28,19473936,5467,257
2020-04-12,Romania,RO,523,25,19473936,5990,282
2020-04-13,Romania,RO,310,24,19473936,6300,306
2020-04-14,Romania,RO,333,12,19473936,6633,318
2020-04-15,Romania,RO,246,26,19473936,6879,344
2020-04-16,Romania,RO,337,28,19473936,7216,372
2020-04-17,Romania,RO,491,15,19473936,7707,387
2020-04-18,Romania,RO,360,13,19473936,8067,400
2020-04-19,Romania,RO,351,17,19473936,8418,417
2020-04-20,Romania,RO,328,17,19473936,8746,434
2020-04-21,Romania,RO,190,17,19473936,8936,451
2020-04-22,Romania,RO,306,32,19473936,9242,483
2020-04-23,Romania,RO,468,25,19473936,9710,508
2020-04-24,Romania,RO,386,19,19473936,10096,527
2020-04-25,Romania,RO,321,25,19473936,10417,552
2020-04-26,Romania,RO,218,23,19473936,10635,575
2020-04-27,Romania,RO,401,33,19473936,11036,608
2020-04-28,Romania,RO,303,23,19473936,11339,631
2020-04-29,Romania,RO,277,19,19473936,11616,650
2020-04-30,Romania,RO,362,25,19473936,11978,675
2020-05-01,Romania,RO,262,42,19473936,12240,717
2020-05-02,Romania,RO,327,27,19473936,12567,744
2020-05-03,Romania,RO,165,27,19473936,12732,771
2020-03-07,Serbia,RS,1,0,6982084,1,0
2020-03-11,Serbia,RS,4,0,6982084,5,0
2020-03-12,Serbia,RS,13,0,6982084,18,0
2020-03-13,Serbia,RS,6,0,6982084,24,0
2020-03-14,Serbia,RS,17,0,6982084,41,0
2020-03-15,Serbia,RS,5,0,6982084,46,0
2020-03-16,Serbia,RS,9,0,6982084,55,0
2020-03-17,Serbia,RS,2,0,6982084,57,0
2020-03-18,Serbia,RS,15,0,6982084,72,0
2020-03-19,Serbia,RS,22,0,6982084,94,0
2020-03-20,Serbia,RS,32,0,6982084,126,0
2020-03-21,Serbia,RS,9,1,6982084,135,1
2020-03-22,Serbia,RS,14,0,6982084,149,1
2020-03-23,Serbia,RS,39,0,6982084,188,1
2020-03-24,Serbia,RS,34,0,6982084,222,1
2020-03-25,Serbia,RS,27,0,6982084,249,1
2020-03-26,Serbia,RS,54,1,6982084,303,2
2020-03-27,Serbia,RS,81,1,6982084,384,3
2020-03-28,Serbia,RS,73,3,6982084,457,6
2020-03-29,Serbia,RS,202,4,6982084,659,10
2020-03-30,Serbia,RS,82,3,6982084,741,13
2020-03-31,Serbia,RS,0,0,6982084,741,13
2020-04-01,Serbia,RS,159,10,6982084,900,23
2020-04-02,Serbia,RS,160,0,6982084,1060,23
2020-04-03,Serbia,RS,111,8,6982084,1171,31
2020-04-04,Serbia,RS,305,8,6982084,1476,39
2020-04-05,Serbia,RS,148,5,6982084,1624,44
2020-04-06,Serbia,RS,284,7,6982084,1908,51
2020-04-07,Serbia,RS,292,7,6982084,2200,58
2020-04-08,Serbia,RS,247,3,6982084,2447,61
2020-04-09,Serbia,RS,219,4,6982084,2666,65
2020-04-10,Serbia,RS,201,1,6982084,2867,66
2020-04-11,Serbia,RS,238,5,6982084,3105,71
2020-04-12,Serbia,RS,275,3,6982084,3380,74
2020-04-13,Serbia,RS,250,6,6982084,3630,80
2020-04-14,Serbia,RS,424,5,6982084,4054,85
2020-04-15,Serbia,RS,411,9,6982084,4465,94
2020-04-16,Serbia,RS,408,5,6982084,4873,99
2020-04-17,Serbia,RS,445,4,6982084,5318,103
2020-04-18,Serbia,RS,372,7,6982084,5690,110
2020-04-19,Serbia,RS,304,7,6982084,5994,117
2020-04-20,Serbia,RS,324,5,6982084,6318,122
2020-04-21,Serbia,RS,312,3,6982084,6630,125
2020-04-22,Serbia,RS,260,0,6982084,6890,125
2020-04-23,Serbia,RS,224,9,6982084,7114,134
2020-04-24,Serbia,RS,162,5,6982084,7276,139
2020-04-25,Serbia,RS,207,5,6982084,7483,144
2020-04-26,Serbia,RS,296,7,6982084,7779,151
2020-04-27,Serbia,RS,263,5,6982084,8042,156
2020-04-28,Serbia,RS,233,6,6982084,8275,162
2020-04-29,Serbia,RS,222,6,6982084,8497,168
2020-04-30,Serbia,RS,227,5,6982084,8724,173
2020-05-01,Serbia,RS,285,6,6982084,9009,179
2020-05-02,Serbia,RS,196,6,6982084,9205,185
2020-05-03,Serbia,RS,157,4,6982084,9362,189
2019-12-31,Russia,RU,0,0,144478050,0,0
2020-01-01,Russia,RU,0,0,144478050,0,0
2020-01-02,Russia,RU,0,0,144478050,0,0
2020-01-03,Russia,RU,0,0,144478050,0,0
2020-01-04,Russia,RU,0,0,144478050,0,0
2020-01-05,Russia,RU,0,0,144478050,0,0
2020-01-06,Russia,RU,0,0,144478050,0,0
2020-01-07,Russia,RU,0,0,144478050,0,0
2020-01-08,Russia,RU,0,0,144478050,0,0
2020-01-09,Russia,RU,0,0,144478050,0,0
2020-01-10,Russia,RU,0,0,144478050,0,0
2020-01-11,Russia,RU,0,0,144478050,0,0
2020-01-12,Russia,RU,0,0,144478050,0,0
2020-01-13,Russia,RU,0,0,144478050,0,0
2020-01-14,Russia,RU,0,0,144478050,0,0
2020-01-15,Russia,RU,0,0,144478050,0,0
2020-01-16,Russia,RU,0,0,144478050,0,0
2020-01-17,Russia,RU,0,0,144478050,0,0
2020-01-18,Russia,RU,0,0,144478050,0,0
2020-01-19,Russia,RU,0,0,144478050,0,0
2020-01-20,Russia,RU,0,0,144478050,0,0
2020-01-21,Russia,RU,0,0,144478050,0,0
2020-01-22,Russia,RU,0,0,144478050,0,0
2020-01-23,Russia,RU,0,0,144478050,0,0
2020-01-24,Russia,RU,0,0,144478050,0,0
2020-01-25,Russia,RU,0,0,144478050,0,0
2020-01-26,Russia,RU,0,0,144478050,0,0
2020-01-27,Russia,RU,0,0,144478050,0,0
2020-01-28,Russia,RU,0,0,144478050,0,0
2020-01-29,Russia,RU,0,0,144478050,0,0
2020-01-30,Russia,RU,0,0,144478050,0,0
2020-01-31,Russia,RU,0,0,144478050,0,0
2020-02-01,Russia,RU,2,0,144478050,2,0
2020-02-02,Russia,RU,0,0,144478050,2,0
2020-02-03,Russia,RU,0,0,144478050,2,0
2020-02-04,Russia,RU,0,0,144478050,2,0
2020-02-05,Russia,RU,0,0,144478050,2,0
2020-02-06,Russia,RU,0,0,144478050,2,0
2020-02-07,Russia,RU,0,0,144478050,2,0
2020-02-08,Russia,RU,0,0,144478050,2,0
2020-02-09,Russia,RU,0,0,144478050,2,0
2020-02-10,Russia,RU,0,0,144478050,2,0
2020-02-11,Russia,RU,0,0,144478050,2,0
2020-02-12,Russia,RU,0,0,144478050,2,0
2020-02-13,Russia,RU,0,0,144478050,2,0
2020-02-14,Russia,RU,0,0,144478050,2,0
2020-02-15,Russia,RU,0,0,144478050,2,0
2020-02-16,Russia,RU,0,0,144478050,2,0
2020-02-17,Russia,RU,0,0,144478050,2,0
2020-02-18,Russia,RU,0,0,144478050,2,0
2020-02-19,Russia,RU,0,0,144478050,2,0
2020-02-20,Russia,RU,0,0,144478050,2,0
2020-02-21,Russia,RU,0,0,144478050,2,0
2020-02-22,Russia,RU,0,0,144478050,2,0
2020-02-23,Russia,RU,0,0,144478050,2,0
2020-02-24,Russia,RU,0,0,144478050,2,0
2020-02-25,Russia,RU,0,0,144478050,2,0
2020-02-26,Russia,RU,0,0,144478050,2,0
2020-02-27,Russia,RU,0,0,144478050,2,0
2020-02-28,Russia,RU,0,0,144478050,2,0
2020-02-29,Russia,RU,0,0,144478050,2,0
2020-03-01,Russia,RU,0,0,144478050,2,0
2020-03-02,Russia,RU,0,0,144478050,2,0
2020-03-03,Russia,RU,1,0,144478050,3,0
2020-03-04,Russia,RU,1,0,144478050,4,0
2020-03-05,Russia,RU,0,0,144478050,4,0
2020-03-06,Russia,RU,0,0,144478050,4,0
2020-03-07,Russia,RU,6,0,144478050,10,0
2020-03-08,Russia,RU,0,0,144478050,10,0
2020-03-09,Russia,RU,0,0,144478050,10,0
2020-03-10,Russia,RU,0,0,144478050,10,0
2020-03-11,Russia,RU,0,0,144478050,10,0
2020-03-12,Russia,RU,15,0,144478050,25,0
2020-03-13,Russia,RU,5,0,144478050,30,0
2020-03-14,Russia,RU,15,0,144478050,45,0
2020-03-15,Russia,RU,14,0,144478050,59,0
2020-03-16,Russia,RU,4,0,144478050,63,0
2020-03-17,Russia,RU,30,0,144478050,93,0
2020-03-18,Russia,RU,21,0,144478050,114,0
2020-03-19,Russia,RU,33,0,144478050,147,0
2020-03-20,Russia,RU,52,0,144478050,199,0
2020-03-21,Russia,RU,54,0,144478050,253,0
2020-03-22,Russia,RU,53,0,144478050,306,0
2020-03-23,Russia,RU,132,0,144478050,438,0
2020-03-24,Russia,RU,0,0,144478050,438,0
2020-03-25,Russia,RU,57,0,144478050,495,0
2020-03-26,Russia,RU,163,0,144478050,658,0
2020-03-27,Russia,RU,182,2,144478050,840,2
2020-03-28,Russia,RU,196,2,144478050,1036,4
2020-03-29,Russia,RU,228,1,144478050,1264,5
2020-03-30,Russia,RU,270,3,144478050,1534,8
2020-03-31,Russia,RU,302,2,144478050,1836,10
2020-04-01,Russia,RU,501,7,144478050,2337,17
2020-04-02,Russia,RU,440,7,144478050,2777,24
2020-04-03,Russia,RU,771,6,144478050,3548,30
2020-04-04,Russia,RU,601,4,144478050,4149,34
2020-04-05,Russia,RU,582,9,144478050,4731,43
2020-04-06,Russia,RU,658,2,144478050,5389,45
2020-04-07,Russia,RU,954,2,144478050,6343,47
2020-04-08,Russia,RU,1154,11,144478050,7497,58
2020-04-09,Russia,RU,1175,5,144478050,8672,63
2020-04-10,Russia,RU,1459,13,144478050,10131,76
2020-04-11,Russia,RU,1786,18,144478050,11917,94
2020-04-12,Russia,RU,1667,12,144478050,13584,106
2020-04-13,Russia,RU,2186,24,144478050,15770,130
2020-04-14,Russia,RU,2558,18,144478050,18328,148
2020-04-15,Russia,RU,2774,22,144478050,21102,170
2020-04-16,Russia,RU,3388,28,144478050,24490,198
2020-04-17,Russia,RU,3448,34,144478050,27938,232
2020-04-18,Russia,RU,4070,41,144478050,32008,273
2020-04-19,Russia,RU,4785,40,144478050,36793,313
2020-04-20,Russia,RU,6060,48,144478050,42853,361
2020-04-21,Russia,RU,4268,44,144478050,47121,405
2020-04-22,Russia,RU,5642,51,144478050,52763,456
2020-04-23,Russia,RU,5236,57,144478050,57999,513
2020-04-24,Russia,RU,4774,42,144478050,62773,555
2020-04-25,Russia,RU,5849,60,144478050,68622,615
2020-04-26,Russia,RU,5966,66,144478050,74588,681
2020-04-27,Russia,RU,6361,66,144478050,80949,747
2020-04-28,Russia,RU,6198,48,144478050,87147,795
2020-04-29,Russia,RU,6411,72,144478050,93558,867
2020-04-30,Russia,RU,5841,105,144478050,99399,972
2020-05-01,Russia,RU,7099,101,144478050,106498,1073
2020-05-02,Russia,RU,7933,96,144478050,114431,1169
2020-05-03,Russia,RU,9623,53,144478050,124054,1222
2020-03-15,Rwanda,RW,1,0,12301939,1,0
2020-03-16,Rwanda,RW,4,0,12301939,5,0
2020-03-17,Rwanda,RW,0,0,12301939,5,0
2020-03-18,Rwanda,RW,2,0,12301939,7,0
2020-03-19,Rwanda,RW,4,0,12301939,11,0
2020-03-20,Rwanda,RW,0,0,12301939,11,0
2020-03-21,Rwanda,RW,6,0,12301939,17,0
2020-03-22,Rwanda,RW,0,0,12301939,17,0
2020-03-23,Rwanda,RW,2,0,12301939,19,0
2020-03-24,Rwanda,RW,17,0,12301939,36,0
2020-03-25,Rwanda,RW,4,0,12301939,40,0
2020-03-26,Rwanda,RW,1,0,12301939,41,0
2020-03-27,Rwanda,RW,9,0,12301939,50,0
2020-03-28,Rwanda,RW,4,0,12301939,54,0
2020-03-29,Rwanda,RW,6,0,12301939,60,0
2020-03-30,Rwanda,RW,10,0,12301939,70,0
2020-03-31,Rwanda,RW,0,0,12301939,70,0
2020-04-01,Rwanda,RW,5,0,12301939,75,0
2020-04-02,Rwanda,RW,7,0,12301939,82,0
2020-04-03,Rwanda,RW,0,0,12301939,82,0
2020-04-04,Rwanda,RW,7,0,12301939,89,0
2020-04-05,Rwanda,RW,13,0,12301939,102,0
2020-04-06,Rwanda,RW,2,0,12301939,104,0
2020-04-07,Rwanda,RW,1,0,12301939,105,0
2020-04-08,Rwanda,RW,0,0,12301939,105,0
2020-04-09,Rwanda,RW,5,0,12301939,110,0
2020-04-10,Rwanda,RW,3,0,12301939,113,0
2020-04-11,Rwanda,RW,5,0,12301939,118,0
2020-04-12,Rwanda,RW,2,0,12301939,120,0
2020-04-13,Rwanda,RW,6,0,12301939,126,0
2020-04-14,Rwanda,RW,1,0,12301939,127,0
2020-04-15,Rwanda,RW,7,0,12301939,134,0
2020-04-16,Rwanda,RW,2,0,12301939,136,0
2020-04-17,Rwanda,RW,2,0,12301939,138,0
2020-04-18,Rwanda,RW,5,0,12301939,143,0
2020-04-19,Rwanda,RW,1,0,12301939,144,0
2020-04-20,Rwanda,RW,3,0,12301939,147,0
2020-04-21,Rwanda,RW,0,0,12301939,147,0
2020-04-22,Rwanda,RW,3,0,12301939,150,0
2020-04-23,Rwanda,RW,3,0,12301939,153,0
2020-04-24,Rwanda,RW,1,0,12301939,154,0
2020-04-25,Rwanda,RW,22,0,12301939,176,0
2020-04-26,Rwanda,RW,7,0,12301939,183,0
2020-04-27,Rwanda,RW,8,0,12301939,191,0
2020-04-28,Rwanda,RW,16,0,12301939,207,0
2020-04-29,Rwanda,RW,5,0,12301939,212,0
2020-04-30,Rwanda,RW,13,0,12301939,225,0
2020-05-01,Rwanda,RW,18,0,12301939,243,0
2020-05-02,Rwanda,RW,6,0,12301939,249,0
2020-05-03,Rwanda,RW,6,0,12301939,255,0
2020-03-03,Saudi_Arabia,SA,1,0,33699947,1,0
2020-03-06,Saudi_Arabia,SA,4,0,33699947,5,0
2020-03-08,Saudi_Arabia,SA,2,0,33699947,7,0
2020-03-09,Saudi_Arabia,SA,4,0,33699947,11,0
2020-03-10,Saudi_Arabia,SA,4,0,33699947,15,0
2020-03-11,Saudi_Arabia,SA,5,0,33699947,20,0
2020-03-12,Saudi_Arabia,SA,25,0,33699947,45,0
2020-03-13,Saudi_Arabia,SA,17,0,33699947,62,0
2020-03-14,Saudi_Arabia,SA,24,0,33699947,86,0
2020-03-15,Saudi_Arabia,SA,0,0,33699947,86,0
2020-03-16,Saudi_Arabia,SA,32,0,33699947,118,0
2020-03-17,Saudi_Arabia,SA,15,0,33699947,133,0
2020-03-18,Saudi_Arabia,SA,0,0,33699947,133,0
2020-03-19,Saudi_Arabia,SA,38,0,33699947,171,0
2020-03-20,Saudi_Arabia,SA,67,0,33699947,238,0
2020-03-21,Saudi_Arabia,SA,36,0,33699947,274,0
2020-03-22,Saudi_Arabia,SA,118,0,33699947,392,0
2020-03-23,Saudi_Arabia,SA,119,0,33699947,511,0
2020-03-24,Saudi_Arabia,SA,51,0,33699947,562,0
2020-03-25,Saudi_Arabia,SA,205,1,33699947,767,1
2020-03-26,Saudi_Arabia,SA,133,1,33699947,900,2
2020-03-27,Saudi_Arabia,SA,112,1,33699947,1012,3
2020-03-28,Saudi_Arabia,SA,92,0,33699947,1104,3
2020-03-29,Saudi_Arabia,SA,99,1,33699947,1203,4
2020-03-30,Saudi_Arabia,SA,26,4,33699947,1229,8
2020-03-31,Saudi_Arabia,SA,224,0,33699947,1453,8
2020-04-01,Saudi_Arabia,SA,110,2,33699947,1563,10
2020-04-02,Saudi_Arabia,SA,157,6,33699947,1720,16
2020-04-03,Saudi_Arabia,SA,165,5,33699947,1885,21
2020-04-04,Saudi_Arabia,SA,0,0,33699947,1885,21
2020-04-05,Saudi_Arabia,SA,294,8,33699947,2179,29
2020-04-06,Saudi_Arabia,SA,206,5,33699947,2385,34
2020-04-07,Saudi_Arabia,SA,138,4,33699947,2523,38
2020-04-08,Saudi_Arabia,SA,272,3,33699947,2795,41
2020-04-09,Saudi_Arabia,SA,137,0,33699947,2932,41
2020-04-10,Saudi_Arabia,SA,355,3,33699947,3287,44
2020-04-11,Saudi_Arabia,SA,364,3,33699947,3651,47
2020-04-12,Saudi_Arabia,SA,382,5,33699947,4033,52
2020-04-13,Saudi_Arabia,SA,429,7,33699947,4462,59
2020-04-14,Saudi_Arabia,SA,472,6,33699947,4934,65
2020-04-15,Saudi_Arabia,SA,435,8,33699947,5369,73
2020-04-16,Saudi_Arabia,SA,493,6,33699947,5862,79
2020-04-17,Saudi_Arabia,SA,518,4,33699947,6380,83
2020-04-18,Saudi_Arabia,SA,762,4,33699947,7142,87
2020-04-19,Saudi_Arabia,SA,1132,5,33699947,8274,92
2020-04-20,Saudi_Arabia,SA,1088,5,33699947,9362,97
2020-04-21,Saudi_Arabia,SA,1122,6,33699947,10484,103
2020-04-22,Saudi_Arabia,SA,1147,6,33699947,11631,109
2020-04-23,Saudi_Arabia,SA,1141,5,33699947,12772,114
2020-04-24,Saudi_Arabia,SA,1158,7,33699947,13930,121
2020-04-25,Saudi_Arabia,SA,1172,6,33699947,15102,127
2020-04-26,Saudi_Arabia,SA,1197,9,33699947,16299,136
2020-04-27,Saudi_Arabia,SA,1223,3,33699947,17522,139
2020-04-28,Saudi_Arabia,SA,1289,5,33699947,18811,144
2020-04-29,Saudi_Arabia,SA,1266,8,33699947,20077,152
2020-04-30,Saudi_Arabia,SA,1325,5,33699947,21402,157
2020-05-01,Saudi_Arabia,SA,1351,5,33699947,22753,162
2020-05-02,Saudi_Arabia,SA,1344,7,33699947,24097,169
2020-05-03,Saudi_Arabia,SA,1362,7,33699947,25459,176
2020-03-15,Seychelles,SC,2,0,96762,2,0
2020-03-16,Seychelles,SC,1,0,96762,3,0
2020-03-17,Seychelles,SC,1,0,96762,4,0
2020-03-18,Seychelles,SC,0,0,96762,4,0
2020-03-19,Seychelles,SC,2,0,96762,6,0
2020-03-20,Seychelles,SC,0,0,96762,6,0
2020-03-21,Seychelles,SC,1,0,96762,7,0
2020-03-22,Seychelles,SC,0,0,96762,7,0
2020-03-23,Seychelles,SC,0,0,96762,7,0
2020-03-24,Seychelles,SC,0,0,96762,7,0
2020-03-25,Seychelles,SC,0,0,96762,7,0
2020-03-26,Seychelles,SC,0,0,96762,7,0
2020-03-27,Seychelles,SC,0,0,96762,7,0
2020-03-28,Seychelles,SC,0,0,96762,7,0
2020-03-29,Seychelles,SC,0,0,96762,7,0
2020-03-30,Seychelles,SC,1,0,96762,8,0
2020-03-31,Seychelles,SC,2,0,96762,10,0
2020-04-01,Seychelles,SC,0,0,96762,10,0
2020-04-02,Seychelles,SC,0,0,96762,10,0
2020-04-03,Seychelles,SC,0,0,96762,10,0
2020-04-04,Seychelles,SC,0,0,96762,10,0
2020-04-05,Seychelles,SC,0,0,96762,10,0
2020-04-06,Seychelles,SC,0,0,96762,10,0
2020-04-07,Seychelles,SC,0,0,96762,10,0
2020-04-08,Seychelles,SC,0,0,96762,10,0
2020-04-09,Seychelles,SC,0,0,96762,10,0
2020-04-10,Seychelles,SC,0,0,96762,10,0
2020-04-11,Seychelles,SC,0,0,96762,10,0
2020-04-12,Seychelles,SC,0,0,96762,10,0
2020-04-13,Seychelles,SC,0,0,96762,10,0
2020-04-14,Seychelles,SC,0,0,96762,10,0
2020-04-15,Seychelles,SC,1,0,96762,11,0
2020-04-16,Seychelles,SC,0,0,96762,11,0
2020-04-17,Seychelles,SC,0,0,96762,11,0
2020-04-18,Seychelles,SC,0,0,96762,11,0
2020-04-19,Seychelles,SC,0,0,96762,11,0
2020-04-20,Seychelles,SC,0,0,96762,11,0
2020-04-21,Seychelles,SC,0,0,96762,11,0
2020-04-22,Seychelles,SC,0,0,96762,11,0
2020-04-23,Seychelles,SC,0,0,96762,11,0
2020-04-24,Seychelles,SC,0,0,96762,11,0
2020-04-25,Seychelles,SC,0,0,96762,11,0
2020-04-26,Seychelles,SC,0,0,96762,11,0
2020-04-27,Seychelles,SC,0,0,96762,11,0
2020-04-28,Seychelles,SC,0,0,96762,11,0
2020-04-29,Seychelles,SC,0,0,96762,11,0
2020-04-30,Seychelles,SC,0,0,96762,11,0
2020-05-01,Seychelles,SC,0,0,96762,11,0
2020-05-02,Seychelles,SC,0,0,96762,11,0
2020-05-03,Seychelles,SC,0,0,96762,11,0
2020-03-14,Sudan,SD,1,0,41801533,1,0
2020-03-15,Sudan,SD,0,1,41801533,1,1
2020-03-16,Sudan,SD,0,0,41801533,1,1
2020-03-17,Sudan,SD,0,0,41801533,1,1
2020-03-18,Sudan,SD,0,0,41801533,1,1
2020-03-19,Sudan,SD,1,0,41801533,2,1
2020-03-20,Sudan,SD,0,0,41801533,2,1
2020-03-21,Sudan,SD,0,0,41801533,2,1
2020-03-22,Sudan,SD,0,0,41801533,2,1
2020-03-23,Sudan,SD,0,0,41801533,2,1
2020-03-24,Sudan,SD,0,0,41801533,2,1
2020-03-25,Sudan,SD,1,0,41801533,3,1
2020-03-26,Sudan,SD,0,0,41801533,3,1
2020-03-27,Sudan,SD,0,0,41801533,3,1
2020-03-28,Sudan,SD,0,0,41801533,3,1
2020-03-29,Sudan,SD,2,0,41801533,5,1
2020-03-30,Sudan,SD,0,0,41801533,5,1
2020-03-31,Sudan,SD,1,1,41801533,6,2
2020-04-01,Sudan,SD,1,0,41801533,7,2
2020-04-02,Sudan,SD,0,0,41801533,7,2
2020-04-03,Sudan,SD,0,0,41801533,7,2
2020-04-04,Sudan,SD,0,0,41801533,7,2
2020-04-05,Sudan,SD,3,0,41801533,10,2
2020-04-06,Sudan,SD,2,0,41801533,12,2
2020-04-07,Sudan,SD,0,0,41801533,12,2
2020-04-08,Sudan,SD,2,0,41801533,14,2
2020-04-09,Sudan,SD,0,0,41801533,14,2
2020-04-10,Sudan,SD,0,0,41801533,14,2
2020-04-11,Sudan,SD,1,0,41801533,15,2
2020-04-12,Sudan,SD,4,0,41801533,19,2
2020-04-13,Sudan,SD,0,0,41801533,19,2
2020-04-14,Sudan,SD,10,2,41801533,29,4
2020-04-15,Sudan,SD,3,1,41801533,32,5
2020-04-16,Sudan,SD,0,0,41801533,32,5
2020-04-17,Sudan,SD,0,0,41801533,32,5
2020-04-18,Sudan,SD,0,0,41801533,32,5
2020-04-19,Sudan,SD,34,5,41801533,66,10
2020-04-20,Sudan,SD,0,0,41801533,66,10
2020-04-21,Sudan,SD,26,2,41801533,92,12
2020-04-22,Sudan,SD,15,0,41801533,107,12
2020-04-23,Sudan,SD,33,1,41801533,140,13
2020-04-24,Sudan,SD,22,0,41801533,162,13
2020-04-25,Sudan,SD,12,3,41801533,174,16
2020-04-26,Sudan,SD,39,1,41801533,213,17
2020-04-27,Sudan,SD,24,4,41801533,237,21
2020-04-28,Sudan,SD,38,1,41801533,275,22
2020-04-29,Sudan,SD,43,3,41801533,318,25
2020-04-30,Sudan,SD,57,3,41801533,375,28
2020-05-01,Sudan,SD,67,3,41801533,442,31
2020-05-02,Sudan,SD,0,0,41801533,442,31
2020-05-03,Sudan,SD,150,10,41801533,592,41
2019-12-31,Sweden,SE,0,0,10183175,0,0
2020-01-01,Sweden,SE,0,0,10183175,0,0
2020-01-02,Sweden,SE,0,0,10183175,0,0
2020-01-03,Sweden,SE,0,0,10183175,0,0
2020-01-04,Sweden,SE,0,0,10183175,0,0
2020-01-05,Sweden,SE,0,0,10183175,0,0
2020-01-06,Sweden,SE,0,0,10183175,0,0
2020-01-07,Sweden,SE,0,0,10183175,0,0
2020-01-08,Sweden,SE,0,0,10183175,0,0
2020-01-09,Sweden,SE,0,0,10183175,0,0
2020-01-10,Sweden,SE,0,0,10183175,0,0
2020-01-11,Sweden,SE,0,0,10183175,0,0
2020-01-12,Sweden,SE,0,0,10183175,0,0
2020-01-13,Sweden,SE,0,0,10183175,0,0
2020-01-14,Sweden,SE,0,0,10183175,0,0
2020-01-15,Sweden,SE,0,0,10183175,0,0
2020-01-16,Sweden,SE,0,0,10183175,0,0
2020-01-17,Sweden,SE,0,0,10183175,0,0
2020-01-18,Sweden,SE,0,0,10183175,0,0
2020-01-19,Sweden,SE,0,0,10183175,0,0
2020-01-20,Sweden,SE,0,0,10183175,0,0
2020-01-21,Sweden,SE,0,0,10183175,0,0
2020-01-22,Sweden,SE,0,0,10183175,0,0
2020-01-23,Sweden,SE,0,0,10183175,0,0
2020-01-24,Sweden,SE,0,0,10183175,0,0
2020-01-25,Sweden,SE,0,0,10183175,0,0
2020-01-26,Sweden,SE,0,0,10183175,0,0
2020-01-27,Sweden,SE,0,0,10183175,0,0
2020-01-28,Sweden,SE,0,0,10183175,0,0
2020-01-29,Sweden,SE,0,0,10183175,0,0
2020-01-30,Sweden,SE,0,0,10183175,0,0
2020-01-31,Sweden,SE,0,0,10183175,0,0
2020-02-01,Sweden,SE,1,0,10183175,1,0
2020-02-02,Sweden,SE,0,0,10183175,1,0
2020-02-03,Sweden,SE,0,0,10183175,1,0
2020-02-04,Sweden,SE,0,0,10183175,1,0
2020-02-05,Sweden,SE,0,0,10183175,1,0
2020-02-06,Sweden,SE,0,0,10183175,1,0
2020-02-07,Sweden,SE,0,0,10183175,1,0
2020-02-08,Sweden,SE,0,0,10183175,1,0
2020-02-09,Sweden,SE,0,0,10183175,1,0
2020-02-10,Sweden,SE,0,0,10183175,1,0
2020-02-11,Sweden,SE,0,0,10183175,1,0
2020-02-12,Sweden,SE,0,0,10183175,1,0
2020-02-13,Sweden,SE,0,0,10183175,1,0
2020-02-14,Sweden,SE,0,0,10183175,1,0
2020-02-15,Sweden,SE,0,0,10183175,1,0
2020-02-16,Sweden,SE,0,0,10183175,1,0
2020-02-17,Sweden,SE,0,0,10183175,1,0
2020-02-18,Sweden,SE,0,0,10183175,1,0
2020-02-19,Sweden,SE,0,0,10183175,1,0
2020-02-20,Sweden,SE,0,0,10183175,1,0
2020-02-21,Sweden,SE,0,0,10183175,1,0
2020-02-22,Sweden,SE,0,0,10183175,1,0
2020-02-23,Sweden,SE,0,0,10183175,1,0
2020-02-24,Sweden,SE,0,0,10183175,1,0
2020-02-25,Sweden,SE,0,0,10183175,1,0
2020-02-26,Sweden,SE,0,0,10183175,1,0
2020-02-27,Sweden,SE,1,0,10183175,2,0
2020-02-28,Sweden,SE,5,0,10183175,7,0
2020-02-29,Sweden,SE,5,0,10183175,12,0
2020-03-01,Sweden,SE,1,0,10183175,13,0
2020-03-02,Sweden,SE,1,0,10183175,14,0
2020-03-03,Sweden,SE,1,0,10183175,15,0
2020-03-04,Sweden,SE,9,0,10183175,24,0
2020-03-05,Sweden,SE,11,0,10183175,35,0
2020-03-06,Sweden,SE,26,0,10183175,61,0
2020-03-07,Sweden,SE,76,0,10183175,137,0
2020-03-08,Sweden,SE,24,0,10183175,161,0
2020-03-09,Sweden,SE,42,0,10183175,203,0
2020-03-10,Sweden,SE,45,0,10183175,248,0
2020-03-11,Sweden,SE,78,0,10183175,326,0
2020-03-12,Sweden,SE,136,1,10183175,462,1
2020-03-13,Sweden,SE,158,0,10183175,620,1
2020-03-14,Sweden,SE,155,0,10183175,775,1
2020-03-15,Sweden,SE,149,0,10183175,924,1
2020-03-16,Sweden,SE,108,2,10183175,1032,3
2020-03-17,Sweden,SE,89,4,10183175,1121,7
2020-03-18,Sweden,SE,46,1,10183175,1167,8
2020-03-19,Sweden,SE,134,2,10183175,1301,10
2020-03-20,Sweden,SE,122,0,10183175,1423,10
2020-03-21,Sweden,SE,200,6,10183175,1623,16
2020-03-22,Sweden,SE,123,4,10183175,1746,20
2020-03-23,Sweden,SE,160,1,10183175,1906,21
2020-03-24,Sweden,SE,110,4,10183175,2016,25
2020-03-25,Sweden,SE,256,11,10183175,2272,36
2020-03-26,Sweden,SE,238,6,10183175,2510,42
2020-03-27,Sweden,SE,296,24,10183175,2806,66
2020-03-28,Sweden,SE,240,26,10183175,3046,92
2020-03-29,Sweden,SE,401,10,10183175,3447,102
2020-03-30,Sweden,SE,253,8,10183175,3700,110
2020-03-31,Sweden,SE,328,36,10183175,4028,146
2020-04-01,Sweden,SE,407,34,10183175,4435,180
2020-04-02,Sweden,SE,512,59,10183175,4947,239
2020-04-03,Sweden,SE,519,43,10183175,5466,282
2020-04-04,Sweden,SE,612,51,10183175,6078,333
2020-04-05,Sweden,SE,365,40,10183175,6443,373
2020-04-06,Sweden,SE,387,28,10183175,6830,401
2020-04-07,Sweden,SE,376,76,10183175,7206,477
2020-04-08,Sweden,SE,487,114,10183175,7693,591
2020-04-09,Sweden,SE,726,96,10183175,8419,687
2020-04-10,Sweden,SE,722,106,10183175,9141,793
2020-04-11,Sweden,SE,544,77,10183175,9685,870
2020-04-12,Sweden,SE,466,17,10183175,10151,887
2020-04-13,Sweden,SE,332,12,10183175,10483,899
2020-04-14,Sweden,SE,465,20,10183175,10948,919
2020-04-15,Sweden,SE,497,114,10183175,11445,1033
2020-04-16,Sweden,SE,482,170,10183175,11927,1203
2020-04-17,Sweden,SE,613,130,10183175,12540,1333
2020-04-18,Sweden,SE,676,67,10183175,13216,1400
2020-04-19,Sweden,SE,606,111,10183175,13822,1511
2020-04-20,Sweden,SE,563,29,10183175,14385,1540
2020-04-21,Sweden,SE,392,40,10183175,14777,1580
2020-04-22,Sweden,SE,545,185,10183175,15322,1765
2020-04-23,Sweden,SE,682,172,10183175,16004,1937
2020-04-24,Sweden,SE,751,84,10183175,16755,2021
2020-04-25,Sweden,SE,812,131,10183175,17567,2152
2020-04-26,Sweden,SE,610,40,10183175,18177,2192
2020-04-27,Sweden,SE,463,2,10183175,18640,2194
2020-04-28,Sweden,SE,286,80,10183175,18926,2274
2020-04-29,Sweden,SE,695,81,10183175,19621,2355
2020-04-30,Sweden,SE,681,107,10183175,20302,2462
2020-05-01,Sweden,SE,790,124,10183175,21092,2586
2020-05-02,Sweden,SE,428,67,10183175,21520,2653
2020-05-03,Sweden,SE,562,16,10183175,22082,2669
2019-12-31,Singapore,SG,0,0,5638676,0,0
2020-01-01,Singapore,SG,0,0,5638676,0,0
2020-01-02,Singapore,SG,0,0,5638676,0,0
2020-01-03,Singapore,SG,0,0,5638676,0,0
2020-01-04,Singapore,SG,0,0,5638676,0,0
2020-01-05,Singapore,SG,0,0,5638676,0,0
2020-01-06,Singapore,SG,0,0,5638676,0,0
2020-01-07,Singapore,SG,0,0,5638676,0,0
2020-01-08,Singapore,SG,0,0,5638676,0,0
2020-01-09,Singapore,SG,0,0,5638676,0,0
2020-01-10,Singapore,SG,0,0,5638676,0,0
2020-01-11,Singapore,SG,0,0,5638676,0,0
2020-01-12,Singapore,SG,0,0,5638676,0,0
2020-01-13,Singapore,SG,0,0,5638676,0,0
2020-01-14,Singapore,SG,0,0,5638676,0,0
2020-01-15,Singapore,SG,0,0,5638676,0,0
2020-01-16,Singapore,SG,0,0,5638676,0,0
2020-01-17,Singapore,SG,0,0,5638676,0,0
2020-01-18,Singapore,SG,0,0,5638676,0,0
2020-01-19,Singapore,SG,0,0,5638676,0,0
2020-01-20,Singapore,SG,0,0,5638676,0,0
2020-01-21,Singapore,SG,0,0,5638676,0,0
2020-01-22,Singapore,SG,0,0,5638676,0,0
2020-01-23,Singapore,SG,0,0,5638676,0,0
2020-01-24,Singapore,SG,3,0,5638676,3,0
2020-01-25,Singapore,SG,0,0,5638676,3,0
2020-01-26,Singapore,SG,1,0,5638676,4,0
2020-01-27,Singapore,SG,0,0,5638676,4,0
2020-01-28,Singapore,SG,1,0,5638676,5,0
2020-01-29,Singapore,SG,2,0,5638676,7,0
2020-01-30,Singapore,SG,3,0,5638676,10,0
2020-01-31,Singapore,SG,3,0,5638676,13,0
2020-02-01,Singapore,SG,3,0,5638676,16,0
2020-02-02,Singapore,SG,2,0,5638676,18,0
2020-02-03,Singapore,SG,0,0,5638676,18,0
2020-02-04,Singapore,SG,0,0,5638676,18,0
2020-02-05,Singapore,SG,6,0,5638676,24,0
2020-02-06,Singapore,SG,4,0,5638676,28,0
2020-02-07,Singapore,SG,2,0,5638676,30,0
2020-02-08,Singapore,SG,3,0,5638676,33,0
2020-02-09,Singapore,SG,7,0,5638676,40,0
2020-02-10,Singapore,SG,3,0,5638676,43,0
2020-02-11,Singapore,SG,2,0,5638676,45,0
2020-02-12,Singapore,SG,2,0,5638676,47,0
2020-02-13,Singapore,SG,3,0,5638676,50,0
2020-02-14,Singapore,SG,8,0,5638676,58,0
2020-02-15,Singapore,SG,9,0,5638676,67,0
2020-02-16,Singapore,SG,5,0,5638676,72,0
2020-02-17,Singapore,SG,3,0,5638676,75,0
2020-02-18,Singapore,SG,2,0,5638676,77,0
2020-02-19,Singapore,SG,4,0,5638676,81,0
2020-02-20,Singapore,SG,3,0,5638676,84,0
2020-02-21,Singapore,SG,1,0,5638676,85,0
2020-02-22,Singapore,SG,1,0,5638676,86,0
2020-02-23,Singapore,SG,3,0,5638676,89,0
2020-02-24,Singapore,SG,0,0,5638676,89,0
2020-02-25,Singapore,SG,1,0,5638676,90,0
2020-02-26,Singapore,SG,1,0,5638676,91,0
2020-02-27,Singapore,SG,2,0,5638676,93,0
2020-02-28,Singapore,SG,3,0,5638676,96,0
2020-02-29,Singapore,SG,2,0,5638676,98,0
2020-03-01,Singapore,SG,4,0,5638676,102,0
2020-03-02,Singapore,SG,4,0,5638676,106,0
2020-03-03,Singapore,SG,2,0,5638676,108,0
2020-03-04,Singapore,SG,2,0,5638676,110,0
2020-03-05,Singapore,SG,2,0,5638676,112,0
2020-03-06,Singapore,SG,5,0,5638676,117,0
2020-03-07,Singapore,SG,13,0,5638676,130,0
2020-03-08,Singapore,SG,8,0,5638676,138,0
2020-03-09,Singapore,SG,12,0,5638676,150,0
2020-03-10,Singapore,SG,10,0,5638676,160,0
2020-03-11,Singapore,SG,6,0,5638676,166,0
2020-03-12,Singapore,SG,12,0,5638676,178,0
2020-03-13,Singapore,SG,9,0,5638676,187,0
2020-03-14,Singapore,SG,13,0,5638676,200,0
2020-03-15,Singapore,SG,14,0,5638676,214,0
2020-03-16,Singapore,SG,12,0,5638676,226,0
2020-03-17,Singapore,SG,17,0,5638676,243,0
2020-03-18,Singapore,SG,23,0,5638676,266,0
2020-03-19,Singapore,SG,47,0,5638676,313,0
2020-03-20,Singapore,SG,32,0,5638676,345,0
2020-03-21,Singapore,SG,40,0,5638676,385,0
2020-03-22,Singapore,SG,47,2,5638676,432,2
2020-03-23,Singapore,SG,23,0,5638676,455,2
2020-03-24,Singapore,SG,54,0,5638676,509,2
2020-03-25,Singapore,SG,49,0,5638676,558,2
2020-03-26,Singapore,SG,10,0,5638676,568,2
2020-03-27,Singapore,SG,26,0,5638676,594,2
2020-03-28,Singapore,SG,138,0,5638676,732,2
2020-03-29,Singapore,SG,71,1,5638676,803,3
2020-03-30,Singapore,SG,41,0,5638676,844,3
2020-03-31,Singapore,SG,0,0,5638676,844,3
2020-04-01,Singapore,SG,35,0,5638676,879,3
2020-04-02,Singapore,SG,121,1,5638676,1000,4
2020-04-03,Singapore,SG,49,1,5638676,1049,5
2020-04-04,Singapore,SG,65,0,5638676,1114,5
2020-04-05,Singapore,SG,75,1,5638676,1189,6
2020-04-06,Singapore,SG,120,0,5638676,1309,6
2020-04-07,Singapore,SG,66,0,5638676,1375,6
2020-04-08,Singapore,SG,106,0,5638676,1481,6
2020-04-09,Singapore,SG,142,0,5638676,1623,6
2020-04-10,Singapore,SG,286,0,5638676,1909,6
2020-04-11,Singapore,SG,0,0,5638676,1909,6
2020-04-12,Singapore,SG,390,2,5638676,2299,8
2020-04-13,Singapore,SG,233,0,5638676,2532,8
2020-04-14,Singapore,SG,386,1,5638676,2918,9
2020-04-15,Singapore,SG,334,1,5638676,3252,10
2020-04-16,Singapore,SG,447,0,5638676,3699,10
2020-04-17,Singapore,SG,728,0,5638676,4427,10
2020-04-18,Singapore,SG,623,1,5638676,5050,11
2020-04-19,Singapore,SG,942,0,5638676,5992,11
2020-04-20,Singapore,SG,596,0,5638676,6588,11
2020-04-21,Singapore,SG,1426,0,5638676,8014,11
2020-04-22,Singapore,SG,1111,0,5638676,9125,11
2020-04-23,Singapore,SG,1016,1,5638676,10141,12
2020-04-24,Singapore,SG,1037,0,5638676,11178,12
2020-04-25,Singapore,SG,0,0,5638676,11178,12
2020-04-26,Singapore,SG,1515,0,5638676,12693,12
2020-04-27,Singapore,SG,931,0,5638676,13624,12
2020-04-28,Singapore,SG,799,2,5638676,14423,14
2020-04-29,Singapore,SG,528,0,5638676,14951,14
2020-04-30,Singapore,SG,690,0,5638676,15641,14
2020-05-01,Singapore,SG,528,1,5638676,16169,15
2020-05-02,Singapore,SG,932,1,5638676,17101,16
2020-05-03,Singapore,SG,447,1,5638676,17548,17
2020-03-05,Slovenia,SI,1,0,2067372,1,0
2020-03-06,Slovenia,SI,5,0,2067372,6,0
2020-03-07,Slovenia,SI,3,0,2067372,9,0
2020-03-08,Slovenia,SI,3,0,2067372,12,0
2020-03-09,Slovenia,SI,4,0,2067372,16,0
2020-03-11,Slovenia,SI,15,0,2067372,31,0
2020-03-12,Slovenia,SI,26,0,2067372,57,0
2020-03-13,Slovenia,SI,39,0,2067372,96,0
2020-03-14,Slovenia,SI,45,0,2067372,141,0
2020-03-15,Slovenia,SI,40,0,2067372,181,0
2020-03-16,Slovenia,SI,38,0,2067372,219,0
2020-03-17,Slovenia,SI,34,0,2067372,253,0
2020-03-18,Slovenia,SI,22,1,2067372,275,1
2020-03-19,Slovenia,SI,11,0,2067372,286,1
2020-03-20,Slovenia,SI,33,0,2067372,319,1
2020-03-21,Slovenia,SI,22,0,2067372,341,1
2020-03-22,Slovenia,SI,42,0,2067372,383,1
2020-03-23,Slovenia,SI,31,0,2067372,414,1
2020-03-24,Slovenia,SI,28,0,2067372,442,1
2020-03-25,Slovenia,SI,38,2,2067372,480,3
2020-03-26,Slovenia,SI,48,1,2067372,528,4
2020-03-27,Slovenia,SI,49,1,2067372,577,5
2020-03-28,Slovenia,SI,55,4,2067372,632,9
2020-03-29,Slovenia,SI,59,0,2067372,691,9
2020-03-30,Slovenia,SI,39,2,2067372,730,11
2020-03-31,Slovenia,SI,33,0,2067372,763,11
2020-04-01,Slovenia,SI,51,2,2067372,814,13
2020-04-02,Slovenia,SI,27,2,2067372,841,15
2020-04-03,Slovenia,SI,56,1,2067372,897,16
2020-04-04,Slovenia,SI,37,4,2067372,934,20
2020-04-05,Slovenia,SI,43,2,2067372,977,22
2020-04-06,Slovenia,SI,20,6,2067372,997,28
2020-04-07,Slovenia,SI,24,2,2067372,1021,30
2020-04-08,Slovenia,SI,34,6,2067372,1055,36
2020-04-09,Slovenia,SI,36,4,2067372,1091,40
2020-04-10,Slovenia,SI,33,3,2067372,1124,43
2020-04-11,Slovenia,SI,36,2,2067372,1160,45
2020-04-12,Slovenia,SI,28,5,2067372,1188,50
2020-04-13,Slovenia,SI,17,3,2067372,1205,53
2020-04-14,Slovenia,SI,7,2,2067372,1212,55
2020-04-15,Slovenia,SI,8,1,2067372,1220,56
2020-04-16,Slovenia,SI,28,5,2067372,1248,61
2020-04-17,Slovenia,SI,20,0,2067372,1268,61
2020-04-18,Slovenia,SI,36,5,2067372,1304,66
2020-04-19,Slovenia,SI,13,4,2067372,1317,70
2020-04-20,Slovenia,SI,13,4,2067372,1330,74
2020-04-21,Slovenia,SI,5,0,2067372,1335,74
2020-04-22,Slovenia,SI,5,3,2067372,1340,77
2020-04-23,Slovenia,SI,13,2,2067372,1353,79
2020-04-24,Slovenia,SI,13,0,2067372,1366,79
2020-04-25,Slovenia,SI,7,1,2067372,1373,80
2020-04-26,Slovenia,SI,15,1,2067372,1388,81
2020-04-27,Slovenia,SI,19,1,2067372,1407,82
2020-04-28,Slovenia,SI,0,1,2067372,1407,83
2020-04-29,Slovenia,SI,1,3,2067372,1408,86
2020-04-30,Slovenia,SI,10,3,2067372,1418,89
2020-05-01,Slovenia,SI,11,2,2067372,1429,91
2020-05-02,Slovenia,SI,5,2,2067372,1434,93
2020-05-03,Slovenia,SI,5,1,2067372,1439,94
2020-03-07,Slovakia,SK,1,0,5447011,1,0
2020-03-08,Slovakia,SK,2,0,5447011,3,0
2020-03-09,Slovakia,SK,2,0,5447011,5,0
2020-03-11,Slovakia,SK,2,0,5447011,7,0
2020-03-12,Slovakia,SK,3,0,5447011,10,0
2020-03-13,Slovakia,SK,11,0,5447011,21,0
2020-03-14,Slovakia,SK,9,0,5447011,30,0
2020-03-15,Slovakia,SK,14,0,5447011,44,0
2020-03-16,Slovakia,SK,17,0,5447011,61,0
2020-03-17,Slovakia,SK,23,0,5447011,84,0
2020-03-18,Slovakia,SK,13,0,5447011,97,0
2020-03-19,Slovakia,SK,10,0,5447011,107,0
2020-03-20,Slovakia,SK,16,0,5447011,123,0
2020-03-21,Slovakia,SK,14,0,5447011,137,0
2020-03-22,Slovakia,SK,41,0,5447011,178,0
2020-03-23,Slovakia,SK,7,0,5447011,185,0
2020-03-24,Slovakia,SK,6,0,5447011,191,0
2020-03-25,Slovakia,SK,13,0,5447011,204,0
2020-03-26,Slovakia,SK,12,0,5447011,216,0
2020-03-27,Slovakia,SK,10,0,5447011,226,0
2020-03-28,Slovakia,SK,69,0,5447011,295,0
2020-03-29,Slovakia,SK,0,0,5447011,295,0
2020-03-30,Slovakia,SK,41,0,5447011,336,0
2020-03-31,Slovakia,SK,0,0,5447011,336,0
2020-04-01,Slovakia,SK,27,0,5447011,363,0
2020-04-02,Slovakia,SK,37,0,5447011,400,0
2020-04-03,Slovakia,SK,26,0,5447011,426,0
2020-04-04,Slovakia,SK,24,0,5447011,450,0
2020-04-05,Slovakia,SK,21,0,5447011,471,0
2020-04-06,Slovakia,SK,14,0,5447011,485,0
2020-04-07,Slovakia,SK,49,2,5447011,534,2
2020-04-08,Slovakia,SK,47,0,5447011,581,2
2020-04-09,Slovakia,SK,101,0,5447011,682,2
2020-04-10,Slovakia,SK,19,0,5447011,701,2
2020-04-11,Slovakia,SK,14,0,5447011,715,2
2020-04-12,Slovakia,SK,13,0,5447011,728,2
2020-04-13,Slovakia,SK,14,0,5447011,742,2
2020-04-14,Slovakia,SK,27,0,5447011,769,2
2020-04-15,Slovakia,SK,66,0,5447011,835,2
2020-04-16,Slovakia,SK,28,4,5447011,863,6
2020-04-17,Slovakia,SK,114,2,5447011,977,8
2020-04-18,Slovakia,SK,72,1,5447011,1049,9
2020-04-19,Slovakia,SK,40,2,5447011,1089,11
2020-04-20,Slovakia,SK,72,1,5447011,1161,12
2020-04-21,Slovakia,SK,12,1,5447011,1173,13
2020-04-22,Slovakia,SK,26,1,5447011,1199,14
2020-04-23,Slovakia,SK,45,0,5447011,1244,14
2020-04-24,Slovakia,SK,81,1,5447011,1325,15
2020-04-25,Slovakia,SK,35,2,5447011,1360,17
2020-04-26,Slovakia,SK,13,0,5447011,1373,17
2020-04-27,Slovakia,SK,6,1,5447011,1379,18
2020-04-28,Slovakia,SK,2,0,5447011,1381,18
2020-04-29,Slovakia,SK,3,2,5447011,1384,20
2020-04-30,Slovakia,SK,7,2,5447011,1391,22
2020-05-01,Slovakia,SK,5,1,5447011,1396,23
2020-05-02,Slovakia,SK,7,0,5447011,1403,23
2020-05-03,Slovakia,SK,4,1,5447011,1407,24
2020-04-01,Sierra_Leone,SL,1,0,7650154,1,0
2020-04-02,Sierra_Leone,SL,0,0,7650154,1,0
2020-04-03,Sierra_Leone,SL,1,0,7650154,2,0
2020-04-04,Sierra_Leone,SL,0,0,7650154,2,0
2020-04-05,Sierra_Leone,SL,2,0,7650154,4,0
2020-04-06,Sierra_Leone,SL,2,0,7650154,6,0
2020-04-07,Sierra_Leone,SL,0,0,7650154,6,0
2020-04-08,Sierra_Leone,SL,0,0,7650154,6,0
2020-04-09,Sierra_Leone,SL,1,0,7650154,7,0
2020-04-10,Sierra_Leone,SL,0,0,7650154,7,0
2020-04-11,Sierra_Leone,SL,1,0,7650154,8,0
2020-04-12,Sierra_Leone,SL,2,0,7650154,10,0
2020-04-13,Sierra_Leone,SL,0,0,7650154,10,0
2020-04-14,Sierra_Leone,SL,1,0,7650154,11,0
2020-04-15,Sierra_Leone,SL,0,0,7650154,11,0
2020-04-16,Sierra_Leone,SL,2,0,7650154,13,0
2020-04-17,Sierra_Leone,SL,2,0,7650154,15,0
2020-04-18,Sierra_Leone,SL,11,0,7650154,26,0
2020-04-19,Sierra_Leone,SL,4,0,7650154,30,0
2020-04-20,Sierra_Leone,SL,5,0,7650154,35,0
2020-04-21,Sierra_Leone,SL,8,0,7650154,43,0
2020-04-22,Sierra_Leone,SL,7,0,7650154,50,0
2020-04-23,Sierra_Leone,SL,11,0,7650154,61,0
2020-04-24,Sierra_Leone,SL,3,1,7650154,64,1
2020-04-25,Sierra_Leone,SL,18,2,7650154,82,3
2020-04-26,Sierra_Leone,SL,0,0,7650154,82,3
2020-04-27,Sierra_Leone,SL,11,1,7650154,93,4
2020-04-28,Sierra_Leone,SL,6,0,7650154,99,4
2020-04-29,Sierra_Leone,SL,5,0,7650154,104,4
2020-04-30,Sierra_Leone,SL,12,0,7650154,116,4
2020-05-01,Sierra_Leone,SL,8,3,7650154,124,7
2020-05-02,Sierra_Leone,SL,12,0,7650154,136,7
2020-05-03,Sierra_Leone,SL,19,1,7650154,155,8
2019-12-31,San_Marino,SM,0,0,33785,0,0
2020-01-01,San_Marino,SM,0,0,33785,0,0
2020-01-02,San_Marino,SM,0,0,33785,0,0
2020-01-03,San_Marino,SM,0,0,33785,0,0
2020-01-04,San_Marino,SM,0,0,33785,0,0
2020-01-05,San_Marino,SM,0,0,33785,0,0
2020-01-06,San_Marino,SM,0,0,33785,0,0
2020-01-07,San_Marino,SM,0,0,33785,0,0
2020-01-08,San_Marino,SM,0,0,33785,0,0
2020-01-09,San_Marino,SM,0,0,33785,0,0
2020-01-10,San_Marino,SM,0,0,33785,0,0
2020-01-11,San_Marino,SM,0,0,33785,0,0
2020-01-12,San_Marino,SM,0,0,33785,0,0
2020-01-13,San_Marino,SM,0,0,33785,0,0
2020-01-14,San_Marino,SM,0,0,33785,0,0
2020-01-15,San_Marino,SM,0,0,33785,0,0
2020-01-16,San_Marino,SM,0,0,33785,0,0
2020-01-17,San_Marino,SM,0,0,33785,0,0
2020-01-18,San_Marino,SM,0,0,33785,0,0
2020-01-19,San_Marino,SM,0,0,33785,0,0
2020-01-20,San_Marino,SM,0,0,33785,0,0
2020-01-21,San_Marino,SM,0,0,33785,0,0
2020-01-22,San_Marino,SM,0,0,33785,0,0
2020-01-23,San_Marino,SM,0,0,33785,0,0
2020-01-24,San_Marino,SM,0,0,33785,0,0
2020-01-25,San_Marino,SM,0,0,33785,0,0
2020-01-26,San_Marino,SM,0,0,33785,0,0
2020-01-27,San_Marino,SM,0,0,33785,0,0
2020-01-28,San_Marino,SM,0,0,33785,0,0
2020-01-29,San_Marino,SM,0,0,33785,0,0
2020-01-30,San_Marino,SM,0,0,33785,0,0
2020-01-31,San_Marino,SM,0,0,33785,0,0
2020-02-01,San_Marino,SM,0,0,33785,0,0
2020-02-02,San_Marino,SM,0,0,33785,0,0
2020-02-03,San_Marino,SM,0,0,33785,0,0
2020-02-04,San_Marino,SM,0,0,33785,0,0
2020-02-05,San_Marino,SM,0,0,33785,0,0
2020-02-06,San_Marino,SM,0,0,33785,0,0
2020-02-07,San_Marino,SM,0,0,33785,0,0
2020-02-08,San_Marino,SM,0,0,33785,0,0
2020-02-09,San_Marino,SM,0,0,33785,0,0
2020-02-10,San_Marino,SM,0,0,33785,0,0
2020-02-11,San_Marino,SM,0,0,33785,0,0
2020-02-12,San_Marino,SM,0,0,33785,0,0
2020-02-13,San_Marino,SM,0,0,33785,0,0
2020-02-14,San_Marino,SM,0,0,33785,0,0
2020-02-15,San_Marino,SM,0,0,33785,0,0
2020-02-16,San_Marino,SM,0,0,33785,0,0
2020-02-17,San_Marino,SM,0,0,33785,0,0
2020-02-18,San_Marino,SM,0,0,33785,0,0
2020-02-19,San_Marino,SM,0,0,33785,0,0
2020-02-20,San_Marino,SM,0,0,33785,0,0
2020-02-21,San_Marino,SM,0,0,33785,0,0
2020-02-22,San_Marino,SM,0,0,33785,0,0
2020-02-23,San_Marino,SM,0,0,33785,0,0
2020-02-24,San_Marino,SM,0,0,33785,0,0
2020-02-25,San_Marino,SM,0,0,33785,0,0
2020-02-26,San_Marino,SM,0,0,33785,0,0
2020-02-27,San_Marino,SM,0,0,33785,0,0
2020-02-28,San_Marino,SM,1,0,33785,1,0
2020-02-29,San_Marino,SM,0,0,33785,1,0
2020-03-01,San_Marino,SM,0,0,33785,1,0
2020-03-02,San_Marino,SM,7,1,33785,8,1
2020-03-04,San_Marino,SM,2,0,33785,10,1
2020-03-05,San_Marino,SM,5,0,33785,15,1
2020-03-06,San_Marino,SM,7,0,33785,22,1
2020-03-07,San_Marino,SM,1,0,33785,23,1
2020-03-08,San_Marino,SM,3,0,33785,26,1
2020-03-09,San_Marino,SM,11,0,33785,37,1
2020-03-10,San_Marino,SM,12,1,33785,49,2
2020-03-11,San_Marino,SM,13,0,33785,62,2
2020-03-12,San_Marino,SM,4,1,33785,66,3
2020-03-13,San_Marino,SM,1,2,33785,67,5
2020-03-14,San_Marino,SM,6,0,33785,73,5
2020-03-15,San_Marino,SM,19,0,33785,92,5
2020-03-16,San_Marino,SM,6,2,33785,98,7
2020-03-17,San_Marino,SM,4,2,33785,102,9
2020-03-18,San_Marino,SM,2,2,33785,104,11
2020-03-19,San_Marino,SM,5,3,33785,109,14
2020-03-20,San_Marino,SM,17,0,33785,126,14
2020-03-21,San_Marino,SM,25,0,33785,151,14
2020-03-22,San_Marino,SM,0,6,33785,151,20
2020-03-23,San_Marino,SM,0,0,33785,151,20
2020-03-24,San_Marino,SM,36,0,33785,187,20
2020-03-25,San_Marino,SM,0,1,33785,187,21
2020-03-26,San_Marino,SM,21,0,33785,208,21
2020-03-27,San_Marino,SM,10,0,33785,218,21
2020-03-28,San_Marino,SM,5,0,33785,223,21
2020-03-29,San_Marino,SM,1,1,33785,224,22
2020-03-30,San_Marino,SM,5,2,33785,229,24
2020-03-31,San_Marino,SM,0,1,33785,229,25
2020-04-01,San_Marino,SM,1,1,33785,230,26
2020-04-02,San_Marino,SM,6,0,33785,236,26
2020-04-03,San_Marino,SM,9,4,33785,245,30
2020-04-04,San_Marino,SM,6,2,33785,251,32
2020-04-05,San_Marino,SM,8,0,33785,259,32
2020-04-06,San_Marino,SM,7,0,33785,266,32
2020-04-07,San_Marino,SM,11,0,33785,277,32
2020-04-08,San_Marino,SM,2,2,33785,279,34
2020-04-09,San_Marino,SM,29,0,33785,308,34
2020-04-10,San_Marino,SM,25,0,33785,333,34
2020-04-11,San_Marino,SM,11,0,33785,344,34
2020-04-12,San_Marino,SM,12,1,33785,356,35
2020-04-13,San_Marino,SM,0,0,33785,356,35
2020-04-14,San_Marino,SM,0,1,33785,356,36
2020-04-15,San_Marino,SM,16,0,33785,372,36
2020-04-16,San_Marino,SM,20,0,33785,392,36
2020-04-17,San_Marino,SM,34,2,33785,426,38
2020-04-18,San_Marino,SM,9,1,33785,435,39
2020-04-19,San_Marino,SM,20,0,33785,455,39
2020-04-20,San_Marino,SM,6,0,33785,461,39
2020-04-21,San_Marino,SM,1,0,33785,462,39
2020-04-22,San_Marino,SM,14,1,33785,476,40
2020-04-23,San_Marino,SM,12,0,33785,488,40
2020-04-24,San_Marino,SM,13,0,33785,501,40
2020-04-25,San_Marino,SM,12,0,33785,513,40
2020-04-26,San_Marino,SM,0,0,33785,513,40
2020-04-27,San_Marino,SM,25,1,33785,538,41
2020-04-28,San_Marino,SM,0,0,33785,538,41
2020-04-29,San_Marino,SM,15,0,33785,553,41
2020-04-30,San_Marino,SM,10,0,33785,563,41
2020-05-01,San_Marino,SM,6,0,33785,569,41
2020-05-02,San_Marino,SM,11,0,33785,580,41
2020-05-03,San_Marino,SM,0,0,33785,580,41
2020-03-03,Senegal,SN,1,0,15854360,1,0
2020-03-05,Senegal,SN,2,0,15854360,3,0
2020-03-06,Senegal,SN,1,0,15854360,4,0
2020-03-13,Senegal,SN,2,0,15854360,6,0
2020-03-14,Senegal,SN,13,0,15854360,19,0
2020-03-15,Senegal,SN,2,0,15854360,21,0
2020-03-16,Senegal,SN,5,0,15854360,26,0
2020-03-17,Senegal,SN,1,0,15854360,27,0
2020-03-18,Senegal,SN,4,0,15854360,31,0
2020-03-19,Senegal,SN,5,0,15854360,36,0
2020-03-20,Senegal,SN,0,0,15854360,36,0
2020-03-21,Senegal,SN,11,0,15854360,47,0
2020-03-22,Senegal,SN,9,0,15854360,56,0
2020-03-23,Senegal,SN,11,0,15854360,67,0
2020-03-24,Senegal,SN,12,0,15854360,79,0
2020-03-25,Senegal,SN,7,0,15854360,86,0
2020-03-26,Senegal,SN,13,0,15854360,99,0
2020-03-27,Senegal,SN,6,0,15854360,105,0
2020-03-28,Senegal,SN,14,0,15854360,119,0
2020-03-29,Senegal,SN,11,0,15854360,130,0
2020-03-30,Senegal,SN,12,0,15854360,142,0
2020-03-31,Senegal,SN,20,0,15854360,162,0
2020-04-01,Senegal,SN,13,0,15854360,175,0
2020-04-02,Senegal,SN,15,1,15854360,190,1
2020-04-03,Senegal,SN,5,0,15854360,195,1
2020-04-04,Senegal,SN,12,0,15854360,207,1
2020-04-05,Senegal,SN,12,1,15854360,219,2
2020-04-06,Senegal,SN,3,0,15854360,222,2
2020-04-07,Senegal,SN,4,0,15854360,226,2
2020-04-08,Senegal,SN,11,0,15854360,237,2
2020-04-09,Senegal,SN,7,0,15854360,244,2
2020-04-10,Senegal,SN,6,0,15854360,250,2
2020-04-11,Senegal,SN,15,0,15854360,265,2
2020-04-12,Senegal,SN,13,0,15854360,278,2
2020-04-13,Senegal,SN,2,0,15854360,280,2
2020-04-14,Senegal,SN,11,0,15854360,291,2
2020-04-15,Senegal,SN,8,0,15854360,299,2
2020-04-16,Senegal,SN,15,0,15854360,314,2
2020-04-17,Senegal,SN,21,0,15854360,335,2
2020-04-18,Senegal,SN,7,1,15854360,342,3
2020-04-19,Senegal,SN,8,0,15854360,350,3
2020-04-20,Senegal,SN,17,1,15854360,367,4
2020-04-21,Senegal,SN,10,1,15854360,377,5
2020-04-22,Senegal,SN,35,0,15854360,412,5
2020-04-23,Senegal,SN,30,1,15854360,442,6
2020-04-24,Senegal,SN,37,0,15854360,479,6
2020-04-25,Senegal,SN,66,1,15854360,545,7
2020-04-26,Senegal,SN,69,0,15854360,614,7
2020-04-27,Senegal,SN,57,2,15854360,671,9
2020-04-28,Senegal,SN,64,0,15854360,735,9
2020-04-29,Senegal,SN,88,0,15854360,823,9
2020-04-30,Senegal,SN,59,0,15854360,882,9
2020-05-01,Senegal,SN,51,0,15854360,933,9
2020-05-02,Senegal,SN,91,0,15854360,1024,9
2020-05-03,Senegal,SN,91,0,15854360,1115,9
2020-03-17,Somalia,SO,1,0,15008154,1,0
2020-03-18,Somalia,SO,0,0,15008154,1,0
2020-03-19,Somalia,SO,0,0,15008154,1,0
2020-03-20,Somalia,SO,0,0,15008154,1,0
2020-03-21,Somalia,SO,0,0,15008154,1,0
2020-03-22,Somalia,SO,0,0,15008154,1,0
2020-03-23,Somalia,SO,0,0,15008154,1,0
2020-03-24,Somalia,SO,0,0,15008154,1,0
2020-03-25,Somalia,SO,0,0,15008154,1,0
2020-03-26,Somalia,SO,0,0,15008154,1,0
2020-03-27,Somalia,SO,1,0,15008154,2,0
2020-03-28,Somalia,SO,1,0,15008154,3,0
2020-03-29,Somalia,SO,0,0,15008154,3,0
2020-03-30,Somalia,SO,0,0,15008154,3,0
2020-03-31,Somalia,SO,0,0,15008154,3,0
2020-04-01,Somalia,SO,0,0,15008154,3,0
2020-04-02,Somalia,SO,2,0,15008154,5,0
2020-04-03,Somalia,SO,0,0,15008154,5,0
2020-04-04,Somalia,SO,0,0,15008154,5,0
2020-04-05,Somalia,SO,2,0,15008154,7,0
2020-04-06,Somalia,SO,0,0,15008154,7,0
2020-04-07,Somalia,SO,0,0,15008154,7,0
2020-04-08,Somalia,SO,1,0,15008154,8,0
2020-04-09,Somalia,SO,0,0,15008154,8,0
2020-04-10,Somalia,SO,4,1,15008154,12,1
2020-04-11,Somalia,SO,9,0,15008154,21,1
2020-04-12,Somalia,SO,0,0,15008154,21,1
2020-04-13,Somalia,SO,4,1,15008154,25,2
2020-04-14,Somalia,SO,0,0,15008154,25,2
2020-04-15,Somalia,SO,35,0,15008154,60,2
2020-04-16,Somalia,SO,20,3,15008154,80,5
2020-04-17,Somalia,SO,0,0,15008154,80,5
2020-04-18,Somalia,SO,36,0,15008154,116,5
2020-04-19,Somalia,SO,19,2,15008154,135,7
2020-04-20,Somalia,SO,29,0,15008154,164,7
2020-04-21,Somalia,SO,73,1,15008154,237,8
2020-04-22,Somalia,SO,49,0,15008154,286,8
2020-04-23,Somalia,SO,0,6,15008154,286,14
2020-04-24,Somalia,SO,42,0,15008154,328,14
2020-04-25,Somalia,SO,0,2,15008154,328,16
2020-04-26,Somalia,SO,62,2,15008154,390,18
2020-04-27,Somalia,SO,46,5,15008154,436,23
2020-04-28,Somalia,SO,44,3,15008154,480,26
2020-04-29,Somalia,SO,48,2,15008154,528,28
2020-04-30,Somalia,SO,54,0,15008154,582,28
2020-05-01,Somalia,SO,19,0,15008154,601,28
2020-05-02,Somalia,SO,0,0,15008154,601,28
2020-05-03,Somalia,SO,70,3,15008154,671,31
2020-03-15,Suriname,SR,1,0,575991,1,0
2020-03-21,Suriname,SR,0,0,575991,1,0
2020-03-22,Suriname,SR,4,0,575991,5,0
2020-03-23,Suriname,SR,0,0,575991,5,0
2020-03-24,Suriname,SR,1,0,575991,6,0
2020-03-25,Suriname,SR,2,0,575991,8,0
2020-03-26,Suriname,SR,0,0,575991,8,0
2020-03-27,Suriname,SR,0,0,575991,8,0
2020-03-28,Suriname,SR,0,0,575991,8,0
2020-03-29,Suriname,SR,0,0,575991,8,0
2020-03-30,Suriname,SR,0,0,575991,8,0
2020-03-31,Suriname,SR,0,0,575991,8,0
2020-04-01,Suriname,SR,2,0,575991,10,0
2020-04-02,Suriname,SR,0,0,575991,10,0
2020-04-03,Suriname,SR,0,0,575991,10,0
2020-04-04,Suriname,SR,0,1,575991,10,1
2020-04-05,Suriname,SR,0,0,575991,10,1
2020-04-06,Suriname,SR,0,0,575991,10,1
2020-04-07,Suriname,SR,0,0,575991,10,1
2020-04-08,Suriname,SR,0,0,575991,10,1
2020-04-09,Suriname,SR,0,0,575991,10,1
2020-04-10,Suriname,SR,0,0,575991,10,1
2020-04-11,Suriname,SR,0,0,575991,10,1
2020-04-12,Suriname,SR,0,0,575991,10,1
2020-04-13,Suriname,SR,0,0,575991,10,1
2020-04-14,Suriname,SR,0,0,575991,10,1
2020-04-15,Suriname,SR,0,0,575991,10,1
2020-04-16,Suriname,SR,0,0,575991,10,1
2020-04-17,Suriname,SR,0,0,575991,10,1
2020-04-18,Suriname,SR,0,0,575991,10,1
2020-04-19,Suriname,SR,0,0,575991,10,1
2020-04-20,Suriname,SR,0,0,575991,10,1
2020-04-21,Suriname,SR,0,0,575991,10,1
2020-04-22,Suriname,SR,0,0,575991,10,1
2020-04-23,Suriname,SR,0,0,575991,10,1
2020-04-24,Suriname,SR,0,0,575991,10,1
2020-04-25,Suriname,SR,0,0,575991,10,1
2020-04-26,Suriname,SR,0,0,575991,10,1
2020-04-27,Suriname,SR,0,0,575991,10,1
2020-04-28,Suriname,SR,0,0,575991,10,1
2020-04-29,Suriname,SR,0,0,575991,10,1
2020-04-30,Suriname,SR,0,0,575991,10,1
2020-05-01,Suriname,SR,0,0,575991,10,1
2020-05-02,Suriname,SR,0,0,575991,10,1
2020-05-03,Suriname,SR,0,0,575991,10,1
2020-04-06,South_Sudan,SS,1,0,10975920,1,0
2020-04-07,South_Sudan,SS,0,0,10975920,1,0
2020-04-08,South_Sudan,SS,0,0,10975920,1,0
2020-04-09,South_Sudan,SS,1,0,10975920,2,0
2020-04-10,South_Sudan,SS,0,0,10975920,2,0
2020-04-11,South_Sudan,SS,1,0,10975920,3,0
2020-04-12,South_Sudan,SS,1,0,10975920,4,0
2020-04-13,South_Sudan,SS,0,0,10975920,4,0
2020-04-14,South_Sudan,SS,0,0,10975920,4,0
2020-04-15,South_Sudan,SS,0,0,10975920,4,0
2020-04-16,South_Sudan,SS,0,0,10975920,4,0
2020-04-17,South_Sudan,SS,0,0,10975920,4,0
2020-04-18,South_Sudan,SS,0,0,10975920,4,0
2020-04-19,South_Sudan,SS,0,0,10975920,4,0
2020-04-20,South_Sudan,SS,0,0,10975920,4,0
2020-04-21,South_Sudan,SS,0,0,10975920,4,0
2020-04-22,South_Sudan,SS,0,0,10975920,4,0
2020-04-23,South_Sudan,SS,0,0,10975920,4,0
2020-04-24,South_Sudan,SS,0,0,10975920,4,0
2020-04-25,South_Sudan,SS,1,0,10975920,5,0
2020-04-26,South_Sudan,SS,0,0,10975920,5,0
2020-04-27,South_Sudan,SS,1,0,10975920,6,0
2020-04-28,South_Sudan,SS,0,0,10975920,6,0
2020-04-29,South_Sudan,SS,28,0,10975920,34,0
2020-04-30,South_Sudan,SS,0,0,10975920,34,0
2020-05-01,South_Sudan,SS,1,0,10975920,35,0
2020-05-02,South_Sudan,SS,10,0,10975920,45,0
2020-05-03,South_Sudan,SS,0,0,10975920,45,0
2020-04-09,Sao_Tome_and_Principe,ST,4,0,211028,4,0
2020-04-10,Sao_Tome_and_Principe,ST,0,0,211028,4,0
2020-04-11,Sao_Tome_and_Principe,ST,0,0,211028,4,0
2020-04-12,Sao_Tome_and_Principe,ST,0,0,211028,4,0
2020-04-13,Sao_Tome_and_Principe,ST,0,0,211028,4,0
2020-04-14,Sao_Tome_and_Principe,ST,0,0,211028,4,0
2020-04-15,Sao_Tome_and_Principe,ST,0,0,211028,4,0
2020-04-16,Sao_Tome_and_Principe,ST,0,0,211028,4,0
2020-04-17,Sao_Tome_and_Principe,ST,0,0,211028,4,0
2020-04-18,Sao_Tome_and_Principe,ST,0,0,211028,4,0
2020-04-19,Sao_Tome_and_Principe,ST,0,0,211028,4,0
2020-04-20,Sao_Tome_and_Principe,ST,0,0,211028,4,0
2020-04-21,Sao_Tome_and_Principe,ST,0,0,211028,4,0
2020-04-22,Sao_Tome_and_Principe,ST,0,0,211028,4,0
2020-04-23,Sao_Tome_and_Principe,ST,3,0,211028,7,0
2020-04-24,Sao_Tome_and_Principe,ST,1,0,211028,8,0
2020-04-25,Sao_Tome_and_Principe,ST,0,0,211028,8,0
2020-04-26,Sao_Tome_and_Principe,ST,0,0,211028,8,0
2020-04-27,Sao_Tome_and_Principe,ST,0,0,211028,8,0
2020-04-28,Sao_Tome_and_Principe,ST,0,0,211028,8,0
2020-04-29,Sao_Tome_and_Principe,ST,3,0,211028,11,0
2020-04-30,Sao_Tome_and_Principe,ST,3,0,211028,14,0
2020-05-01,Sao_Tome_and_Principe,ST,2,1,211028,16,1
2020-05-02,Sao_Tome_and_Principe,ST,2,0,211028,18,1
2020-05-03,Sao_Tome_and_Principe,ST,0,0,211028,18,1
2020-03-19,El_Salvador,SV,1,0,6420744,1,0
2020-03-20,El_Salvador,SV,0,0,6420744,1,0
2020-03-21,El_Salvador,SV,2,0,6420744,3,0
2020-03-22,El_Salvador,SV,0,0,6420744,3,0
2020-03-23,El_Salvador,SV,0,0,6420744,3,0
2020-03-24,El_Salvador,SV,2,0,6420744,5,0
2020-03-25,El_Salvador,SV,4,0,6420744,9,0
2020-03-26,El_Salvador,SV,4,0,6420744,13,0
2020-03-27,El_Salvador,SV,0,0,6420744,13,0
2020-03-28,El_Salvador,SV,0,0,6420744,13,0
2020-03-29,El_Salvador,SV,6,0,6420744,19,0
2020-03-30,El_Salvador,SV,11,0,6420744,30,0
2020-03-31,El_Salvador,SV,2,0,6420744,32,0
2020-04-01,El_Salvador,SV,0,1,6420744,32,1
2020-04-02,El_Salvador,SV,9,1,6420744,41,2
2020-04-03,El_Salvador,SV,5,0,6420744,46,2
2020-04-04,El_Salvador,SV,10,1,6420744,56,3
2020-04-05,El_Salvador,SV,6,0,6420744,62,3
2020-04-06,El_Salvador,SV,7,0,6420744,69,3
2020-04-07,El_Salvador,SV,9,1,6420744,78,4
2020-04-08,El_Salvador,SV,0,0,6420744,78,4
2020-04-09,El_Salvador,SV,25,1,6420744,103,5
2020-04-10,El_Salvador,SV,14,1,6420744,117,6
2020-04-11,El_Salvador,SV,1,0,6420744,118,6
2020-04-12,El_Salvador,SV,0,0,6420744,118,6
2020-04-13,El_Salvador,SV,7,0,6420744,125,6
2020-04-14,El_Salvador,SV,24,0,6420744,149,6
2020-04-15,El_Salvador,SV,10,0,6420744,159,6
2020-04-16,El_Salvador,SV,0,0,6420744,159,6
2020-04-17,El_Salvador,SV,5,0,6420744,164,6
2020-04-18,El_Salvador,SV,13,1,6420744,177,7
2020-04-19,El_Salvador,SV,13,0,6420744,190,7
2020-04-20,El_Salvador,SV,11,0,6420744,201,7
2020-04-21,El_Salvador,SV,17,0,6420744,218,7
2020-04-22,El_Salvador,SV,7,0,6420744,225,7
2020-04-23,El_Salvador,SV,12,1,6420744,237,8
2020-04-24,El_Salvador,SV,13,0,6420744,250,8
2020-04-25,El_Salvador,SV,11,0,6420744,261,8
2020-04-26,El_Salvador,SV,37,0,6420744,298,8
2020-04-27,El_Salvador,SV,0,0,6420744,298,8
2020-04-28,El_Salvador,SV,25,0,6420744,323,8
2020-04-29,El_Salvador,SV,22,1,6420744,345,9
2020-04-30,El_Salvador,SV,32,0,6420744,377,9
2020-05-01,El_Salvador,SV,47,1,6420744,424,10
2020-05-02,El_Salvador,SV,22,0,6420744,446,10
2020-05-03,El_Salvador,SV,0,1,6420744,446,11
2020-03-03,Sint_Maarten,SX,1,0,41486,1,0
2020-03-26,Sint_Maarten,SX,1,0,41486,2,0
2020-03-27,Sint_Maarten,SX,0,0,41486,2,0
2020-03-28,Sint_Maarten,SX,1,0,41486,3,0
2020-03-29,Sint_Maarten,SX,0,0,41486,3,0
2020-03-30,Sint_Maarten,SX,0,0,41486,3,0
2020-04-01,Sint_Maarten,SX,3,0,41486,6,0
2020-04-02,Sint_Maarten,SX,10,1,41486,16,1
2020-04-03,Sint_Maarten,SX,7,1,41486,23,2
2020-04-04,Sint_Maarten,SX,0,0,41486,23,2
2020-04-05,Sint_Maarten,SX,0,0,41486,23,2
2020-04-06,Sint_Maarten,SX,2,2,41486,25,4
2020-04-07,Sint_Maarten,SX,0,0,41486,25,4
2020-04-08,Sint_Maarten,SX,15,4,41486,40,8
2020-04-09,Sint_Maarten,SX,0,0,41486,40,8
2020-04-10,Sint_Maarten,SX,10,0,41486,50,8
2020-04-11,Sint_Maarten,SX,0,1,41486,50,9
2020-04-12,Sint_Maarten,SX,0,0,41486,50,9
2020-04-13,Sint_Maarten,SX,0,0,41486,50,9
2020-04-14,Sint_Maarten,SX,2,0,41486,52,9
2020-04-15,Sint_Maarten,SX,0,0,41486,52,9
2020-04-16,Sint_Maarten,SX,5,0,41486,57,9
2020-04-17,Sint_Maarten,SX,0,0,41486,57,9
2020-04-18,Sint_Maarten,SX,0,0,41486,57,9
2020-04-19,Sint_Maarten,SX,7,0,41486,64,9
2020-04-20,Sint_Maarten,SX,3,1,41486,67,10
2020-04-21,Sint_Maarten,SX,1,0,41486,68,10
2020-04-22,Sint_Maarten,SX,0,0,41486,68,10
2020-04-23,Sint_Maarten,SX,5,2,41486,73,12
2020-04-24,Sint_Maarten,SX,0,0,41486,73,12
2020-04-25,Sint_Maarten,SX,0,0,41486,73,12
2020-04-26,Sint_Maarten,SX,0,0,41486,73,12
2020-04-27,Sint_Maarten,SX,1,1,41486,74,13
2020-04-28,Sint_Maarten,SX,1,0,41486,75,13
2020-04-29,Sint_Maarten,SX,0,0,41486,75,13
2020-04-30,Sint_Maarten,SX,1,0,41486,76,13
2020-05-01,Sint_Maarten,SX,0,0,41486,76,13
2020-05-02,Sint_Maarten,SX,0,0,41486,76,13
2020-05-03,Sint_Maarten,SX,0,0,41486,76,13
2020-03-23,Syria,SY,1,0,16906283,1,0
2020-03-24,Syria,SY,0,0,16906283,1,0
2020-03-25,Syria,SY,0,0,16906283,1,0
2020-03-26,Syria,SY,0,0,16906283,1,0
2020-03-27,Syria,SY,4,0,16906283,5,0
2020-03-28,Syria,SY,0,0,16906283,5,0
2020-03-29,Syria,SY,0,0,16906283,5,0
2020-03-30,Syria,SY,4,1,16906283,9,1
2020-03-31,Syria,SY,1,1,16906283,10,2
2020-04-01,Syria,SY,0,0,16906283,10,2
2020-04-02,Syria,SY,0,0,16906283,10,2
2020-04-03,Syria,SY,6,0,16906283,16,2
2020-04-04,Syria,SY,0,0,16906283,16,2
2020-04-05,Syria,SY,0,0,16906283,16,2
2020-04-06,Syria,SY,3,0,16906283,19,2
2020-04-07,Syria,SY,0,0,16906283,19,2
2020-04-08,Syria,SY,0,0,16906283,19,2
2020-04-09,Syria,SY,0,0,16906283,19,2
2020-04-10,Syria,SY,0,0,16906283,19,2
2020-04-11,Syria,SY,0,0,16906283,19,2
2020-04-12,Syria,SY,6,0,16906283,25,2
2020-04-13,Syria,SY,0,0,16906283,25,2
2020-04-14,Syria,SY,0,0,16906283,25,2
2020-04-15,Syria,SY,4,0,16906283,29,2
2020-04-16,Syria,SY,4,0,16906283,33,2
2020-04-17,Syria,SY,0,0,16906283,33,2
2020-04-18,Syria,SY,5,0,16906283,38,2
2020-04-19,Syria,SY,0,0,16906283,38,2
2020-04-20,Syria,SY,1,1,16906283,39,3
2020-04-21,Syria,SY,0,0,16906283,39,3
2020-04-22,Syria,SY,3,0,16906283,42,3
2020-04-23,Syria,SY,0,0,16906283,42,3
2020-04-24,Syria,SY,0,0,16906283,42,3
2020-04-25,Syria,SY,0,0,16906283,42,3
2020-04-26,Syria,SY,0,0,16906283,42,3
2020-04-27,Syria,SY,1,0,16906283,43,3
2020-04-28,Syria,SY,0,0,16906283,43,3
2020-04-29,Syria,SY,0,0,16906283,43,3
2020-04-30,Syria,SY,0,0,16906283,43,3
2020-05-01,Syria,SY,0,0,16906283,43,3
2020-05-02,Syria,SY,1,0,16906283,44,3
2020-05-03,Syria,SY,0,0,16906283,44,3
2020-03-15,Eswatini,SZ,1,0,1367000,1,0
2020-03-16,Eswatini,SZ,0,0,1367000,1,0
2020-03-17,Eswatini,SZ,0,0,1367000,1,0
2020-03-18,Eswatini,SZ,0,0,1367000,1,0
2020-03-19,Eswatini,SZ,0,0,1367000,1,0
2020-03-20,Eswatini,SZ,0,0,1367000,1,0
2020-03-21,Eswatini,SZ,0,0,1367000,1,0
2020-03-22,Eswatini,SZ,0,0,1367000,1,0
2020-03-23,Eswatini,SZ,3,0,1367000,4,0
2020-03-24,Eswatini,SZ,0,0,1367000,4,0
2020-03-25,Eswatini,SZ,0,0,1367000,4,0
2020-03-26,Eswatini,SZ,0,0,1367000,4,0
2020-03-27,Eswatini,SZ,2,0,1367000,6,0
2020-03-28,Eswatini,SZ,3,0,1367000,9,0
2020-03-29,Eswatini,SZ,0,0,1367000,9,0
2020-03-30,Eswatini,SZ,0,0,1367000,9,0
2020-03-31,Eswatini,SZ,0,0,1367000,9,0
2020-04-01,Eswatini,SZ,0,0,1367000,9,0
2020-04-02,Eswatini,SZ,0,0,1367000,9,0
2020-04-03,Eswatini,SZ,0,0,1367000,9,0
2020-04-04,Eswatini,SZ,0,0,1367000,9,0
2020-04-05,Eswatini,SZ,0,0,1367000,9,0
2020-04-06,Eswatini,SZ,0,0,1367000,9,0
2020-04-07,Eswatini,SZ,1,0,1367000,10,0
2020-04-08,Eswatini,SZ,0,0,1367000,10,0
2020-04-09,Eswatini,SZ,2,0,1367000,12,0
2020-04-10,Eswatini,SZ,0,0,1367000,12,0
2020-04-11,Eswatini,SZ,0,0,1367000,12,0
2020-04-12,Eswatini,SZ,2,0,1367000,14,0
2020-04-13,Eswatini,SZ,0,0,1367000,14,0
2020-04-14,Eswatini,SZ,1,0,1367000,15,0
2020-04-15,Eswatini,SZ,0,0,1367000,15,0
2020-04-16,Eswatini,SZ,1,0,1367000,16,0
2020-04-17,Eswatini,SZ,0,0,1367000,16,0
2020-04-18,Eswatini,SZ,3,1,1367000,19,1
2020-04-19,Eswatini,SZ,0,0,1367000,19,1
2020-04-20,Eswatini,SZ,3,0,1367000,22,1
2020-04-21,Eswatini,SZ,2,0,1367000,24,1
2020-04-22,Eswatini,SZ,0,0,1367000,24,1
2020-04-23,Eswatini,SZ,7,0,1367000,31,1
2020-04-24,Eswatini,SZ,1,0,1367000,32,1
2020-04-25,Eswatini,SZ,8,0,1367000,40,1
2020-04-26,Eswatini,SZ,0,0,1367000,40,1
2020-04-27,Eswatini,SZ,19,0,1367000,59,1
2020-04-28,Eswatini,SZ,6,0,1367000,65,1
2020-04-29,Eswatini,SZ,6,0,1367000,71,1
2020-04-30,Eswatini,SZ,20,0,1367000,91,1
2020-05-01,Eswatini,SZ,9,0,1367000,100,1
2020-05-02,Eswatini,SZ,6,0,1367000,106,1
2020-05-03,Eswatini,SZ,2,0,1367000,108,1
2020-03-25,Turks_and_Caicos_islands,TC,1,0,31458,1,0
2020-03-26,Turks_and_Caicos_islands,TC,0,0,31458,1,0
2020-03-27,Turks_and_Caicos_islands,TC,1,0,31458,2,0
2020-03-28,Turks_and_Caicos_islands,TC,0,0,31458,2,0
2020-03-29,Turks_and_Caicos_islands,TC,3,0,31458,5,0
2020-03-30,Turks_and_Caicos_islands,TC,0,0,31458,5,0
2020-03-31,Turks_and_Caicos_islands,TC,0,0,31458,5,0
2020-04-01,Turks_and_Caicos_islands,TC,0,0,31458,5,0
2020-04-02,Turks_and_Caicos_islands,TC,0,0,31458,5,0
2020-04-03,Turks_and_Caicos_islands,TC,0,0,31458,5,0
2020-04-04,Turks_and_Caicos_islands,TC,0,0,31458,5,0
2020-04-05,Turks_and_Caicos_islands,TC,0,0,31458,5,0
2020-04-06,Turks_and_Caicos_islands,TC,0,1,31458,5,1
2020-04-07,Turks_and_Caicos_islands,TC,3,0,31458,8,1
2020-04-08,Turks_and_Caicos_islands,TC,0,0,31458,8,1
2020-04-09,Turks_and_Caicos_islands,TC,0,0,31458,8,1
2020-04-10,Turks_and_Caicos_islands,TC,0,0,31458,8,1
2020-04-11,Turks_and_Caicos_islands,TC,1,0,31458,9,1
2020-04-12,Turks_and_Caicos_islands,TC,0,0,31458,9,1
2020-04-13,Turks_and_Caicos_islands,TC,0,0,31458,9,1
2020-04-14,Turks_and_Caicos_islands,TC,1,0,31458,10,1
2020-04-15,Turks_and_Caicos_islands,TC,0,0,31458,10,1
2020-04-16,Turks_and_Caicos_islands,TC,1,0,31458,11,1
2020-04-17,Turks_and_Caicos_islands,TC,0,0,31458,11,1
2020-04-18,Turks_and_Caicos_islands,TC,0,0,31458,11,1
2020-04-19,Turks_and_Caicos_islands,TC,0,0,31458,11,1
2020-04-20,Turks_and_Caicos_islands,TC,0,0,31458,11,1
2020-04-21,Turks_and_Caicos_islands,TC,0,0,31458,11,1
2020-04-22,Turks_and_Caicos_islands,TC,0,0,31458,11,1
2020-04-23,Turks_and_Caicos_islands,TC,0,0,31458,11,1
2020-04-24,Turks_and_Caicos_islands,TC,0,0,31458,11,1
2020-04-25,Turks_and_Caicos_islands,TC,0,0,31458,11,1
2020-04-26,Turks_and_Caicos_islands,TC,0,0,31458,11,1
2020-04-27,Turks_and_Caicos_islands,TC,0,0,31458,11,1
2020-04-28,Turks_and_Caicos_islands,TC,1,0,31458,12,1
2020-04-29,Turks_and_Caicos_islands,TC,0,0,31458,12,1
2020-04-30,Turks_and_Caicos_islands,TC,0,0,31458,12,1
2020-05-01,Turks_and_Caicos_islands,TC,0,0,31458,12,1
2020-05-02,Turks_and_Caicos_islands,TC,0,0,31458,12,1
2020-05-03,Turks_and_Caicos_islands,TC,0,0,31458,12,1
2020-03-20,Chad,TD,1,0,15477751,1,0
2020-03-21,Chad,TD,0,0,15477751,1,0
2020-03-22,Chad,TD,1,0,15477751,2,0
2020-03-23,Chad,TD,0,0,15477751,2,0
2020-03-24,Chad,TD,0,0,15477751,2,0
2020-03-25,Chad,TD,1,0,15477751,3,0
2020-03-26,Chad,TD,0,0,15477751,3,0
2020-03-27,Chad,TD,2,0,15477751,5,0
2020-03-28,Chad,TD,0,0,15477751,5,0
2020-03-29,Chad,TD,0,0,15477751,5,0
2020-03-30,Chad,TD,0,0,15477751,5,0
2020-03-31,Chad,TD,2,0,15477751,7,0
2020-04-01,Chad,TD,0,0,15477751,7,0
2020-04-02,Chad,TD,0,0,15477751,7,0
2020-04-03,Chad,TD,0,0,15477751,7,0
2020-04-04,Chad,TD,0,0,15477751,7,0
2020-04-05,Chad,TD,1,0,15477751,8,0
2020-04-06,Chad,TD,1,0,15477751,9,0
2020-04-07,Chad,TD,0,0,15477751,9,0
2020-04-08,Chad,TD,0,0,15477751,9,0
2020-04-09,Chad,TD,1,0,15477751,10,0
2020-04-10,Chad,TD,1,0,15477751,11,0
2020-04-11,Chad,TD,0,0,15477751,11,0
2020-04-12,Chad,TD,0,0,15477751,11,0
2020-04-13,Chad,TD,4,0,15477751,15,0
2020-04-14,Chad,TD,8,0,15477751,23,0
2020-04-15,Chad,TD,0,0,15477751,23,0
2020-04-16,Chad,TD,4,0,15477751,27,0
2020-04-17,Chad,TD,0,0,15477751,27,0
2020-04-18,Chad,TD,6,0,15477751,33,0
2020-04-19,Chad,TD,0,0,15477751,33,0
2020-04-20,Chad,TD,0,0,15477751,33,0
2020-04-21,Chad,TD,0,0,15477751,33,0
2020-04-22,Chad,TD,1,0,15477751,34,0
2020-04-23,Chad,TD,0,0,15477751,34,0
2020-04-24,Chad,TD,6,0,15477751,40,0
2020-04-25,Chad,TD,0,0,15477751,40,0
2020-04-26,Chad,TD,0,0,15477751,40,0
2020-04-27,Chad,TD,6,0,15477751,46,0
2020-04-28,Chad,TD,0,0,15477751,46,0
2020-04-29,Chad,TD,6,2,15477751,52,2
2020-04-30,Chad,TD,0,0,15477751,52,2
2020-05-01,Chad,TD,21,3,15477751,73,5
2020-05-02,Chad,TD,0,0,15477751,73,5
2020-05-03,Chad,TD,44,5,15477751,117,10
2020-03-07,Togo,TG,1,0,7889094,1,0
2020-03-15,Togo,TG,0,0,7889094,1,0
2020-03-16,Togo,TG,0,0,7889094,1,0
2020-03-17,Togo,TG,0,0,7889094,1,0
2020-03-18,Togo,TG,0,0,7889094,1,0
2020-03-19,Togo,TG,0,0,7889094,1,0
2020-03-20,Togo,TG,0,0,7889094,1,0
2020-03-21,Togo,TG,8,0,7889094,9,0
2020-03-22,Togo,TG,6,0,7889094,15,0
2020-03-23,Togo,TG,0,0,7889094,15,0
2020-03-24,Togo,TG,3,0,7889094,18,0
2020-03-25,Togo,TG,0,0,7889094,18,0
2020-03-26,Togo,TG,5,0,7889094,23,0
2020-03-27,Togo,TG,1,0,7889094,24,0
2020-03-28,Togo,TG,1,1,7889094,25,1
2020-03-29,Togo,TG,3,0,7889094,28,1
2020-03-30,Togo,TG,2,0,7889094,30,1
2020-03-31,Togo,TG,4,0,7889094,34,1
2020-04-01,Togo,TG,0,0,7889094,34,1
2020-04-02,Togo,TG,2,1,7889094,36,2
2020-04-03,Togo,TG,3,0,7889094,39,2
2020-04-04,Togo,TG,1,1,7889094,40,3
2020-04-05,Togo,TG,1,0,7889094,41,3
2020-04-06,Togo,TG,3,0,7889094,44,3
2020-04-07,Togo,TG,14,0,7889094,58,3
2020-04-08,Togo,TG,7,0,7889094,65,3
2020-04-09,Togo,TG,5,0,7889094,70,3
2020-04-10,Togo,TG,3,0,7889094,73,3
2020-04-11,Togo,TG,3,0,7889094,76,3
2020-04-12,Togo,TG,0,0,7889094,76,3
2020-04-13,Togo,TG,0,0,7889094,76,3
2020-04-14,Togo,TG,1,0,7889094,77,3
2020-04-15,Togo,TG,0,0,7889094,77,3
2020-04-16,Togo,TG,4,0,7889094,81,3
2020-04-17,Togo,TG,0,2,7889094,81,5
2020-04-18,Togo,TG,2,0,7889094,83,5
2020-04-19,Togo,TG,1,0,7889094,84,5
2020-04-20,Togo,TG,0,0,7889094,84,5
2020-04-21,Togo,TG,0,1,7889094,84,6
2020-04-22,Togo,TG,2,0,7889094,86,6
2020-04-23,Togo,TG,2,0,7889094,88,6
2020-04-24,Togo,TG,0,0,7889094,88,6
2020-04-25,Togo,TG,2,0,7889094,90,6
2020-04-26,Togo,TG,6,0,7889094,96,6
2020-04-27,Togo,TG,2,0,7889094,98,6
2020-04-28,Togo,TG,1,0,7889094,99,6
2020-04-29,Togo,TG,0,0,7889094,99,6
2020-04-30,Togo,TG,10,1,7889094,109,7
2020-05-01,Togo,TG,7,2,7889094,116,9
2020-05-02,Togo,TG,7,0,7889094,123,9
2020-05-03,Togo,TG,0,0,7889094,123,9
2019-12-31,Thailand,TH,0,0,69428524,0,0
2020-01-01,Thailand,TH,0,0,69428524,0,0
2020-01-02,Thailand,TH,0,0,69428524,0,0
2020-01-03,Thailand,TH,0,0,69428524,0,0
2020-01-04,Thailand,TH,0,0,69428524,0,0
2020-01-05,Thailand,TH,0,0,69428524,0,0
2020-01-06,Thailand,TH,0,0,69428524,0,0
2020-01-07,Thailand,TH,0,0,69428524,0,0
2020-01-08,Thailand,TH,0,0,69428524,0,0
2020-01-09,Thailand,TH,0,0,69428524,0,0
2020-01-10,Thailand,TH,0,0,69428524,0,0
2020-01-11,Thailand,TH,0,0,69428524,0,0
2020-01-12,Thailand,TH,0,0,69428524,0,0
2020-01-13,Thailand,TH,1,0,69428524,1,0
2020-01-14,Thailand,TH,0,0,69428524,1,0
2020-01-15,Thailand,TH,0,0,69428524,1,0
2020-01-16,Thailand,TH,0,0,69428524,1,0
2020-01-17,Thailand,TH,1,0,69428524,2,0
2020-01-18,Thailand,TH,0,0,69428524,2,0
2020-01-19,Thailand,TH,0,0,69428524,2,0
2020-01-20,Thailand,TH,0,0,69428524,2,0
2020-01-21,Thailand,TH,0,0,69428524,2,0
2020-01-22,Thailand,TH,2,0,69428524,4,0
2020-01-23,Thailand,TH,0,0,69428524,4,0
2020-01-24,Thailand,TH,0,0,69428524,4,0
2020-01-25,Thailand,TH,1,0,69428524,5,0
2020-01-26,Thailand,TH,0,0,69428524,5,0
2020-01-27,Thailand,TH,3,0,69428524,8,0
2020-01-28,Thailand,TH,6,0,69428524,14,0
2020-01-29,Thailand,TH,0,0,69428524,14,0
2020-01-30,Thailand,TH,0,0,69428524,14,0
2020-01-31,Thailand,TH,0,0,69428524,14,0
2020-02-01,Thailand,TH,5,0,69428524,19,0
2020-02-02,Thailand,TH,0,0,69428524,19,0
2020-02-03,Thailand,TH,0,0,69428524,19,0
2020-02-04,Thailand,TH,0,0,69428524,19,0
2020-02-05,Thailand,TH,6,0,69428524,25,0
2020-02-06,Thailand,TH,0,0,69428524,25,0
2020-02-07,Thailand,TH,0,0,69428524,25,0
2020-02-08,Thailand,TH,7,0,69428524,32,0
2020-02-09,Thailand,TH,0,0,69428524,32,0
2020-02-10,Thailand,TH,0,0,69428524,32,0
2020-02-11,Thailand,TH,0,0,69428524,32,0
2020-02-12,Thailand,TH,1,0,69428524,33,0
2020-02-13,Thailand,TH,0,0,69428524,33,0
2020-02-14,Thailand,TH,0,0,69428524,33,0
2020-02-15,Thailand,TH,1,0,69428524,34,0
2020-02-16,Thailand,TH,0,0,69428524,34,0
2020-02-17,Thailand,TH,0,0,69428524,34,0
2020-02-18,Thailand,TH,1,0,69428524,35,0
2020-02-19,Thailand,TH,0,0,69428524,35,0
2020-02-20,Thailand,TH,0,0,69428524,35,0
2020-02-21,Thailand,TH,0,0,69428524,35,0
2020-02-22,Thailand,TH,0,0,69428524,35,0
2020-02-23,Thailand,TH,0,0,69428524,35,0
2020-02-24,Thailand,TH,0,0,69428524,35,0
2020-02-25,Thailand,TH,2,0,69428524,37,0
2020-02-26,Thailand,TH,3,0,69428524,40,0
2020-02-27,Thailand,TH,0,0,69428524,40,0
2020-02-28,Thailand,TH,0,0,69428524,40,0
2020-02-29,Thailand,TH,2,0,69428524,42,0
2020-03-01,Thailand,TH,0,1,69428524,42,1
2020-03-02,Thailand,TH,1,0,69428524,43,1
2020-03-05,Thailand,TH,4,0,69428524,47,1
2020-03-07,Thailand,TH,3,0,69428524,50,1
2020-03-11,Thailand,TH,9,0,69428524,59,1
2020-03-12,Thailand,TH,11,0,69428524,70,1
2020-03-14,Thailand,TH,12,0,69428524,82,1
2020-03-15,Thailand,TH,0,0,69428524,82,1
2020-03-16,Thailand,TH,32,0,69428524,114,1
2020-03-17,Thailand,TH,63,0,69428524,177,1
2020-03-18,Thailand,TH,0,0,69428524,177,1
2020-03-19,Thailand,TH,0,0,69428524,177,1
2020-03-20,Thailand,TH,35,0,69428524,212,1
2020-03-21,Thailand,TH,154,0,69428524,366,1
2020-03-22,Thailand,TH,233,0,69428524,599,1
2020-03-23,Thailand,TH,122,0,69428524,721,1
2020-03-24,Thailand,TH,106,3,69428524,827,4
2020-03-25,Thailand,TH,107,0,69428524,934,4
2020-03-26,Thailand,TH,111,0,69428524,1045,4
2020-03-27,Thailand,TH,91,1,69428524,1136,5
2020-03-28,Thailand,TH,0,0,69428524,1136,5
2020-03-29,Thailand,TH,109,1,69428524,1245,6
2020-03-30,Thailand,TH,143,1,69428524,1388,7
2020-03-31,Thailand,TH,263,3,69428524,1651,10
2020-04-01,Thailand,TH,0,0,69428524,1651,10
2020-04-02,Thailand,TH,120,2,69428524,1771,12
2020-04-03,Thailand,TH,104,3,69428524,1875,15
2020-04-04,Thailand,TH,103,4,69428524,1978,19
2020-04-05,Thailand,TH,191,4,69428524,2169,23
2020-04-06,Thailand,TH,51,3,69428524,2220,26
2020-04-07,Thailand,TH,38,0,69428524,2258,26
2020-04-08,Thailand,TH,111,4,69428524,2369,30
2020-04-09,Thailand,TH,54,2,69428524,2423,32
2020-04-10,Thailand,TH,50,1,69428524,2473,33
2020-04-11,Thailand,TH,45,2,69428524,2518,35
2020-04-12,Thailand,TH,33,3,69428524,2551,38
2020-04-13,Thailand,TH,28,2,69428524,2579,40
2020-04-14,Thailand,TH,34,1,69428524,2613,41
2020-04-15,Thailand,TH,30,2,69428524,2643,43
2020-04-16,Thailand,TH,29,3,69428524,2672,46
2020-04-17,Thailand,TH,28,1,69428524,2700,47
2020-04-18,Thailand,TH,0,0,69428524,2700,47
2020-04-19,Thailand,TH,33,0,69428524,2733,47
2020-04-20,Thailand,TH,32,0,69428524,2765,47
2020-04-21,Thailand,TH,27,0,69428524,2792,47
2020-04-22,Thailand,TH,19,1,69428524,2811,48
2020-04-23,Thailand,TH,28,2,69428524,2839,50
2020-04-24,Thailand,TH,0,0,69428524,2839,50
2020-04-25,Thailand,TH,15,0,69428524,2854,50
2020-04-26,Thailand,TH,68,1,69428524,2922,51
2020-04-27,Thailand,TH,0,0,69428524,2922,51
2020-04-28,Thailand,TH,16,3,69428524,2938,54
2020-04-29,Thailand,TH,0,0,69428524,2938,54
2020-04-30,Thailand,TH,16,0,69428524,2954,54
2020-05-01,Thailand,TH,6,0,69428524,2960,54
2020-05-02,Thailand,TH,0,0,69428524,2960,54
2020-05-03,Thailand,TH,6,0,69428524,2966,54
2020-05-01,Tajikistan,TJ,15,0,9100837,15,0
2020-05-02,Tajikistan,TJ,0,0,9100837,15,0
2020-05-03,Tajikistan,TJ,17,0,9100837,32,0
2020-03-22,Timor_Leste,TL,1,0,1267972,1,0
2020-03-23,Timor_Leste,TL,0,0,1267972,1,0
2020-03-24,Timor_Leste,TL,0,0,1267972,1,0
2020-03-25,Timor_Leste,TL,0,0,1267972,1,0
2020-03-26,Timor_Leste,TL,0,0,1267972,1,0
2020-03-27,Timor_Leste,TL,0,0,1267972,1,0
2020-03-28,Timor_Leste,TL,0,0,1267972,1,0
2020-03-29,Timor_Leste,TL,0,0,1267972,1,0
2020-03-30,Timor_Leste,TL,0,0,1267972,1,0
2020-03-31,Timor_Leste,TL,0,0,1267972,1,0
2020-04-01,Timor_Leste,TL,0,0,1267972,1,0
2020-04-02,Timor_Leste,TL,0,0,1267972,1,0
2020-04-03,Timor_Leste,TL,0,0,1267972,1,0
2020-04-04,Timor_Leste,TL,0,0,1267972,1,0
2020-04-05,Timor_Leste,TL,0,0,1267972,1,0
2020-04-06,Timor_Leste,TL,0,0,1267972,1,0
2020-04-07,Timor_Leste,TL,0,0,1267972,1,0
2020-04-08,Timor_Leste,TL,0,0,1267972,1,0
2020-04-09,Timor_Leste,TL,0,0,1267972,1,0
2020-04-10,Timor_Leste,TL,1,0,1267972,2,0
2020-04-11,Timor_Leste,TL,0,0,1267972,2,0
2020-04-12,Timor_Leste,TL,0,0,1267972,2,0
2020-04-13,Timor_Leste,TL,0,0,1267972,2,0
2020-04-14,Timor_Leste,TL,2,0,1267972,4,0
2020-04-15,Timor_Leste,TL,2,0,1267972,6,0
2020-04-16,Timor_Leste,TL,0,0,1267972,6,0
2020-04-17,Timor_Leste,TL,12,0,1267972,18,0
2020-04-18,Timor_Leste,TL,0,0,1267972,18,0
2020-04-19,Timor_Leste,TL,0,0,1267972,18,0
2020-04-20,Timor_Leste,TL,1,0,1267972,19,0
2020-04-21,Timor_Leste,TL,3,0,1267972,22,0
2020-04-22,Timor_Leste,TL,1,0,1267972,23,0
2020-04-23,Timor_Leste,TL,0,0,1267972,23,0
2020-04-24,Timor_Leste,TL,0,0,1267972,23,0
2020-04-25,Timor_Leste,TL,1,0,1267972,24,0
2020-04-26,Timor_Leste,TL,0,0,1267972,24,0
2020-04-27,Timor_Leste,TL,0,0,1267972,24,0
2020-04-28,Timor_Leste,TL,0,0,1267972,24,0
2020-04-29,Timor_Leste,TL,0,0,1267972,24,0
2020-04-30,Timor_Leste,TL,0,0,1267972,24,0
2020-05-01,Timor_Leste,TL,0,0,1267972,24,0
2020-05-02,Timor_Leste,TL,0,0,1267972,24,0
2020-05-03,Timor_Leste,TL,0,0,1267972,24,0
2020-03-03,Tunisia,TN,1,0,11565204,1,0
2020-03-10,Tunisia,TN,1,0,11565204,2,0
2020-03-11,Tunisia,TN,3,0,11565204,5,0
2020-03-12,Tunisia,TN,2,0,11565204,7,0
2020-03-13,Tunisia,TN,6,0,11565204,13,0
2020-03-14,Tunisia,TN,3,0,11565204,16,0
2020-03-15,Tunisia,TN,0,0,11565204,16,0
2020-03-16,Tunisia,TN,2,0,11565204,18,0
2020-03-17,Tunisia,TN,2,0,11565204,20,0
2020-03-18,Tunisia,TN,4,0,11565204,24,0
2020-03-19,Tunisia,TN,5,0,11565204,29,0
2020-03-20,Tunisia,TN,10,0,11565204,39,0
2020-03-21,Tunisia,TN,15,1,11565204,54,1
2020-03-22,Tunisia,TN,6,0,11565204,60,1
2020-03-23,Tunisia,TN,15,2,11565204,75,3
2020-03-24,Tunisia,TN,14,0,11565204,89,3
2020-03-25,Tunisia,TN,25,0,11565204,114,3
2020-03-26,Tunisia,TN,59,2,11565204,173,5
2020-03-27,Tunisia,TN,0,0,11565204,173,5
2020-03-28,Tunisia,TN,54,1,11565204,227,6
2020-03-29,Tunisia,TN,0,0,11565204,227,6
2020-03-30,Tunisia,TN,51,2,11565204,278,8
2020-03-31,Tunisia,TN,34,0,11565204,312,8
2020-04-01,Tunisia,TN,50,1,11565204,362,9
2020-04-02,Tunisia,TN,32,1,11565204,394,10
2020-04-03,Tunisia,TN,61,3,11565204,455,13
2020-04-04,Tunisia,TN,0,0,11565204,455,13
2020-04-05,Tunisia,TN,40,5,11565204,495,18
2020-04-06,Tunisia,TN,58,1,11565204,553,19
2020-04-07,Tunisia,TN,21,3,11565204,574,22
2020-04-08,Tunisia,TN,22,0,11565204,596,22
2020-04-09,Tunisia,TN,27,1,11565204,623,23
2020-04-10,Tunisia,TN,20,2,11565204,643,25
2020-04-11,Tunisia,TN,28,0,11565204,671,25
2020-04-12,Tunisia,TN,14,3,11565204,685,28
2020-04-13,Tunisia,TN,22,3,11565204,707,31
2020-04-14,Tunisia,TN,19,3,11565204,726,34
2020-04-15,Tunisia,TN,21,0,11565204,747,34
2020-04-16,Tunisia,TN,33,1,11565204,780,35
2020-04-17,Tunisia,TN,42,2,11565204,822,37
2020-04-18,Tunisia,TN,42,0,11565204,864,37
2020-04-19,Tunisia,TN,2,0,11565204,866,37
2020-04-20,Tunisia,TN,13,1,11565204,879,38
2020-04-21,Tunisia,TN,5,0,11565204,884,38
2020-04-22,Tunisia,TN,17,0,11565204,901,38
2020-04-23,Tunisia,TN,0,0,11565204,901,38
2020-04-24,Tunisia,TN,17,0,11565204,918,38
2020-04-25,Tunisia,TN,4,0,11565204,922,38
2020-04-26,Tunisia,TN,17,0,11565204,939,38
2020-04-27,Tunisia,TN,10,0,11565204,949,38
2020-04-28,Tunisia,TN,18,1,11565204,967,39
2020-04-29,Tunisia,TN,8,1,11565204,975,40
2020-04-30,Tunisia,TN,5,0,11565204,980,40
2020-05-01,Tunisia,TN,14,0,11565204,994,40
2020-05-02,Tunisia,TN,4,1,11565204,998,41
2020-05-03,Tunisia,TN,11,1,11565204,1009,42
2020-03-12,Turkey,TR,1,0,82319724,1,0
2020-03-13,Turkey,TR,1,0,82319724,2,0
2020-03-16,Turkey,TR,16,0,82319724,18,0
2020-03-17,Turkey,TR,29,0,82319724,47,0
2020-03-18,Turkey,TR,51,0,82319724,98,0
2020-03-19,Turkey,TR,93,1,82319724,191,1
2020-03-20,Turkey,TR,168,3,82319724,359,4
2020-03-21,Turkey,TR,311,5,82319724,670,9
2020-03-22,Turkey,TR,277,12,82319724,947,21
2020-03-23,Turkey,TR,289,9,82319724,1236,30
2020-03-24,Turkey,TR,293,7,82319724,1529,37
2020-03-25,Turkey,TR,343,7,82319724,1872,44
2020-03-26,Turkey,TR,561,15,82319724,2433,59
2020-03-27,Turkey,TR,1196,16,82319724,3629,75
2020-03-28,Turkey,TR,2069,17,82319724,5698,92
2020-03-29,Turkey,TR,1704,16,82319724,7402,108
2020-03-30,Turkey,TR,1815,23,82319724,9217,131
2020-03-31,Turkey,TR,1610,37,82319724,10827,168
2020-04-01,Turkey,TR,2704,46,82319724,13531,214
2020-04-02,Turkey,TR,2148,63,82319724,15679,277
2020-04-03,Turkey,TR,2456,79,82319724,18135,356
2020-04-04,Turkey,TR,2786,69,82319724,20921,425
2020-04-05,Turkey,TR,3013,76,82319724,23934,501
2020-04-06,Turkey,TR,3135,73,82319724,27069,574
2020-04-07,Turkey,TR,3148,75,82319724,30217,649
2020-04-08,Turkey,TR,3892,76,82319724,34109,725
2020-04-09,Turkey,TR,4117,87,82319724,38226,812
2020-04-10,Turkey,TR,4056,96,82319724,42282,908
2020-04-11,Turkey,TR,4747,98,82319724,47029,1006
2020-04-12,Turkey,TR,5138,95,82319724,52167,1101
2020-04-13,Turkey,TR,4789,97,82319724,56956,1198
2020-04-14,Turkey,TR,4093,98,82319724,61049,1296
2020-04-15,Turkey,TR,4062,107,82319724,65111,1403
2020-04-16,Turkey,TR,4281,115,82319724,69392,1518
2020-04-17,Turkey,TR,4801,125,82319724,74193,1643
2020-04-18,Turkey,TR,4353,126,82319724,78546,1769
2020-04-19,Turkey,TR,3783,121,82319724,82329,1890
2020-04-20,Turkey,TR,3977,127,82319724,86306,2017
2020-04-21,Turkey,TR,4674,123,82319724,90980,2140
2020-04-22,Turkey,TR,4611,119,82319724,95591,2259
2020-04-23,Turkey,TR,3083,117,82319724,98674,2376
2020-04-24,Turkey,TR,3116,115,82319724,101790,2491
2020-04-25,Turkey,TR,3122,109,82319724,104912,2600
2020-04-26,Turkey,TR,2861,106,82319724,107773,2706
2020-04-27,Turkey,TR,2357,99,82319724,110130,2805
2020-04-28,Turkey,TR,2131,95,82319724,112261,2900
2020-04-29,Turkey,TR,2392,92,82319724,114653,2992
2020-04-30,Turkey,TR,2936,89,82319724,117589,3081
2020-05-01,Turkey,TR,2615,93,82319724,120204,3174
2020-05-02,Turkey,TR,2188,84,82319724,122392,3258
2020-05-03,Turkey,TR,1983,78,82319724,124375,3336
2020-03-13,Trinidad_and_Tobago,TT,1,0,1389858,1,0
2020-03-14,Trinidad_and_Tobago,TT,1,0,1389858,2,0
2020-03-15,Trinidad_and_Tobago,TT,0,0,1389858,2,0
2020-03-16,Trinidad_and_Tobago,TT,2,0,1389858,4,0
2020-03-17,Trinidad_and_Tobago,TT,1,0,1389858,5,0
2020-03-18,Trinidad_and_Tobago,TT,2,0,1389858,7,0
2020-03-19,Trinidad_and_Tobago,TT,2,0,1389858,9,0
2020-03-20,Trinidad_and_Tobago,TT,0,0,1389858,9,0
2020-03-21,Trinidad_and_Tobago,TT,0,0,1389858,9,0
2020-03-22,Trinidad_and_Tobago,TT,40,0,1389858,49,0
2020-03-23,Trinidad_and_Tobago,TT,1,0,1389858,50,0
2020-03-24,Trinidad_and_Tobago,TT,1,0,1389858,51,0
2020-03-25,Trinidad_and_Tobago,TT,6,0,1389858,57,0
2020-03-26,Trinidad_and_Tobago,TT,3,1,1389858,60,1
2020-03-27,Trinidad_and_Tobago,TT,5,0,1389858,65,1
2020-03-28,Trinidad_and_Tobago,TT,1,1,1389858,66,2
2020-03-29,Trinidad_and_Tobago,TT,8,0,1389858,74,2
2020-03-30,Trinidad_and_Tobago,TT,4,1,1389858,78,3
2020-03-31,Trinidad_and_Tobago,TT,7,0,1389858,85,3
2020-04-01,Trinidad_and_Tobago,TT,2,0,1389858,87,3
2020-04-02,Trinidad_and_Tobago,TT,2,2,1389858,89,5
2020-04-03,Trinidad_and_Tobago,TT,8,1,1389858,97,6
2020-04-04,Trinidad_and_Tobago,TT,3,0,1389858,100,6
2020-04-05,Trinidad_and_Tobago,TT,3,0,1389858,103,6
2020-04-06,Trinidad_and_Tobago,TT,1,1,1389858,104,7
2020-04-07,Trinidad_and_Tobago,TT,1,1,1389858,105,8
2020-04-08,Trinidad_and_Tobago,TT,2,0,1389858,107,8
2020-04-09,Trinidad_and_Tobago,TT,0,0,1389858,107,8
2020-04-10,Trinidad_and_Tobago,TT,2,0,1389858,109,8
2020-04-11,Trinidad_and_Tobago,TT,0,0,1389858,109,8
2020-04-12,Trinidad_and_Tobago,TT,3,0,1389858,112,8
2020-04-13,Trinidad_and_Tobago,TT,1,0,1389858,113,8
2020-04-14,Trinidad_and_Tobago,TT,0,0,1389858,113,8
2020-04-15,Trinidad_and_Tobago,TT,0,0,1389858,113,8
2020-04-16,Trinidad_and_Tobago,TT,1,0,1389858,114,8
2020-04-17,Trinidad_and_Tobago,TT,0,0,1389858,114,8
2020-04-18,Trinidad_and_Tobago,TT,0,0,1389858,114,8
2020-04-19,Trinidad_and_Tobago,TT,0,0,1389858,114,8
2020-04-20,Trinidad_and_Tobago,TT,0,0,1389858,114,8
2020-04-21,Trinidad_and_Tobago,TT,0,0,1389858,114,8
2020-04-22,Trinidad_and_Tobago,TT,1,0,1389858,115,8
2020-04-23,Trinidad_and_Tobago,TT,0,0,1389858,115,8
2020-04-24,Trinidad_and_Tobago,TT,0,0,1389858,115,8
2020-04-25,Trinidad_and_Tobago,TT,0,0,1389858,115,8
2020-04-26,Trinidad_and_Tobago,TT,0,0,1389858,115,8
2020-04-27,Trinidad_and_Tobago,TT,1,0,1389858,116,8
2020-04-28,Trinidad_and_Tobago,TT,0,0,1389858,116,8
2020-04-29,Trinidad_and_Tobago,TT,0,0,1389858,116,8
2020-04-30,Trinidad_and_Tobago,TT,0,0,1389858,116,8
2020-05-01,Trinidad_and_Tobago,TT,0,0,1389858,116,8
2020-05-02,Trinidad_and_Tobago,TT,0,0,1389858,116,8
2020-05-03,Trinidad_and_Tobago,TT,0,0,1389858,116,8
2019-12-31,Taiwan,TW,0,0,23780452,0,0
2020-01-01,Taiwan,TW,0,0,23780452,0,0
2020-01-02,Taiwan,TW,0,0,23780452,0,0
2020-01-03,Taiwan,TW,0,0,23780452,0,0
2020-01-04,Taiwan,TW,0,0,23780452,0,0
2020-01-05,Taiwan,TW,0,0,23780452,0,0
2020-01-06,Taiwan,TW,0,0,23780452,0,0
2020-01-07,Taiwan,TW,0,0,23780452,0,0
2020-01-08,Taiwan,TW,0,0,23780452,0,0
2020-01-09,Taiwan,TW,0,0,23780452,0,0
2020-01-10,Taiwan,TW,0,0,23780452,0,0
2020-01-11,Taiwan,TW,0,0,23780452,0,0
2020-01-12,Taiwan,TW,0,0,23780452,0,0
2020-01-13,Taiwan,TW,0,0,23780452,0,0
2020-01-14,Taiwan,TW,0,0,23780452,0,0
2020-01-15,Taiwan,TW,0,0,23780452,0,0
2020-01-16,Taiwan,TW,0,0,23780452,0,0
2020-01-17,Taiwan,TW,0,0,23780452,0,0
2020-01-18,Taiwan,TW,0,0,23780452,0,0
2020-01-19,Taiwan,TW,0,0,23780452,0,0
2020-01-20,Taiwan,TW,0,0,23780452,0,0
2020-01-21,Taiwan,TW,1,0,23780452,1,0
2020-01-22,Taiwan,TW,0,0,23780452,1,0
2020-01-23,Taiwan,TW,0,0,23780452,1,0
2020-01-24,Taiwan,TW,0,0,23780452,1,0
2020-01-25,Taiwan,TW,2,0,23780452,3,0
2020-01-26,Taiwan,TW,0,0,23780452,3,0
2020-01-27,Taiwan,TW,2,0,23780452,5,0
2020-01-28,Taiwan,TW,2,0,23780452,7,0
2020-01-29,Taiwan,TW,1,0,23780452,8,0
2020-01-30,Taiwan,TW,0,0,23780452,8,0
2020-01-31,Taiwan,TW,1,0,23780452,9,0
2020-02-01,Taiwan,TW,1,0,23780452,10,0
2020-02-02,Taiwan,TW,0,0,23780452,10,0
2020-02-03,Taiwan,TW,0,0,23780452,10,0
2020-02-04,Taiwan,TW,0,0,23780452,10,0
2020-02-05,Taiwan,TW,1,0,23780452,11,0
2020-02-06,Taiwan,TW,0,0,23780452,11,0
2020-02-07,Taiwan,TW,5,0,23780452,16,0
2020-02-08,Taiwan,TW,1,0,23780452,17,0
2020-02-09,Taiwan,TW,1,0,23780452,18,0
2020-02-10,Taiwan,TW,0,0,23780452,18,0
2020-02-11,Taiwan,TW,0,0,23780452,18,0
2020-02-12,Taiwan,TW,0,0,23780452,18,0
2020-02-13,Taiwan,TW,0,0,23780452,18,0
2020-02-14,Taiwan,TW,0,0,23780452,18,0
2020-02-15,Taiwan,TW,0,0,23780452,18,0
2020-02-16,Taiwan,TW,0,0,23780452,18,0
2020-02-17,Taiwan,TW,2,1,23780452,20,1
2020-02-18,Taiwan,TW,2,0,23780452,22,1
2020-02-19,Taiwan,TW,0,0,23780452,22,1
2020-02-20,Taiwan,TW,2,0,23780452,24,1
2020-02-21,Taiwan,TW,0,0,23780452,24,1
2020-02-22,Taiwan,TW,2,0,23780452,26,1
2020-02-23,Taiwan,TW,0,0,23780452,26,1
2020-02-24,Taiwan,TW,2,0,23780452,28,1
2020-02-25,Taiwan,TW,2,0,23780452,30,1
2020-02-26,Taiwan,TW,1,0,23780452,31,1
2020-02-27,Taiwan,TW,1,0,23780452,32,1
2020-02-28,Taiwan,TW,2,0,23780452,34,1
2020-02-29,Taiwan,TW,5,0,23780452,39,1
2020-03-01,Taiwan,TW,1,0,23780452,40,1
2020-03-02,Taiwan,TW,0,0,23780452,40,1
2020-03-03,Taiwan,TW,1,0,23780452,41,1
2020-03-04,Taiwan,TW,1,0,23780452,42,1
2020-03-06,Taiwan,TW,2,0,23780452,44,1
2020-03-07,Taiwan,TW,1,0,23780452,45,1
2020-03-08,Taiwan,TW,0,0,23780452,45,1
2020-03-09,Taiwan,TW,0,0,23780452,45,1
2020-03-11,Taiwan,TW,3,0,23780452,48,1
2020-03-12,Taiwan,TW,0,0,23780452,48,1
2020-03-13,Taiwan,TW,1,0,23780452,49,1
2020-03-14,Taiwan,TW,4,0,23780452,53,1
2020-03-15,Taiwan,TW,6,0,23780452,59,1
2020-03-16,Taiwan,TW,0,0,23780452,59,1
2020-03-17,Taiwan,TW,8,0,23780452,67,1
2020-03-18,Taiwan,TW,10,0,23780452,77,1
2020-03-19,Taiwan,TW,31,0,23780452,108,1
2020-03-20,Taiwan,TW,0,0,23780452,108,1
2020-03-21,Taiwan,TW,27,1,23780452,135,2
2020-03-22,Taiwan,TW,18,0,23780452,153,2
2020-03-23,Taiwan,TW,12,0,23780452,165,2
2020-03-24,Taiwan,TW,30,0,23780452,195,2
2020-03-25,Taiwan,TW,21,0,23780452,216,2
2020-03-26,Taiwan,TW,19,0,23780452,235,2
2020-03-27,Taiwan,TW,17,0,23780452,252,2
2020-03-28,Taiwan,TW,15,0,23780452,267,2
2020-03-29,Taiwan,TW,16,0,23780452,283,2
2020-03-30,Taiwan,TW,23,3,23780452,306,5
2020-03-31,Taiwan,TW,0,0,23780452,306,5
2020-04-01,Taiwan,TW,16,0,23780452,322,5
2020-04-02,Taiwan,TW,17,0,23780452,339,5
2020-04-03,Taiwan,TW,0,0,23780452,339,5
2020-04-04,Taiwan,TW,16,0,23780452,355,5
2020-04-05,Taiwan,TW,8,0,23780452,363,5
2020-04-06,Taiwan,TW,0,0,23780452,363,5
2020-04-07,Taiwan,TW,10,0,23780452,373,5
2020-04-08,Taiwan,TW,3,0,23780452,376,5
2020-04-09,Taiwan,TW,3,0,23780452,379,5
2020-04-10,Taiwan,TW,1,0,23780452,380,5
2020-04-11,Taiwan,TW,0,0,23780452,380,5
2020-04-12,Taiwan,TW,5,1,23780452,385,6
2020-04-13,Taiwan,TW,3,0,23780452,388,6
2020-04-14,Taiwan,TW,5,0,23780452,393,6
2020-04-15,Taiwan,TW,2,0,23780452,395,6
2020-04-16,Taiwan,TW,0,0,23780452,395,6
2020-04-17,Taiwan,TW,0,0,23780452,395,6
2020-04-18,Taiwan,TW,0,0,23780452,395,6
2020-04-19,Taiwan,TW,3,0,23780452,398,6
2020-04-20,Taiwan,TW,22,0,23780452,420,6
2020-04-21,Taiwan,TW,2,0,23780452,422,6
2020-04-22,Taiwan,TW,3,0,23780452,425,6
2020-04-23,Taiwan,TW,1,0,23780452,426,6
2020-04-24,Taiwan,TW,1,0,23780452,427,6
2020-04-25,Taiwan,TW,1,0,23780452,428,6
2020-04-26,Taiwan,TW,1,0,23780452,429,6
2020-04-27,Taiwan,TW,0,0,23780452,429,6
2020-04-28,Taiwan,TW,0,0,23780452,429,6
2020-04-29,Taiwan,TW,0,0,23780452,429,6
2020-04-30,Taiwan,TW,0,0,23780452,429,6
2020-05-01,Taiwan,TW,0,0,23780452,429,6
2020-05-02,Taiwan,TW,0,0,23780452,429,6
2020-05-03,Taiwan,TW,3,0,23780452,432,6
2020-03-17,United_Republic_of_Tanzania,TZ,1,0,56318348,1,0
2020-03-18,United_Republic_of_Tanzania,TZ,0,0,56318348,1,0
2020-03-19,United_Republic_of_Tanzania,TZ,2,0,56318348,3,0
2020-03-20,United_Republic_of_Tanzania,TZ,0,0,56318348,3,0
2020-03-21,United_Republic_of_Tanzania,TZ,0,0,56318348,3,0
2020-03-22,United_Republic_of_Tanzania,TZ,3,0,56318348,6,0
2020-03-23,United_Republic_of_Tanzania,TZ,6,0,56318348,12,0
2020-03-24,United_Republic_of_Tanzania,TZ,0,0,56318348,12,0
2020-03-25,United_Republic_of_Tanzania,TZ,0,0,56318348,12,0
2020-03-26,United_Republic_of_Tanzania,TZ,0,0,56318348,12,0
2020-03-27,United_Republic_of_Tanzania,TZ,1,0,56318348,13,0
2020-03-28,United_Republic_of_Tanzania,TZ,0,0,56318348,13,0
2020-03-29,United_Republic_of_Tanzania,TZ,0,1,56318348,13,1
2020-03-30,United_Republic_of_Tanzania,TZ,1,0,56318348,14,1
2020-03-31,United_Republic_of_Tanzania,TZ,5,0,56318348,19,1
2020-04-01,United_Republic_of_Tanzania,TZ,0,0,56318348,19,1
2020-04-02,United_Republic_of_Tanzania,TZ,1,0,56318348,20,1
2020-04-03,United_Republic_of_Tanzania,TZ,1,0,56318348,21,1
2020-04-04,United_Republic_of_Tanzania,TZ,0,0,56318348,21,1
2020-04-05,United_Republic_of_Tanzania,TZ,0,0,56318348,21,1
2020-04-06,United_Republic_of_Tanzania,TZ,1,0,56318348,22,1
2020-04-07,United_Republic_of_Tanzania,TZ,2,0,56318348,24,1
2020-04-08,United_Republic_of_Tanzania,TZ,0,0,56318348,24,1
2020-04-09,United_Republic_of_Tanzania,TZ,1,0,56318348,25,1
2020-04-10,United_Republic_of_Tanzania,TZ,0,0,56318348,25,1
2020-04-11,United_Republic_of_Tanzania,TZ,7,2,56318348,32,3
2020-04-12,United_Republic_of_Tanzania,TZ,0,0,56318348,32,3
2020-04-13,United_Republic_of_Tanzania,TZ,0,0,56318348,32,3
2020-04-14,United_Republic_of_Tanzania,TZ,14,0,56318348,46,3
2020-04-15,United_Republic_of_Tanzania,TZ,7,0,56318348,53,3
2020-04-16,United_Republic_of_Tanzania,TZ,35,1,56318348,88,4
2020-04-17,United_Republic_of_Tanzania,TZ,6,0,56318348,94,4
2020-04-18,United_Republic_of_Tanzania,TZ,53,1,56318348,147,5
2020-04-19,United_Republic_of_Tanzania,TZ,1,0,56318348,148,5
2020-04-20,United_Republic_of_Tanzania,TZ,22,0,56318348,170,5
2020-04-21,United_Republic_of_Tanzania,TZ,0,0,56318348,170,5
2020-04-22,United_Republic_of_Tanzania,TZ,84,3,56318348,254,8
2020-04-23,United_Republic_of_Tanzania,TZ,31,2,56318348,285,10
2020-04-24,United_Republic_of_Tanzania,TZ,0,0,56318348,285,10
2020-04-25,United_Republic_of_Tanzania,TZ,15,0,56318348,300,10
2020-04-26,United_Republic_of_Tanzania,TZ,0,0,56318348,300,10
2020-04-27,United_Republic_of_Tanzania,TZ,0,0,56318348,300,10
2020-04-28,United_Republic_of_Tanzania,TZ,0,0,56318348,300,10
2020-04-29,United_Republic_of_Tanzania,TZ,6,0,56318348,306,10
2020-04-30,United_Republic_of_Tanzania,TZ,174,6,56318348,480,16
2020-05-01,United_Republic_of_Tanzania,TZ,0,0,56318348,480,16
2020-05-02,United_Republic_of_Tanzania,TZ,0,0,56318348,480,16
2020-05-03,United_Republic_of_Tanzania,TZ,0,0,56318348,480,16
2020-03-04,Ukraine,UA,1,0,44622516,1,0
2020-03-13,Ukraine,UA,2,0,44622516,3,0
2020-03-16,Ukraine,UA,0,0,44622516,3,0
2020-03-17,Ukraine,UA,2,0,44622516,5,0
2020-03-18,Ukraine,UA,9,0,44622516,14,0
2020-03-19,Ukraine,UA,5,2,44622516,19,2
2020-03-20,Ukraine,UA,7,0,44622516,26,2
2020-03-21,Ukraine,UA,0,1,44622516,26,3
2020-03-22,Ukraine,UA,15,0,44622516,41,3
2020-03-23,Ukraine,UA,6,0,44622516,47,3
2020-03-24,Ukraine,UA,26,0,44622516,73,3
2020-03-25,Ukraine,UA,11,0,44622516,84,3
2020-03-26,Ukraine,UA,29,1,44622516,113,4
2020-03-27,Ukraine,UA,43,1,44622516,156,5
2020-03-28,Ukraine,UA,62,0,44622516,218,5
2020-03-29,Ukraine,UA,93,3,44622516,311,8
2020-03-30,Ukraine,UA,107,1,44622516,418,9
2020-03-31,Ukraine,UA,62,2,44622516,480,11
2020-04-01,Ukraine,UA,69,2,44622516,549,13
2020-04-02,Ukraine,UA,245,7,44622516,794,20
2020-04-03,Ukraine,UA,10,0,44622516,804,20
2020-04-04,Ukraine,UA,183,3,44622516,987,23
2020-04-05,Ukraine,UA,109,5,44622516,1096,28
2020-04-06,Ukraine,UA,155,4,44622516,1251,32
2020-04-07,Ukraine,UA,68,6,44622516,1319,38
2020-04-08,Ukraine,UA,143,7,44622516,1462,45
2020-04-09,Ukraine,UA,206,7,44622516,1668,52
2020-04-10,Ukraine,UA,224,5,44622516,1892,57
2020-04-11,Ukraine,UA,311,12,44622516,2203,69
2020-04-12,Ukraine,UA,308,4,44622516,2511,73
2020-04-13,Ukraine,UA,266,10,44622516,2777,83
2020-04-14,Ukraine,UA,325,10,44622516,3102,93
2020-04-15,Ukraine,UA,270,5,44622516,3372,98
2020-04-16,Ukraine,UA,789,18,44622516,4161,116
2020-04-17,Ukraine,UA,301,9,44622516,4462,125
2020-04-18,Ukraine,UA,644,8,44622516,5106,133
2020-04-19,Ukraine,UA,343,8,44622516,5449,141
2020-04-20,Ukraine,UA,261,10,44622516,5710,151
2020-04-21,Ukraine,UA,415,10,44622516,6125,161
2020-04-22,Ukraine,UA,467,13,44622516,6592,174
2020-04-23,Ukraine,UA,578,13,44622516,7170,187
2020-04-24,Ukraine,UA,477,6,44622516,7647,193
2020-04-25,Ukraine,UA,478,8,44622516,8125,201
2020-04-26,Ukraine,UA,492,8,44622516,8617,209
2020-04-27,Ukraine,UA,392,11,44622516,9009,220
2020-04-28,Ukraine,UA,0,0,44622516,9009,220
2020-04-29,Ukraine,UA,401,19,44622516,9410,239
2020-04-30,Ukraine,UA,456,11,44622516,9866,250
2020-05-01,Ukraine,UA,0,0,44622516,9866,250
2020-05-02,Ukraine,UA,1545,29,44622516,11411,279
2020-05-03,Ukraine,UA,0,0,44622516,11411,279
2020-03-22,Uganda,UG,1,0,42723139,1,0
2020-03-23,Uganda,UG,0,0,42723139,1,0
2020-03-24,Uganda,UG,8,0,42723139,9,0
2020-03-25,Uganda,UG,0,0,42723139,9,0
2020-03-26,Uganda,UG,5,0,42723139,14,0
2020-03-27,Uganda,UG,0,0,42723139,14,0
2020-03-28,Uganda,UG,0,0,42723139,14,0
2020-03-29,Uganda,UG,16,0,42723139,30,0
2020-03-30,Uganda,UG,3,0,42723139,33,0
2020-03-31,Uganda,UG,0,0,42723139,33,0
2020-04-01,Uganda,UG,11,0,42723139,44,0
2020-04-02,Uganda,UG,0,0,42723139,44,0
2020-04-03,Uganda,UG,1,0,42723139,45,0
2020-04-04,Uganda,UG,3,0,42723139,48,0
2020-04-05,Uganda,UG,0,0,42723139,48,0
2020-04-06,Uganda,UG,4,0,42723139,52,0
2020-04-07,Uganda,UG,0,0,42723139,52,0
2020-04-08,Uganda,UG,0,0,42723139,52,0
2020-04-09,Uganda,UG,1,0,42723139,53,0
2020-04-10,Uganda,UG,0,0,42723139,53,0
2020-04-11,Uganda,UG,0,0,42723139,53,0
2020-04-12,Uganda,UG,0,0,42723139,53,0
2020-04-13,Uganda,UG,1,0,42723139,54,0
2020-04-14,Uganda,UG,0,0,42723139,54,0
2020-04-15,Uganda,UG,1,0,42723139,55,0
2020-04-16,Uganda,UG,0,0,42723139,55,0
2020-04-17,Uganda,UG,0,0,42723139,55,0
2020-04-18,Uganda,UG,0,0,42723139,55,0
2020-04-19,Uganda,UG,0,0,42723139,55,0
2020-04-20,Uganda,UG,0,0,42723139,55,0
2020-04-21,Uganda,UG,1,0,42723139,56,0
2020-04-22,Uganda,UG,2,0,42723139,58,0
2020-04-23,Uganda,UG,3,0,42723139,61,0
2020-04-24,Uganda,UG,13,0,42723139,74,0
2020-04-25,Uganda,UG,1,0,42723139,75,0
2020-04-26,Uganda,UG,0,0,42723139,75,0
2020-04-27,Uganda,UG,4,0,42723139,79,0
2020-04-28,Uganda,UG,0,0,42723139,79,0
2020-04-29,Uganda,UG,0,0,42723139,79,0
2020-04-30,Uganda,UG,2,0,42723139,81,0
2020-05-01,Uganda,UG,2,0,42723139,83,0
2020-05-02,Uganda,UG,2,0,42723139,85,0
2020-05-03,Uganda,UG,3,0,42723139,88,0
2019-12-31,United_Kingdom,UK,0,0,66488991,0,0
2020-01-01,United_Kingdom,UK,0,0,66488991,0,0
2020-01-02,United_Kingdom,UK,0,0,66488991,0,0
2020-01-03,United_Kingdom,UK,0,0,66488991,0,0
2020-01-04,United_Kingdom,UK,0,0,66488991,0,0
2020-01-05,United_Kingdom,UK,0,0,66488991,0,0
2020-01-06,United_Kingdom,UK,0,0,66488991,0,0
2020-01-07,United_Kingdom,UK,0,0,66488991,0,0
2020-01-08,United_Kingdom,UK,0,0,66488991,0,0
2020-01-09,United_Kingdom,UK,0,0,66488991,0,0
2020-01-10,United_Kingdom,UK,0,0,66488991,0,0
2020-01-11,United_Kingdom,UK,0,0,66488991,0,0
2020-01-12,United_Kingdom,UK,0,0,66488991,0,0
2020-01-13,United_Kingdom,UK,0,0,66488991,0,0
2020-01-14,United_Kingdom,UK,0,0,66488991,0,0
2020-01-15,United_Kingdom,UK,0,0,66488991,0,0
2020-01-16,United_Kingdom,UK,0,0,66488991,0,0
2020-01-17,United_Kingdom,UK,0,0,66488991,0,0
2020-01-18,United_Kingdom,UK,0,0,66488991,0,0
2020-01-19,United_Kingdom,UK,0,0,66488991,0,0
2020-01-20,United_Kingdom,UK,0,0,66488991,0,0
2020-01-21,United_Kingdom,UK,0,0,66488991,0,0
2020-01-22,United_Kingdom,UK,0,0,66488991,0,0
2020-01-23,United_Kingdom,UK,0,0,66488991,0,0
2020-01-24,United_Kingdom,UK,0,0,66488991,0,0
2020-01-25,United_Kingdom,UK,0,0,66488991,0,0
2020-01-26,United_Kingdom,UK,0,0,66488991,0,0
2020-01-27,United_Kingdom,UK,0,0,66488991,0,0
2020-01-28,United_Kingdom,UK,0,0,66488991,0,0
2020-01-29,United_Kingdom,UK,0,0,66488991,0,0
2020-01-30,United_Kingdom,UK,0,0,66488991,0,0
2020-01-31,United_Kingdom,UK,2,0,66488991,2,0
2020-02-01,United_Kingdom,UK,0,0,66488991,2,0
2020-02-02,United_Kingdom,UK,0,0,66488991,2,0
2020-02-03,United_Kingdom,UK,0,0,66488991,2,0
2020-02-04,United_Kingdom,UK,0,0,66488991,2,0
2020-02-05,United_Kingdom,UK,0,0,66488991,2,0
2020-02-06,United_Kingdom,UK,0,0,66488991,2,0
2020-02-07,United_Kingdom,UK,1,0,66488991,3,0
2020-02-08,United_Kingdom,UK,0,0,66488991,3,0
2020-02-09,United_Kingdom,UK,1,0,66488991,4,0
2020-02-10,United_Kingdom,UK,0,0,66488991,4,0
2020-02-11,United_Kingdom,UK,4,0,66488991,8,0
2020-02-12,United_Kingdom,UK,0,0,66488991,8,0
2020-02-13,United_Kingdom,UK,1,0,66488991,9,0
2020-02-14,United_Kingdom,UK,0,0,66488991,9,0
2020-02-15,United_Kingdom,UK,0,0,66488991,9,0
2020-02-16,United_Kingdom,UK,0,0,66488991,9,0
2020-02-17,United_Kingdom,UK,0,0,66488991,9,0
2020-02-18,United_Kingdom,UK,0,0,66488991,9,0
2020-02-19,United_Kingdom,UK,0,0,66488991,9,0
2020-02-20,United_Kingdom,UK,0,0,66488991,9,0
2020-02-21,United_Kingdom,UK,0,0,66488991,9,0
2020-02-22,United_Kingdom,UK,0,0,66488991,9,0
2020-02-23,United_Kingdom,UK,0,0,66488991,9,0
2020-02-24,United_Kingdom,UK,4,0,66488991,13,0
2020-02-25,United_Kingdom,UK,0,0,66488991,13,0
2020-02-26,United_Kingdom,UK,0,0,66488991,13,0
2020-02-27,United_Kingdom,UK,0,0,66488991,13,0
2020-02-28,United_Kingdom,UK,3,0,66488991,16,0
2020-02-29,United_Kingdom,UK,2,0,66488991,18,0
2020-03-01,United_Kingdom,UK,5,0,66488991,23,0
2020-03-02,United_Kingdom,UK,13,0,66488991,36,0
2020-03-03,United_Kingdom,UK,4,0,66488991,40,0
2020-03-04,United_Kingdom,UK,11,0,66488991,51,0
2020-03-05,United_Kingdom,UK,34,0,66488991,85,0
2020-03-06,United_Kingdom,UK,30,0,66488991,115,0
2020-03-07,United_Kingdom,UK,48,1,66488991,163,1
2020-03-08,United_Kingdom,UK,43,1,66488991,206,2
2020-03-09,United_Kingdom,UK,67,0,66488991,273,2
2020-03-10,United_Kingdom,UK,48,1,66488991,321,3
2020-03-11,United_Kingdom,UK,52,4,66488991,373,7
2020-03-12,United_Kingdom,UK,83,0,66488991,456,7
2020-03-13,United_Kingdom,UK,134,2,66488991,590,9
2020-03-14,United_Kingdom,UK,117,1,66488991,707,10
2020-03-15,United_Kingdom,UK,433,18,66488991,1140,28
2020-03-16,United_Kingdom,UK,251,15,66488991,1391,43
2020-03-17,United_Kingdom,UK,152,22,66488991,1543,65
2020-03-18,United_Kingdom,UK,407,16,66488991,1950,81
2020-03-19,United_Kingdom,UK,680,34,66488991,2630,115
2020-03-20,United_Kingdom,UK,647,43,66488991,3277,158
2020-03-21,United_Kingdom,UK,706,36,66488991,3983,194
2020-03-22,United_Kingdom,UK,1035,56,66488991,5018,250
2020-03-23,United_Kingdom,UK,665,35,66488991,5683,285
2020-03-24,United_Kingdom,UK,967,74,66488991,6650,359
2020-03-25,United_Kingdom,UK,1427,149,66488991,8077,508
2020-03-26,United_Kingdom,UK,1452,186,66488991,9529,694
2020-03-27,United_Kingdom,UK,2129,183,66488991,11658,877
2020-03-28,United_Kingdom,UK,2885,284,66488991,14543,1161
2020-03-29,United_Kingdom,UK,2546,294,66488991,17089,1455
2020-03-30,United_Kingdom,UK,2433,214,66488991,19522,1669
2020-03-31,United_Kingdom,UK,2619,374,66488991,22141,2043
2020-04-01,United_Kingdom,UK,3009,382,66488991,25150,2425
2020-04-02,United_Kingdom,UK,4324,670,66488991,29474,3095
2020-04-03,United_Kingdom,UK,4244,652,66488991,33718,3747
2020-04-04,United_Kingdom,UK,4450,714,66488991,38168,4461
2020-04-05,United_Kingdom,UK,3735,760,66488991,41903,5221
2020-04-06,United_Kingdom,UK,5903,644,66488991,47806,5865
2020-04-07,United_Kingdom,UK,3802,568,66488991,51608,6433
2020-04-08,United_Kingdom,UK,3634,1038,66488991,55242,7471
2020-04-09,United_Kingdom,UK,5491,1034,66488991,60733,8505
2020-04-10,United_Kingdom,UK,4344,1103,66488991,65077,9608
2020-04-11,United_Kingdom,UK,5195,1152,66488991,70272,10760
2020-04-12,United_Kingdom,UK,8719,839,66488991,78991,11599
2020-04-13,United_Kingdom,UK,5288,686,66488991,84279,12285
2020-04-14,United_Kingdom,UK,4342,744,66488991,88621,13029
2020-04-15,United_Kingdom,UK,5252,1044,66488991,93873,14073
2020-04-16,United_Kingdom,UK,4603,842,66488991,98476,14915
2020-04-17,United_Kingdom,UK,4617,1029,66488991,103093,15944
2020-04-18,United_Kingdom,UK,5599,935,66488991,108692,16879
2020-04-19,United_Kingdom,UK,5525,1115,66488991,114217,17994
2020-04-20,United_Kingdom,UK,5850,498,66488991,120067,18492
2020-04-21,United_Kingdom,UK,4676,559,66488991,124743,19051
2020-04-22,United_Kingdom,UK,4301,1172,66488991,129044,20223
2020-04-23,United_Kingdom,UK,4451,837,66488991,133495,21060
2020-04-24,United_Kingdom,UK,4583,727,66488991,138078,21787
2020-04-25,United_Kingdom,UK,5386,1005,66488991,143464,22792
2020-04-26,United_Kingdom,UK,4913,843,66488991,148377,23635
2020-04-27,United_Kingdom,UK,4463,420,66488991,152840,24055
2020-04-28,United_Kingdom,UK,4309,338,66488991,157149,24393
2020-04-29,United_Kingdom,UK,3996,909,66488991,161145,25302
2020-04-30,United_Kingdom,UK,4076,795,66488991,165221,26097
2020-05-01,United_Kingdom,UK,6032,674,66488991,171253,26771
2020-05-02,United_Kingdom,UK,6201,739,66488991,177454,27510
2020-05-03,United_Kingdom,UK,4806,621,66488991,182260,28131
2019-12-31,United_States_of_America,US,0,0,327167434,0,0
2020-01-01,United_States_of_America,US,0,0,327167434,0,0
2020-01-02,United_States_of_America,US,0,0,327167434,0,0
2020-01-03,United_States_of_America,US,0,0,327167434,0,0
2020-01-04,United_States_of_America,US,0,0,327167434,0,0
2020-01-05,United_States_of_America,US,0,0,327167434,0,0
2020-01-06,United_States_of_America,US,0,0,327167434,0,0
2020-01-07,United_States_of_America,US,0,0,327167434,0,0
2020-01-08,United_States_of_America,US,0,0,327167434,0,0
2020-01-09,United_States_of_America,US,0,0,327167434,0,0
2020-01-10,United_States_of_America,US,0,0,327167434,0,0
2020-01-11,United_States_of_America,US,0,0,327167434,0,0
2020-01-12,United_States_of_America,US,0,0,327167434,0,0
2020-01-13,United_States_of_America,US,0,0,327167434,0,0
2020-01-14,United_States_of_America,US,0,0,327167434,0,0
2020-01-15,United_States_of_America,US,0,0,327167434,0,0
2020-01-16,United_States_of_America,US,0,0,327167434,0,0
2020-01-17,United_States_of_America,US,0,0,327167434,0,0
2020-01-18,United_States_of_America,US,0,0,327167434,0,0
2020-01-19,United_States_of_America,US,0,0,327167434,0,0
2020-01-20,United_States_of_America,US,0,0,327167434,0,0
2020-01-21,United_States_of_America,US,1,0,327167434,1,0
2020-01-22,United_States_of_America,US,0,0,327167434,1,0
2020-01-23,United_States_of_America,US,0,0,327167434,1,0
2020-01-24,United_States_of_America,US,0,0,327167434,1,0
2020-01-25,United_States_of_America,US,1,0,327167434,2,0
2020-01-26,United_States_of_America,US,0,0,327167434,2,0
2020-01-27,United_States_of_America,US,3,0,327167434,5,0
2020-01-28,United_States_of_America,US,0,0,327167434,5,0
2020-01-29,United_States_of_America,US,0,0,327167434,5,0
2020-01-30,United_States_of_America,US,0,0,327167434,5,0
2020-01-31,United_States_of_America,US,1,0,327167434,6,0
2020-02-01,United_States_of_America,US,1,0,327167434,7,0
2020-02-02,United_States_of_America,US,1,0,327167434,8,0
2020-02-03,United_States_of_America,US,3,0,327167434,11,0
2020-02-04,United_States_of_America,US,0,0,327167434,11,0
2020-02-05,United_States_of_America,US,0,0,327167434,11,0
2020-02-06,United_States_of_America,US,1,0,327167434,12,0
2020-02-07,United_States_of_America,US,0,0,327167434,12,0
2020-02-08,United_States_of_America,US,0,0,327167434,12,0
2020-02-09,United_States_of_America,US,0,0,327167434,12,0
2020-02-10,United_States_of_America,US,0,0,327167434,12,0
2020-02-11,United_States_of_America,US,1,0,327167434,13,0
2020-02-12,United_States_of_America,US,0,0,327167434,13,0
2020-02-13,United_States_of_America,US,1,0,327167434,14,0
2020-02-14,United_States_of_America,US,1,0,327167434,15,0
2020-02-15,United_States_of_America,US,0,0,327167434,15,0
2020-02-16,United_States_of_America,US,0,0,327167434,15,0
2020-02-17,United_States_of_America,US,0,0,327167434,15,0
2020-02-18,United_States_of_America,US,0,0,327167434,15,0
2020-02-19,United_States_of_America,US,0,0,327167434,15,0
2020-02-20,United_States_of_America,US,0,0,327167434,15,0
2020-02-21,United_States_of_America,US,1,0,327167434,16,0
2020-02-22,United_States_of_America,US,19,0,327167434,35,0
2020-02-23,United_States_of_America,US,0,0,327167434,35,0
2020-02-24,United_States_of_America,US,0,0,327167434,35,0
2020-02-25,United_States_of_America,US,18,0,327167434,53,0
2020-02-26,United_States_of_America,US,0,0,327167434,53,0
2020-02-27,United_States_of_America,US,6,0,327167434,59,0
2020-02-28,United_States_of_America,US,1,0,327167434,60,0
2020-02-29,United_States_of_America,US,6,0,327167434,66,0
2020-03-01,United_States_of_America,US,3,1,327167434,69,1
2020-03-02,United_States_of_America,US,20,1,327167434,89,2
2020-03-03,United_States_of_America,US,14,4,327167434,103,6
2020-03-04,United_States_of_America,US,22,3,327167434,125,9
2020-03-05,United_States_of_America,US,34,2,327167434,159,11
2020-03-06,United_States_of_America,US,74,1,327167434,233,12
2020-03-07,United_States_of_America,US,105,2,327167434,338,14
2020-03-08,United_States_of_America,US,95,3,327167434,433,17
2020-03-09,United_States_of_America,US,121,4,327167434,554,21
2020-03-10,United_States_of_America,US,200,5,327167434,754,26
2020-03-11,United_States_of_America,US,271,2,327167434,1025,28
2020-03-12,United_States_of_America,US,287,2,327167434,1312,30
2020-03-13,United_States_of_America,US,351,10,327167434,1663,40
2020-03-14,United_States_of_America,US,511,7,327167434,2174,47
2020-03-15,United_States_of_America,US,777,10,327167434,2951,57
2020-03-16,United_States_of_America,US,823,12,327167434,3774,69
2020-03-17,United_States_of_America,US,887,16,327167434,4661,85
2020-03-18,United_States_of_America,US,1766,23,327167434,6427,108
2020-03-19,United_States_of_America,US,2988,42,327167434,9415,150
2020-03-20,United_States_of_America,US,4835,0,327167434,14250,150
2020-03-21,United_States_of_America,US,5374,110,327167434,19624,260
2020-03-22,United_States_of_America,US,7123,80,327167434,26747,340
2020-03-23,United_States_of_America,US,8459,131,327167434,35206,471
2020-03-24,United_States_of_America,US,11236,119,327167434,46442,590
2020-03-25,United_States_of_America,US,8789,211,327167434,55231,801
2020-03-26,United_States_of_America,US,13963,249,327167434,69194,1050
2020-03-27,United_States_of_America,US,16797,246,327167434,85991,1296
2020-03-28,United_States_of_America,US,18695,411,327167434,104686,1707
2020-03-29,United_States_of_America,US,19979,484,327167434,124665,2191
2020-03-30,United_States_of_America,US,18360,318,327167434,143025,2509
2020-03-31,United_States_of_America,US,21595,661,327167434,164620,3170
2020-04-01,United_States_of_America,US,24998,909,327167434,189618,4079
2020-04-02,United_States_of_America,US,27103,1059,327167434,216721,5138
2020-04-03,United_States_of_America,US,28819,915,327167434,245540,6053
2020-04-04,United_States_of_America,US,32425,1104,327167434,277965,7157
2020-04-05,United_States_of_America,US,34272,1344,327167434,312237,8501
2020-04-06,United_States_of_America,US,25398,1146,327167434,337635,9647
2020-04-07,United_States_of_America,US,30561,1342,327167434,368196,10989
2020-04-08,United_States_of_America,US,30613,1906,327167434,398809,12895
2020-04-09,United_States_of_America,US,33323,1922,327167434,432132,14817
2020-04-10,United_States_of_America,US,33901,1873,327167434,466033,16690
2020-04-11,United_States_of_America,US,35527,2087,327167434,501560,18777
2020-04-12,United_States_of_America,US,28391,1831,327167434,529951,20608
2020-04-13,United_States_of_America,US,27620,1500,327167434,557571,22108
2020-04-14,United_States_of_America,US,25023,1541,327167434,582594,23649
2020-04-15,United_States_of_America,US,26922,2408,327167434,609516,26057
2020-04-16,United_States_of_America,US,30148,4928,327167434,639664,30985
2020-04-17,United_States_of_America,US,31667,2299,327167434,671331,33284
2020-04-18,United_States_of_America,US,30833,3770,327167434,702164,37054
2020-04-19,United_States_of_America,US,32922,1856,327167434,735086,38910
2020-04-20,United_States_of_America,US,24601,1772,327167434,759687,40682
2020-04-21,United_States_of_America,US,28065,1857,327167434,787752,42539
2020-04-22,United_States_of_America,US,37289,2524,327167434,825041,45063
2020-04-23,United_States_of_America,US,17588,1721,327167434,842629,46784
2020-04-24,United_States_of_America,US,26543,3179,327167434,869172,49963
2020-04-25,United_States_of_America,US,21352,1054,327167434,890524,51017
2020-04-26,United_States_of_America,US,48529,2172,327167434,939053,53189
2020-04-27,United_States_of_America,US,26857,1687,327167434,965910,54876
2020-04-28,United_States_of_America,US,22541,1369,327167434,988451,56245
2020-04-29,United_States_of_America,US,24132,2110,327167434,1012583,58355
2020-04-30,United_States_of_America,US,27326,2611,327167434,1039909,60966
2020-05-01,United_States_of_America,US,29917,2040,327167434,1069826,63006
2020-05-02,United_States_of_America,US,33955,2062,327167434,1103781,65068
2020-05-03,United_States_of_America,US,29288,1317,327167434,1133069,66385
2020-03-15,Uruguay,UY,6,0,3449299,6,0
2020-03-16,Uruguay,UY,2,0,3449299,8,0
2020-03-17,Uruguay,UY,21,0,3449299,29,0
2020-03-18,Uruguay,UY,21,0,3449299,50,0
2020-03-19,Uruguay,UY,29,0,3449299,79,0
2020-03-20,Uruguay,UY,15,0,3449299,94,0
2020-03-21,Uruguay,UY,16,0,3449299,110,0
2020-03-22,Uruguay,UY,25,0,3449299,135,0
2020-03-23,Uruguay,UY,23,0,3449299,158,0
2020-03-24,Uruguay,UY,4,0,3449299,162,0
2020-03-25,Uruguay,UY,27,0,3449299,189,0
2020-03-26,Uruguay,UY,28,0,3449299,217,0
2020-03-27,Uruguay,UY,21,0,3449299,238,0
2020-03-28,Uruguay,UY,0,0,3449299,238,0
2020-03-29,Uruguay,UY,21,0,3449299,259,0
2020-03-30,Uruguay,UY,36,1,3449299,295,1
2020-03-31,Uruguay,UY,29,0,3449299,324,1
2020-04-01,Uruguay,UY,6,0,3449299,330,1
2020-04-02,Uruguay,UY,11,1,3449299,341,2
2020-04-03,Uruguay,UY,18,2,3449299,359,4
2020-04-04,Uruguay,UY,12,0,3449299,371,4
2020-04-05,Uruguay,UY,19,1,3449299,390,5
2020-04-06,Uruguay,UY,17,1,3449299,407,6
2020-04-07,Uruguay,UY,4,0,3449299,411,6
2020-04-08,Uruguay,UY,6,1,3449299,417,7
2020-04-09,Uruguay,UY,9,0,3449299,426,7
2020-04-10,Uruguay,UY,7,0,3449299,433,7
2020-04-11,Uruguay,UY,13,0,3449299,446,7
2020-04-12,Uruguay,UY,7,0,3449299,453,7
2020-04-13,Uruguay,UY,12,1,3449299,465,8
2020-04-14,Uruguay,UY,7,0,3449299,472,8
2020-04-15,Uruguay,UY,11,0,3449299,483,8
2020-04-16,Uruguay,UY,10,1,3449299,493,9
2020-04-17,Uruguay,UY,9,0,3449299,502,9
2020-04-18,Uruguay,UY,6,0,3449299,508,9
2020-04-19,Uruguay,UY,9,0,3449299,517,9
2020-04-20,Uruguay,UY,11,1,3449299,528,10
2020-04-21,Uruguay,UY,7,0,3449299,535,10
2020-04-22,Uruguay,UY,8,2,3449299,543,12
2020-04-23,Uruguay,UY,6,0,3449299,549,12
2020-04-24,Uruguay,UY,8,0,3449299,557,12
2020-04-25,Uruguay,UY,6,0,3449299,563,12
2020-04-26,Uruguay,UY,33,2,3449299,596,14
2020-04-27,Uruguay,UY,10,1,3449299,606,15
2020-04-28,Uruguay,UY,14,0,3449299,620,15
2020-04-29,Uruguay,UY,5,0,3449299,625,15
2020-04-30,Uruguay,UY,5,0,3449299,630,15
2020-05-01,Uruguay,UY,13,2,3449299,643,17
2020-05-02,Uruguay,UY,5,0,3449299,648,17
2020-05-03,Uruguay,UY,4,0,3449299,652,17
2020-03-16,Uzbekistan,UZ,6,0,32955400,6,0
2020-03-17,Uzbekistan,UZ,2,0,32955400,8,0
2020-03-18,Uzbekistan,UZ,8,0,32955400,16,0
2020-03-19,Uzbekistan,UZ,7,0,32955400,23,0
2020-03-20,Uzbekistan,UZ,0,0,32955400,23,0
2020-03-21,Uzbekistan,UZ,10,0,32955400,33,0
2020-03-22,Uzbekistan,UZ,0,0,32955400,33,0
2020-03-23,Uzbekistan,UZ,13,0,32955400,46,0
2020-03-24,Uzbekistan,UZ,3,0,32955400,49,0
2020-03-25,Uzbekistan,UZ,6,0,32955400,55,0
2020-03-26,Uzbekistan,UZ,10,0,32955400,65,0
2020-03-27,Uzbekistan,UZ,18,0,32955400,83,0
2020-03-28,Uzbekistan,UZ,21,0,32955400,104,0
2020-03-29,Uzbekistan,UZ,29,1,32955400,133,1
2020-03-30,Uzbekistan,UZ,12,0,32955400,145,1
2020-03-31,Uzbekistan,UZ,4,1,32955400,149,2
2020-04-01,Uzbekistan,UZ,24,0,32955400,173,2
2020-04-02,Uzbekistan,UZ,14,0,32955400,187,2
2020-04-03,Uzbekistan,UZ,3,0,32955400,190,2
2020-04-04,Uzbekistan,UZ,37,0,32955400,227,2
2020-04-05,Uzbekistan,UZ,39,0,32955400,266,2
2020-04-06,Uzbekistan,UZ,76,0,32955400,342,2
2020-04-07,Uzbekistan,UZ,55,0,32955400,397,2
2020-04-08,Uzbekistan,UZ,107,0,32955400,504,2
2020-04-09,Uzbekistan,UZ,51,1,32955400,555,3
2020-04-10,Uzbekistan,UZ,27,0,32955400,582,3
2020-04-11,Uzbekistan,UZ,42,0,32955400,624,3
2020-04-12,Uzbekistan,UZ,172,1,32955400,796,4
2020-04-13,Uzbekistan,UZ,69,0,32955400,865,4
2020-04-14,Uzbekistan,UZ,133,0,32955400,998,4
2020-04-15,Uzbekistan,UZ,167,0,32955400,1165,4
2020-04-16,Uzbekistan,UZ,137,0,32955400,1302,4
2020-04-17,Uzbekistan,UZ,78,0,32955400,1380,4
2020-04-18,Uzbekistan,UZ,70,0,32955400,1450,4
2020-04-19,Uzbekistan,UZ,45,1,32955400,1495,5
2020-04-20,Uzbekistan,UZ,70,0,32955400,1565,5
2020-04-21,Uzbekistan,UZ,92,0,32955400,1657,5
2020-04-22,Uzbekistan,UZ,35,1,32955400,1692,6
2020-04-23,Uzbekistan,UZ,24,1,32955400,1716,7
2020-04-24,Uzbekistan,UZ,62,0,32955400,1778,7
2020-04-25,Uzbekistan,UZ,58,1,32955400,1836,8
2020-04-26,Uzbekistan,UZ,29,0,32955400,1865,8
2020-04-27,Uzbekistan,UZ,22,0,32955400,1887,8
2020-04-28,Uzbekistan,UZ,17,0,32955400,1904,8
2020-04-29,Uzbekistan,UZ,35,0,32955400,1939,8
2020-04-30,Uzbekistan,UZ,63,1,32955400,2002,9
2020-05-01,Uzbekistan,UZ,44,0,32955400,2046,9
2020-05-02,Uzbekistan,UZ,48,0,32955400,2094,9
2020-05-03,Uzbekistan,UZ,33,0,32955400,2127,9
2020-03-07,Holy_See,VA,1,0,1000,1,0
2020-03-16,Holy_See,VA,0,0,1000,1,0
2020-03-17,Holy_See,VA,0,0,1000,1,0
2020-03-18,Holy_See,VA,0,0,1000,1,0
2020-03-19,Holy_See,VA,0,0,1000,1,0
2020-03-20,Holy_See,VA,0,0,1000,1,0
2020-03-21,Holy_See,VA,0,0,1000,1,0
2020-03-22,Holy_See,VA,0,0,1000,1,0
2020-03-23,Holy_See,VA,0,0,1000,1,0
2020-03-24,Holy_See,VA,0,0,1000,1,0
2020-03-25,Holy_See,VA,0,0,1000,1,0
2020-03-26,Holy_See,VA,0,0,1000,1,0
2020-03-27,Holy_See,VA,4,0,1000,5,0
2020-03-28,Holy_See,VA,0,0,1000,5,0
2020-03-29,Holy_See,VA,1,0,1000,6,0
2020-03-30,Holy_See,VA,0,0,1000,6,0
2020-03-31,Holy_See,VA,0,0,1000,6,0
2020-04-01,Holy_See,VA,0,0,1000,6,0
2020-04-02,Holy_See,VA,0,0,1000,6,0
2020-04-03,Holy_See,VA,0,0,1000,6,0
2020-04-04,Holy_See,VA,1,0,1000,7,0
2020-04-05,Holy_See,VA,0,0,1000,7,0
2020-04-06,Holy_See,VA,0,0,1000,7,0
2020-04-07,Holy_See,VA,0,0,1000,7,0
2020-04-08,Holy_See,VA,0,0,1000,7,0
2020-04-09,Holy_See,VA,1,0,1000,8,0
2020-04-10,Holy_See,VA,0,0,1000,8,0
2020-04-11,Holy_See,VA,0,0,1000,8,0
2020-04-12,Holy_See,VA,0,0,1000,8,0
2020-04-13,Holy_See,VA,0,0,1000,8,0
2020-04-14,Holy_See,VA,0,0,1000,8,0
2020-04-15,Holy_See,VA,0,0,1000,8,0
2020-04-16,Holy_See,VA,0,0,1000,8,0
2020-04-17,Holy_See,VA,0,0,1000,8,0
2020-04-18,Holy_See,VA,0,0,1000,8,0
2020-04-19,Holy_See,VA,0,0,1000,8,0
2020-04-20,Holy_See,VA,0,0,1000,8,0
2020-04-21,Holy_See,VA,1,0,1000,9,0
2020-04-22,Holy_See,VA,0,0,1000,9,0
2020-04-23,Holy_See,VA,0,0,1000,9,0
2020-04-24,Holy_See,VA,0,0,1000,9,0
2020-04-25,Holy_See,VA,0,0,1000,9,0
2020-04-26,Holy_See,VA,0,0,1000,9,0
2020-04-27,Holy_See,VA,0,0,1000,9,0
2020-04-28,Holy_See,VA,0,0,1000,9,0
2020-04-29,Holy_See,VA,0,0,1000,9,0
2020-04-30,Holy_See,VA,1,0,1000,10,0
2020-05-01,Holy_See,VA,1,0,1000,11,0
2020-05-02,Holy_See,VA,0,0,1000,11,0
2020-05-03,Holy_See,VA,0,0,1000,11,0
2020-03-13,Saint_Vincent_and_the_Grenadines,VC,1,0,110210,1,0
2020-03-25,Saint_Vincent_and_the_Grenadines,VC,0,0,110210,1,0
2020-03-26,Saint_Vincent_and_the_Grenadines,VC,0,0,110210,1,0
2020-03-27,Saint_Vincent_and_the_Grenadines,VC,0,0,110210,1,0
2020-03-28,Saint_Vincent_and_the_Grenadines,VC,0,0,110210,1,0
2020-03-29,Saint_Vincent_and_the_Grenadines,VC,0,0,110210,1,0
2020-03-30,Saint_Vincent_and_the_Grenadines,VC,0,0,110210,1,0
2020-03-31,Saint_Vincent_and_the_Grenadines,VC,0,0,110210,1,0
2020-04-01,Saint_Vincent_and_the_Grenadines,VC,0,0,110210,1,0
2020-04-02,Saint_Vincent_and_the_Grenadines,VC,1,0,110210,2,0
2020-04-03,Saint_Vincent_and_the_Grenadines,VC,0,0,110210,2,0
2020-04-04,Saint_Vincent_and_the_Grenadines,VC,5,0,110210,7,0
2020-04-05,Saint_Vincent_and_the_Grenadines,VC,0,0,110210,7,0
2020-04-06,Saint_Vincent_and_the_Grenadines,VC,0,0,110210,7,0
2020-04-07,Saint_Vincent_and_the_Grenadines,VC,0,0,110210,7,0
2020-04-08,Saint_Vincent_and_the_Grenadines,VC,1,0,110210,8,0
2020-04-09,Saint_Vincent_and_the_Grenadines,VC,0,0,110210,8,0
2020-04-10,Saint_Vincent_and_the_Grenadines,VC,4,0,110210,12,0
2020-04-11,Saint_Vincent_and_the_Grenadines,VC,0,0,110210,12,0
2020-04-12,Saint_Vincent_and_the_Grenadines,VC,0,0,110210,12,0
2020-04-13,Saint_Vincent_and_the_Grenadines,VC,0,0,110210,12,0
2020-04-14,Saint_Vincent_and_the_Grenadines,VC,0,0,110210,12,0
2020-04-15,Saint_Vincent_and_the_Grenadines,VC,0,0,110210,12,0
2020-04-16,Saint_Vincent_and_the_Grenadines,VC,0,0,110210,12,0
2020-04-17,Saint_Vincent_and_the_Grenadines,VC,0,0,110210,12,0
2020-04-18,Saint_Vincent_and_the_Grenadines,VC,0,0,110210,12,0
2020-04-19,Saint_Vincent_and_the_Grenadines,VC,0,0,110210,12,0
2020-04-20,Saint_Vincent_and_the_Grenadines,VC,0,0,110210,12,0
2020-04-21,Saint_Vincent_and_the_Grenadines,VC,0,0,110210,12,0
2020-04-22,Saint_Vincent_and_the_Grenadines,VC,0,0,110210,12,0
2020-04-23,Saint_Vincent_and_the_Grenadines,VC,1,0,110210,13,0
2020-04-24,Saint_Vincent_and_the_Grenadines,VC,0,0,110210,13,0
2020-04-25,Saint_Vincent_and_the_Grenadines,VC,1,0,110210,14,0
2020-04-26,Saint_Vincent_and_the_Grenadines,VC,0,0,110210,14,0
2020-04-27,Saint_Vincent_and_the_Grenadines,VC,0,0,110210,14,0
2020-04-28,Saint_Vincent_and_the_Grenadines,VC,1,0,110210,15,0
2020-04-29,Saint_Vincent_and_the_Grenadines,VC,1,0,110210,16,0
2020-04-30,Saint_Vincent_and_the_Grenadines,VC,0,0,110210,16,0
2020-05-01,Saint_Vincent_and_the_Grenadines,VC,0,0,110210,16,0
2020-05-02,Saint_Vincent_and_the_Grenadines,VC,0,0,110210,16,0
2020-05-03,Saint_Vincent_and_the_Grenadines,VC,0,0,110210,16,0
2020-03-15,Venezuela,VE,10,0,28870195,10,0
2020-03-16,Venezuela,VE,5,0,28870195,15,0
2020-03-17,Venezuela,VE,18,0,28870195,33,0
2020-03-18,Venezuela,VE,0,0,28870195,33,0
2020-03-19,Venezuela,VE,0,0,28870195,33,0
2020-03-20,Venezuela,VE,0,0,28870195,33,0
2020-03-21,Venezuela,VE,3,0,28870195,36,0
2020-03-22,Venezuela,VE,0,0,28870195,36,0
2020-03-23,Venezuela,VE,0,0,28870195,36,0
2020-03-24,Venezuela,VE,48,0,28870195,84,0
2020-03-25,Venezuela,VE,7,0,28870195,91,0
2020-03-26,Venezuela,VE,15,0,28870195,106,0
2020-03-27,Venezuela,VE,1,1,28870195,107,1
2020-03-28,Venezuela,VE,12,0,28870195,119,1
2020-03-29,Venezuela,VE,0,0,28870195,119,1
2020-03-30,Venezuela,VE,0,0,28870195,119,1
2020-03-31,Venezuela,VE,16,2,28870195,135,3
2020-04-01,Venezuela,VE,0,0,28870195,135,3
2020-04-02,Venezuela,VE,8,0,28870195,143,3
2020-04-03,Venezuela,VE,1,0,28870195,144,3
2020-04-04,Venezuela,VE,0,0,28870195,144,3
2020-04-05,Venezuela,VE,0,2,28870195,144,5
2020-04-06,Venezuela,VE,4,0,28870195,148,5
2020-04-07,Venezuela,VE,11,0,28870195,159,5
2020-04-08,Venezuela,VE,7,2,28870195,166,7
2020-04-09,Venezuela,VE,1,1,28870195,167,8
2020-04-10,Venezuela,VE,4,1,28870195,171,9
2020-04-11,Venezuela,VE,4,0,28870195,175,9
2020-04-12,Venezuela,VE,0,0,28870195,175,9
2020-04-13,Venezuela,VE,6,0,28870195,181,9
2020-04-14,Venezuela,VE,8,0,28870195,189,9
2020-04-15,Venezuela,VE,4,0,28870195,193,9
2020-04-16,Venezuela,VE,4,0,28870195,197,9
2020-04-17,Venezuela,VE,7,0,28870195,204,9
2020-04-18,Venezuela,VE,23,0,28870195,227,9
2020-04-19,Venezuela,VE,0,0,28870195,227,9
2020-04-20,Venezuela,VE,29,0,28870195,256,9
2020-04-21,Venezuela,VE,0,0,28870195,256,9
2020-04-22,Venezuela,VE,29,1,28870195,285,10
2020-04-23,Venezuela,VE,3,0,28870195,288,10
2020-04-24,Venezuela,VE,10,0,28870195,298,10
2020-04-25,Venezuela,VE,20,0,28870195,318,10
2020-04-26,Venezuela,VE,5,0,28870195,323,10
2020-04-27,Venezuela,VE,2,0,28870195,325,10
2020-04-28,Venezuela,VE,4,0,28870195,329,10
2020-04-29,Venezuela,VE,0,0,28870195,329,10
2020-04-30,Venezuela,VE,2,0,28870195,331,10
2020-05-01,Venezuela,VE,2,0,28870195,333,10
2020-05-02,Venezuela,VE,2,0,28870195,335,10
2020-05-03,Venezuela,VE,10,0,28870195,345,10
2020-03-27,British_Virgin_Islands,VG,2,0,29802,2,0
2020-03-28,British_Virgin_Islands,VG,0,0,29802,2,0
2020-03-29,British_Virgin_Islands,VG,0,0,29802,2,0
2020-03-30,British_Virgin_Islands,VG,0,0,29802,2,0
2020-03-31,British_Virgin_Islands,VG,1,0,29802,3,0
2020-04-01,British_Virgin_Islands,VG,0,0,29802,3,0
2020-04-02,British_Virgin_Islands,VG,0,0,29802,3,0
2020-04-03,British_Virgin_Islands,VG,0,0,29802,3,0
2020-04-04,British_Virgin_Islands,VG,0,0,29802,3,0
2020-04-05,British_Virgin_Islands,VG,0,0,29802,3,0
2020-04-06,British_Virgin_Islands,VG,0,0,29802,3,0
2020-04-07,British_Virgin_Islands,VG,0,0,29802,3,0
2020-04-08,British_Virgin_Islands,VG,0,0,29802,3,0
2020-04-09,British_Virgin_Islands,VG,0,0,29802,3,0
2020-04-10,British_Virgin_Islands,VG,0,0,29802,3,0
2020-04-11,British_Virgin_Islands,VG,0,0,29802,3,0
2020-04-12,British_Virgin_Islands,VG,0,0,29802,3,0
2020-04-13,British_Virgin_Islands,VG,0,0,29802,3,0
2020-04-14,British_Virgin_Islands,VG,0,0,29802,3,0
2020-04-15,British_Virgin_Islands,VG,0,0,29802,3,0
2020-04-16,British_Virgin_Islands,VG,0,0,29802,3,0
2020-04-17,British_Virgin_Islands,VG,0,0,29802,3,0
2020-04-18,British_Virgin_Islands,VG,0,0,29802,3,0
2020-04-19,British_Virgin_Islands,VG,0,0,29802,3,0
2020-04-20,British_Virgin_Islands,VG,1,1,29802,4,1
2020-04-21,British_Virgin_Islands,VG,1,0,29802,5,1
2020-04-22,British_Virgin_Islands,VG,0,0,29802,5,1
2020-04-23,British_Virgin_Islands,VG,0,0,29802,5,1
2020-04-24,British_Virgin_Islands,VG,0,0,29802,5,1
2020-04-25,British_Virgin_Islands,VG,1,0,29802,6,1
2020-04-26,British_Virgin_Islands,VG,0,0,29802,6,1
2020-04-27,British_Virgin_Islands,VG,0,0,29802,6,1
2020-04-28,British_Virgin_Islands,VG,0,0,29802,6,1
2020-04-29,British_Virgin_Islands,VG,0,0,29802,6,1
2020-04-30,British_Virgin_Islands,VG,0,0,29802,6,1
2020-05-01,British_Virgin_Islands,VG,0,0,29802,6,1
2020-05-02,British_Virgin_Islands,VG,0,0,29802,6,1
2020-05-03,British_Virgin_Islands,VG,0,0,29802,6,1
2020-03-24,United_States_Virgin_Islands,VI,17,0,106977,17,0
2020-03-25,United_States_Virgin_Islands,VI,0,0,106977,17,0
2020-03-26,United_States_Virgin_Islands,VI,0,0,106977,17,0
2020-03-27,United_States_Virgin_Islands,VI,0,0,106977,17,0
2020-03-28,United_States_Virgin_Islands,VI,2,0,106977,19,0
2020-03-29,United_States_Virgin_Islands,VI,3,0,106977,22,0
2020-03-30,United_States_Virgin_Islands,VI,8,0,106977,30,0
2020-04-01,United_States_Virgin_Islands,VI,0,0,106977,30,0
2020-04-02,United_States_Virgin_Islands,VI,0,0,106977,30,0
2020-04-03,United_States_Virgin_Islands,VI,3,0,106977,33,0
2020-04-04,United_States_Virgin_Islands,VI,7,0,106977,40,0
2020-04-05,United_States_Virgin_Islands,VI,0,0,106977,40,0
2020-04-06,United_States_Virgin_Islands,VI,2,1,106977,42,1
2020-04-07,United_States_Virgin_Islands,VI,0,0,106977,42,1
2020-04-08,United_States_Virgin_Islands,VI,3,0,106977,45,1
2020-04-09,United_States_Virgin_Islands,VI,0,0,106977,45,1
2020-04-10,United_States_Virgin_Islands,VI,5,0,106977,50,1
2020-04-11,United_States_Virgin_Islands,VI,0,0,106977,50,1
2020-04-12,United_States_Virgin_Islands,VI,1,0,106977,51,1
2020-04-13,United_States_Virgin_Islands,VI,0,0,106977,51,1
2020-04-14,United_States_Virgin_Islands,VI,0,0,106977,51,1
2020-04-15,United_States_Virgin_Islands,VI,0,0,106977,51,1
2020-04-16,United_States_Virgin_Islands,VI,0,0,106977,51,1
2020-04-17,United_States_Virgin_Islands,VI,0,0,106977,51,1
2020-04-18,United_States_Virgin_Islands,VI,0,1,106977,51,2
2020-04-19,United_States_Virgin_Islands,VI,2,1,106977,53,3
2020-04-20,United_States_Virgin_Islands,VI,0,0,106977,53,3
2020-04-21,United_States_Virgin_Islands,VI,1,0,106977,54,3
2020-04-22,United_States_Virgin_Islands,VI,0,0,106977,54,3
2020-04-23,United_States_Virgin_Islands,VI,0,0,106977,54,3
2020-04-24,United_States_Virgin_Islands,VI,0,0,106977,54,3
2020-04-25,United_States_Virgin_Islands,VI,0,0,106977,54,3
2020-04-26,United_States_Virgin_Islands,VI,1,0,106977,55,3
2020-04-27,United_States_Virgin_Islands,VI,0,0,106977,55,3
2020-04-28,United_States_Virgin_Islands,VI,4,1,106977,59,4
2020-04-29,United_States_Virgin_Islands,VI,0,0,106977,59,4
2020-04-30,United_States_Virgin_Islands,VI,7,0,106977,66,4
2020-05-01,United_States_Virgin_Islands,VI,0,0,106977,66,4
2020-05-02,United_States_Virgin_Islands,VI,0,0,106977,66,4
2020-05-03,United_States_Virgin_Islands,VI,0,0,106977,66,4
2019-12-31,Vietnam,VN,0,0,95540395,0,0
2020-01-01,Vietnam,VN,0,0,95540395,0,0
2020-01-02,Vietnam,VN,0,0,95540395,0,0
2020-01-03,Vietnam,VN,0,0,95540395,0,0
2020-01-04,Vietnam,VN,0,0,95540395,0,0
2020-01-05,Vietnam,VN,0,0,95540395,0,0
2020-01-06,Vietnam,VN,0,0,95540395,0,0
2020-01-07,Vietnam,VN,0,0,95540395,0,0
2020-01-08,Vietnam,VN,0,0,95540395,0,0
2020-01-09,Vietnam,VN,0,0,95540395,0,0
2020-01-10,Vietnam,VN,0,0,95540395,0,0
2020-01-11,Vietnam,VN,0,0,95540395,0,0
2020-01-12,Vietnam,VN,0,0,95540395,0,0
2020-01-13,Vietnam,VN,0,0,95540395,0,0
2020-01-14,Vietnam,VN,0,0,95540395,0,0
2020-01-15,Vietnam,VN,0,0,95540395,0,0
2020-01-16,Vietnam,VN,0,0,95540395,0,0
2020-01-17,Vietnam,VN,0,0,95540395,0,0
2020-01-18,Vietnam,VN,0,0,95540395,0,0
2020-01-19,Vietnam,VN,0,0,95540395,0,0
2020-01-20,Vietnam,VN,0,0,95540395,0,0
2020-01-21,Vietnam,VN,0,0,95540395,0,0
2020-01-22,Vietnam,VN,0,0,95540395,0,0
2020-01-23,Vietnam,VN,0,0,95540395,0,0
2020-01-24,Vietnam,VN,2,0,95540395,2,0
2020-01-25,Vietnam,VN,0,0,95540395,2,0
2020-01-26,Vietnam,VN,0,0,95540395,2,0
2020-01-27,Vietnam,VN,0,0,95540395,2,0
2020-01-28,Vietnam,VN,0,0,95540395,2,0
2020-01-29,Vietnam,VN,0,0,95540395,2,0
2020-01-30,Vietnam,VN,0,0,95540395,2,0
2020-01-31,Vietnam,VN,3,0,95540395,5,0
2020-02-01,Vietnam,VN,0,0,95540395,5,0
2020-02-02,Vietnam,VN,2,0,95540395,7,0
2020-02-03,Vietnam,VN,1,0,95540395,8,0
2020-02-04,Vietnam,VN,1,0,95540395,9,0
2020-02-05,Vietnam,VN,1,0,95540395,10,0
2020-02-06,Vietnam,VN,0,0,95540395,10,0
2020-02-07,Vietnam,VN,2,0,95540395,12,0
2020-02-08,Vietnam,VN,1,0,95540395,13,0
2020-02-09,Vietnam,VN,1,0,95540395,14,0
2020-02-10,Vietnam,VN,0,0,95540395,14,0
2020-02-11,Vietnam,VN,1,0,95540395,15,0
2020-02-12,Vietnam,VN,0,0,95540395,15,0
2020-02-13,Vietnam,VN,1,0,95540395,16,0
2020-02-14,Vietnam,VN,0,0,95540395,16,0
2020-02-15,Vietnam,VN,0,0,95540395,16,0
2020-02-16,Vietnam,VN,0,0,95540395,16,0
2020-02-17,Vietnam,VN,0,0,95540395,16,0
2020-02-18,Vietnam,VN,0,0,95540395,16,0
2020-02-19,Vietnam,VN,0,0,95540395,16,0
2020-02-20,Vietnam,VN,0,0,95540395,16,0
2020-02-21,Vietnam,VN,0,0,95540395,16,0
2020-02-22,Vietnam,VN,0,0,95540395,16,0
2020-02-23,Vietnam,VN,0,0,95540395,16,0
2020-02-24,Vietnam,VN,0,0,95540395,16,0
2020-02-25,Vietnam,VN,0,0,95540395,16,0
2020-02-26,Vietnam,VN,0,0,95540395,16,0
2020-02-27,Vietnam,VN,0,0,95540395,16,0
2020-02-28,Vietnam,VN,0,0,95540395,16,0
2020-02-29,Vietnam,VN,0,0,95540395,16,0
2020-03-01,Vietnam,VN,0,0,95540395,16,0
2020-03-02,Vietnam,VN,0,0,95540395,16,0
2020-03-07,Vietnam,VN,1,0,95540395,17,0
2020-03-08,Vietnam,VN,4,0,95540395,21,0
2020-03-09,Vietnam,VN,9,0,95540395,30,0
2020-03-10,Vietnam,VN,4,0,95540395,34,0
2020-03-11,Vietnam,VN,4,0,95540395,38,0
2020-03-12,Vietnam,VN,1,0,95540395,39,0
2020-03-13,Vietnam,VN,5,0,95540395,44,0
2020-03-14,Vietnam,VN,9,0,95540395,53,0
2020-03-15,Vietnam,VN,0,0,95540395,53,0
2020-03-16,Vietnam,VN,4,0,95540395,57,0
2020-03-17,Vietnam,VN,4,0,95540395,61,0
2020-03-18,Vietnam,VN,7,0,95540395,68,0
2020-03-19,Vietnam,VN,8,0,95540395,76,0
2020-03-20,Vietnam,VN,11,0,95540395,87,0
2020-03-21,Vietnam,VN,1,0,95540395,88,0
2020-03-22,Vietnam,VN,7,0,95540395,95,0
2020-03-23,Vietnam,VN,26,0,95540395,121,0
2020-03-24,Vietnam,VN,11,0,95540395,132,0
2020-03-25,Vietnam,VN,5,0,95540395,137,0
2020-03-26,Vietnam,VN,16,0,95540395,153,0
2020-03-27,Vietnam,VN,10,0,95540395,163,0
2020-03-28,Vietnam,VN,8,0,95540395,171,0
2020-03-29,Vietnam,VN,17,0,95540395,188,0
2020-03-30,Vietnam,VN,15,0,95540395,203,0
2020-03-31,Vietnam,VN,3,0,95540395,206,0
2020-04-01,Vietnam,VN,6,0,95540395,212,0
2020-04-02,Vietnam,VN,21,0,95540395,233,0
2020-04-03,Vietnam,VN,3,0,95540395,236,0
2020-04-04,Vietnam,VN,4,0,95540395,240,0
2020-04-05,Vietnam,VN,1,0,95540395,241,0
2020-04-06,Vietnam,VN,4,0,95540395,245,0
2020-04-07,Vietnam,VN,6,0,95540395,251,0
2020-04-08,Vietnam,VN,0,0,95540395,251,0
2020-04-09,Vietnam,VN,4,0,95540395,255,0
2020-04-10,Vietnam,VN,2,0,95540395,257,0
2020-04-11,Vietnam,VN,1,0,95540395,258,0
2020-04-12,Vietnam,VN,4,0,95540395,262,0
2020-04-13,Vietnam,VN,2,0,95540395,264,0
2020-04-14,Vietnam,VN,3,0,95540395,267,0
2020-04-15,Vietnam,VN,1,0,95540395,268,0
2020-04-16,Vietnam,VN,0,0,95540395,268,0
2020-04-17,Vietnam,VN,0,0,95540395,268,0
2020-04-18,Vietnam,VN,0,0,95540395,268,0
2020-04-19,Vietnam,VN,0,0,95540395,268,0
2020-04-20,Vietnam,VN,0,0,95540395,268,0
2020-04-21,Vietnam,VN,0,0,95540395,268,0
2020-04-22,Vietnam,VN,0,0,95540395,268,0
2020-04-23,Vietnam,VN,0,0,95540395,268,0
2020-04-24,Vietnam,VN,2,0,95540395,270,0
2020-04-25,Vietnam,VN,0,0,95540395,270,0
2020-04-26,Vietnam,VN,0,0,95540395,270,0
2020-04-27,Vietnam,VN,0,0,95540395,270,0
2020-04-28,Vietnam,VN,0,0,95540395,270,0
2020-04-29,Vietnam,VN,0,0,95540395,270,0
2020-04-30,Vietnam,VN,0,0,95540395,270,0
2020-05-01,Vietnam,VN,0,0,95540395,270,0
2020-05-02,Vietnam,VN,0,0,95540395,270,0
2020-05-03,Vietnam,VN,0,0,95540395,270,0
2020-03-16,Kosovo,XK,2,0,1845300,2,0
2020-03-17,Kosovo,XK,0,0,1845300,2,0
2020-03-18,Kosovo,XK,17,0,1845300,19,0
2020-03-19,Kosovo,XK,0,0,1845300,19,0
2020-03-20,Kosovo,XK,2,0,1845300,21,0
2020-03-21,Kosovo,XK,3,0,1845300,24,0
2020-03-22,Kosovo,XK,0,0,1845300,24,0
2020-03-23,Kosovo,XK,7,1,1845300,31,1
2020-03-24,Kosovo,XK,30,0,1845300,61,1
2020-03-25,Kosovo,XK,2,0,1845300,63,1
2020-03-26,Kosovo,XK,8,0,1845300,71,1
2020-03-27,Kosovo,XK,8,0,1845300,79,1
2020-03-28,Kosovo,XK,7,0,1845300,86,1
2020-03-29,Kosovo,XK,2,0,1845300,88,1
2020-03-30,Kosovo,XK,3,0,1845300,91,1
2020-03-31,Kosovo,XK,15,0,1845300,106,1
2020-04-01,Kosovo,XK,6,0,1845300,112,1
2020-04-02,Kosovo,XK,0,0,1845300,112,1
2020-04-03,Kosovo,XK,13,0,1845300,125,1
2020-04-04,Kosovo,XK,1,0,1845300,126,1
2020-04-05,Kosovo,XK,6,0,1845300,132,1
2020-04-06,Kosovo,XK,8,0,1845300,140,1
2020-04-07,Kosovo,XK,5,2,1845300,145,3
2020-04-08,Kosovo,XK,39,2,1845300,184,5
2020-04-09,Kosovo,XK,0,0,1845300,184,5
2020-04-10,Kosovo,XK,43,2,1845300,227,7
2020-04-11,Kosovo,XK,23,0,1845300,250,7
2020-04-12,Kosovo,XK,33,0,1845300,283,7
2020-04-13,Kosovo,XK,79,0,1845300,362,7
2020-04-14,Kosovo,XK,15,1,1845300,377,8
2020-04-15,Kosovo,XK,10,0,1845300,387,8
2020-04-16,Kosovo,XK,36,1,1845300,423,9
2020-04-17,Kosovo,XK,26,2,1845300,449,11
2020-04-18,Kosovo,XK,31,1,1845300,480,12
2020-04-19,Kosovo,XK,30,0,1845300,510,12
2020-04-20,Kosovo,XK,0,0,1845300,510,12
2020-04-21,Kosovo,XK,88,3,1845300,598,15
2020-04-22,Kosovo,XK,6,3,1845300,604,18
2020-04-23,Kosovo,XK,26,0,1845300,630,18
2020-04-24,Kosovo,XK,39,1,1845300,669,19
2020-04-25,Kosovo,XK,34,0,1845300,703,19
2020-04-26,Kosovo,XK,28,1,1845300,731,20
2020-04-27,Kosovo,XK,32,1,1845300,763,21
2020-04-28,Kosovo,XK,17,1,1845300,780,22
2020-04-29,Kosovo,XK,10,0,1845300,790,22
2020-04-30,Kosovo,XK,9,0,1845300,799,22
2020-05-01,Kosovo,XK,0,0,1845300,799,22
2020-05-02,Kosovo,XK,14,0,1845300,813,22
2020-05-03,Kosovo,XK,10,0,1845300,823,22
2020-04-10,Yemen,YE,1,0,28498687,1,0
2020-04-11,Yemen,YE,0,0,28498687,1,0
2020-04-12,Yemen,YE,0,0,28498687,1,0
2020-04-13,Yemen,YE,0,0,28498687,1,0
2020-04-14,Yemen,YE,0,0,28498687,1,0
2020-04-15,Yemen,YE,0,0,28498687,1,0
2020-04-16,Yemen,YE,0,0,28498687,1,0
2020-04-17,Yemen,YE,0,0,28498687,1,0
2020-04-18,Yemen,YE,0,0,28498687,1,0
2020-04-19,Yemen,YE,0,0,28498687,1,0
2020-04-20,Yemen,YE,0,0,28498687,1,0
2020-04-21,Yemen,YE,0,0,28498687,1,0
2020-04-22,Yemen,YE,0,0,28498687,1,0
2020-04-23,Yemen,YE,0,0,28498687,1,0
2020-04-24,Yemen,YE,0,0,28498687,1,0
2020-04-25,Yemen,YE,0,0,28498687,1,0
2020-04-26,Yemen,YE,0,0,28498687,1,0
2020-04-27,Yemen,YE,0,0,28498687,1,0
2020-04-28,Yemen,YE,0,0,28498687,1,0
2020-04-29,Yemen,YE,0,0,28498687,1,0
2020-04-30,Yemen,YE,5,0,28498687,6,0
2020-05-01,Yemen,YE,0,2,28498687,6,2
2020-05-02,Yemen,YE,1,0,28498687,7,2
2020-05-03,Yemen,YE,3,0,28498687,10,2
2020-03-06,South_Africa,ZA,1,0,57779622,1,0
2020-03-08,South_Africa,ZA,1,0,57779622,2,0
2020-03-09,South_Africa,ZA,1,0,57779622,3,0
2020-03-10,South_Africa,ZA,4,0,57779622,7,0
2020-03-12,South_Africa,ZA,6,0,57779622,13,0
2020-03-13,South_Africa,ZA,4,0,57779622,17,0
2020-03-14,South_Africa,ZA,7,0,57779622,24,0
2020-03-15,South_Africa,ZA,0,0,57779622,24,0
2020-03-16,South_Africa,ZA,27,0,57779622,51,0
2020-03-17,South_Africa,ZA,11,0,57779622,62,0
2020-03-18,South_Africa,ZA,23,0,57779622,85,0
2020-03-19,South_Africa,ZA,31,0,57779622,116,0
2020-03-20,South_Africa,ZA,34,0,57779622,150,0
2020-03-21,South_Africa,ZA,55,0,57779622,205,0
2020-03-22,South_Africa,ZA,35,0,57779622,240,0
2020-03-23,South_Africa,ZA,34,0,57779622,274,0
2020-03-24,South_Africa,ZA,128,0,57779622,402,0
2020-03-25,South_Africa,ZA,155,0,57779622,557,0
2020-03-26,South_Africa,ZA,152,0,57779622,709,0
2020-03-27,South_Africa,ZA,218,2,57779622,927,2
2020-03-28,South_Africa,ZA,243,0,57779622,1170,2
2020-03-29,South_Africa,ZA,17,0,57779622,1187,2
2020-03-30,South_Africa,ZA,93,0,57779622,1280,2
2020-03-31,South_Africa,ZA,46,1,57779622,1326,3
2020-04-01,South_Africa,ZA,27,2,57779622,1353,5
2020-04-02,South_Africa,ZA,27,0,57779622,1380,5
2020-04-03,South_Africa,ZA,82,0,57779622,1462,5
2020-04-04,South_Africa,ZA,43,2,57779622,1505,7
2020-04-05,South_Africa,ZA,80,2,57779622,1585,9
2020-04-06,South_Africa,ZA,70,2,57779622,1655,11
2020-04-07,South_Africa,ZA,31,1,57779622,1686,12
2020-04-08,South_Africa,ZA,63,1,57779622,1749,13
2020-04-09,South_Africa,ZA,96,5,57779622,1845,18
2020-04-10,South_Africa,ZA,89,0,57779622,1934,18
2020-04-11,South_Africa,ZA,69,6,57779622,2003,24
2020-04-12,South_Africa,ZA,25,1,57779622,2028,25
2020-04-13,South_Africa,ZA,145,0,57779622,2173,25
2020-04-14,South_Africa,ZA,99,2,57779622,2272,27
2020-04-15,South_Africa,ZA,143,0,57779622,2415,27
2020-04-16,South_Africa,ZA,91,7,57779622,2506,34
2020-04-17,South_Africa,ZA,99,14,57779622,2605,48
2020-04-18,South_Africa,ZA,178,2,57779622,2783,50
2020-04-19,South_Africa,ZA,251,2,57779622,3034,52
2020-04-20,South_Africa,ZA,124,2,57779622,3158,54
2020-04-21,South_Africa,ZA,142,4,57779622,3300,58
2020-04-22,South_Africa,ZA,165,0,57779622,3465,58
2020-04-23,South_Africa,ZA,170,7,57779622,3635,65
2020-04-24,South_Africa,ZA,318,10,57779622,3953,75
2020-04-25,South_Africa,ZA,267,4,57779622,4220,79
2020-04-26,South_Africa,ZA,141,7,57779622,4361,86
2020-04-27,South_Africa,ZA,185,1,57779622,4546,87
2020-04-28,South_Africa,ZA,247,3,57779622,4793,90
2020-04-29,South_Africa,ZA,203,3,57779622,4996,93
2020-04-30,South_Africa,ZA,354,10,57779622,5350,103
2020-05-01,South_Africa,ZA,297,0,57779622,5647,103
2020-05-02,South_Africa,ZA,304,13,57779622,5951,116
2020-05-03,South_Africa,ZA,385,7,57779622,6336,123
2020-03-19,Zambia,ZM,2,0,17351822,2,0
2020-03-20,Zambia,ZM,0,0,17351822,2,0
2020-03-21,Zambia,ZM,0,0,17351822,2,0
2020-03-22,Zambia,ZM,0,0,17351822,2,0
2020-03-23,Zambia,ZM,1,0,17351822,3,0
2020-03-24,Zambia,ZM,0,0,17351822,3,0
2020-03-25,Zambia,ZM,0,0,17351822,3,0
2020-03-26,Zambia,ZM,9,0,17351822,12,0
2020-03-27,Zambia,ZM,2,0,17351822,14,0
2020-03-28,Zambia,ZM,2,0,17351822,16,0
2020-03-29,Zambia,ZM,12,0,17351822,28,0
2020-03-30,Zambia,ZM,1,0,17351822,29,0
2020-03-31,Zambia,ZM,6,0,17351822,35,0
2020-04-01,Zambia,ZM,0,0,17351822,35,0
2020-04-02,Zambia,ZM,1,0,17351822,36,0
2020-04-03,Zambia,ZM,3,1,17351822,39,1
2020-04-04,Zambia,ZM,0,0,17351822,39,1
2020-04-05,Zambia,ZM,0,0,17351822,39,1
2020-04-06,Zambia,ZM,0,0,17351822,39,1
2020-04-07,Zambia,ZM,0,0,17351822,39,1
2020-04-08,Zambia,ZM,0,0,17351822,39,1
2020-04-09,Zambia,ZM,0,0,17351822,39,1
2020-04-10,Zambia,ZM,0,0,17351822,39,1
2020-04-11,Zambia,ZM,1,1,17351822,40,2
2020-04-12,Zambia,ZM,0,0,17351822,40,2
2020-04-13,Zambia,ZM,3,0,17351822,43,2
2020-04-14,Zambia,ZM,2,0,17351822,45,2
2020-04-15,Zambia,ZM,0,0,17351822,45,2
2020-04-16,Zambia,ZM,3,0,17351822,48,2
2020-04-17,Zambia,ZM,0,0,17351822,48,2
2020-04-18,Zambia,ZM,4,0,17351822,52,2
2020-04-19,Zambia,ZM,5,0,17351822,57,2
2020-04-20,Zambia,ZM,4,1,17351822,61,3
2020-04-21,Zambia,ZM,4,0,17351822,65,3
2020-04-22,Zambia,ZM,0,0,17351822,65,3
2020-04-23,Zambia,ZM,9,0,17351822,74,3
2020-04-24,Zambia,ZM,2,0,17351822,76,3
2020-04-25,Zambia,ZM,8,0,17351822,84,3
2020-04-26,Zambia,ZM,0,0,17351822,84,3
2020-04-27,Zambia,ZM,4,0,17351822,88,3
2020-04-28,Zambia,ZM,1,0,17351822,89,3
2020-04-29,Zambia,ZM,6,0,17351822,95,3
2020-04-30,Zambia,ZM,2,0,17351822,97,3
2020-05-01,Zambia,ZM,9,0,17351822,106,3
2020-05-02,Zambia,ZM,3,0,17351822,109,3
2020-05-03,Zambia,ZM,10,0,17351822,119,3
2020-03-21,Zimbabwe,ZW,1,0,14439018,1,0
2020-03-22,Zimbabwe,ZW,1,0,14439018,2,0
2020-03-23,Zimbabwe,ZW,0,0,14439018,2,0
2020-03-24,Zimbabwe,ZW,0,1,14439018,2,1
2020-03-25,Zimbabwe,ZW,0,0,14439018,2,1
2020-03-26,Zimbabwe,ZW,1,0,14439018,3,1
2020-03-27,Zimbabwe,ZW,0,0,14439018,3,1
2020-03-28,Zimbabwe,ZW,2,0,14439018,5,1
2020-03-29,Zimbabwe,ZW,2,0,14439018,7,1
2020-03-30,Zimbabwe,ZW,0,0,14439018,7,1
2020-03-31,Zimbabwe,ZW,0,0,14439018,7,1
2020-04-01,Zimbabwe,ZW,1,0,14439018,8,1
2020-04-02,Zimbabwe,ZW,0,0,14439018,8,1
2020-04-03,Zimbabwe,ZW,0,0,14439018,8,1
2020-04-04,Zimbabwe,ZW,1,0,14439018,9,1
2020-04-05,Zimbabwe,ZW,0,0,14439018,9,1
2020-04-06,Zimbabwe,ZW,0,0,14439018,9,1
2020-04-07,Zimbabwe,ZW,0,0,14439018,9,1
2020-04-08,Zimbabwe,ZW,1,0,14439018,10,1
2020-04-09,Zimbabwe,ZW,1,1,14439018,11,2
2020-04-10,Zimbabwe,ZW,0,1,14439018,11,3
2020-04-11,Zimbabwe,ZW,0,0,14439018,11,3
2020-04-12,Zimbabwe,ZW,3,0,14439018,14,3
2020-04-13,Zimbabwe,ZW,0,0,14439018,14,3
2020-04-14,Zimbabwe,ZW,3,0,14439018,17,3
2020-04-15,Zimbabwe,ZW,0,0,14439018,17,3
2020-04-16,Zimbabwe,ZW,6,0,14439018,23,3
2020-04-17,Zimbabwe,ZW,1,0,14439018,24,3
2020-04-18,Zimbabwe,ZW,0,0,14439018,24,3
2020-04-19,Zimbabwe,ZW,1,0,14439018,25,3
2020-04-20,Zimbabwe,ZW,0,0,14439018,25,3
2020-04-21,Zimbabwe,ZW,0,0,14439018,25,3
2020-04-22,Zimbabwe,ZW,3,0,14439018,28,3
2020-04-23,Zimbabwe,ZW,0,0,14439018,28,3
2020-04-24,Zimbabwe,ZW,1,0,14439018,29,3
2020-04-25,Zimbabwe,ZW,0,1,14439018,29,4
2020-04-26,Zimbabwe,ZW,2,0,14439018,31,4
2020-04-27,Zimbabwe,ZW,0,0,14439018,31,4
2020-04-28,Zimbabwe,ZW,1,0,14439018,32,4
2020-04-29,Zimbabwe,ZW,0,0,14439018,32,4
2020-04-30,Zimbabwe,ZW,2,0,14439018,34,4
2020-05-01,Zimbabwe,ZW,0,0,14439018,34,4
2020-05-02,Zimbabwe,ZW,0,0,14439018,34,4
2020-05-03,Zimbabwe,ZW,0,0,14439018,34,4
2019-12-31,World,WW,27,0,5716034541,27,0
2020-01-01,World,WW,0,0,5716034541,27,0
2020-01-02,World,WW,0,0,5716034541,27,0
2020-01-03,World,WW,17,0,5716034541,44,0
2020-01-04,World,WW,0,0,5716034541,44,0
2020-01-05,World,WW,15,0,5716034541,59,0
2020-01-06,World,WW,0,0,5716034541,59,0
2020-01-07,World,WW,0,0,5716034541,59,0
2020-01-08,World,WW,0,0,5716034541,59,0
2020-01-09,World,WW,0,0,5716034541,59,0
2020-01-10,World,WW,0,0,5716034541,59,0
2020-01-11,World,WW,0,1,5716034541,59,1
2020-01-12,World,WW,0,0,5716034541,59,1
2020-01-13,World,WW,1,0,5716034541,60,1
2020-01-14,World,WW,0,0,5716034541,60,1
2020-01-15,World,WW,1,1,5716034541,61,2
2020-01-16,World,WW,0,0,5716034541,61,2
2020-01-17,World,WW,5,0,5716034541,66,2
2020-01-18,World,WW,17,0,5716034541,83,2
2020-01-19,World,WW,136,1,5716034541,219,3
2020-01-20,World,WW,20,0,5716034541,239,3
2020-01-21,World,WW,153,3,5716034541,392,6
2020-01-22,World,WW,142,11,5716034541,534,17
2020-01-23,World,WW,97,0,5716034541,631,17
2020-01-24,World,WW,266,9,5716034541,897,26
2020-01-25,World,WW,453,15,5716034541,1350,41
2020-01-26,World,WW,673,15,5716034541,2023,56
2020-01-27,World,WW,797,25,5716034541,2820,81
2020-01-28,World,WW,1767,25,5716034541,4587,106
2020-01-29,World,WW,1480,26,5716034541,6067,132
2020-01-30,World,WW,1756,38,5716034541,7823,170
2020-01-31,World,WW,2003,43,5716034541,9826,213
2020-02-01,World,WW,2120,46,5716034541,11946,259
2020-02-02,World,WW,2608,46,5716034541,14554,305
2020-02-03,World,WW,2818,57,5716034541,17372,362
2020-02-04,World,WW,3243,65,5716034541,20615,427
2020-02-05,World,WW,3907,66,5716034541,24522,493
2020-02-06,World,WW,3751,72,5716034541,28273,565
2020-02-07,World,WW,3218,73,5716034541,31491,638
2020-02-08,World,WW,3442,86,5716034541,34933,724
2020-02-09,World,WW,2619,89,5716034541,37552,813
2020-02-10,World,WW,2988,97,5716034541,40540,910
2020-02-11,World,WW,2565,108,5716034541,43105,1018
2020-02-12,World,WW,2072,97,5716034541,45177,1115
2020-02-13,World,WW,15151,255,5716034541,60328,1370
2020-02-14,World,WW,4215,13,5716034541,64543,1383
2020-02-15,World,WW,2560,144,5716034541,67103,1527
2020-02-16,World,WW,2162,142,5716034541,69265,1669
2020-02-17,World,WW,2067,106,5716034541,71332,1775
2020-02-18,World,WW,1995,98,5716034541,73327,1873
2020-02-19,World,WW,1864,139,5716034541,75191,2012
2020-02-20,World,WW,532,116,5716034541,75723,2128
2020-02-21,World,WW,996,119,5716034541,76719,2247
2020-02-22,World,WW,1085,112,5716034541,77804,2359
2020-02-23,World,WW,1008,104,5716034541,78812,2463
2020-02-24,World,WW,527,156,5716034541,79339,2619
2020-02-25,World,WW,793,79,5716034541,80132,2698
2020-02-26,World,WW,863,64,5716034541,80995,2762
2020-02-27,World,WW,1106,38,5716034541,82101,2800
2020-02-28,World,WW,1264,57,5716034541,83365,2857
2020-02-29,World,WW,1838,64,5716034541,85203,2921
2020-03-01,World,WW,1823,58,5716034541,87026,2979
2020-03-02,World,WW,2042,67,5716034541,89068,3046
2020-03-03,World,WW,1797,72,4374601733,90865,3118
2020-03-04,World,WW,2212,84,4723901857,93077,3202
2020-03-05,World,WW,2239,80,4460409162,95316,3282
2020-03-06,World,WW,2856,102,4735505020,98172,3384
2020-03-07,World,WW,3961,104,5415507468,102133,3488
2020-03-08,World,WW,3691,97,4811730953,105824,3585
2020-03-09,World,WW,3871,228,4176182316,109695,3813
2020-03-10,World,WW,4540,208,5278449024,114235,4021
2020-03-11,World,WW,4378,272,5608087968,118613,4293
2020-03-12,World,WW,6884,326,5915125869,125497,4619
2020-03-13,World,WW,8356,349,5609620452,133853,4968
2020-03-14,World,WW,9406,439,6149317780,143259,5407
2020-03-15,World,WW,11515,361,6806590680,154774,5768
2020-03-16,World,WW,12644,746,6780433572,167418,6514
2020-03-17,World,WW,12676,598,7135738258,180094,7112
2020-03-18,World,WW,14749,800,7104227157,194843,7912
2020-03-19,World,WW,18306,942,7142183403,213149,8854
2020-03-20,World,WW,29225,1043,7172020658,242374,9897
2020-03-21,World,WW,28742,1369,7245095695,271116,11266
2020-03-22,World,WW,34119,1700,7319896568,305235,12966
2020-03-23,World,WW,33000,1641,7366481892,338235,14607
2020-03-24,World,WW,39733,1780,7420946029,377968,16387
2020-03-25,World,WW,38913,2264,7434667922,416881,18651
2020-03-26,World,WW,51211,2573,7453999388,468092,21224
2020-03-27,World,WW,59747,2749,7455903499,527839,23973
2020-03-28,World,WW,63957,3422,7459098652,591796,27395
2020-03-29,World,WW,65038,3493,7459098652,656834,30888
2020-03-30,World,WW,58543,3129,7459098652,715377,34017
2020-03-31,World,WW,61810,3894,7458741377,777187,37911
2020-04-01,World,WW,74400,4629,7480229292,851587,42540
2020-04-02,World,WW,76904,4907,7480235192,928491,47447
2020-04-03,World,WW,77572,4956,7498378507,1006063,52403
2020-04-04,World,WW,81759,6633,7498378507,1087822,59036
2020-04-05,World,WW,86484,6145,7493809420,1174306,65181
2020-04-06,World,WW,71295,4678,7509354427,1245601,69859
2020-04-07,World,WW,71387,5266,7509354427,1316988,75125
2020-04-08,World,WW,74893,7663,7509354427,1391881,82788
2020-04-09,World,WW,84911,6436,7509565455,1476792,89224
2020-04-10,World,WW,87027,7445,7538064142,1563819,96669
2020-04-11,World,WW,89341,7221,7538064142,1653160,103890
2020-04-12,World,WW,81708,6026,7538064142,1734868,109916
2020-04-13,World,WW,72388,5266,7538064142,1807256,115182
2020-04-14,World,WW,66383,5371,7538064142,1873639,120553
2020-04-15,World,WW,80147,7604,7538064142,1953786,128157
2020-04-16,World,WW,79959,10520,7538064142,2033745,138677
2020-04-17,World,WW,83552,8709,7538064142,2117297,147386
2020-04-18,World,WW,82163,8568,7538064142,2199460,155954
2020-04-19,World,WW,79024,6493,7538064142,2278484,162447
2020-04-20,World,WW,72509,5036,7538064142,2350993,167483
2020-04-21,World,WW,76360,5336,7538064142,2427353,172819
2020-04-22,World,WW,86046,7284,7538064142,2513399,180103
2020-04-23,World,WW,66424,6101,7538064142,2579823,186204
2020-04-24,World,WW,78087,7444,7538064142,2657910,193648
2020-04-25,World,WW,72833,5406,7538064142,2730743,199054
2020-04-26,World,WW,101716,6249,7538064142,2832459,205303
2020-04-27,World,WW,83536,3926,7538064142,2915995,209229
2020-04-28,World,WW,65432,4897,7538064142,2981427,214126
2020-04-29,World,WW,72977,6513,7538064142,3054404,220639
2020-04-30,World,WW,76898,6680,7538064142,3131302,227319
2020-05-01,World,WW,84729,5532,7547164979,3216031,232851
2020-05-02,World,WW,91569,5580,7501273552,3307600,238431
2020-05-03,World,WW,81065,4881,7547997301,3388665,243312
