date,country,geoid,cases,deaths,population,continent,cum_cases,cum_deaths
2020-03-03,Andorra,AD,1,0,76177,Europe,1,0
2020-03-14,Andorra,AD,1,0,76177,Europe,2,0
2020-03-16,Andorra,AD,3,0,76177,Europe,5,0
2020-03-17,Andorra,AD,9,0,76177,Europe,14,0
2020-03-18,Andorra,AD,0,0,76177,Europe,14,0
2020-03-19,Andorra,AD,39,0,76177,Europe,53,0
2020-03-20,Andorra,AD,22,0,76177,Europe,75,0
2020-03-21,Andorra,AD,0,0,76177,Europe,75,0
2020-03-22,Andorra,AD,13,0,76177,Europe,88,0
2020-03-23,Andorra,AD,25,0,76177,Europe,113,0
2020-03-24,Andorra,AD,20,0,76177,Europe,133,0
2020-03-25,Andorra,AD,31,0,76177,Europe,164,0
2020-03-26,Andorra,AD,24,0,76177,Europe,188,0
2020-03-27,Andorra,AD,36,3,76177,Europe,224,3
2020-03-28,Andorra,AD,43,0,76177,Europe,267,3
2020-03-29,Andorra,AD,41,1,76177,Europe,308,4
2020-03-30,Andorra,AD,26,2,76177,Europe,334,6
2020-03-31,Andorra,AD,36,2,76177,Europe,370,8
2020-04-01,Andorra,AD,6,4,76177,Europe,376,12
2020-04-02,Andorra,AD,14,2,76177,Europe,390,14
2020-04-03,Andorra,AD,38,1,76177,Europe,428,15
2020-04-04,Andorra,AD,11,1,76177,Europe,439,16
2020-04-05,Andorra,AD,27,1,76177,Europe,466,17
2020-04-06,Andorra,AD,35,1,76177,Europe,501,18
2020-04-07,Andorra,AD,25,3,76177,Europe,526,21
2020-04-08,Andorra,AD,19,1,76177,Europe,545,22
2020-04-09,Andorra,AD,19,1,76177,Europe,564,23
2020-04-10,Andorra,AD,19,2,76177,Europe,583,25
2020-04-11,Andorra,AD,18,1,76177,Europe,601,26
2020-04-12,Andorra,AD,21,2,76177,Europe,622,28
2020-04-13,Andorra,AD,16,1,76177,Europe,638,29
2020-04-14,Andorra,AD,8,0,76177,Europe,646,29
2020-04-15,Andorra,AD,13,2,76177,Europe,659,31
2020-04-16,Andorra,AD,14,2,76177,Europe,673,33
2020-04-17,Andorra,AD,9,0,76177,Europe,682,33
2020-04-18,Andorra,AD,14,2,76177,Europe,696,35
2020-04-19,Andorra,AD,8,0,76177,Europe,704,35
2020-04-20,Andorra,AD,9,1,76177,Europe,713,36
2020-04-21,Andorra,AD,4,0,76177,Europe,717,36
2020-04-22,Andorra,AD,0,1,76177,Europe,717,37
2020-04-23,Andorra,AD,6,0,76177,Europe,723,37
2020-04-24,Andorra,AD,1,0,76177,Europe,724,37
2020-04-25,Andorra,AD,7,3,76177,Europe,731,40
2020-04-26,Andorra,AD,2,0,76177,Europe,733,40
2020-04-27,Andorra,AD,7,0,76177,Europe,740,40
2020-04-28,Andorra,AD,3,0,76177,Europe,743,40
2020-04-29,Andorra,AD,0,1,76177,Europe,743,41
2020-04-30,Andorra,AD,0,1,76177,Europe,743,42
2020-05-01,Andorra,AD,2,0,76177,Europe,745,42
2020-05-02,Andorra,AD,1,1,76177,Europe,746,43
2020-05-03,Andorra,AD,1,1,76177,Europe,747,44
2020-05-04,Andorra,AD,1,1,76177,Europe,748,45
2020-05-05,Andorra,AD,2,0,76177,Europe,750,45
2020-05-06,Andorra,AD,1,1,76177,Europe,751,46
2020-05-07,Andorra,AD,0,0,76177,Europe,751,46
2020-05-08,Andorra,AD,1,1,76177,Europe,752,47
2020-05-09,Andorra,AD,0,0,76177,Europe,752,47
2020-05-10,Andorra,AD,2,1,76177,Europe,754,48
2020-05-11,Andorra,AD,1,0,76177,Europe,755,48
2020-05-12,Andorra,AD,1,0,76177,Europe,756,48
2020-05-13,Andorra,AD,2,0,76177,Europe,758,48
2020-05-14,Andorra,AD,2,1,76177,Europe,760,49
2020-05-15,Andorra,AD,1,0,76177,Europe,761,49
2020-05-16,Andorra,AD,0,0,76177,Europe,761,49
2020-05-17,Andorra,AD,0,2,76177,Europe,761,51
2020-05-18,Andorra,AD,0,0,76177,Europe,761,51
2020-05-19,Andorra,AD,0,0,76177,Europe,761,51
2020-05-20,Andorra,AD,0,0,76177,Europe,761,51
2020-05-21,Andorra,AD,1,0,76177,Europe,762,51
2020-05-22,Andorra,AD,0,0,76177,Europe,762,51
2020-05-23,Andorra,AD,0,0,76177,Europe,762,51
2020-05-24,Andorra,AD,0,0,76177,Europe,762,51
2020-05-25,Andorra,AD,1,0,76177,Europe,763,51
2020-05-26,Andorra,AD,0,0,76177,Europe,763,51
2020-05-27,Andorra,AD,0,0,76177,Europe,763,51
2020-05-28,Andorra,AD,0,0,76177,Europe,763,51
2020-05-29,Andorra,AD,0,0,76177,Europe,763,51
2020-05-30,Andorra,AD,1,0,76177,Europe,764,51
2020-05-31,Andorra,AD,0,0,76177,Europe,764,51
2020-06-01,Andorra,AD,0,0,76177,Europe,764,51
2020-06-02,Andorra,AD,1,0,76177,Europe,765,51
2020-06-03,Andorra,AD,79,0,76177,Europe,844,51
2020-06-04,Andorra,AD,7,0,76177,Europe,851,51
2020-06-05,Andorra,AD,1,0,76177,Europe,852,51
2020-06-06,Andorra,AD,0,0,76177,Europe,852,51
2020-06-07,Andorra,AD,0,0,76177,Europe,852,51
2020-06-08,Andorra,AD,0,0,76177,Europe,852,51
2020-06-09,Andorra,AD,0,0,76177,Europe,852,51
2020-06-10,Andorra,AD,0,0,76177,Europe,852,51
2020-06-11,Andorra,AD,0,0,76177,Europe,852,51
2020-06-12,Andorra,AD,0,0,76177,Europe,852,51
2020-06-13,Andorra,AD,1,0,76177,Europe,853,51
2020-06-14,Andorra,AD,0,0,76177,Europe,853,51
2020-06-15,Andorra,AD,0,0,76177,Europe,853,51
2020-06-16,Andorra,AD,0,0,76177,Europe,853,51
2020-06-17,Andorra,AD,1,1,76177,Europe,854,52
2020-06-18,Andorra,AD,0,0,76177,Europe,854,52
2020-06-19,Andorra,AD,1,0,76177,Europe,855,52
2020-06-20,Andorra,AD,0,0,76177,Europe,855,52
2020-06-21,Andorra,AD,0,0,76177,Europe,855,52
2020-06-22,Andorra,AD,0,0,76177,Europe,855,52
2020-06-23,Andorra,AD,0,0,76177,Europe,855,52
2020-06-24,Andorra,AD,0,0,76177,Europe,855,52
2020-06-25,Andorra,AD,0,0,76177,Europe,855,52
2020-06-26,Andorra,AD,0,0,76177,Europe,855,52
2020-06-27,Andorra,AD,0,0,76177,Europe,855,52
2020-06-28,Andorra,AD,0,0,76177,Europe,855,52
2020-06-29,Andorra,AD,0,0,76177,Europe,855,52
2020-06-30,Andorra,AD,0,0,76177,Europe,855,52
2020-07-01,Andorra,AD,0,0,76177,Europe,855,52
2020-07-02,Andorra,AD,0,0,76177,Europe,855,52
2020-07-03,Andorra,AD,0,0,76177,Europe,855,52
2020-07-04,Andorra,AD,0,0,76177,Europe,855,52
2020-07-05,Andorra,AD,0,0,76177,Europe,855,52
2020-07-06,Andorra,AD,0,0,76177,Europe,855,52
2020-07-07,Andorra,AD,0,0,76177,Europe,855,52
2020-07-08,Andorra,AD,0,0,76177,Europe,855,52
2020-07-09,Andorra,AD,0,0,76177,Europe,855,52
2020-07-10,Andorra,AD,0,0,76177,Europe,855,52
2020-07-11,Andorra,AD,0,0,76177,Europe,855,52
2020-07-12,Andorra,AD,0,0,76177,Europe,855,52
2020-07-13,Andorra,AD,0,0,76177,Europe,855,52
2020-07-14,Andorra,AD,3,0,76177,Europe,858,52
2020-07-15,Andorra,AD,3,0,76177,Europe,861,52
2020-07-16,Andorra,AD,1,0,76177,Europe,862,52
2020-07-17,Andorra,AD,15,0,76177,Europe,877,52
2020-07-18,Andorra,AD,3,0,76177,Europe,880,52
2020-07-19,Andorra,AD,0,0,76177,Europe,880,52
2020-07-20,Andorra,AD,0,0,76177,Europe,880,52
2020-07-21,Andorra,AD,4,0,76177,Europe,884,52
2020-07-22,Andorra,AD,0,0,76177,Europe,884,52
2020-07-23,Andorra,AD,5,0,76177,Europe,889,52
2020-07-24,Andorra,AD,0,0,76177,Europe,889,52
2020-07-25,Andorra,AD,0,0,76177,Europe,889,52
2020-07-26,Andorra,AD,8,0,76177,Europe,897,52
2020-07-27,Andorra,AD,0,0,76177,Europe,897,52
2020-07-28,Andorra,AD,10,0,76177,Europe,907,52
2020-07-29,Andorra,AD,0,0,76177,Europe,907,52
2020-07-30,Andorra,AD,11,0,76177,Europe,918,52
2020-07-31,Andorra,AD,4,0,76177,Europe,922,52
2020-08-01,Andorra,AD,3,0,76177,Europe,925,52
2020-08-02,Andorra,AD,0,0,76177,Europe,925,52
2020-08-03,Andorra,AD,0,0,76177,Europe,925,52
2020-08-04,Andorra,AD,12,0,76177,Europe,937,52
2020-08-05,Andorra,AD,2,0,76177,Europe,939,52
2020-08-06,Andorra,AD,0,0,76177,Europe,939,52
2020-08-07,Andorra,AD,5,0,76177,Europe,944,52
2020-08-08,Andorra,AD,11,0,76177,Europe,955,52
2020-08-09,Andorra,AD,1,0,76177,Europe,956,52
2020-08-10,Andorra,AD,0,0,76177,Europe,956,52
2020-08-11,Andorra,AD,7,0,76177,Europe,963,52
2020-08-12,Andorra,AD,0,0,76177,Europe,963,52
2020-08-13,Andorra,AD,14,1,76177,Europe,977,53
2020-08-14,Andorra,AD,4,0,76177,Europe,981,53
2020-08-15,Andorra,AD,8,0,76177,Europe,989,53
2020-08-16,Andorra,AD,0,0,76177,Europe,989,53
2020-08-17,Andorra,AD,0,0,76177,Europe,989,53
2020-08-18,Andorra,AD,16,0,76177,Europe,1005,53
2020-08-19,Andorra,AD,0,0,76177,Europe,1005,53
2020-08-20,Andorra,AD,19,0,76177,Europe,1024,53
2020-08-21,Andorra,AD,0,0,76177,Europe,1024,53
2020-08-22,Andorra,AD,21,0,76177,Europe,1045,53
2020-08-23,Andorra,AD,0,0,76177,Europe,1045,53
2020-08-24,Andorra,AD,0,0,76177,Europe,1045,53
2020-08-25,Andorra,AD,15,0,76177,Europe,1060,53
2020-08-26,Andorra,AD,0,0,76177,Europe,1060,53
2020-08-27,Andorra,AD,38,0,76177,Europe,1098,53
2020-08-28,Andorra,AD,0,0,76177,Europe,1098,53
2020-08-29,Andorra,AD,26,0,76177,Europe,1124,53
2020-08-30,Andorra,AD,0,0,76177,Europe,1124,53
2020-08-31,Andorra,AD,0,0,76177,Europe,1124,53
2020-09-01,Andorra,AD,52,0,76177,Europe,1176,53
2020-09-02,Andorra,AD,8,0,76177,Europe,1184,53
2020-09-03,Andorra,AD,15,0,76177,Europe,1199,53
2020-09-04,Andorra,AD,0,0,76177,Europe,1199,53
2020-09-05,Andorra,AD,16,0,76177,Europe,1215,53
2020-09-06,Andorra,AD,0,0,76177,Europe,1215,53
2020-09-07,Andorra,AD,0,0,76177,Europe,1215,53
2020-09-08,Andorra,AD,46,0,76177,Europe,1261,53
2020-09-09,Andorra,AD,0,0,76177,Europe,1261,53
2020-09-10,Andorra,AD,40,0,76177,Europe,1301,53
2020-09-11,Andorra,AD,0,0,76177,Europe,1301,53
2020-09-12,Andorra,AD,43,0,76177,Europe,1344,53
2020-09-13,Andorra,AD,0,0,76177,Europe,1344,53
2020-09-14,Andorra,AD,0,0,76177,Europe,1344,53
2020-09-15,Andorra,AD,94,0,76177,Europe,1438,53
2020-09-16,Andorra,AD,0,0,76177,Europe,1438,53
2020-09-17,Andorra,AD,0,0,76177,Europe,1438,53
2020-09-18,Andorra,AD,45,0,76177,Europe,1483,53
2020-09-19,Andorra,AD,81,0,76177,Europe,1564,53
2020-09-20,Andorra,AD,0,0,76177,Europe,1564,53
2020-09-21,Andorra,AD,0,0,76177,Europe,1564,53
2020-09-22,Andorra,AD,117,0,76177,Europe,1681,53
2020-09-23,Andorra,AD,0,0,76177,Europe,1681,53
2020-09-24,Andorra,AD,72,0,76177,Europe,1753,53
2020-09-25,Andorra,AD,0,0,76177,Europe,1753,53
2020-09-26,Andorra,AD,83,0,76177,Europe,1836,53
2020-09-27,Andorra,AD,0,0,76177,Europe,1836,53
2020-09-28,Andorra,AD,0,0,76177,Europe,1836,53
2020-09-29,Andorra,AD,130,0,76177,Europe,1966,53
2020-09-30,Andorra,AD,0,0,76177,Europe,1966,53
2020-10-01,Andorra,AD,84,0,76177,Europe,2050,53
2020-10-02,Andorra,AD,0,0,76177,Europe,2050,53
2020-10-03,Andorra,AD,60,0,76177,Europe,2110,53
2020-10-04,Andorra,AD,0,0,76177,Europe,2110,53
2020-10-05,Andorra,AD,0,0,76177,Europe,2110,53
2020-10-06,Andorra,AD,260,0,76177,Europe,2370,53
2020-10-07,Andorra,AD,0,0,76177,Europe,2370,53
2020-10-08,Andorra,AD,198,0,76177,Europe,2568,53
2020-10-09,Andorra,AD,0,1,76177,Europe,2568,54
2020-10-10,Andorra,AD,128,1,76177,Europe,2696,55
2020-10-11,Andorra,AD,0,0,76177,Europe,2696,55
2020-10-12,Andorra,AD,0,0,76177,Europe,2696,55
2020-10-13,Andorra,AD,299,2,76177,Europe,2995,57
2020-10-14,Andorra,AD,0,0,76177,Europe,2995,57
2020-10-15,Andorra,AD,195,2,76177,Europe,3190,59
2020-10-16,Andorra,AD,0,0,76177,Europe,3190,59
2020-10-17,Andorra,AD,187,0,76177,Europe,3377,59
2020-10-18,Andorra,AD,0,0,76177,Europe,3377,59
2020-10-19,Andorra,AD,0,0,76177,Europe,3377,59
2020-10-20,Andorra,AD,246,3,76177,Europe,3623,62
2020-10-21,Andorra,AD,0,0,76177,Europe,3623,62
2020-10-22,Andorra,AD,188,1,76177,Europe,3811,63
2020-10-23,Andorra,AD,0,0,76177,Europe,3811,63
2020-10-24,Andorra,AD,227,6,76177,Europe,4038,69
2020-10-25,Andorra,AD,0,0,76177,Europe,4038,69
2020-10-26,Andorra,AD,0,0,76177,Europe,4038,69
2020-10-27,Andorra,AD,287,3,76177,Europe,4325,72
2020-10-28,Andorra,AD,85,0,76177,Europe,4410,72
2020-10-29,Andorra,AD,107,0,76177,Europe,4517,72
2020-10-30,Andorra,AD,50,1,76177,Europe,4567,73
2020-10-31,Andorra,AD,98,2,76177,Europe,4665,75
2020-11-01,Andorra,AD,91,0,76177,Europe,4756,75
2020-11-02,Andorra,AD,69,0,76177,Europe,4825,75
2020-11-03,Andorra,AD,63,0,76177,Europe,4888,75
2020-11-04,Andorra,AD,22,0,76177,Europe,4910,75
2020-11-05,Andorra,AD,135,0,76177,Europe,5045,75
2020-11-06,Andorra,AD,90,0,76177,Europe,5135,75
2020-11-07,Andorra,AD,0,0,76177,Europe,5135,75
2020-11-08,Andorra,AD,184,0,76177,Europe,5319,75
2020-11-09,Andorra,AD,64,0,76177,Europe,5383,75
2020-11-10,Andorra,AD,54,0,76177,Europe,5437,75
2020-11-11,Andorra,AD,40,0,76177,Europe,5477,75
2020-11-12,Andorra,AD,90,0,76177,Europe,5567,75
2020-11-13,Andorra,AD,49,0,76177,Europe,5616,75
2020-11-14,Andorra,AD,109,0,76177,Europe,5725,75
2020-11-15,Andorra,AD,0,0,76177,Europe,5725,75
2020-11-16,Andorra,AD,147,1,76177,Europe,5872,76
2020-11-17,Andorra,AD,42,0,76177,Europe,5914,76
2020-11-18,Andorra,AD,37,0,76177,Europe,5951,76
2020-11-19,Andorra,AD,67,0,76177,Europe,6018,76
2020-11-20,Andorra,AD,48,0,76177,Europe,6066,76
2020-11-21,Andorra,AD,76,0,76177,Europe,6142,76
2020-11-22,Andorra,AD,65,0,76177,Europe,6207,76
2020-11-23,Andorra,AD,49,0,76177,Europe,6256,76
2020-11-24,Andorra,AD,48,0,76177,Europe,6304,76
2020-11-25,Andorra,AD,47,0,76177,Europe,6351,76
2020-11-26,Andorra,AD,77,0,76177,Europe,6428,76
2020-11-27,Andorra,AD,106,0,76177,Europe,6534,76
2020-11-28,Andorra,AD,76,0,76177,Europe,6610,76
2020-11-29,Andorra,AD,60,0,76177,Europe,6670,76
2020-11-30,Andorra,AD,42,0,76177,Europe,6712,76
2020-12-01,Andorra,AD,33,0,76177,Europe,6745,76
2020-12-02,Andorra,AD,45,0,76177,Europe,6790,76
2020-12-03,Andorra,AD,52,0,76177,Europe,6842,76
2020-12-04,Andorra,AD,62,1,76177,Europe,6904,77
2020-12-05,Andorra,AD,51,0,76177,Europe,6955,77
2020-12-06,Andorra,AD,50,1,76177,Europe,7005,78
2020-12-07,Andorra,AD,45,0,76177,Europe,7050,78
2020-12-08,Andorra,AD,34,0,76177,Europe,7084,78
2020-12-09,Andorra,AD,43,0,76177,Europe,7127,78
2020-12-10,Andorra,AD,35,0,76177,Europe,7162,78
2020-12-11,Andorra,AD,28,0,76177,Europe,7190,78
2020-12-12,Andorra,AD,46,0,76177,Europe,7236,78
2020-12-13,Andorra,AD,52,0,76177,Europe,7288,78
2020-12-14,Andorra,AD,50,1,76177,Europe,7338,79
2019-12-31,United_Arab_Emirates,AE,0,0,9770526,Asia,0,0
2020-01-01,United_Arab_Emirates,AE,0,0,9770526,Asia,0,0
2020-01-02,United_Arab_Emirates,AE,0,0,9770526,Asia,0,0
2020-01-03,United_Arab_Emirates,AE,0,0,9770526,Asia,0,0
2020-01-04,United_Arab_Emirates,AE,0,0,9770526,Asia,0,0
2020-01-05,United_Arab_Emirates,AE,0,0,9770526,Asia,0,0
2020-01-06,United_Arab_Emirates,AE,0,0,9770526,Asia,0,0
2020-01-07,United_Arab_Emirates,AE,0,0,9770526,Asia,0,0
2020-01-08,United_Arab_Emirates,AE,0,0,9770526,Asia,0,0
2020-01-09,United_Arab_Emirates,AE,0,0,9770526,Asia,0,0
2020-01-10,United_Arab_Emirates,AE,0,0,9770526,Asia,0,0
2020-01-11,United_Arab_Emirates,AE,0,0,9770526,Asia,0,0
2020-01-12,United_Arab_Emirates,AE,0,0,9770526,Asia,0,0
2020-01-13,United_Arab_Emirates,AE,0,0,9770526,Asia,0,0
2020-01-14,United_Arab_Emirates,AE,0,0,9770526,Asia,0,0
2020-01-15,United_Arab_Emirates,AE,0,0,9770526,Asia,0,0
2020-01-16,United_Arab_Emirates,AE,0,0,9770526,Asia,0,0
2020-01-17,United_Arab_Emirates,AE,0,0,9770526,Asia,0,0
2020-01-18,United_Arab_Emirates,AE,0,0,9770526,Asia,0,0
2020-01-19,United_Arab_Emirates,AE,0,0,9770526,Asia,0,0
2020-01-20,United_Arab_Emirates,AE,0,0,9770526,Asia,0,0
2020-01-21,United_Arab_Emirates,AE,0,0,9770526,Asia,0,0
2020-01-22,United_Arab_Emirates,AE,0,0,9770526,Asia,0,0
2020-01-23,United_Arab_Emirates,AE,0,0,9770526,Asia,0,0
2020-01-24,United_Arab_Emirates,AE,0,0,9770526,Asia,0,0
2020-01-25,United_Arab_Emirates,AE,0,0,9770526,Asia,0,0
2020-01-26,United_Arab_Emirates,AE,0,0,9770526,Asia,0,0
2020-01-27,United_Arab_Emirates,AE,1,0,9770526,Asia,1,0
2020-01-28,United_Arab_Emirates,AE,0,0,9770526,Asia,1,0
2020-01-29,United_Arab_Emirates,AE,0,0,9770526,Asia,1,0
2020-01-30,United_Arab_Emirates,AE,3,0,9770526,Asia,4,0
2020-01-31,United_Arab_Emirates,AE,0,0,9770526,Asia,4,0
2020-02-01,United_Arab_Emirates,AE,0,0,9770526,Asia,4,0
2020-02-02,United_Arab_Emirates,AE,1,0,9770526,Asia,5,0
2020-02-03,United_Arab_Emirates,AE,0,0,9770526,Asia,5,0
2020-02-04,United_Arab_Emirates,AE,0,0,9770526,Asia,5,0
2020-02-05,United_Arab_Emirates,AE,0,0,9770526,Asia,5,0
2020-02-06,United_Arab_Emirates,AE,0,0,9770526,Asia,5,0
2020-02-07,United_Arab_Emirates,AE,0,0,9770526,Asia,5,0
2020-02-08,United_Arab_Emirates,AE,2,0,9770526,Asia,7,0
2020-02-09,United_Arab_Emirates,AE,0,0,9770526,Asia,7,0
2020-02-10,United_Arab_Emirates,AE,0,0,9770526,Asia,7,0
2020-02-11,United_Arab_Emirates,AE,1,0,9770526,Asia,8,0
2020-02-12,United_Arab_Emirates,AE,0,0,9770526,Asia,8,0
2020-02-13,United_Arab_Emirates,AE,0,0,9770526,Asia,8,0
2020-02-14,United_Arab_Emirates,AE,0,0,9770526,Asia,8,0
2020-02-15,United_Arab_Emirates,AE,0,0,9770526,Asia,8,0
2020-02-16,United_Arab_Emirates,AE,0,0,9770526,Asia,8,0
2020-02-17,United_Arab_Emirates,AE,1,0,9770526,Asia,9,0
2020-02-18,United_Arab_Emirates,AE,0,0,9770526,Asia,9,0
2020-02-19,United_Arab_Emirates,AE,0,0,9770526,Asia,9,0
2020-02-20,United_Arab_Emirates,AE,0,0,9770526,Asia,9,0
2020-02-21,United_Arab_Emirates,AE,0,0,9770526,Asia,9,0
2020-02-22,United_Arab_Emirates,AE,2,0,9770526,Asia,11,0
2020-02-23,United_Arab_Emirates,AE,2,0,9770526,Asia,13,0
2020-02-24,United_Arab_Emirates,AE,0,0,9770526,Asia,13,0
2020-02-25,United_Arab_Emirates,AE,0,0,9770526,Asia,13,0
2020-02-26,United_Arab_Emirates,AE,0,0,9770526,Asia,13,0
2020-02-27,United_Arab_Emirates,AE,0,0,9770526,Asia,13,0
2020-02-28,United_Arab_Emirates,AE,6,0,9770526,Asia,19,0
2020-02-29,United_Arab_Emirates,AE,2,0,9770526,Asia,21,0
2020-03-01,United_Arab_Emirates,AE,0,0,9770526,Asia,21,0
2020-03-02,United_Arab_Emirates,AE,0,0,9770526,Asia,21,0
2020-03-04,United_Arab_Emirates,AE,6,0,9770526,Asia,27,0
2020-03-06,United_Arab_Emirates,AE,2,0,9770526,Asia,29,0
2020-03-08,United_Arab_Emirates,AE,16,0,9770526,Asia,45,0
2020-03-10,United_Arab_Emirates,AE,14,0,9770526,Asia,59,0
2020-03-11,United_Arab_Emirates,AE,15,0,9770526,Asia,74,0
2020-03-13,United_Arab_Emirates,AE,11,0,9770526,Asia,85,0
2020-03-15,United_Arab_Emirates,AE,1,0,9770526,Asia,86,0
2020-03-16,United_Arab_Emirates,AE,12,0,9770526,Asia,98,0
2020-03-17,United_Arab_Emirates,AE,0,0,9770526,Asia,98,0
2020-03-18,United_Arab_Emirates,AE,15,0,9770526,Asia,113,0
2020-03-19,United_Arab_Emirates,AE,0,0,9770526,Asia,113,0
2020-03-20,United_Arab_Emirates,AE,27,0,9770526,Asia,140,0
2020-03-21,United_Arab_Emirates,AE,0,0,9770526,Asia,140,0
2020-03-22,United_Arab_Emirates,AE,13,2,9770526,Asia,153,2
2020-03-23,United_Arab_Emirates,AE,0,0,9770526,Asia,153,2
2020-03-24,United_Arab_Emirates,AE,45,0,9770526,Asia,198,2
2020-03-25,United_Arab_Emirates,AE,50,0,9770526,Asia,248,2
2020-03-26,United_Arab_Emirates,AE,85,0,9770526,Asia,333,2
2020-03-27,United_Arab_Emirates,AE,0,0,9770526,Asia,333,2
2020-03-28,United_Arab_Emirates,AE,72,0,9770526,Asia,405,2
2020-03-29,United_Arab_Emirates,AE,63,0,9770526,Asia,468,2
2020-03-30,United_Arab_Emirates,AE,102,1,9770526,Asia,570,3
2020-03-31,United_Arab_Emirates,AE,41,2,9770526,Asia,611,5
2020-04-01,United_Arab_Emirates,AE,53,1,9770526,Asia,664,6
2020-04-02,United_Arab_Emirates,AE,150,2,9770526,Asia,814,8
2020-04-03,United_Arab_Emirates,AE,210,0,9770526,Asia,1024,8
2020-04-04,United_Arab_Emirates,AE,240,1,9770526,Asia,1264,9
2020-04-05,United_Arab_Emirates,AE,241,1,9770526,Asia,1505,10
2020-04-06,United_Arab_Emirates,AE,278,0,9770526,Asia,1783,10
2020-04-07,United_Arab_Emirates,AE,262,1,9770526,Asia,2045,11
2020-04-08,United_Arab_Emirates,AE,268,1,9770526,Asia,2313,12
2020-04-09,United_Arab_Emirates,AE,284,0,9770526,Asia,2597,12
2020-04-10,United_Arab_Emirates,AE,313,2,9770526,Asia,2910,14
2020-04-11,United_Arab_Emirates,AE,350,2,9770526,Asia,3260,16
2020-04-12,United_Arab_Emirates,AE,356,4,9770526,Asia,3616,20
2020-04-13,United_Arab_Emirates,AE,366,2,9770526,Asia,3982,22
2020-04-14,United_Arab_Emirates,AE,377,3,9770526,Asia,4359,25
2020-04-15,United_Arab_Emirates,AE,390,3,9770526,Asia,4749,28
2020-04-16,United_Arab_Emirates,AE,409,5,9770526,Asia,5158,33
2020-04-17,United_Arab_Emirates,AE,435,2,9770526,Asia,5593,35
2020-04-18,United_Arab_Emirates,AE,452,2,9770526,Asia,6045,37
2020-04-19,United_Arab_Emirates,AE,445,0,9770526,Asia,6490,37
2020-04-20,United_Arab_Emirates,AE,453,4,9770526,Asia,6943,41
2020-04-21,United_Arab_Emirates,AE,458,2,9770526,Asia,7401,43
2020-04-22,United_Arab_Emirates,AE,464,3,9770526,Asia,7865,46
2020-04-23,United_Arab_Emirates,AE,457,6,9770526,Asia,8322,52
2020-04-24,United_Arab_Emirates,AE,490,4,9770526,Asia,8812,56
2020-04-25,United_Arab_Emirates,AE,497,8,9770526,Asia,9309,64
2020-04-26,United_Arab_Emirates,AE,504,7,9770526,Asia,9813,71
2020-04-27,United_Arab_Emirates,AE,536,5,9770526,Asia,10349,76
2020-04-28,United_Arab_Emirates,AE,490,6,9770526,Asia,10839,82
2020-04-29,United_Arab_Emirates,AE,541,7,9770526,Asia,11380,89
2020-04-30,United_Arab_Emirates,AE,549,9,9770526,Asia,11929,98
2020-05-01,United_Arab_Emirates,AE,552,7,9770526,Asia,12481,105
2020-05-02,United_Arab_Emirates,AE,557,6,9770526,Asia,13038,111
2020-05-03,United_Arab_Emirates,AE,561,8,9770526,Asia,13599,119
2020-05-04,United_Arab_Emirates,AE,564,7,9770526,Asia,14163,126
2020-05-05,United_Arab_Emirates,AE,567,11,9770526,Asia,14730,137
2020-05-06,United_Arab_Emirates,AE,462,9,9770526,Asia,15192,146
2020-05-07,United_Arab_Emirates,AE,546,11,9770526,Asia,15738,157
2020-05-08,United_Arab_Emirates,AE,502,8,9770526,Asia,16240,165
2020-05-09,United_Arab_Emirates,AE,553,9,9770526,Asia,16793,174
2020-05-10,United_Arab_Emirates,AE,624,11,9770526,Asia,17417,185
2020-05-11,United_Arab_Emirates,AE,781,13,9770526,Asia,18198,198
2020-05-12,United_Arab_Emirates,AE,680,3,9770526,Asia,18878,201
2020-05-13,United_Arab_Emirates,AE,783,2,9770526,Asia,19661,203
2020-05-14,United_Arab_Emirates,AE,725,3,9770526,Asia,20386,206
2020-05-15,United_Arab_Emirates,AE,698,2,9770526,Asia,21084,208
2020-05-16,United_Arab_Emirates,AE,747,2,9770526,Asia,21831,210
2020-05-17,United_Arab_Emirates,AE,796,4,9770526,Asia,22627,214
2020-05-18,United_Arab_Emirates,AE,731,6,9770526,Asia,23358,220
2020-05-19,United_Arab_Emirates,AE,832,4,9770526,Asia,24190,224
2020-05-20,United_Arab_Emirates,AE,873,3,9770526,Asia,25063,227
2020-05-21,United_Arab_Emirates,AE,941,6,9770526,Asia,26004,233
2020-05-22,United_Arab_Emirates,AE,894,4,9770526,Asia,26898,237
2020-05-23,United_Arab_Emirates,AE,994,4,9770526,Asia,27892,241
2020-05-24,United_Arab_Emirates,AE,812,3,9770526,Asia,28704,244
2020-05-25,United_Arab_Emirates,AE,781,1,9770526,Asia,29485,245
2020-05-26,United_Arab_Emirates,AE,822,3,9770526,Asia,30307,248
2020-05-27,United_Arab_Emirates,AE,779,5,9770526,Asia,31086,253
2020-05-28,United_Arab_Emirates,AE,883,2,9770526,Asia,31969,255
2020-05-29,United_Arab_Emirates,AE,563,3,9770526,Asia,32532,258
2020-05-30,United_Arab_Emirates,AE,638,2,9770526,Asia,33170,260
2020-05-31,United_Arab_Emirates,AE,726,2,9770526,Asia,33896,262
2020-06-01,United_Arab_Emirates,AE,661,2,9770526,Asia,34557,264
2020-06-02,United_Arab_Emirates,AE,635,2,9770526,Asia,35192,266
2020-06-03,United_Arab_Emirates,AE,596,3,9770526,Asia,35788,269
2020-06-04,United_Arab_Emirates,AE,571,1,9770526,Asia,36359,270
2020-06-05,United_Arab_Emirates,AE,659,3,9770526,Asia,37018,273
2020-06-06,United_Arab_Emirates,AE,624,1,9770526,Asia,37642,274
2020-06-07,United_Arab_Emirates,AE,626,1,9770526,Asia,38268,275
2020-06-08,United_Arab_Emirates,AE,540,1,9770526,Asia,38808,276
2020-06-09,United_Arab_Emirates,AE,568,5,9770526,Asia,39376,281
2020-06-10,United_Arab_Emirates,AE,528,2,9770526,Asia,39904,283
2020-06-11,United_Arab_Emirates,AE,603,1,9770526,Asia,40507,284
2020-06-12,United_Arab_Emirates,AE,479,2,9770526,Asia,40986,286
2020-06-13,United_Arab_Emirates,AE,513,1,9770526,Asia,41499,287
2020-06-14,United_Arab_Emirates,AE,491,1,9770526,Asia,41990,288
2020-06-15,United_Arab_Emirates,AE,304,1,9770526,Asia,42294,289
2020-06-16,United_Arab_Emirates,AE,342,2,9770526,Asia,42636,291
2020-06-17,United_Arab_Emirates,AE,346,2,9770526,Asia,42982,293
2020-06-18,United_Arab_Emirates,AE,382,2,9770526,Asia,43364,295
2020-06-19,United_Arab_Emirates,AE,388,3,9770526,Asia,43752,298
2020-06-20,United_Arab_Emirates,AE,393,2,9770526,Asia,44145,300
2020-06-21,United_Arab_Emirates,AE,388,1,9770526,Asia,44533,301
2020-06-22,United_Arab_Emirates,AE,392,1,9770526,Asia,44925,302
2020-06-23,United_Arab_Emirates,AE,378,1,9770526,Asia,45303,303
2020-06-24,United_Arab_Emirates,AE,380,2,9770526,Asia,45683,305
2020-06-25,United_Arab_Emirates,AE,450,2,9770526,Asia,46133,307
2020-06-26,United_Arab_Emirates,AE,430,1,9770526,Asia,46563,308
2020-06-27,United_Arab_Emirates,AE,410,2,9770526,Asia,46973,310
2020-06-28,United_Arab_Emirates,AE,387,1,9770526,Asia,47360,311
2020-06-29,United_Arab_Emirates,AE,437,2,9770526,Asia,47797,313
2020-06-30,United_Arab_Emirates,AE,449,1,9770526,Asia,48246,314
2020-07-01,United_Arab_Emirates,AE,421,1,9770526,Asia,48667,315
2020-07-02,United_Arab_Emirates,AE,402,1,9770526,Asia,49069,316
2020-07-03,United_Arab_Emirates,AE,400,1,9770526,Asia,49469,317
2020-07-04,United_Arab_Emirates,AE,672,1,9770526,Asia,50141,318
2020-07-05,United_Arab_Emirates,AE,716,3,9770526,Asia,50857,321
2020-07-06,United_Arab_Emirates,AE,683,2,9770526,Asia,51540,323
2020-07-07,United_Arab_Emirates,AE,528,1,9770526,Asia,52068,324
2020-07-08,United_Arab_Emirates,AE,532,2,9770526,Asia,52600,326
2020-07-09,United_Arab_Emirates,AE,445,1,9770526,Asia,53045,327
2020-07-10,United_Arab_Emirates,AE,532,1,9770526,Asia,53577,328
2020-07-11,United_Arab_Emirates,AE,473,2,9770526,Asia,54050,330
2020-07-12,United_Arab_Emirates,AE,403,1,9770526,Asia,54453,331
2020-07-13,United_Arab_Emirates,AE,401,2,9770526,Asia,54854,333
2020-07-14,United_Arab_Emirates,AE,344,1,9770526,Asia,55198,334
2020-07-15,United_Arab_Emirates,AE,375,1,9770526,Asia,55573,335
2020-07-16,United_Arab_Emirates,AE,275,0,9770526,Asia,55848,335
2020-07-17,United_Arab_Emirates,AE,281,0,9770526,Asia,56129,335
2020-07-18,United_Arab_Emirates,AE,293,2,9770526,Asia,56422,337
2020-07-19,United_Arab_Emirates,AE,289,1,9770526,Asia,56711,338
2020-07-20,United_Arab_Emirates,AE,211,1,9770526,Asia,56922,339
2020-07-21,United_Arab_Emirates,AE,271,1,9770526,Asia,57193,340
2020-07-22,United_Arab_Emirates,AE,305,1,9770526,Asia,57498,341
2020-07-23,United_Arab_Emirates,AE,236,1,9770526,Asia,57734,342
2020-07-24,United_Arab_Emirates,AE,254,0,9770526,Asia,57988,342
2020-07-25,United_Arab_Emirates,AE,261,1,9770526,Asia,58249,343
2020-07-26,United_Arab_Emirates,AE,313,0,9770526,Asia,58562,343
2020-07-27,United_Arab_Emirates,AE,351,1,9770526,Asia,58913,344
2020-07-28,United_Arab_Emirates,AE,264,1,9770526,Asia,59177,345
2020-07-29,United_Arab_Emirates,AE,369,2,9770526,Asia,59546,347
2020-07-30,United_Arab_Emirates,AE,375,0,9770526,Asia,59921,347
2020-07-31,United_Arab_Emirates,AE,585,4,9770526,Asia,60506,351
2020-08-01,United_Arab_Emirates,AE,0,0,9770526,Asia,60506,351
2020-08-02,United_Arab_Emirates,AE,254,0,9770526,Asia,60760,351
2020-08-03,United_Arab_Emirates,AE,239,0,9770526,Asia,60999,351
2020-08-04,United_Arab_Emirates,AE,164,0,9770526,Asia,61163,351
2020-08-05,United_Arab_Emirates,AE,189,0,9770526,Asia,61352,351
2020-08-06,United_Arab_Emirates,AE,254,2,9770526,Asia,61606,353
2020-08-07,United_Arab_Emirates,AE,239,1,9770526,Asia,61845,354
2020-08-08,United_Arab_Emirates,AE,216,2,9770526,Asia,62061,356
2020-08-09,United_Arab_Emirates,AE,239,0,9770526,Asia,62300,356
2020-08-10,United_Arab_Emirates,AE,225,1,9770526,Asia,62525,357
2020-08-11,United_Arab_Emirates,AE,179,0,9770526,Asia,62704,357
2020-08-12,United_Arab_Emirates,AE,262,0,9770526,Asia,62966,357
2020-08-13,United_Arab_Emirates,AE,246,0,9770526,Asia,63212,357
2020-08-14,United_Arab_Emirates,AE,277,1,9770526,Asia,63489,358
2020-08-15,United_Arab_Emirates,AE,330,1,9770526,Asia,63819,359
2020-08-16,United_Arab_Emirates,AE,283,2,9770526,Asia,64102,361
2020-08-17,United_Arab_Emirates,AE,210,3,9770526,Asia,64312,364
2020-08-18,United_Arab_Emirates,AE,229,0,9770526,Asia,64541,364
2020-08-19,United_Arab_Emirates,AE,365,2,9770526,Asia,64906,366
2020-08-20,United_Arab_Emirates,AE,435,1,9770526,Asia,65341,367
2020-08-21,United_Arab_Emirates,AE,461,2,9770526,Asia,65802,369
2020-08-22,United_Arab_Emirates,AE,391,1,9770526,Asia,66193,370
2020-08-23,United_Arab_Emirates,AE,424,2,9770526,Asia,66617,372
2020-08-24,United_Arab_Emirates,AE,390,3,9770526,Asia,67007,375
2020-08-25,United_Arab_Emirates,AE,275,1,9770526,Asia,67282,376
2020-08-26,United_Arab_Emirates,AE,339,1,9770526,Asia,67621,377
2020-08-27,United_Arab_Emirates,AE,399,1,9770526,Asia,68020,378
2020-08-28,United_Arab_Emirates,AE,491,0,9770526,Asia,68511,378
2020-08-29,United_Arab_Emirates,AE,390,1,9770526,Asia,68901,379
2020-08-30,United_Arab_Emirates,AE,427,0,9770526,Asia,69328,379
2020-08-31,United_Arab_Emirates,AE,362,3,9770526,Asia,69690,382
2020-09-01,United_Arab_Emirates,AE,541,2,9770526,Asia,70231,384
2020-09-02,United_Arab_Emirates,AE,574,0,9770526,Asia,70805,384
2020-09-03,United_Arab_Emirates,AE,735,3,9770526,Asia,71540,387
2020-09-04,United_Arab_Emirates,AE,614,0,9770526,Asia,72154,387
2020-09-05,United_Arab_Emirates,AE,612,0,9770526,Asia,72766,387
2020-09-06,United_Arab_Emirates,AE,705,1,9770526,Asia,73471,388
2020-09-07,United_Arab_Emirates,AE,513,0,9770526,Asia,73984,388
2020-09-08,United_Arab_Emirates,AE,470,2,9770526,Asia,74454,390
2020-09-09,United_Arab_Emirates,AE,644,1,9770526,Asia,75098,391
2020-09-10,United_Arab_Emirates,AE,883,2,9770526,Asia,75981,393
2020-09-11,United_Arab_Emirates,AE,930,5,9770526,Asia,76911,398
2020-09-12,United_Arab_Emirates,AE,931,0,9770526,Asia,77842,398
2020-09-13,United_Arab_Emirates,AE,1007,1,9770526,Asia,78849,399
2020-09-14,United_Arab_Emirates,AE,640,0,9770526,Asia,79489,399
2020-09-15,United_Arab_Emirates,AE,777,0,9770526,Asia,80266,399
2020-09-16,United_Arab_Emirates,AE,674,2,9770526,Asia,80940,401
2020-09-17,United_Arab_Emirates,AE,842,1,9770526,Asia,81782,402
2020-09-18,United_Arab_Emirates,AE,786,0,9770526,Asia,82568,402
2020-09-19,United_Arab_Emirates,AE,865,1,9770526,Asia,83433,403
2020-09-20,United_Arab_Emirates,AE,809,1,9770526,Asia,84242,404
2020-09-21,United_Arab_Emirates,AE,674,0,9770526,Asia,84916,404
2020-09-22,United_Arab_Emirates,AE,679,1,9770526,Asia,85595,405
2020-09-23,United_Arab_Emirates,AE,852,0,9770526,Asia,86447,405
2020-09-24,United_Arab_Emirates,AE,1083,1,9770526,Asia,87530,406
2020-09-25,United_Arab_Emirates,AE,1002,1,9770526,Asia,88532,407
2020-09-26,United_Arab_Emirates,AE,1008,2,9770526,Asia,89540,409
2020-09-27,United_Arab_Emirates,AE,1078,2,9770526,Asia,90618,411
2020-09-28,United_Arab_Emirates,AE,851,1,9770526,Asia,91469,412
2020-09-29,United_Arab_Emirates,AE,626,1,9770526,Asia,92095,413
2020-09-30,United_Arab_Emirates,AE,995,3,9770526,Asia,93090,416
2020-10-01,United_Arab_Emirates,AE,1100,3,9770526,Asia,94190,419
2020-10-02,United_Arab_Emirates,AE,1158,2,9770526,Asia,95348,421
2020-10-03,United_Arab_Emirates,AE,1181,3,9770526,Asia,96529,424
2020-10-04,United_Arab_Emirates,AE,1231,2,9770526,Asia,97760,426
2020-10-05,United_Arab_Emirates,AE,1041,0,9770526,Asia,98801,426
2020-10-06,United_Arab_Emirates,AE,932,3,9770526,Asia,99733,429
2020-10-07,United_Arab_Emirates,AE,1061,6,9770526,Asia,100794,435
2020-10-08,United_Arab_Emirates,AE,1046,1,9770526,Asia,101840,436
2020-10-09,United_Arab_Emirates,AE,1089,2,9770526,Asia,102929,438
2020-10-10,United_Arab_Emirates,AE,1075,4,9770526,Asia,104004,442
2020-10-11,United_Arab_Emirates,AE,1129,1,9770526,Asia,105133,443
2020-10-12,United_Arab_Emirates,AE,1096,2,9770526,Asia,106229,445
2020-10-13,United_Arab_Emirates,AE,1064,1,9770526,Asia,107293,446
2020-10-14,United_Arab_Emirates,AE,1315,2,9770526,Asia,108608,448
2020-10-15,United_Arab_Emirates,AE,1431,2,9770526,Asia,110039,450
2020-10-16,United_Arab_Emirates,AE,1398,2,9770526,Asia,111437,452
2020-10-17,United_Arab_Emirates,AE,1412,3,9770526,Asia,112849,455
2020-10-18,United_Arab_Emirates,AE,1538,4,9770526,Asia,114387,459
2020-10-19,United_Arab_Emirates,AE,1215,4,9770526,Asia,115602,463
2020-10-20,United_Arab_Emirates,AE,915,3,9770526,Asia,116517,466
2020-10-21,United_Arab_Emirates,AE,1077,4,9770526,Asia,117594,470
2020-10-22,United_Arab_Emirates,AE,1538,2,9770526,Asia,119132,472
2020-10-23,United_Arab_Emirates,AE,1578,2,9770526,Asia,120710,474
2020-10-24,United_Arab_Emirates,AE,1563,1,9770526,Asia,122273,475
2020-10-25,United_Arab_Emirates,AE,1491,0,9770526,Asia,123764,475
2020-10-26,United_Arab_Emirates,AE,1359,2,9770526,Asia,125123,477
2020-10-27,United_Arab_Emirates,AE,1111,3,9770526,Asia,126234,480
2020-10-28,United_Arab_Emirates,AE,1390,2,9770526,Asia,127624,482
2020-10-29,United_Arab_Emirates,AE,1400,3,9770526,Asia,129024,485
2020-10-30,United_Arab_Emirates,AE,1312,3,9770526,Asia,130336,488
2020-10-31,United_Arab_Emirates,AE,1172,2,9770526,Asia,131508,490
2020-11-01,United_Arab_Emirates,AE,1121,5,9770526,Asia,132629,495
2020-11-02,United_Arab_Emirates,AE,1278,1,9770526,Asia,133907,496
2020-11-03,United_Arab_Emirates,AE,1234,1,9770526,Asia,135141,497
2020-11-04,United_Arab_Emirates,AE,1008,6,9770526,Asia,136149,503
2020-11-05,United_Arab_Emirates,AE,1161,2,9770526,Asia,137310,505
2020-11-06,United_Arab_Emirates,AE,1289,3,9770526,Asia,138599,508
2020-11-07,United_Arab_Emirates,AE,1292,2,9770526,Asia,139891,510
2020-11-08,United_Arab_Emirates,AE,1141,4,9770526,Asia,141032,514
2020-11-09,United_Arab_Emirates,AE,1111,0,9770526,Asia,142143,514
2020-11-10,United_Arab_Emirates,AE,1146,1,9770526,Asia,143289,515
2020-11-11,United_Arab_Emirates,AE,1096,3,9770526,Asia,144385,518
2020-11-12,United_Arab_Emirates,AE,1214,2,9770526,Asia,145599,520
2020-11-13,United_Arab_Emirates,AE,1136,3,9770526,Asia,146735,523
2020-11-14,United_Arab_Emirates,AE,1226,5,9770526,Asia,147961,528
2020-11-15,United_Arab_Emirates,AE,1174,0,9770526,Asia,149135,528
2020-11-16,United_Arab_Emirates,AE,1210,2,9770526,Asia,150345,530
2020-11-17,United_Arab_Emirates,AE,1209,4,9770526,Asia,151554,534
2020-11-18,United_Arab_Emirates,AE,1255,4,9770526,Asia,152809,538
2020-11-19,United_Arab_Emirates,AE,1292,4,9770526,Asia,154101,542
2020-11-20,United_Arab_Emirates,AE,1153,2,9770526,Asia,155254,544
2020-11-21,United_Arab_Emirates,AE,1269,3,9770526,Asia,156523,547
2020-11-22,United_Arab_Emirates,AE,1262,1,9770526,Asia,157785,548
2020-11-23,United_Arab_Emirates,AE,1205,4,9770526,Asia,158990,552
2020-11-24,United_Arab_Emirates,AE,1065,2,9770526,Asia,160055,554
2020-11-25,United_Arab_Emirates,AE,1310,5,9770526,Asia,161365,559
2020-11-26,United_Arab_Emirates,AE,1297,4,9770526,Asia,162662,563
2020-11-27,United_Arab_Emirates,AE,1305,1,9770526,Asia,163967,564
2020-11-28,United_Arab_Emirates,AE,1283,3,9770526,Asia,165250,567
2020-11-29,United_Arab_Emirates,AE,1252,2,9770526,Asia,166502,569
2020-11-30,United_Arab_Emirates,AE,1251,1,9770526,Asia,167753,570
2020-12-01,United_Arab_Emirates,AE,1107,2,9770526,Asia,168860,572
2020-12-02,United_Arab_Emirates,AE,1289,4,9770526,Asia,170149,576
2020-12-03,United_Arab_Emirates,AE,1285,4,9770526,Asia,171434,580
2020-12-04,United_Arab_Emirates,AE,1317,5,9770526,Asia,172751,585
2020-12-05,United_Arab_Emirates,AE,1311,1,9770526,Asia,174062,586
2020-12-06,United_Arab_Emirates,AE,1214,3,9770526,Asia,175276,589
2020-12-07,United_Arab_Emirates,AE,1153,3,9770526,Asia,176429,592
2020-12-08,United_Arab_Emirates,AE,1148,2,9770526,Asia,177577,594
2020-12-09,United_Arab_Emirates,AE,1260,2,9770526,Asia,178837,596
2020-12-10,United_Arab_Emirates,AE,1313,2,9770526,Asia,180150,598
2020-12-11,United_Arab_Emirates,AE,1255,4,9770526,Asia,181405,602
2020-12-12,United_Arab_Emirates,AE,1196,5,9770526,Asia,182601,607
2020-12-13,United_Arab_Emirates,AE,1154,2,9770526,Asia,183755,609
2020-12-14,United_Arab_Emirates,AE,1194,8,9770526,Asia,184949,617
2019-12-31,Afghanistan,AF,0,0,38041757,Asia,0,0
2020-01-01,Afghanistan,AF,0,0,38041757,Asia,0,0
2020-01-02,Afghanistan,AF,0,0,38041757,Asia,0,0
2020-01-03,Afghanistan,AF,0,0,38041757,Asia,0,0
2020-01-04,Afghanistan,AF,0,0,38041757,Asia,0,0
2020-01-05,Afghanistan,AF,0,0,38041757,Asia,0,0
2020-01-06,Afghanistan,AF,0,0,38041757,Asia,0,0
2020-01-07,Afghanistan,AF,0,0,38041757,Asia,0,0
2020-01-08,Afghanistan,AF,0,0,38041757,Asia,0,0
2020-01-09,Afghanistan,AF,0,0,38041757,Asia,0,0
2020-01-10,Afghanistan,AF,0,0,38041757,Asia,0,0
2020-01-11,Afghanistan,AF,0,0,38041757,Asia,0,0
2020-01-12,Afghanistan,AF,0,0,38041757,Asia,0,0
2020-01-13,Afghanistan,AF,0,0,38041757,Asia,0,0
2020-01-14,Afghanistan,AF,0,0,38041757,Asia,0,0
2020-01-15,Afghanistan,AF,0,0,38041757,Asia,0,0
2020-01-16,Afghanistan,AF,0,0,38041757,Asia,0,0
2020-01-17,Afghanistan,AF,0,0,38041757,Asia,0,0
2020-01-18,Afghanistan,AF,0,0,38041757,Asia,0,0
2020-01-19,Afghanistan,AF,0,0,38041757,Asia,0,0
2020-01-20,Afghanistan,AF,0,0,38041757,Asia,0,0
2020-01-21,Afghanistan,AF,0,0,38041757,Asia,0,0
2020-01-22,Afghanistan,AF,0,0,38041757,Asia,0,0
2020-01-23,Afghanistan,AF,0,0,38041757,Asia,0,0
2020-01-24,Afghanistan,AF,0,0,38041757,Asia,0,0
2020-01-25,Afghanistan,AF,0,0,38041757,Asia,0,0
2020-01-26,Afghanistan,AF,0,0,38041757,Asia,0,0
2020-01-27,Afghanistan,AF,0,0,38041757,Asia,0,0
2020-01-28,Afghanistan,AF,0,0,38041757,Asia,0,0
2020-01-29,Afghanistan,AF,0,0,38041757,Asia,0,0
2020-01-30,Afghanistan,AF,0,0,38041757,Asia,0,0
2020-01-31,Afghanistan,AF,0,0,38041757,Asia,0,0
2020-02-01,Afghanistan,AF,0,0,38041757,Asia,0,0
2020-02-02,Afghanistan,AF,0,0,38041757,Asia,0,0
2020-02-03,Afghanistan,AF,0,0,38041757,Asia,0,0
2020-02-04,Afghanistan,AF,0,0,38041757,Asia,0,0
2020-02-05,Afghanistan,AF,0,0,38041757,Asia,0,0
2020-02-06,Afghanistan,AF,0,0,38041757,Asia,0,0
2020-02-07,Afghanistan,AF,0,0,38041757,Asia,0,0
2020-02-08,Afghanistan,AF,0,0,38041757,Asia,0,0
2020-02-09,Afghanistan,AF,0,0,38041757,Asia,0,0
2020-02-10,Afghanistan,AF,0,0,38041757,Asia,0,0
2020-02-11,Afghanistan,AF,0,0,38041757,Asia,0,0
2020-02-12,Afghanistan,AF,0,0,38041757,Asia,0,0
2020-02-13,Afghanistan,AF,0,0,38041757,Asia,0,0
2020-02-14,Afghanistan,AF,0,0,38041757,Asia,0,0
2020-02-15,Afghanistan,AF,0,0,38041757,Asia,0,0
2020-02-16,Afghanistan,AF,0,0,38041757,Asia,0,0
2020-02-17,Afghanistan,AF,0,0,38041757,Asia,0,0
2020-02-18,Afghanistan,AF,0,0,38041757,Asia,0,0
2020-02-19,Afghanistan,AF,0,0,38041757,Asia,0,0
2020-02-20,Afghanistan,AF,0,0,38041757,Asia,0,0
2020-02-21,Afghanistan,AF,0,0,38041757,Asia,0,0
2020-02-22,Afghanistan,AF,0,0,38041757,Asia,0,0
2020-02-23,Afghanistan,AF,0,0,38041757,Asia,0,0
2020-02-24,Afghanistan,AF,0,0,38041757,Asia,0,0
2020-02-25,Afghanistan,AF,1,0,38041757,Asia,1,0
2020-02-26,Afghanistan,AF,0,0,38041757,Asia,1,0
2020-02-27,Afghanistan,AF,0,0,38041757,Asia,1,0
2020-02-28,Afghanistan,AF,0,0,38041757,Asia,1,0
2020-02-29,Afghanistan,AF,0,0,38041757,Asia,1,0
2020-03-01,Afghanistan,AF,0,0,38041757,Asia,1,0
2020-03-02,Afghanistan,AF,0,0,38041757,Asia,1,0
2020-03-08,Afghanistan,AF,3,0,38041757,Asia,4,0
2020-03-11,Afghanistan,AF,3,0,38041757,Asia,7,0
2020-03-15,Afghanistan,AF,3,0,38041757,Asia,10,0
2020-03-16,Afghanistan,AF,6,0,38041757,Asia,16,0
2020-03-17,Afghanistan,AF,5,0,38041757,Asia,21,0
2020-03-18,Afghanistan,AF,1,0,38041757,Asia,22,0
2020-03-19,Afghanistan,AF,0,0,38041757,Asia,22,0
2020-03-20,Afghanistan,AF,0,0,38041757,Asia,22,0
2020-03-21,Afghanistan,AF,2,0,38041757,Asia,24,0
2020-03-22,Afghanistan,AF,0,0,38041757,Asia,24,0
2020-03-23,Afghanistan,AF,10,0,38041757,Asia,34,0
2020-03-24,Afghanistan,AF,6,1,38041757,Asia,40,1
2020-03-25,Afghanistan,AF,2,0,38041757,Asia,42,1
2020-03-26,Afghanistan,AF,33,0,38041757,Asia,75,1
2020-03-27,Afghanistan,AF,0,0,38041757,Asia,75,1
2020-03-28,Afghanistan,AF,16,1,38041757,Asia,91,2
2020-03-29,Afghanistan,AF,15,1,38041757,Asia,106,3
2020-03-30,Afghanistan,AF,8,1,38041757,Asia,114,4
2020-03-31,Afghanistan,AF,27,0,38041757,Asia,141,4
2020-04-01,Afghanistan,AF,25,0,38041757,Asia,166,4
2020-04-02,Afghanistan,AF,26,0,38041757,Asia,192,4
2020-04-03,Afghanistan,AF,43,0,38041757,Asia,235,4
2020-04-04,Afghanistan,AF,0,0,38041757,Asia,235,4
2020-04-05,Afghanistan,AF,35,1,38041757,Asia,270,5
2020-04-06,Afghanistan,AF,29,2,38041757,Asia,299,7
2020-04-07,Afghanistan,AF,38,0,38041757,Asia,337,7
2020-04-08,Afghanistan,AF,30,4,38041757,Asia,367,11
2020-04-09,Afghanistan,AF,56,3,38041757,Asia,423,14
2020-04-10,Afghanistan,AF,61,1,38041757,Asia,484,15
2020-04-11,Afghanistan,AF,37,0,38041757,Asia,521,15
2020-04-12,Afghanistan,AF,34,3,38041757,Asia,555,18
2020-04-13,Afghanistan,AF,52,0,38041757,Asia,607,18
2020-04-14,Afghanistan,AF,58,3,38041757,Asia,665,21
2020-04-15,Afghanistan,AF,49,2,38041757,Asia,714,23
2020-04-16,Afghanistan,AF,70,2,38041757,Asia,784,25
2020-04-17,Afghanistan,AF,10,4,38041757,Asia,794,29
2020-04-18,Afghanistan,AF,51,1,38041757,Asia,845,30
2020-04-19,Afghanistan,AF,63,0,38041757,Asia,908,30
2020-04-20,Afghanistan,AF,88,3,38041757,Asia,996,33
2020-04-21,Afghanistan,AF,35,2,38041757,Asia,1031,35
2020-04-22,Afghanistan,AF,61,1,38041757,Asia,1092,36
2020-04-23,Afghanistan,AF,84,4,38041757,Asia,1176,40
2020-04-24,Afghanistan,AF,105,2,38041757,Asia,1281,42
2020-04-25,Afghanistan,AF,70,1,38041757,Asia,1351,43
2020-04-26,Afghanistan,AF,112,4,38041757,Asia,1463,47
2020-04-27,Afghanistan,AF,68,10,38041757,Asia,1531,57
2020-04-28,Afghanistan,AF,172,0,38041757,Asia,1703,57
2020-04-29,Afghanistan,AF,124,3,38041757,Asia,1827,60
2020-04-30,Afghanistan,AF,122,0,38041757,Asia,1949,60
2020-05-01,Afghanistan,AF,222,4,38041757,Asia,2171,64
2020-05-02,Afghanistan,AF,164,4,38041757,Asia,2335,68
2020-05-03,Afghanistan,AF,134,4,38041757,Asia,2469,72
2020-05-04,Afghanistan,AF,235,13,38041757,Asia,2704,85
2020-05-05,Afghanistan,AF,190,5,38041757,Asia,2894,90
2020-05-06,Afghanistan,AF,330,5,38041757,Asia,3224,95
2020-05-07,Afghanistan,AF,168,9,38041757,Asia,3392,104
2020-05-08,Afghanistan,AF,171,2,38041757,Asia,3563,106
2020-05-09,Afghanistan,AF,215,3,38041757,Asia,3778,109
2020-05-10,Afghanistan,AF,255,6,38041757,Asia,4033,115
2020-05-11,Afghanistan,AF,369,5,38041757,Asia,4402,120
2020-05-12,Afghanistan,AF,285,2,38041757,Asia,4687,122
2020-05-13,Afghanistan,AF,280,5,38041757,Asia,4967,127
2020-05-14,Afghanistan,AF,259,3,38041757,Asia,5226,130
2020-05-15,Afghanistan,AF,113,6,38041757,Asia,5339,136
2020-05-16,Afghanistan,AF,1063,32,38041757,Asia,6402,168
2020-05-17,Afghanistan,AF,0,0,38041757,Asia,6402,168
2020-05-18,Afghanistan,AF,262,1,38041757,Asia,6664,169
2020-05-19,Afghanistan,AF,408,4,38041757,Asia,7072,173
2020-05-20,Afghanistan,AF,581,5,38041757,Asia,7653,178
2020-05-21,Afghanistan,AF,492,9,38041757,Asia,8145,187
2020-05-22,Afghanistan,AF,531,6,38041757,Asia,8676,193
2020-05-23,Afghanistan,AF,540,12,38041757,Asia,9216,205
2020-05-24,Afghanistan,AF,782,11,38041757,Asia,9998,216
2020-05-25,Afghanistan,AF,584,2,38041757,Asia,10582,218
2020-05-26,Afghanistan,AF,591,1,38041757,Asia,11173,219
2020-05-27,Afghanistan,AF,658,1,38041757,Asia,11831,220
2020-05-28,Afghanistan,AF,625,7,38041757,Asia,12456,227
2020-05-29,Afghanistan,AF,580,8,38041757,Asia,13036,235
2020-05-30,Afghanistan,AF,623,11,38041757,Asia,13659,246
2020-05-31,Afghanistan,AF,866,3,38041757,Asia,14525,249
2020-06-01,Afghanistan,AF,680,8,38041757,Asia,15205,257
2020-06-02,Afghanistan,AF,545,8,38041757,Asia,15750,265
2020-06-03,Afghanistan,AF,759,5,38041757,Asia,16509,270
2020-06-04,Afghanistan,AF,758,24,38041757,Asia,17267,294
2020-06-05,Afghanistan,AF,787,6,38041757,Asia,18054,300
2020-06-06,Afghanistan,AF,915,9,38041757,Asia,18969,309
2020-06-07,Afghanistan,AF,582,18,38041757,Asia,19551,327
2020-06-08,Afghanistan,AF,791,30,38041757,Asia,20342,357
2020-06-09,Afghanistan,AF,575,12,38041757,Asia,20917,369
2020-06-10,Afghanistan,AF,542,15,38041757,Asia,21459,384
2020-06-11,Afghanistan,AF,684,21,38041757,Asia,22143,405
2020-06-12,Afghanistan,AF,747,21,38041757,Asia,22890,426
2020-06-13,Afghanistan,AF,656,20,38041757,Asia,23546,446
2020-06-14,Afghanistan,AF,556,5,38041757,Asia,24102,451
2020-06-15,Afghanistan,AF,664,20,38041757,Asia,24766,471
2020-06-16,Afghanistan,AF,761,7,38041757,Asia,25527,478
2020-06-17,Afghanistan,AF,783,13,38041757,Asia,26310,491
2020-06-18,Afghanistan,AF,564,13,38041757,Asia,26874,504
2020-06-19,Afghanistan,AF,658,42,38041757,Asia,27532,546
2020-06-20,Afghanistan,AF,346,2,38041757,Asia,27878,548
2020-06-21,Afghanistan,AF,546,21,38041757,Asia,28424,569
2020-06-22,Afghanistan,AF,409,12,38041757,Asia,28833,581
2020-06-23,Afghanistan,AF,310,17,38041757,Asia,29143,598
2020-06-24,Afghanistan,AF,338,20,38041757,Asia,29481,618
2020-06-25,Afghanistan,AF,234,21,38041757,Asia,29715,639
2020-06-26,Afghanistan,AF,460,36,38041757,Asia,30175,675
2020-06-27,Afghanistan,AF,276,8,38041757,Asia,30451,683
2020-06-28,Afghanistan,AF,165,20,38041757,Asia,30616,703
2020-06-29,Afghanistan,AF,351,18,38041757,Asia,30967,721
2020-06-30,Afghanistan,AF,271,12,38041757,Asia,31238,733
2020-07-01,Afghanistan,AF,279,13,38041757,Asia,31517,746
2020-07-02,Afghanistan,AF,319,28,38041757,Asia,31836,774
2020-07-03,Afghanistan,AF,186,33,38041757,Asia,32022,807
2020-07-04,Afghanistan,AF,302,12,38041757,Asia,32324,819
2020-07-05,Afghanistan,AF,348,7,38041757,Asia,32672,826
2020-07-06,Afghanistan,AF,279,38,38041757,Asia,32951,864
2020-07-07,Afghanistan,AF,433,56,38041757,Asia,33384,920
2020-07-08,Afghanistan,AF,210,16,38041757,Asia,33594,936
2020-07-09,Afghanistan,AF,59,1,38041757,Asia,33653,937
2020-07-10,Afghanistan,AF,255,20,38041757,Asia,33908,957
2020-07-11,Afghanistan,AF,458,37,38041757,Asia,34366,994
2020-07-12,Afghanistan,AF,85,16,38041757,Asia,34451,1010
2020-07-13,Afghanistan,AF,0,0,38041757,Asia,34451,1010
2020-07-14,Afghanistan,AF,4,2,38041757,Asia,34455,1012
2020-07-15,Afghanistan,AF,285,33,38041757,Asia,34740,1045
2020-07-16,Afghanistan,AF,254,49,38041757,Asia,34994,1094
2020-07-17,Afghanistan,AF,76,21,38041757,Asia,35070,1115
2020-07-18,Afghanistan,AF,219,32,38041757,Asia,35289,1147
2020-07-19,Afghanistan,AF,12,17,38041757,Asia,35301,1164
2020-07-20,Afghanistan,AF,174,17,38041757,Asia,35475,1181
2020-07-21,Afghanistan,AF,140,5,38041757,Asia,35615,1186
2020-07-22,Afghanistan,AF,112,4,38041757,Asia,35727,1190
2020-07-23,Afghanistan,AF,188,21,38041757,Asia,35915,1211
2020-07-24,Afghanistan,AF,13,0,38041757,Asia,35928,1211
2020-07-25,Afghanistan,AF,108,35,38041757,Asia,36036,1246
2020-07-26,Afghanistan,AF,121,13,38041757,Asia,36157,1259
2020-07-27,Afghanistan,AF,106,10,38041757,Asia,36263,1269
2020-07-28,Afghanistan,AF,105,1,38041757,Asia,36368,1270
2020-07-29,Afghanistan,AF,103,1,38041757,Asia,36471,1271
2020-07-30,Afghanistan,AF,0,0,38041757,Asia,36471,1271
2020-07-31,Afghanistan,AF,71,0,38041757,Asia,36542,1271
2020-08-01,Afghanistan,AF,168,12,38041757,Asia,36710,1283
2020-08-02,Afghanistan,AF,0,0,38041757,Asia,36710,1283
2020-08-03,Afghanistan,AF,0,1,38041757,Asia,36710,1284
2020-08-04,Afghanistan,AF,37,4,38041757,Asia,36747,1288
2020-08-05,Afghanistan,AF,82,6,38041757,Asia,36829,1294
2020-08-06,Afghanistan,AF,67,4,38041757,Asia,36896,1298
2020-08-07,Afghanistan,AF,41,0,38041757,Asia,36937,1298
2020-08-08,Afghanistan,AF,78,9,38041757,Asia,37015,1307
2020-08-09,Afghanistan,AF,39,5,38041757,Asia,37054,1312
2020-08-10,Afghanistan,AF,0,0,38041757,Asia,37054,1312
2020-08-11,Afghanistan,AF,0,0,38041757,Asia,37054,1312
2020-08-12,Afghanistan,AF,215,32,38041757,Asia,37269,1344
2020-08-13,Afghanistan,AF,76,10,38041757,Asia,37345,1354
2020-08-14,Afghanistan,AF,79,9,38041757,Asia,37424,1363
2020-08-15,Afghanistan,AF,7,0,38041757,Asia,37431,1363
2020-08-16,Afghanistan,AF,120,7,38041757,Asia,37551,1370
2020-08-17,Afghanistan,AF,45,5,38041757,Asia,37596,1375
2020-08-18,Afghanistan,AF,3,0,38041757,Asia,37599,1375
2020-08-19,Afghanistan,AF,0,0,38041757,Asia,37599,1375
2020-08-20,Afghanistan,AF,160,8,38041757,Asia,37759,1383
2020-08-21,Afghanistan,AF,97,2,38041757,Asia,37856,1385
2020-08-22,Afghanistan,AF,38,0,38041757,Asia,37894,1385
2020-08-23,Afghanistan,AF,105,2,38041757,Asia,37999,1387
2020-08-24,Afghanistan,AF,0,0,38041757,Asia,37999,1387
2020-08-25,Afghanistan,AF,71,10,38041757,Asia,38070,1397
2020-08-26,Afghanistan,AF,1,0,38041757,Asia,38071,1397
2020-08-27,Afghanistan,AF,55,4,38041757,Asia,38126,1401
2020-08-28,Afghanistan,AF,3,0,38041757,Asia,38129,1401
2020-08-29,Afghanistan,AF,11,1,38041757,Asia,38140,1402
2020-08-30,Afghanistan,AF,3,0,38041757,Asia,38143,1402
2020-08-31,Afghanistan,AF,19,0,38041757,Asia,38162,1402
2020-09-01,Afghanistan,AF,34,4,38041757,Asia,38196,1406
2020-09-02,Afghanistan,AF,9,0,38041757,Asia,38205,1406
2020-09-03,Afghanistan,AF,38,3,38041757,Asia,38243,1409
2020-09-04,Afghanistan,AF,45,1,38041757,Asia,38288,1410
2020-09-05,Afghanistan,AF,16,0,38041757,Asia,38304,1410
2020-09-06,Afghanistan,AF,20,0,38041757,Asia,38324,1410
2020-09-07,Afghanistan,AF,74,2,38041757,Asia,38398,1412
2020-09-08,Afghanistan,AF,96,3,38041757,Asia,38494,1415
2020-09-09,Afghanistan,AF,26,3,38041757,Asia,38520,1418
2020-09-10,Afghanistan,AF,24,2,38041757,Asia,38544,1420
2020-09-11,Afghanistan,AF,28,0,38041757,Asia,38572,1420
2020-09-12,Afghanistan,AF,34,0,38041757,Asia,38606,1420
2020-09-13,Afghanistan,AF,35,0,38041757,Asia,38641,1420
2020-09-14,Afghanistan,AF,75,0,38041757,Asia,38716,1420
2020-09-15,Afghanistan,AF,99,6,38041757,Asia,38815,1426
2020-09-16,Afghanistan,AF,40,10,38041757,Asia,38855,1436
2020-09-17,Afghanistan,AF,17,0,38041757,Asia,38872,1436
2020-09-18,Afghanistan,AF,0,0,38041757,Asia,38872,1436
2020-09-19,Afghanistan,AF,47,1,38041757,Asia,38919,1437
2020-09-20,Afghanistan,AF,125,4,38041757,Asia,39044,1441
2020-09-21,Afghanistan,AF,0,0,38041757,Asia,39044,1441
2020-09-22,Afghanistan,AF,30,3,38041757,Asia,39074,1444
2020-09-23,Afghanistan,AF,71,2,38041757,Asia,39145,1446
2020-09-24,Afghanistan,AF,25,5,38041757,Asia,39170,1451
2020-09-25,Afghanistan,AF,16,0,38041757,Asia,39186,1451
2020-09-26,Afghanistan,AF,6,2,38041757,Asia,39192,1453
2020-09-27,Afghanistan,AF,35,0,38041757,Asia,39227,1453
2020-09-28,Afghanistan,AF,0,0,38041757,Asia,39227,1453
2020-09-29,Afghanistan,AF,12,3,38041757,Asia,39239,1456
2020-09-30,Afghanistan,AF,15,2,38041757,Asia,39254,1458
2020-10-01,Afghanistan,AF,14,0,38041757,Asia,39268,1458
2020-10-02,Afghanistan,AF,17,0,38041757,Asia,39285,1458
2020-10-03,Afghanistan,AF,5,0,38041757,Asia,39290,1458
2020-10-04,Afghanistan,AF,7,4,38041757,Asia,39297,1462
2020-10-05,Afghanistan,AF,44,0,38041757,Asia,39341,1462
2020-10-06,Afghanistan,AF,145,5,38041757,Asia,39486,1467
2020-10-07,Afghanistan,AF,62,2,38041757,Asia,39548,1469
2020-10-08,Afghanistan,AF,68,1,38041757,Asia,39616,1470
2020-10-09,Afghanistan,AF,77,2,38041757,Asia,39693,1472
2020-10-10,Afghanistan,AF,10,1,38041757,Asia,39703,1473
2020-10-11,Afghanistan,AF,0,0,38041757,Asia,39703,1473
2020-10-12,Afghanistan,AF,96,4,38041757,Asia,39799,1477
2020-10-13,Afghanistan,AF,129,3,38041757,Asia,39928,1480
2020-10-14,Afghanistan,AF,66,0,38041757,Asia,39994,1480
2020-10-15,Afghanistan,AF,32,1,38041757,Asia,40026,1481
2020-10-16,Afghanistan,AF,0,0,38041757,Asia,40026,1481
2020-10-17,Afghanistan,AF,47,4,38041757,Asia,40073,1485
2020-10-18,Afghanistan,AF,68,3,38041757,Asia,40141,1488
2020-10-19,Afghanistan,AF,59,4,38041757,Asia,40200,1492
2020-10-20,Afghanistan,AF,87,5,38041757,Asia,40287,1497
2020-10-21,Afghanistan,AF,88,2,38041757,Asia,40375,1499
2020-10-22,Afghanistan,AF,135,2,38041757,Asia,40510,1501
2020-10-23,Afghanistan,AF,116,4,38041757,Asia,40626,1505
2020-10-24,Afghanistan,AF,61,2,38041757,Asia,40687,1507
2020-10-25,Afghanistan,AF,81,4,38041757,Asia,40768,1511
2020-10-26,Afghanistan,AF,65,3,38041757,Asia,40833,1514
2020-10-27,Afghanistan,AF,199,8,38041757,Asia,41032,1522
2020-10-28,Afghanistan,AF,113,7,38041757,Asia,41145,1529
2020-10-29,Afghanistan,AF,0,0,38041757,Asia,41145,1529
2020-10-30,Afghanistan,AF,123,3,38041757,Asia,41268,1532
2020-10-31,Afghanistan,AF,157,4,38041757,Asia,41425,1536
2020-11-01,Afghanistan,AF,76,0,38041757,Asia,41501,1536
2020-11-02,Afghanistan,AF,132,5,38041757,Asia,41633,1541
2020-11-03,Afghanistan,AF,95,3,38041757,Asia,41728,1544
2020-11-04,Afghanistan,AF,86,4,38041757,Asia,41814,1548
2020-11-05,Afghanistan,AF,121,6,38041757,Asia,41935,1554
2020-11-06,Afghanistan,AF,40,0,38041757,Asia,41975,1554
2020-11-07,Afghanistan,AF,58,2,38041757,Asia,42033,1556
2020-11-08,Afghanistan,AF,126,6,38041757,Asia,42159,1562
2020-11-09,Afghanistan,AF,80,3,38041757,Asia,42239,1565
2020-11-10,Afghanistan,AF,224,12,38041757,Asia,42463,1577
2020-11-11,Afghanistan,AF,0,0,38041757,Asia,42463,1577
2020-11-12,Afghanistan,AF,146,4,38041757,Asia,42609,1581
2020-11-13,Afghanistan,AF,360,14,38041757,Asia,42969,1595
2020-11-14,Afghanistan,AF,66,10,38041757,Asia,43035,1605
2020-11-15,Afghanistan,AF,205,12,38041757,Asia,43240,1617
2020-11-16,Afghanistan,AF,163,9,38041757,Asia,43403,1626
2020-11-17,Afghanistan,AF,65,6,38041757,Asia,43468,1632
2020-11-18,Afghanistan,AF,383,13,38041757,Asia,43851,1645
2020-11-19,Afghanistan,AF,0,0,38041757,Asia,43851,1645
2020-11-20,Afghanistan,AF,282,5,38041757,Asia,44133,1650
2020-11-21,Afghanistan,AF,232,25,38041757,Asia,44365,1675
2020-11-22,Afghanistan,AF,154,12,38041757,Asia,44519,1687
2020-11-23,Afghanistan,AF,252,8,38041757,Asia,44771,1695
2020-11-24,Afghanistan,AF,246,17,38041757,Asia,45017,1712
2020-11-25,Afghanistan,AF,185,13,38041757,Asia,45202,1725
2020-11-26,Afghanistan,AF,200,12,38041757,Asia,45402,1737
2020-11-27,Afghanistan,AF,0,0,38041757,Asia,45402,1737
2020-11-28,Afghanistan,AF,214,15,38041757,Asia,45616,1752
2020-11-29,Afghanistan,AF,228,11,38041757,Asia,45844,1763
2020-11-30,Afghanistan,AF,0,0,38041757,Asia,45844,1763
2020-12-01,Afghanistan,AF,272,11,38041757,Asia,46116,1774
2020-12-02,Afghanistan,AF,400,48,38041757,Asia,46516,1822
2020-12-03,Afghanistan,AF,202,19,38041757,Asia,46718,1841
2020-12-04,Afghanistan,AF,119,5,38041757,Asia,46837,1846
2020-12-05,Afghanistan,AF,235,18,38041757,Asia,47072,1864
2020-12-06,Afghanistan,AF,234,10,38041757,Asia,47306,1874
2020-12-07,Afghanistan,AF,210,26,38041757,Asia,47516,1900
2020-12-08,Afghanistan,AF,200,6,38041757,Asia,47716,1906
2020-12-09,Afghanistan,AF,135,13,38041757,Asia,47851,1919
2020-12-10,Afghanistan,AF,202,16,38041757,Asia,48053,1935
2020-12-11,Afghanistan,AF,63,10,38041757,Asia,48116,1945
2020-12-12,Afghanistan,AF,113,11,38041757,Asia,48229,1956
2020-12-13,Afghanistan,AF,298,9,38041757,Asia,48527,1965
2020-12-14,Afghanistan,AF,746,6,38041757,Asia,49273,1971
2020-03-15,Antigua_and_Barbuda,AG,1,0,97115,America,1,0
2020-03-21,Antigua_and_Barbuda,AG,0,0,97115,America,1,0
2020-03-22,Antigua_and_Barbuda,AG,0,0,97115,America,1,0
2020-03-23,Antigua_and_Barbuda,AG,0,0,97115,America,1,0
2020-03-24,Antigua_and_Barbuda,AG,0,0,97115,America,1,0
2020-03-25,Antigua_and_Barbuda,AG,2,0,97115,America,3,0
2020-03-26,Antigua_and_Barbuda,AG,0,0,97115,America,3,0
2020-03-27,Antigua_and_Barbuda,AG,4,0,97115,America,7,0
2020-03-28,Antigua_and_Barbuda,AG,0,0,97115,America,7,0
2020-03-29,Antigua_and_Barbuda,AG,0,0,97115,America,7,0
2020-03-30,Antigua_and_Barbuda,AG,0,0,97115,America,7,0
2020-03-31,Antigua_and_Barbuda,AG,0,0,97115,America,7,0
2020-04-01,Antigua_and_Barbuda,AG,0,0,97115,America,7,0
2020-04-02,Antigua_and_Barbuda,AG,0,0,97115,America,7,0
2020-04-03,Antigua_and_Barbuda,AG,2,0,97115,America,9,0
2020-04-04,Antigua_and_Barbuda,AG,6,0,97115,America,15,0
2020-04-05,Antigua_and_Barbuda,AG,0,0,97115,America,15,0
2020-04-06,Antigua_and_Barbuda,AG,0,0,97115,America,15,0
2020-04-07,Antigua_and_Barbuda,AG,0,0,97115,America,15,0
2020-04-08,Antigua_and_Barbuda,AG,0,0,97115,America,15,0
2020-04-09,Antigua_and_Barbuda,AG,0,0,97115,America,15,0
2020-04-10,Antigua_and_Barbuda,AG,4,2,97115,America,19,2
2020-04-11,Antigua_and_Barbuda,AG,2,0,97115,America,21,2
2020-04-12,Antigua_and_Barbuda,AG,0,0,97115,America,21,2
2020-04-13,Antigua_and_Barbuda,AG,0,0,97115,America,21,2
2020-04-14,Antigua_and_Barbuda,AG,2,0,97115,America,23,2
2020-04-15,Antigua_and_Barbuda,AG,0,0,97115,America,23,2
2020-04-16,Antigua_and_Barbuda,AG,0,0,97115,America,23,2
2020-04-17,Antigua_and_Barbuda,AG,0,0,97115,America,23,2
2020-04-18,Antigua_and_Barbuda,AG,0,0,97115,America,23,2
2020-04-19,Antigua_and_Barbuda,AG,0,0,97115,America,23,2
2020-04-20,Antigua_and_Barbuda,AG,0,0,97115,America,23,2
2020-04-21,Antigua_and_Barbuda,AG,0,1,97115,America,23,3
2020-04-22,Antigua_and_Barbuda,AG,1,0,97115,America,24,3
2020-04-23,Antigua_and_Barbuda,AG,0,0,97115,America,24,3
2020-04-24,Antigua_and_Barbuda,AG,0,0,97115,America,24,3
2020-04-25,Antigua_and_Barbuda,AG,0,0,97115,America,24,3
2020-04-26,Antigua_and_Barbuda,AG,0,0,97115,America,24,3
2020-04-27,Antigua_and_Barbuda,AG,0,0,97115,America,24,3
2020-04-28,Antigua_and_Barbuda,AG,0,0,97115,America,24,3
2020-04-29,Antigua_and_Barbuda,AG,0,0,97115,America,24,3
2020-04-30,Antigua_and_Barbuda,AG,0,0,97115,America,24,3
2020-05-01,Antigua_and_Barbuda,AG,0,0,97115,America,24,3
2020-05-02,Antigua_and_Barbuda,AG,1,0,97115,America,25,3
2020-05-03,Antigua_and_Barbuda,AG,0,0,97115,America,25,3
2020-05-04,Antigua_and_Barbuda,AG,0,0,97115,America,25,3
2020-05-05,Antigua_and_Barbuda,AG,0,0,97115,America,25,3
2020-05-06,Antigua_and_Barbuda,AG,0,0,97115,America,25,3
2020-05-07,Antigua_and_Barbuda,AG,0,0,97115,America,25,3
2020-05-08,Antigua_and_Barbuda,AG,0,0,97115,America,25,3
2020-05-09,Antigua_and_Barbuda,AG,0,0,97115,America,25,3
2020-05-10,Antigua_and_Barbuda,AG,0,0,97115,America,25,3
2020-05-11,Antigua_and_Barbuda,AG,0,0,97115,America,25,3
2020-05-12,Antigua_and_Barbuda,AG,0,0,97115,America,25,3
2020-05-13,Antigua_and_Barbuda,AG,0,0,97115,America,25,3
2020-05-14,Antigua_and_Barbuda,AG,0,0,97115,America,25,3
2020-05-15,Antigua_and_Barbuda,AG,0,0,97115,America,25,3
2020-05-16,Antigua_and_Barbuda,AG,0,0,97115,America,25,3
2020-05-17,Antigua_and_Barbuda,AG,0,0,97115,America,25,3
2020-05-18,Antigua_and_Barbuda,AG,0,0,97115,America,25,3
2020-05-19,Antigua_and_Barbuda,AG,0,0,97115,America,25,3
2020-05-20,Antigua_and_Barbuda,AG,0,0,97115,America,25,3
2020-05-21,Antigua_and_Barbuda,AG,0,0,97115,America,25,3
2020-05-22,Antigua_and_Barbuda,AG,0,0,97115,America,25,3
2020-05-23,Antigua_and_Barbuda,AG,0,0,97115,America,25,3
2020-05-24,Antigua_and_Barbuda,AG,0,0,97115,America,25,3
2020-05-25,Antigua_and_Barbuda,AG,0,0,97115,America,25,3
2020-05-26,Antigua_and_Barbuda,AG,0,0,97115,America,25,3
2020-05-27,Antigua_and_Barbuda,AG,0,0,97115,America,25,3
2020-05-28,Antigua_and_Barbuda,AG,0,0,97115,America,25,3
2020-05-29,Antigua_and_Barbuda,AG,0,0,97115,America,25,3
2020-05-30,Antigua_and_Barbuda,AG,0,0,97115,America,25,3
2020-05-31,Antigua_and_Barbuda,AG,0,0,97115,America,25,3
2020-06-01,Antigua_and_Barbuda,AG,0,0,97115,America,25,3
2020-06-02,Antigua_and_Barbuda,AG,0,0,97115,America,25,3
2020-06-03,Antigua_and_Barbuda,AG,0,0,97115,America,25,3
2020-06-04,Antigua_and_Barbuda,AG,1,0,97115,America,26,3
2020-06-05,Antigua_and_Barbuda,AG,0,0,97115,America,26,3
2020-06-06,Antigua_and_Barbuda,AG,0,0,97115,America,26,3
2020-06-07,Antigua_and_Barbuda,AG,0,0,97115,America,26,3
2020-06-08,Antigua_and_Barbuda,AG,0,0,97115,America,26,3
2020-06-09,Antigua_and_Barbuda,AG,0,0,97115,America,26,3
2020-06-10,Antigua_and_Barbuda,AG,0,0,97115,America,26,3
2020-06-11,Antigua_and_Barbuda,AG,0,0,97115,America,26,3
2020-06-12,Antigua_and_Barbuda,AG,0,0,97115,America,26,3
2020-06-13,Antigua_and_Barbuda,AG,0,0,97115,America,26,3
2020-06-14,Antigua_and_Barbuda,AG,0,0,97115,America,26,3
2020-06-15,Antigua_and_Barbuda,AG,0,0,97115,America,26,3
2020-06-16,Antigua_and_Barbuda,AG,0,0,97115,America,26,3
2020-06-17,Antigua_and_Barbuda,AG,0,0,97115,America,26,3
2020-06-18,Antigua_and_Barbuda,AG,0,0,97115,America,26,3
2020-06-19,Antigua_and_Barbuda,AG,0,0,97115,America,26,3
2020-06-20,Antigua_and_Barbuda,AG,0,0,97115,America,26,3
2020-06-21,Antigua_and_Barbuda,AG,0,0,97115,America,26,3
2020-06-22,Antigua_and_Barbuda,AG,0,0,97115,America,26,3
2020-06-23,Antigua_and_Barbuda,AG,0,0,97115,America,26,3
2020-06-24,Antigua_and_Barbuda,AG,0,0,97115,America,26,3
2020-06-25,Antigua_and_Barbuda,AG,39,0,97115,America,65,3
2020-06-26,Antigua_and_Barbuda,AG,0,0,97115,America,65,3
2020-06-27,Antigua_and_Barbuda,AG,0,0,97115,America,65,3
2020-06-28,Antigua_and_Barbuda,AG,0,0,97115,America,65,3
2020-06-29,Antigua_and_Barbuda,AG,0,0,97115,America,65,3
2020-06-30,Antigua_and_Barbuda,AG,1,0,97115,America,66,3
2020-07-01,Antigua_and_Barbuda,AG,0,0,97115,America,66,3
2020-07-02,Antigua_and_Barbuda,AG,0,0,97115,America,66,3
2020-07-03,Antigua_and_Barbuda,AG,2,0,97115,America,68,3
2020-07-04,Antigua_and_Barbuda,AG,0,0,97115,America,68,3
2020-07-05,Antigua_and_Barbuda,AG,0,0,97115,America,68,3
2020-07-06,Antigua_and_Barbuda,AG,0,0,97115,America,68,3
2020-07-07,Antigua_and_Barbuda,AG,2,0,97115,America,70,3
2020-07-08,Antigua_and_Barbuda,AG,0,0,97115,America,70,3
2020-07-09,Antigua_and_Barbuda,AG,3,0,97115,America,73,3
2020-07-10,Antigua_and_Barbuda,AG,0,0,97115,America,73,3
2020-07-11,Antigua_and_Barbuda,AG,1,0,97115,America,74,3
2020-07-12,Antigua_and_Barbuda,AG,0,0,97115,America,74,3
2020-07-13,Antigua_and_Barbuda,AG,0,0,97115,America,74,3
2020-07-14,Antigua_and_Barbuda,AG,0,0,97115,America,74,3
2020-07-15,Antigua_and_Barbuda,AG,0,0,97115,America,74,3
2020-07-16,Antigua_and_Barbuda,AG,0,0,97115,America,74,3
2020-07-17,Antigua_and_Barbuda,AG,0,0,97115,America,74,3
2020-07-18,Antigua_and_Barbuda,AG,2,0,97115,America,76,3
2020-07-19,Antigua_and_Barbuda,AG,0,0,97115,America,76,3
2020-07-20,Antigua_and_Barbuda,AG,0,0,97115,America,76,3
2020-07-21,Antigua_and_Barbuda,AG,0,0,97115,America,76,3
2020-07-22,Antigua_and_Barbuda,AG,0,0,97115,America,76,3
2020-07-23,Antigua_and_Barbuda,AG,0,0,97115,America,76,3
2020-07-24,Antigua_and_Barbuda,AG,0,0,97115,America,76,3
2020-07-25,Antigua_and_Barbuda,AG,6,0,97115,America,82,3
2020-07-26,Antigua_and_Barbuda,AG,0,0,97115,America,82,3
2020-07-27,Antigua_and_Barbuda,AG,0,0,97115,America,82,3
2020-07-28,Antigua_and_Barbuda,AG,4,0,97115,America,86,3
2020-07-29,Antigua_and_Barbuda,AG,0,0,97115,America,86,3
2020-07-30,Antigua_and_Barbuda,AG,5,0,97115,America,91,3
2020-07-31,Antigua_and_Barbuda,AG,0,0,97115,America,91,3
2020-08-01,Antigua_and_Barbuda,AG,0,0,97115,America,91,3
2020-08-02,Antigua_and_Barbuda,AG,0,0,97115,America,91,3
2020-08-03,Antigua_and_Barbuda,AG,0,0,97115,America,91,3
2020-08-04,Antigua_and_Barbuda,AG,1,0,97115,America,92,3
2020-08-05,Antigua_and_Barbuda,AG,0,0,97115,America,92,3
2020-08-06,Antigua_and_Barbuda,AG,0,0,97115,America,92,3
2020-08-07,Antigua_and_Barbuda,AG,0,0,97115,America,92,3
2020-08-08,Antigua_and_Barbuda,AG,0,0,97115,America,92,3
2020-08-09,Antigua_and_Barbuda,AG,0,0,97115,America,92,3
2020-08-10,Antigua_and_Barbuda,AG,0,0,97115,America,92,3
2020-08-11,Antigua_and_Barbuda,AG,0,0,97115,America,92,3
2020-08-12,Antigua_and_Barbuda,AG,0,0,97115,America,92,3
2020-08-13,Antigua_and_Barbuda,AG,0,0,97115,America,92,3
2020-08-14,Antigua_and_Barbuda,AG,1,0,97115,America,93,3
2020-08-15,Antigua_and_Barbuda,AG,0,0,97115,America,93,3
2020-08-16,Antigua_and_Barbuda,AG,0,0,97115,America,93,3
2020-08-17,Antigua_and_Barbuda,AG,0,0,97115,America,93,3
2020-08-18,Antigua_and_Barbuda,AG,0,0,97115,America,93,3
2020-08-19,Antigua_and_Barbuda,AG,0,0,97115,America,93,3
2020-08-20,Antigua_and_Barbuda,AG,1,0,97115,America,94,3
2020-08-21,Antigua_and_Barbuda,AG,0,0,97115,America,94,3
2020-08-22,Antigua_and_Barbuda,AG,0,0,97115,America,94,3
2020-08-23,Antigua_and_Barbuda,AG,0,0,97115,America,94,3
2020-08-24,Antigua_and_Barbuda,AG,0,0,97115,America,94,3
2020-08-25,Antigua_and_Barbuda,AG,0,0,97115,America,94,3
2020-08-26,Antigua_and_Barbuda,AG,0,0,97115,America,94,3
2020-08-27,Antigua_and_Barbuda,AG,0,0,97115,America,94,3
2020-08-28,Antigua_and_Barbuda,AG,0,0,97115,America,94,3
2020-08-29,Antigua_and_Barbuda,AG,0,0,97115,America,94,3
2020-08-30,Antigua_and_Barbuda,AG,0,0,97115,America,94,3
2020-08-31,Antigua_and_Barbuda,AG,0,0,97115,America,94,3
2020-09-01,Antigua_and_Barbuda,AG,0,0,97115,America,94,3
2020-09-02,Antigua_and_Barbuda,AG,0,0,97115,America,94,3
2020-09-03,Antigua_and_Barbuda,AG,0,0,97115,America,94,3
2020-09-04,Antigua_and_Barbuda,AG,1,0,97115,America,95,3
2020-09-05,Antigua_and_Barbuda,AG,0,0,97115,America,95,3
2020-09-06,Antigua_and_Barbuda,AG,0,0,97115,America,95,3
2020-09-07,Antigua_and_Barbuda,AG,0,0,97115,America,95,3
2020-09-08,Antigua_and_Barbuda,AG,0,0,97115,America,95,3
2020-09-09,Antigua_and_Barbuda,AG,0,0,97115,America,95,3
2020-09-10,Antigua_and_Barbuda,AG,0,0,97115,America,95,3
2020-09-11,Antigua_and_Barbuda,AG,0,0,97115,America,95,3
2020-09-12,Antigua_and_Barbuda,AG,0,0,97115,America,95,3
2020-09-13,Antigua_and_Barbuda,AG,0,0,97115,America,95,3
2020-09-14,Antigua_and_Barbuda,AG,0,0,97115,America,95,3
2020-09-15,Antigua_and_Barbuda,AG,0,0,97115,America,95,3
2020-09-16,Antigua_and_Barbuda,AG,0,0,97115,America,95,3
2020-09-17,Antigua_and_Barbuda,AG,0,0,97115,America,95,3
2020-09-18,Antigua_and_Barbuda,AG,0,0,97115,America,95,3
2020-09-19,Antigua_and_Barbuda,AG,0,0,97115,America,95,3
2020-09-20,Antigua_and_Barbuda,AG,1,0,97115,America,96,3
2020-09-21,Antigua_and_Barbuda,AG,0,0,97115,America,96,3
2020-09-22,Antigua_and_Barbuda,AG,0,0,97115,America,96,3
2020-09-23,Antigua_and_Barbuda,AG,0,0,97115,America,96,3
2020-09-24,Antigua_and_Barbuda,AG,1,0,97115,America,97,3
2020-09-25,Antigua_and_Barbuda,AG,1,0,97115,America,98,3
2020-09-26,Antigua_and_Barbuda,AG,0,0,97115,America,98,3
2020-09-27,Antigua_and_Barbuda,AG,3,0,97115,America,101,3
2020-09-28,Antigua_and_Barbuda,AG,0,0,97115,America,101,3
2020-09-29,Antigua_and_Barbuda,AG,0,0,97115,America,101,3
2020-09-30,Antigua_and_Barbuda,AG,0,0,97115,America,101,3
2020-10-01,Antigua_and_Barbuda,AG,0,0,97115,America,101,3
2020-10-02,Antigua_and_Barbuda,AG,5,0,97115,America,106,3
2020-10-03,Antigua_and_Barbuda,AG,0,0,97115,America,106,3
2020-10-04,Antigua_and_Barbuda,AG,1,0,97115,America,107,3
2020-10-05,Antigua_and_Barbuda,AG,0,0,97115,America,107,3
2020-10-06,Antigua_and_Barbuda,AG,0,0,97115,America,107,3
2020-10-07,Antigua_and_Barbuda,AG,1,0,97115,America,108,3
2020-10-08,Antigua_and_Barbuda,AG,0,0,97115,America,108,3
2020-10-09,Antigua_and_Barbuda,AG,3,0,97115,America,111,3
2020-10-10,Antigua_and_Barbuda,AG,0,0,97115,America,111,3
2020-10-11,Antigua_and_Barbuda,AG,0,0,97115,America,111,3
2020-10-12,Antigua_and_Barbuda,AG,0,0,97115,America,111,3
2020-10-13,Antigua_and_Barbuda,AG,0,0,97115,America,111,3
2020-10-14,Antigua_and_Barbuda,AG,0,0,97115,America,111,3
2020-10-15,Antigua_and_Barbuda,AG,1,0,97115,America,112,3
2020-10-16,Antigua_and_Barbuda,AG,0,0,97115,America,112,3
2020-10-17,Antigua_and_Barbuda,AG,0,0,97115,America,112,3
2020-10-18,Antigua_and_Barbuda,AG,7,0,97115,America,119,3
2020-10-19,Antigua_and_Barbuda,AG,0,0,97115,America,119,3
2020-10-20,Antigua_and_Barbuda,AG,0,0,97115,America,119,3
2020-10-21,Antigua_and_Barbuda,AG,0,0,97115,America,119,3
2020-10-22,Antigua_and_Barbuda,AG,3,0,97115,America,122,3
2020-10-23,Antigua_and_Barbuda,AG,0,0,97115,America,122,3
2020-10-24,Antigua_and_Barbuda,AG,0,0,97115,America,122,3
2020-10-25,Antigua_and_Barbuda,AG,2,0,97115,America,124,3
2020-10-26,Antigua_and_Barbuda,AG,0,0,97115,America,124,3
2020-10-27,Antigua_and_Barbuda,AG,0,0,97115,America,124,3
2020-10-28,Antigua_and_Barbuda,AG,0,0,97115,America,124,3
2020-10-29,Antigua_and_Barbuda,AG,0,0,97115,America,124,3
2020-10-30,Antigua_and_Barbuda,AG,0,0,97115,America,124,3
2020-10-31,Antigua_and_Barbuda,AG,3,0,97115,America,127,3
2020-11-01,Antigua_and_Barbuda,AG,1,0,97115,America,128,3
2020-11-02,Antigua_and_Barbuda,AG,0,0,97115,America,128,3
2020-11-03,Antigua_and_Barbuda,AG,0,0,97115,America,128,3
2020-11-04,Antigua_and_Barbuda,AG,2,0,97115,America,130,3
2020-11-05,Antigua_and_Barbuda,AG,0,0,97115,America,130,3
2020-11-06,Antigua_and_Barbuda,AG,0,0,97115,America,130,3
2020-11-07,Antigua_and_Barbuda,AG,0,0,97115,America,130,3
2020-11-08,Antigua_and_Barbuda,AG,1,0,97115,America,131,3
2020-11-09,Antigua_and_Barbuda,AG,0,0,97115,America,131,3
2020-11-10,Antigua_and_Barbuda,AG,0,0,97115,America,131,3
2020-11-11,Antigua_and_Barbuda,AG,0,0,97115,America,131,3
2020-11-12,Antigua_and_Barbuda,AG,0,0,97115,America,131,3
2020-11-13,Antigua_and_Barbuda,AG,0,0,97115,America,131,3
2020-11-14,Antigua_and_Barbuda,AG,2,1,97115,America,133,4
2020-11-15,Antigua_and_Barbuda,AG,1,0,97115,America,134,4
2020-11-16,Antigua_and_Barbuda,AG,0,0,97115,America,134,4
2020-11-17,Antigua_and_Barbuda,AG,0,0,97115,America,134,4
2020-11-18,Antigua_and_Barbuda,AG,0,0,97115,America,134,4
2020-11-19,Antigua_and_Barbuda,AG,5,0,97115,America,139,4
2020-11-20,Antigua_and_Barbuda,AG,0,0,97115,America,139,4
2020-11-21,Antigua_and_Barbuda,AG,0,0,97115,America,139,4
2020-11-22,Antigua_and_Barbuda,AG,0,0,97115,America,139,4
2020-11-23,Antigua_and_Barbuda,AG,0,0,97115,America,139,4
2020-11-24,Antigua_and_Barbuda,AG,0,0,97115,America,139,4
2020-11-25,Antigua_and_Barbuda,AG,1,0,97115,America,140,4
2020-11-26,Antigua_and_Barbuda,AG,0,0,97115,America,140,4
2020-11-27,Antigua_and_Barbuda,AG,1,0,97115,America,141,4
2020-11-28,Antigua_and_Barbuda,AG,0,0,97115,America,141,4
2020-11-29,Antigua_and_Barbuda,AG,0,0,97115,America,141,4
2020-11-30,Antigua_and_Barbuda,AG,0,0,97115,America,141,4
2020-12-01,Antigua_and_Barbuda,AG,0,0,97115,America,141,4
2020-12-02,Antigua_and_Barbuda,AG,1,0,97115,America,142,4
2020-12-03,Antigua_and_Barbuda,AG,2,0,97115,America,144,4
2020-12-04,Antigua_and_Barbuda,AG,0,0,97115,America,144,4
2020-12-05,Antigua_and_Barbuda,AG,0,0,97115,America,144,4
2020-12-06,Antigua_and_Barbuda,AG,0,0,97115,America,144,4
2020-12-07,Antigua_and_Barbuda,AG,2,0,97115,America,146,4
2020-12-08,Antigua_and_Barbuda,AG,0,0,97115,America,146,4
2020-12-09,Antigua_and_Barbuda,AG,0,0,97115,America,146,4
2020-12-10,Antigua_and_Barbuda,AG,0,0,97115,America,146,4
2020-12-11,Antigua_and_Barbuda,AG,0,0,97115,America,146,4
2020-12-12,Antigua_and_Barbuda,AG,1,0,97115,America,147,4
2020-12-13,Antigua_and_Barbuda,AG,1,0,97115,America,148,4
2020-12-14,Antigua_and_Barbuda,AG,0,0,97115,America,148,4
2020-03-27,Anguilla,AI,2,0,14872,America,2,0
2020-03-28,Anguilla,AI,0,0,14872,America,2,0
2020-03-29,Anguilla,AI,0,0,14872,America,2,0
2020-03-30,Anguilla,AI,0,0,14872,America,2,0
2020-03-31,Anguilla,AI,0,0,14872,America,2,0
2020-04-01,Anguilla,AI,0,0,14872,America,2,0
2020-04-02,Anguilla,AI,0,0,14872,America,2,0
2020-04-03,Anguilla,AI,1,0,14872,America,3,0
2020-04-04,Anguilla,AI,0,0,14872,America,3,0
2020-04-05,Anguilla,AI,0,0,14872,America,3,0
2020-04-06,Anguilla,AI,0,0,14872,America,3,0
2020-04-07,Anguilla,AI,0,0,14872,America,3,0
2020-04-08,Anguilla,AI,0,0,14872,America,3,0
2020-04-09,Anguilla,AI,0,0,14872,America,3,0
2020-04-10,Anguilla,AI,0,0,14872,America,3,0
2020-04-11,Anguilla,AI,0,0,14872,America,3,0
2020-04-12,Anguilla,AI,0,0,14872,America,3,0
2020-04-13,Anguilla,AI,0,0,14872,America,3,0
2020-04-14,Anguilla,AI,0,0,14872,America,3,0
2020-04-15,Anguilla,AI,0,0,14872,America,3,0
2020-04-16,Anguilla,AI,0,0,14872,America,3,0
2020-04-17,Anguilla,AI,0,0,14872,America,3,0
2020-04-18,Anguilla,AI,0,0,14872,America,3,0
2020-04-19,Anguilla,AI,0,0,14872,America,3,0
2020-04-20,Anguilla,AI,0,0,14872,America,3,0
2020-04-21,Anguilla,AI,0,0,14872,America,3,0
2020-04-22,Anguilla,AI,0,0,14872,America,3,0
2020-04-23,Anguilla,AI,0,0,14872,America,3,0
2020-04-24,Anguilla,AI,0,0,14872,America,3,0
2020-04-25,Anguilla,AI,0,0,14872,America,3,0
2020-04-26,Anguilla,AI,0,0,14872,America,3,0
2020-04-27,Anguilla,AI,0,0,14872,America,3,0
2020-04-28,Anguilla,AI,0,0,14872,America,3,0
2020-04-29,Anguilla,AI,0,0,14872,America,3,0
2020-04-30,Anguilla,AI,0,0,14872,America,3,0
2020-05-01,Anguilla,AI,0,0,14872,America,3,0
2020-05-02,Anguilla,AI,0,0,14872,America,3,0
2020-05-03,Anguilla,AI,0,0,14872,America,3,0
2020-05-04,Anguilla,AI,0,0,14872,America,3,0
2020-05-05,Anguilla,AI,0,0,14872,America,3,0
2020-05-06,Anguilla,AI,0,0,14872,America,3,0
2020-05-07,Anguilla,AI,0,0,14872,America,3,0
2020-05-08,Anguilla,AI,0,0,14872,America,3,0
2020-05-09,Anguilla,AI,0,0,14872,America,3,0
2020-05-10,Anguilla,AI,0,0,14872,America,3,0
2020-05-11,Anguilla,AI,0,0,14872,America,3,0
2020-05-12,Anguilla,AI,0,0,14872,America,3,0
2020-05-13,Anguilla,AI,0,0,14872,America,3,0
2020-05-14,Anguilla,AI,0,0,14872,America,3,0
2020-05-15,Anguilla,AI,0,0,14872,America,3,0
2020-05-16,Anguilla,AI,0,0,14872,America,3,0
2020-05-17,Anguilla,AI,0,0,14872,America,3,0
2020-05-18,Anguilla,AI,0,0,14872,America,3,0
2020-05-19,Anguilla,AI,0,0,14872,America,3,0
2020-05-20,Anguilla,AI,0,0,14872,America,3,0
2020-05-21,Anguilla,AI,0,0,14872,America,3,0
2020-05-22,Anguilla,AI,0,0,14872,America,3,0
2020-05-23,Anguilla,AI,0,0,14872,America,3,0
2020-05-24,Anguilla,AI,0,0,14872,America,3,0
2020-05-25,Anguilla,AI,0,0,14872,America,3,0
2020-05-26,Anguilla,AI,0,0,14872,America,3,0
2020-05-27,Anguilla,AI,0,0,14872,America,3,0
2020-05-28,Anguilla,AI,0,0,14872,America,3,0
2020-05-29,Anguilla,AI,0,0,14872,America,3,0
2020-05-30,Anguilla,AI,0,0,14872,America,3,0
2020-05-31,Anguilla,AI,0,0,14872,America,3,0
2020-06-01,Anguilla,AI,0,0,14872,America,3,0
2020-06-02,Anguilla,AI,0,0,14872,America,3,0
2020-06-03,Anguilla,AI,0,0,14872,America,3,0
2020-06-04,Anguilla,AI,0,0,14872,America,3,0
2020-06-05,Anguilla,AI,0,0,14872,America,3,0
2020-06-06,Anguilla,AI,0,0,14872,America,3,0
2020-06-07,Anguilla,AI,0,0,14872,America,3,0
2020-06-08,Anguilla,AI,0,0,14872,America,3,0
2020-06-09,Anguilla,AI,0,0,14872,America,3,0
2020-06-10,Anguilla,AI,0,0,14872,America,3,0
2020-06-11,Anguilla,AI,0,0,14872,America,3,0
2020-06-12,Anguilla,AI,0,0,14872,America,3,0
2020-06-13,Anguilla,AI,0,0,14872,America,3,0
2020-06-14,Anguilla,AI,0,0,14872,America,3,0
2020-06-15,Anguilla,AI,0,0,14872,America,3,0
2020-06-16,Anguilla,AI,0,0,14872,America,3,0
2020-06-17,Anguilla,AI,0,0,14872,America,3,0
2020-06-18,Anguilla,AI,0,0,14872,America,3,0
2020-06-19,Anguilla,AI,0,0,14872,America,3,0
2020-06-20,Anguilla,AI,0,0,14872,America,3,0
2020-06-21,Anguilla,AI,0,0,14872,America,3,0
2020-06-22,Anguilla,AI,0,0,14872,America,3,0
2020-06-23,Anguilla,AI,0,0,14872,America,3,0
2020-06-24,Anguilla,AI,0,0,14872,America,3,0
2020-06-25,Anguilla,AI,0,0,14872,America,3,0
2020-06-26,Anguilla,AI,0,0,14872,America,3,0
2020-06-27,Anguilla,AI,0,0,14872,America,3,0
2020-06-28,Anguilla,AI,0,0,14872,America,3,0
2020-06-29,Anguilla,AI,0,0,14872,America,3,0
2020-06-30,Anguilla,AI,0,0,14872,America,3,0
2020-07-01,Anguilla,AI,0,0,14872,America,3,0
2020-07-02,Anguilla,AI,0,0,14872,America,3,0
2020-07-03,Anguilla,AI,0,0,14872,America,3,0
2020-07-04,Anguilla,AI,0,0,14872,America,3,0
2020-07-05,Anguilla,AI,0,0,14872,America,3,0
2020-07-06,Anguilla,AI,0,0,14872,America,3,0
2020-07-07,Anguilla,AI,0,0,14872,America,3,0
2020-07-08,Anguilla,AI,0,0,14872,America,3,0
2020-07-09,Anguilla,AI,0,0,14872,America,3,0
2020-07-10,Anguilla,AI,0,0,14872,America,3,0
2020-07-11,Anguilla,AI,0,0,14872,America,3,0
2020-07-12,Anguilla,AI,0,0,14872,America,3,0
2020-07-13,Anguilla,AI,0,0,14872,America,3,0
2020-07-14,Anguilla,AI,0,0,14872,America,3,0
2020-07-15,Anguilla,AI,0,0,14872,America,3,0
2020-07-16,Anguilla,AI,0,0,14872,America,3,0
2020-07-17,Anguilla,AI,0,0,14872,America,3,0
2020-07-18,Anguilla,AI,0,0,14872,America,3,0
2020-07-19,Anguilla,AI,0,0,14872,America,3,0
2020-07-20,Anguilla,AI,0,0,14872,America,3,0
2020-07-21,Anguilla,AI,0,0,14872,America,3,0
2020-07-22,Anguilla,AI,0,0,14872,America,3,0
2020-07-23,Anguilla,AI,0,0,14872,America,3,0
2020-07-24,Anguilla,AI,0,0,14872,America,3,0
2020-07-25,Anguilla,AI,0,0,14872,America,3,0
2020-07-26,Anguilla,AI,0,0,14872,America,3,0
2020-07-27,Anguilla,AI,0,0,14872,America,3,0
2020-07-28,Anguilla,AI,0,0,14872,America,3,0
2020-07-29,Anguilla,AI,0,0,14872,America,3,0
2020-07-30,Anguilla,AI,0,0,14872,America,3,0
2020-07-31,Anguilla,AI,0,0,14872,America,3,0
2020-08-01,Anguilla,AI,0,0,14872,America,3,0
2020-08-02,Anguilla,AI,0,0,14872,America,3,0
2020-08-03,Anguilla,AI,0,0,14872,America,3,0
2020-08-04,Anguilla,AI,0,0,14872,America,3,0
2020-08-05,Anguilla,AI,0,0,14872,America,3,0
2020-08-06,Anguilla,AI,0,0,14872,America,3,0
2020-08-07,Anguilla,AI,0,0,14872,America,3,0
2020-08-08,Anguilla,AI,0,0,14872,America,3,0
2020-08-09,Anguilla,AI,0,0,14872,America,3,0
2020-08-10,Anguilla,AI,0,0,14872,America,3,0
2020-08-11,Anguilla,AI,0,0,14872,America,3,0
2020-08-12,Anguilla,AI,0,0,14872,America,3,0
2020-08-13,Anguilla,AI,0,0,14872,America,3,0
2020-08-14,Anguilla,AI,0,0,14872,America,3,0
2020-08-15,Anguilla,AI,0,0,14872,America,3,0
2020-08-16,Anguilla,AI,0,0,14872,America,3,0
2020-08-17,Anguilla,AI,0,0,14872,America,3,0
2020-08-18,Anguilla,AI,0,0,14872,America,3,0
2020-08-19,Anguilla,AI,0,0,14872,America,3,0
2020-08-20,Anguilla,AI,0,0,14872,America,3,0
2020-08-21,Anguilla,AI,0,0,14872,America,3,0
2020-08-22,Anguilla,AI,0,0,14872,America,3,0
2020-08-23,Anguilla,AI,0,0,14872,America,3,0
2020-08-24,Anguilla,AI,0,0,14872,America,3,0
2020-08-25,Anguilla,AI,0,0,14872,America,3,0
2020-08-26,Anguilla,AI,0,0,14872,America,3,0
2020-08-27,Anguilla,AI,0,0,14872,America,3,0
2020-08-28,Anguilla,AI,0,0,14872,America,3,0
2020-08-29,Anguilla,AI,0,0,14872,America,3,0
2020-08-30,Anguilla,AI,0,0,14872,America,3,0
2020-08-31,Anguilla,AI,0,0,14872,America,3,0
2020-09-01,Anguilla,AI,0,0,14872,America,3,0
2020-09-02,Anguilla,AI,0,0,14872,America,3,0
2020-09-03,Anguilla,AI,0,0,14872,America,3,0
2020-09-04,Anguilla,AI,0,0,14872,America,3,0
2020-09-05,Anguilla,AI,0,0,14872,America,3,0
2020-09-06,Anguilla,AI,0,0,14872,America,3,0
2020-09-07,Anguilla,AI,0,0,14872,America,3,0
2020-09-08,Anguilla,AI,0,0,14872,America,3,0
2020-09-09,Anguilla,AI,0,0,14872,America,3,0
2020-09-10,Anguilla,AI,0,0,14872,America,3,0
2020-09-11,Anguilla,AI,0,0,14872,America,3,0
2020-09-12,Anguilla,AI,0,0,14872,America,3,0
2020-09-13,Anguilla,AI,0,0,14872,America,3,0
2020-09-14,Anguilla,AI,0,0,14872,America,3,0
2020-09-15,Anguilla,AI,0,0,14872,America,3,0
2020-09-16,Anguilla,AI,0,0,14872,America,3,0
2020-09-17,Anguilla,AI,0,0,14872,America,3,0
2020-09-18,Anguilla,AI,0,0,14872,America,3,0
2020-09-19,Anguilla,AI,0,0,14872,America,3,0
2020-09-20,Anguilla,AI,0,0,14872,America,3,0
2020-09-21,Anguilla,AI,0,0,14872,America,3,0
2020-09-22,Anguilla,AI,0,0,14872,America,3,0
2020-09-23,Anguilla,AI,0,0,14872,America,3,0
2020-09-24,Anguilla,AI,0,0,14872,America,3,0
2020-09-25,Anguilla,AI,0,0,14872,America,3,0
2020-09-26,Anguilla,AI,0,0,14872,America,3,0
2020-09-27,Anguilla,AI,0,0,14872,America,3,0
2020-09-28,Anguilla,AI,0,0,14872,America,3,0
2020-09-29,Anguilla,AI,0,0,14872,America,3,0
2020-09-30,Anguilla,AI,0,0,14872,America,3,0
2020-10-01,Anguilla,AI,0,0,14872,America,3,0
2020-10-02,Anguilla,AI,0,0,14872,America,3,0
2020-10-03,Anguilla,AI,0,0,14872,America,3,0
2020-10-04,Anguilla,AI,0,0,14872,America,3,0
2020-10-05,Anguilla,AI,0,0,14872,America,3,0
2020-10-06,Anguilla,AI,0,0,14872,America,3,0
2020-10-07,Anguilla,AI,0,0,14872,America,3,0
2020-10-08,Anguilla,AI,0,0,14872,America,3,0
2020-10-09,Anguilla,AI,0,0,14872,America,3,0
2020-10-10,Anguilla,AI,0,0,14872,America,3,0
2020-10-11,Anguilla,AI,0,0,14872,America,3,0
2020-10-12,Anguilla,AI,0,0,14872,America,3,0
2020-10-13,Anguilla,AI,0,0,14872,America,3,0
2020-10-14,Anguilla,AI,0,0,14872,America,3,0
2020-10-15,Anguilla,AI,0,0,14872,America,3,0
2020-10-16,Anguilla,AI,0,0,14872,America,3,0
2020-10-17,Anguilla,AI,0,0,14872,America,3,0
2020-10-18,Anguilla,AI,0,0,14872,America,3,0
2020-10-19,Anguilla,AI,0,0,14872,America,3,0
2020-10-20,Anguilla,AI,0,0,14872,America,3,0
2020-10-21,Anguilla,AI,0,0,14872,America,3,0
2020-10-22,Anguilla,AI,0,0,14872,America,3,0
2020-10-23,Anguilla,AI,0,0,14872,America,3,0
2020-10-24,Anguilla,AI,0,0,14872,America,3,0
2020-10-25,Anguilla,AI,0,0,14872,America,3,0
2020-10-26,Anguilla,AI,0,0,14872,America,3,0
2020-10-27,Anguilla,AI,0,0,14872,America,3,0
2020-10-28,Anguilla,AI,0,0,14872,America,3,0
2020-10-29,Anguilla,AI,0,0,14872,America,3,0
2020-10-30,Anguilla,AI,0,0,14872,America,3,0
2020-10-31,Anguilla,AI,0,0,14872,America,3,0
2020-11-01,Anguilla,AI,0,0,14872,America,3,0
2020-11-02,Anguilla,AI,0,0,14872,America,3,0
2020-11-03,Anguilla,AI,0,0,14872,America,3,0
2020-11-04,Anguilla,AI,0,0,14872,America,3,0
2020-11-05,Anguilla,AI,0,0,14872,America,3,0
2020-11-06,Anguilla,AI,0,0,14872,America,3,0
2020-11-07,Anguilla,AI,0,0,14872,America,3,0
2020-11-08,Anguilla,AI,0,0,14872,America,3,0
2020-11-09,Anguilla,AI,0,0,14872,America,3,0
2020-11-10,Anguilla,AI,0,0,14872,America,3,0
2020-11-11,Anguilla,AI,0,0,14872,America,3,0
2020-11-12,Anguilla,AI,0,0,14872,America,3,0
2020-11-13,Anguilla,AI,0,0,14872,America,3,0
2020-11-14,Anguilla,AI,0,0,14872,America,3,0
2020-11-15,Anguilla,AI,0,0,14872,America,3,0
2020-11-16,Anguilla,AI,0,0,14872,America,3,0
2020-11-17,Anguilla,AI,0,0,14872,America,3,0
2020-11-18,Anguilla,AI,0,0,14872,America,3,0
2020-11-19,Anguilla,AI,0,0,14872,America,3,0
2020-11-20,Anguilla,AI,0,0,14872,America,3,0
2020-11-21,Anguilla,AI,0,0,14872,America,3,0
2020-11-22,Anguilla,AI,0,0,14872,America,3,0
2020-11-23,Anguilla,AI,1,0,14872,America,4,0
2020-11-24,Anguilla,AI,0,0,14872,America,4,0
2020-11-25,Anguilla,AI,0,0,14872,America,4,0
2020-11-26,Anguilla,AI,0,0,14872,America,4,0
2020-11-27,Anguilla,AI,0,0,14872,America,4,0
2020-11-28,Anguilla,AI,0,0,14872,America,4,0
2020-11-29,Anguilla,AI,0,0,14872,America,4,0
2020-11-30,Anguilla,AI,0,0,14872,America,4,0
2020-12-01,Anguilla,AI,2,0,14872,America,6,0
2020-12-02,Anguilla,AI,0,0,14872,America,6,0
2020-12-03,Anguilla,AI,0,0,14872,America,6,0
2020-12-04,Anguilla,AI,0,0,14872,America,6,0
2020-12-05,Anguilla,AI,1,0,14872,America,7,0
2020-12-06,Anguilla,AI,0,0,14872,America,7,0
2020-12-07,Anguilla,AI,2,0,14872,America,9,0
2020-12-08,Anguilla,AI,0,0,14872,America,9,0
2020-12-09,Anguilla,AI,1,0,14872,America,10,0
2020-12-10,Anguilla,AI,0,0,14872,America,10,0
2020-12-11,Anguilla,AI,0,0,14872,America,10,0
2020-12-12,Anguilla,AI,0,0,14872,America,10,0
2020-12-13,Anguilla,AI,0,0,14872,America,10,0
2020-12-14,Anguilla,AI,0,0,14872,America,10,0
2020-03-09,Albania,AL,2,0,2862427,Europe,2,0
2020-03-10,Albania,AL,4,0,2862427,Europe,6,0
2020-03-11,Albania,AL,4,0,2862427,Europe,10,0
2020-03-12,Albania,AL,1,1,2862427,Europe,11,1
2020-03-13,Albania,AL,12,0,2862427,Europe,23,1
2020-03-14,Albania,AL,10,0,2862427,Europe,33,1
2020-03-15,Albania,AL,5,0,2862427,Europe,38,1
2020-03-16,Albania,AL,4,0,2862427,Europe,42,1
2020-03-17,Albania,AL,9,0,2862427,Europe,51,1
2020-03-18,Albania,AL,4,0,2862427,Europe,55,1
2020-03-19,Albania,AL,4,1,2862427,Europe,59,2
2020-03-20,Albania,AL,11,0,2862427,Europe,70,2
2020-03-21,Albania,AL,0,0,2862427,Europe,70,2
2020-03-22,Albania,AL,6,0,2862427,Europe,76,2
2020-03-23,Albania,AL,13,0,2862427,Europe,89,2
2020-03-24,Albania,AL,11,2,2862427,Europe,100,4
2020-03-25,Albania,AL,23,1,2862427,Europe,123,5
2020-03-26,Albania,AL,23,0,2862427,Europe,146,5
2020-03-27,Albania,AL,28,1,2862427,Europe,174,6
2020-03-28,Albania,AL,12,3,2862427,Europe,186,9
2020-03-29,Albania,AL,11,1,2862427,Europe,197,10
2020-03-30,Albania,AL,15,0,2862427,Europe,212,10
2020-03-31,Albania,AL,11,2,2862427,Europe,223,12
2020-04-01,Albania,AL,20,3,2862427,Europe,243,15
2020-04-02,Albania,AL,16,0,2862427,Europe,259,15
2020-04-03,Albania,AL,18,1,2862427,Europe,277,16
2020-04-04,Albania,AL,27,1,2862427,Europe,304,17
2020-04-05,Albania,AL,29,2,2862427,Europe,333,19
2020-04-06,Albania,AL,28,2,2862427,Europe,361,21
2020-04-07,Albania,AL,16,1,2862427,Europe,377,22
2020-04-08,Albania,AL,6,0,2862427,Europe,383,22
2020-04-09,Albania,AL,17,0,2862427,Europe,400,22
2020-04-10,Albania,AL,9,1,2862427,Europe,409,23
2020-04-11,Albania,AL,7,0,2862427,Europe,416,23
2020-04-12,Albania,AL,17,0,2862427,Europe,433,23
2020-04-13,Albania,AL,13,0,2862427,Europe,446,23
2020-04-14,Albania,AL,21,0,2862427,Europe,467,23
2020-04-15,Albania,AL,8,1,2862427,Europe,475,24
2020-04-16,Albania,AL,19,1,2862427,Europe,494,25
2020-04-17,Albania,AL,24,1,2862427,Europe,518,26
2020-04-18,Albania,AL,21,0,2862427,Europe,539,26
2020-04-19,Albania,AL,9,0,2862427,Europe,548,26
2020-04-20,Albania,AL,14,0,2862427,Europe,562,26
2020-04-21,Albania,AL,22,0,2862427,Europe,584,26
2020-04-22,Albania,AL,25,0,2862427,Europe,609,26
2020-04-23,Albania,AL,25,1,2862427,Europe,634,27
2020-04-24,Albania,AL,29,0,2862427,Europe,663,27
2020-04-25,Albania,AL,15,0,2862427,Europe,678,27
2020-04-26,Albania,AL,34,0,2862427,Europe,712,27
2020-04-27,Albania,AL,14,1,2862427,Europe,726,28
2020-04-28,Albania,AL,10,0,2862427,Europe,736,28
2020-04-29,Albania,AL,14,2,2862427,Europe,750,30
2020-04-30,Albania,AL,16,1,2862427,Europe,766,31
2020-05-01,Albania,AL,7,0,2862427,Europe,773,31
2020-05-02,Albania,AL,9,0,2862427,Europe,782,31
2020-05-03,Albania,AL,7,0,2862427,Europe,789,31
2020-05-04,Albania,AL,6,0,2862427,Europe,795,31
2020-05-05,Albania,AL,8,0,2862427,Europe,803,31
2020-05-06,Albania,AL,17,0,2862427,Europe,820,31
2020-05-07,Albania,AL,12,0,2862427,Europe,832,31
2020-05-08,Albania,AL,10,0,2862427,Europe,842,31
2020-05-09,Albania,AL,8,0,2862427,Europe,850,31
2020-05-10,Albania,AL,6,0,2862427,Europe,856,31
2020-05-11,Albania,AL,12,0,2862427,Europe,868,31
2020-05-12,Albania,AL,4,0,2862427,Europe,872,31
2020-05-13,Albania,AL,4,0,2862427,Europe,876,31
2020-05-14,Albania,AL,4,0,2862427,Europe,880,31
2020-05-15,Albania,AL,18,0,2862427,Europe,898,31
2020-05-16,Albania,AL,18,0,2862427,Europe,916,31
2020-05-17,Albania,AL,17,0,2862427,Europe,933,31
2020-05-18,Albania,AL,13,0,2862427,Europe,946,31
2020-05-19,Albania,AL,2,0,2862427,Europe,948,31
2020-05-20,Albania,AL,1,0,2862427,Europe,949,31
2020-05-21,Albania,AL,15,0,2862427,Europe,964,31
2020-05-22,Albania,AL,5,0,2862427,Europe,969,31
2020-05-23,Albania,AL,12,0,2862427,Europe,981,31
2020-05-24,Albania,AL,8,0,2862427,Europe,989,31
2020-05-25,Albania,AL,9,1,2862427,Europe,998,32
2020-05-26,Albania,AL,6,0,2862427,Europe,1004,32
2020-05-27,Albania,AL,25,1,2862427,Europe,1029,33
2020-05-28,Albania,AL,21,0,2862427,Europe,1050,33
2020-05-29,Albania,AL,26,0,2862427,Europe,1076,33
2020-05-30,Albania,AL,23,0,2862427,Europe,1099,33
2020-05-31,Albania,AL,23,0,2862427,Europe,1122,33
2020-06-01,Albania,AL,15,0,2862427,Europe,1137,33
2020-06-02,Albania,AL,6,0,2862427,Europe,1143,33
2020-06-03,Albania,AL,21,0,2862427,Europe,1164,33
2020-06-04,Albania,AL,20,0,2862427,Europe,1184,33
2020-06-05,Albania,AL,13,0,2862427,Europe,1197,33
2020-06-06,Albania,AL,15,0,2862427,Europe,1212,33
2020-06-07,Albania,AL,20,1,2862427,Europe,1232,34
2020-06-08,Albania,AL,14,0,2862427,Europe,1246,34
2020-06-09,Albania,AL,17,0,2862427,Europe,1263,34
2020-06-10,Albania,AL,36,0,2862427,Europe,1299,34
2020-06-11,Albania,AL,42,0,2862427,Europe,1341,34
2020-06-12,Albania,AL,44,1,2862427,Europe,1385,35
2020-06-13,Albania,AL,31,1,2862427,Europe,1416,36
2020-06-14,Albania,AL,48,0,2862427,Europe,1464,36
2020-06-15,Albania,AL,57,0,2862427,Europe,1521,36
2020-06-16,Albania,AL,69,0,2862427,Europe,1590,36
2020-06-17,Albania,AL,82,1,2862427,Europe,1672,37
2020-06-18,Albania,AL,50,1,2862427,Europe,1722,38
2020-06-19,Albania,AL,66,1,2862427,Europe,1788,39
2020-06-20,Albania,AL,50,3,2862427,Europe,1838,42
2020-06-21,Albania,AL,53,1,2862427,Europe,1891,43
2020-06-22,Albania,AL,36,1,2862427,Europe,1927,44
2020-06-23,Albania,AL,68,0,2862427,Europe,1995,44
2020-06-24,Albania,AL,52,1,2862427,Europe,2047,45
2020-06-25,Albania,AL,67,2,2862427,Europe,2114,47
2020-06-26,Albania,AL,78,2,2862427,Europe,2192,49
2020-06-27,Albania,AL,77,2,2862427,Europe,2269,51
2020-06-28,Albania,AL,61,2,2862427,Europe,2330,53
2020-06-29,Albania,AL,72,2,2862427,Europe,2402,55
2020-06-30,Albania,AL,64,3,2862427,Europe,2466,58
2020-07-01,Albania,AL,69,4,2862427,Europe,2535,62
2020-07-02,Albania,AL,45,3,2862427,Europe,2580,65
2020-07-03,Albania,AL,82,4,2862427,Europe,2662,69
2020-07-04,Albania,AL,90,3,2862427,Europe,2752,72
2020-07-05,Albania,AL,67,2,2862427,Europe,2819,74
2020-07-06,Albania,AL,74,2,2862427,Europe,2893,76
2020-07-07,Albania,AL,71,3,2862427,Europe,2964,79
2020-07-08,Albania,AL,74,2,2862427,Europe,3038,81
2020-07-09,Albania,AL,68,2,2862427,Europe,3106,83
2020-07-10,Albania,AL,82,0,2862427,Europe,3188,83
2020-07-11,Albania,AL,90,2,2862427,Europe,3278,85
2020-07-12,Albania,AL,93,4,2862427,Europe,3371,89
2020-07-13,Albania,AL,83,4,2862427,Europe,3454,93
2020-07-14,Albania,AL,117,2,2862427,Europe,3571,95
2020-07-15,Albania,AL,96,2,2862427,Europe,3667,97
2020-07-16,Albania,AL,85,4,2862427,Europe,3752,101
2020-07-17,Albania,AL,99,3,2862427,Europe,3851,104
2020-07-18,Albania,AL,55,3,2862427,Europe,3906,107
2020-07-19,Albania,AL,102,4,2862427,Europe,4008,111
2020-07-20,Albania,AL,82,1,2862427,Europe,4090,112
2020-07-21,Albania,AL,81,1,2862427,Europe,4171,113
2020-07-22,Albania,AL,119,4,2862427,Europe,4290,117
2020-07-23,Albania,AL,68,3,2862427,Europe,4358,120
2020-07-24,Albania,AL,108,3,2862427,Europe,4466,123
2020-07-25,Albania,AL,104,5,2862427,Europe,4570,128
2020-07-26,Albania,AL,67,6,2862427,Europe,4637,134
2020-07-27,Albania,AL,126,4,2862427,Europe,4763,138
2020-07-28,Albania,AL,117,6,2862427,Europe,4880,144
2020-07-29,Albania,AL,117,4,2862427,Europe,4997,148
2020-07-30,Albania,AL,108,2,2862427,Europe,5105,150
2020-07-31,Albania,AL,92,4,2862427,Europe,5197,154
2020-08-01,Albania,AL,79,3,2862427,Europe,5276,157
2020-08-02,Albania,AL,120,4,2862427,Europe,5396,161
2020-08-03,Albania,AL,123,5,2862427,Europe,5519,166
2020-08-04,Albania,AL,101,6,2862427,Europe,5620,172
2020-08-05,Albania,AL,130,4,2862427,Europe,5750,176
2020-08-06,Albania,AL,139,6,2862427,Europe,5889,182
2020-08-07,Albania,AL,127,6,2862427,Europe,6016,188
2020-08-08,Albania,AL,135,1,2862427,Europe,6151,189
2020-08-09,Albania,AL,124,4,2862427,Europe,6275,193
2020-08-10,Albania,AL,136,6,2862427,Europe,6411,199
2020-08-11,Albania,AL,125,1,2862427,Europe,6536,200
2020-08-12,Albania,AL,140,5,2862427,Europe,6676,205
2020-08-13,Albania,AL,141,3,2862427,Europe,6817,208
2020-08-14,Albania,AL,154,5,2862427,Europe,6971,213
2020-08-15,Albania,AL,146,6,2862427,Europe,7117,219
2020-08-16,Albania,AL,143,6,2862427,Europe,7260,225
2020-08-17,Albania,AL,120,3,2862427,Europe,7380,228
2020-08-18,Albania,AL,119,2,2862427,Europe,7499,230
2020-08-19,Albania,AL,155,2,2862427,Europe,7654,232
2020-08-20,Albania,AL,158,2,2862427,Europe,7812,234
2020-08-21,Albania,AL,155,4,2862427,Europe,7967,238
2020-08-22,Albania,AL,152,2,2862427,Europe,8119,240
2020-08-23,Albania,AL,156,5,2862427,Europe,8275,245
2020-08-24,Albania,AL,152,5,2862427,Europe,8427,250
2020-08-25,Albania,AL,178,4,2862427,Europe,8605,254
2020-08-26,Albania,AL,154,5,2862427,Europe,8759,259
2020-08-27,Albania,AL,168,4,2862427,Europe,8927,263
2020-08-28,Albania,AL,156,3,2862427,Europe,9083,266
2020-08-29,Albania,AL,112,5,2862427,Europe,9195,271
2020-08-30,Albania,AL,84,4,2862427,Europe,9279,275
2020-08-31,Albania,AL,101,5,2862427,Europe,9380,280
2020-09-01,Albania,AL,133,4,2862427,Europe,9513,284
2020-09-02,Albania,AL,93,6,2862427,Europe,9606,290
2020-09-03,Albania,AL,122,6,2862427,Europe,9728,296
2020-09-04,Albania,AL,116,5,2862427,Europe,9844,301
2020-09-05,Albania,AL,123,5,2862427,Europe,9967,306
2020-09-06,Albania,AL,135,6,2862427,Europe,10102,312
2020-09-07,Albania,AL,153,4,2862427,Europe,10255,316
2020-09-08,Albania,AL,151,3,2862427,Europe,10406,319
2020-09-09,Albania,AL,147,2,2862427,Europe,10553,321
2020-09-10,Albania,AL,151,1,2862427,Europe,10704,322
2020-09-11,Albania,AL,156,2,2862427,Europe,10860,324
2020-09-12,Albania,AL,161,3,2862427,Europe,11021,327
2020-09-13,Albania,AL,164,3,2862427,Europe,11185,330
2020-09-14,Albania,AL,168,4,2862427,Europe,11353,334
2020-09-15,Albania,AL,167,4,2862427,Europe,11520,338
2020-09-16,Albania,AL,152,2,2862427,Europe,11672,340
2020-09-17,Albania,AL,144,3,2862427,Europe,11816,343
2020-09-18,Albania,AL,132,5,2862427,Europe,11948,348
2020-09-19,Albania,AL,125,5,2862427,Europe,12073,353
2020-09-20,Albania,AL,153,5,2862427,Europe,12226,358
2020-09-21,Albania,AL,159,4,2862427,Europe,12385,362
2020-09-22,Albania,AL,150,2,2862427,Europe,12535,364
2020-09-23,Albania,AL,131,3,2862427,Europe,12666,367
2020-09-24,Albania,AL,121,3,2862427,Europe,12787,370
2020-09-25,Albania,AL,134,0,2862427,Europe,12921,370
2020-09-26,Albania,AL,124,3,2862427,Europe,13045,373
2020-09-27,Albania,AL,108,2,2862427,Europe,13153,375
2020-09-28,Albania,AL,106,2,2862427,Europe,13259,377
2020-09-29,Albania,AL,132,3,2862427,Europe,13391,380
2020-09-30,Albania,AL,127,4,2862427,Europe,13518,384
2020-10-01,Albania,AL,131,3,2862427,Europe,13649,387
2020-10-02,Albania,AL,157,1,2862427,Europe,13806,388
2020-10-03,Albania,AL,159,1,2862427,Europe,13965,389
2020-10-04,Albania,AL,152,3,2862427,Europe,14117,392
2020-10-05,Albania,AL,149,4,2862427,Europe,14266,396
2020-10-06,Albania,AL,144,4,2862427,Europe,14410,400
2020-10-07,Albania,AL,158,3,2862427,Europe,14568,403
2020-10-08,Albania,AL,162,4,2862427,Europe,14730,407
2020-10-09,Albania,AL,169,4,2862427,Europe,14899,411
2020-10-10,Albania,AL,167,2,2862427,Europe,15066,413
2020-10-11,Albania,AL,165,3,2862427,Europe,15231,416
2020-10-12,Albania,AL,168,4,2862427,Europe,15399,420
2020-10-13,Albania,AL,171,4,2862427,Europe,15570,424
2020-10-14,Albania,AL,182,5,2862427,Europe,15752,429
2020-10-15,Albania,AL,203,5,2862427,Europe,15955,434
2020-10-16,Albania,AL,257,5,2862427,Europe,16212,439
2020-10-17,Albania,AL,289,4,2862427,Europe,16501,443
2020-10-18,Albania,AL,273,5,2862427,Europe,16774,448
2020-10-19,Albania,AL,281,3,2862427,Europe,17055,451
2020-10-20,Albania,AL,295,3,2862427,Europe,17350,454
2020-10-21,Albania,AL,301,4,2862427,Europe,17651,458
2020-10-22,Albania,AL,297,4,2862427,Europe,17948,462
2020-10-23,Albania,AL,302,3,2862427,Europe,18250,465
2020-10-24,Albania,AL,306,4,2862427,Europe,18556,469
2020-10-25,Albania,AL,302,4,2862427,Europe,18858,473
2020-10-26,Albania,AL,299,4,2862427,Europe,19157,477
2020-10-27,Albania,AL,288,3,2862427,Europe,19445,480
2020-10-28,Albania,AL,284,7,2862427,Europe,19729,487
2020-10-29,Albania,AL,311,6,2862427,Europe,20040,493
2020-10-30,Albania,AL,275,6,2862427,Europe,20315,499
2020-10-31,Albania,AL,319,3,2862427,Europe,20634,502
2020-11-01,Albania,AL,241,7,2862427,Europe,20875,509
2020-11-02,Albania,AL,327,9,2862427,Europe,21202,518
2020-11-03,Albania,AL,321,9,2862427,Europe,21523,527
2020-11-04,Albania,AL,381,5,2862427,Europe,21904,532
2020-11-05,Albania,AL,396,4,2862427,Europe,22300,536
2020-11-06,Albania,AL,421,7,2862427,Europe,22721,543
2020-11-07,Albania,AL,489,6,2862427,Europe,23210,549
2020-11-08,Albania,AL,495,8,2862427,Europe,23705,557
2020-11-09,Albania,AL,501,2,2862427,Europe,24206,559
2020-11-10,Albania,AL,525,12,2862427,Europe,24731,571
2020-11-11,Albania,AL,563,8,2862427,Europe,25294,579
2020-11-12,Albania,AL,507,11,2862427,Europe,25801,590
2020-11-13,Albania,AL,410,8,2862427,Europe,26211,598
2020-11-14,Albania,AL,490,7,2862427,Europe,26701,605
2020-11-15,Albania,AL,532,7,2862427,Europe,27233,612
2020-11-16,Albania,AL,597,11,2862427,Europe,27830,623
2020-11-17,Albania,AL,602,8,2862427,Europe,28432,631
2020-11-18,Albania,AL,694,6,2862427,Europe,29126,637
2020-11-19,Albania,AL,711,9,2862427,Europe,29837,646
2020-11-20,Albania,AL,786,11,2862427,Europe,30623,657
2020-11-21,Albania,AL,836,15,2862427,Europe,31459,672
2020-11-22,Albania,AL,737,13,2862427,Europe,32196,685
2020-11-23,Albania,AL,565,14,2862427,Europe,32761,699
2020-11-24,Albania,AL,795,17,2862427,Europe,33556,716
2020-11-25,Albania,AL,744,19,2862427,Europe,34300,735
2020-11-26,Albania,AL,644,8,2862427,Europe,34944,743
2020-11-27,Albania,AL,656,10,2862427,Europe,35600,753
2020-11-28,Albania,AL,645,18,2862427,Europe,36245,771
2020-11-29,Albania,AL,545,16,2862427,Europe,36790,787
2020-11-30,Albania,AL,835,11,2862427,Europe,37625,798
2020-12-01,Albania,AL,557,12,2862427,Europe,38182,810
2020-12-02,Albania,AL,832,12,2862427,Europe,39014,822
2020-12-03,Albania,AL,705,17,2862427,Europe,39719,839
2020-12-04,Albania,AL,782,13,2862427,Europe,40501,852
2020-12-05,Albania,AL,801,18,2862427,Europe,41302,870
2020-12-06,Albania,AL,846,19,2862427,Europe,42148,889
2020-12-07,Albania,AL,840,16,2862427,Europe,42988,905
2020-12-08,Albania,AL,695,17,2862427,Europe,43683,922
2020-12-09,Albania,AL,753,14,2862427,Europe,44436,936
2020-12-10,Albania,AL,752,15,2862427,Europe,45188,951
2020-12-11,Albania,AL,873,14,2862427,Europe,46061,965
2020-12-12,Albania,AL,802,12,2862427,Europe,46863,977
2020-12-13,Albania,AL,879,12,2862427,Europe,47742,989
2020-12-14,Albania,AL,788,14,2862427,Europe,48530,1003
2019-12-31,Armenia,AM,0,0,2957728,Europe,0,0
2020-01-01,Armenia,AM,0,0,2957728,Europe,0,0
2020-01-02,Armenia,AM,0,0,2957728,Europe,0,0
2020-01-03,Armenia,AM,0,0,2957728,Europe,0,0
2020-01-04,Armenia,AM,0,0,2957728,Europe,0,0
2020-01-05,Armenia,AM,0,0,2957728,Europe,0,0
2020-01-06,Armenia,AM,0,0,2957728,Europe,0,0
2020-01-07,Armenia,AM,0,0,2957728,Europe,0,0
2020-01-08,Armenia,AM,0,0,2957728,Europe,0,0
2020-01-09,Armenia,AM,0,0,2957728,Europe,0,0
2020-01-10,Armenia,AM,0,0,2957728,Europe,0,0
2020-01-11,Armenia,AM,0,0,2957728,Europe,0,0
2020-01-12,Armenia,AM,0,0,2957728,Europe,0,0
2020-01-13,Armenia,AM,0,0,2957728,Europe,0,0
2020-01-14,Armenia,AM,0,0,2957728,Europe,0,0
2020-01-15,Armenia,AM,0,0,2957728,Europe,0,0
2020-01-16,Armenia,AM,0,0,2957728,Europe,0,0
2020-01-17,Armenia,AM,0,0,2957728,Europe,0,0
2020-01-18,Armenia,AM,0,0,2957728,Europe,0,0
2020-01-19,Armenia,AM,0,0,2957728,Europe,0,0
2020-01-20,Armenia,AM,0,0,2957728,Europe,0,0
2020-01-21,Armenia,AM,0,0,2957728,Europe,0,0
2020-01-22,Armenia,AM,0,0,2957728,Europe,0,0
2020-01-23,Armenia,AM,0,0,2957728,Europe,0,0
2020-01-24,Armenia,AM,0,0,2957728,Europe,0,0
2020-01-25,Armenia,AM,0,0,2957728,Europe,0,0
2020-01-26,Armenia,AM,0,0,2957728,Europe,0,0
2020-01-27,Armenia,AM,0,0,2957728,Europe,0,0
2020-01-28,Armenia,AM,0,0,2957728,Europe,0,0
2020-01-29,Armenia,AM,0,0,2957728,Europe,0,0
2020-01-30,Armenia,AM,0,0,2957728,Europe,0,0
2020-01-31,Armenia,AM,0,0,2957728,Europe,0,0
2020-02-01,Armenia,AM,0,0,2957728,Europe,0,0
2020-02-02,Armenia,AM,0,0,2957728,Europe,0,0
2020-02-03,Armenia,AM,0,0,2957728,Europe,0,0
2020-02-04,Armenia,AM,0,0,2957728,Europe,0,0
2020-02-05,Armenia,AM,0,0,2957728,Europe,0,0
2020-02-06,Armenia,AM,0,0,2957728,Europe,0,0
2020-02-07,Armenia,AM,0,0,2957728,Europe,0,0
2020-02-08,Armenia,AM,0,0,2957728,Europe,0,0
2020-02-09,Armenia,AM,0,0,2957728,Europe,0,0
2020-02-10,Armenia,AM,0,0,2957728,Europe,0,0
2020-02-11,Armenia,AM,0,0,2957728,Europe,0,0
2020-02-12,Armenia,AM,0,0,2957728,Europe,0,0
2020-02-13,Armenia,AM,0,0,2957728,Europe,0,0
2020-02-14,Armenia,AM,0,0,2957728,Europe,0,0
2020-02-15,Armenia,AM,0,0,2957728,Europe,0,0
2020-02-16,Armenia,AM,0,0,2957728,Europe,0,0
2020-02-17,Armenia,AM,0,0,2957728,Europe,0,0
2020-02-18,Armenia,AM,0,0,2957728,Europe,0,0
2020-02-19,Armenia,AM,0,0,2957728,Europe,0,0
2020-02-20,Armenia,AM,0,0,2957728,Europe,0,0
2020-02-21,Armenia,AM,0,0,2957728,Europe,0,0
2020-02-22,Armenia,AM,0,0,2957728,Europe,0,0
2020-02-23,Armenia,AM,0,0,2957728,Europe,0,0
2020-02-24,Armenia,AM,0,0,2957728,Europe,0,0
2020-02-25,Armenia,AM,0,0,2957728,Europe,0,0
2020-02-26,Armenia,AM,0,0,2957728,Europe,0,0
2020-02-27,Armenia,AM,0,0,2957728,Europe,0,0
2020-02-28,Armenia,AM,0,0,2957728,Europe,0,0
2020-02-29,Armenia,AM,0,0,2957728,Europe,0,0
2020-03-01,Armenia,AM,1,0,2957728,Europe,1,0
2020-03-02,Armenia,AM,0,0,2957728,Europe,1,0
2020-03-12,Armenia,AM,3,0,2957728,Europe,4,0
2020-03-13,Armenia,AM,2,0,2957728,Europe,6,0
2020-03-14,Armenia,AM,7,0,2957728,Europe,13,0
2020-03-15,Armenia,AM,7,0,2957728,Europe,20,0
2020-03-16,Armenia,AM,8,0,2957728,Europe,28,0
2020-03-17,Armenia,AM,17,0,2957728,Europe,45,0
2020-03-18,Armenia,AM,33,0,2957728,Europe,78,0
2020-03-19,Armenia,AM,32,0,2957728,Europe,110,0
2020-03-20,Armenia,AM,26,0,2957728,Europe,136,0
2020-03-21,Armenia,AM,24,0,2957728,Europe,160,0
2020-03-22,Armenia,AM,30,0,2957728,Europe,190,0
2020-03-23,Armenia,AM,4,0,2957728,Europe,194,0
2020-03-24,Armenia,AM,41,0,2957728,Europe,235,0
2020-03-25,Armenia,AM,30,0,2957728,Europe,265,0
2020-03-26,Armenia,AM,25,0,2957728,Europe,290,0
2020-03-27,Armenia,AM,39,1,2957728,Europe,329,1
2020-03-28,Armenia,AM,43,0,2957728,Europe,372,1
2020-03-29,Armenia,AM,52,0,2957728,Europe,424,1
2020-03-30,Armenia,AM,58,2,2957728,Europe,482,3
2020-03-31,Armenia,AM,50,0,2957728,Europe,532,3
2020-04-01,Armenia,AM,39,0,2957728,Europe,571,3
2020-04-02,Armenia,AM,92,1,2957728,Europe,663,4
2020-04-03,Armenia,AM,73,3,2957728,Europe,736,7
2020-04-04,Armenia,AM,34,0,2957728,Europe,770,7
2020-04-05,Armenia,AM,52,0,2957728,Europe,822,7
2020-04-06,Armenia,AM,11,1,2957728,Europe,833,8
2020-04-07,Armenia,AM,20,0,2957728,Europe,853,8
2020-04-08,Armenia,AM,28,1,2957728,Europe,881,9
2020-04-09,Armenia,AM,40,1,2957728,Europe,921,10
2020-04-10,Armenia,AM,16,1,2957728,Europe,937,11
2020-04-11,Armenia,AM,30,2,2957728,Europe,967,13
2020-04-12,Armenia,AM,46,0,2957728,Europe,1013,13
2020-04-13,Armenia,AM,26,1,2957728,Europe,1039,14
2020-04-14,Armenia,AM,28,2,2957728,Europe,1067,16
2020-04-15,Armenia,AM,44,1,2957728,Europe,1111,17
2020-04-16,Armenia,AM,48,1,2957728,Europe,1159,18
2020-04-17,Armenia,AM,42,1,2957728,Europe,1201,19
2020-04-18,Armenia,AM,47,1,2957728,Europe,1248,20
2020-04-19,Armenia,AM,43,0,2957728,Europe,1291,20
2020-04-20,Armenia,AM,48,2,2957728,Europe,1339,22
2020-04-21,Armenia,AM,62,2,2957728,Europe,1401,24
2020-04-22,Armenia,AM,72,0,2957728,Europe,1473,24
2020-04-23,Armenia,AM,50,0,2957728,Europe,1523,24
2020-04-24,Armenia,AM,73,3,2957728,Europe,1596,27
2020-04-25,Armenia,AM,81,1,2957728,Europe,1677,28
2020-04-26,Armenia,AM,69,0,2957728,Europe,1746,28
2020-04-27,Armenia,AM,62,1,2957728,Europe,1808,29
2020-04-28,Armenia,AM,59,1,2957728,Europe,1867,30
2020-04-29,Armenia,AM,65,0,2957728,Europe,1932,30
2020-04-30,Armenia,AM,134,2,2957728,Europe,2066,32
2020-05-01,Armenia,AM,82,1,2957728,Europe,2148,33
2020-05-02,Armenia,AM,125,0,2957728,Europe,2273,33
2020-05-03,Armenia,AM,113,2,2957728,Europe,2386,35
2020-05-04,Armenia,AM,121,4,2957728,Europe,2507,39
2020-05-05,Armenia,AM,112,1,2957728,Europe,2619,40
2020-05-06,Armenia,AM,163,0,2957728,Europe,2782,40
2020-05-07,Armenia,AM,102,2,2957728,Europe,2884,42
2020-05-08,Armenia,AM,145,1,2957728,Europe,3029,43
2020-05-09,Armenia,AM,146,1,2957728,Europe,3175,44
2020-05-10,Armenia,AM,138,1,2957728,Europe,3313,45
2020-05-11,Armenia,AM,79,1,2957728,Europe,3392,46
2020-05-12,Armenia,AM,146,1,2957728,Europe,3538,47
2020-05-13,Armenia,AM,180,1,2957728,Europe,3718,48
2020-05-14,Armenia,AM,142,1,2957728,Europe,3860,49
2020-05-15,Armenia,AM,184,3,2957728,Europe,4044,52
2020-05-16,Armenia,AM,239,3,2957728,Europe,4283,55
2020-05-17,Armenia,AM,189,5,2957728,Europe,4472,60
2020-05-18,Armenia,AM,351,1,2957728,Europe,4823,61
2020-05-19,Armenia,AM,218,3,2957728,Europe,5041,64
2020-05-20,Armenia,AM,230,3,2957728,Europe,5271,67
2020-05-21,Armenia,AM,335,3,2957728,Europe,5606,70
2020-05-22,Armenia,AM,322,4,2957728,Europe,5928,74
2020-05-23,Armenia,AM,374,3,2957728,Europe,6302,77
2020-05-24,Armenia,AM,359,4,2957728,Europe,6661,81
2020-05-25,Armenia,AM,452,6,2957728,Europe,7113,87
2020-05-26,Armenia,AM,289,4,2957728,Europe,7402,91
2020-05-27,Armenia,AM,372,7,2957728,Europe,7774,98
2020-05-28,Armenia,AM,442,15,2957728,Europe,8216,113
2020-05-29,Armenia,AM,460,7,2957728,Europe,8676,120
2020-05-30,Armenia,AM,251,7,2957728,Europe,8927,127
2020-05-31,Armenia,AM,355,4,2957728,Europe,9282,131
2020-06-01,Armenia,AM,210,8,2957728,Europe,9492,139
2020-06-02,Armenia,AM,517,19,2957728,Europe,10009,158
2020-06-03,Armenia,AM,515,12,2957728,Europe,10524,170
2020-06-04,Armenia,AM,697,6,2957728,Europe,11221,176
2020-06-05,Armenia,AM,596,7,2957728,Europe,11817,183
2020-06-06,Armenia,AM,547,7,2957728,Europe,12364,190
2020-06-07,Armenia,AM,766,10,2957728,Europe,13130,200
2020-06-08,Armenia,AM,195,11,2957728,Europe,13325,211
2020-06-09,Armenia,AM,350,6,2957728,Europe,13675,217
2020-06-10,Armenia,AM,428,10,2957728,Europe,14103,227
2020-06-11,Armenia,AM,566,18,2957728,Europe,14669,245
2020-06-12,Armenia,AM,612,13,2957728,Europe,15281,258
2020-06-13,Armenia,AM,723,6,2957728,Europe,16004,264
2020-06-14,Armenia,AM,663,5,2957728,Europe,16667,269
2020-06-15,Armenia,AM,397,16,2957728,Europe,17064,285
2020-06-16,Armenia,AM,425,8,2957728,Europe,17489,293
2020-06-17,Armenia,AM,544,9,2957728,Europe,18033,302
2020-06-18,Armenia,AM,665,7,2957728,Europe,18698,309
2020-06-19,Armenia,AM,459,10,2957728,Europe,19157,319
2020-06-20,Armenia,AM,551,13,2957728,Europe,19708,332
2020-06-21,Armenia,AM,560,18,2957728,Europe,20268,350
2020-06-22,Armenia,AM,320,10,2957728,Europe,20588,360
2020-06-23,Armenia,AM,418,12,2957728,Europe,21006,372
2020-06-24,Armenia,AM,711,14,2957728,Europe,21717,386
2020-06-25,Armenia,AM,771,11,2957728,Europe,22488,397
2020-06-26,Armenia,AM,759,13,2957728,Europe,23247,410
2020-06-27,Armenia,AM,662,10,2957728,Europe,23909,420
2020-06-28,Armenia,AM,736,6,2957728,Europe,24645,426
2020-06-29,Armenia,AM,482,7,2957728,Europe,25127,433
2020-06-30,Armenia,AM,415,10,2957728,Europe,25542,443
2020-07-01,Armenia,AM,523,10,2957728,Europe,26065,453
2020-07-02,Armenia,AM,593,6,2957728,Europe,26658,459
2020-07-03,Armenia,AM,662,10,2957728,Europe,27320,469
2020-07-04,Armenia,AM,580,8,2957728,Europe,27900,477
2020-07-05,Armenia,AM,706,7,2957728,Europe,28606,484
2020-07-06,Armenia,AM,330,7,2957728,Europe,28936,491
2020-07-07,Armenia,AM,349,12,2957728,Europe,29285,503
2020-07-08,Armenia,AM,535,18,2957728,Europe,29820,521
2020-07-09,Armenia,AM,526,14,2957728,Europe,30346,535
2020-07-10,Armenia,AM,557,11,2957728,Europe,30903,546
2020-07-11,Armenia,AM,489,13,2957728,Europe,31392,559
2020-07-12,Armenia,AM,577,6,2957728,Europe,31969,565
2020-07-13,Armenia,AM,182,8,2957728,Europe,32151,573
2020-07-14,Armenia,AM,339,8,2957728,Europe,32490,581
2020-07-15,Armenia,AM,515,11,2957728,Europe,33005,592
2020-07-16,Armenia,AM,554,15,2957728,Europe,33559,607
2020-07-17,Armenia,AM,442,13,2957728,Europe,34001,620
2020-07-18,Armenia,AM,461,11,2957728,Europe,34462,631
2020-07-19,Armenia,AM,415,10,2957728,Europe,34877,641
2020-07-20,Armenia,AM,104,9,2957728,Europe,34981,650
2020-07-21,Armenia,AM,273,12,2957728,Europe,35254,662
2020-07-22,Armenia,AM,439,16,2957728,Europe,35693,678
2020-07-23,Armenia,AM,469,10,2957728,Europe,36162,688
2020-07-24,Armenia,AM,451,4,2957728,Europe,36613,692
2020-07-25,Armenia,AM,383,8,2957728,Europe,36996,700
2020-07-26,Armenia,AM,321,5,2957728,Europe,37317,705
2020-07-27,Armenia,AM,73,6,2957728,Europe,37390,711
2020-07-28,Armenia,AM,239,8,2957728,Europe,37629,719
2020-07-29,Armenia,AM,308,4,2957728,Europe,37937,723
2020-07-30,Armenia,AM,259,5,2957728,Europe,38196,728
2020-07-31,Armenia,AM,354,10,2957728,Europe,38550,738
2020-08-01,Armenia,AM,291,11,2957728,Europe,38841,749
2020-08-02,Armenia,AM,209,5,2957728,Europe,39050,754
2020-08-03,Armenia,AM,52,8,2957728,Europe,39102,762
2020-08-04,Armenia,AM,0,0,2957728,Europe,39102,762
2020-08-05,Armenia,AM,196,6,2957728,Europe,39298,768
2020-08-06,Armenia,AM,288,2,2957728,Europe,39586,770
2020-08-07,Armenia,AM,233,2,2957728,Europe,39819,772
2020-08-08,Armenia,AM,66,5,2957728,Europe,39885,777
2020-08-09,Armenia,AM,300,8,2957728,Europe,40185,785
2020-08-10,Armenia,AM,225,6,2957728,Europe,40410,791
2020-08-11,Armenia,AM,23,5,2957728,Europe,40433,796
2020-08-12,Armenia,AM,160,7,2957728,Europe,40593,803
2020-08-13,Armenia,AM,201,3,2957728,Europe,40794,806
2020-08-14,Armenia,AM,229,3,2957728,Europe,41023,809
2020-08-15,Armenia,AM,276,5,2957728,Europe,41299,814
2020-08-16,Armenia,AM,196,3,2957728,Europe,41495,817
2020-08-17,Armenia,AM,168,1,2957728,Europe,41663,818
2020-08-18,Armenia,AM,38,6,2957728,Europe,41701,824
2020-08-19,Armenia,AM,145,8,2957728,Europe,41846,832
2020-08-20,Armenia,AM,210,1,2957728,Europe,42056,833
2020-08-21,Armenia,AM,263,3,2957728,Europe,42319,836
2020-08-22,Armenia,AM,158,6,2957728,Europe,42477,842
2020-08-23,Armenia,AM,139,8,2957728,Europe,42616,850
2020-08-24,Armenia,AM,176,2,2957728,Europe,42792,852
2020-08-25,Armenia,AM,33,2,2957728,Europe,42825,854
2020-08-26,Armenia,AM,111,4,2957728,Europe,42936,858
2020-08-27,Armenia,AM,131,3,2957728,Europe,43067,861
2020-08-28,Armenia,AM,203,3,2957728,Europe,43270,864
2020-08-29,Armenia,AM,181,5,2957728,Europe,43451,869
2020-08-30,Armenia,AM,175,3,2957728,Europe,43626,872
2020-08-31,Armenia,AM,124,5,2957728,Europe,43750,877
2020-09-01,Armenia,AM,31,2,2957728,Europe,43781,879
2020-09-02,Armenia,AM,97,2,2957728,Europe,43878,881
2020-09-03,Armenia,AM,197,3,2957728,Europe,44075,884
2020-09-04,Armenia,AM,196,3,2957728,Europe,44271,887
2020-09-05,Armenia,AM,190,4,2957728,Europe,44461,891
2020-09-06,Armenia,AM,188,4,2957728,Europe,44649,895
2020-09-07,Armenia,AM,134,2,2957728,Europe,44783,897
2020-09-08,Armenia,AM,62,3,2957728,Europe,44845,900
2020-09-09,Armenia,AM,108,3,2957728,Europe,44953,903
2020-09-10,Armenia,AM,199,2,2957728,Europe,45152,905
2020-09-11,Armenia,AM,174,1,2957728,Europe,45326,906
2020-09-12,Armenia,AM,177,3,2957728,Europe,45503,909
2020-09-13,Armenia,AM,172,2,2957728,Europe,45675,911
2020-09-14,Armenia,AM,187,5,2957728,Europe,45862,916
2020-09-15,Armenia,AM,107,3,2957728,Europe,45969,919
2020-09-16,Armenia,AM,150,1,2957728,Europe,46119,920
2020-09-17,Armenia,AM,257,3,2957728,Europe,46376,923
2020-09-18,Armenia,AM,295,2,2957728,Europe,46671,925
2020-09-19,Armenia,AM,239,1,2957728,Europe,46910,926
2020-09-20,Armenia,AM,244,2,2957728,Europe,47154,928
2020-09-21,Armenia,AM,277,2,2957728,Europe,47431,930
2020-09-22,Armenia,AM,121,6,2957728,Europe,47552,936
2020-09-23,Armenia,AM,115,2,2957728,Europe,47667,938
2020-09-24,Armenia,AM,210,4,2957728,Europe,47877,942
2020-09-25,Armenia,AM,374,3,2957728,Europe,48251,945
2020-09-26,Armenia,AM,392,2,2957728,Europe,48643,947
2020-09-27,Armenia,AM,429,1,2957728,Europe,49072,948
2020-09-28,Armenia,AM,328,3,2957728,Europe,49400,951
2020-09-29,Armenia,AM,174,6,2957728,Europe,49574,957
2020-09-30,Armenia,AM,327,1,2957728,Europe,49901,958
2020-10-01,Armenia,AM,458,1,2957728,Europe,50359,959
2020-10-02,Armenia,AM,491,4,2957728,Europe,50850,963
2020-10-03,Armenia,AM,532,3,2957728,Europe,51382,966
2020-10-04,Armenia,AM,543,6,2957728,Europe,51925,972
2020-10-05,Armenia,AM,571,5,2957728,Europe,52496,977
2020-10-06,Armenia,AM,181,7,2957728,Europe,52677,984
2020-10-07,Armenia,AM,406,6,2957728,Europe,53083,990
2020-10-08,Armenia,AM,672,5,2957728,Europe,53755,995
2020-10-09,Armenia,AM,718,10,2957728,Europe,54473,1005
2020-10-10,Armenia,AM,614,5,2957728,Europe,55087,1010
2020-10-11,Armenia,AM,649,6,2957728,Europe,55736,1016
2020-10-12,Armenia,AM,715,4,2957728,Europe,56451,1020
2020-10-13,Armenia,AM,1115,12,2957728,Europe,57566,1032
2020-10-14,Armenia,AM,1058,7,2957728,Europe,58624,1039
2020-10-15,Armenia,AM,0,0,2957728,Europe,58624,1039
2020-10-16,Armenia,AM,1371,7,2957728,Europe,59995,1046
2020-10-17,Armenia,AM,1465,10,2957728,Europe,61460,1056
2020-10-18,Armenia,AM,1540,11,2957728,Europe,63000,1067
2020-10-19,Armenia,AM,1694,14,2957728,Europe,64694,1081
2020-10-20,Armenia,AM,766,10,2957728,Europe,65460,1091
2020-10-21,Armenia,AM,1234,10,2957728,Europe,66694,1101
2020-10-22,Armenia,AM,1836,20,2957728,Europe,68530,1121
2020-10-23,Armenia,AM,2306,10,2957728,Europe,70836,1131
2020-10-24,Armenia,AM,2474,14,2957728,Europe,73310,1145
2020-10-25,Armenia,AM,4527,35,2957728,Europe,77837,1180
2020-10-26,Armenia,AM,973,16,2957728,Europe,78810,1196
2020-10-27,Armenia,AM,1600,26,2957728,Europe,80410,1222
2020-10-28,Armenia,AM,2241,21,2957728,Europe,82651,1243
2020-10-29,Armenia,AM,2383,29,2957728,Europe,85034,1272
2020-10-30,Armenia,AM,2398,28,2957728,Europe,87432,1300
2020-10-31,Armenia,AM,2381,41,2957728,Europe,89813,1341
2020-11-01,Armenia,AM,2441,22,2957728,Europe,92254,1363
2020-11-02,Armenia,AM,1194,28,2957728,Europe,93448,1391
2020-11-03,Armenia,AM,1328,22,2957728,Europe,94776,1413
2020-11-04,Armenia,AM,2374,35,2957728,Europe,97150,1448
2020-11-05,Armenia,AM,2413,28,2957728,Europe,99563,1476
2020-11-06,Armenia,AM,2210,30,2957728,Europe,101773,1506
2020-11-07,Armenia,AM,2476,27,2957728,Europe,104249,1533
2020-11-08,Armenia,AM,2175,26,2957728,Europe,106424,1559
2020-11-09,Armenia,AM,1042,21,2957728,Europe,107466,1580
2020-11-10,Armenia,AM,1221,29,2957728,Europe,108687,1609
2020-11-11,Armenia,AM,2000,27,2957728,Europe,110687,1636
2020-11-12,Armenia,AM,1993,32,2957728,Europe,112680,1668
2020-11-13,Armenia,AM,1703,29,2957728,Europe,114383,1697
2020-11-14,Armenia,AM,1472,41,2957728,Europe,115855,1738
2020-11-15,Armenia,AM,1482,25,2957728,Europe,117337,1763
2020-11-16,Armenia,AM,549,25,2957728,Europe,117886,1788
2020-11-17,Armenia,AM,984,23,2957728,Europe,118870,1811
2020-11-18,Armenia,AM,1589,28,2957728,Europe,120459,1839
2020-11-19,Armenia,AM,1520,31,2957728,Europe,121979,1870
2020-11-20,Armenia,AM,1667,30,2957728,Europe,123646,1900
2020-11-21,Armenia,AM,1193,31,2957728,Europe,124839,1931
2020-11-22,Armenia,AM,1385,21,2957728,Europe,126224,1952
2020-11-23,Armenia,AM,485,24,2957728,Europe,126709,1976
2020-11-24,Armenia,AM,813,26,2957728,Europe,127522,2002
2020-11-25,Armenia,AM,1563,38,2957728,Europe,129085,2040
2020-11-26,Armenia,AM,1785,28,2957728,Europe,130870,2068
2020-11-27,Armenia,AM,1476,22,2957728,Europe,132346,2090
2020-11-28,Armenia,AM,1248,31,2957728,Europe,133594,2121
2020-11-29,Armenia,AM,1174,21,2957728,Europe,134768,2142
2020-11-30,Armenia,AM,356,22,2957728,Europe,135124,2164
2020-12-01,Armenia,AM,843,29,2957728,Europe,135967,2193
2020-12-02,Armenia,AM,1264,35,2957728,Europe,137231,2228
2020-12-03,Armenia,AM,1277,26,2957728,Europe,138508,2254
2020-12-04,Armenia,AM,1184,23,2957728,Europe,139692,2277
2020-12-05,Armenia,AM,1267,32,2957728,Europe,140959,2309
2020-12-06,Armenia,AM,978,17,2957728,Europe,141937,2326
2020-12-07,Armenia,AM,407,18,2957728,Europe,142344,2344
2020-12-08,Armenia,AM,584,28,2957728,Europe,142928,2372
2020-12-09,Armenia,AM,1138,21,2957728,Europe,144066,2393
2020-12-10,Armenia,AM,1174,23,2957728,Europe,145240,2416
2020-12-11,Armenia,AM,1077,29,2957728,Europe,146317,2445
2020-12-12,Armenia,AM,995,17,2957728,Europe,147312,2462
2020-12-13,Armenia,AM,1013,24,2957728,Europe,148325,2486
2020-12-14,Armenia,AM,357,17,2957728,Europe,148682,2503
2020-03-22,Angola,AO,2,0,31825299,Africa,2,0
2020-03-23,Angola,AO,0,0,31825299,Africa,2,0
2020-03-24,Angola,AO,0,0,31825299,Africa,2,0
2020-03-25,Angola,AO,0,0,31825299,Africa,2,0
2020-03-26,Angola,AO,0,0,31825299,Africa,2,0
2020-03-27,Angola,AO,1,0,31825299,Africa,3,0
2020-03-28,Angola,AO,1,0,31825299,Africa,4,0
2020-03-29,Angola,AO,0,0,31825299,Africa,4,0
2020-03-30,Angola,AO,3,2,31825299,Africa,7,2
2020-03-31,Angola,AO,0,0,31825299,Africa,7,2
2020-04-01,Angola,AO,0,0,31825299,Africa,7,2
2020-04-02,Angola,AO,1,0,31825299,Africa,8,2
2020-04-03,Angola,AO,0,0,31825299,Africa,8,2
2020-04-04,Angola,AO,0,0,31825299,Africa,8,2
2020-04-05,Angola,AO,2,0,31825299,Africa,10,2
2020-04-06,Angola,AO,4,0,31825299,Africa,14,2
2020-04-07,Angola,AO,2,0,31825299,Africa,16,2
2020-04-08,Angola,AO,1,0,31825299,Africa,17,2
2020-04-09,Angola,AO,2,0,31825299,Africa,19,2
2020-04-10,Angola,AO,0,0,31825299,Africa,19,2
2020-04-11,Angola,AO,0,0,31825299,Africa,19,2
2020-04-12,Angola,AO,0,0,31825299,Africa,19,2
2020-04-13,Angola,AO,0,0,31825299,Africa,19,2
2020-04-14,Angola,AO,0,0,31825299,Africa,19,2
2020-04-15,Angola,AO,0,0,31825299,Africa,19,2
2020-04-16,Angola,AO,0,0,31825299,Africa,19,2
2020-04-17,Angola,AO,0,0,31825299,Africa,19,2
2020-04-18,Angola,AO,0,0,31825299,Africa,19,2
2020-04-19,Angola,AO,5,0,31825299,Africa,24,2
2020-04-20,Angola,AO,0,0,31825299,Africa,24,2
2020-04-21,Angola,AO,0,0,31825299,Africa,24,2
2020-04-22,Angola,AO,0,0,31825299,Africa,24,2
2020-04-23,Angola,AO,0,0,31825299,Africa,24,2
2020-04-24,Angola,AO,1,0,31825299,Africa,25,2
2020-04-25,Angola,AO,0,0,31825299,Africa,25,2
2020-04-26,Angola,AO,0,0,31825299,Africa,25,2
2020-04-27,Angola,AO,1,0,31825299,Africa,26,2
2020-04-28,Angola,AO,1,0,31825299,Africa,27,2
2020-04-29,Angola,AO,0,0,31825299,Africa,27,2
2020-04-30,Angola,AO,0,0,31825299,Africa,27,2
2020-05-01,Angola,AO,0,0,31825299,Africa,27,2
2020-05-02,Angola,AO,2,0,31825299,Africa,29,2
2020-05-03,Angola,AO,6,0,31825299,Africa,35,2
2020-05-04,Angola,AO,0,0,31825299,Africa,35,2
2020-05-05,Angola,AO,0,0,31825299,Africa,35,2
2020-05-06,Angola,AO,1,0,31825299,Africa,36,2
2020-05-07,Angola,AO,0,0,31825299,Africa,36,2
2020-05-08,Angola,AO,0,0,31825299,Africa,36,2
2020-05-09,Angola,AO,7,0,31825299,Africa,43,2
2020-05-10,Angola,AO,0,0,31825299,Africa,43,2
2020-05-11,Angola,AO,2,0,31825299,Africa,45,2
2020-05-12,Angola,AO,0,0,31825299,Africa,45,2
2020-05-13,Angola,AO,0,0,31825299,Africa,45,2
2020-05-14,Angola,AO,0,0,31825299,Africa,45,2
2020-05-15,Angola,AO,3,0,31825299,Africa,48,2
2020-05-16,Angola,AO,0,0,31825299,Africa,48,2
2020-05-17,Angola,AO,0,0,31825299,Africa,48,2
2020-05-18,Angola,AO,0,0,31825299,Africa,48,2
2020-05-19,Angola,AO,0,0,31825299,Africa,48,2
2020-05-20,Angola,AO,2,0,31825299,Africa,50,2
2020-05-21,Angola,AO,2,1,31825299,Africa,52,3
2020-05-22,Angola,AO,6,0,31825299,Africa,58,3
2020-05-23,Angola,AO,2,0,31825299,Africa,60,3
2020-05-24,Angola,AO,0,0,31825299,Africa,60,3
2020-05-25,Angola,AO,9,1,31825299,Africa,69,4
2020-05-26,Angola,AO,0,0,31825299,Africa,69,4
2020-05-27,Angola,AO,2,0,31825299,Africa,71,4
2020-05-28,Angola,AO,0,0,31825299,Africa,71,4
2020-05-29,Angola,AO,2,0,31825299,Africa,73,4
2020-05-30,Angola,AO,4,0,31825299,Africa,77,4
2020-05-31,Angola,AO,7,0,31825299,Africa,84,4
2020-06-01,Angola,AO,2,0,31825299,Africa,86,4
2020-06-02,Angola,AO,0,0,31825299,Africa,86,4
2020-06-03,Angola,AO,0,0,31825299,Africa,86,4
2020-06-04,Angola,AO,0,0,31825299,Africa,86,4
2020-06-05,Angola,AO,0,0,31825299,Africa,86,4
2020-06-06,Angola,AO,0,0,31825299,Africa,86,4
2020-06-07,Angola,AO,0,0,31825299,Africa,86,4
2020-06-08,Angola,AO,5,0,31825299,Africa,91,4
2020-06-09,Angola,AO,1,0,31825299,Africa,92,4
2020-06-10,Angola,AO,4,0,31825299,Africa,96,4
2020-06-11,Angola,AO,17,0,31825299,Africa,113,4
2020-06-12,Angola,AO,5,1,31825299,Africa,118,5
2020-06-13,Angola,AO,12,0,31825299,Africa,130,5
2020-06-14,Angola,AO,8,1,31825299,Africa,138,6
2020-06-15,Angola,AO,2,0,31825299,Africa,140,6
2020-06-16,Angola,AO,2,0,31825299,Africa,142,6
2020-06-17,Angola,AO,0,0,31825299,Africa,142,6
2020-06-18,Angola,AO,13,1,31825299,Africa,155,7
2020-06-19,Angola,AO,0,0,31825299,Africa,155,7
2020-06-20,Angola,AO,11,1,31825299,Africa,166,8
2020-06-21,Angola,AO,6,0,31825299,Africa,172,8
2020-06-22,Angola,AO,4,1,31825299,Africa,176,9
2020-06-23,Angola,AO,7,0,31825299,Africa,183,9
2020-06-24,Angola,AO,3,1,31825299,Africa,186,10
2020-06-25,Angola,AO,3,0,31825299,Africa,189,10
2020-06-26,Angola,AO,8,0,31825299,Africa,197,10
2020-06-27,Angola,AO,15,0,31825299,Africa,212,10
2020-06-28,Angola,AO,32,0,31825299,Africa,244,10
2020-06-29,Angola,AO,23,1,31825299,Africa,267,11
2020-06-30,Angola,AO,9,0,31825299,Africa,276,11
2020-07-01,Angola,AO,8,2,31825299,Africa,284,13
2020-07-02,Angola,AO,7,2,31825299,Africa,291,15
2020-07-03,Angola,AO,24,2,31825299,Africa,315,17
2020-07-04,Angola,AO,13,1,31825299,Africa,328,18
2020-07-05,Angola,AO,18,1,31825299,Africa,346,19
2020-07-06,Angola,AO,0,0,31825299,Africa,346,19
2020-07-07,Angola,AO,7,0,31825299,Africa,353,19
2020-07-08,Angola,AO,0,0,31825299,Africa,353,19
2020-07-09,Angola,AO,33,2,31825299,Africa,386,21
2020-07-10,Angola,AO,10,1,31825299,Africa,396,22
2020-07-11,Angola,AO,62,1,31825299,Africa,458,23
2020-07-12,Angola,AO,25,2,31825299,Africa,483,25
2020-07-13,Angola,AO,23,1,31825299,Africa,506,26
2020-07-14,Angola,AO,0,0,31825299,Africa,506,26
2020-07-15,Angola,AO,19,0,31825299,Africa,525,26
2020-07-16,Angola,AO,51,1,31825299,Africa,576,27
2020-07-17,Angola,AO,31,1,31825299,Africa,607,28
2020-07-18,Angola,AO,31,1,31825299,Africa,638,29
2020-07-19,Angola,AO,49,0,31825299,Africa,687,29
2020-07-20,Angola,AO,18,0,31825299,Africa,705,29
2020-07-21,Angola,AO,44,0,31825299,Africa,749,29
2020-07-22,Angola,AO,0,0,31825299,Africa,749,29
2020-07-23,Angola,AO,30,1,31825299,Africa,779,30
2020-07-24,Angola,AO,33,3,31825299,Africa,812,33
2020-07-25,Angola,AO,39,0,31825299,Africa,851,33
2020-07-26,Angola,AO,29,2,31825299,Africa,880,35
2020-07-27,Angola,AO,50,5,31825299,Africa,930,40
2020-07-28,Angola,AO,2,0,31825299,Africa,932,40
2020-07-29,Angola,AO,18,1,31825299,Africa,950,41
2020-07-30,Angola,AO,50,6,31825299,Africa,1000,47
2020-07-31,Angola,AO,78,1,31825299,Africa,1078,48
2020-08-01,Angola,AO,31,3,31825299,Africa,1109,51
2020-08-02,Angola,AO,5,1,31825299,Africa,1114,52
2020-08-03,Angola,AO,34,0,31825299,Africa,1148,52
2020-08-04,Angola,AO,16,2,31825299,Africa,1164,54
2020-08-05,Angola,AO,0,0,31825299,Africa,1164,54
2020-08-06,Angola,AO,180,5,31825299,Africa,1344,59
2020-08-07,Angola,AO,51,3,31825299,Africa,1395,62
2020-08-08,Angola,AO,88,2,31825299,Africa,1483,64
2020-08-09,Angola,AO,0,0,31825299,Africa,1483,64
2020-08-10,Angola,AO,89,6,31825299,Africa,1572,70
2020-08-11,Angola,AO,100,5,31825299,Africa,1672,75
2020-08-12,Angola,AO,7,3,31825299,Africa,1679,78
2020-08-13,Angola,AO,56,2,31825299,Africa,1735,80
2020-08-14,Angola,AO,27,0,31825299,Africa,1762,80
2020-08-15,Angola,AO,53,3,31825299,Africa,1815,83
2020-08-16,Angola,AO,37,3,31825299,Africa,1852,86
2020-08-17,Angola,AO,27,0,31825299,Africa,1879,86
2020-08-18,Angola,AO,27,2,31825299,Africa,1906,88
2020-08-19,Angola,AO,60,2,31825299,Africa,1966,90
2020-08-20,Angola,AO,0,0,31825299,Africa,1966,90
2020-08-21,Angola,AO,49,2,31825299,Africa,2015,92
2020-08-22,Angola,AO,29,1,31825299,Africa,2044,93
2020-08-23,Angola,AO,24,1,31825299,Africa,2068,94
2020-08-24,Angola,AO,103,2,31825299,Africa,2171,96
2020-08-25,Angola,AO,51,4,31825299,Africa,2222,100
2020-08-26,Angola,AO,61,2,31825299,Africa,2283,102
2020-08-27,Angola,AO,49,1,31825299,Africa,2332,103
2020-08-28,Angola,AO,83,2,31825299,Africa,2415,105
2020-08-29,Angola,AO,56,1,31825299,Africa,2471,106
2020-08-30,Angola,AO,80,1,31825299,Africa,2551,107
2020-08-31,Angola,AO,73,0,31825299,Africa,2624,107
2020-09-01,Angola,AO,0,0,31825299,Africa,2624,107
2020-09-02,Angola,AO,30,1,31825299,Africa,2654,108
2020-09-03,Angola,AO,75,1,31825299,Africa,2729,109
2020-09-04,Angola,AO,48,3,31825299,Africa,2777,112
2020-09-05,Angola,AO,28,1,31825299,Africa,2805,113
2020-09-06,Angola,AO,71,2,31825299,Africa,2876,115
2020-09-07,Angola,AO,59,2,31825299,Africa,2935,117
2020-09-08,Angola,AO,30,0,31825299,Africa,2965,117
2020-09-09,Angola,AO,16,3,31825299,Africa,2981,120
2020-09-10,Angola,AO,52,4,31825299,Africa,3033,124
2020-09-11,Angola,AO,59,2,31825299,Africa,3092,126
2020-09-12,Angola,AO,125,4,31825299,Africa,3217,130
2020-09-13,Angola,AO,62,1,31825299,Africa,3279,131
2020-09-14,Angola,AO,56,1,31825299,Africa,3335,132
2020-09-15,Angola,AO,53,2,31825299,Africa,3388,134
2020-09-16,Angola,AO,51,0,31825299,Africa,3439,134
2020-09-17,Angola,AO,130,5,31825299,Africa,3569,139
2020-09-18,Angola,AO,180,5,31825299,Africa,3749,144
2020-09-19,Angola,AO,40,0,31825299,Africa,3789,144
2020-09-20,Angola,AO,112,0,31825299,Africa,3901,144
2020-09-21,Angola,AO,90,8,31825299,Africa,3991,152
2020-09-22,Angola,AO,126,2,31825299,Africa,4117,154
2020-09-23,Angola,AO,119,1,31825299,Africa,4236,155
2020-09-24,Angola,AO,0,0,31825299,Africa,4236,155
2020-09-25,Angola,AO,127,4,31825299,Africa,4363,159
2020-09-26,Angola,AO,112,3,31825299,Africa,4475,162
2020-09-27,Angola,AO,115,5,31825299,Africa,4590,167
2020-09-28,Angola,AO,82,4,31825299,Africa,4672,171
2020-09-29,Angola,AO,125,5,31825299,Africa,4797,176
2020-09-30,Angola,AO,108,3,31825299,Africa,4905,179
2020-10-01,Angola,AO,67,3,31825299,Africa,4972,182
2020-10-02,Angola,AO,0,1,31825299,Africa,4972,183
2020-10-03,Angola,AO,142,2,31825299,Africa,5114,185
2020-10-04,Angola,AO,97,4,31825299,Africa,5211,189
2020-10-05,Angola,AO,159,4,31825299,Africa,5370,193
2020-10-06,Angola,AO,0,0,31825299,Africa,5370,193
2020-10-07,Angola,AO,355,13,31825299,Africa,5725,206
2020-10-08,Angola,AO,0,0,31825299,Africa,5725,206
2020-10-09,Angola,AO,138,0,31825299,Africa,5863,206
2020-10-10,Angola,AO,95,2,31825299,Africa,5958,208
2020-10-11,Angola,AO,73,4,31825299,Africa,6031,212
2020-10-12,Angola,AO,215,6,31825299,Africa,6246,218
2020-10-13,Angola,AO,120,0,31825299,Africa,6366,218
2020-10-14,Angola,AO,122,1,31825299,Africa,6488,219
2020-10-15,Angola,AO,192,3,31825299,Africa,6680,222
2020-10-16,Angola,AO,166,5,31825299,Africa,6846,227
2020-10-17,Angola,AO,250,1,31825299,Africa,7096,228
2020-10-18,Angola,AO,126,6,31825299,Africa,7222,234
2020-10-19,Angola,AO,240,7,31825299,Africa,7462,241
2020-10-20,Angola,AO,160,6,31825299,Africa,7622,247
2020-10-21,Angola,AO,207,1,31825299,Africa,7829,248
2020-10-22,Angola,AO,220,3,31825299,Africa,8049,251
2020-10-23,Angola,AO,289,4,31825299,Africa,8338,255
2020-10-24,Angola,AO,244,5,31825299,Africa,8582,260
2020-10-25,Angola,AO,247,5,31825299,Africa,8829,265
2020-10-26,Angola,AO,197,2,31825299,Africa,9026,267
2020-10-27,Angola,AO,355,1,31825299,Africa,9381,268
2020-10-28,Angola,AO,263,2,31825299,Africa,9644,270
2020-10-29,Angola,AO,227,1,31825299,Africa,9871,271
2020-10-30,Angola,AO,203,4,31825299,Africa,10074,275
2020-10-31,Angola,AO,195,0,31825299,Africa,10269,275
2020-11-01,Angola,AO,289,4,31825299,Africa,10558,279
2020-11-02,Angola,AO,247,5,31825299,Africa,10805,284
2020-11-03,Angola,AO,230,2,31825299,Africa,11035,286
2020-11-04,Angola,AO,193,3,31825299,Africa,11228,289
2020-11-05,Angola,AO,349,2,31825299,Africa,11577,291
2020-11-06,Angola,AO,236,5,31825299,Africa,11813,296
2020-11-07,Angola,AO,289,3,31825299,Africa,12102,299
2020-11-08,Angola,AO,121,1,31825299,Africa,12223,300
2020-11-09,Angola,AO,112,3,31825299,Africa,12335,303
2020-11-10,Angola,AO,98,4,31825299,Africa,12433,307
2020-11-11,Angola,AO,247,1,31825299,Africa,12680,308
2020-11-12,Angola,AO,136,0,31825299,Africa,12816,308
2020-11-13,Angola,AO,137,4,31825299,Africa,12953,312
2020-11-14,Angola,AO,104,3,31825299,Africa,13057,315
2020-11-15,Angola,AO,171,2,31825299,Africa,13228,317
2020-11-16,Angola,AO,146,5,31825299,Africa,13374,322
2020-11-17,Angola,AO,77,0,31825299,Africa,13451,322
2020-11-18,Angola,AO,164,0,31825299,Africa,13615,322
2020-11-19,Angola,AO,203,6,31825299,Africa,13818,328
2020-11-20,Angola,AO,104,4,31825299,Africa,13922,332
2020-11-21,Angola,AO,212,1,31825299,Africa,14134,333
2020-11-22,Angola,AO,279,3,31825299,Africa,14413,336
2020-11-23,Angola,AO,80,1,31825299,Africa,14493,337
2020-11-24,Angola,AO,0,0,31825299,Africa,14493,337
2020-11-25,Angola,AO,141,0,31825299,Africa,14634,337
2020-11-26,Angola,AO,108,1,31825299,Africa,14742,338
2020-11-27,Angola,AO,79,2,31825299,Africa,14821,340
2020-11-28,Angola,AO,99,1,31825299,Africa,14920,341
2020-11-29,Angola,AO,167,4,31825299,Africa,15087,345
2020-11-30,Angola,AO,16,1,31825299,Africa,15103,346
2020-12-01,Angola,AO,36,2,31825299,Africa,15139,348
2020-12-02,Angola,AO,112,2,31825299,Africa,15251,350
2020-12-03,Angola,AO,68,1,31825299,Africa,15319,351
2020-12-04,Angola,AO,42,1,31825299,Africa,15361,352
2020-12-05,Angola,AO,132,1,31825299,Africa,15493,353
2020-12-06,Angola,AO,43,1,31825299,Africa,15536,354
2020-12-07,Angola,AO,0,0,31825299,Africa,15536,354
2020-12-08,Angola,AO,112,0,31825299,Africa,15648,354
2020-12-09,Angola,AO,81,1,31825299,Africa,15729,355
2020-12-10,Angola,AO,75,3,31825299,Africa,15804,358
2020-12-11,Angola,AO,121,4,31825299,Africa,15925,362
2020-12-12,Angola,AO,136,3,31825299,Africa,16061,365
2020-12-13,Angola,AO,100,1,31825299,Africa,16161,366
2020-12-14,Angola,AO,27,5,31825299,Africa,16188,371
2020-03-04,Argentina,AR,1,0,44780675,America,1,0
2020-03-06,Argentina,AR,1,0,44780675,America,2,0
2020-03-07,Argentina,AR,6,0,44780675,America,8,0
2020-03-08,Argentina,AR,1,1,44780675,America,9,1
2020-03-09,Argentina,AR,3,0,44780675,America,12,1
2020-03-11,Argentina,AR,7,0,44780675,America,19,1
2020-03-13,Argentina,AR,12,0,44780675,America,31,1
2020-03-14,Argentina,AR,3,1,44780675,America,34,2
2020-03-15,Argentina,AR,11,0,44780675,America,45,2
2020-03-16,Argentina,AR,11,0,44780675,America,56,2
2020-03-17,Argentina,AR,9,0,44780675,America,65,2
2020-03-18,Argentina,AR,14,0,44780675,America,79,2
2020-03-19,Argentina,AR,18,0,44780675,America,97,2
2020-03-20,Argentina,AR,31,1,44780675,America,128,3
2020-03-21,Argentina,AR,30,0,44780675,America,158,3
2020-03-22,Argentina,AR,67,1,44780675,America,225,4
2020-03-23,Argentina,AR,41,0,44780675,America,266,4
2020-03-24,Argentina,AR,35,0,44780675,America,301,4
2020-03-25,Argentina,AR,86,2,44780675,America,387,6
2020-03-26,Argentina,AR,115,2,44780675,America,502,8
2020-03-27,Argentina,AR,87,4,44780675,America,589,12
2020-03-28,Argentina,AR,101,5,44780675,America,690,17
2020-03-29,Argentina,AR,55,2,44780675,America,745,19
2020-03-30,Argentina,AR,75,1,44780675,America,820,20
2020-03-31,Argentina,AR,146,4,44780675,America,966,24
2020-04-01,Argentina,AR,0,0,44780675,America,966,24
2020-04-02,Argentina,AR,167,7,44780675,America,1133,31
2020-04-03,Argentina,AR,0,3,44780675,America,1133,34
2020-04-04,Argentina,AR,132,3,44780675,America,1265,37
2020-04-05,Argentina,AR,186,6,44780675,America,1451,43
2020-04-06,Argentina,AR,103,3,44780675,America,1554,46
2020-04-07,Argentina,AR,74,7,44780675,America,1628,53
2020-04-08,Argentina,AR,87,7,44780675,America,1715,60
2020-04-09,Argentina,AR,80,5,44780675,America,1795,65
2020-04-10,Argentina,AR,99,14,44780675,America,1894,79
2020-04-11,Argentina,AR,81,3,44780675,America,1975,82
2020-04-12,Argentina,AR,162,7,44780675,America,2137,89
2020-04-13,Argentina,AR,66,6,44780675,America,2203,95
2020-04-14,Argentina,AR,69,3,44780675,America,2272,98
2020-04-15,Argentina,AR,160,7,44780675,America,2432,105
2020-04-16,Argentina,AR,0,4,44780675,America,2432,109
2020-04-17,Argentina,AR,128,6,44780675,America,2560,115
2020-04-18,Argentina,AR,98,7,44780675,America,2658,122
2020-04-19,Argentina,AR,170,10,44780675,America,2828,132
2020-04-20,Argentina,AR,102,2,44780675,America,2930,134
2020-04-21,Argentina,AR,90,8,44780675,America,3020,142
2020-04-22,Argentina,AR,112,9,44780675,America,3132,151
2020-04-23,Argentina,AR,144,8,44780675,America,3276,159
2020-04-24,Argentina,AR,147,6,44780675,America,3423,165
2020-04-25,Argentina,AR,0,2,44780675,America,3423,167
2020-04-26,Argentina,AR,344,18,44780675,America,3767,185
2020-04-27,Argentina,AR,0,1,44780675,America,3767,186
2020-04-28,Argentina,AR,223,11,44780675,America,3990,197
2020-04-29,Argentina,AR,124,10,44780675,America,4114,207
2020-04-30,Argentina,AR,158,7,44780675,America,4272,214
2020-05-01,Argentina,AR,143,4,44780675,America,4415,218
2020-05-02,Argentina,AR,104,7,44780675,America,4519,225
2020-05-03,Argentina,AR,149,12,44780675,America,4668,237
2020-05-04,Argentina,AR,102,9,44780675,America,4770,246
2020-05-05,Argentina,AR,104,14,44780675,America,4874,260
2020-05-06,Argentina,AR,133,4,44780675,America,5007,264
2020-05-07,Argentina,AR,188,9,44780675,America,5195,273
2020-05-08,Argentina,AR,163,9,44780675,America,5358,282
2020-05-09,Argentina,AR,240,11,44780675,America,5598,293
2020-05-10,Argentina,AR,165,7,44780675,America,5763,300
2020-05-11,Argentina,AR,13,0,44780675,America,5776,300
2020-05-12,Argentina,AR,245,5,44780675,America,6021,305
2020-05-13,Argentina,AR,529,14,44780675,America,6550,319
2020-05-14,Argentina,AR,316,10,44780675,America,6866,329
2020-05-15,Argentina,AR,255,24,44780675,America,7121,353
2020-05-16,Argentina,AR,345,3,44780675,America,7466,356
2020-05-17,Argentina,AR,326,7,44780675,America,7792,363
2020-05-18,Argentina,AR,0,3,44780675,America,7792,366
2020-05-19,Argentina,AR,566,16,44780675,America,8358,382
2020-05-20,Argentina,AR,438,11,44780675,America,8796,393
2020-05-21,Argentina,AR,474,10,44780675,America,9270,403
2020-05-22,Argentina,AR,648,13,44780675,America,9918,416
2020-05-23,Argentina,AR,718,17,44780675,America,10636,433
2020-05-24,Argentina,AR,704,12,44780675,America,11340,445
2020-05-25,Argentina,AR,723,7,44780675,America,12063,452
2020-05-26,Argentina,AR,552,15,44780675,America,12615,467
2020-05-27,Argentina,AR,600,17,44780675,America,13215,484
2020-05-28,Argentina,AR,705,16,44780675,America,13920,500
2020-05-29,Argentina,AR,769,8,44780675,America,14689,508
2020-05-30,Argentina,AR,717,12,44780675,America,15406,520
2020-05-31,Argentina,AR,795,8,44780675,America,16201,528
2020-06-01,Argentina,AR,637,11,44780675,America,16838,539
2020-06-02,Argentina,AR,564,17,44780675,America,17402,556
2020-06-03,Argentina,AR,904,13,44780675,America,18306,569
2020-06-04,Argentina,AR,949,14,44780675,America,19255,583
2020-06-05,Argentina,AR,0,5,44780675,America,19255,588
2020-06-06,Argentina,AR,1769,44,44780675,America,21024,632
2020-06-07,Argentina,AR,983,16,44780675,America,22007,648
2020-06-08,Argentina,AR,774,16,44780675,America,22781,664
2020-06-09,Argentina,AR,826,29,44780675,America,23607,693
2020-06-10,Argentina,AR,1141,24,44780675,America,24748,717
2020-06-11,Argentina,AR,1239,18,44780675,America,25987,735
2020-06-12,Argentina,AR,1373,30,44780675,America,27360,765
2020-06-13,Argentina,AR,1391,20,44780675,America,28751,785
2020-06-14,Argentina,AR,1531,30,44780675,America,30282,815
2020-06-15,Argentina,AR,1282,18,44780675,America,31564,833
2020-06-16,Argentina,AR,1208,21,44780675,America,32772,854
2020-06-17,Argentina,AR,1374,24,44780675,America,34146,878
2020-06-18,Argentina,AR,1393,35,44780675,America,35539,913
2020-06-19,Argentina,AR,0,16,44780675,America,35539,929
2020-06-20,Argentina,AR,4018,50,44780675,America,39557,979
2020-06-21,Argentina,AR,1634,13,44780675,America,41191,992
2020-06-22,Argentina,AR,1581,19,44780675,America,42772,1011
2020-06-23,Argentina,AR,2146,32,44780675,America,44918,1043
2020-06-24,Argentina,AR,0,6,44780675,America,44918,1049
2020-06-25,Argentina,AR,4920,36,44780675,America,49838,1085
2020-06-26,Argentina,AR,2606,39,44780675,America,52444,1124
2020-06-27,Argentina,AR,0,43,44780675,America,52444,1167
2020-06-28,Argentina,AR,5287,40,44780675,America,57731,1207
2020-06-29,Argentina,AR,0,10,44780675,America,57731,1217
2020-06-30,Argentina,AR,4524,63,44780675,America,62255,1280
2020-07-01,Argentina,AR,2262,27,44780675,America,64517,1307
2020-07-02,Argentina,AR,2667,44,44780675,America,67184,1351
2020-07-03,Argentina,AR,2744,34,44780675,America,69928,1385
2020-07-04,Argentina,AR,2845,52,44780675,America,72773,1437
2020-07-05,Argentina,AR,0,16,44780675,America,72773,1453
2020-07-06,Argentina,AR,2590,37,44780675,America,75363,1490
2020-07-07,Argentina,AR,2439,33,44780675,America,77802,1523
2020-07-08,Argentina,AR,2632,79,44780675,America,80434,1602
2020-07-09,Argentina,AR,2979,52,44780675,America,83413,1654
2020-07-10,Argentina,AR,3604,53,44780675,America,87017,1707
2020-07-11,Argentina,AR,3663,42,44780675,America,90680,1749
2020-07-12,Argentina,AR,3367,61,44780675,America,94047,1810
2020-07-13,Argentina,AR,3449,8,44780675,America,97496,1818
2020-07-14,Argentina,AR,2657,85,44780675,America,100153,1903
2020-07-15,Argentina,AR,3099,23,44780675,America,103252,1926
2020-07-16,Argentina,AR,3645,124,44780675,America,106897,2050
2020-07-17,Argentina,AR,4250,62,44780675,America,111147,2112
2020-07-18,Argentina,AR,3623,21,44780675,America,114770,2133
2020-07-19,Argentina,AR,4518,71,44780675,America,119288,2204
2020-07-20,Argentina,AR,3223,42,44780675,America,122511,2246
2020-07-21,Argentina,AR,4231,127,44780675,America,126742,2373
2020-07-22,Argentina,AR,4019,0,44780675,America,130761,2373
2020-07-23,Argentina,AR,5344,133,44780675,America,136105,2506
2020-07-24,Argentina,AR,5782,111,44780675,America,141887,2617
2020-07-25,Argentina,AR,6127,105,44780675,America,148014,2722
2020-07-26,Argentina,AR,5493,125,44780675,America,153507,2847
2020-07-27,Argentina,AR,9006,92,44780675,America,162513,2939
2020-07-28,Argentina,AR,0,17,44780675,America,162513,2956
2020-07-29,Argentina,AR,4890,126,44780675,America,167403,3082
2020-07-30,Argentina,AR,5939,118,44780675,America,173342,3200
2020-07-31,Argentina,AR,5641,111,44780675,America,178983,3311
2020-08-01,Argentina,AR,6377,155,44780675,America,185360,3466
2020-08-02,Argentina,AR,5929,92,44780675,America,191289,3558
2020-08-03,Argentina,AR,5241,54,44780675,America,196530,3612
2020-08-04,Argentina,AR,5376,55,44780675,America,201906,3667
2020-08-05,Argentina,AR,4824,196,44780675,America,206730,3863
2020-08-06,Argentina,AR,6792,146,44780675,America,213522,4009
2020-08-07,Argentina,AR,7147,126,44780675,America,220669,4135
2020-08-08,Argentina,AR,7513,156,44780675,America,228182,4291
2020-08-09,Argentina,AR,7482,159,44780675,America,235664,4450
2020-08-10,Argentina,AR,6134,106,44780675,America,241798,4556
2020-08-11,Argentina,AR,4688,78,44780675,America,246486,4634
2020-08-12,Argentina,AR,7369,151,44780675,America,253855,4785
2020-08-13,Argentina,AR,7043,303,44780675,America,260898,5088
2020-08-14,Argentina,AR,7663,158,44780675,America,268561,5246
2020-08-15,Argentina,AR,7498,182,44780675,America,276059,5428
2020-08-16,Argentina,AR,6365,137,44780675,America,282424,5565
2020-08-17,Argentina,AR,6663,92,44780675,America,289087,5657
2020-08-18,Argentina,AR,5469,93,44780675,America,294556,5750
2020-08-19,Argentina,AR,4557,127,44780675,America,299113,5877
2020-08-20,Argentina,AR,6840,237,44780675,America,305953,6114
2020-08-21,Argentina,AR,6693,292,44780675,America,312646,6406
2020-08-22,Argentina,AR,8225,161,44780675,America,320871,6567
2020-08-23,Argentina,AR,8159,228,44780675,America,329030,6795
2020-08-24,Argentina,AR,7759,53,44780675,America,336789,6848
2020-08-25,Argentina,AR,5352,231,44780675,America,342141,7079
2020-08-26,Argentina,AR,8713,323,44780675,America,350854,7402
2020-08-27,Argentina,AR,8771,259,44780675,America,359625,7661
2020-08-28,Argentina,AR,10550,283,44780675,America,370175,7944
2020-08-29,Argentina,AR,10104,185,44780675,America,380279,8129
2020-08-30,Argentina,AR,11730,176,44780675,America,392009,8305
2020-08-31,Argentina,AR,9217,96,44780675,America,401226,8401
2020-09-01,Argentina,AR,7187,97,44780675,America,408413,8498
2020-09-02,Argentina,AR,9309,232,44780675,America,417722,8730
2020-09-03,Argentina,AR,10504,241,44780675,America,428226,8971
2020-09-04,Argentina,AR,10933,184,44780675,America,439159,9155
2020-09-05,Argentina,AR,12026,313,44780675,America,451185,9468
2020-09-06,Argentina,AR,10684,217,44780675,America,461869,9685
2020-09-07,Argentina,AR,9924,122,44780675,America,471793,9807
2020-09-08,Argentina,AR,6986,105,44780675,America,478779,9912
2020-09-09,Argentina,AR,9215,267,44780675,America,487994,10179
2020-09-10,Argentina,AR,12027,278,44780675,America,500021,10457
2020-09-11,Argentina,AR,12259,256,44780675,America,512280,10713
2020-09-12,Argentina,AR,11905,281,44780675,America,524185,10994
2020-09-13,Argentina,AR,11505,212,44780675,America,535690,11206
2020-09-14,Argentina,AR,10778,101,44780675,America,546468,11307
2020-09-15,Argentina,AR,9056,105,44780675,America,555524,11412
2020-09-16,Argentina,AR,9908,298,44780675,America,565432,11710
2020-09-17,Argentina,AR,11893,200,44780675,America,577325,11910
2020-09-18,Argentina,AR,11674,319,44780675,America,588999,12229
2020-09-19,Argentina,AR,12701,262,44780675,America,601700,12491
2020-09-20,Argentina,AR,11945,214,44780675,America,613645,12705
2020-09-21,Argentina,AR,9276,204,44780675,America,622921,12909
2020-09-22,Argentina,AR,17213,573,44780675,America,640134,13482
2020-09-23,Argentina,AR,12027,470,44780675,America,652161,13952
2020-09-24,Argentina,AR,12638,424,44780675,America,664799,14376
2020-09-25,Argentina,AR,13467,390,44780675,America,678266,14766
2020-09-26,Argentina,AR,12956,442,44780675,America,691222,15208
2020-09-27,Argentina,AR,11249,335,44780675,America,702471,15543
2020-09-28,Argentina,AR,8841,206,44780675,America,711312,15749
2020-09-29,Argentina,AR,11807,364,44780675,America,723119,16113
2020-09-30,Argentina,AR,13477,406,44780675,America,736596,16519
2020-10-01,Argentina,AR,14392,418,44780675,America,750988,16937
2020-10-02,Argentina,AR,14001,3351,44780675,America,764989,20288
2020-10-03,Argentina,AR,14687,311,44780675,America,779676,20599
2020-10-04,Argentina,AR,11129,196,44780675,America,790805,20795
2020-10-05,Argentina,AR,7668,223,44780675,America,798473,21018
2020-10-06,Argentina,AR,11242,450,44780675,America,809715,21468
2020-10-07,Argentina,AR,14740,359,44780675,America,824455,21827
2020-10-08,Argentina,AR,16447,399,44780675,America,840902,22226
2020-10-09,Argentina,AR,15454,484,44780675,America,856356,22710
2020-10-10,Argentina,AR,15099,515,44780675,America,871455,23225
2020-10-11,Argentina,AR,12428,356,44780675,America,883883,23581
2020-10-12,Argentina,AR,10310,287,44780675,America,894193,23868
2020-10-13,Argentina,AR,9524,318,44780675,America,903717,24186
2020-10-14,Argentina,AR,13305,386,44780675,America,917022,24572
2020-10-15,Argentina,AR,14932,349,44780675,America,931954,24921
2020-10-16,Argentina,AR,17096,421,44780675,America,949050,25342
2020-10-17,Argentina,AR,16546,381,44780675,America,965596,25723
2020-10-18,Argentina,AR,13510,384,44780675,America,979106,26107
2020-10-19,Argentina,AR,10561,160,44780675,America,989667,26267
2020-10-20,Argentina,AR,12982,449,44780675,America,1002649,26716
2020-10-21,Argentina,AR,16337,384,44780675,America,1018986,27100
2020-10-22,Argentina,AR,18326,419,44780675,America,1037312,27519
2020-10-23,Argentina,AR,16325,438,44780675,America,1053637,27957
2020-10-24,Argentina,AR,15718,381,44780675,America,1069355,28338
2020-10-25,Argentina,AR,11968,275,44780675,America,1081323,28613
2020-10-26,Argentina,AR,9253,283,44780675,America,1090576,28896
2020-10-27,Argentina,AR,11712,405,44780675,America,1102288,29301
2020-10-28,Argentina,AR,14308,429,44780675,America,1116596,29730
2020-10-29,Argentina,AR,13924,341,44780675,America,1130520,30071
2020-10-30,Argentina,AR,12691,371,44780675,America,1143211,30442
2020-10-31,Argentina,AR,13955,350,44780675,America,1157166,30792
2020-11-01,Argentina,AR,9745,210,44780675,America,1166911,31002
2020-11-02,Argentina,AR,6609,138,44780675,America,1173520,31140
2020-11-03,Argentina,AR,9598,483,44780675,America,1183118,31623
2020-11-04,Argentina,AR,12145,429,44780675,America,1195263,32052
2020-11-05,Argentina,AR,10652,468,44780675,America,1205915,32520
2020-11-06,Argentina,AR,11100,246,44780675,America,1217015,32766
2020-11-07,Argentina,AR,11786,370,44780675,America,1228801,33136
2020-11-08,Argentina,AR,8037,212,44780675,America,1236838,33348
2020-11-09,Argentina,AR,5331,212,44780675,America,1242169,33560
2020-11-10,Argentina,AR,8317,347,44780675,America,1250486,33907
2020-11-11,Argentina,AR,11976,276,44780675,America,1262462,34183
2020-11-12,Argentina,AR,10880,348,44780675,America,1273342,34531
2020-11-13,Argentina,AR,11162,251,44780675,America,1284504,34782
2020-11-14,Argentina,AR,11859,263,44780675,America,1296363,35045
2020-11-15,Argentina,AR,8468,262,44780675,America,1304831,35307
2020-11-16,Argentina,AR,5645,129,44780675,America,1310476,35436
2020-11-17,Argentina,AR,7895,291,44780675,America,1318371,35727
2020-11-18,Argentina,AR,10621,379,44780675,America,1328992,36106
2020-11-19,Argentina,AR,10332,241,44780675,America,1339324,36347
2020-11-20,Argentina,AR,10110,185,44780675,America,1349434,36532
2020-11-21,Argentina,AR,9592,258,44780675,America,1359026,36790
2020-11-22,Argentina,AR,7143,112,44780675,America,1366169,36902
2020-11-23,Argentina,AR,4181,100,44780675,America,1370350,37002
2020-11-24,Argentina,AR,3998,120,44780675,America,1374348,37122
2020-11-25,Argentina,AR,7434,310,44780675,America,1381782,37432
2020-11-26,Argentina,AR,8593,269,44780675,America,1390375,37701
2020-11-27,Argentina,AR,9043,240,44780675,America,1399418,37941
2020-11-28,Argentina,AR,7846,262,44780675,America,1407264,38203
2020-11-29,Argentina,AR,6098,106,44780675,America,1413362,38309
2020-11-30,Argentina,AR,5432,164,44780675,America,1418794,38473
2020-12-01,Argentina,AR,5724,257,44780675,America,1424518,38730
2020-12-02,Argentina,AR,8037,198,44780675,America,1432555,38928
2020-12-03,Argentina,AR,7535,228,44780675,America,1440090,39156
2020-12-04,Argentina,AR,7625,149,44780675,America,1447715,39305
2020-12-05,Argentina,AR,6899,207,44780675,America,1454614,39512
2020-12-06,Argentina,AR,5201,120,44780675,America,1459815,39632
2020-12-07,Argentina,AR,3278,138,44780675,America,1463093,39770
2020-12-08,Argentina,AR,3216,118,44780675,America,1466309,39888
2020-12-09,Argentina,AR,3610,121,44780675,America,1469919,40009
2020-12-10,Argentina,AR,5303,213,44780675,America,1475222,40222
2020-12-11,Argentina,AR,6994,209,44780675,America,1482216,40431
2020-12-12,Argentina,AR,7112,175,44780675,America,1489328,40606
2020-12-13,Argentina,AR,5274,62,44780675,America,1494602,40668
2020-12-14,Argentina,AR,3558,98,44780675,America,1498160,40766
2019-12-31,Austria,AT,0,0,8858775,Europe,0,0
2020-01-01,Austria,AT,0,0,8858775,Europe,0,0
2020-01-02,Austria,AT,0,0,8858775,Europe,0,0
2020-01-03,Austria,AT,0,0,8858775,Europe,0,0
2020-01-04,Austria,AT,0,0,8858775,Europe,0,0
2020-01-05,Austria,AT,0,0,8858775,Europe,0,0
2020-01-06,Austria,AT,0,0,8858775,Europe,0,0
2020-01-07,Austria,AT,0,0,8858775,Europe,0,0
2020-01-08,Austria,AT,0,0,8858775,Europe,0,0
2020-01-09,Austria,AT,0,0,8858775,Europe,0,0
2020-01-10,Austria,AT,0,0,8858775,Europe,0,0
2020-01-11,Austria,AT,0,0,8858775,Europe,0,0
2020-01-12,Austria,AT,0,0,8858775,Europe,0,0
2020-01-13,Austria,AT,0,0,8858775,Europe,0,0
2020-01-14,Austria,AT,0,0,8858775,Europe,0,0
2020-01-15,Austria,AT,0,0,8858775,Europe,0,0
2020-01-16,Austria,AT,0,0,8858775,Europe,0,0
2020-01-17,Austria,AT,0,0,8858775,Europe,0,0
2020-01-18,Austria,AT,0,0,8858775,Europe,0,0
2020-01-19,Austria,AT,0,0,8858775,Europe,0,0
2020-01-20,Austria,AT,0,0,8858775,Europe,0,0
2020-01-21,Austria,AT,0,0,8858775,Europe,0,0
2020-01-22,Austria,AT,0,0,8858775,Europe,0,0
2020-01-23,Austria,AT,0,0,8858775,Europe,0,0
2020-01-24,Austria,AT,0,0,8858775,Europe,0,0
2020-01-25,Austria,AT,0,0,8858775,Europe,0,0
2020-01-26,Austria,AT,0,0,8858775,Europe,0,0
2020-01-27,Austria,AT,0,0,8858775,Europe,0,0
2020-01-28,Austria,AT,0,0,8858775,Europe,0,0
2020-01-29,Austria,AT,0,0,8858775,Europe,0,0
2020-01-30,Austria,AT,0,0,8858775,Europe,0,0
2020-01-31,Austria,AT,0,0,8858775,Europe,0,0
2020-02-01,Austria,AT,0,0,8858775,Europe,0,0
2020-02-02,Austria,AT,0,0,8858775,Europe,0,0
2020-02-03,Austria,AT,0,0,8858775,Europe,0,0
2020-02-04,Austria,AT,0,0,8858775,Europe,0,0
2020-02-05,Austria,AT,0,0,8858775,Europe,0,0
2020-02-06,Austria,AT,0,0,8858775,Europe,0,0
2020-02-07,Austria,AT,0,0,8858775,Europe,0,0
2020-02-08,Austria,AT,0,0,8858775,Europe,0,0
2020-02-09,Austria,AT,0,0,8858775,Europe,0,0
2020-02-10,Austria,AT,0,0,8858775,Europe,0,0
2020-02-11,Austria,AT,0,0,8858775,Europe,0,0
2020-02-12,Austria,AT,0,0,8858775,Europe,0,0
2020-02-13,Austria,AT,0,0,8858775,Europe,0,0
2020-02-14,Austria,AT,0,0,8858775,Europe,0,0
2020-02-15,Austria,AT,0,0,8858775,Europe,0,0
2020-02-16,Austria,AT,0,0,8858775,Europe,0,0
2020-02-17,Austria,AT,0,0,8858775,Europe,0,0
2020-02-18,Austria,AT,0,0,8858775,Europe,0,0
2020-02-19,Austria,AT,0,0,8858775,Europe,0,0
2020-02-20,Austria,AT,0,0,8858775,Europe,0,0
2020-02-21,Austria,AT,0,0,8858775,Europe,0,0
2020-02-22,Austria,AT,0,0,8858775,Europe,0,0
2020-02-23,Austria,AT,0,0,8858775,Europe,0,0
2020-02-24,Austria,AT,0,0,8858775,Europe,0,0
2020-02-25,Austria,AT,0,0,8858775,Europe,0,0
2020-02-26,Austria,AT,2,0,8858775,Europe,2,0
2020-02-27,Austria,AT,0,0,8858775,Europe,2,0
2020-02-28,Austria,AT,3,0,8858775,Europe,5,0
2020-02-29,Austria,AT,2,0,8858775,Europe,7,0
2020-03-01,Austria,AT,3,0,8858775,Europe,10,0
2020-03-02,Austria,AT,4,0,8858775,Europe,14,0
2020-03-03,Austria,AT,4,0,8858775,Europe,18,0
2020-03-04,Austria,AT,6,0,8858775,Europe,24,0
2020-03-05,Austria,AT,5,0,8858775,Europe,29,0
2020-03-06,Austria,AT,12,0,8858775,Europe,41,0
2020-03-07,Austria,AT,33,0,8858775,Europe,74,0
2020-03-08,Austria,AT,25,0,8858775,Europe,99,0
2020-03-09,Austria,AT,3,0,8858775,Europe,102,0
2020-03-10,Austria,AT,29,0,8858775,Europe,131,0
2020-03-11,Austria,AT,51,0,8858775,Europe,182,0
2020-03-12,Austria,AT,64,0,8858775,Europe,246,0
2020-03-13,Austria,AT,115,1,8858775,Europe,361,1
2020-03-14,Austria,AT,143,0,8858775,Europe,504,1
2020-03-15,Austria,AT,151,0,8858775,Europe,655,1
2020-03-16,Austria,AT,205,0,8858775,Europe,860,1
2020-03-17,Austria,AT,156,2,8858775,Europe,1016,3
2020-03-18,Austria,AT,316,0,8858775,Europe,1332,3
2020-03-19,Austria,AT,314,1,8858775,Europe,1646,4
2020-03-20,Austria,AT,550,2,8858775,Europe,2196,6
2020-03-21,Austria,AT,453,0,8858775,Europe,2649,6
2020-03-22,Austria,AT,375,2,8858775,Europe,3024,8
2020-03-23,Austria,AT,607,8,8858775,Europe,3631,16
2020-03-24,Austria,AT,855,9,8858775,Europe,4486,25
2020-03-25,Austria,AT,796,5,8858775,Europe,5282,30
2020-03-26,Austria,AT,606,4,8858775,Europe,5888,34
2020-03-27,Austria,AT,1141,18,8858775,Europe,7029,52
2020-03-28,Austria,AT,668,16,8858775,Europe,7697,68
2020-03-29,Austria,AT,594,0,8858775,Europe,8291,68
2020-03-30,Austria,AT,522,18,8858775,Europe,8813,86
2020-03-31,Austria,AT,805,22,8858775,Europe,9618,108
2020-04-01,Austria,AT,564,20,8858775,Europe,10182,128
2020-04-02,Austria,AT,529,18,8858775,Europe,10711,146
2020-04-03,Austria,AT,418,12,8858775,Europe,11129,158
2020-04-04,Austria,AT,396,10,8858775,Europe,11525,168
2020-04-05,Austria,AT,241,18,8858775,Europe,11766,186
2020-04-06,Austria,AT,217,18,8858775,Europe,11983,204
2020-04-07,Austria,AT,314,16,8858775,Europe,12297,220
2020-04-08,Austria,AT,343,23,8858775,Europe,12640,243
2020-04-09,Austria,AT,329,30,8858775,Europe,12969,273
2020-04-10,Austria,AT,279,22,8858775,Europe,13248,295
2020-04-11,Austria,AT,312,24,8858775,Europe,13560,319
2020-04-12,Austria,AT,247,18,8858775,Europe,13807,337
2020-04-13,Austria,AT,130,13,8858775,Europe,13937,350
2020-04-14,Austria,AT,106,18,8858775,Europe,14043,368
2020-04-15,Austria,AT,191,16,8858775,Europe,14234,384
2020-04-16,Austria,AT,136,9,8858775,Europe,14370,393
2020-04-17,Austria,AT,78,17,8858775,Europe,14448,410
2020-04-18,Austria,AT,155,21,8858775,Europe,14603,431
2020-04-19,Austria,AT,59,12,8858775,Europe,14662,443
2020-04-20,Austria,AT,48,9,8858775,Europe,14710,452
2020-04-21,Austria,AT,73,10,8858775,Europe,14783,462
2020-04-22,Austria,AT,50,1,8858775,Europe,14833,463
2020-04-23,Austria,AT,91,31,8858775,Europe,14924,494
2020-04-24,Austria,AT,61,14,8858775,Europe,14985,508
2020-04-25,Austria,AT,83,5,8858775,Europe,15068,513
2020-04-26,Austria,AT,66,23,8858775,Europe,15134,536
2020-04-27,Austria,AT,55,6,8858775,Europe,15189,542
2020-04-28,Austria,AT,67,7,8858775,Europe,15256,549
2020-04-29,Austria,AT,58,20,8858775,Europe,15314,569
2020-04-30,Austria,AT,50,11,8858775,Europe,15364,580
2020-05-01,Austria,AT,60,4,8858775,Europe,15424,584
2020-05-02,Austria,AT,34,5,8858775,Europe,15458,589
2020-05-03,Austria,AT,12,7,8858775,Europe,15470,596
2020-05-04,Austria,AT,68,2,8858775,Europe,15538,598
2020-05-05,Austria,AT,31,2,8858775,Europe,15569,600
2020-05-06,Austria,AT,17,6,8858775,Europe,15586,606
2020-05-07,Austria,AT,65,2,8858775,Europe,15651,608
2020-05-08,Austria,AT,22,1,8858775,Europe,15673,609
2020-05-09,Austria,AT,62,5,8858775,Europe,15735,614
2020-05-10,Austria,AT,42,1,8858775,Europe,15777,615
2020-05-11,Austria,AT,10,3,8858775,Europe,15787,618
2020-05-12,Austria,AT,87,2,8858775,Europe,15874,620
2020-05-13,Austria,AT,36,3,8858775,Europe,15910,623
2020-05-14,Austria,AT,54,1,8858775,Europe,15964,624
2020-05-15,Austria,AT,41,2,8858775,Europe,16005,626
2020-05-16,Austria,AT,63,2,8858775,Europe,16068,628
2020-05-17,Austria,AT,72,0,8858775,Europe,16140,628
2020-05-18,Austria,AT,14,1,8858775,Europe,16154,629
2020-05-19,Austria,AT,25,0,8858775,Europe,16179,629
2020-05-20,Austria,AT,78,3,8858775,Europe,16257,632
2020-05-21,Austria,AT,18,1,8858775,Europe,16275,633
2020-05-22,Austria,AT,57,0,8858775,Europe,16332,633
2020-05-23,Austria,AT,29,2,8858775,Europe,16361,635
2020-05-24,Austria,AT,46,4,8858775,Europe,16407,639
2020-05-25,Austria,AT,32,1,8858775,Europe,16439,640
2020-05-26,Austria,AT,20,1,8858775,Europe,16459,641
2020-05-27,Austria,AT,38,2,8858775,Europe,16497,643
2020-05-28,Austria,AT,18,2,8858775,Europe,16515,645
2020-05-29,Austria,AT,28,23,8858775,Europe,16543,668
2020-05-30,Austria,AT,51,0,8858775,Europe,16594,668
2020-05-31,Austria,AT,44,0,8858775,Europe,16638,668
2020-06-01,Austria,AT,4,0,8858775,Europe,16642,668
2020-06-02,Austria,AT,21,0,8858775,Europe,16663,668
2020-06-03,Austria,AT,11,1,8858775,Europe,16674,669
2020-06-04,Austria,AT,31,1,8858775,Europe,16705,670
2020-06-05,Austria,AT,36,0,8858775,Europe,16741,670
2020-06-06,Austria,AT,62,2,8858775,Europe,16803,672
2020-06-07,Austria,AT,19,0,8858775,Europe,16822,672
2020-06-08,Austria,AT,46,0,8858775,Europe,16868,672
2020-06-09,Austria,AT,21,0,8858775,Europe,16889,672
2020-06-10,Austria,AT,13,0,8858775,Europe,16902,672
2020-06-11,Austria,AT,34,1,8858775,Europe,16936,673
2020-06-12,Austria,AT,28,1,8858775,Europe,16964,674
2020-06-13,Austria,AT,30,1,8858775,Europe,16994,675
2020-06-14,Austria,AT,20,2,8858775,Europe,17014,677
2020-06-15,Austria,AT,24,0,8858775,Europe,17038,677
2020-06-16,Austria,AT,27,1,8858775,Europe,17065,678
2020-06-17,Austria,AT,33,3,8858775,Europe,17098,681
2020-06-18,Austria,AT,17,6,8858775,Europe,17115,687
2020-06-19,Austria,AT,40,1,8858775,Europe,17155,688
2020-06-20,Austria,AT,30,0,8858775,Europe,17185,688
2020-06-21,Austria,AT,62,0,8858775,Europe,17247,688
2020-06-22,Austria,AT,38,2,8858775,Europe,17285,690
2020-06-23,Austria,AT,35,0,8858775,Europe,17320,690
2020-06-24,Austria,AT,31,3,8858775,Europe,17351,693
2020-06-25,Austria,AT,33,0,8858775,Europe,17384,693
2020-06-26,Austria,AT,47,5,8858775,Europe,17431,698
2020-06-27,Austria,AT,67,0,8858775,Europe,17498,698
2020-06-28,Austria,AT,64,2,8858775,Europe,17562,700
2020-06-29,Austria,AT,63,2,8858775,Europe,17625,702
2020-06-30,Austria,AT,41,1,8858775,Europe,17666,703
2020-07-01,Austria,AT,111,2,8858775,Europe,17777,705
2020-07-02,Austria,AT,37,0,8858775,Europe,17814,705
2020-07-03,Austria,AT,138,0,8858775,Europe,17952,705
2020-07-04,Austria,AT,121,0,8858775,Europe,18073,705
2020-07-05,Austria,AT,123,0,8858775,Europe,18196,705
2020-07-06,Austria,AT,73,1,8858775,Europe,18269,706
2020-07-07,Austria,AT,57,0,8858775,Europe,18326,706
2020-07-08,Austria,AT,89,0,8858775,Europe,18415,706
2020-07-09,Austria,AT,101,0,8858775,Europe,18516,706
2020-07-10,Austria,AT,97,0,8858775,Europe,18613,706
2020-07-11,Austria,AT,74,0,8858775,Europe,18687,706
2020-07-12,Austria,AT,108,0,8858775,Europe,18795,706
2020-07-13,Austria,AT,52,2,8858775,Europe,18847,708
2020-07-14,Austria,AT,12,0,8858775,Europe,18859,708
2020-07-15,Austria,AT,201,1,8858775,Europe,19060,709
2020-07-16,Austria,AT,55,1,8858775,Europe,19115,710
2020-07-17,Austria,AT,153,0,8858775,Europe,19268,710
2020-07-18,Austria,AT,138,0,8858775,Europe,19406,710
2020-07-19,Austria,AT,102,0,8858775,Europe,19508,710
2020-07-20,Austria,AT,63,0,8858775,Europe,19571,710
2020-07-21,Austria,AT,108,0,8858775,Europe,19679,710
2020-07-22,Austria,AT,139,0,8858775,Europe,19818,710
2020-07-23,Austria,AT,140,1,8858775,Europe,19958,711
2020-07-24,Austria,AT,164,0,8858775,Europe,20122,711
2020-07-25,Austria,AT,107,0,8858775,Europe,20229,711
2020-07-26,Austria,AT,120,1,8858775,Europe,20349,712
2020-07-27,Austria,AT,137,0,8858775,Europe,20486,712
2020-07-28,Austria,AT,64,1,8858775,Europe,20550,713
2020-07-29,Austria,AT,132,0,8858775,Europe,20682,713
2020-07-30,Austria,AT,164,3,8858775,Europe,20846,716
2020-07-31,Austria,AT,163,2,8858775,Europe,21009,718
2020-08-01,Austria,AT,89,0,8858775,Europe,21098,718
2020-08-02,Austria,AT,126,0,8858775,Europe,21224,718
2020-08-03,Austria,AT,85,0,8858775,Europe,21309,718
2020-08-04,Austria,AT,32,0,8858775,Europe,21341,718
2020-08-05,Austria,AT,131,1,8858775,Europe,21472,719
2020-08-06,Austria,AT,103,0,8858775,Europe,21575,719
2020-08-07,Austria,AT,114,0,8858775,Europe,21689,719
2020-08-08,Austria,AT,130,1,8858775,Europe,21819,720
2020-08-09,Austria,AT,116,1,8858775,Europe,21935,721
2020-08-10,Austria,AT,76,0,8858775,Europe,22011,721
2020-08-11,Austria,AT,111,2,8858775,Europe,22122,723
2020-08-12,Austria,AT,138,0,8858775,Europe,22260,723
2020-08-13,Austria,AT,241,1,8858775,Europe,22501,724
2020-08-14,Austria,AT,229,1,8858775,Europe,22730,725
2020-08-15,Austria,AT,221,0,8858775,Europe,22951,725
2020-08-16,Austria,AT,260,3,8858775,Europe,23211,728
2020-08-17,Austria,AT,162,0,8858775,Europe,23373,728
2020-08-18,Austria,AT,344,1,8858775,Europe,23717,729
2020-08-19,Austria,AT,158,0,8858775,Europe,23875,729
2020-08-20,Austria,AT,425,0,8858775,Europe,24300,729
2020-08-21,Austria,AT,308,0,8858775,Europe,24608,729
2020-08-22,Austria,AT,275,1,8858775,Europe,24883,730
2020-08-23,Austria,AT,216,2,8858775,Europe,25099,732
2020-08-24,Austria,AT,140,0,8858775,Europe,25239,732
2020-08-25,Austria,AT,308,1,8858775,Europe,25547,733
2020-08-26,Austria,AT,291,0,8858775,Europe,25838,733
2020-08-27,Austria,AT,316,0,8858775,Europe,26154,733
2020-08-28,Austria,AT,227,0,8858775,Europe,26381,733
2020-08-29,Austria,AT,382,0,8858775,Europe,26763,733
2020-08-30,Austria,AT,174,0,8858775,Europe,26937,733
2020-08-31,Austria,AT,281,0,8858775,Europe,27218,733
2020-09-01,Austria,AT,186,0,8858775,Europe,27404,733
2020-09-02,Austria,AT,337,1,8858775,Europe,27741,734
2020-09-03,Austria,AT,442,0,8858775,Europe,28183,734
2020-09-04,Austria,AT,312,1,8858775,Europe,28495,735
2020-09-05,Austria,AT,271,0,8858775,Europe,28766,735
2020-09-06,Austria,AT,208,0,8858775,Europe,28974,735
2020-09-07,Austria,AT,220,1,8858775,Europe,29194,736
2020-09-08,Austria,AT,511,10,8858775,Europe,29705,746
2020-09-09,Austria,AT,495,1,8858775,Europe,30200,747
2020-09-10,Austria,AT,754,0,8858775,Europe,30954,747
2020-09-11,Austria,AT,497,1,8858775,Europe,31451,748
2020-09-12,Austria,AT,1005,2,8858775,Europe,32456,750
2020-09-13,Austria,AT,495,4,8858775,Europe,32951,754
2020-09-14,Austria,AT,384,2,8858775,Europe,33335,756
2020-09-15,Austria,AT,549,1,8858775,Europe,33884,757
2020-09-16,Austria,AT,860,0,8858775,Europe,34744,757
2020-09-17,Austria,AT,704,1,8858775,Europe,35448,758
2020-09-18,Austria,AT,922,0,8858775,Europe,36370,758
2020-09-19,Austria,AT,821,5,8858775,Europe,37191,763
2020-09-20,Austria,AT,757,2,8858775,Europe,37948,765
2020-09-21,Austria,AT,609,1,8858775,Europe,38557,766
2020-09-22,Austria,AT,593,1,8858775,Europe,39150,767
2020-09-23,Austria,AT,747,4,8858775,Europe,39897,771
2020-09-24,Austria,AT,661,6,8858775,Europe,40558,777
2020-09-25,Austria,AT,688,6,8858775,Europe,41246,783
2020-09-26,Austria,AT,1071,3,8858775,Europe,42317,786
2020-09-27,Austria,AT,623,1,8858775,Europe,42940,787
2020-09-28,Austria,AT,526,0,8858775,Europe,43466,787
2020-09-29,Austria,AT,419,3,8858775,Europe,43885,790
2020-09-30,Austria,AT,722,6,8858775,Europe,44607,796
2020-10-01,Austria,AT,1146,3,8858775,Europe,45753,799
2020-10-02,Austria,AT,564,3,8858775,Europe,46317,802
2020-10-03,Austria,AT,872,1,8858775,Europe,47189,803
2020-10-04,Austria,AT,830,6,8858775,Europe,48019,809
2020-10-05,Austria,AT,599,4,8858775,Europe,48618,813
2020-10-06,Austria,AT,1268,5,8858775,Europe,49886,818
2020-10-07,Austria,AT,549,22,8858775,Europe,50435,840
2020-10-08,Austria,AT,947,4,8858775,Europe,51382,844
2020-10-09,Austria,AT,1221,9,8858775,Europe,52603,853
2020-10-10,Austria,AT,1181,4,8858775,Europe,53784,857
2020-10-11,Austria,AT,901,1,8858775,Europe,54685,858
2020-10-12,Austria,AT,1298,6,8858775,Europe,55983,864
2020-10-13,Austria,AT,608,5,8858775,Europe,56591,869
2020-10-14,Austria,AT,1171,10,8858775,Europe,57762,879
2020-10-15,Austria,AT,1606,9,8858775,Europe,59368,888
2020-10-16,Austria,AT,1396,6,8858775,Europe,60764,894
2020-10-17,Austria,AT,1691,7,8858775,Europe,62455,901
2020-10-18,Austria,AT,2040,6,8858775,Europe,64495,907
2020-10-19,Austria,AT,1062,3,8858775,Europe,65557,910
2020-10-20,Austria,AT,1054,9,8858775,Europe,66611,919
2020-10-21,Austria,AT,1803,8,8858775,Europe,68414,927
2020-10-22,Austria,AT,2355,13,8858775,Europe,70769,940
2020-10-23,Austria,AT,2570,17,8858775,Europe,73339,957
2020-10-24,Austria,AT,3442,15,8858775,Europe,76781,972
2020-10-25,Austria,AT,2989,6,8858775,Europe,79770,978
2020-10-26,Austria,AT,2766,6,8858775,Europe,82536,984
2020-10-27,Austria,AT,2512,4,8858775,Europe,85048,988
2020-10-28,Austria,AT,2698,18,8858775,Europe,87746,1006
2020-10-29,Austria,AT,4149,34,8858775,Europe,91895,1040
2020-10-30,Austria,AT,4305,24,8858775,Europe,96200,1064
2020-10-31,Austria,AT,5243,15,8858775,Europe,101443,1079
2020-11-01,Austria,AT,5141,18,8858775,Europe,106584,1097
2020-11-02,Austria,AT,4526,17,8858775,Europe,111110,1114
2020-11-03,Austria,AT,3160,21,8858775,Europe,114270,1135
2020-11-04,Austria,AT,4445,34,8858775,Europe,118715,1169
2020-11-05,Austria,AT,6514,35,8858775,Europe,125229,1204
2020-11-06,Austria,AT,7051,47,8858775,Europe,132280,1251
2020-11-07,Austria,AT,6324,44,8858775,Europe,138604,1295
2020-11-08,Austria,AT,7898,23,8858775,Europe,146502,1318
2020-11-09,Austria,AT,6006,17,8858775,Europe,152508,1335
2020-11-10,Austria,AT,5704,48,8858775,Europe,158212,1383
2020-11-11,Austria,AT,3839,35,8858775,Europe,162051,1418
2020-11-12,Austria,AT,9643,55,8858775,Europe,171694,1473
2020-11-13,Austria,AT,10368,37,8858775,Europe,182062,1510
2020-11-14,Austria,AT,8962,64,8858775,Europe,191024,1574
2020-11-15,Austria,AT,7192,55,8858775,Europe,198216,1629
2020-11-16,Austria,AT,5278,50,8858775,Europe,203494,1679
2020-11-17,Austria,AT,4304,62,8858775,Europe,207798,1741
2020-11-18,Austria,AT,5664,74,8858775,Europe,213462,1815
2020-11-19,Austria,AT,7766,113,8858775,Europe,221228,1928
2020-11-20,Austria,AT,6830,90,8858775,Europe,228058,2018
2020-11-21,Austria,AT,6612,79,8858775,Europe,234670,2097
2020-11-22,Austria,AT,6239,58,8858775,Europe,240909,2155
2020-11-23,Austria,AT,5215,44,8858775,Europe,246124,2199
2020-11-24,Austria,AT,3090,94,8858775,Europe,249214,2293
2020-11-25,Austria,AT,4135,115,8858775,Europe,253349,2408
2020-11-26,Austria,AT,5896,94,8858775,Europe,259245,2502
2020-11-27,Austria,AT,5447,114,8858775,Europe,264692,2616
2020-11-28,Austria,AT,4818,148,8858775,Europe,269510,2764
2020-11-29,Austria,AT,4765,58,8858775,Europe,274275,2822
2020-11-30,Austria,AT,3907,82,8858775,Europe,278182,2904
2020-12-01,Austria,AT,2348,79,8858775,Europe,280530,2983
2020-12-02,Austria,AT,3464,213,8858775,Europe,283994,3196
2020-12-03,Austria,AT,3660,133,8858775,Europe,287654,3329
2020-12-04,Austria,AT,3783,118,8858775,Europe,291437,3447
2020-12-05,Austria,AT,3634,140,8858775,Europe,295071,3587
2020-12-06,Austria,AT,3160,87,8858775,Europe,298231,3674
2020-12-07,Austria,AT,2745,58,8858775,Europe,300976,3732
2020-12-08,Austria,AT,2181,95,8858775,Europe,303157,3827
2020-12-09,Austria,AT,2531,80,8858775,Europe,305688,3907
2020-12-10,Austria,AT,2913,126,8858775,Europe,308601,4033
2020-12-11,Austria,AT,2466,125,8858775,Europe,311067,4158
2020-12-12,Austria,AT,3026,101,8858775,Europe,314093,4259
2020-12-13,Austria,AT,2938,96,8858775,Europe,317031,4355
2020-12-14,Austria,AT,3005,45,8858775,Europe,320036,4400
2019-12-31,Australia,AU,0,0,25203200,Oceania,0,0
2020-01-01,Australia,AU,0,0,25203200,Oceania,0,0
2020-01-02,Australia,AU,0,0,25203200,Oceania,0,0
2020-01-03,Australia,AU,0,0,25203200,Oceania,0,0
2020-01-04,Australia,AU,0,0,25203200,Oceania,0,0
2020-01-05,Australia,AU,0,0,25203200,Oceania,0,0
2020-01-06,Australia,AU,0,0,25203200,Oceania,0,0
2020-01-07,Australia,AU,0,0,25203200,Oceania,0,0
2020-01-08,Australia,AU,0,0,25203200,Oceania,0,0
2020-01-09,Australia,AU,0,0,25203200,Oceania,0,0
2020-01-10,Australia,AU,0,0,25203200,Oceania,0,0
2020-01-11,Australia,AU,0,0,25203200,Oceania,0,0
2020-01-12,Australia,AU,0,0,25203200,Oceania,0,0
2020-01-13,Australia,AU,0,0,25203200,Oceania,0,0
2020-01-14,Australia,AU,0,0,25203200,Oceania,0,0
2020-01-15,Australia,AU,0,0,25203200,Oceania,0,0
2020-01-16,Australia,AU,0,0,25203200,Oceania,0,0
2020-01-17,Australia,AU,0,0,25203200,Oceania,0,0
2020-01-18,Australia,AU,0,0,25203200,Oceania,0,0
2020-01-19,Australia,AU,0,0,25203200,Oceania,0,0
2020-01-20,Australia,AU,0,0,25203200,Oceania,0,0
2020-01-21,Australia,AU,0,0,25203200,Oceania,0,0
2020-01-22,Australia,AU,0,0,25203200,Oceania,0,0
2020-01-23,Australia,AU,0,0,25203200,Oceania,0,0
2020-01-24,Australia,AU,0,0,25203200,Oceania,0,0
2020-01-25,Australia,AU,1,0,25203200,Oceania,1,0
2020-01-26,Australia,AU,3,0,25203200,Oceania,4,0
2020-01-27,Australia,AU,0,0,25203200,Oceania,4,0
2020-01-28,Australia,AU,0,0,25203200,Oceania,4,0
2020-01-29,Australia,AU,0,0,25203200,Oceania,4,0
2020-01-30,Australia,AU,2,0,25203200,Oceania,6,0
2020-01-31,Australia,AU,1,0,25203200,Oceania,7,0
2020-02-01,Australia,AU,2,0,25203200,Oceania,9,0
2020-02-02,Australia,AU,2,0,25203200,Oceania,11,0
2020-02-03,Australia,AU,0,0,25203200,Oceania,11,0
2020-02-04,Australia,AU,0,0,25203200,Oceania,11,0
2020-02-05,Australia,AU,1,0,25203200,Oceania,12,0
2020-02-06,Australia,AU,1,0,25203200,Oceania,13,0
2020-02-07,Australia,AU,1,0,25203200,Oceania,14,0
2020-02-08,Australia,AU,0,0,25203200,Oceania,14,0
2020-02-09,Australia,AU,0,0,25203200,Oceania,14,0
2020-02-10,Australia,AU,0,0,25203200,Oceania,14,0
2020-02-11,Australia,AU,0,0,25203200,Oceania,14,0
2020-02-12,Australia,AU,0,0,25203200,Oceania,14,0
2020-02-13,Australia,AU,0,0,25203200,Oceania,14,0
2020-02-14,Australia,AU,1,0,25203200,Oceania,15,0
2020-02-15,Australia,AU,0,0,25203200,Oceania,15,0
2020-02-16,Australia,AU,0,0,25203200,Oceania,15,0
2020-02-17,Australia,AU,0,0,25203200,Oceania,15,0
2020-02-18,Australia,AU,0,0,25203200,Oceania,15,0
2020-02-19,Australia,AU,0,0,25203200,Oceania,15,0
2020-02-20,Australia,AU,0,0,25203200,Oceania,15,0
2020-02-21,Australia,AU,2,0,25203200,Oceania,17,0
2020-02-22,Australia,AU,4,0,25203200,Oceania,21,0
2020-02-23,Australia,AU,1,0,25203200,Oceania,22,0
2020-02-24,Australia,AU,0,0,25203200,Oceania,22,0
2020-02-25,Australia,AU,0,0,25203200,Oceania,22,0
2020-02-26,Australia,AU,0,0,25203200,Oceania,22,0
2020-02-27,Australia,AU,1,0,25203200,Oceania,23,0
2020-02-28,Australia,AU,0,0,25203200,Oceania,23,0
2020-02-29,Australia,AU,2,0,25203200,Oceania,25,0
2020-03-01,Australia,AU,1,1,25203200,Oceania,26,1
2020-03-02,Australia,AU,3,0,25203200,Oceania,29,1
2020-03-03,Australia,AU,4,0,25203200,Oceania,33,1
2020-03-04,Australia,AU,8,0,25203200,Oceania,41,1
2020-03-05,Australia,AU,11,1,25203200,Oceania,52,2
2020-03-06,Australia,AU,7,0,25203200,Oceania,59,2
2020-03-07,Australia,AU,4,0,25203200,Oceania,63,2
2020-03-08,Australia,AU,11,1,25203200,Oceania,74,3
2020-03-09,Australia,AU,6,0,25203200,Oceania,80,3
2020-03-10,Australia,AU,20,0,25203200,Oceania,100,3
2020-03-11,Australia,AU,12,0,25203200,Oceania,112,3
2020-03-12,Australia,AU,14,0,25203200,Oceania,126,3
2020-03-13,Australia,AU,30,0,25203200,Oceania,156,3
2020-03-14,Australia,AU,41,0,25203200,Oceania,197,3
2020-03-15,Australia,AU,52,0,25203200,Oceania,249,3
2020-03-16,Australia,AU,49,2,25203200,Oceania,298,5
2020-03-17,Australia,AU,77,0,25203200,Oceania,375,5
2020-03-18,Australia,AU,79,0,25203200,Oceania,454,5
2020-03-19,Australia,AU,111,1,25203200,Oceania,565,6
2020-03-20,Australia,AU,144,0,25203200,Oceania,709,6
2020-03-21,Australia,AU,165,1,25203200,Oceania,874,7
2020-03-22,Australia,AU,224,0,25203200,Oceania,1098,7
2020-03-23,Australia,AU,611,0,25203200,Oceania,1709,7
2020-03-24,Australia,AU,114,0,25203200,Oceania,1823,7
2020-03-25,Australia,AU,600,1,25203200,Oceania,2423,8
2020-03-26,Australia,AU,376,3,25203200,Oceania,2799,11
2020-03-27,Australia,AU,367,2,25203200,Oceania,3166,13
2020-03-28,Australia,AU,212,0,25203200,Oceania,3378,13
2020-03-29,Australia,AU,431,1,25203200,Oceania,3809,14
2020-03-30,Australia,AU,284,2,25203200,Oceania,4093,16
2020-03-31,Australia,AU,464,3,25203200,Oceania,4557,19
2020-04-01,Australia,AU,150,1,25203200,Oceania,4707,20
2020-04-02,Australia,AU,269,1,25203200,Oceania,4976,21
2020-04-03,Australia,AU,248,2,25203200,Oceania,5224,23
2020-04-04,Australia,AU,324,7,25203200,Oceania,5548,30
2020-04-05,Australia,AU,139,4,25203200,Oceania,5687,34
2020-04-06,Australia,AU,57,2,25203200,Oceania,5744,36
2020-04-07,Australia,AU,100,6,25203200,Oceania,5844,42
2020-04-08,Australia,AU,112,3,25203200,Oceania,5956,45
2020-04-09,Australia,AU,96,5,25203200,Oceania,6052,50
2020-04-10,Australia,AU,100,2,25203200,Oceania,6152,52
2020-04-11,Australia,AU,86,2,25203200,Oceania,6238,54
2020-04-12,Australia,AU,51,3,25203200,Oceania,6289,57
2020-04-13,Australia,AU,33,4,25203200,Oceania,6322,61
2020-04-14,Australia,AU,44,0,25203200,Oceania,6366,61
2020-04-15,Australia,AU,50,0,25203200,Oceania,6416,61
2020-04-16,Australia,AU,42,2,25203200,Oceania,6458,63
2020-04-17,Australia,AU,39,0,25203200,Oceania,6497,63
2020-04-18,Australia,AU,36,4,25203200,Oceania,6533,67
2020-04-19,Australia,AU,53,2,25203200,Oceania,6586,69
2020-04-20,Australia,AU,26,1,25203200,Oceania,6612,70
2020-04-21,Australia,AU,13,1,25203200,Oceania,6625,71
2020-04-22,Australia,AU,22,3,25203200,Oceania,6647,74
2020-04-23,Australia,AU,7,0,25203200,Oceania,6654,74
2020-04-24,Australia,AU,13,1,25203200,Oceania,6667,75
2020-04-25,Australia,AU,20,4,25203200,Oceania,6687,79
2020-04-26,Australia,AU,16,2,25203200,Oceania,6703,81
2020-04-27,Australia,AU,10,2,25203200,Oceania,6713,83
2020-04-28,Australia,AU,12,1,25203200,Oceania,6725,84
2020-04-29,Australia,AU,13,4,25203200,Oceania,6738,88
2020-04-30,Australia,AU,8,2,25203200,Oceania,6746,90
2020-05-01,Australia,AU,16,2,25203200,Oceania,6762,92
2020-05-02,Australia,AU,5,1,25203200,Oceania,6767,93
2020-05-03,Australia,AU,16,0,25203200,Oceania,6783,93
2020-05-04,Australia,AU,18,2,25203200,Oceania,6801,95
2020-05-05,Australia,AU,24,0,25203200,Oceania,6825,95
2020-05-06,Australia,AU,24,1,25203200,Oceania,6849,96
2020-05-07,Australia,AU,26,1,25203200,Oceania,6875,97
2020-05-08,Australia,AU,21,0,25203200,Oceania,6896,97
2020-05-09,Australia,AU,18,0,25203200,Oceania,6914,97
2020-05-10,Australia,AU,15,0,25203200,Oceania,6929,97
2020-05-11,Australia,AU,12,0,25203200,Oceania,6941,97
2020-05-12,Australia,AU,7,0,25203200,Oceania,6948,97
2020-05-13,Australia,AU,16,0,25203200,Oceania,6964,97
2020-05-14,Australia,AU,11,1,25203200,Oceania,6975,98
2020-05-15,Australia,AU,14,0,25203200,Oceania,6989,98
2020-05-16,Australia,AU,30,0,25203200,Oceania,7019,98
2020-05-17,Australia,AU,17,0,25203200,Oceania,7036,98
2020-05-18,Australia,AU,9,0,25203200,Oceania,7045,98
2020-05-19,Australia,AU,15,1,25203200,Oceania,7060,99
2020-05-20,Australia,AU,8,0,25203200,Oceania,7068,99
2020-05-21,Australia,AU,11,1,25203200,Oceania,7079,100
2020-05-22,Australia,AU,2,0,25203200,Oceania,7081,100
2020-05-23,Australia,AU,14,1,25203200,Oceania,7095,101
2020-05-24,Australia,AU,11,1,25203200,Oceania,7106,102
2020-05-25,Australia,AU,3,0,25203200,Oceania,7109,102
2020-05-26,Australia,AU,9,0,25203200,Oceania,7118,102
2020-05-27,Australia,AU,15,0,25203200,Oceania,7133,102
2020-05-28,Australia,AU,6,0,25203200,Oceania,7139,102
2020-05-29,Australia,AU,11,0,25203200,Oceania,7150,102
2020-05-30,Australia,AU,23,0,25203200,Oceania,7173,102
2020-05-31,Australia,AU,12,0,25203200,Oceania,7185,102
2020-06-01,Australia,AU,10,0,25203200,Oceania,7195,102
2020-06-02,Australia,AU,9,0,25203200,Oceania,7204,102
2020-06-03,Australia,AU,17,0,25203200,Oceania,7221,102
2020-06-04,Australia,AU,8,0,25203200,Oceania,7229,102
2020-06-05,Australia,AU,11,0,25203200,Oceania,7240,102
2020-06-06,Australia,AU,11,0,25203200,Oceania,7251,102
2020-06-07,Australia,AU,4,0,25203200,Oceania,7255,102
2020-06-08,Australia,AU,5,0,25203200,Oceania,7260,102
2020-06-09,Australia,AU,5,0,25203200,Oceania,7265,102
2020-06-10,Australia,AU,2,0,25203200,Oceania,7267,102
2020-06-11,Australia,AU,9,0,25203200,Oceania,7276,102
2020-06-12,Australia,AU,9,0,25203200,Oceania,7285,102
2020-06-13,Australia,AU,5,0,25203200,Oceania,7290,102
2020-06-14,Australia,AU,12,0,25203200,Oceania,7302,102
2020-06-15,Australia,AU,18,0,25203200,Oceania,7320,102
2020-06-16,Australia,AU,15,0,25203200,Oceania,7335,102
2020-06-17,Australia,AU,12,0,25203200,Oceania,7347,102
2020-06-18,Australia,AU,23,0,25203200,Oceania,7370,102
2020-06-19,Australia,AU,21,0,25203200,Oceania,7391,102
2020-06-20,Australia,AU,18,0,25203200,Oceania,7409,102
2020-06-21,Australia,AU,27,0,25203200,Oceania,7436,102
2020-06-22,Australia,AU,25,0,25203200,Oceania,7461,102
2020-06-23,Australia,AU,13,0,25203200,Oceania,7474,102
2020-06-24,Australia,AU,18,0,25203200,Oceania,7492,102
2020-06-25,Australia,AU,29,1,25203200,Oceania,7521,103
2020-06-26,Australia,AU,37,1,25203200,Oceania,7558,104
2020-06-27,Australia,AU,37,0,25203200,Oceania,7595,104
2020-06-28,Australia,AU,46,0,25203200,Oceania,7641,104
2020-06-29,Australia,AU,45,0,25203200,Oceania,7686,104
2020-06-30,Australia,AU,81,0,25203200,Oceania,7767,104
2020-07-01,Australia,AU,67,0,25203200,Oceania,7834,104
2020-07-02,Australia,AU,86,0,25203200,Oceania,7920,104
2020-07-03,Australia,AU,81,0,25203200,Oceania,8001,104
2020-07-04,Australia,AU,254,0,25203200,Oceania,8255,104
2020-07-05,Australia,AU,107,0,25203200,Oceania,8362,104
2020-07-06,Australia,AU,87,0,25203200,Oceania,8449,104
2020-07-07,Australia,AU,137,2,25203200,Oceania,8586,106
2020-07-08,Australia,AU,169,0,25203200,Oceania,8755,106
2020-07-09,Australia,AU,131,0,25203200,Oceania,8886,106
2020-07-10,Australia,AU,173,0,25203200,Oceania,9059,106
2020-07-11,Australia,AU,300,0,25203200,Oceania,9359,106
2020-07-12,Australia,AU,194,1,25203200,Oceania,9553,107
2020-07-13,Australia,AU,244,1,25203200,Oceania,9797,108
2020-07-14,Australia,AU,183,0,25203200,Oceania,9980,108
2020-07-15,Australia,AU,271,0,25203200,Oceania,10251,108
2020-07-16,Australia,AU,244,3,25203200,Oceania,10495,111
2020-07-17,Australia,AU,315,2,25203200,Oceania,10810,113
2020-07-18,Australia,AU,425,3,25203200,Oceania,11235,116
2020-07-19,Australia,AU,206,2,25203200,Oceania,11441,118
2020-07-20,Australia,AU,361,4,25203200,Oceania,11802,122
2020-07-21,Australia,AU,267,1,25203200,Oceania,12069,123
2020-07-22,Australia,AU,359,3,25203200,Oceania,12428,126
2020-07-23,Australia,AU,468,2,25203200,Oceania,12896,128
2020-07-24,Australia,AU,410,5,25203200,Oceania,13306,133
2020-07-25,Australia,AU,289,6,25203200,Oceania,13595,139
2020-07-26,Australia,AU,355,6,25203200,Oceania,13950,145
2020-07-27,Australia,AU,453,10,25203200,Oceania,14403,155
2020-07-28,Australia,AU,532,6,25203200,Oceania,14935,161
2020-07-29,Australia,AU,369,6,25203200,Oceania,15304,167
2020-07-30,Australia,AU,278,9,25203200,Oceania,15582,176
2020-07-31,Australia,AU,721,13,25203200,Oceania,16303,189
2020-08-01,Australia,AU,602,7,25203200,Oceania,16905,196
2020-08-02,Australia,AU,377,4,25203200,Oceania,17282,200
2020-08-03,Australia,AU,641,8,25203200,Oceania,17923,208
2020-08-04,Australia,AU,395,13,25203200,Oceania,18318,221
2020-08-05,Australia,AU,411,11,25203200,Oceania,18729,232
2020-08-06,Australia,AU,715,15,25203200,Oceania,19444,247
2020-08-07,Australia,AU,418,8,25203200,Oceania,19862,255
2020-08-08,Australia,AU,410,11,25203200,Oceania,20272,266
2020-08-09,Australia,AU,426,12,25203200,Oceania,20698,278
2020-08-10,Australia,AU,386,17,25203200,Oceania,21084,295
2020-08-11,Australia,AU,313,18,25203200,Oceania,21397,313
2020-08-12,Australia,AU,316,18,25203200,Oceania,21713,331
2020-08-13,Australia,AU,414,21,25203200,Oceania,22127,352
2020-08-14,Australia,AU,231,9,25203200,Oceania,22358,361
2020-08-15,Australia,AU,385,14,25203200,Oceania,22743,375
2020-08-16,Australia,AU,292,4,25203200,Oceania,23035,379
2020-08-17,Australia,AU,253,17,25203200,Oceania,23288,396
2020-08-18,Australia,AU,311,25,25203200,Oceania,23599,421
2020-08-19,Australia,AU,174,17,25203200,Oceania,23773,438
2020-08-20,Australia,AU,220,12,25203200,Oceania,23993,450
2020-08-21,Australia,AU,243,13,25203200,Oceania,24236,463
2020-08-22,Australia,AU,171,9,25203200,Oceania,24407,472
2020-08-23,Australia,AU,195,13,25203200,Oceania,24602,485
2020-08-24,Australia,AU,210,17,25203200,Oceania,24812,502
2020-08-25,Australia,AU,104,15,25203200,Oceania,24916,517
2020-08-26,Australia,AU,137,8,25203200,Oceania,25053,525
2020-08-27,Australia,AU,152,24,25203200,Oceania,25205,549
2020-08-28,Australia,AU,117,23,25203200,Oceania,25322,572
2020-08-29,Australia,AU,126,11,25203200,Oceania,25448,583
2020-08-30,Australia,AU,99,17,25203200,Oceania,25547,600
2020-08-31,Australia,AU,123,11,25203200,Oceania,25670,611
2020-09-01,Australia,AU,76,41,25203200,Oceania,25746,652
2020-09-02,Australia,AU,73,5,25203200,Oceania,25819,657
2020-09-03,Australia,AU,104,6,25203200,Oceania,25923,663
2020-09-04,Australia,AU,126,15,25203200,Oceania,26049,678
2020-09-05,Australia,AU,87,59,25203200,Oceania,26136,737
2020-09-06,Australia,AU,71,11,25203200,Oceania,26207,748
2020-09-07,Australia,AU,72,5,25203200,Oceania,26279,753
2020-09-08,Australia,AU,43,9,25203200,Oceania,26322,762
2020-09-09,Australia,AU,52,8,25203200,Oceania,26374,770
2020-09-10,Australia,AU,91,11,25203200,Oceania,26465,781
2020-09-11,Australia,AU,48,7,25203200,Oceania,26513,788
2020-09-12,Australia,AU,52,9,25203200,Oceania,26565,797
2020-09-13,Australia,AU,42,6,25203200,Oceania,26607,803
2020-09-14,Australia,AU,44,7,25203200,Oceania,26651,810
2020-09-15,Australia,AU,41,6,25203200,Oceania,26692,816
2020-09-16,Australia,AU,46,0,25203200,Oceania,26738,816
2020-09-17,Australia,AU,41,8,25203200,Oceania,26779,824
2020-09-18,Australia,AU,34,8,25203200,Oceania,26813,832
2020-09-19,Australia,AU,48,5,25203200,Oceania,26861,837
2020-09-20,Australia,AU,24,7,25203200,Oceania,26885,844
2020-09-21,Australia,AU,13,5,25203200,Oceania,26898,849
2020-09-22,Australia,AU,14,2,25203200,Oceania,26912,851
2020-09-23,Australia,AU,30,3,25203200,Oceania,26942,854
2020-09-24,Australia,AU,31,5,25203200,Oceania,26973,859
2020-09-25,Australia,AU,10,2,25203200,Oceania,26983,861
2020-09-26,Australia,AU,17,8,25203200,Oceania,27000,869
2020-09-27,Australia,AU,16,1,25203200,Oceania,27016,870
2020-09-28,Australia,AU,24,2,25203200,Oceania,27040,872
2020-09-29,Australia,AU,4,3,25203200,Oceania,27044,875
2020-09-30,Australia,AU,19,7,25203200,Oceania,27063,882
2020-10-01,Australia,AU,0,0,25203200,Oceania,27063,882
2020-10-02,Australia,AU,33,6,25203200,Oceania,27096,888
2020-10-03,Australia,AU,17,2,25203200,Oceania,27113,890
2020-10-04,Australia,AU,8,3,25203200,Oceania,27121,893
2020-10-05,Australia,AU,15,1,25203200,Oceania,27136,894
2020-10-06,Australia,AU,13,0,25203200,Oceania,27149,894
2020-10-07,Australia,AU,25,1,25203200,Oceania,27174,895
2020-10-08,Australia,AU,8,2,25203200,Oceania,27182,897
2020-10-09,Australia,AU,24,0,25203200,Oceania,27206,897
2020-10-10,Australia,AU,23,0,25203200,Oceania,27229,897
2020-10-11,Australia,AU,15,0,25203200,Oceania,27244,897
2020-10-12,Australia,AU,20,1,25203200,Oceania,27264,898
2020-10-13,Australia,AU,22,0,25203200,Oceania,27286,898
2020-10-14,Australia,AU,31,1,25203200,Oceania,27317,899
2020-10-15,Australia,AU,24,5,25203200,Oceania,27341,904
2020-10-16,Australia,AU,21,0,25203200,Oceania,27362,904
2020-10-17,Australia,AU,9,0,25203200,Oceania,27371,904
2020-10-18,Australia,AU,12,0,25203200,Oceania,27383,904
2020-10-19,Australia,AU,7,0,25203200,Oceania,27390,904
2020-10-20,Australia,AU,9,1,25203200,Oceania,27399,905
2020-10-21,Australia,AU,31,0,25203200,Oceania,27430,905
2020-10-22,Australia,AU,14,0,25203200,Oceania,27444,905
2020-10-23,Australia,AU,22,0,25203200,Oceania,27466,905
2020-10-24,Australia,AU,18,0,25203200,Oceania,27484,905
2020-10-25,Australia,AU,15,0,25203200,Oceania,27499,905
2020-10-26,Australia,AU,21,0,25203200,Oceania,27520,905
2020-10-27,Australia,AU,7,0,25203200,Oceania,27527,905
2020-10-28,Australia,AU,14,0,25203200,Oceania,27541,905
2020-10-29,Australia,AU,13,2,25203200,Oceania,27554,907
2020-10-30,Australia,AU,15,0,25203200,Oceania,27569,907
2020-10-31,Australia,AU,13,0,25203200,Oceania,27582,907
2020-11-01,Australia,AU,8,0,25203200,Oceania,27590,907
2020-11-02,Australia,AU,5,0,25203200,Oceania,27595,907
2020-11-03,Australia,AU,7,0,25203200,Oceania,27602,907
2020-11-04,Australia,AU,8,0,25203200,Oceania,27610,907
2020-11-05,Australia,AU,12,0,25203200,Oceania,27622,907
2020-11-06,Australia,AU,11,0,25203200,Oceania,27633,907
2020-11-07,Australia,AU,12,0,25203200,Oceania,27645,907
2020-11-08,Australia,AU,7,0,25203200,Oceania,27652,907
2020-11-09,Australia,AU,6,0,25203200,Oceania,27658,907
2020-11-10,Australia,AU,10,0,25203200,Oceania,27668,907
2020-11-11,Australia,AU,10,0,25203200,Oceania,27678,907
2020-11-12,Australia,AU,8,0,25203200,Oceania,27686,907
2020-11-13,Australia,AU,12,0,25203200,Oceania,27698,907
2020-11-14,Australia,AU,5,0,25203200,Oceania,27703,907
2020-11-15,Australia,AU,8,0,25203200,Oceania,27711,907
2020-11-16,Australia,AU,14,0,25203200,Oceania,27725,907
2020-11-17,Australia,AU,25,0,25203200,Oceania,27750,907
2020-11-18,Australia,AU,6,0,25203200,Oceania,27756,907
2020-11-19,Australia,AU,21,0,25203200,Oceania,27777,907
2020-11-20,Australia,AU,7,0,25203200,Oceania,27784,907
2020-11-21,Australia,AU,5,0,25203200,Oceania,27789,907
2020-11-22,Australia,AU,18,0,25203200,Oceania,27807,907
2020-11-23,Australia,AU,14,0,25203200,Oceania,27821,907
2020-11-24,Australia,AU,14,0,25203200,Oceania,27835,907
2020-11-25,Australia,AU,13,0,25203200,Oceania,27848,907
2020-11-26,Australia,AU,6,0,25203200,Oceania,27854,907
2020-11-27,Australia,AU,13,0,25203200,Oceania,27867,907
2020-11-28,Australia,AU,7,0,25203200,Oceania,27874,907
2020-11-29,Australia,AU,11,0,25203200,Oceania,27885,907
2020-11-30,Australia,AU,8,0,25203200,Oceania,27893,907
2020-12-01,Australia,AU,11,1,25203200,Oceania,27904,908
2020-12-02,Australia,AU,8,0,25203200,Oceania,27912,908
2020-12-03,Australia,AU,11,0,25203200,Oceania,27923,908
2020-12-04,Australia,AU,16,0,25203200,Oceania,27939,908
2020-12-05,Australia,AU,10,0,25203200,Oceania,27949,908
2020-12-06,Australia,AU,7,0,25203200,Oceania,27956,908
2020-12-07,Australia,AU,9,0,25203200,Oceania,27965,908
2020-12-08,Australia,AU,7,0,25203200,Oceania,27972,908
2020-12-09,Australia,AU,15,0,25203200,Oceania,27987,908
2020-12-10,Australia,AU,6,0,25203200,Oceania,27993,908
2020-12-11,Australia,AU,7,0,25203200,Oceania,28000,908
2020-12-12,Australia,AU,12,0,25203200,Oceania,28012,908
2020-12-13,Australia,AU,13,0,25203200,Oceania,28025,908
2020-12-14,Australia,AU,6,0,25203200,Oceania,28031,908
2020-03-13,Aruba,AW,2,0,106310,America,2,0
2020-03-20,Aruba,AW,2,0,106310,America,4,0
2020-03-24,Aruba,AW,8,0,106310,America,12,0
2020-03-25,Aruba,AW,5,0,106310,America,17,0
2020-03-26,Aruba,AW,2,0,106310,America,19,0
2020-03-27,Aruba,AW,9,0,106310,America,28,0
2020-03-28,Aruba,AW,0,0,106310,America,28,0
2020-03-29,Aruba,AW,0,0,106310,America,28,0
2020-03-30,Aruba,AW,22,0,106310,America,50,0
2020-04-01,Aruba,AW,5,0,106310,America,55,0
2020-04-02,Aruba,AW,0,0,106310,America,55,0
2020-04-03,Aruba,AW,5,0,106310,America,60,0
2020-04-04,Aruba,AW,2,0,106310,America,62,0
2020-04-05,Aruba,AW,2,0,106310,America,64,0
2020-04-06,Aruba,AW,0,0,106310,America,64,0
2020-04-07,Aruba,AW,7,0,106310,America,71,0
2020-04-08,Aruba,AW,3,0,106310,America,74,0
2020-04-09,Aruba,AW,3,0,106310,America,77,0
2020-04-10,Aruba,AW,5,0,106310,America,82,0
2020-04-11,Aruba,AW,4,0,106310,America,86,0
2020-04-12,Aruba,AW,6,0,106310,America,92,0
2020-04-13,Aruba,AW,0,0,106310,America,92,0
2020-04-14,Aruba,AW,0,0,106310,America,92,0
2020-04-15,Aruba,AW,0,0,106310,America,92,0
2020-04-16,Aruba,AW,1,1,106310,America,93,1
2020-04-17,Aruba,AW,2,0,106310,America,95,1
2020-04-18,Aruba,AW,1,1,106310,America,96,2
2020-04-19,Aruba,AW,0,0,106310,America,96,2
2020-04-20,Aruba,AW,1,0,106310,America,97,2
2020-04-21,Aruba,AW,0,0,106310,America,97,2
2020-04-22,Aruba,AW,0,0,106310,America,97,2
2020-04-23,Aruba,AW,3,0,106310,America,100,2
2020-04-24,Aruba,AW,0,0,106310,America,100,2
2020-04-25,Aruba,AW,0,0,106310,America,100,2
2020-04-26,Aruba,AW,0,0,106310,America,100,2
2020-04-27,Aruba,AW,0,0,106310,America,100,2
2020-04-28,Aruba,AW,0,0,106310,America,100,2
2020-04-29,Aruba,AW,0,0,106310,America,100,2
2020-04-30,Aruba,AW,0,0,106310,America,100,2
2020-05-01,Aruba,AW,0,0,106310,America,100,2
2020-05-02,Aruba,AW,0,0,106310,America,100,2
2020-05-03,Aruba,AW,0,0,106310,America,100,2
2020-05-04,Aruba,AW,0,0,106310,America,100,2
2020-05-05,Aruba,AW,0,0,106310,America,100,2
2020-05-06,Aruba,AW,0,0,106310,America,100,2
2020-05-07,Aruba,AW,1,0,106310,America,101,2
2020-05-08,Aruba,AW,0,1,106310,America,101,3
2020-05-09,Aruba,AW,0,0,106310,America,101,3
2020-05-10,Aruba,AW,0,0,106310,America,101,3
2020-05-11,Aruba,AW,0,0,106310,America,101,3
2020-05-12,Aruba,AW,0,0,106310,America,101,3
2020-05-13,Aruba,AW,0,0,106310,America,101,3
2020-05-14,Aruba,AW,0,0,106310,America,101,3
2020-05-15,Aruba,AW,0,0,106310,America,101,3
2020-05-16,Aruba,AW,0,0,106310,America,101,3
2020-05-17,Aruba,AW,0,0,106310,America,101,3
2020-05-18,Aruba,AW,0,0,106310,America,101,3
2020-05-19,Aruba,AW,0,0,106310,America,101,3
2020-05-20,Aruba,AW,0,0,106310,America,101,3
2020-05-21,Aruba,AW,0,0,106310,America,101,3
2020-05-22,Aruba,AW,0,0,106310,America,101,3
2020-05-23,Aruba,AW,0,0,106310,America,101,3
2020-05-24,Aruba,AW,0,0,106310,America,101,3
2020-05-25,Aruba,AW,0,0,106310,America,101,3
2020-05-26,Aruba,AW,0,0,106310,America,101,3
2020-05-27,Aruba,AW,0,0,106310,America,101,3
2020-05-28,Aruba,AW,0,0,106310,America,101,3
2020-05-29,Aruba,AW,0,0,106310,America,101,3
2020-05-30,Aruba,AW,0,0,106310,America,101,3
2020-05-31,Aruba,AW,0,0,106310,America,101,3
2020-06-01,Aruba,AW,0,0,106310,America,101,3
2020-06-02,Aruba,AW,0,0,106310,America,101,3
2020-06-03,Aruba,AW,0,0,106310,America,101,3
2020-06-04,Aruba,AW,0,0,106310,America,101,3
2020-06-05,Aruba,AW,0,0,106310,America,101,3
2020-06-06,Aruba,AW,0,0,106310,America,101,3
2020-06-07,Aruba,AW,0,0,106310,America,101,3
2020-06-08,Aruba,AW,0,0,106310,America,101,3
2020-06-09,Aruba,AW,0,0,106310,America,101,3
2020-06-10,Aruba,AW,0,0,106310,America,101,3
2020-06-11,Aruba,AW,0,0,106310,America,101,3
2020-06-12,Aruba,AW,0,0,106310,America,101,3
2020-06-13,Aruba,AW,0,0,106310,America,101,3
2020-06-14,Aruba,AW,0,0,106310,America,101,3
2020-06-15,Aruba,AW,0,0,106310,America,101,3
2020-06-16,Aruba,AW,0,0,106310,America,101,3
2020-06-17,Aruba,AW,0,0,106310,America,101,3
2020-06-18,Aruba,AW,0,0,106310,America,101,3
2020-06-19,Aruba,AW,0,0,106310,America,101,3
2020-06-20,Aruba,AW,0,0,106310,America,101,3
2020-06-21,Aruba,AW,0,0,106310,America,101,3
2020-06-22,Aruba,AW,0,0,106310,America,101,3
2020-06-23,Aruba,AW,0,0,106310,America,101,3
2020-06-24,Aruba,AW,0,0,106310,America,101,3
2020-06-25,Aruba,AW,0,0,106310,America,101,3
2020-06-26,Aruba,AW,0,0,106310,America,101,3
2020-06-27,Aruba,AW,0,0,106310,America,101,3
2020-06-28,Aruba,AW,0,0,106310,America,101,3
2020-06-29,Aruba,AW,0,0,106310,America,101,3
2020-06-30,Aruba,AW,2,0,106310,America,103,3
2020-07-01,Aruba,AW,0,0,106310,America,103,3
2020-07-02,Aruba,AW,0,0,106310,America,103,3
2020-07-03,Aruba,AW,1,0,106310,America,104,3
2020-07-04,Aruba,AW,0,0,106310,America,104,3
2020-07-05,Aruba,AW,1,0,106310,America,105,3
2020-07-06,Aruba,AW,0,0,106310,America,105,3
2020-07-07,Aruba,AW,0,0,106310,America,105,3
2020-07-08,Aruba,AW,0,0,106310,America,105,3
2020-07-09,Aruba,AW,0,0,106310,America,105,3
2020-07-10,Aruba,AW,0,0,106310,America,105,3
2020-07-11,Aruba,AW,0,0,106310,America,105,3
2020-07-12,Aruba,AW,0,0,106310,America,105,3
2020-07-13,Aruba,AW,0,0,106310,America,105,3
2020-07-14,Aruba,AW,0,0,106310,America,105,3
2020-07-15,Aruba,AW,1,0,106310,America,106,3
2020-07-16,Aruba,AW,0,0,106310,America,106,3
2020-07-17,Aruba,AW,2,0,106310,America,108,3
2020-07-18,Aruba,AW,0,0,106310,America,108,3
2020-07-19,Aruba,AW,0,0,106310,America,108,3
2020-07-20,Aruba,AW,5,0,106310,America,113,3
2020-07-21,Aruba,AW,2,0,106310,America,115,3
2020-07-22,Aruba,AW,2,0,106310,America,117,3
2020-07-23,Aruba,AW,0,0,106310,America,117,3
2020-07-24,Aruba,AW,0,0,106310,America,117,3
2020-07-25,Aruba,AW,1,0,106310,America,118,3
2020-07-26,Aruba,AW,1,0,106310,America,119,3
2020-07-27,Aruba,AW,0,0,106310,America,119,3
2020-07-28,Aruba,AW,0,0,106310,America,119,3
2020-07-29,Aruba,AW,0,0,106310,America,119,3
2020-07-30,Aruba,AW,0,0,106310,America,119,3
2020-07-31,Aruba,AW,1,0,106310,America,120,3
2020-08-01,Aruba,AW,1,0,106310,America,121,3
2020-08-02,Aruba,AW,0,0,106310,America,121,3
2020-08-03,Aruba,AW,1,0,106310,America,122,3
2020-08-04,Aruba,AW,2,0,106310,America,124,3
2020-08-05,Aruba,AW,8,0,106310,America,132,3
2020-08-06,Aruba,AW,39,0,106310,America,171,3
2020-08-07,Aruba,AW,92,0,106310,America,263,3
2020-08-08,Aruba,AW,133,0,106310,America,396,3
2020-08-09,Aruba,AW,113,0,106310,America,509,3
2020-08-10,Aruba,AW,54,0,106310,America,563,3
2020-08-11,Aruba,AW,67,0,106310,America,630,3
2020-08-12,Aruba,AW,87,0,106310,America,717,3
2020-08-13,Aruba,AW,81,0,106310,America,798,3
2020-08-14,Aruba,AW,96,1,106310,America,894,4
2020-08-15,Aruba,AW,79,0,106310,America,973,4
2020-08-16,Aruba,AW,75,0,106310,America,1048,4
2020-08-17,Aruba,AW,54,0,106310,America,1102,4
2020-08-18,Aruba,AW,19,0,106310,America,1121,4
2020-08-19,Aruba,AW,0,0,106310,America,1121,4
2020-08-20,Aruba,AW,175,1,106310,America,1296,5
2020-08-21,Aruba,AW,91,1,106310,America,1387,6
2020-08-22,Aruba,AW,77,0,106310,America,1464,6
2020-08-23,Aruba,AW,70,1,106310,America,1534,7
2020-08-24,Aruba,AW,34,0,106310,America,1568,7
2020-08-25,Aruba,AW,60,0,106310,America,1628,7
2020-08-26,Aruba,AW,42,1,106310,America,1670,8
2020-08-27,Aruba,AW,90,0,106310,America,1760,8
2020-08-28,Aruba,AW,88,0,106310,America,1848,8
2020-08-29,Aruba,AW,58,1,106310,America,1906,9
2020-08-30,Aruba,AW,69,1,106310,America,1975,10
2020-08-31,Aruba,AW,22,0,106310,America,1997,10
2020-09-01,Aruba,AW,9,0,106310,America,2006,10
2020-09-02,Aruba,AW,98,0,106310,America,2104,10
2020-09-03,Aruba,AW,107,2,106310,America,2211,12
2020-09-04,Aruba,AW,81,1,106310,America,2292,13
2020-09-05,Aruba,AW,66,0,106310,America,2358,13
2020-09-06,Aruba,AW,70,1,106310,America,2428,14
2020-09-07,Aruba,AW,21,0,106310,America,2449,14
2020-09-08,Aruba,AW,33,1,106310,America,2482,15
2020-09-09,Aruba,AW,107,0,106310,America,2589,15
2020-09-10,Aruba,AW,141,0,106310,America,2730,15
2020-09-11,Aruba,AW,89,1,106310,America,2819,16
2020-09-12,Aruba,AW,79,2,106310,America,2898,18
2020-09-13,Aruba,AW,96,0,106310,America,2994,18
2020-09-14,Aruba,AW,52,0,106310,America,3046,18
2020-09-15,Aruba,AW,14,2,106310,America,3060,20
2020-09-16,Aruba,AW,92,2,106310,America,3152,22
2020-09-17,Aruba,AW,176,0,106310,America,3328,22
2020-09-18,Aruba,AW,54,1,106310,America,3382,23
2020-09-19,Aruba,AW,78,0,106310,America,3460,23
2020-09-20,Aruba,AW,0,0,106310,America,3460,23
2020-09-21,Aruba,AW,91,0,106310,America,3551,23
2020-09-22,Aruba,AW,36,1,106310,America,3587,24
2020-09-23,Aruba,AW,78,1,106310,America,3665,25
2020-09-24,Aruba,AW,56,0,106310,America,3721,25
2020-09-25,Aruba,AW,35,0,106310,America,3756,25
2020-09-26,Aruba,AW,43,0,106310,America,3799,25
2020-09-27,Aruba,AW,33,0,106310,America,3832,25
2020-09-28,Aruba,AW,12,0,106310,America,3844,25
2020-09-29,Aruba,AW,28,0,106310,America,3872,25
2020-09-30,Aruba,AW,62,1,106310,America,3934,26
2020-10-01,Aruba,AW,29,1,106310,America,3963,27
2020-10-02,Aruba,AW,35,0,106310,America,3998,27
2020-10-03,Aruba,AW,40,3,106310,America,4038,30
2020-10-04,Aruba,AW,36,0,106310,America,4074,30
2020-10-05,Aruba,AW,5,0,106310,America,4079,30
2020-10-06,Aruba,AW,0,0,106310,America,4079,30
2020-10-07,Aruba,AW,15,1,106310,America,4094,31
2020-10-08,Aruba,AW,14,0,106310,America,4108,31
2020-10-09,Aruba,AW,25,0,106310,America,4133,31
2020-10-10,Aruba,AW,34,1,106310,America,4167,32
2020-10-11,Aruba,AW,21,0,106310,America,4188,32
2020-10-12,Aruba,AW,6,0,106310,America,4194,32
2020-10-13,Aruba,AW,3,0,106310,America,4197,32
2020-10-14,Aruba,AW,32,0,106310,America,4229,32
2020-10-15,Aruba,AW,26,0,106310,America,4255,32
2020-10-16,Aruba,AW,30,0,106310,America,4285,32
2020-10-17,Aruba,AW,4,0,106310,America,4289,32
2020-10-18,Aruba,AW,15,2,106310,America,4304,34
2020-10-19,Aruba,AW,18,0,106310,America,4322,34
2020-10-20,Aruba,AW,12,0,106310,America,4334,34
2020-10-21,Aruba,AW,21,0,106310,America,4355,34
2020-10-22,Aruba,AW,14,1,106310,America,4369,35
2020-10-23,Aruba,AW,20,1,106310,America,4389,36
2020-10-24,Aruba,AW,12,0,106310,America,4401,36
2020-10-25,Aruba,AW,9,0,106310,America,4410,36
2020-10-26,Aruba,AW,10,0,106310,America,4420,36
2020-10-27,Aruba,AW,0,0,106310,America,4420,36
2020-10-28,Aruba,AW,0,0,106310,America,4420,36
2020-10-29,Aruba,AW,17,0,106310,America,4437,36
2020-10-30,Aruba,AW,18,1,106310,America,4455,37
2020-10-31,Aruba,AW,17,0,106310,America,4472,37
2020-11-01,Aruba,AW,41,1,106310,America,4513,38
2020-11-02,Aruba,AW,6,0,106310,America,4519,38
2020-11-03,Aruba,AW,5,0,106310,America,4524,38
2020-11-04,Aruba,AW,14,0,106310,America,4538,38
2020-11-05,Aruba,AW,15,1,106310,America,4553,39
2020-11-06,Aruba,AW,11,0,106310,America,4564,39
2020-11-07,Aruba,AW,14,0,106310,America,4578,39
2020-11-08,Aruba,AW,11,1,106310,America,4589,40
2020-11-09,Aruba,AW,11,0,106310,America,4600,40
2020-11-10,Aruba,AW,6,1,106310,America,4606,41
2020-11-11,Aruba,AW,16,1,106310,America,4622,42
2020-11-12,Aruba,AW,9,1,106310,America,4631,43
2020-11-13,Aruba,AW,8,0,106310,America,4639,43
2020-11-14,Aruba,AW,11,0,106310,America,4650,43
2020-11-15,Aruba,AW,8,1,106310,America,4658,44
2020-11-16,Aruba,AW,4,0,106310,America,4662,44
2020-11-17,Aruba,AW,6,0,106310,America,4668,44
2020-11-18,Aruba,AW,8,0,106310,America,4676,44
2020-11-19,Aruba,AW,9,1,106310,America,4685,45
2020-11-20,Aruba,AW,8,0,106310,America,4693,45
2020-11-21,Aruba,AW,5,0,106310,America,4698,45
2020-11-22,Aruba,AW,26,0,106310,America,4724,45
2020-11-23,Aruba,AW,7,0,106310,America,4731,45
2020-11-24,Aruba,AW,6,0,106310,America,4737,45
2020-11-25,Aruba,AW,14,0,106310,America,4751,45
2020-11-26,Aruba,AW,27,0,106310,America,4778,45
2020-11-27,Aruba,AW,13,0,106310,America,4791,45
2020-11-28,Aruba,AW,17,0,106310,America,4808,45
2020-11-29,Aruba,AW,25,0,106310,America,4833,45
2020-11-30,Aruba,AW,5,0,106310,America,4838,45
2020-12-01,Aruba,AW,7,0,106310,America,4845,45
2020-12-02,Aruba,AW,27,0,106310,America,4872,45
2020-12-03,Aruba,AW,30,0,106310,America,4902,45
2020-12-04,Aruba,AW,21,0,106310,America,4923,45
2020-12-05,Aruba,AW,19,0,106310,America,4942,45
2020-12-06,Aruba,AW,15,0,106310,America,4957,45
2020-12-07,Aruba,AW,8,0,106310,America,4965,45
2020-12-08,Aruba,AW,1,0,106310,America,4966,45
2020-12-09,Aruba,AW,18,0,106310,America,4984,45
2020-12-10,Aruba,AW,12,0,106310,America,4996,45
2020-12-11,Aruba,AW,15,1,106310,America,5011,46
2020-12-12,Aruba,AW,20,0,106310,America,5031,46
2020-12-13,Aruba,AW,13,0,106310,America,5044,46
2020-12-14,Aruba,AW,5,0,106310,America,5049,46
2019-12-31,Azerbaijan,AZ,0,0,10047719,Europe,0,0
2020-01-01,Azerbaijan,AZ,0,0,10047719,Europe,0,0
2020-01-02,Azerbaijan,AZ,0,0,10047719,Europe,0,0
2020-01-03,Azerbaijan,AZ,0,0,10047719,Europe,0,0
2020-01-04,Azerbaijan,AZ,0,0,10047719,Europe,0,0
2020-01-05,Azerbaijan,AZ,0,0,10047719,Europe,0,0
2020-01-06,Azerbaijan,AZ,0,0,10047719,Europe,0,0
2020-01-07,Azerbaijan,AZ,0,0,10047719,Europe,0,0
2020-01-08,Azerbaijan,AZ,0,0,10047719,Europe,0,0
2020-01-09,Azerbaijan,AZ,0,0,10047719,Europe,0,0
2020-01-10,Azerbaijan,AZ,0,0,10047719,Europe,0,0
2020-01-11,Azerbaijan,AZ,0,0,10047719,Europe,0,0
2020-01-12,Azerbaijan,AZ,0,0,10047719,Europe,0,0
2020-01-13,Azerbaijan,AZ,0,0,10047719,Europe,0,0
2020-01-14,Azerbaijan,AZ,0,0,10047719,Europe,0,0
2020-01-15,Azerbaijan,AZ,0,0,10047719,Europe,0,0
2020-01-16,Azerbaijan,AZ,0,0,10047719,Europe,0,0
2020-01-17,Azerbaijan,AZ,0,0,10047719,Europe,0,0
2020-01-18,Azerbaijan,AZ,0,0,10047719,Europe,0,0
2020-01-19,Azerbaijan,AZ,0,0,10047719,Europe,0,0
2020-01-20,Azerbaijan,AZ,0,0,10047719,Europe,0,0
2020-01-21,Azerbaijan,AZ,0,0,10047719,Europe,0,0
2020-01-22,Azerbaijan,AZ,0,0,10047719,Europe,0,0
2020-01-23,Azerbaijan,AZ,0,0,10047719,Europe,0,0
2020-01-24,Azerbaijan,AZ,0,0,10047719,Europe,0,0
2020-01-25,Azerbaijan,AZ,0,0,10047719,Europe,0,0
2020-01-26,Azerbaijan,AZ,0,0,10047719,Europe,0,0
2020-01-27,Azerbaijan,AZ,0,0,10047719,Europe,0,0
2020-01-28,Azerbaijan,AZ,0,0,10047719,Europe,0,0
2020-01-29,Azerbaijan,AZ,0,0,10047719,Europe,0,0
2020-01-30,Azerbaijan,AZ,0,0,10047719,Europe,0,0
2020-01-31,Azerbaijan,AZ,0,0,10047719,Europe,0,0
2020-02-01,Azerbaijan,AZ,0,0,10047719,Europe,0,0
2020-02-02,Azerbaijan,AZ,0,0,10047719,Europe,0,0
2020-02-03,Azerbaijan,AZ,0,0,10047719,Europe,0,0
2020-02-04,Azerbaijan,AZ,0,0,10047719,Europe,0,0
2020-02-05,Azerbaijan,AZ,0,0,10047719,Europe,0,0
2020-02-06,Azerbaijan,AZ,0,0,10047719,Europe,0,0
2020-02-07,Azerbaijan,AZ,0,0,10047719,Europe,0,0
2020-02-08,Azerbaijan,AZ,0,0,10047719,Europe,0,0
2020-02-09,Azerbaijan,AZ,0,0,10047719,Europe,0,0
2020-02-10,Azerbaijan,AZ,0,0,10047719,Europe,0,0
2020-02-11,Azerbaijan,AZ,0,0,10047719,Europe,0,0
2020-02-12,Azerbaijan,AZ,0,0,10047719,Europe,0,0
2020-02-13,Azerbaijan,AZ,0,0,10047719,Europe,0,0
2020-02-14,Azerbaijan,AZ,0,0,10047719,Europe,0,0
2020-02-15,Azerbaijan,AZ,0,0,10047719,Europe,0,0
2020-02-16,Azerbaijan,AZ,0,0,10047719,Europe,0,0
2020-02-17,Azerbaijan,AZ,0,0,10047719,Europe,0,0
2020-02-18,Azerbaijan,AZ,0,0,10047719,Europe,0,0
2020-02-19,Azerbaijan,AZ,0,0,10047719,Europe,0,0
2020-02-20,Azerbaijan,AZ,0,0,10047719,Europe,0,0
2020-02-21,Azerbaijan,AZ,0,0,10047719,Europe,0,0
2020-02-22,Azerbaijan,AZ,0,0,10047719,Europe,0,0
2020-02-23,Azerbaijan,AZ,0,0,10047719,Europe,0,0
2020-02-24,Azerbaijan,AZ,0,0,10047719,Europe,0,0
2020-02-25,Azerbaijan,AZ,0,0,10047719,Europe,0,0
2020-02-26,Azerbaijan,AZ,0,0,10047719,Europe,0,0
2020-02-27,Azerbaijan,AZ,0,0,10047719,Europe,0,0
2020-02-28,Azerbaijan,AZ,0,0,10047719,Europe,0,0
2020-02-29,Azerbaijan,AZ,1,0,10047719,Europe,1,0
2020-03-01,Azerbaijan,AZ,0,0,10047719,Europe,1,0
2020-03-02,Azerbaijan,AZ,2,0,10047719,Europe,3,0
2020-03-06,Azerbaijan,AZ,3,0,10047719,Europe,6,0
2020-03-07,Azerbaijan,AZ,3,0,10047719,Europe,9,0
2020-03-11,Azerbaijan,AZ,2,0,10047719,Europe,11,0
2020-03-12,Azerbaijan,AZ,2,0,10047719,Europe,13,0
2020-03-13,Azerbaijan,AZ,0,0,10047719,Europe,13,0
2020-03-15,Azerbaijan,AZ,6,0,10047719,Europe,19,0
2020-03-16,Azerbaijan,AZ,0,0,10047719,Europe,19,0
2020-03-17,Azerbaijan,AZ,0,0,10047719,Europe,19,0
2020-03-18,Azerbaijan,AZ,9,0,10047719,Europe,28,0
2020-03-19,Azerbaijan,AZ,6,0,10047719,Europe,34,0
2020-03-20,Azerbaijan,AZ,10,0,10047719,Europe,44,0
2020-03-21,Azerbaijan,AZ,0,1,10047719,Europe,44,1
2020-03-22,Azerbaijan,AZ,9,0,10047719,Europe,53,1
2020-03-23,Azerbaijan,AZ,12,0,10047719,Europe,65,1
2020-03-24,Azerbaijan,AZ,7,0,10047719,Europe,72,1
2020-03-25,Azerbaijan,AZ,15,0,10047719,Europe,87,1
2020-03-26,Azerbaijan,AZ,6,1,10047719,Europe,93,2
2020-03-27,Azerbaijan,AZ,29,1,10047719,Europe,122,3
2020-03-28,Azerbaijan,AZ,43,0,10047719,Europe,165,3
2020-03-29,Azerbaijan,AZ,17,1,10047719,Europe,182,4
2020-03-30,Azerbaijan,AZ,27,0,10047719,Europe,209,4
2020-03-31,Azerbaijan,AZ,64,0,10047719,Europe,273,4
2020-04-01,Azerbaijan,AZ,25,1,10047719,Europe,298,5
2020-04-02,Azerbaijan,AZ,61,0,10047719,Europe,359,5
2020-04-03,Azerbaijan,AZ,41,0,10047719,Europe,400,5
2020-04-04,Azerbaijan,AZ,43,0,10047719,Europe,443,5
2020-04-05,Azerbaijan,AZ,78,0,10047719,Europe,521,5
2020-04-06,Azerbaijan,AZ,63,2,10047719,Europe,584,7
2020-04-07,Azerbaijan,AZ,57,0,10047719,Europe,641,7
2020-04-08,Azerbaijan,AZ,76,1,10047719,Europe,717,8
2020-04-09,Azerbaijan,AZ,105,0,10047719,Europe,822,8
2020-04-10,Azerbaijan,AZ,104,1,10047719,Europe,926,9
2020-04-11,Azerbaijan,AZ,65,1,10047719,Europe,991,10
2020-04-12,Azerbaijan,AZ,67,1,10047719,Europe,1058,11
2020-04-13,Azerbaijan,AZ,40,0,10047719,Europe,1098,11
2020-04-14,Azerbaijan,AZ,50,1,10047719,Europe,1148,12
2020-04-15,Azerbaijan,AZ,49,1,10047719,Europe,1197,13
2020-04-16,Azerbaijan,AZ,56,0,10047719,Europe,1253,13
2020-04-17,Azerbaijan,AZ,30,2,10047719,Europe,1283,15
2020-04-18,Azerbaijan,AZ,57,0,10047719,Europe,1340,15
2020-04-19,Azerbaijan,AZ,33,3,10047719,Europe,1373,18
2020-04-20,Azerbaijan,AZ,25,1,10047719,Europe,1398,19
2020-04-21,Azerbaijan,AZ,38,0,10047719,Europe,1436,19
2020-04-22,Azerbaijan,AZ,44,1,10047719,Europe,1480,20
2020-04-23,Azerbaijan,AZ,38,0,10047719,Europe,1518,20
2020-04-24,Azerbaijan,AZ,30,0,10047719,Europe,1548,20
2020-04-25,Azerbaijan,AZ,44,1,10047719,Europe,1592,21
2020-04-26,Azerbaijan,AZ,25,0,10047719,Europe,1617,21
2020-04-27,Azerbaijan,AZ,28,0,10047719,Europe,1645,21
2020-04-28,Azerbaijan,AZ,33,1,10047719,Europe,1678,22
2020-04-29,Azerbaijan,AZ,39,0,10047719,Europe,1717,22
2020-04-30,Azerbaijan,AZ,49,1,10047719,Europe,1766,23
2020-05-01,Azerbaijan,AZ,38,1,10047719,Europe,1804,24
2020-05-02,Azerbaijan,AZ,50,1,10047719,Europe,1854,25
2020-05-03,Azerbaijan,AZ,40,0,10047719,Europe,1894,25
2020-05-04,Azerbaijan,AZ,38,0,10047719,Europe,1932,25
2020-05-05,Azerbaijan,AZ,52,1,10047719,Europe,1984,26
2020-05-06,Azerbaijan,AZ,76,0,10047719,Europe,2060,26
2020-05-07,Azerbaijan,AZ,67,2,10047719,Europe,2127,28
2020-05-08,Azerbaijan,AZ,77,0,10047719,Europe,2204,28
2020-05-09,Azerbaijan,AZ,75,0,10047719,Europe,2279,28
2020-05-10,Azerbaijan,AZ,143,3,10047719,Europe,2422,31
2020-05-11,Azerbaijan,AZ,97,1,10047719,Europe,2519,32
2020-05-12,Azerbaijan,AZ,70,0,10047719,Europe,2589,32
2020-05-13,Azerbaijan,AZ,104,1,10047719,Europe,2693,33
2020-05-14,Azerbaijan,AZ,65,2,10047719,Europe,2758,35
2020-05-15,Azerbaijan,AZ,121,0,10047719,Europe,2879,35
2020-05-16,Azerbaijan,AZ,101,1,10047719,Europe,2980,36
2020-05-17,Azerbaijan,AZ,158,0,10047719,Europe,3138,36
2020-05-18,Azerbaijan,AZ,136,3,10047719,Europe,3274,39
2020-05-19,Azerbaijan,AZ,13,1,10047719,Europe,3287,40
2020-05-20,Azerbaijan,AZ,231,1,10047719,Europe,3518,41
2020-05-21,Azerbaijan,AZ,113,2,10047719,Europe,3631,43
2020-05-22,Azerbaijan,AZ,118,1,10047719,Europe,3749,44
2020-05-23,Azerbaijan,AZ,106,2,10047719,Europe,3855,46
2020-05-24,Azerbaijan,AZ,127,3,10047719,Europe,3982,49
2020-05-25,Azerbaijan,AZ,140,0,10047719,Europe,4122,49
2020-05-26,Azerbaijan,AZ,149,2,10047719,Europe,4271,51
2020-05-27,Azerbaijan,AZ,132,1,10047719,Europe,4403,52
2020-05-28,Azerbaijan,AZ,165,2,10047719,Europe,4568,54
2020-05-29,Azerbaijan,AZ,191,2,10047719,Europe,4759,56
2020-05-30,Azerbaijan,AZ,230,2,10047719,Europe,4989,58
2020-05-31,Azerbaijan,AZ,257,3,10047719,Europe,5246,61
2020-06-01,Azerbaijan,AZ,248,2,10047719,Europe,5494,63
2020-06-02,Azerbaijan,AZ,168,5,10047719,Europe,5662,68
2020-06-03,Azerbaijan,AZ,273,3,10047719,Europe,5935,71
2020-06-04,Azerbaijan,AZ,325,5,10047719,Europe,6260,76
2020-06-05,Azerbaijan,AZ,262,2,10047719,Europe,6522,78
2020-06-06,Azerbaijan,AZ,338,4,10047719,Europe,6860,82
2020-06-07,Azerbaijan,AZ,379,2,10047719,Europe,7239,84
2020-06-08,Azerbaijan,AZ,314,4,10047719,Europe,7553,88
2020-06-09,Azerbaijan,AZ,323,5,10047719,Europe,7876,93
2020-06-10,Azerbaijan,AZ,315,5,10047719,Europe,8191,98
2020-06-11,Azerbaijan,AZ,339,4,10047719,Europe,8530,102
2020-06-12,Azerbaijan,AZ,352,6,10047719,Europe,8882,108
2020-06-13,Azerbaijan,AZ,336,5,10047719,Europe,9218,113
2020-06-14,Azerbaijan,AZ,352,2,10047719,Europe,9570,115
2020-06-15,Azerbaijan,AZ,387,4,10047719,Europe,9957,119
2020-06-16,Azerbaijan,AZ,367,3,10047719,Europe,10324,122
2020-06-17,Azerbaijan,AZ,338,4,10047719,Europe,10662,126
2020-06-18,Azerbaijan,AZ,329,7,10047719,Europe,10991,133
2020-06-19,Azerbaijan,AZ,338,6,10047719,Europe,11329,139
2020-06-20,Azerbaijan,AZ,438,4,10047719,Europe,11767,143
2020-06-21,Azerbaijan,AZ,471,5,10047719,Europe,12238,148
2020-06-22,Azerbaijan,AZ,491,6,10047719,Europe,12729,154
2020-06-23,Azerbaijan,AZ,478,7,10047719,Europe,13207,161
2020-06-24,Azerbaijan,AZ,508,6,10047719,Europe,13715,167
2020-06-25,Azerbaijan,AZ,590,7,10047719,Europe,14305,174
2020-06-26,Azerbaijan,AZ,547,6,10047719,Europe,14852,180
2020-06-27,Azerbaijan,AZ,517,7,10047719,Europe,15369,187
2020-06-28,Azerbaijan,AZ,521,6,10047719,Europe,15890,193
2020-06-29,Azerbaijan,AZ,534,5,10047719,Europe,16424,198
2020-06-30,Azerbaijan,AZ,544,8,10047719,Europe,16968,206
2020-07-01,Azerbaijan,AZ,556,7,10047719,Europe,17524,213
2020-07-02,Azerbaijan,AZ,588,7,10047719,Europe,18112,220
2020-07-03,Azerbaijan,AZ,572,8,10047719,Europe,18684,228
2020-07-04,Azerbaijan,AZ,583,7,10047719,Europe,19267,235
2020-07-05,Azerbaijan,AZ,534,6,10047719,Europe,19801,241
2020-07-06,Azerbaijan,AZ,523,9,10047719,Europe,20324,250
2020-07-07,Azerbaijan,AZ,513,8,10047719,Europe,20837,258
2020-07-08,Azerbaijan,AZ,537,7,10047719,Europe,21374,265
2020-07-09,Azerbaijan,AZ,542,9,10047719,Europe,21916,274
2020-07-10,Azerbaijan,AZ,548,10,10047719,Europe,22464,284
2020-07-11,Azerbaijan,AZ,526,8,10047719,Europe,22990,292
2020-07-12,Azerbaijan,AZ,531,6,10047719,Europe,23521,298
2020-07-13,Azerbaijan,AZ,520,8,10047719,Europe,24041,306
2020-07-14,Azerbaijan,AZ,529,7,10047719,Europe,24570,313
2020-07-15,Azerbaijan,AZ,543,6,10047719,Europe,25113,319
2020-07-16,Azerbaijan,AZ,559,7,10047719,Europe,25672,326
2020-07-17,Azerbaijan,AZ,493,8,10047719,Europe,26165,334
2020-07-18,Azerbaijan,AZ,471,7,10047719,Europe,26636,341
2020-07-19,Azerbaijan,AZ,497,8,10047719,Europe,27133,349
2020-07-20,Azerbaijan,AZ,388,5,10047719,Europe,27521,354
2020-07-21,Azerbaijan,AZ,369,9,10047719,Europe,27890,363
2020-07-22,Azerbaijan,AZ,352,13,10047719,Europe,28242,376
2020-07-23,Azerbaijan,AZ,391,9,10047719,Europe,28633,385
2020-07-24,Azerbaijan,AZ,347,6,10047719,Europe,28980,391
2020-07-25,Azerbaijan,AZ,332,9,10047719,Europe,29312,400
2020-07-26,Azerbaijan,AZ,321,8,10047719,Europe,29633,408
2020-07-27,Azerbaijan,AZ,417,9,10047719,Europe,30050,417
2020-07-28,Azerbaijan,AZ,396,6,10047719,Europe,30446,423
2020-07-29,Azerbaijan,AZ,412,7,10047719,Europe,30858,430
2020-07-30,Azerbaijan,AZ,363,8,10047719,Europe,31221,438
2020-07-31,Azerbaijan,AZ,339,3,10047719,Europe,31560,441
2020-08-01,Azerbaijan,AZ,318,7,10047719,Europe,31878,448
2020-08-02,Azerbaijan,AZ,279,6,10047719,Europe,32157,454
2020-08-03,Azerbaijan,AZ,286,8,10047719,Europe,32443,462
2020-08-04,Azerbaijan,AZ,241,6,10047719,Europe,32684,468
2020-08-05,Azerbaijan,AZ,226,5,10047719,Europe,32910,473
2020-08-06,Azerbaijan,AZ,193,3,10047719,Europe,33103,476
2020-08-07,Azerbaijan,AZ,144,3,10047719,Europe,33247,479
2020-08-08,Azerbaijan,AZ,129,4,10047719,Europe,33376,483
2020-08-09,Azerbaijan,AZ,105,5,10047719,Europe,33481,488
2020-08-10,Azerbaijan,AZ,87,2,10047719,Europe,33568,490
2020-08-11,Azerbaijan,AZ,79,2,10047719,Europe,33647,492
2020-08-12,Azerbaijan,AZ,84,3,10047719,Europe,33731,495
2020-08-13,Azerbaijan,AZ,93,2,10047719,Europe,33824,497
2020-08-14,Azerbaijan,AZ,91,3,10047719,Europe,33915,500
2020-08-15,Azerbaijan,AZ,103,4,10047719,Europe,34018,504
2020-08-16,Azerbaijan,AZ,89,2,10047719,Europe,34107,506
2020-08-17,Azerbaijan,AZ,112,0,10047719,Europe,34219,506
2020-08-18,Azerbaijan,AZ,124,2,10047719,Europe,34343,508
2020-08-19,Azerbaijan,AZ,131,1,10047719,Europe,34474,509
2020-08-20,Azerbaijan,AZ,146,1,10047719,Europe,34620,510
2020-08-21,Azerbaijan,AZ,139,0,10047719,Europe,34759,510
2020-08-22,Azerbaijan,AZ,162,2,10047719,Europe,34921,512
2020-08-23,Azerbaijan,AZ,184,3,10047719,Europe,35105,515
2020-08-24,Azerbaijan,AZ,169,3,10047719,Europe,35274,518
2020-08-25,Azerbaijan,AZ,152,1,10047719,Europe,35426,519
2020-08-26,Azerbaijan,AZ,133,2,10047719,Europe,35559,521
2020-08-27,Azerbaijan,AZ,148,1,10047719,Europe,35707,522
2020-08-28,Azerbaijan,AZ,137,2,10047719,Europe,35844,524
2020-08-29,Azerbaijan,AZ,142,3,10047719,Europe,35986,527
2020-08-30,Azerbaijan,AZ,188,2,10047719,Europe,36174,529
2020-08-31,Azerbaijan,AZ,135,2,10047719,Europe,36309,531
2020-09-01,Azerbaijan,AZ,126,3,10047719,Europe,36435,534
2020-09-02,Azerbaijan,AZ,143,2,10047719,Europe,36578,536
2020-09-03,Azerbaijan,AZ,154,2,10047719,Europe,36732,538
2020-09-04,Azerbaijan,AZ,167,3,10047719,Europe,36899,541
2020-09-05,Azerbaijan,AZ,132,2,10047719,Europe,37031,543
2020-09-06,Azerbaijan,AZ,161,2,10047719,Europe,37192,545
2020-09-07,Azerbaijan,AZ,137,3,10047719,Europe,37329,548
2020-09-08,Azerbaijan,AZ,89,3,10047719,Europe,37418,551
2020-09-09,Azerbaijan,AZ,139,1,10047719,Europe,37557,552
2020-09-10,Azerbaijan,AZ,175,3,10047719,Europe,37732,555
2020-09-11,Azerbaijan,AZ,142,1,10047719,Europe,37874,556
2020-09-12,Azerbaijan,AZ,163,1,10047719,Europe,38037,557
2020-09-13,Azerbaijan,AZ,135,2,10047719,Europe,38172,559
2020-09-14,Azerbaijan,AZ,155,3,10047719,Europe,38327,562
2020-09-15,Azerbaijan,AZ,76,2,10047719,Europe,38403,564
2020-09-16,Azerbaijan,AZ,114,2,10047719,Europe,38517,566
2020-09-17,Azerbaijan,AZ,141,3,10047719,Europe,38658,569
2020-09-18,Azerbaijan,AZ,119,2,10047719,Europe,38777,571
2020-09-19,Azerbaijan,AZ,117,1,10047719,Europe,38894,572
2020-09-20,Azerbaijan,AZ,148,2,10047719,Europe,39042,574
2020-09-21,Azerbaijan,AZ,146,1,10047719,Europe,39188,575
2020-09-22,Azerbaijan,AZ,92,1,10047719,Europe,39280,576
2020-09-23,Azerbaijan,AZ,98,2,10047719,Europe,39378,578
2020-09-24,Azerbaijan,AZ,146,2,10047719,Europe,39524,580
2020-09-25,Azerbaijan,AZ,162,1,10047719,Europe,39686,581
2020-09-26,Azerbaijan,AZ,101,2,10047719,Europe,39787,583
2020-09-27,Azerbaijan,AZ,108,2,10047719,Europe,39895,585
2020-09-28,Azerbaijan,AZ,128,1,10047719,Europe,40023,586
2020-09-29,Azerbaijan,AZ,38,2,10047719,Europe,40061,588
2020-09-30,Azerbaijan,AZ,58,2,10047719,Europe,40119,590
2020-10-01,Azerbaijan,AZ,110,1,10047719,Europe,40229,591
2020-10-02,Azerbaijan,AZ,80,2,10047719,Europe,40309,593
2020-10-03,Azerbaijan,AZ,144,1,10047719,Europe,40453,594
2020-10-04,Azerbaijan,AZ,108,1,10047719,Europe,40561,595
2020-10-05,Azerbaijan,AZ,130,1,10047719,Europe,40691,596
2020-10-06,Azerbaijan,AZ,97,2,10047719,Europe,40788,598
2020-10-07,Azerbaijan,AZ,143,2,10047719,Europe,40931,600
2020-10-08,Azerbaijan,AZ,182,2,10047719,Europe,41113,602
2020-10-09,Azerbaijan,AZ,191,1,10047719,Europe,41304,603
2020-10-10,Azerbaijan,AZ,215,2,10047719,Europe,41519,605
2020-10-11,Azerbaijan,AZ,233,3,10047719,Europe,41752,608
2020-10-12,Azerbaijan,AZ,230,1,10047719,Europe,41982,609
2020-10-13,Azerbaijan,AZ,122,0,10047719,Europe,42104,609
2020-10-14,Azerbaijan,AZ,277,3,10047719,Europe,42381,612
2020-10-15,Azerbaijan,AZ,369,4,10047719,Europe,42750,616
2020-10-16,Azerbaijan,AZ,530,3,10047719,Europe,43280,619
2020-10-17,Azerbaijan,AZ,509,2,10047719,Europe,43789,621
2020-10-18,Azerbaijan,AZ,528,2,10047719,Europe,44317,623
2020-10-19,Azerbaijan,AZ,647,3,10047719,Europe,44964,626
2020-10-20,Azerbaijan,AZ,331,4,10047719,Europe,45295,630
2020-10-21,Azerbaijan,AZ,584,5,10047719,Europe,45879,635
2020-10-22,Azerbaijan,AZ,714,7,10047719,Europe,46593,642
2020-10-23,Azerbaijan,AZ,825,6,10047719,Europe,47418,648
2020-10-24,Azerbaijan,AZ,803,8,10047719,Europe,48221,656
2020-10-25,Azerbaijan,AZ,792,8,10047719,Europe,49013,664
2020-10-26,Azerbaijan,AZ,946,7,10047719,Europe,49959,671
2020-10-27,Azerbaijan,AZ,527,8,10047719,Europe,50486,679
2020-10-28,Azerbaijan,AZ,663,9,10047719,Europe,51149,688
2020-10-29,Azerbaijan,AZ,988,11,10047719,Europe,52137,699
2020-10-30,Azerbaijan,AZ,1015,9,10047719,Europe,53152,708
2020-10-31,Azerbaijan,AZ,1022,10,10047719,Europe,54174,718
2020-11-01,Azerbaijan,AZ,1095,12,10047719,Europe,55269,730
2020-11-02,Azerbaijan,AZ,1175,10,10047719,Europe,56444,740
2020-11-03,Azerbaijan,AZ,596,13,10047719,Europe,57040,753
2020-11-04,Azerbaijan,AZ,1242,15,10047719,Europe,58282,768
2020-11-05,Azerbaijan,AZ,1227,12,10047719,Europe,59509,780
2020-11-06,Azerbaijan,AZ,1364,14,10047719,Europe,60873,794
2020-11-07,Azerbaijan,AZ,0,0,10047719,Europe,60873,794
2020-11-08,Azerbaijan,AZ,2875,30,10047719,Europe,63748,824
2020-11-09,Azerbaijan,AZ,1663,16,10047719,Europe,65411,840
2020-11-10,Azerbaijan,AZ,635,12,10047719,Europe,66046,852
2020-11-11,Azerbaijan,AZ,1346,15,10047719,Europe,67392,867
2020-11-12,Azerbaijan,AZ,1202,18,10047719,Europe,68594,885
2020-11-13,Azerbaijan,AZ,1622,20,10047719,Europe,70216,905
2020-11-14,Azerbaijan,AZ,1364,22,10047719,Europe,71580,927
2020-11-15,Azerbaijan,AZ,1849,19,10047719,Europe,73429,946
2020-11-16,Azerbaijan,AZ,2259,21,10047719,Europe,75688,967
2020-11-17,Azerbaijan,AZ,1395,18,10047719,Europe,77083,985
2020-11-18,Azerbaijan,AZ,2075,20,10047719,Europe,79158,1005
2020-11-19,Azerbaijan,AZ,2239,25,10047719,Europe,81397,1030
2020-11-20,Azerbaijan,AZ,2597,23,10047719,Europe,83994,1053
2020-11-21,Azerbaijan,AZ,3169,26,10047719,Europe,87163,1079
2020-11-22,Azerbaijan,AZ,2735,28,10047719,Europe,89898,1107
2020-11-23,Azerbaijan,AZ,3196,24,10047719,Europe,93094,1131
2020-11-24,Azerbaijan,AZ,2187,29,10047719,Europe,95281,1160
2020-11-25,Azerbaijan,AZ,3646,34,10047719,Europe,98927,1194
2020-11-26,Azerbaijan,AZ,3469,30,10047719,Europe,102396,1224
2020-11-27,Azerbaijan,AZ,3705,32,10047719,Europe,106101,1256
2020-11-28,Azerbaijan,AZ,3712,35,10047719,Europe,109813,1291
2020-11-29,Azerbaijan,AZ,4212,32,10047719,Europe,114025,1323
2020-11-30,Azerbaijan,AZ,4170,38,10047719,Europe,118195,1361
2020-12-01,Azerbaijan,AZ,2981,31,10047719,Europe,121176,1392
2020-12-02,Azerbaijan,AZ,4426,41,10047719,Europe,125602,1433
2020-12-03,Azerbaijan,AZ,3942,37,10047719,Europe,129544,1470
2020-12-04,Azerbaijan,AZ,4189,40,10047719,Europe,133733,1510
2020-12-05,Azerbaijan,AZ,4267,41,10047719,Europe,138000,1551
2020-12-06,Azerbaijan,AZ,4323,42,10047719,Europe,142323,1593
2020-12-07,Azerbaijan,AZ,4356,39,10047719,Europe,146679,1632
2020-12-08,Azerbaijan,AZ,3086,43,10047719,Europe,149765,1675
2020-12-09,Azerbaijan,AZ,4387,38,10047719,Europe,154152,1713
2020-12-10,Azerbaijan,AZ,4403,42,10047719,Europe,158555,1755
2020-12-11,Azerbaijan,AZ,4219,38,10047719,Europe,162774,1793
2020-12-12,Azerbaijan,AZ,4381,47,10047719,Europe,167155,1840
2020-12-13,Azerbaijan,AZ,4268,43,10047719,Europe,171423,1883
2020-12-14,Azerbaijan,AZ,4451,39,10047719,Europe,175874,1922
2020-03-06,Bosnia_and_Herzegovina,BA,2,0,3300998,Europe,2,0
2020-03-12,Bosnia_and_Herzegovina,BA,1,0,3300998,Europe,3,0
2020-03-13,Bosnia_and_Herzegovina,BA,0,0,3300998,Europe,3,0
2020-03-16,Bosnia_and_Herzegovina,BA,15,0,3300998,Europe,18,0
2020-03-17,Bosnia_and_Herzegovina,BA,3,0,3300998,Europe,21,0
2020-03-18,Bosnia_and_Herzegovina,BA,9,0,3300998,Europe,30,0
2020-03-19,Bosnia_and_Herzegovina,BA,5,0,3300998,Europe,35,0
2020-03-20,Bosnia_and_Herzegovina,BA,9,0,3300998,Europe,44,0
2020-03-21,Bosnia_and_Herzegovina,BA,18,0,3300998,Europe,62,0
2020-03-22,Bosnia_and_Herzegovina,BA,30,1,3300998,Europe,92,1
2020-03-23,Bosnia_and_Herzegovina,BA,33,0,3300998,Europe,125,1
2020-03-24,Bosnia_and_Herzegovina,BA,6,0,3300998,Europe,131,1
2020-03-25,Bosnia_and_Herzegovina,BA,33,1,3300998,Europe,164,2
2020-03-26,Bosnia_and_Herzegovina,BA,9,1,3300998,Europe,173,3
2020-03-27,Bosnia_and_Herzegovina,BA,40,0,3300998,Europe,213,3
2020-03-28,Bosnia_and_Herzegovina,BA,20,1,3300998,Europe,233,4
2020-03-29,Bosnia_and_Herzegovina,BA,24,1,3300998,Europe,257,5
2020-03-30,Bosnia_and_Herzegovina,BA,66,1,3300998,Europe,323,6
2020-03-31,Bosnia_and_Herzegovina,BA,30,2,3300998,Europe,353,8
2020-04-01,Bosnia_and_Herzegovina,BA,60,4,3300998,Europe,413,12
2020-04-02,Bosnia_and_Herzegovina,BA,51,1,3300998,Europe,464,13
2020-04-03,Bosnia_and_Herzegovina,BA,68,4,3300998,Europe,532,17
2020-04-04,Bosnia_and_Herzegovina,BA,54,1,3300998,Europe,586,18
2020-04-05,Bosnia_and_Herzegovina,BA,46,3,3300998,Europe,632,21
2020-04-06,Bosnia_and_Herzegovina,BA,31,3,3300998,Europe,663,24
2020-04-07,Bosnia_and_Herzegovina,BA,32,4,3300998,Europe,695,28
2020-04-08,Bosnia_and_Herzegovina,BA,86,4,3300998,Europe,781,32
2020-04-09,Bosnia_and_Herzegovina,BA,35,3,3300998,Europe,816,35
2020-04-10,Bosnia_and_Herzegovina,BA,59,1,3300998,Europe,875,36
2020-04-11,Bosnia_and_Herzegovina,BA,26,1,3300998,Europe,901,37
2020-04-12,Bosnia_and_Herzegovina,BA,47,0,3300998,Europe,948,37
2020-04-13,Bosnia_and_Herzegovina,BA,59,1,3300998,Europe,1007,38
2020-04-14,Bosnia_and_Herzegovina,BA,21,0,3300998,Europe,1028,38
2020-04-15,Bosnia_and_Herzegovina,BA,45,1,3300998,Europe,1073,39
2020-04-16,Bosnia_and_Herzegovina,BA,27,1,3300998,Europe,1100,40
2020-04-17,Bosnia_and_Herzegovina,BA,52,1,3300998,Europe,1152,41
2020-04-18,Bosnia_and_Herzegovina,BA,58,3,3300998,Europe,1210,44
2020-04-19,Bosnia_and_Herzegovina,BA,44,1,3300998,Europe,1254,45
2020-04-20,Bosnia_and_Herzegovina,BA,15,1,3300998,Europe,1269,46
2020-04-21,Bosnia_and_Herzegovina,BA,31,2,3300998,Europe,1300,48
2020-04-22,Bosnia_and_Herzegovina,BA,40,2,3300998,Europe,1340,50
2020-04-23,Bosnia_and_Herzegovina,BA,27,2,3300998,Europe,1367,52
2020-04-24,Bosnia_and_Herzegovina,BA,46,1,3300998,Europe,1413,53
2020-04-25,Bosnia_and_Herzegovina,BA,7,1,3300998,Europe,1420,54
2020-04-26,Bosnia_and_Herzegovina,BA,65,2,3300998,Europe,1485,56
2020-04-27,Bosnia_and_Herzegovina,BA,31,2,3300998,Europe,1516,58
2020-04-28,Bosnia_and_Herzegovina,BA,48,2,3300998,Europe,1564,60
2020-04-29,Bosnia_and_Herzegovina,BA,24,2,3300998,Europe,1588,62
2020-04-30,Bosnia_and_Herzegovina,BA,101,2,3300998,Europe,1689,64
2020-05-01,Bosnia_and_Herzegovina,BA,68,4,3300998,Europe,1757,68
2020-05-02,Bosnia_and_Herzegovina,BA,25,1,3300998,Europe,1782,69
2020-05-03,Bosnia_and_Herzegovina,BA,58,2,3300998,Europe,1840,71
2020-05-04,Bosnia_and_Herzegovina,BA,17,5,3300998,Europe,1857,76
2020-05-05,Bosnia_and_Herzegovina,BA,69,1,3300998,Europe,1926,77
2020-05-06,Bosnia_and_Herzegovina,BA,20,1,3300998,Europe,1946,78
2020-05-07,Bosnia_and_Herzegovina,BA,40,6,3300998,Europe,1986,84
2020-05-08,Bosnia_and_Herzegovina,BA,41,6,3300998,Europe,2027,90
2020-05-09,Bosnia_and_Herzegovina,BA,43,8,3300998,Europe,2070,98
2020-05-10,Bosnia_and_Herzegovina,BA,22,3,3300998,Europe,2092,101
2020-05-11,Bosnia_and_Herzegovina,BA,25,6,3300998,Europe,2117,107
2020-05-12,Bosnia_and_Herzegovina,BA,25,5,3300998,Europe,2142,112
2020-05-13,Bosnia_and_Herzegovina,BA,16,4,3300998,Europe,2158,116
2020-05-14,Bosnia_and_Herzegovina,BA,23,4,3300998,Europe,2181,120
2020-05-15,Bosnia_and_Herzegovina,BA,35,3,3300998,Europe,2216,123
2020-05-16,Bosnia_and_Herzegovina,BA,21,4,3300998,Europe,2237,127
2020-05-17,Bosnia_and_Herzegovina,BA,30,2,3300998,Europe,2267,129
2020-05-18,Bosnia_and_Herzegovina,BA,22,3,3300998,Europe,2289,132
2020-05-19,Bosnia_and_Herzegovina,BA,14,0,3300998,Europe,2303,132
2020-05-20,Bosnia_and_Herzegovina,BA,16,1,3300998,Europe,2319,133
2020-05-21,Bosnia_and_Herzegovina,BA,15,2,3300998,Europe,2334,135
2020-05-22,Bosnia_and_Herzegovina,BA,18,4,3300998,Europe,2352,139
2020-05-23,Bosnia_and_Herzegovina,BA,20,2,3300998,Europe,2372,141
2020-05-24,Bosnia_and_Herzegovina,BA,19,0,3300998,Europe,2391,141
2020-05-25,Bosnia_and_Herzegovina,BA,9,2,3300998,Europe,2400,143
2020-05-26,Bosnia_and_Herzegovina,BA,5,2,3300998,Europe,2405,145
2020-05-27,Bosnia_and_Herzegovina,BA,10,4,3300998,Europe,2415,149
2020-05-28,Bosnia_and_Herzegovina,BA,19,1,3300998,Europe,2434,150
2020-05-29,Bosnia_and_Herzegovina,BA,28,2,3300998,Europe,2462,152
2020-05-30,Bosnia_and_Herzegovina,BA,22,0,3300998,Europe,2484,152
2020-05-31,Bosnia_and_Herzegovina,BA,9,0,3300998,Europe,2493,152
2020-06-01,Bosnia_and_Herzegovina,BA,16,0,3300998,Europe,2509,152
2020-06-02,Bosnia_and_Herzegovina,BA,14,1,3300998,Europe,2523,153
2020-06-03,Bosnia_and_Herzegovina,BA,11,3,3300998,Europe,2534,156
2020-06-04,Bosnia_and_Herzegovina,BA,16,0,3300998,Europe,2550,156
2020-06-05,Bosnia_and_Herzegovina,BA,43,2,3300998,Europe,2593,158
2020-06-06,Bosnia_and_Herzegovina,BA,12,0,3300998,Europe,2605,158
2020-06-07,Bosnia_and_Herzegovina,BA,31,0,3300998,Europe,2636,158
2020-06-08,Bosnia_and_Herzegovina,BA,37,1,3300998,Europe,2673,159
2020-06-09,Bosnia_and_Herzegovina,BA,30,0,3300998,Europe,2703,159
2020-06-10,Bosnia_and_Herzegovina,BA,24,0,3300998,Europe,2727,159
2020-06-11,Bosnia_and_Herzegovina,BA,49,1,3300998,Europe,2776,160
2020-06-12,Bosnia_and_Herzegovina,BA,55,0,3300998,Europe,2831,160
2020-06-13,Bosnia_and_Herzegovina,BA,61,2,3300998,Europe,2892,162
2020-06-14,Bosnia_and_Herzegovina,BA,48,1,3300998,Europe,2940,163
2020-06-15,Bosnia_and_Herzegovina,BA,61,0,3300998,Europe,3001,163
2020-06-16,Bosnia_and_Herzegovina,BA,38,1,3300998,Europe,3039,164
2020-06-17,Bosnia_and_Herzegovina,BA,45,3,3300998,Europe,3084,167
2020-06-18,Bosnia_and_Herzegovina,BA,60,0,3300998,Europe,3144,167
2020-06-19,Bosnia_and_Herzegovina,BA,58,0,3300998,Europe,3202,167
2020-06-20,Bosnia_and_Herzegovina,BA,86,1,3300998,Europe,3288,168
2020-06-21,Bosnia_and_Herzegovina,BA,66,1,3300998,Europe,3354,169
2020-06-22,Bosnia_and_Herzegovina,BA,77,0,3300998,Europe,3431,169
2020-06-23,Bosnia_and_Herzegovina,BA,93,1,3300998,Europe,3524,170
2020-06-24,Bosnia_and_Herzegovina,BA,63,1,3300998,Europe,3587,171
2020-06-25,Bosnia_and_Herzegovina,BA,88,1,3300998,Europe,3675,172
2020-06-26,Bosnia_and_Herzegovina,BA,119,2,3300998,Europe,3794,174
2020-06-27,Bosnia_and_Herzegovina,BA,140,3,3300998,Europe,3934,177
2020-06-28,Bosnia_and_Herzegovina,BA,173,2,3300998,Europe,4107,179
2020-06-29,Bosnia_and_Herzegovina,BA,108,3,3300998,Europe,4215,182
2020-06-30,Bosnia_and_Herzegovina,BA,128,1,3300998,Europe,4343,183
2020-07-01,Bosnia_and_Herzegovina,BA,110,2,3300998,Europe,4453,185
2020-07-02,Bosnia_and_Herzegovina,BA,153,2,3300998,Europe,4606,187
2020-07-03,Bosnia_and_Herzegovina,BA,182,1,3300998,Europe,4788,188
2020-07-04,Bosnia_and_Herzegovina,BA,172,2,3300998,Europe,4960,190
2020-07-05,Bosnia_and_Herzegovina,BA,289,0,3300998,Europe,5249,190
2020-07-06,Bosnia_and_Herzegovina,BA,144,3,3300998,Europe,5393,193
2020-07-07,Bosnia_and_Herzegovina,BA,64,3,3300998,Europe,5457,196
2020-07-08,Bosnia_and_Herzegovina,BA,161,10,3300998,Europe,5618,206
2020-07-09,Bosnia_and_Herzegovina,BA,250,1,3300998,Europe,5868,207
2020-07-10,Bosnia_and_Herzegovina,BA,219,6,3300998,Europe,6087,213
2020-07-11,Bosnia_and_Herzegovina,BA,315,2,3300998,Europe,6402,215
2020-07-12,Bosnia_and_Herzegovina,BA,318,3,3300998,Europe,6720,218
2020-07-13,Bosnia_and_Herzegovina,BA,164,2,3300998,Europe,6884,220
2020-07-14,Bosnia_and_Herzegovina,BA,95,4,3300998,Europe,6979,224
2020-07-15,Bosnia_and_Herzegovina,BA,197,1,3300998,Europe,7176,225
2020-07-16,Bosnia_and_Herzegovina,BA,231,8,3300998,Europe,7407,233
2020-07-17,Bosnia_and_Herzegovina,BA,274,6,3300998,Europe,7681,239
2020-07-18,Bosnia_and_Herzegovina,BA,227,4,3300998,Europe,7908,243
2020-07-19,Bosnia_and_Herzegovina,BA,256,2,3300998,Europe,8164,245
2020-07-20,Bosnia_and_Herzegovina,BA,288,5,3300998,Europe,8452,250
2020-07-21,Bosnia_and_Herzegovina,BA,139,6,3300998,Europe,8591,256
2020-07-22,Bosnia_and_Herzegovina,BA,195,5,3300998,Europe,8786,261
2020-07-23,Bosnia_and_Herzegovina,BA,330,6,3300998,Europe,9116,267
2020-07-24,Bosnia_and_Herzegovina,BA,344,5,3300998,Europe,9460,272
2020-07-25,Bosnia_and_Herzegovina,BA,2,2,3300998,Europe,9462,274
2020-07-26,Bosnia_and_Herzegovina,BA,302,4,3300998,Europe,9764,278
2020-07-27,Bosnia_and_Herzegovina,BA,305,5,3300998,Europe,10069,283
2020-07-28,Bosnia_and_Herzegovina,BA,429,11,3300998,Europe,10498,294
2020-07-29,Bosnia_and_Herzegovina,BA,268,3,3300998,Europe,10766,297
2020-07-30,Bosnia_and_Herzegovina,BA,0,0,3300998,Europe,10766,297
2020-07-31,Bosnia_and_Herzegovina,BA,678,31,3300998,Europe,11444,328
2020-08-01,Bosnia_and_Herzegovina,BA,0,0,3300998,Europe,11444,328
2020-08-02,Bosnia_and_Herzegovina,BA,431,7,3300998,Europe,11875,335
2020-08-03,Bosnia_and_Herzegovina,BA,233,8,3300998,Europe,12108,343
2020-08-04,Bosnia_and_Herzegovina,BA,188,4,3300998,Europe,12296,347
2020-08-05,Bosnia_and_Herzegovina,BA,562,21,3300998,Europe,12858,368
2020-08-06,Bosnia_and_Herzegovina,BA,288,6,3300998,Europe,13146,374
2020-08-07,Bosnia_and_Herzegovina,BA,251,5,3300998,Europe,13397,379
2020-08-08,Bosnia_and_Herzegovina,BA,290,15,3300998,Europe,13687,394
2020-08-09,Bosnia_and_Herzegovina,BA,402,2,3300998,Europe,14089,396
2020-08-10,Bosnia_and_Herzegovina,BA,236,6,3300998,Europe,14325,402
2020-08-11,Bosnia_and_Herzegovina,BA,173,23,3300998,Europe,14498,425
2020-08-12,Bosnia_and_Herzegovina,BA,210,22,3300998,Europe,14708,447
2020-08-13,Bosnia_and_Herzegovina,BA,253,6,3300998,Europe,14961,453
2020-08-14,Bosnia_and_Herzegovina,BA,223,5,3300998,Europe,15184,458
2020-08-15,Bosnia_and_Herzegovina,BA,350,6,3300998,Europe,15534,464
2020-08-16,Bosnia_and_Herzegovina,BA,1,5,3300998,Europe,15535,469
2020-08-17,Bosnia_and_Herzegovina,BA,0,0,3300998,Europe,15535,469
2020-08-18,Bosnia_and_Herzegovina,BA,500,6,3300998,Europe,16035,475
2020-08-19,Bosnia_and_Herzegovina,BA,316,20,3300998,Europe,16351,495
2020-08-20,Bosnia_and_Herzegovina,BA,340,12,3300998,Europe,16691,507
2020-08-21,Bosnia_and_Herzegovina,BA,338,8,3300998,Europe,17029,515
2020-08-22,Bosnia_and_Herzegovina,BA,363,5,3300998,Europe,17392,520
2020-08-23,Bosnia_and_Herzegovina,BA,0,0,3300998,Europe,17392,520
2020-08-24,Bosnia_and_Herzegovina,BA,508,9,3300998,Europe,17900,529
2020-08-25,Bosnia_and_Herzegovina,BA,127,11,3300998,Europe,18027,540
2020-08-26,Bosnia_and_Herzegovina,BA,297,14,3300998,Europe,18324,554
2020-08-27,Bosnia_and_Herzegovina,BA,285,17,3300998,Europe,18609,571
2020-08-28,Bosnia_and_Herzegovina,BA,311,11,3300998,Europe,18920,582
2020-08-29,Bosnia_and_Herzegovina,BA,294,3,3300998,Europe,19214,585
2020-08-30,Bosnia_and_Herzegovina,BA,0,3,3300998,Europe,19214,588
2020-08-31,Bosnia_and_Herzegovina,BA,575,4,3300998,Europe,19789,592
2020-09-01,Bosnia_and_Herzegovina,BA,175,17,3300998,Europe,19964,609
2020-09-02,Bosnia_and_Herzegovina,BA,270,11,3300998,Europe,20234,620
2020-09-03,Bosnia_and_Herzegovina,BA,283,7,3300998,Europe,20517,627
2020-09-04,Bosnia_and_Herzegovina,BA,287,9,3300998,Europe,20804,636
2020-09-05,Bosnia_and_Herzegovina,BA,338,3,3300998,Europe,21142,639
2020-09-06,Bosnia_and_Herzegovina,BA,0,0,3300998,Europe,21142,639
2020-09-07,Bosnia_and_Herzegovina,BA,0,0,3300998,Europe,21142,639
2020-09-08,Bosnia_and_Herzegovina,BA,518,25,3300998,Europe,21660,664
2020-09-09,Bosnia_and_Herzegovina,BA,301,5,3300998,Europe,21961,669
2020-09-10,Bosnia_and_Herzegovina,BA,297,6,3300998,Europe,22258,675
2020-09-11,Bosnia_and_Herzegovina,BA,286,5,3300998,Europe,22544,680
2020-09-12,Bosnia_and_Herzegovina,BA,290,6,3300998,Europe,22834,686
2020-09-13,Bosnia_and_Herzegovina,BA,300,0,3300998,Europe,23134,686
2020-09-14,Bosnia_and_Herzegovina,BA,328,3,3300998,Europe,23462,689
2020-09-15,Bosnia_and_Herzegovina,BA,168,9,3300998,Europe,23630,698
2020-09-16,Bosnia_and_Herzegovina,BA,294,20,3300998,Europe,23924,718
2020-09-17,Bosnia_and_Herzegovina,BA,282,11,3300998,Europe,24206,729
2020-09-18,Bosnia_and_Herzegovina,BA,394,12,3300998,Europe,24600,741
2020-09-19,Bosnia_and_Herzegovina,BA,292,5,3300998,Europe,24892,746
2020-09-20,Bosnia_and_Herzegovina,BA,320,6,3300998,Europe,25212,752
2020-09-21,Bosnia_and_Herzegovina,BA,212,5,3300998,Europe,25424,757
2020-09-22,Bosnia_and_Herzegovina,BA,92,6,3300998,Europe,25516,763
2020-09-23,Bosnia_and_Herzegovina,BA,221,15,3300998,Europe,25737,778
2020-09-24,Bosnia_and_Herzegovina,BA,344,12,3300998,Europe,26081,790
2020-09-25,Bosnia_and_Herzegovina,BA,235,12,3300998,Europe,26316,802
2020-09-26,Bosnia_and_Herzegovina,BA,248,6,3300998,Europe,26564,808
2020-09-27,Bosnia_and_Herzegovina,BA,231,0,3300998,Europe,26795,808
2020-09-28,Bosnia_and_Herzegovina,BA,122,2,3300998,Europe,26917,810
2020-09-29,Bosnia_and_Herzegovina,BA,80,12,3300998,Europe,26997,822
2020-09-30,Bosnia_and_Herzegovina,BA,225,14,3300998,Europe,27222,836
2020-10-01,Bosnia_and_Herzegovina,BA,243,13,3300998,Europe,27465,849
2020-10-02,Bosnia_and_Herzegovina,BA,280,5,3300998,Europe,27745,854
2020-10-03,Bosnia_and_Herzegovina,BA,0,0,3300998,Europe,27745,854
2020-10-04,Bosnia_and_Herzegovina,BA,226,10,3300998,Europe,27971,864
2020-10-05,Bosnia_and_Herzegovina,BA,4,7,3300998,Europe,27975,871
2020-10-06,Bosnia_and_Herzegovina,BA,474,17,3300998,Europe,28449,888
2020-10-07,Bosnia_and_Herzegovina,BA,261,15,3300998,Europe,28710,903
2020-10-08,Bosnia_and_Herzegovina,BA,365,5,3300998,Europe,29075,908
2020-10-09,Bosnia_and_Herzegovina,BA,453,5,3300998,Europe,29528,913
2020-10-10,Bosnia_and_Herzegovina,BA,387,6,3300998,Europe,29915,919
2020-10-11,Bosnia_and_Herzegovina,BA,428,1,3300998,Europe,30343,920
2020-10-12,Bosnia_and_Herzegovina,BA,302,1,3300998,Europe,30645,921
2020-10-13,Bosnia_and_Herzegovina,BA,189,9,3300998,Europe,30834,930
2020-10-14,Bosnia_and_Herzegovina,BA,339,13,3300998,Europe,31173,943
2020-10-15,Bosnia_and_Herzegovina,BA,479,12,3300998,Europe,31652,955
2020-10-16,Bosnia_and_Herzegovina,BA,578,15,3300998,Europe,32230,970
2020-10-17,Bosnia_and_Herzegovina,BA,618,8,3300998,Europe,32848,978
2020-10-18,Bosnia_and_Herzegovina,BA,713,2,3300998,Europe,33561,980
2020-10-19,Bosnia_and_Herzegovina,BA,559,4,3300998,Europe,34120,984
2020-10-20,Bosnia_and_Herzegovina,BA,545,13,3300998,Europe,34665,997
2020-10-21,Bosnia_and_Herzegovina,BA,726,20,3300998,Europe,35391,1017
2020-10-22,Bosnia_and_Herzegovina,BA,928,14,3300998,Europe,36319,1031
2020-10-23,Bosnia_and_Herzegovina,BA,1003,20,3300998,Europe,37322,1051
2020-10-24,Bosnia_and_Herzegovina,BA,1178,14,3300998,Europe,38500,1065
2020-10-25,Bosnia_and_Herzegovina,BA,1258,6,3300998,Europe,39758,1071
2020-10-26,Bosnia_and_Herzegovina,BA,1136,15,3300998,Europe,40894,1086
2020-10-27,Bosnia_and_Herzegovina,BA,722,18,3300998,Europe,41616,1104
2020-10-28,Bosnia_and_Herzegovina,BA,1558,21,3300998,Europe,43174,1125
2020-10-29,Bosnia_and_Herzegovina,BA,1584,36,3300998,Europe,44758,1161
2020-10-30,Bosnia_and_Herzegovina,BA,1910,21,3300998,Europe,46668,1182
2020-10-31,Bosnia_and_Herzegovina,BA,1485,30,3300998,Europe,48153,1212
2020-11-01,Bosnia_and_Herzegovina,BA,1937,22,3300998,Europe,50090,1234
2020-11-02,Bosnia_and_Herzegovina,BA,1415,14,3300998,Europe,51505,1248
2020-11-03,Bosnia_and_Herzegovina,BA,764,32,3300998,Europe,52269,1280
2020-11-04,Bosnia_and_Herzegovina,BA,1553,37,3300998,Europe,53822,1317
2020-11-05,Bosnia_and_Herzegovina,BA,1776,41,3300998,Europe,55598,1358
2020-11-06,Bosnia_and_Herzegovina,BA,1908,44,3300998,Europe,57506,1402
2020-11-07,Bosnia_and_Herzegovina,BA,1921,55,3300998,Europe,59427,1457
2020-11-08,Bosnia_and_Herzegovina,BA,1785,33,3300998,Europe,61212,1490
2020-11-09,Bosnia_and_Herzegovina,BA,1211,20,3300998,Europe,62423,1510
2020-11-10,Bosnia_and_Herzegovina,BA,996,73,3300998,Europe,63419,1583
2020-11-11,Bosnia_and_Herzegovina,BA,1605,46,3300998,Europe,65024,1629
2020-11-12,Bosnia_and_Herzegovina,BA,1541,72,3300998,Europe,66565,1701
2020-11-13,Bosnia_and_Herzegovina,BA,1728,49,3300998,Europe,68293,1750
2020-11-14,Bosnia_and_Herzegovina,BA,1332,58,3300998,Europe,69625,1808
2020-11-15,Bosnia_and_Herzegovina,BA,1275,49,3300998,Europe,70900,1857
2020-11-16,Bosnia_and_Herzegovina,BA,0,0,3300998,Europe,70900,1857
2020-11-17,Bosnia_and_Herzegovina,BA,1789,116,3300998,Europe,72689,1973
2020-11-18,Bosnia_and_Herzegovina,BA,1255,69,3300998,Europe,73944,2042
2020-11-19,Bosnia_and_Herzegovina,BA,1633,47,3300998,Europe,75577,2089
2020-11-20,Bosnia_and_Herzegovina,BA,1180,64,3300998,Europe,76757,2153
2020-11-21,Bosnia_and_Herzegovina,BA,1237,56,3300998,Europe,77994,2209
2020-11-22,Bosnia_and_Herzegovina,BA,1315,40,3300998,Europe,79309,2249
2020-11-23,Bosnia_and_Herzegovina,BA,698,27,3300998,Europe,80007,2276
2020-11-24,Bosnia_and_Herzegovina,BA,546,66,3300998,Europe,80553,2342
2020-11-25,Bosnia_and_Herzegovina,BA,1186,52,3300998,Europe,81739,2394
2020-11-26,Bosnia_and_Herzegovina,BA,1589,35,3300998,Europe,83328,2429
2020-11-27,Bosnia_and_Herzegovina,BA,924,51,3300998,Europe,84252,2480
2020-11-28,Bosnia_and_Herzegovina,BA,1179,62,3300998,Europe,85431,2542
2020-11-29,Bosnia_and_Herzegovina,BA,0,0,3300998,Europe,85431,2542
2020-11-30,Bosnia_and_Herzegovina,BA,1943,78,3300998,Europe,87374,2620
2020-12-01,Bosnia_and_Herzegovina,BA,527,61,3300998,Europe,87901,2681
2020-12-02,Bosnia_and_Herzegovina,BA,1184,46,3300998,Europe,89085,2727
2020-12-03,Bosnia_and_Herzegovina,BA,1293,46,3300998,Europe,90378,2773
2020-12-04,Bosnia_and_Herzegovina,BA,1161,39,3300998,Europe,91539,2812
2020-12-05,Bosnia_and_Herzegovina,BA,1254,53,3300998,Europe,92793,2865
2020-12-06,Bosnia_and_Herzegovina,BA,975,57,3300998,Europe,93768,2922
2020-12-07,Bosnia_and_Herzegovina,BA,739,30,3300998,Europe,94507,2952
2020-12-08,Bosnia_and_Herzegovina,BA,437,60,3300998,Europe,94944,3012
2020-12-09,Bosnia_and_Herzegovina,BA,1077,69,3300998,Europe,96021,3081
2020-12-10,Bosnia_and_Herzegovina,BA,1296,70,3300998,Europe,97317,3151
2020-12-11,Bosnia_and_Herzegovina,BA,1286,48,3300998,Europe,98603,3199
2020-12-12,Bosnia_and_Herzegovina,BA,940,51,3300998,Europe,99543,3250
2020-12-13,Bosnia_and_Herzegovina,BA,763,48,3300998,Europe,100306,3298
2020-12-14,Bosnia_and_Herzegovina,BA,811,38,3300998,Europe,101117,3336
2020-03-18,Barbados,BB,1,0,287021,America,1,0
2020-03-19,Barbados,BB,0,0,287021,America,1,0
2020-03-20,Barbados,BB,1,0,287021,America,2,0
2020-03-21,Barbados,BB,4,0,287021,America,6,0
2020-03-22,Barbados,BB,8,0,287021,America,14,0
2020-03-23,Barbados,BB,3,0,287021,America,17,0
2020-03-24,Barbados,BB,0,0,287021,America,17,0
2020-03-25,Barbados,BB,1,0,287021,America,18,0
2020-03-26,Barbados,BB,0,0,287021,America,18,0
2020-03-27,Barbados,BB,6,0,287021,America,24,0
2020-03-28,Barbados,BB,0,0,287021,America,24,0
2020-03-29,Barbados,BB,2,0,287021,America,26,0
2020-03-30,Barbados,BB,7,0,287021,America,33,0
2020-03-31,Barbados,BB,1,0,287021,America,34,0
2020-04-01,Barbados,BB,0,0,287021,America,34,0
2020-04-02,Barbados,BB,11,0,287021,America,45,0
2020-04-03,Barbados,BB,0,0,287021,America,45,0
2020-04-04,Barbados,BB,0,0,287021,America,45,0
2020-04-05,Barbados,BB,6,0,287021,America,51,0
2020-04-06,Barbados,BB,5,1,287021,America,56,1
2020-04-07,Barbados,BB,4,1,287021,America,60,2
2020-04-08,Barbados,BB,3,1,287021,America,63,3
2020-04-09,Barbados,BB,0,0,287021,America,63,3
2020-04-10,Barbados,BB,3,0,287021,America,66,3
2020-04-11,Barbados,BB,1,1,287021,America,67,4
2020-04-12,Barbados,BB,1,0,287021,America,68,4
2020-04-13,Barbados,BB,3,0,287021,America,71,4
2020-04-14,Barbados,BB,1,0,287021,America,72,4
2020-04-15,Barbados,BB,1,1,287021,America,73,5
2020-04-16,Barbados,BB,2,0,287021,America,75,5
2020-04-17,Barbados,BB,0,0,287021,America,75,5
2020-04-18,Barbados,BB,0,0,287021,America,75,5
2020-04-19,Barbados,BB,0,0,287021,America,75,5
2020-04-20,Barbados,BB,0,0,287021,America,75,5
2020-04-21,Barbados,BB,0,0,287021,America,75,5
2020-04-22,Barbados,BB,0,0,287021,America,75,5
2020-04-23,Barbados,BB,1,1,287021,America,76,6
2020-04-24,Barbados,BB,0,0,287021,America,76,6
2020-04-25,Barbados,BB,0,0,287021,America,76,6
2020-04-26,Barbados,BB,3,0,287021,America,79,6
2020-04-27,Barbados,BB,0,0,287021,America,79,6
2020-04-28,Barbados,BB,1,0,287021,America,80,6
2020-04-29,Barbados,BB,0,0,287021,America,80,6
2020-04-30,Barbados,BB,0,1,287021,America,80,7
2020-05-01,Barbados,BB,1,0,287021,America,81,7
2020-05-02,Barbados,BB,0,0,287021,America,81,7
2020-05-03,Barbados,BB,0,0,287021,America,81,7
2020-05-04,Barbados,BB,1,0,287021,America,82,7
2020-05-05,Barbados,BB,0,0,287021,America,82,7
2020-05-06,Barbados,BB,0,0,287021,America,82,7
2020-05-07,Barbados,BB,0,0,287021,America,82,7
2020-05-08,Barbados,BB,0,0,287021,America,82,7
2020-05-09,Barbados,BB,1,0,287021,America,83,7
2020-05-10,Barbados,BB,1,0,287021,America,84,7
2020-05-11,Barbados,BB,0,0,287021,America,84,7
2020-05-12,Barbados,BB,0,0,287021,America,84,7
2020-05-13,Barbados,BB,1,0,287021,America,85,7
2020-05-14,Barbados,BB,0,0,287021,America,85,7
2020-05-15,Barbados,BB,0,0,287021,America,85,7
2020-05-16,Barbados,BB,0,0,287021,America,85,7
2020-05-17,Barbados,BB,1,0,287021,America,86,7
2020-05-18,Barbados,BB,2,0,287021,America,88,7
2020-05-19,Barbados,BB,0,0,287021,America,88,7
2020-05-20,Barbados,BB,2,0,287021,America,90,7
2020-05-21,Barbados,BB,0,0,287021,America,90,7
2020-05-22,Barbados,BB,0,0,287021,America,90,7
2020-05-23,Barbados,BB,0,0,287021,America,90,7
2020-05-24,Barbados,BB,2,0,287021,America,92,7
2020-05-25,Barbados,BB,0,0,287021,America,92,7
2020-05-26,Barbados,BB,0,0,287021,America,92,7
2020-05-27,Barbados,BB,0,0,287021,America,92,7
2020-05-28,Barbados,BB,0,0,287021,America,92,7
2020-05-29,Barbados,BB,0,0,287021,America,92,7
2020-05-30,Barbados,BB,0,0,287021,America,92,7
2020-05-31,Barbados,BB,0,0,287021,America,92,7
2020-06-01,Barbados,BB,0,0,287021,America,92,7
2020-06-02,Barbados,BB,0,0,287021,America,92,7
2020-06-03,Barbados,BB,0,0,287021,America,92,7
2020-06-04,Barbados,BB,0,0,287021,America,92,7
2020-06-05,Barbados,BB,0,0,287021,America,92,7
2020-06-06,Barbados,BB,0,0,287021,America,92,7
2020-06-07,Barbados,BB,0,0,287021,America,92,7
2020-06-08,Barbados,BB,0,0,287021,America,92,7
2020-06-09,Barbados,BB,0,0,287021,America,92,7
2020-06-10,Barbados,BB,0,0,287021,America,92,7
2020-06-11,Barbados,BB,4,0,287021,America,96,7
2020-06-12,Barbados,BB,0,0,287021,America,96,7
2020-06-13,Barbados,BB,0,0,287021,America,96,7
2020-06-14,Barbados,BB,0,0,287021,America,96,7
2020-06-15,Barbados,BB,0,0,287021,America,96,7
2020-06-16,Barbados,BB,1,0,287021,America,97,7
2020-06-17,Barbados,BB,0,0,287021,America,97,7
2020-06-18,Barbados,BB,0,0,287021,America,97,7
2020-06-19,Barbados,BB,0,0,287021,America,97,7
2020-06-20,Barbados,BB,0,0,287021,America,97,7
2020-06-21,Barbados,BB,0,0,287021,America,97,7
2020-06-22,Barbados,BB,0,0,287021,America,97,7
2020-06-23,Barbados,BB,0,0,287021,America,97,7
2020-06-24,Barbados,BB,0,0,287021,America,97,7
2020-06-25,Barbados,BB,0,0,287021,America,97,7
2020-06-26,Barbados,BB,0,0,287021,America,97,7
2020-06-27,Barbados,BB,0,0,287021,America,97,7
2020-06-28,Barbados,BB,0,0,287021,America,97,7
2020-06-29,Barbados,BB,0,0,287021,America,97,7
2020-06-30,Barbados,BB,0,0,287021,America,97,7
2020-07-01,Barbados,BB,0,0,287021,America,97,7
2020-07-02,Barbados,BB,0,0,287021,America,97,7
2020-07-03,Barbados,BB,0,0,287021,America,97,7
2020-07-04,Barbados,BB,0,0,287021,America,97,7
2020-07-05,Barbados,BB,0,0,287021,America,97,7
2020-07-06,Barbados,BB,1,0,287021,America,98,7
2020-07-07,Barbados,BB,0,0,287021,America,98,7
2020-07-08,Barbados,BB,0,0,287021,America,98,7
2020-07-09,Barbados,BB,0,0,287021,America,98,7
2020-07-10,Barbados,BB,0,0,287021,America,98,7
2020-07-11,Barbados,BB,0,0,287021,America,98,7
2020-07-12,Barbados,BB,5,0,287021,America,103,7
2020-07-13,Barbados,BB,0,0,287021,America,103,7
2020-07-14,Barbados,BB,0,0,287021,America,103,7
2020-07-15,Barbados,BB,0,0,287021,America,103,7
2020-07-16,Barbados,BB,1,0,287021,America,104,7
2020-07-17,Barbados,BB,0,0,287021,America,104,7
2020-07-18,Barbados,BB,0,0,287021,America,104,7
2020-07-19,Barbados,BB,0,0,287021,America,104,7
2020-07-20,Barbados,BB,1,0,287021,America,105,7
2020-07-21,Barbados,BB,1,0,287021,America,106,7
2020-07-22,Barbados,BB,0,0,287021,America,106,7
2020-07-23,Barbados,BB,0,0,287021,America,106,7
2020-07-24,Barbados,BB,0,0,287021,America,106,7
2020-07-25,Barbados,BB,2,0,287021,America,108,7
2020-07-26,Barbados,BB,0,0,287021,America,108,7
2020-07-27,Barbados,BB,2,0,287021,America,110,7
2020-07-28,Barbados,BB,0,0,287021,America,110,7
2020-07-29,Barbados,BB,0,0,287021,America,110,7
2020-07-30,Barbados,BB,0,0,287021,America,110,7
2020-07-31,Barbados,BB,0,0,287021,America,110,7
2020-08-01,Barbados,BB,0,0,287021,America,110,7
2020-08-02,Barbados,BB,12,0,287021,America,122,7
2020-08-03,Barbados,BB,10,0,287021,America,132,7
2020-08-04,Barbados,BB,0,0,287021,America,132,7
2020-08-05,Barbados,BB,0,0,287021,America,132,7
2020-08-06,Barbados,BB,1,0,287021,America,133,7
2020-08-07,Barbados,BB,0,0,287021,America,133,7
2020-08-08,Barbados,BB,5,0,287021,America,138,7
2020-08-09,Barbados,BB,0,0,287021,America,138,7
2020-08-10,Barbados,BB,4,0,287021,America,142,7
2020-08-11,Barbados,BB,1,0,287021,America,143,7
2020-08-12,Barbados,BB,0,0,287021,America,143,7
2020-08-13,Barbados,BB,0,0,287021,America,143,7
2020-08-14,Barbados,BB,1,0,287021,America,144,7
2020-08-15,Barbados,BB,4,0,287021,America,148,7
2020-08-16,Barbados,BB,2,0,287021,America,150,7
2020-08-17,Barbados,BB,1,0,287021,America,151,7
2020-08-18,Barbados,BB,1,0,287021,America,152,7
2020-08-19,Barbados,BB,1,0,287021,America,153,7
2020-08-20,Barbados,BB,2,0,287021,America,155,7
2020-08-21,Barbados,BB,1,0,287021,America,156,7
2020-08-22,Barbados,BB,1,0,287021,America,157,7
2020-08-23,Barbados,BB,1,0,287021,America,158,7
2020-08-24,Barbados,BB,3,0,287021,America,161,7
2020-08-25,Barbados,BB,0,0,287021,America,161,7
2020-08-26,Barbados,BB,3,0,287021,America,164,7
2020-08-27,Barbados,BB,1,0,287021,America,165,7
2020-08-28,Barbados,BB,0,0,287021,America,165,7
2020-08-29,Barbados,BB,1,0,287021,America,166,7
2020-08-30,Barbados,BB,4,0,287021,America,170,7
2020-08-31,Barbados,BB,3,0,287021,America,173,7
2020-09-01,Barbados,BB,1,0,287021,America,174,7
2020-09-02,Barbados,BB,2,0,287021,America,176,7
2020-09-03,Barbados,BB,0,0,287021,America,176,7
2020-09-04,Barbados,BB,1,0,287021,America,177,7
2020-09-05,Barbados,BB,1,0,287021,America,178,7
2020-09-06,Barbados,BB,0,0,287021,America,178,7
2020-09-07,Barbados,BB,1,0,287021,America,179,7
2020-09-08,Barbados,BB,0,0,287021,America,179,7
2020-09-09,Barbados,BB,1,0,287021,America,180,7
2020-09-10,Barbados,BB,0,0,287021,America,180,7
2020-09-11,Barbados,BB,0,0,287021,America,180,7
2020-09-12,Barbados,BB,0,0,287021,America,180,7
2020-09-13,Barbados,BB,0,0,287021,America,180,7
2020-09-14,Barbados,BB,1,0,287021,America,181,7
2020-09-15,Barbados,BB,2,0,287021,America,183,7
2020-09-16,Barbados,BB,1,0,287021,America,184,7
2020-09-17,Barbados,BB,1,0,287021,America,185,7
2020-09-18,Barbados,BB,0,0,287021,America,185,7
2020-09-19,Barbados,BB,0,0,287021,America,185,7
2020-09-20,Barbados,BB,0,0,287021,America,185,7
2020-09-21,Barbados,BB,4,0,287021,America,189,7
2020-09-22,Barbados,BB,0,0,287021,America,189,7
2020-09-23,Barbados,BB,0,0,287021,America,189,7
2020-09-24,Barbados,BB,0,0,287021,America,189,7
2020-09-25,Barbados,BB,0,0,287021,America,189,7
2020-09-26,Barbados,BB,1,0,287021,America,190,7
2020-09-27,Barbados,BB,0,0,287021,America,190,7
2020-09-28,Barbados,BB,0,0,287021,America,190,7
2020-09-29,Barbados,BB,0,0,287021,America,190,7
2020-09-30,Barbados,BB,0,0,287021,America,190,7
2020-10-01,Barbados,BB,0,0,287021,America,190,7
2020-10-02,Barbados,BB,3,0,287021,America,193,7
2020-10-03,Barbados,BB,0,0,287021,America,193,7
2020-10-04,Barbados,BB,3,0,287021,America,196,7
2020-10-05,Barbados,BB,3,0,287021,America,199,7
2020-10-06,Barbados,BB,1,0,287021,America,200,7
2020-10-07,Barbados,BB,0,0,287021,America,200,7
2020-10-08,Barbados,BB,3,0,287021,America,203,7
2020-10-09,Barbados,BB,0,0,287021,America,203,7
2020-10-10,Barbados,BB,1,0,287021,America,204,7
2020-10-11,Barbados,BB,2,0,287021,America,206,7
2020-10-12,Barbados,BB,2,0,287021,America,208,7
2020-10-13,Barbados,BB,0,0,287021,America,208,7
2020-10-14,Barbados,BB,2,0,287021,America,210,7
2020-10-15,Barbados,BB,5,0,287021,America,215,7
2020-10-16,Barbados,BB,3,0,287021,America,218,7
2020-10-17,Barbados,BB,1,0,287021,America,219,7
2020-10-18,Barbados,BB,0,0,287021,America,219,7
2020-10-19,Barbados,BB,3,0,287021,America,222,7
2020-10-20,Barbados,BB,0,0,287021,America,222,7
2020-10-21,Barbados,BB,0,0,287021,America,222,7
2020-10-22,Barbados,BB,0,0,287021,America,222,7
2020-10-23,Barbados,BB,2,0,287021,America,224,7
2020-10-24,Barbados,BB,3,0,287021,America,227,7
2020-10-25,Barbados,BB,0,0,287021,America,227,7
2020-10-26,Barbados,BB,0,0,287021,America,227,7
2020-10-27,Barbados,BB,6,0,287021,America,233,7
2020-10-28,Barbados,BB,0,0,287021,America,233,7
2020-10-29,Barbados,BB,1,0,287021,America,234,7
2020-10-30,Barbados,BB,0,0,287021,America,234,7
2020-10-31,Barbados,BB,2,0,287021,America,236,7
2020-11-01,Barbados,BB,1,0,287021,America,237,7
2020-11-02,Barbados,BB,0,0,287021,America,237,7
2020-11-03,Barbados,BB,1,0,287021,America,238,7
2020-11-04,Barbados,BB,0,0,287021,America,238,7
2020-11-05,Barbados,BB,1,0,287021,America,239,7
2020-11-06,Barbados,BB,0,0,287021,America,239,7
2020-11-07,Barbados,BB,3,0,287021,America,242,7
2020-11-08,Barbados,BB,0,0,287021,America,242,7
2020-11-09,Barbados,BB,0,0,287021,America,242,7
2020-11-10,Barbados,BB,1,0,287021,America,243,7
2020-11-11,Barbados,BB,0,0,287021,America,243,7
2020-11-12,Barbados,BB,6,0,287021,America,249,7
2020-11-13,Barbados,BB,0,0,287021,America,249,7
2020-11-14,Barbados,BB,0,0,287021,America,249,7
2020-11-15,Barbados,BB,0,0,287021,America,249,7
2020-11-16,Barbados,BB,1,0,287021,America,250,7
2020-11-17,Barbados,BB,0,0,287021,America,250,7
2020-11-18,Barbados,BB,0,0,287021,America,250,7
2020-11-19,Barbados,BB,2,0,287021,America,252,7
2020-11-20,Barbados,BB,1,0,287021,America,253,7
2020-11-21,Barbados,BB,0,0,287021,America,253,7
2020-11-22,Barbados,BB,2,0,287021,America,255,7
2020-11-23,Barbados,BB,4,0,287021,America,259,7
2020-11-24,Barbados,BB,1,0,287021,America,260,7
2020-11-25,Barbados,BB,2,0,287021,America,262,7
2020-11-26,Barbados,BB,1,0,287021,America,263,7
2020-11-27,Barbados,BB,3,0,287021,America,266,7
2020-11-28,Barbados,BB,4,0,287021,America,270,7
2020-11-29,Barbados,BB,0,0,287021,America,270,7
2020-11-30,Barbados,BB,5,0,287021,America,275,7
2020-12-01,Barbados,BB,1,0,287021,America,276,7
2020-12-02,Barbados,BB,2,0,287021,America,278,7
2020-12-03,Barbados,BB,1,0,287021,America,279,7
2020-12-04,Barbados,BB,2,0,287021,America,281,7
2020-12-05,Barbados,BB,3,0,287021,America,284,7
2020-12-06,Barbados,BB,1,0,287021,America,285,7
2020-12-07,Barbados,BB,2,0,287021,America,287,7
2020-12-08,Barbados,BB,2,0,287021,America,289,7
2020-12-09,Barbados,BB,1,0,287021,America,290,7
2020-12-10,Barbados,BB,0,0,287021,America,290,7
2020-12-11,Barbados,BB,1,0,287021,America,291,7
2020-12-12,Barbados,BB,1,0,287021,America,292,7
2020-12-13,Barbados,BB,0,0,287021,America,292,7
2020-12-14,Barbados,BB,0,0,287021,America,292,7
2020-03-09,Bangladesh,BD,3,0,163046173,Asia,3,0
2020-03-15,Bangladesh,BD,0,0,163046173,Asia,3,0
2020-03-17,Bangladesh,BD,2,0,163046173,Asia,5,0
2020-03-18,Bangladesh,BD,3,0,163046173,Asia,8,0
2020-03-19,Bangladesh,BD,2,0,163046173,Asia,10,0
2020-03-20,Bangladesh,BD,0,0,163046173,Asia,10,0
2020-03-21,Bangladesh,BD,7,0,163046173,Asia,17,0
2020-03-22,Bangladesh,BD,7,2,163046173,Asia,24,2
2020-03-23,Bangladesh,BD,3,1,163046173,Asia,27,3
2020-03-24,Bangladesh,BD,6,0,163046173,Asia,33,3
2020-03-25,Bangladesh,BD,6,1,163046173,Asia,39,4
2020-03-26,Bangladesh,BD,0,1,163046173,Asia,39,5
2020-03-27,Bangladesh,BD,9,0,163046173,Asia,48,5
2020-03-28,Bangladesh,BD,0,0,163046173,Asia,48,5
2020-03-29,Bangladesh,BD,0,0,163046173,Asia,48,5
2020-03-30,Bangladesh,BD,1,0,163046173,Asia,49,5
2020-03-31,Bangladesh,BD,0,0,163046173,Asia,49,5
2020-04-01,Bangladesh,BD,2,0,163046173,Asia,51,5
2020-04-02,Bangladesh,BD,3,1,163046173,Asia,54,6
2020-04-03,Bangladesh,BD,2,0,163046173,Asia,56,6
2020-04-04,Bangladesh,BD,5,0,163046173,Asia,61,6
2020-04-05,Bangladesh,BD,9,2,163046173,Asia,70,8
2020-04-06,Bangladesh,BD,18,1,163046173,Asia,88,9
2020-04-07,Bangladesh,BD,35,3,163046173,Asia,123,12
2020-04-08,Bangladesh,BD,41,5,163046173,Asia,164,17
2020-04-09,Bangladesh,BD,54,3,163046173,Asia,218,20
2020-04-10,Bangladesh,BD,112,1,163046173,Asia,330,21
2020-04-11,Bangladesh,BD,94,6,163046173,Asia,424,27
2020-04-12,Bangladesh,BD,58,3,163046173,Asia,482,30
2020-04-13,Bangladesh,BD,139,4,163046173,Asia,621,34
2020-04-14,Bangladesh,BD,182,5,163046173,Asia,803,39
2020-04-15,Bangladesh,BD,209,7,163046173,Asia,1012,46
2020-04-16,Bangladesh,BD,219,4,163046173,Asia,1231,50
2020-04-17,Bangladesh,BD,341,10,163046173,Asia,1572,60
2020-04-18,Bangladesh,BD,266,15,163046173,Asia,1838,75
2020-04-19,Bangladesh,BD,306,9,163046173,Asia,2144,84
2020-04-20,Bangladesh,BD,312,7,163046173,Asia,2456,91
2020-04-21,Bangladesh,BD,492,10,163046173,Asia,2948,101
2020-04-22,Bangladesh,BD,434,9,163046173,Asia,3382,110
2020-04-23,Bangladesh,BD,390,10,163046173,Asia,3772,120
2020-04-24,Bangladesh,BD,414,7,163046173,Asia,4186,127
2020-04-25,Bangladesh,BD,503,4,163046173,Asia,4689,131
2020-04-26,Bangladesh,BD,309,9,163046173,Asia,4998,140
2020-04-27,Bangladesh,BD,418,5,163046173,Asia,5416,145
2020-04-28,Bangladesh,BD,497,7,163046173,Asia,5913,152
2020-04-29,Bangladesh,BD,549,3,163046173,Asia,6462,155
2020-04-30,Bangladesh,BD,641,8,163046173,Asia,7103,163
2020-05-01,Bangladesh,BD,564,5,163046173,Asia,7667,168
2020-05-02,Bangladesh,BD,571,2,163046173,Asia,8238,170
2020-05-03,Bangladesh,BD,552,5,163046173,Asia,8790,175
2020-05-04,Bangladesh,BD,665,2,163046173,Asia,9455,177
2020-05-05,Bangladesh,BD,688,5,163046173,Asia,10143,182
2020-05-06,Bangladesh,BD,786,1,163046173,Asia,10929,183
2020-05-07,Bangladesh,BD,790,3,163046173,Asia,11719,186
2020-05-08,Bangladesh,BD,706,13,163046173,Asia,12425,199
2020-05-09,Bangladesh,BD,709,7,163046173,Asia,13134,206
2020-05-10,Bangladesh,BD,636,8,163046173,Asia,13770,214
2020-05-11,Bangladesh,BD,887,14,163046173,Asia,14657,228
2020-05-12,Bangladesh,BD,1034,11,163046173,Asia,15691,239
2020-05-13,Bangladesh,BD,969,11,163046173,Asia,16660,250
2020-05-14,Bangladesh,BD,1162,19,163046173,Asia,17822,269
2020-05-15,Bangladesh,BD,1041,14,163046173,Asia,18863,283
2020-05-16,Bangladesh,BD,1202,15,163046173,Asia,20065,298
2020-05-17,Bangladesh,BD,930,16,163046173,Asia,20995,314
2020-05-18,Bangladesh,BD,1273,14,163046173,Asia,22268,328
2020-05-19,Bangladesh,BD,1602,21,163046173,Asia,23870,349
2020-05-20,Bangladesh,BD,1251,21,163046173,Asia,25121,370
2020-05-21,Bangladesh,BD,1617,16,163046173,Asia,26738,386
2020-05-22,Bangladesh,BD,1773,22,163046173,Asia,28511,408
2020-05-23,Bangladesh,BD,1694,24,163046173,Asia,30205,432
2020-05-24,Bangladesh,BD,1873,20,163046173,Asia,32078,452
2020-05-25,Bangladesh,BD,1532,28,163046173,Asia,33610,480
2020-05-26,Bangladesh,BD,1975,21,163046173,Asia,35585,501
2020-05-27,Bangladesh,BD,1166,21,163046173,Asia,36751,522
2020-05-28,Bangladesh,BD,1541,22,163046173,Asia,38292,544
2020-05-29,Bangladesh,BD,2029,15,163046173,Asia,40321,559
2020-05-30,Bangladesh,BD,2523,23,163046173,Asia,42844,582
2020-05-31,Bangladesh,BD,1764,28,163046173,Asia,44608,610
2020-06-01,Bangladesh,BD,2545,40,163046173,Asia,47153,650
2020-06-02,Bangladesh,BD,2381,22,163046173,Asia,49534,672
2020-06-03,Bangladesh,BD,2911,37,163046173,Asia,52445,709
2020-06-04,Bangladesh,BD,2695,37,163046173,Asia,55140,746
2020-06-05,Bangladesh,BD,2423,35,163046173,Asia,57563,781
2020-06-06,Bangladesh,BD,2828,30,163046173,Asia,60391,811
2020-06-07,Bangladesh,BD,2635,35,163046173,Asia,63026,846
2020-06-08,Bangladesh,BD,2743,42,163046173,Asia,65769,888
2020-06-09,Bangladesh,BD,2735,42,163046173,Asia,68504,930
2020-06-10,Bangladesh,BD,3171,45,163046173,Asia,71675,975
2020-06-11,Bangladesh,BD,3190,37,163046173,Asia,74865,1012
2020-06-12,Bangladesh,BD,3187,37,163046173,Asia,78052,1049
2020-06-13,Bangladesh,BD,3471,46,163046173,Asia,81523,1095
2020-06-14,Bangladesh,BD,2856,44,163046173,Asia,84379,1139
2020-06-15,Bangladesh,BD,3141,32,163046173,Asia,87520,1171
2020-06-16,Bangladesh,BD,3099,38,163046173,Asia,90619,1209
2020-06-17,Bangladesh,BD,3862,53,163046173,Asia,94481,1262
2020-06-18,Bangladesh,BD,4008,43,163046173,Asia,98489,1305
2020-06-19,Bangladesh,BD,3803,38,163046173,Asia,102292,1343
2020-06-20,Bangladesh,BD,3243,45,163046173,Asia,105535,1388
2020-06-21,Bangladesh,BD,3240,37,163046173,Asia,108775,1425
2020-06-22,Bangladesh,BD,3531,39,163046173,Asia,112306,1464
2020-06-23,Bangladesh,BD,3480,38,163046173,Asia,115786,1502
2020-06-24,Bangladesh,BD,3412,43,163046173,Asia,119198,1545
2020-06-25,Bangladesh,BD,3462,37,163046173,Asia,122660,1582
2020-06-26,Bangladesh,BD,3946,39,163046173,Asia,126606,1621
2020-06-27,Bangladesh,BD,3868,40,163046173,Asia,130474,1661
2020-06-28,Bangladesh,BD,3504,34,163046173,Asia,133978,1695
2020-06-29,Bangladesh,BD,3809,43,163046173,Asia,137787,1738
2020-06-30,Bangladesh,BD,4014,45,163046173,Asia,141801,1783
2020-07-01,Bangladesh,BD,3682,64,163046173,Asia,145483,1847
2020-07-02,Bangladesh,BD,3775,41,163046173,Asia,149258,1888
2020-07-03,Bangladesh,BD,4019,38,163046173,Asia,153277,1926
2020-07-04,Bangladesh,BD,3114,42,163046173,Asia,156391,1968
2020-07-05,Bangladesh,BD,3288,29,163046173,Asia,159679,1997
2020-07-06,Bangladesh,BD,2738,55,163046173,Asia,162417,2052
2020-07-07,Bangladesh,BD,3201,44,163046173,Asia,165618,2096
2020-07-08,Bangladesh,BD,3027,55,163046173,Asia,168645,2151
2020-07-09,Bangladesh,BD,3489,46,163046173,Asia,172134,2197
2020-07-10,Bangladesh,BD,3360,41,163046173,Asia,175494,2238
2020-07-11,Bangladesh,BD,2949,37,163046173,Asia,178443,2275
2020-07-12,Bangladesh,BD,2686,30,163046173,Asia,181129,2305
2020-07-13,Bangladesh,BD,2666,47,163046173,Asia,183795,2352
2020-07-14,Bangladesh,BD,3099,39,163046173,Asia,186894,2391
2020-07-15,Bangladesh,BD,3163,33,163046173,Asia,190057,2424
2020-07-16,Bangladesh,BD,3533,33,163046173,Asia,193590,2457
2020-07-17,Bangladesh,BD,2733,39,163046173,Asia,196323,2496
2020-07-18,Bangladesh,BD,3034,51,163046173,Asia,199357,2547
2020-07-19,Bangladesh,BD,2709,34,163046173,Asia,202066,2581
2020-07-20,Bangladesh,BD,2459,37,163046173,Asia,204525,2618
2020-07-21,Bangladesh,BD,2928,50,163046173,Asia,207453,2668
2020-07-22,Bangladesh,BD,3057,41,163046173,Asia,210510,2709
2020-07-23,Bangladesh,BD,2744,42,163046173,Asia,213254,2751
2020-07-24,Bangladesh,BD,2856,50,163046173,Asia,216110,2801
2020-07-25,Bangladesh,BD,2548,35,163046173,Asia,218658,2836
2020-07-26,Bangladesh,BD,2520,38,163046173,Asia,221178,2874
2020-07-27,Bangladesh,BD,2275,54,163046173,Asia,223453,2928
2020-07-28,Bangladesh,BD,2772,37,163046173,Asia,226225,2965
2020-07-29,Bangladesh,BD,2960,35,163046173,Asia,229185,3000
2020-07-30,Bangladesh,BD,3009,35,163046173,Asia,232194,3035
2020-07-31,Bangladesh,BD,2695,48,163046173,Asia,234889,3083
2020-08-01,Bangladesh,BD,2772,28,163046173,Asia,237661,3111
2020-08-02,Bangladesh,BD,2199,21,163046173,Asia,239860,3132
2020-08-03,Bangladesh,BD,886,22,163046173,Asia,240746,3154
2020-08-04,Bangladesh,BD,1356,30,163046173,Asia,242102,3184
2020-08-05,Bangladesh,BD,1918,50,163046173,Asia,244020,3234
2020-08-06,Bangladesh,BD,2654,33,163046173,Asia,246674,3267
2020-08-07,Bangladesh,BD,2977,39,163046173,Asia,249651,3306
2020-08-08,Bangladesh,BD,2851,27,163046173,Asia,252502,3333
2020-08-09,Bangladesh,BD,2611,32,163046173,Asia,255113,3365
2020-08-10,Bangladesh,BD,2487,34,163046173,Asia,257600,3399
2020-08-11,Bangladesh,BD,2907,39,163046173,Asia,260507,3438
2020-08-12,Bangladesh,BD,2996,33,163046173,Asia,263503,3471
2020-08-13,Bangladesh,BD,2995,42,163046173,Asia,266498,3513
2020-08-14,Bangladesh,BD,2617,44,163046173,Asia,269115,3557
2020-08-15,Bangladesh,BD,2766,34,163046173,Asia,271881,3591
2020-08-16,Bangladesh,BD,2644,34,163046173,Asia,274525,3625
2020-08-17,Bangladesh,BD,2024,32,163046173,Asia,276549,3657
2020-08-18,Bangladesh,BD,2595,37,163046173,Asia,279144,3694
2020-08-19,Bangladesh,BD,3200,46,163046173,Asia,282344,3740
2020-08-20,Bangladesh,BD,2747,41,163046173,Asia,285091,3781
2020-08-21,Bangladesh,BD,2868,41,163046173,Asia,287959,3822
2020-08-22,Bangladesh,BD,2401,39,163046173,Asia,290360,3861
2020-08-23,Bangladesh,BD,2265,46,163046173,Asia,292625,3907
2020-08-24,Bangladesh,BD,1973,34,163046173,Asia,294598,3941
2020-08-25,Bangladesh,BD,2485,42,163046173,Asia,297083,3983
2020-08-26,Bangladesh,BD,2545,45,163046173,Asia,299628,4028
2020-08-27,Bangladesh,BD,2519,54,163046173,Asia,302147,4082
2020-08-28,Bangladesh,BD,2436,45,163046173,Asia,304583,4127
2020-08-29,Bangladesh,BD,2211,47,163046173,Asia,306794,4174
2020-08-30,Bangladesh,BD,2131,32,163046173,Asia,308925,4206
2020-08-31,Bangladesh,BD,1897,42,163046173,Asia,310822,4248
2020-09-01,Bangladesh,BD,2174,33,163046173,Asia,312996,4281
2020-09-02,Bangladesh,BD,1950,35,163046173,Asia,314946,4316
2020-09-03,Bangladesh,BD,2582,35,163046173,Asia,317528,4351
2020-09-04,Bangladesh,BD,2158,32,163046173,Asia,319686,4383
2020-09-05,Bangladesh,BD,1929,29,163046173,Asia,321615,4412
2020-09-06,Bangladesh,BD,1950,35,163046173,Asia,323565,4447
2020-09-07,Bangladesh,BD,1592,2,163046173,Asia,325157,4449
2020-09-08,Bangladesh,BD,2202,67,163046173,Asia,327359,4516
2020-09-09,Bangladesh,BD,1892,36,163046173,Asia,329251,4552
2020-09-10,Bangladesh,BD,1827,41,163046173,Asia,331078,4593
2020-09-11,Bangladesh,BD,1892,41,163046173,Asia,332970,4634
2020-09-12,Bangladesh,BD,1792,34,163046173,Asia,334762,4668
2020-09-13,Bangladesh,BD,1282,34,163046173,Asia,336044,4702
2020-09-14,Bangladesh,BD,1476,31,163046173,Asia,337520,4733
2020-09-15,Bangladesh,BD,1812,26,163046173,Asia,339332,4759
2020-09-16,Bangladesh,BD,1724,43,163046173,Asia,341056,4802
2020-09-17,Bangladesh,BD,1615,21,163046173,Asia,342671,4823
2020-09-18,Bangladesh,BD,1593,36,163046173,Asia,344264,4859
2020-09-19,Bangladesh,BD,1541,22,163046173,Asia,345805,4881
2020-09-20,Bangladesh,BD,1567,32,163046173,Asia,347372,4913
2020-09-21,Bangladesh,BD,1544,26,163046173,Asia,348916,4939
2020-09-22,Bangladesh,BD,1705,40,163046173,Asia,350621,4979
2020-09-23,Bangladesh,BD,1557,28,163046173,Asia,352178,5007
2020-09-24,Bangladesh,BD,1666,37,163046173,Asia,353844,5044
2020-09-25,Bangladesh,BD,1540,28,163046173,Asia,355384,5072
2020-09-26,Bangladesh,BD,1383,21,163046173,Asia,356767,5093
2020-09-27,Bangladesh,BD,1106,36,163046173,Asia,357873,5129
2020-09-28,Bangladesh,BD,1275,32,163046173,Asia,359148,5161
2020-09-29,Bangladesh,BD,1407,32,163046173,Asia,360555,5193
2020-09-30,Bangladesh,BD,1488,26,163046173,Asia,362043,5219
2020-10-01,Bangladesh,BD,1436,32,163046173,Asia,363479,5251
2020-10-02,Bangladesh,BD,1508,21,163046173,Asia,364987,5272
2020-10-03,Bangladesh,BD,1396,33,163046173,Asia,366383,5305
2020-10-04,Bangladesh,BD,1182,20,163046173,Asia,367565,5325
2020-10-05,Bangladesh,BD,1125,23,163046173,Asia,368690,5348
2020-10-06,Bangladesh,BD,1442,27,163046173,Asia,370132,5375
2020-10-07,Bangladesh,BD,1499,30,163046173,Asia,371631,5405
2020-10-08,Bangladesh,BD,1520,35,163046173,Asia,373151,5440
2020-10-09,Bangladesh,BD,1441,20,163046173,Asia,374592,5460
2020-10-10,Bangladesh,BD,1278,17,163046173,Asia,375870,5477
2020-10-11,Bangladesh,BD,1203,23,163046173,Asia,377073,5500
2020-10-12,Bangladesh,BD,1193,24,163046173,Asia,378266,5524
2020-10-13,Bangladesh,BD,1472,31,163046173,Asia,379738,5555
2020-10-14,Bangladesh,BD,1537,22,163046173,Asia,381275,5577
2020-10-15,Bangladesh,BD,1684,16,163046173,Asia,382959,5593
2020-10-16,Bangladesh,BD,1600,15,163046173,Asia,384559,5608
2020-10-17,Bangladesh,BD,1527,15,163046173,Asia,386086,5623
2020-10-18,Bangladesh,BD,1209,23,163046173,Asia,387295,5646
2020-10-19,Bangladesh,BD,1274,14,163046173,Asia,388569,5660
2020-10-20,Bangladesh,BD,1637,21,163046173,Asia,390206,5681
2020-10-21,Bangladesh,BD,1383,18,163046173,Asia,391589,5699
2020-10-22,Bangladesh,BD,1542,24,163046173,Asia,393131,5723
2020-10-23,Bangladesh,BD,1696,24,163046173,Asia,394827,5747
2020-10-24,Bangladesh,BD,1586,14,163046173,Asia,396413,5761
2020-10-25,Bangladesh,BD,1094,19,163046173,Asia,397507,5780
2020-10-26,Bangladesh,BD,1308,23,163046173,Asia,398815,5803
2020-10-27,Bangladesh,BD,1436,15,163046173,Asia,400251,5818
2020-10-28,Bangladesh,BD,1335,20,163046173,Asia,401586,5838
2020-10-29,Bangladesh,BD,1493,23,163046173,Asia,403079,5861
2020-10-30,Bangladesh,BD,1681,25,163046173,Asia,404760,5886
2020-10-31,Bangladesh,BD,1604,19,163046173,Asia,406364,5905
2020-11-01,Bangladesh,BD,1320,18,163046173,Asia,407684,5923
2020-11-02,Bangladesh,BD,1568,18,163046173,Asia,409252,5941
2020-11-03,Bangladesh,BD,1736,25,163046173,Asia,410988,5966
2020-11-04,Bangladesh,BD,1659,17,163046173,Asia,412647,5983
2020-11-05,Bangladesh,BD,1517,21,163046173,Asia,414164,6004
2020-11-06,Bangladesh,BD,1842,17,163046173,Asia,416006,6021
2020-11-07,Bangladesh,BD,1469,15,163046173,Asia,417475,6036
2020-11-08,Bangladesh,BD,1289,13,163046173,Asia,418764,6049
2020-11-09,Bangladesh,BD,1474,18,163046173,Asia,420238,6067
2020-11-10,Bangladesh,BD,1683,25,163046173,Asia,421921,6092
2020-11-11,Bangladesh,BD,1699,16,163046173,Asia,423620,6108
2020-11-12,Bangladesh,BD,1733,19,163046173,Asia,425353,6127
2020-11-13,Bangladesh,BD,1845,13,163046173,Asia,427198,6140
2020-11-14,Bangladesh,BD,1767,19,163046173,Asia,428965,6159
2020-11-15,Bangladesh,BD,1531,14,163046173,Asia,430496,6173
2020-11-16,Bangladesh,BD,1837,21,163046173,Asia,432333,6194
2020-11-17,Bangladesh,BD,2139,21,163046173,Asia,434472,6215
2020-11-18,Bangladesh,BD,2212,39,163046173,Asia,436684,6254
2020-11-19,Bangladesh,BD,2111,21,163046173,Asia,438795,6275
2020-11-20,Bangladesh,BD,2364,30,163046173,Asia,441159,6305
2020-11-21,Bangladesh,BD,2275,17,163046173,Asia,443434,6322
2020-11-22,Bangladesh,BD,1847,28,163046173,Asia,445281,6350
2020-11-23,Bangladesh,BD,2060,38,163046173,Asia,447341,6388
2020-11-24,Bangladesh,BD,2419,28,163046173,Asia,449760,6416
2020-11-25,Bangladesh,BD,2230,32,163046173,Asia,451990,6448
2020-11-26,Bangladesh,BD,2156,39,163046173,Asia,454146,6487
2020-11-27,Bangladesh,BD,2292,37,163046173,Asia,456438,6524
2020-11-28,Bangladesh,BD,2273,20,163046173,Asia,458711,6544
2020-11-29,Bangladesh,BD,1908,36,163046173,Asia,460619,6580
2020-11-30,Bangladesh,BD,1788,29,163046173,Asia,462407,6609
2020-12-01,Bangladesh,BD,2525,35,163046173,Asia,464932,6644
2020-12-02,Bangladesh,BD,2293,31,163046173,Asia,467225,6675
2020-12-03,Bangladesh,BD,2198,38,163046173,Asia,469423,6713
2020-12-04,Bangladesh,BD,2316,35,163046173,Asia,471739,6748
2020-12-05,Bangladesh,BD,2252,24,163046173,Asia,473991,6772
2020-12-06,Bangladesh,BD,1888,35,163046173,Asia,475879,6807
2020-12-07,Bangladesh,BD,1666,31,163046173,Asia,477545,6838
2020-12-08,Bangladesh,BD,2198,36,163046173,Asia,479743,6874
2020-12-09,Bangladesh,BD,2202,32,163046173,Asia,481945,6906
2020-12-10,Bangladesh,BD,2159,24,163046173,Asia,484104,6930
2020-12-11,Bangladesh,BD,1861,37,163046173,Asia,485965,6967
2020-12-12,Bangladesh,BD,1884,19,163046173,Asia,487849,6986
2020-12-13,Bangladesh,BD,1329,34,163046173,Asia,489178,7020
2020-12-14,Bangladesh,BD,1355,32,163046173,Asia,490533,7052
2019-12-31,Belgium,BE,0,0,11455519,Europe,0,0
2020-01-01,Belgium,BE,0,0,11455519,Europe,0,0
2020-01-02,Belgium,BE,0,0,11455519,Europe,0,0
2020-01-03,Belgium,BE,0,0,11455519,Europe,0,0
2020-01-04,Belgium,BE,0,0,11455519,Europe,0,0
2020-01-05,Belgium,BE,0,0,11455519,Europe,0,0
2020-01-06,Belgium,BE,0,0,11455519,Europe,0,0
2020-01-07,Belgium,BE,0,0,11455519,Europe,0,0
2020-01-08,Belgium,BE,0,0,11455519,Europe,0,0
2020-01-09,Belgium,BE,0,0,11455519,Europe,0,0
2020-01-10,Belgium,BE,0,0,11455519,Europe,0,0
2020-01-11,Belgium,BE,0,0,11455519,Europe,0,0
2020-01-12,Belgium,BE,0,0,11455519,Europe,0,0
2020-01-13,Belgium,BE,0,0,11455519,Europe,0,0
2020-01-14,Belgium,BE,0,0,11455519,Europe,0,0
2020-01-15,Belgium,BE,0,0,11455519,Europe,0,0
2020-01-16,Belgium,BE,0,0,11455519,Europe,0,0
2020-01-17,Belgium,BE,0,0,11455519,Europe,0,0
2020-01-18,Belgium,BE,0,0,11455519,Europe,0,0
2020-01-19,Belgium,BE,0,0,11455519,Europe,0,0
2020-01-20,Belgium,BE,0,0,11455519,Europe,0,0
2020-01-21,Belgium,BE,0,0,11455519,Europe,0,0
2020-01-22,Belgium,BE,0,0,11455519,Europe,0,0
2020-01-23,Belgium,BE,0,0,11455519,Europe,0,0
2020-01-24,Belgium,BE,0,0,11455519,Europe,0,0
2020-01-25,Belgium,BE,0,0,11455519,Europe,0,0
2020-01-26,Belgium,BE,0,0,11455519,Europe,0,0
2020-01-27,Belgium,BE,0,0,11455519,Europe,0,0
2020-01-28,Belgium,BE,0,0,11455519,Europe,0,0
2020-01-29,Belgium,BE,0,0,11455519,Europe,0,0
2020-01-30,Belgium,BE,0,0,11455519,Europe,0,0
2020-01-31,Belgium,BE,0,0,11455519,Europe,0,0
2020-02-01,Belgium,BE,0,0,11455519,Europe,0,0
2020-02-02,Belgium,BE,0,0,11455519,Europe,0,0
2020-02-03,Belgium,BE,0,0,11455519,Europe,0,0
2020-02-04,Belgium,BE,1,0,11455519,Europe,1,0
2020-02-05,Belgium,BE,0,0,11455519,Europe,1,0
2020-02-06,Belgium,BE,0,0,11455519,Europe,1,0
2020-02-07,Belgium,BE,0,0,11455519,Europe,1,0
2020-02-08,Belgium,BE,0,0,11455519,Europe,1,0
2020-02-09,Belgium,BE,0,0,11455519,Europe,1,0
2020-02-10,Belgium,BE,0,0,11455519,Europe,1,0
2020-02-11,Belgium,BE,0,0,11455519,Europe,1,0
2020-02-12,Belgium,BE,0,0,11455519,Europe,1,0
2020-02-13,Belgium,BE,0,0,11455519,Europe,1,0
2020-02-14,Belgium,BE,0,0,11455519,Europe,1,0
2020-02-15,Belgium,BE,0,0,11455519,Europe,1,0
2020-02-16,Belgium,BE,0,0,11455519,Europe,1,0
2020-02-17,Belgium,BE,0,0,11455519,Europe,1,0
2020-02-18,Belgium,BE,0,0,11455519,Europe,1,0
2020-02-19,Belgium,BE,0,0,11455519,Europe,1,0
2020-02-20,Belgium,BE,0,0,11455519,Europe,1,0
2020-02-21,Belgium,BE,0,0,11455519,Europe,1,0
2020-02-22,Belgium,BE,0,0,11455519,Europe,1,0
2020-02-23,Belgium,BE,0,0,11455519,Europe,1,0
2020-02-24,Belgium,BE,0,0,11455519,Europe,1,0
2020-02-25,Belgium,BE,0,0,11455519,Europe,1,0
2020-02-26,Belgium,BE,0,0,11455519,Europe,1,0
2020-02-27,Belgium,BE,0,0,11455519,Europe,1,0
2020-02-28,Belgium,BE,0,0,11455519,Europe,1,0
2020-02-29,Belgium,BE,0,0,11455519,Europe,1,0
2020-03-01,Belgium,BE,18,0,11455519,Europe,19,0
2020-03-02,Belgium,BE,0,0,11455519,Europe,19,0
2020-03-03,Belgium,BE,19,0,11455519,Europe,38,0
2020-03-04,Belgium,BE,34,0,11455519,Europe,72,0
2020-03-05,Belgium,BE,53,0,11455519,Europe,125,0
2020-03-06,Belgium,BE,81,0,11455519,Europe,206,0
2020-03-07,Belgium,BE,110,0,11455519,Europe,316,0
2020-03-08,Belgium,BE,27,0,11455519,Europe,343,0
2020-03-09,Belgium,BE,64,0,11455519,Europe,407,0
2020-03-10,Belgium,BE,94,1,11455519,Europe,501,1
2020-03-11,Belgium,BE,99,0,11455519,Europe,600,1
2020-03-12,Belgium,BE,174,3,11455519,Europe,774,4
2020-03-13,Belgium,BE,251,1,11455519,Europe,1025,5
2020-03-14,Belgium,BE,338,3,11455519,Europe,1363,8
2020-03-15,Belgium,BE,179,5,11455519,Europe,1542,13
2020-03-16,Belgium,BE,214,6,11455519,Europe,1756,19
2020-03-17,Belgium,BE,387,12,11455519,Europe,2143,31
2020-03-18,Belgium,BE,422,10,11455519,Europe,2565,41
2020-03-19,Belgium,BE,535,22,11455519,Europe,3100,63
2020-03-20,Belgium,BE,713,33,11455519,Europe,3813,96
2020-03-21,Belgium,BE,662,35,11455519,Europe,4475,131
2020-03-22,Belgium,BE,469,40,11455519,Europe,4944,171
2020-03-23,Belgium,BE,486,47,11455519,Europe,5430,218
2020-03-24,Belgium,BE,1328,78,11455519,Europe,6758,296
2020-03-25,Belgium,BE,1195,77,11455519,Europe,7953,373
2020-03-26,Belgium,BE,1199,107,11455519,Europe,9152,480
2020-03-27,Belgium,BE,1363,102,11455519,Europe,10515,582
2020-03-28,Belgium,BE,1520,128,11455519,Europe,12035,710
2020-03-29,Belgium,BE,845,141,11455519,Europe,12880,851
2020-03-30,Belgium,BE,685,149,11455519,Europe,13565,1000
2020-03-31,Belgium,BE,1739,170,11455519,Europe,15304,1170
2020-04-01,Belgium,BE,1683,208,11455519,Europe,16987,1378
2020-04-02,Belgium,BE,1517,233,11455519,Europe,18504,1611
2020-04-03,Belgium,BE,1479,219,11455519,Europe,19983,1830
2020-04-04,Belgium,BE,1694,236,11455519,Europe,21677,2066
2020-04-05,Belgium,BE,923,271,11455519,Europe,22600,2337
2020-04-06,Belgium,BE,667,247,11455519,Europe,23267,2584
2020-04-07,Belgium,BE,1937,257,11455519,Europe,25204,2841
2020-04-08,Belgium,BE,1515,277,11455519,Europe,26719,3118
2020-04-09,Belgium,BE,1599,322,11455519,Europe,28318,3440
2020-04-10,Belgium,BE,2240,272,11455519,Europe,30558,3712
2020-04-11,Belgium,BE,2336,302,11455519,Europe,32894,4014
2020-04-12,Belgium,BE,1032,284,11455519,Europe,33926,4298
2020-04-13,Belgium,BE,524,265,11455519,Europe,34450,4563
2020-04-14,Belgium,BE,538,277,11455519,Europe,34988,4840
2020-04-15,Belgium,BE,1561,261,11455519,Europe,36549,5101
2020-04-16,Belgium,BE,1633,280,11455519,Europe,38182,5381
2020-04-17,Belgium,BE,1675,246,11455519,Europe,39857,5627
2020-04-18,Belgium,BE,1395,205,11455519,Europe,41252,5832
2020-04-19,Belgium,BE,722,208,11455519,Europe,41974,6040
2020-04-20,Belgium,BE,444,190,11455519,Europe,42418,6230
2020-04-21,Belgium,BE,1278,206,11455519,Europe,43696,6436
2020-04-22,Belgium,BE,1270,203,11455519,Europe,44966,6639
2020-04-23,Belgium,BE,778,181,11455519,Europe,45744,6820
2020-04-24,Belgium,BE,976,156,11455519,Europe,46720,6976
2020-04-25,Belgium,BE,811,155,11455519,Europe,47531,7131
2020-04-26,Belgium,BE,388,142,11455519,Europe,47919,7273
2020-04-27,Belgium,BE,205,154,11455519,Europe,48124,7427
2020-04-28,Belgium,BE,755,135,11455519,Europe,48879,7562
2020-04-29,Belgium,BE,569,110,11455519,Europe,49448,7672
2020-04-30,Belgium,BE,522,107,11455519,Europe,49970,7779
2020-05-01,Belgium,BE,586,87,11455519,Europe,50556,7866
2020-05-02,Belgium,BE,237,93,11455519,Europe,50793,7959
2020-05-03,Belgium,BE,286,75,11455519,Europe,51079,8034
2020-05-04,Belgium,BE,140,94,11455519,Europe,51219,8128
2020-05-05,Belgium,BE,670,95,11455519,Europe,51889,8223
2020-05-06,Belgium,BE,547,81,11455519,Europe,52436,8304
2020-05-07,Belgium,BE,552,76,11455519,Europe,52988,8380
2020-05-08,Belgium,BE,442,71,11455519,Europe,53430,8451
2020-05-09,Belgium,BE,483,74,11455519,Europe,53913,8525
2020-05-10,Belgium,BE,240,71,11455519,Europe,54153,8596
2020-05-11,Belgium,BE,118,72,11455519,Europe,54271,8668
2020-05-12,Belgium,BE,476,65,11455519,Europe,54747,8733
2020-05-13,Belgium,BE,395,45,11455519,Europe,55142,8778
2020-05-14,Belgium,BE,321,56,11455519,Europe,55463,8834
2020-05-15,Belgium,BE,305,43,11455519,Europe,55768,8877
2020-05-16,Belgium,BE,347,45,11455519,Europe,56115,8922
2020-05-17,Belgium,BE,147,30,11455519,Europe,56262,8952
2020-05-18,Belgium,BE,81,31,11455519,Europe,56343,8983
2020-05-19,Belgium,BE,317,37,11455519,Europe,56660,9020
2020-05-20,Belgium,BE,292,33,11455519,Europe,56952,9053
2020-05-21,Belgium,BE,385,30,11455519,Europe,57337,9083
2020-05-22,Belgium,BE,70,34,11455519,Europe,57407,9117
2020-05-23,Belgium,BE,248,41,11455519,Europe,57655,9158
2020-05-24,Belgium,BE,123,25,11455519,Europe,57778,9183
2020-05-25,Belgium,BE,75,33,11455519,Europe,57853,9216
2020-05-26,Belgium,BE,314,26,11455519,Europe,58167,9242
2020-05-27,Belgium,BE,202,24,11455519,Europe,58369,9266
2020-05-28,Belgium,BE,182,24,11455519,Europe,58551,9290
2020-05-29,Belgium,BE,171,26,11455519,Europe,58722,9316
2020-05-30,Belgium,BE,165,16,11455519,Europe,58887,9332
2020-05-31,Belgium,BE,61,23,11455519,Europe,58948,9355
2020-06-01,Belgium,BE,49,22,11455519,Europe,58997,9377
2020-06-02,Belgium,BE,59,21,11455519,Europe,59056,9398
2020-06-03,Belgium,BE,183,23,11455519,Europe,59239,9421
2020-06-04,Belgium,BE,159,20,11455519,Europe,59398,9441
2020-06-05,Belgium,BE,172,14,11455519,Europe,59570,9455
2020-06-06,Belgium,BE,154,12,11455519,Europe,59724,9467
2020-06-07,Belgium,BE,69,11,11455519,Europe,59793,9478
2020-06-08,Belgium,BE,53,12,11455519,Europe,59846,9490
2020-06-09,Belgium,BE,153,9,11455519,Europe,59999,9499
2020-06-10,Belgium,BE,145,12,11455519,Europe,60144,9511
2020-06-11,Belgium,BE,119,12,11455519,Europe,60263,9523
2020-06-12,Belgium,BE,95,7,11455519,Europe,60358,9530
2020-06-13,Belgium,BE,89,10,11455519,Europe,60447,9540
2020-06-14,Belgium,BE,49,5,11455519,Europe,60496,9545
2020-06-15,Belgium,BE,22,3,11455519,Europe,60518,9548
2020-06-16,Belgium,BE,147,8,11455519,Europe,60665,9556
2020-06-17,Belgium,BE,99,7,11455519,Europe,60764,9563
2020-06-18,Belgium,BE,123,7,11455519,Europe,60887,9570
2020-06-19,Belgium,BE,108,5,11455519,Europe,60995,9575
2020-06-20,Belgium,BE,121,4,11455519,Europe,61116,9579
2020-06-21,Belgium,BE,50,3,11455519,Europe,61166,9582
2020-06-22,Belgium,BE,20,9,11455519,Europe,61186,9591
2020-06-23,Belgium,BE,143,12,11455519,Europe,61329,9603
2020-06-24,Belgium,BE,110,4,11455519,Europe,61439,9607
2020-06-25,Belgium,BE,100,3,11455519,Europe,61539,9610
2020-06-26,Belgium,BE,76,5,11455519,Europe,61615,9615
2020-06-27,Belgium,BE,113,2,11455519,Europe,61728,9617
2020-06-28,Belgium,BE,41,8,11455519,Europe,61769,9625
2020-06-29,Belgium,BE,24,5,11455519,Europe,61793,9630
2020-06-30,Belgium,BE,127,3,11455519,Europe,61920,9633
2020-07-01,Belgium,BE,100,8,11455519,Europe,62020,9641
2020-07-02,Belgium,BE,135,2,11455519,Europe,62155,9643
2020-07-03,Belgium,BE,93,5,11455519,Europe,62248,9648
2020-07-04,Belgium,BE,94,2,11455519,Europe,62342,9650
2020-07-05,Belgium,BE,64,3,11455519,Europe,62406,9653
2020-07-06,Belgium,BE,24,2,11455519,Europe,62430,9655
2020-07-07,Belgium,BE,112,1,11455519,Europe,62542,9656
2020-07-08,Belgium,BE,99,3,11455519,Europe,62641,9659
2020-07-09,Belgium,BE,137,1,11455519,Europe,62778,9660
2020-07-10,Belgium,BE,124,2,11455519,Europe,62902,9662
2020-07-11,Belgium,BE,127,0,11455519,Europe,63029,9662
2020-07-12,Belgium,BE,62,2,11455519,Europe,63091,9664
2020-07-13,Belgium,BE,43,4,11455519,Europe,63134,9668
2020-07-14,Belgium,BE,224,0,11455519,Europe,63358,9668
2020-07-15,Belgium,BE,207,3,11455519,Europe,63565,9671
2020-07-16,Belgium,BE,260,5,11455519,Europe,63825,9676
2020-07-17,Belgium,BE,226,5,11455519,Europe,64051,9681
2020-07-18,Belgium,BE,274,2,11455519,Europe,64325,9683
2020-07-19,Belgium,BE,130,3,11455519,Europe,64455,9686
2020-07-20,Belgium,BE,64,1,11455519,Europe,64519,9687
2020-07-21,Belgium,BE,443,2,11455519,Europe,64962,9689
2020-07-22,Belgium,BE,145,1,11455519,Europe,65107,9690
2020-07-23,Belgium,BE,553,2,11455519,Europe,65660,9692
2020-07-24,Belgium,BE,439,2,11455519,Europe,66099,9694
2020-07-25,Belgium,BE,496,5,11455519,Europe,66595,9699
2020-07-26,Belgium,BE,229,1,11455519,Europe,66824,9700
2020-07-27,Belgium,BE,184,2,11455519,Europe,67008,9702
2020-07-28,Belgium,BE,595,4,11455519,Europe,67603,9706
2020-07-29,Belgium,BE,685,1,11455519,Europe,68288,9707
2020-07-30,Belgium,BE,703,3,11455519,Europe,68991,9710
2020-07-31,Belgium,BE,635,2,11455519,Europe,69626,9712
2020-08-01,Belgium,BE,684,3,11455519,Europe,70310,9715
2020-08-02,Belgium,BE,309,2,11455519,Europe,70619,9717
2020-08-03,Belgium,BE,148,5,11455519,Europe,70767,9722
2020-08-04,Belgium,BE,794,3,11455519,Europe,71561,9725
2020-08-05,Belgium,BE,814,5,11455519,Europe,72375,9730
2020-08-06,Belgium,BE,776,5,11455519,Europe,73151,9735
2020-08-07,Belgium,BE,769,4,11455519,Europe,73920,9739
2020-08-08,Belgium,BE,771,6,11455519,Europe,74691,9745
2020-08-09,Belgium,BE,304,2,11455519,Europe,74995,9747
2020-08-10,Belgium,BE,122,5,11455519,Europe,75117,9752
2020-08-11,Belgium,BE,873,11,11455519,Europe,75990,9763
2020-08-12,Belgium,BE,718,13,11455519,Europe,76708,9776
2020-08-13,Belgium,BE,609,11,11455519,Europe,77317,9787
2020-08-14,Belgium,BE,669,12,11455519,Europe,77986,9799
2020-08-15,Belgium,BE,587,12,11455519,Europe,78573,9811
2020-08-16,Belgium,BE,163,9,11455519,Europe,78736,9820
2020-08-17,Belgium,BE,132,7,11455519,Europe,78868,9827
2020-08-18,Belgium,BE,707,7,11455519,Europe,79575,9834
2020-08-19,Belgium,BE,725,11,11455519,Europe,80300,9845
2020-08-20,Belgium,BE,612,9,11455519,Europe,80912,9854
2020-08-21,Belgium,BE,581,4,11455519,Europe,81493,9858
2020-08-22,Belgium,BE,510,3,11455519,Europe,82003,9861
2020-08-23,Belgium,BE,203,5,11455519,Europe,82206,9866
2020-08-24,Belgium,BE,115,3,11455519,Europe,82321,9869
2020-08-25,Belgium,BE,607,5,11455519,Europe,82928,9874
2020-08-26,Belgium,BE,527,5,11455519,Europe,83455,9879
2020-08-27,Belgium,BE,526,4,11455519,Europe,83981,9883
2020-08-28,Belgium,BE,535,3,11455519,Europe,84516,9886
2020-08-29,Belgium,BE,614,4,11455519,Europe,85130,9890
2020-08-30,Belgium,BE,195,6,11455519,Europe,85325,9896
2020-08-31,Belgium,BE,117,1,11455519,Europe,85442,9897
2020-09-01,Belgium,BE,634,3,11455519,Europe,86076,9900
2020-09-02,Belgium,BE,565,3,11455519,Europe,86641,9903
2020-09-03,Belgium,BE,574,2,11455519,Europe,87215,9905
2020-09-04,Belgium,BE,677,4,11455519,Europe,87892,9909
2020-09-05,Belgium,BE,728,2,11455519,Europe,88620,9911
2020-09-06,Belgium,BE,322,1,11455519,Europe,88942,9912
2020-09-07,Belgium,BE,155,2,11455519,Europe,89097,9914
2020-09-08,Belgium,BE,918,4,11455519,Europe,90015,9918
2020-09-09,Belgium,BE,871,3,11455519,Europe,90886,9921
2020-09-10,Belgium,BE,1024,2,11455519,Europe,91910,9923
2020-09-11,Belgium,BE,1143,3,11455519,Europe,93053,9926
2020-09-12,Belgium,BE,1284,5,11455519,Europe,94337,9931
2020-09-13,Belgium,BE,617,1,11455519,Europe,94954,9932
2020-09-14,Belgium,BE,301,1,11455519,Europe,95255,9933
2020-09-15,Belgium,BE,1727,4,11455519,Europe,96982,9937
2020-09-16,Belgium,BE,1628,3,11455519,Europe,98610,9940
2020-09-17,Belgium,BE,1942,2,11455519,Europe,100552,9942
2020-09-18,Belgium,BE,1752,1,11455519,Europe,102304,9943
2020-09-19,Belgium,BE,1709,6,11455519,Europe,104013,9949
2020-09-20,Belgium,BE,894,8,11455519,Europe,104907,9957
2020-09-21,Belgium,BE,461,3,11455519,Europe,105368,9960
2020-09-22,Belgium,BE,2204,3,11455519,Europe,107572,9963
2020-09-23,Belgium,BE,2074,1,11455519,Europe,109646,9964
2020-09-24,Belgium,BE,2097,8,11455519,Europe,111743,9972
2020-09-25,Belgium,BE,1796,4,11455519,Europe,113539,9976
2020-09-26,Belgium,BE,1623,5,11455519,Europe,115162,9981
2020-09-27,Belgium,BE,944,6,11455519,Europe,116106,9987
2020-09-28,Belgium,BE,540,12,11455519,Europe,116646,9999
2020-09-29,Belgium,BE,2782,13,11455519,Europe,119428,10012
2020-09-30,Belgium,BE,2984,10,11455519,Europe,122412,10022
2020-10-01,Belgium,BE,3243,6,11455519,Europe,125655,10028
2020-10-02,Belgium,BE,3410,15,11455519,Europe,129065,10043
2020-10-03,Belgium,BE,3721,11,11455519,Europe,132786,10054
2020-10-04,Belgium,BE,1709,15,11455519,Europe,134495,10069
2020-10-05,Belgium,BE,1035,14,11455519,Europe,135530,10083
2020-10-06,Belgium,BE,5249,14,11455519,Europe,140779,10097
2020-10-07,Belgium,BE,5687,18,11455519,Europe,146466,10115
2020-10-08,Belgium,BE,6803,20,11455519,Europe,153269,10135
2020-10-09,Belgium,BE,6588,20,11455519,Europe,159857,10155
2020-10-10,Belgium,BE,7789,19,11455519,Europe,167646,10174
2020-10-11,Belgium,BE,4310,22,11455519,Europe,171956,10196
2020-10-12,Belgium,BE,2403,26,11455519,Europe,174359,10222
2020-10-13,Belgium,BE,9735,36,11455519,Europe,184094,10258
2020-10-14,Belgium,BE,12577,34,11455519,Europe,196671,10292
2020-10-15,Belgium,BE,12293,41,11455519,Europe,208964,10333
2020-10-16,Belgium,BE,11818,35,11455519,Europe,220782,10368
2020-10-17,Belgium,BE,13477,36,11455519,Europe,234259,10404
2020-10-18,Belgium,BE,7995,23,11455519,Europe,242254,10427
2020-10-19,Belgium,BE,4289,31,11455519,Europe,246543,10458
2020-10-20,Belgium,BE,15560,52,11455519,Europe,262103,10510
2020-10-21,Belgium,BE,19265,52,11455519,Europe,281368,10562
2020-10-22,Belgium,BE,17485,62,11455519,Europe,298853,10624
2020-10-23,Belgium,BE,17687,55,11455519,Europe,316540,10679
2020-10-24,Belgium,BE,18876,94,11455519,Europe,335416,10773
2020-10-25,Belgium,BE,11557,93,11455519,Europe,346973,10866
2020-10-26,Belgium,BE,4895,94,11455519,Europe,351868,10960
2020-10-27,Belgium,BE,19868,121,11455519,Europe,371736,11081
2020-10-28,Belgium,BE,22210,132,11455519,Europe,393946,11213
2020-10-29,Belgium,BE,17998,142,11455519,Europe,411944,11355
2020-10-30,Belgium,BE,15090,139,11455519,Europe,427034,11494
2020-10-31,Belgium,BE,15401,185,11455519,Europe,442435,11679
2020-11-01,Belgium,BE,6308,177,11455519,Europe,448743,11856
2020-11-02,Belgium,BE,2666,164,11455519,Europe,451409,12020
2020-11-03,Belgium,BE,13858,208,11455519,Europe,465267,12228
2020-11-04,Belgium,BE,12102,172,11455519,Europe,477369,12400
2020-11-05,Belgium,BE,9230,198,11455519,Europe,486599,12598
2020-11-06,Belgium,BE,7659,206,11455519,Europe,494258,12804
2020-11-07,Belgium,BE,6648,214,11455519,Europe,500906,13018
2020-11-08,Belgium,BE,3046,208,11455519,Europe,503952,13226
2020-11-09,Belgium,BE,1448,210,11455519,Europe,505400,13436
2020-11-10,Belgium,BE,8636,194,11455519,Europe,514036,13630
2020-11-11,Belgium,BE,7701,218,11455519,Europe,521737,13848
2020-11-12,Belgium,BE,2004,196,11455519,Europe,523741,14044
2020-11-13,Belgium,BE,6482,173,11455519,Europe,530223,14217
2020-11-14,Belgium,BE,5709,183,11455519,Europe,535932,14400
2020-11-15,Belgium,BE,2371,175,11455519,Europe,538303,14575
2020-11-16,Belgium,BE,1057,192,11455519,Europe,539360,14767
2020-11-17,Belgium,BE,5821,195,11455519,Europe,545181,14962
2020-11-18,Belgium,BE,4828,153,11455519,Europe,550009,15115
2020-11-19,Belgium,BE,3700,158,11455519,Europe,553709,15273
2020-11-20,Belgium,BE,3019,172,11455519,Europe,556728,15445
2020-11-21,Belgium,BE,3081,165,11455519,Europe,559809,15610
2020-11-22,Belgium,BE,1263,138,11455519,Europe,561072,15748
2020-11-23,Belgium,BE,589,135,11455519,Europe,561661,15883
2020-11-24,Belgium,BE,3953,139,11455519,Europe,565614,16022
2020-11-25,Belgium,BE,2867,120,11455519,Europe,568481,16142
2020-11-26,Belgium,BE,2673,138,11455519,Europe,571154,16280
2020-11-27,Belgium,BE,2413,118,11455519,Europe,573567,16398
2020-11-28,Belgium,BE,2700,124,11455519,Europe,576267,16522
2020-11-29,Belgium,BE,1004,114,11455519,Europe,577271,16636
2020-11-30,Belgium,BE,560,119,11455519,Europe,577831,16755
2020-12-01,Belgium,BE,3293,99,11455519,Europe,581124,16854
2020-12-02,Belgium,BE,2674,110,11455519,Europe,583798,16964
2020-12-03,Belgium,BE,2611,117,11455519,Europe,586409,17081
2020-12-04,Belgium,BE,2364,93,11455519,Europe,588773,17174
2020-12-05,Belgium,BE,2549,106,11455519,Europe,591322,17280
2020-12-06,Belgium,BE,1098,85,11455519,Europe,592420,17365
2020-12-07,Belgium,BE,592,83,11455519,Europe,593012,17448
2020-12-08,Belgium,BE,3353,96,11455519,Europe,596365,17544
2020-12-09,Belgium,BE,2715,91,11455519,Europe,599080,17635
2020-12-10,Belgium,BE,2708,83,11455519,Europe,601788,17718
2020-12-11,Belgium,BE,2604,87,11455519,Europe,604392,17805
2020-12-12,Belgium,BE,2751,92,11455519,Europe,607143,17897
2020-12-13,Belgium,BE,856,48,11455519,Europe,607999,17945
2020-12-14,Belgium,BE,2,6,11455519,Europe,608001,17951
2020-03-11,Burkina_Faso,BF,2,0,20321383,Africa,2,0
2020-03-12,Burkina_Faso,BF,0,0,20321383,Africa,2,0
2020-03-15,Burkina_Faso,BF,1,0,20321383,Africa,3,0
2020-03-16,Burkina_Faso,BF,0,0,20321383,Africa,3,0
2020-03-17,Burkina_Faso,BF,17,0,20321383,Africa,20,0
2020-03-18,Burkina_Faso,BF,0,0,20321383,Africa,20,0
2020-03-19,Burkina_Faso,BF,6,1,20321383,Africa,26,1
2020-03-20,Burkina_Faso,BF,7,0,20321383,Africa,33,1
2020-03-21,Burkina_Faso,BF,7,0,20321383,Africa,40,1
2020-03-22,Burkina_Faso,BF,24,2,20321383,Africa,64,3
2020-03-23,Burkina_Faso,BF,0,0,20321383,Africa,64,3
2020-03-24,Burkina_Faso,BF,11,0,20321383,Africa,75,3
2020-03-25,Burkina_Faso,BF,24,0,20321383,Africa,99,3
2020-03-26,Burkina_Faso,BF,15,0,20321383,Africa,114,3
2020-03-27,Burkina_Faso,BF,32,0,20321383,Africa,146,3
2020-03-28,Burkina_Faso,BF,0,0,20321383,Africa,146,3
2020-03-29,Burkina_Faso,BF,34,6,20321383,Africa,180,9
2020-03-30,Burkina_Faso,BF,0,0,20321383,Africa,180,9
2020-03-31,Burkina_Faso,BF,42,3,20321383,Africa,222,12
2020-04-01,Burkina_Faso,BF,24,0,20321383,Africa,246,12
2020-04-02,Burkina_Faso,BF,15,2,20321383,Africa,261,14
2020-04-03,Burkina_Faso,BF,27,2,20321383,Africa,288,16
2020-04-04,Burkina_Faso,BF,0,0,20321383,Africa,288,16
2020-04-05,Burkina_Faso,BF,14,0,20321383,Africa,302,16
2020-04-06,Burkina_Faso,BF,43,1,20321383,Africa,345,17
2020-04-07,Burkina_Faso,BF,19,0,20321383,Africa,364,17
2020-04-08,Burkina_Faso,BF,20,2,20321383,Africa,384,19
2020-04-09,Burkina_Faso,BF,30,4,20321383,Africa,414,23
2020-04-10,Burkina_Faso,BF,29,1,20321383,Africa,443,24
2020-04-11,Burkina_Faso,BF,5,2,20321383,Africa,448,26
2020-04-12,Burkina_Faso,BF,36,1,20321383,Africa,484,27
2020-04-13,Burkina_Faso,BF,13,0,20321383,Africa,497,27
2020-04-14,Burkina_Faso,BF,18,1,20321383,Africa,515,28
2020-04-15,Burkina_Faso,BF,13,2,20321383,Africa,528,30
2020-04-16,Burkina_Faso,BF,14,2,20321383,Africa,542,32
2020-04-17,Burkina_Faso,BF,1,0,20321383,Africa,543,32
2020-04-18,Burkina_Faso,BF,14,3,20321383,Africa,557,35
2020-04-19,Burkina_Faso,BF,8,1,20321383,Africa,565,36
2020-04-20,Burkina_Faso,BF,11,0,20321383,Africa,576,36
2020-04-21,Burkina_Faso,BF,5,2,20321383,Africa,581,38
2020-04-22,Burkina_Faso,BF,19,0,20321383,Africa,600,38
2020-04-23,Burkina_Faso,BF,9,1,20321383,Africa,609,39
2020-04-24,Burkina_Faso,BF,7,2,20321383,Africa,616,41
2020-04-25,Burkina_Faso,BF,10,0,20321383,Africa,626,41
2020-04-26,Burkina_Faso,BF,3,0,20321383,Africa,629,41
2020-04-27,Burkina_Faso,BF,3,1,20321383,Africa,632,42
2020-04-28,Burkina_Faso,BF,3,0,20321383,Africa,635,42
2020-04-29,Burkina_Faso,BF,3,0,20321383,Africa,638,42
2020-04-30,Burkina_Faso,BF,3,1,20321383,Africa,641,43
2020-05-01,Burkina_Faso,BF,4,0,20321383,Africa,645,43
2020-05-02,Burkina_Faso,BF,4,1,20321383,Africa,649,44
2020-05-03,Burkina_Faso,BF,3,0,20321383,Africa,652,44
2020-05-04,Burkina_Faso,BF,10,1,20321383,Africa,662,45
2020-05-05,Burkina_Faso,BF,10,1,20321383,Africa,672,46
2020-05-06,Burkina_Faso,BF,16,2,20321383,Africa,688,48
2020-05-07,Burkina_Faso,BF,41,0,20321383,Africa,729,48
2020-05-08,Burkina_Faso,BF,7,0,20321383,Africa,736,48
2020-05-09,Burkina_Faso,BF,8,0,20321383,Africa,744,48
2020-05-10,Burkina_Faso,BF,4,0,20321383,Africa,748,48
2020-05-11,Burkina_Faso,BF,3,1,20321383,Africa,751,49
2020-05-12,Burkina_Faso,BF,9,1,20321383,Africa,760,50
2020-05-13,Burkina_Faso,BF,6,1,20321383,Africa,766,51
2020-05-14,Burkina_Faso,BF,7,0,20321383,Africa,773,51
2020-05-15,Burkina_Faso,BF,0,0,20321383,Africa,773,51
2020-05-16,Burkina_Faso,BF,9,0,20321383,Africa,782,51
2020-05-17,Burkina_Faso,BF,0,0,20321383,Africa,782,51
2020-05-18,Burkina_Faso,BF,14,0,20321383,Africa,796,51
2020-05-19,Burkina_Faso,BF,0,0,20321383,Africa,796,51
2020-05-20,Burkina_Faso,BF,10,1,20321383,Africa,806,52
2020-05-21,Burkina_Faso,BF,3,0,20321383,Africa,809,52
2020-05-22,Burkina_Faso,BF,3,0,20321383,Africa,812,52
2020-05-23,Burkina_Faso,BF,2,0,20321383,Africa,814,52
2020-05-24,Burkina_Faso,BF,0,0,20321383,Africa,814,52
2020-05-25,Burkina_Faso,BF,18,0,20321383,Africa,832,52
2020-05-26,Burkina_Faso,BF,9,0,20321383,Africa,841,52
2020-05-27,Burkina_Faso,BF,4,1,20321383,Africa,845,53
2020-05-28,Burkina_Faso,BF,0,0,20321383,Africa,845,53
2020-05-29,Burkina_Faso,BF,2,0,20321383,Africa,847,53
2020-05-30,Burkina_Faso,BF,0,0,20321383,Africa,847,53
2020-05-31,Burkina_Faso,BF,6,0,20321383,Africa,853,53
2020-06-01,Burkina_Faso,BF,28,0,20321383,Africa,881,53
2020-06-02,Burkina_Faso,BF,0,0,20321383,Africa,881,53
2020-06-03,Burkina_Faso,BF,2,0,20321383,Africa,883,53
2020-06-04,Burkina_Faso,BF,1,0,20321383,Africa,884,53
2020-06-05,Burkina_Faso,BF,1,0,20321383,Africa,885,53
2020-06-06,Burkina_Faso,BF,3,0,20321383,Africa,888,53
2020-06-07,Burkina_Faso,BF,0,0,20321383,Africa,888,53
2020-06-08,Burkina_Faso,BF,1,0,20321383,Africa,889,53
2020-06-09,Burkina_Faso,BF,1,0,20321383,Africa,890,53
2020-06-10,Burkina_Faso,BF,1,0,20321383,Africa,891,53
2020-06-11,Burkina_Faso,BF,0,0,20321383,Africa,891,53
2020-06-12,Burkina_Faso,BF,1,0,20321383,Africa,892,53
2020-06-13,Burkina_Faso,BF,0,0,20321383,Africa,892,53
2020-06-14,Burkina_Faso,BF,2,0,20321383,Africa,894,53
2020-06-15,Burkina_Faso,BF,0,0,20321383,Africa,894,53
2020-06-16,Burkina_Faso,BF,0,0,20321383,Africa,894,53
2020-06-17,Burkina_Faso,BF,1,0,20321383,Africa,895,53
2020-06-18,Burkina_Faso,BF,4,0,20321383,Africa,899,53
2020-06-19,Burkina_Faso,BF,0,0,20321383,Africa,899,53
2020-06-20,Burkina_Faso,BF,1,0,20321383,Africa,900,53
2020-06-21,Burkina_Faso,BF,2,0,20321383,Africa,902,53
2020-06-22,Burkina_Faso,BF,1,0,20321383,Africa,903,53
2020-06-23,Burkina_Faso,BF,4,0,20321383,Africa,907,53
2020-06-24,Burkina_Faso,BF,12,0,20321383,Africa,919,53
2020-06-25,Burkina_Faso,BF,15,0,20321383,Africa,934,53
2020-06-26,Burkina_Faso,BF,7,0,20321383,Africa,941,53
2020-06-27,Burkina_Faso,BF,0,0,20321383,Africa,941,53
2020-06-28,Burkina_Faso,BF,0,0,20321383,Africa,941,53
2020-06-29,Burkina_Faso,BF,18,0,20321383,Africa,959,53
2020-06-30,Burkina_Faso,BF,0,0,20321383,Africa,959,53
2020-07-01,Burkina_Faso,BF,3,0,20321383,Africa,962,53
2020-07-02,Burkina_Faso,BF,0,0,20321383,Africa,962,53
2020-07-03,Burkina_Faso,BF,18,0,20321383,Africa,980,53
2020-07-04,Burkina_Faso,BF,7,0,20321383,Africa,987,53
2020-07-05,Burkina_Faso,BF,0,0,20321383,Africa,987,53
2020-07-06,Burkina_Faso,BF,0,0,20321383,Africa,987,53
2020-07-07,Burkina_Faso,BF,13,0,20321383,Africa,1000,53
2020-07-08,Burkina_Faso,BF,3,0,20321383,Africa,1003,53
2020-07-09,Burkina_Faso,BF,2,0,20321383,Africa,1005,53
2020-07-10,Burkina_Faso,BF,15,0,20321383,Africa,1020,53
2020-07-11,Burkina_Faso,BF,0,0,20321383,Africa,1020,53
2020-07-12,Burkina_Faso,BF,13,0,20321383,Africa,1033,53
2020-07-13,Burkina_Faso,BF,3,0,20321383,Africa,1036,53
2020-07-14,Burkina_Faso,BF,0,0,20321383,Africa,1036,53
2020-07-15,Burkina_Faso,BF,2,0,20321383,Africa,1038,53
2020-07-16,Burkina_Faso,BF,0,0,20321383,Africa,1038,53
2020-07-17,Burkina_Faso,BF,0,0,20321383,Africa,1038,53
2020-07-18,Burkina_Faso,BF,9,0,20321383,Africa,1047,53
2020-07-19,Burkina_Faso,BF,5,0,20321383,Africa,1052,53
2020-07-20,Burkina_Faso,BF,13,0,20321383,Africa,1065,53
2020-07-21,Burkina_Faso,BF,0,0,20321383,Africa,1065,53
2020-07-22,Burkina_Faso,BF,0,0,20321383,Africa,1065,53
2020-07-23,Burkina_Faso,BF,1,0,20321383,Africa,1066,53
2020-07-24,Burkina_Faso,BF,9,0,20321383,Africa,1075,53
2020-07-25,Burkina_Faso,BF,6,0,20321383,Africa,1081,53
2020-07-26,Burkina_Faso,BF,5,0,20321383,Africa,1086,53
2020-07-27,Burkina_Faso,BF,14,0,20321383,Africa,1100,53
2020-07-28,Burkina_Faso,BF,0,0,20321383,Africa,1100,53
2020-07-29,Burkina_Faso,BF,6,0,20321383,Africa,1106,53
2020-07-30,Burkina_Faso,BF,11,0,20321383,Africa,1117,53
2020-07-31,Burkina_Faso,BF,0,0,20321383,Africa,1117,53
2020-08-01,Burkina_Faso,BF,26,0,20321383,Africa,1143,53
2020-08-02,Burkina_Faso,BF,6,0,20321383,Africa,1149,53
2020-08-03,Burkina_Faso,BF,1,0,20321383,Africa,1150,53
2020-08-04,Burkina_Faso,BF,3,1,20321383,Africa,1153,54
2020-08-05,Burkina_Faso,BF,3,0,20321383,Africa,1156,54
2020-08-06,Burkina_Faso,BF,2,0,20321383,Africa,1158,54
2020-08-07,Burkina_Faso,BF,4,0,20321383,Africa,1162,54
2020-08-08,Burkina_Faso,BF,13,0,20321383,Africa,1175,54
2020-08-09,Burkina_Faso,BF,5,0,20321383,Africa,1180,54
2020-08-10,Burkina_Faso,BF,24,0,20321383,Africa,1204,54
2020-08-11,Burkina_Faso,BF,7,0,20321383,Africa,1211,54
2020-08-12,Burkina_Faso,BF,2,0,20321383,Africa,1213,54
2020-08-13,Burkina_Faso,BF,15,0,20321383,Africa,1228,54
2020-08-14,Burkina_Faso,BF,10,0,20321383,Africa,1238,54
2020-08-15,Burkina_Faso,BF,2,0,20321383,Africa,1240,54
2020-08-16,Burkina_Faso,BF,9,0,20321383,Africa,1249,54
2020-08-17,Burkina_Faso,BF,18,1,20321383,Africa,1267,55
2020-08-18,Burkina_Faso,BF,13,0,20321383,Africa,1280,55
2020-08-19,Burkina_Faso,BF,5,0,20321383,Africa,1285,55
2020-08-20,Burkina_Faso,BF,7,0,20321383,Africa,1292,55
2020-08-21,Burkina_Faso,BF,5,0,20321383,Africa,1297,55
2020-08-22,Burkina_Faso,BF,16,0,20321383,Africa,1313,55
2020-08-23,Burkina_Faso,BF,7,0,20321383,Africa,1320,55
2020-08-24,Burkina_Faso,BF,8,0,20321383,Africa,1328,55
2020-08-25,Burkina_Faso,BF,10,0,20321383,Africa,1338,55
2020-08-26,Burkina_Faso,BF,14,0,20321383,Africa,1352,55
2020-08-27,Burkina_Faso,BF,0,0,20321383,Africa,1352,55
2020-08-28,Burkina_Faso,BF,5,0,20321383,Africa,1357,55
2020-08-29,Burkina_Faso,BF,1,0,20321383,Africa,1358,55
2020-08-30,Burkina_Faso,BF,4,0,20321383,Africa,1362,55
2020-08-31,Burkina_Faso,BF,6,0,20321383,Africa,1368,55
2020-09-01,Burkina_Faso,BF,2,0,20321383,Africa,1370,55
2020-09-02,Burkina_Faso,BF,5,0,20321383,Africa,1375,55
2020-09-03,Burkina_Faso,BF,3,0,20321383,Africa,1378,55
2020-09-04,Burkina_Faso,BF,8,0,20321383,Africa,1386,55
2020-09-05,Burkina_Faso,BF,22,0,20321383,Africa,1408,55
2020-09-06,Burkina_Faso,BF,39,0,20321383,Africa,1447,55
2020-09-07,Burkina_Faso,BF,5,0,20321383,Africa,1452,55
2020-09-08,Burkina_Faso,BF,11,1,20321383,Africa,1463,56
2020-09-09,Burkina_Faso,BF,3,0,20321383,Africa,1466,56
2020-09-10,Burkina_Faso,BF,10,0,20321383,Africa,1476,56
2020-09-11,Burkina_Faso,BF,10,0,20321383,Africa,1486,56
2020-09-12,Burkina_Faso,BF,13,0,20321383,Africa,1499,56
2020-09-13,Burkina_Faso,BF,15,0,20321383,Africa,1514,56
2020-09-14,Burkina_Faso,BF,193,0,20321383,Africa,1707,56
2020-09-15,Burkina_Faso,BF,10,0,20321383,Africa,1717,56
2020-09-16,Burkina_Faso,BF,16,0,20321383,Africa,1733,56
2020-09-17,Burkina_Faso,BF,15,0,20321383,Africa,1748,56
2020-09-18,Burkina_Faso,BF,19,0,20321383,Africa,1767,56
2020-09-19,Burkina_Faso,BF,30,0,20321383,Africa,1797,56
2020-09-20,Burkina_Faso,BF,19,0,20321383,Africa,1816,56
2020-09-21,Burkina_Faso,BF,30,0,20321383,Africa,1846,56
2020-09-22,Burkina_Faso,BF,50,0,20321383,Africa,1896,56
2020-09-23,Burkina_Faso,BF,11,0,20321383,Africa,1907,56
2020-09-24,Burkina_Faso,BF,22,0,20321383,Africa,1929,56
2020-09-25,Burkina_Faso,BF,21,0,20321383,Africa,1950,56
2020-09-26,Burkina_Faso,BF,12,0,20321383,Africa,1962,56
2020-09-27,Burkina_Faso,BF,11,0,20321383,Africa,1973,56
2020-09-28,Burkina_Faso,BF,35,0,20321383,Africa,2008,56
2020-09-29,Burkina_Faso,BF,20,1,20321383,Africa,2028,57
2020-09-30,Burkina_Faso,BF,4,1,20321383,Africa,2032,58
2020-10-01,Burkina_Faso,BF,24,0,20321383,Africa,2056,58
2020-10-02,Burkina_Faso,BF,32,0,20321383,Africa,2088,58
2020-10-03,Burkina_Faso,BF,35,0,20321383,Africa,2123,58
2020-10-04,Burkina_Faso,BF,31,1,20321383,Africa,2154,59
2020-10-05,Burkina_Faso,BF,13,0,20321383,Africa,2167,59
2020-10-06,Burkina_Faso,BF,17,0,20321383,Africa,2184,59
2020-10-07,Burkina_Faso,BF,13,0,20321383,Africa,2197,59
2020-10-08,Burkina_Faso,BF,25,0,20321383,Africa,2222,59
2020-10-09,Burkina_Faso,BF,19,1,20321383,Africa,2241,60
2020-10-10,Burkina_Faso,BF,13,0,20321383,Africa,2254,60
2020-10-11,Burkina_Faso,BF,17,1,20321383,Africa,2271,61
2020-10-12,Burkina_Faso,BF,9,2,20321383,Africa,2280,63
2020-10-13,Burkina_Faso,BF,14,0,20321383,Africa,2294,63
2020-10-14,Burkina_Faso,BF,11,0,20321383,Africa,2305,63
2020-10-15,Burkina_Faso,BF,0,0,20321383,Africa,2305,63
2020-10-16,Burkina_Faso,BF,30,2,20321383,Africa,2335,65
2020-10-17,Burkina_Faso,BF,8,0,20321383,Africa,2343,65
2020-10-18,Burkina_Faso,BF,0,0,20321383,Africa,2343,65
2020-10-19,Burkina_Faso,BF,38,0,20321383,Africa,2381,65
2020-10-20,Burkina_Faso,BF,6,0,20321383,Africa,2387,65
2020-10-21,Burkina_Faso,BF,19,0,20321383,Africa,2406,65
2020-10-22,Burkina_Faso,BF,0,0,20321383,Africa,2406,65
2020-10-23,Burkina_Faso,BF,15,0,20321383,Africa,2421,65
2020-10-24,Burkina_Faso,BF,12,0,20321383,Africa,2433,65
2020-10-25,Burkina_Faso,BF,11,0,20321383,Africa,2444,65
2020-10-26,Burkina_Faso,BF,7,0,20321383,Africa,2451,65
2020-10-27,Burkina_Faso,BF,8,2,20321383,Africa,2459,67
2020-10-28,Burkina_Faso,BF,7,0,20321383,Africa,2466,67
2020-10-29,Burkina_Faso,BF,0,0,20321383,Africa,2466,67
2020-10-30,Burkina_Faso,BF,11,0,20321383,Africa,2477,67
2020-10-31,Burkina_Faso,BF,0,0,20321383,Africa,2477,67
2020-11-01,Burkina_Faso,BF,23,0,20321383,Africa,2500,67
2020-11-02,Burkina_Faso,BF,0,0,20321383,Africa,2500,67
2020-11-03,Burkina_Faso,BF,17,0,20321383,Africa,2517,67
2020-11-04,Burkina_Faso,BF,13,0,20321383,Africa,2530,67
2020-11-05,Burkina_Faso,BF,9,0,20321383,Africa,2539,67
2020-11-06,Burkina_Faso,BF,11,0,20321383,Africa,2550,67
2020-11-07,Burkina_Faso,BF,12,0,20321383,Africa,2562,67
2020-11-08,Burkina_Faso,BF,3,0,20321383,Africa,2565,67
2020-11-09,Burkina_Faso,BF,4,0,20321383,Africa,2569,67
2020-11-10,Burkina_Faso,BF,12,0,20321383,Africa,2581,67
2020-11-11,Burkina_Faso,BF,1,0,20321383,Africa,2582,67
2020-11-12,Burkina_Faso,BF,4,0,20321383,Africa,2586,67
2020-11-13,Burkina_Faso,BF,0,0,20321383,Africa,2586,67
2020-11-14,Burkina_Faso,BF,23,1,20321383,Africa,2609,68
2020-11-15,Burkina_Faso,BF,26,0,20321383,Africa,2635,68
2020-11-16,Burkina_Faso,BF,6,0,20321383,Africa,2641,68
2020-11-17,Burkina_Faso,BF,11,0,20321383,Africa,2652,68
2020-11-18,Burkina_Faso,BF,0,0,20321383,Africa,2652,68
2020-11-19,Burkina_Faso,BF,18,0,20321383,Africa,2670,68
2020-11-20,Burkina_Faso,BF,16,0,20321383,Africa,2686,68
2020-11-21,Burkina_Faso,BF,0,0,20321383,Africa,2686,68
2020-11-22,Burkina_Faso,BF,17,0,20321383,Africa,2703,68
2020-11-23,Burkina_Faso,BF,32,0,20321383,Africa,2735,68
2020-11-24,Burkina_Faso,BF,19,0,20321383,Africa,2754,68
2020-11-25,Burkina_Faso,BF,3,0,20321383,Africa,2757,68
2020-11-26,Burkina_Faso,BF,20,0,20321383,Africa,2777,68
2020-11-27,Burkina_Faso,BF,0,0,20321383,Africa,2777,68
2020-11-28,Burkina_Faso,BF,39,0,20321383,Africa,2816,68
2020-11-29,Burkina_Faso,BF,0,0,20321383,Africa,2816,68
2020-11-30,Burkina_Faso,BF,40,0,20321383,Africa,2856,68
2020-12-01,Burkina_Faso,BF,30,0,20321383,Africa,2886,68
2020-12-02,Burkina_Faso,BF,45,0,20321383,Africa,2931,68
2020-12-03,Burkina_Faso,BF,79,0,20321383,Africa,3010,68
2020-12-04,Burkina_Faso,BF,52,0,20321383,Africa,3062,68
2020-12-05,Burkina_Faso,BF,29,0,20321383,Africa,3091,68
2020-12-06,Burkina_Faso,BF,65,0,20321383,Africa,3156,68
2020-12-07,Burkina_Faso,BF,56,0,20321383,Africa,3212,68
2020-12-08,Burkina_Faso,BF,103,0,20321383,Africa,3315,68
2020-12-09,Burkina_Faso,BF,154,1,20321383,Africa,3469,69
2020-12-10,Burkina_Faso,BF,0,0,20321383,Africa,3469,69
2020-12-11,Burkina_Faso,BF,110,0,20321383,Africa,3579,69
2020-12-12,Burkina_Faso,BF,0,0,20321383,Africa,3579,69
2020-12-13,Burkina_Faso,BF,315,2,20321383,Africa,3894,71
2020-12-14,Burkina_Faso,BF,136,0,20321383,Africa,4030,71
2020-03-08,Bulgaria,BG,2,0,7000039,Europe,2,0
2020-03-09,Bulgaria,BG,2,0,7000039,Europe,4,0
2020-03-12,Bulgaria,BG,3,1,7000039,Europe,7,1
2020-03-13,Bulgaria,BG,16,0,7000039,Europe,23,1
2020-03-14,Bulgaria,BG,8,0,7000039,Europe,31,1
2020-03-15,Bulgaria,BG,10,1,7000039,Europe,41,2
2020-03-16,Bulgaria,BG,10,0,7000039,Europe,51,2
2020-03-17,Bulgaria,BG,11,0,7000039,Europe,62,2
2020-03-18,Bulgaria,BG,19,0,7000039,Europe,81,2
2020-03-19,Bulgaria,BG,11,0,7000039,Europe,92,2
2020-03-20,Bulgaria,BG,13,1,7000039,Europe,105,3
2020-03-21,Bulgaria,BG,22,0,7000039,Europe,127,3
2020-03-22,Bulgaria,BG,36,0,7000039,Europe,163,3
2020-03-23,Bulgaria,BG,22,0,7000039,Europe,185,3
2020-03-24,Bulgaria,BG,16,0,7000039,Europe,201,3
2020-03-25,Bulgaria,BG,19,0,7000039,Europe,220,3
2020-03-26,Bulgaria,BG,22,0,7000039,Europe,242,3
2020-03-27,Bulgaria,BG,22,0,7000039,Europe,264,3
2020-03-28,Bulgaria,BG,29,0,7000039,Europe,293,3
2020-03-29,Bulgaria,BG,38,4,7000039,Europe,331,7
2020-03-30,Bulgaria,BG,15,1,7000039,Europe,346,8
2020-03-31,Bulgaria,BG,13,0,7000039,Europe,359,8
2020-04-01,Bulgaria,BG,40,0,7000039,Europe,399,8
2020-04-02,Bulgaria,BG,23,2,7000039,Europe,422,10
2020-04-03,Bulgaria,BG,35,0,7000039,Europe,457,10
2020-04-04,Bulgaria,BG,28,4,7000039,Europe,485,14
2020-04-05,Bulgaria,BG,18,3,7000039,Europe,503,17
2020-04-06,Bulgaria,BG,28,3,7000039,Europe,531,20
2020-04-07,Bulgaria,BG,18,2,7000039,Europe,549,22
2020-04-08,Bulgaria,BG,28,1,7000039,Europe,577,23
2020-04-09,Bulgaria,BG,16,1,7000039,Europe,593,24
2020-04-10,Bulgaria,BG,31,0,7000039,Europe,624,24
2020-04-11,Bulgaria,BG,11,1,7000039,Europe,635,25
2020-04-12,Bulgaria,BG,26,3,7000039,Europe,661,28
2020-04-13,Bulgaria,BG,14,1,7000039,Europe,675,29
2020-04-14,Bulgaria,BG,10,3,7000039,Europe,685,32
2020-04-15,Bulgaria,BG,28,3,7000039,Europe,713,35
2020-04-16,Bulgaria,BG,34,1,7000039,Europe,747,36
2020-04-17,Bulgaria,BG,53,2,7000039,Europe,800,38
2020-04-18,Bulgaria,BG,46,3,7000039,Europe,846,41
2020-04-19,Bulgaria,BG,32,0,7000039,Europe,878,41
2020-04-20,Bulgaria,BG,37,2,7000039,Europe,915,43
2020-04-21,Bulgaria,BG,14,0,7000039,Europe,929,43
2020-04-22,Bulgaria,BG,46,2,7000039,Europe,975,45
2020-04-23,Bulgaria,BG,49,4,7000039,Europe,1024,49
2020-04-24,Bulgaria,BG,73,3,7000039,Europe,1097,52
2020-04-25,Bulgaria,BG,91,2,7000039,Europe,1188,54
2020-04-26,Bulgaria,BG,59,1,7000039,Europe,1247,55
2020-04-27,Bulgaria,BG,53,1,7000039,Europe,1300,56
2020-04-28,Bulgaria,BG,63,2,7000039,Europe,1363,58
2020-04-29,Bulgaria,BG,36,0,7000039,Europe,1399,58
2020-04-30,Bulgaria,BG,48,6,7000039,Europe,1447,64
2020-05-01,Bulgaria,BG,59,2,7000039,Europe,1506,66
2020-05-02,Bulgaria,BG,82,3,7000039,Europe,1588,69
2020-05-03,Bulgaria,BG,6,3,7000039,Europe,1594,72
2020-05-04,Bulgaria,BG,24,1,7000039,Europe,1618,73
2020-05-05,Bulgaria,BG,34,5,7000039,Europe,1652,78
2020-05-06,Bulgaria,BG,37,0,7000039,Europe,1689,78
2020-05-07,Bulgaria,BG,89,6,7000039,Europe,1778,84
2020-05-08,Bulgaria,BG,51,0,7000039,Europe,1829,84
2020-05-09,Bulgaria,BG,82,4,7000039,Europe,1911,88
2020-05-10,Bulgaria,BG,44,2,7000039,Europe,1955,90
2020-05-11,Bulgaria,BG,10,1,7000039,Europe,1965,91
2020-05-12,Bulgaria,BG,25,2,7000039,Europe,1990,93
2020-05-13,Bulgaria,BG,33,2,7000039,Europe,2023,95
2020-05-14,Bulgaria,BG,46,1,7000039,Europe,2069,96
2020-05-15,Bulgaria,BG,31,3,7000039,Europe,2100,99
2020-05-16,Bulgaria,BG,38,3,7000039,Europe,2138,102
2020-05-17,Bulgaria,BG,73,6,7000039,Europe,2211,108
2020-05-18,Bulgaria,BG,24,2,7000039,Europe,2235,110
2020-05-19,Bulgaria,BG,24,2,7000039,Europe,2259,112
2020-05-20,Bulgaria,BG,33,4,7000039,Europe,2292,116
2020-05-21,Bulgaria,BG,39,4,7000039,Europe,2331,120
2020-05-22,Bulgaria,BG,41,5,7000039,Europe,2372,125
2020-05-23,Bulgaria,BG,36,1,7000039,Europe,2408,126
2020-05-24,Bulgaria,BG,0,0,7000039,Europe,2408,126
2020-05-25,Bulgaria,BG,25,4,7000039,Europe,2433,130
2020-05-26,Bulgaria,BG,0,0,7000039,Europe,2433,130
2020-05-27,Bulgaria,BG,27,3,7000039,Europe,2460,133
2020-05-28,Bulgaria,BG,0,0,7000039,Europe,2460,133
2020-05-29,Bulgaria,BG,25,3,7000039,Europe,2485,136
2020-05-30,Bulgaria,BG,14,3,7000039,Europe,2499,139
2020-05-31,Bulgaria,BG,14,1,7000039,Europe,2513,140
2020-06-01,Bulgaria,BG,0,0,7000039,Europe,2513,140
2020-06-02,Bulgaria,BG,0,4,7000039,Europe,2513,144
2020-06-03,Bulgaria,BG,25,0,7000039,Europe,2538,144
2020-06-04,Bulgaria,BG,47,3,7000039,Europe,2585,147
2020-06-05,Bulgaria,BG,0,0,7000039,Europe,2585,147
2020-06-06,Bulgaria,BG,83,13,7000039,Europe,2668,160
2020-06-07,Bulgaria,BG,43,0,7000039,Europe,2711,160
2020-06-08,Bulgaria,BG,16,0,7000039,Europe,2727,160
2020-06-09,Bulgaria,BG,83,4,7000039,Europe,2810,164
2020-06-10,Bulgaria,BG,79,3,7000039,Europe,2889,167
2020-06-11,Bulgaria,BG,104,0,7000039,Europe,2993,167
2020-06-12,Bulgaria,BG,93,1,7000039,Europe,3086,168
2020-06-13,Bulgaria,BG,105,4,7000039,Europe,3191,172
2020-06-14,Bulgaria,BG,75,0,7000039,Europe,3266,172
2020-06-15,Bulgaria,BG,24,2,7000039,Europe,3290,174
2020-06-16,Bulgaria,BG,51,2,7000039,Europe,3341,176
2020-06-17,Bulgaria,BG,112,5,7000039,Europe,3453,181
2020-06-18,Bulgaria,BG,89,3,7000039,Europe,3542,184
2020-06-19,Bulgaria,BG,132,6,7000039,Europe,3674,190
2020-06-20,Bulgaria,BG,81,3,7000039,Europe,3755,193
2020-06-21,Bulgaria,BG,117,6,7000039,Europe,3872,199
2020-06-22,Bulgaria,BG,33,0,7000039,Europe,3905,199
2020-06-23,Bulgaria,BG,79,8,7000039,Europe,3984,207
2020-06-24,Bulgaria,BG,130,1,7000039,Europe,4114,208
2020-06-25,Bulgaria,BG,128,1,7000039,Europe,4242,209
2020-06-26,Bulgaria,BG,166,2,7000039,Europe,4408,211
2020-06-27,Bulgaria,BG,105,4,7000039,Europe,4513,215
2020-06-28,Bulgaria,BG,112,1,7000039,Europe,4625,216
2020-06-29,Bulgaria,BG,66,3,7000039,Europe,4691,219
2020-06-30,Bulgaria,BG,140,4,7000039,Europe,4831,223
2020-07-01,Bulgaria,BG,158,7,7000039,Europe,4989,230
2020-07-02,Bulgaria,BG,165,2,7000039,Europe,5154,232
2020-07-03,Bulgaria,BG,161,0,7000039,Europe,5315,232
2020-07-04,Bulgaria,BG,182,7,7000039,Europe,5497,239
2020-07-05,Bulgaria,BG,180,2,7000039,Europe,5677,241
2020-07-06,Bulgaria,BG,63,5,7000039,Europe,5740,246
2020-07-07,Bulgaria,BG,174,4,7000039,Europe,5914,250
2020-07-08,Bulgaria,BG,188,4,7000039,Europe,6102,254
2020-07-09,Bulgaria,BG,240,5,7000039,Europe,6342,259
2020-07-10,Bulgaria,BG,330,3,7000039,Europe,6672,262
2020-07-11,Bulgaria,BG,292,0,7000039,Europe,6964,262
2020-07-12,Bulgaria,BG,211,0,7000039,Europe,7175,262
2020-07-13,Bulgaria,BG,77,6,7000039,Europe,7252,268
2020-07-14,Bulgaria,BG,159,8,7000039,Europe,7411,276
2020-07-15,Bulgaria,BG,234,7,7000039,Europe,7645,283
2020-07-16,Bulgaria,BG,232,6,7000039,Europe,7877,289
2020-07-17,Bulgaria,BG,267,4,7000039,Europe,8144,293
2020-07-18,Bulgaria,BG,298,4,7000039,Europe,8442,297
2020-07-19,Bulgaria,BG,196,2,7000039,Europe,8638,299
2020-07-20,Bulgaria,BG,95,1,7000039,Europe,8733,300
2020-07-21,Bulgaria,BG,196,8,7000039,Europe,8929,308
2020-07-22,Bulgaria,BG,325,5,7000039,Europe,9254,313
2020-07-23,Bulgaria,BG,330,8,7000039,Europe,9584,321
2020-07-24,Bulgaria,BG,269,8,7000039,Europe,9853,329
2020-07-25,Bulgaria,BG,270,8,7000039,Europe,10123,337
2020-07-26,Bulgaria,BG,189,1,7000039,Europe,10312,338
2020-07-27,Bulgaria,BG,115,2,7000039,Europe,10427,340
2020-07-28,Bulgaria,BG,194,7,7000039,Europe,10621,347
2020-07-29,Bulgaria,BG,250,8,7000039,Europe,10871,355
2020-07-30,Bulgaria,BG,284,13,7000039,Europe,11155,368
2020-07-31,Bulgaria,BG,265,6,7000039,Europe,11420,374
2020-08-01,Bulgaria,BG,270,9,7000039,Europe,11690,383
2020-08-02,Bulgaria,BG,146,2,7000039,Europe,11836,385
2020-08-03,Bulgaria,BG,119,3,7000039,Europe,11955,388
2020-08-04,Bulgaria,BG,0,0,7000039,Europe,11955,388
2020-08-05,Bulgaria,BG,204,16,7000039,Europe,12159,404
2020-08-06,Bulgaria,BG,255,11,7000039,Europe,12414,415
2020-08-07,Bulgaria,BG,303,9,7000039,Europe,12717,424
2020-08-08,Bulgaria,BG,297,11,7000039,Europe,13014,435
2020-08-09,Bulgaria,BG,329,10,7000039,Europe,13343,445
2020-08-10,Bulgaria,BG,53,2,7000039,Europe,13396,447
2020-08-11,Bulgaria,BG,116,12,7000039,Europe,13512,459
2020-08-12,Bulgaria,BG,210,12,7000039,Europe,13722,471
2020-08-13,Bulgaria,BG,171,11,7000039,Europe,13893,482
2020-08-14,Bulgaria,BG,176,2,7000039,Europe,14069,484
2020-08-15,Bulgaria,BG,174,8,7000039,Europe,14243,492
2020-08-16,Bulgaria,BG,90,3,7000039,Europe,14333,495
2020-08-17,Bulgaria,BG,32,3,7000039,Europe,14365,498
2020-08-18,Bulgaria,BG,135,14,7000039,Europe,14500,512
2020-08-19,Bulgaria,BG,169,7,7000039,Europe,14669,519
2020-08-20,Bulgaria,BG,151,8,7000039,Europe,14820,527
2020-08-21,Bulgaria,BG,142,5,7000039,Europe,14962,532
2020-08-22,Bulgaria,BG,169,7,7000039,Europe,15131,539
2020-08-23,Bulgaria,BG,96,6,7000039,Europe,15227,545
2020-08-24,Bulgaria,BG,60,0,7000039,Europe,15287,545
2020-08-25,Bulgaria,BG,99,18,7000039,Europe,15386,563
2020-08-26,Bulgaria,BG,203,9,7000039,Europe,15589,572
2020-08-27,Bulgaria,BG,162,14,7000039,Europe,15751,586
2020-08-28,Bulgaria,BG,157,8,7000039,Europe,15908,594
2020-08-29,Bulgaria,BG,157,9,7000039,Europe,16065,603
2020-08-30,Bulgaria,BG,99,2,7000039,Europe,16164,605
2020-08-31,Bulgaria,BG,26,8,7000039,Europe,16190,613
2020-09-01,Bulgaria,BG,76,16,7000039,Europe,16266,629
2020-09-02,Bulgaria,BG,0,0,7000039,Europe,16266,629
2020-09-03,Bulgaria,BG,188,13,7000039,Europe,16454,642
2020-09-04,Bulgaria,BG,163,6,7000039,Europe,16617,648
2020-09-05,Bulgaria,BG,158,10,7000039,Europe,16775,658
2020-09-06,Bulgaria,BG,179,7,7000039,Europe,16954,665
2020-09-07,Bulgaria,BG,96,6,7000039,Europe,17050,671
2020-09-08,Bulgaria,BG,96,6,7000039,Europe,17146,677
2020-09-09,Bulgaria,BG,167,15,7000039,Europe,17313,692
2020-09-10,Bulgaria,BG,122,10,7000039,Europe,17435,702
2020-09-11,Bulgaria,BG,163,4,7000039,Europe,17598,706
2020-09-12,Bulgaria,BG,201,7,7000039,Europe,17799,713
2020-09-13,Bulgaria,BG,92,4,7000039,Europe,17891,717
2020-09-14,Bulgaria,BG,27,3,7000039,Europe,17918,720
2020-09-15,Bulgaria,BG,143,10,7000039,Europe,18061,730
2020-09-16,Bulgaria,BG,155,6,7000039,Europe,18216,736
2020-09-17,Bulgaria,BG,174,8,7000039,Europe,18390,744
2020-09-18,Bulgaria,BG,154,0,7000039,Europe,18544,744
2020-09-19,Bulgaria,BG,189,9,7000039,Europe,18733,753
2020-09-20,Bulgaria,BG,86,2,7000039,Europe,18819,755
2020-09-21,Bulgaria,BG,44,6,7000039,Europe,18863,761
2020-09-22,Bulgaria,BG,151,4,7000039,Europe,19014,765
2020-09-23,Bulgaria,BG,109,2,7000039,Europe,19123,767
2020-09-24,Bulgaria,BG,160,12,7000039,Europe,19283,779
2020-09-25,Bulgaria,BG,290,6,7000039,Europe,19573,785
2020-09-26,Bulgaria,BG,255,4,7000039,Europe,19828,789
2020-09-27,Bulgaria,BG,169,0,7000039,Europe,19997,789
2020-09-28,Bulgaria,BG,58,7,7000039,Europe,20055,796
2020-09-29,Bulgaria,BG,216,11,7000039,Europe,20271,807
2020-09-30,Bulgaria,BG,276,7,7000039,Europe,20547,814
2020-10-01,Bulgaria,BG,286,11,7000039,Europe,20833,825
2020-10-02,Bulgaria,BG,263,7,7000039,Europe,21096,832
2020-10-03,Bulgaria,BG,240,6,7000039,Europe,21336,838
2020-10-04,Bulgaria,BG,182,3,7000039,Europe,21518,841
2020-10-05,Bulgaria,BG,69,3,7000039,Europe,21587,844
2020-10-06,Bulgaria,BG,283,10,7000039,Europe,21870,854
2020-10-07,Bulgaria,BG,436,8,7000039,Europe,22306,862
2020-10-08,Bulgaria,BG,437,11,7000039,Europe,22743,873
2020-10-09,Bulgaria,BG,516,7,7000039,Europe,23259,880
2020-10-10,Bulgaria,BG,612,7,7000039,Europe,23871,887
2020-10-11,Bulgaria,BG,0,0,7000039,Europe,23871,887
2020-10-12,Bulgaria,BG,531,5,7000039,Europe,24402,892
2020-10-13,Bulgaria,BG,587,23,7000039,Europe,24989,915
2020-10-14,Bulgaria,BG,785,8,7000039,Europe,25774,923
2020-10-15,Bulgaria,BG,819,6,7000039,Europe,26593,929
2020-10-16,Bulgaria,BG,914,15,7000039,Europe,27507,944
2020-10-17,Bulgaria,BG,998,14,7000039,Europe,28505,958
2020-10-18,Bulgaria,BG,603,10,7000039,Europe,29108,968
2020-10-19,Bulgaria,BG,395,18,7000039,Europe,29503,986
2020-10-20,Bulgaria,BG,1024,22,7000039,Europe,30527,1008
2020-10-21,Bulgaria,BG,1336,11,7000039,Europe,31863,1019
2020-10-22,Bulgaria,BG,1472,29,7000039,Europe,33335,1048
2020-10-23,Bulgaria,BG,1595,16,7000039,Europe,34930,1064
2020-10-24,Bulgaria,BG,1589,13,7000039,Europe,36519,1077
2020-10-25,Bulgaria,BG,1043,7,7000039,Europe,37562,1084
2020-10-26,Bulgaria,BG,327,10,7000039,Europe,37889,1094
2020-10-27,Bulgaria,BG,2243,42,7000039,Europe,40132,1136
2020-10-28,Bulgaria,BG,2569,25,7000039,Europe,42701,1161
2020-10-29,Bulgaria,BG,2760,36,7000039,Europe,45461,1197
2020-10-30,Bulgaria,BG,2689,28,7000039,Europe,48150,1225
2020-10-31,Bulgaria,BG,2891,29,7000039,Europe,51041,1254
2020-11-01,Bulgaria,BG,1803,25,7000039,Europe,52844,1279
2020-11-02,Bulgaria,BG,1225,19,7000039,Europe,54069,1298
2020-11-03,Bulgaria,BG,2427,51,7000039,Europe,56496,1349
2020-11-04,Bulgaria,BG,4041,63,7000039,Europe,60537,1412
2020-11-05,Bulgaria,BG,4054,54,7000039,Europe,64591,1466
2020-11-06,Bulgaria,BG,3754,52,7000039,Europe,68345,1518
2020-11-07,Bulgaria,BG,3839,58,7000039,Europe,72184,1576
2020-11-08,Bulgaria,BG,2301,56,7000039,Europe,74485,1632
2020-11-09,Bulgaria,BG,675,33,7000039,Europe,75160,1665
2020-11-10,Bulgaria,BG,3816,106,7000039,Europe,78976,1771
2020-11-11,Bulgaria,BG,4390,80,7000039,Europe,83366,1851
2020-11-12,Bulgaria,BG,3945,47,7000039,Europe,87311,1898
2020-11-13,Bulgaria,BG,3414,72,7000039,Europe,90725,1970
2020-11-14,Bulgaria,BG,4212,85,7000039,Europe,94937,2055
2020-11-15,Bulgaria,BG,2498,36,7000039,Europe,97435,2091
2020-11-16,Bulgaria,BG,816,39,7000039,Europe,98251,2130
2020-11-17,Bulgaria,BG,3519,152,7000039,Europe,101770,2282
2020-11-18,Bulgaria,BG,4828,131,7000039,Europe,106598,2413
2020-11-19,Bulgaria,BG,3938,117,7000039,Europe,110536,2530
2020-11-20,Bulgaria,BG,3899,119,7000039,Europe,114435,2649
2020-11-21,Bulgaria,BG,3983,129,7000039,Europe,118418,2778
2020-11-22,Bulgaria,BG,2279,42,7000039,Europe,120697,2820
2020-11-23,Bulgaria,BG,1123,60,7000039,Europe,121820,2880
2020-11-24,Bulgaria,BG,3146,189,7000039,Europe,124966,3069
2020-11-25,Bulgaria,BG,4382,157,7000039,Europe,129348,3226
2020-11-26,Bulgaria,BG,3712,141,7000039,Europe,133060,3367
2020-11-27,Bulgaria,BG,3568,162,7000039,Europe,136628,3529
2020-11-28,Bulgaria,BG,3327,151,7000039,Europe,139955,3680
2020-11-29,Bulgaria,BG,1792,69,7000039,Europe,141747,3749
2020-11-30,Bulgaria,BG,739,65,7000039,Europe,142486,3814
2020-12-01,Bulgaria,BG,2814,221,7000039,Europe,145300,4035
2020-12-02,Bulgaria,BG,3475,153,7000039,Europe,148775,4188
2020-12-03,Bulgaria,BG,3138,159,7000039,Europe,151913,4347
2020-12-04,Bulgaria,BG,3280,156,7000039,Europe,155193,4503
2020-12-05,Bulgaria,BG,3614,147,7000039,Europe,158807,4650
2020-12-06,Bulgaria,BG,2037,79,7000039,Europe,160844,4729
2020-12-07,Bulgaria,BG,577,68,7000039,Europe,161421,4797
2020-12-08,Bulgaria,BG,2764,213,7000039,Europe,164185,5010
2020-12-09,Bulgaria,BG,3980,146,7000039,Europe,168165,5156
2020-12-10,Bulgaria,BG,3328,127,7000039,Europe,171493,5283
2020-12-11,Bulgaria,BG,3075,122,7000039,Europe,174568,5405
2020-12-12,Bulgaria,BG,3097,157,7000039,Europe,177665,5562
2020-12-13,Bulgaria,BG,1287,64,7000039,Europe,178952,5626
2020-12-14,Bulgaria,BG,497,62,7000039,Europe,179449,5688
2019-12-31,Bahrain,BH,0,0,1641164,Asia,0,0
2020-01-01,Bahrain,BH,0,0,1641164,Asia,0,0
2020-01-02,Bahrain,BH,0,0,1641164,Asia,0,0
2020-01-03,Bahrain,BH,0,0,1641164,Asia,0,0
2020-01-04,Bahrain,BH,0,0,1641164,Asia,0,0
2020-01-05,Bahrain,BH,0,0,1641164,Asia,0,0
2020-01-06,Bahrain,BH,0,0,1641164,Asia,0,0
2020-01-07,Bahrain,BH,0,0,1641164,Asia,0,0
2020-01-08,Bahrain,BH,0,0,1641164,Asia,0,0
2020-01-09,Bahrain,BH,0,0,1641164,Asia,0,0
2020-01-10,Bahrain,BH,0,0,1641164,Asia,0,0
2020-01-11,Bahrain,BH,0,0,1641164,Asia,0,0
2020-01-12,Bahrain,BH,0,0,1641164,Asia,0,0
2020-01-13,Bahrain,BH,0,0,1641164,Asia,0,0
2020-01-14,Bahrain,BH,0,0,1641164,Asia,0,0
2020-01-15,Bahrain,BH,0,0,1641164,Asia,0,0
2020-01-16,Bahrain,BH,0,0,1641164,Asia,0,0
2020-01-17,Bahrain,BH,0,0,1641164,Asia,0,0
2020-01-18,Bahrain,BH,0,0,1641164,Asia,0,0
2020-01-19,Bahrain,BH,0,0,1641164,Asia,0,0
2020-01-20,Bahrain,BH,0,0,1641164,Asia,0,0
2020-01-21,Bahrain,BH,0,0,1641164,Asia,0,0
2020-01-22,Bahrain,BH,0,0,1641164,Asia,0,0
2020-01-23,Bahrain,BH,0,0,1641164,Asia,0,0
2020-01-24,Bahrain,BH,0,0,1641164,Asia,0,0
2020-01-25,Bahrain,BH,0,0,1641164,Asia,0,0
2020-01-26,Bahrain,BH,0,0,1641164,Asia,0,0
2020-01-27,Bahrain,BH,0,0,1641164,Asia,0,0
2020-01-28,Bahrain,BH,0,0,1641164,Asia,0,0
2020-01-29,Bahrain,BH,0,0,1641164,Asia,0,0
2020-01-30,Bahrain,BH,0,0,1641164,Asia,0,0
2020-01-31,Bahrain,BH,0,0,1641164,Asia,0,0
2020-02-01,Bahrain,BH,0,0,1641164,Asia,0,0
2020-02-02,Bahrain,BH,0,0,1641164,Asia,0,0
2020-02-03,Bahrain,BH,0,0,1641164,Asia,0,0
2020-02-04,Bahrain,BH,0,0,1641164,Asia,0,0
2020-02-05,Bahrain,BH,0,0,1641164,Asia,0,0
2020-02-06,Bahrain,BH,0,0,1641164,Asia,0,0
2020-02-07,Bahrain,BH,0,0,1641164,Asia,0,0
2020-02-08,Bahrain,BH,0,0,1641164,Asia,0,0
2020-02-09,Bahrain,BH,0,0,1641164,Asia,0,0
2020-02-10,Bahrain,BH,0,0,1641164,Asia,0,0
2020-02-11,Bahrain,BH,0,0,1641164,Asia,0,0
2020-02-12,Bahrain,BH,0,0,1641164,Asia,0,0
2020-02-13,Bahrain,BH,0,0,1641164,Asia,0,0
2020-02-14,Bahrain,BH,0,0,1641164,Asia,0,0
2020-02-15,Bahrain,BH,0,0,1641164,Asia,0,0
2020-02-16,Bahrain,BH,0,0,1641164,Asia,0,0
2020-02-17,Bahrain,BH,0,0,1641164,Asia,0,0
2020-02-18,Bahrain,BH,0,0,1641164,Asia,0,0
2020-02-19,Bahrain,BH,0,0,1641164,Asia,0,0
2020-02-20,Bahrain,BH,0,0,1641164,Asia,0,0
2020-02-21,Bahrain,BH,0,0,1641164,Asia,0,0
2020-02-22,Bahrain,BH,0,0,1641164,Asia,0,0
2020-02-23,Bahrain,BH,0,0,1641164,Asia,0,0
2020-02-24,Bahrain,BH,1,0,1641164,Asia,1,0
2020-02-25,Bahrain,BH,1,0,1641164,Asia,2,0
2020-02-26,Bahrain,BH,21,0,1641164,Asia,23,0
2020-02-27,Bahrain,BH,10,0,1641164,Asia,33,0
2020-02-28,Bahrain,BH,0,0,1641164,Asia,33,0
2020-02-29,Bahrain,BH,5,0,1641164,Asia,38,0
2020-03-01,Bahrain,BH,3,0,1641164,Asia,41,0
2020-03-02,Bahrain,BH,6,0,1641164,Asia,47,0
2020-03-04,Bahrain,BH,2,0,1641164,Asia,49,0
2020-03-05,Bahrain,BH,3,0,1641164,Asia,52,0
2020-03-06,Bahrain,BH,0,0,1641164,Asia,52,0
2020-03-07,Bahrain,BH,4,0,1641164,Asia,56,0
2020-03-08,Bahrain,BH,7,0,1641164,Asia,63,0
2020-03-09,Bahrain,BH,16,0,1641164,Asia,79,0
2020-03-10,Bahrain,BH,30,0,1641164,Asia,109,0
2020-03-11,Bahrain,BH,1,0,1641164,Asia,110,0
2020-03-12,Bahrain,BH,52,0,1641164,Asia,162,0
2020-03-13,Bahrain,BH,0,0,1641164,Asia,162,0
2020-03-14,Bahrain,BH,48,0,1641164,Asia,210,0
2020-03-15,Bahrain,BH,1,0,1641164,Asia,211,0
2020-03-16,Bahrain,BH,3,0,1641164,Asia,214,0
2020-03-17,Bahrain,BH,7,1,1641164,Asia,221,1
2020-03-18,Bahrain,BH,16,0,1641164,Asia,237,1
2020-03-19,Bahrain,BH,19,0,1641164,Asia,256,1
2020-03-20,Bahrain,BH,13,0,1641164,Asia,269,1
2020-03-21,Bahrain,BH,16,0,1641164,Asia,285,1
2020-03-22,Bahrain,BH,21,0,1641164,Asia,306,1
2020-03-23,Bahrain,BH,28,1,1641164,Asia,334,2
2020-03-24,Bahrain,BH,5,0,1641164,Asia,339,2
2020-03-25,Bahrain,BH,51,1,1641164,Asia,390,3
2020-03-26,Bahrain,BH,29,0,1641164,Asia,419,3
2020-03-27,Bahrain,BH,39,1,1641164,Asia,458,4
2020-03-28,Bahrain,BH,8,0,1641164,Asia,466,4
2020-03-29,Bahrain,BH,7,0,1641164,Asia,473,4
2020-03-30,Bahrain,BH,27,0,1641164,Asia,500,4
2020-03-31,Bahrain,BH,15,0,1641164,Asia,515,4
2020-04-01,Bahrain,BH,52,0,1641164,Asia,567,4
2020-04-02,Bahrain,BH,2,0,1641164,Asia,569,4
2020-04-03,Bahrain,BH,74,0,1641164,Asia,643,4
2020-04-04,Bahrain,BH,0,0,1641164,Asia,643,4
2020-04-05,Bahrain,BH,45,0,1641164,Asia,688,4
2020-04-06,Bahrain,BH,12,0,1641164,Asia,700,4
2020-04-07,Bahrain,BH,56,0,1641164,Asia,756,4
2020-04-08,Bahrain,BH,55,1,1641164,Asia,811,5
2020-04-09,Bahrain,BH,12,0,1641164,Asia,823,5
2020-04-10,Bahrain,BH,64,0,1641164,Asia,887,5
2020-04-11,Bahrain,BH,111,1,1641164,Asia,998,6
2020-04-12,Bahrain,BH,42,0,1641164,Asia,1040,6
2020-04-13,Bahrain,BH,96,0,1641164,Asia,1136,6
2020-04-14,Bahrain,BH,225,1,1641164,Asia,1361,7
2020-04-15,Bahrain,BH,167,0,1641164,Asia,1528,7
2020-04-16,Bahrain,BH,145,0,1641164,Asia,1673,7
2020-04-17,Bahrain,BH,27,0,1641164,Asia,1700,7
2020-04-18,Bahrain,BH,44,0,1641164,Asia,1744,7
2020-04-19,Bahrain,BH,29,0,1641164,Asia,1773,7
2020-04-20,Bahrain,BH,100,0,1641164,Asia,1873,7
2020-04-21,Bahrain,BH,34,0,1641164,Asia,1907,7
2020-04-22,Bahrain,BH,66,0,1641164,Asia,1973,7
2020-04-23,Bahrain,BH,34,0,1641164,Asia,2007,7
2020-04-24,Bahrain,BH,210,1,1641164,Asia,2217,8
2020-04-25,Bahrain,BH,301,0,1641164,Asia,2518,8
2020-04-26,Bahrain,BH,71,0,1641164,Asia,2589,8
2020-04-27,Bahrain,BH,58,0,1641164,Asia,2647,8
2020-04-28,Bahrain,BH,76,0,1641164,Asia,2723,8
2020-04-29,Bahrain,BH,88,0,1641164,Asia,2811,8
2020-04-30,Bahrain,BH,110,0,1641164,Asia,2921,8
2020-05-01,Bahrain,BH,119,0,1641164,Asia,3040,8
2020-05-02,Bahrain,BH,130,0,1641164,Asia,3170,8
2020-05-03,Bahrain,BH,114,0,1641164,Asia,3284,8
2020-05-04,Bahrain,BH,99,0,1641164,Asia,3383,8
2020-05-05,Bahrain,BH,150,0,1641164,Asia,3533,8
2020-05-06,Bahrain,BH,187,0,1641164,Asia,3720,8
2020-05-07,Bahrain,BH,214,0,1641164,Asia,3934,8
2020-05-08,Bahrain,BH,265,0,1641164,Asia,4199,8
2020-05-09,Bahrain,BH,245,0,1641164,Asia,4444,8
2020-05-10,Bahrain,BH,330,0,1641164,Asia,4774,8
2020-05-11,Bahrain,BH,167,0,1641164,Asia,4941,8
2020-05-12,Bahrain,BH,295,0,1641164,Asia,5236,8
2020-05-13,Bahrain,BH,295,1,1641164,Asia,5531,9
2020-05-14,Bahrain,BH,285,1,1641164,Asia,5816,10
2020-05-15,Bahrain,BH,382,0,1641164,Asia,6198,10
2020-05-16,Bahrain,BH,385,2,1641164,Asia,6583,12
2020-05-17,Bahrain,BH,164,0,1641164,Asia,6747,12
2020-05-18,Bahrain,BH,209,0,1641164,Asia,6956,12
2020-05-19,Bahrain,BH,228,0,1641164,Asia,7184,12
2020-05-20,Bahrain,BH,348,0,1641164,Asia,7532,12
2020-05-21,Bahrain,BH,356,0,1641164,Asia,7888,12
2020-05-22,Bahrain,BH,286,0,1641164,Asia,8174,12
2020-05-23,Bahrain,BH,240,0,1641164,Asia,8414,12
2020-05-24,Bahrain,BH,388,1,1641164,Asia,8802,13
2020-05-25,Bahrain,BH,336,1,1641164,Asia,9138,14
2020-05-26,Bahrain,BH,33,0,1641164,Asia,9171,14
2020-05-27,Bahrain,BH,195,0,1641164,Asia,9366,14
2020-05-28,Bahrain,BH,267,1,1641164,Asia,9633,15
2020-05-29,Bahrain,BH,419,0,1641164,Asia,10052,15
2020-05-30,Bahrain,BH,397,0,1641164,Asia,10449,15
2020-05-31,Bahrain,BH,344,2,1641164,Asia,10793,17
2020-06-01,Bahrain,BH,605,2,1641164,Asia,11398,19
2020-06-02,Bahrain,BH,406,0,1641164,Asia,11804,19
2020-06-03,Bahrain,BH,507,0,1641164,Asia,12311,19
2020-06-04,Bahrain,BH,504,1,1641164,Asia,12815,20
2020-06-05,Bahrain,BH,481,1,1641164,Asia,13296,21
2020-06-06,Bahrain,BH,539,2,1641164,Asia,13835,23
2020-06-07,Bahrain,BH,548,1,1641164,Asia,14383,24
2020-06-08,Bahrain,BH,380,2,1641164,Asia,14763,26
2020-06-09,Bahrain,BH,654,1,1641164,Asia,15417,27
2020-06-10,Bahrain,BH,783,2,1641164,Asia,16200,29
2020-06-11,Bahrain,BH,467,3,1641164,Asia,16667,32
2020-06-12,Bahrain,BH,0,2,1641164,Asia,16667,34
2020-06-13,Bahrain,BH,1046,2,1641164,Asia,17713,36
2020-06-14,Bahrain,BH,514,3,1641164,Asia,18227,39
2020-06-15,Bahrain,BH,317,4,1641164,Asia,18544,43
2020-06-16,Bahrain,BH,469,3,1641164,Asia,19013,46
2020-06-17,Bahrain,BH,540,1,1641164,Asia,19553,47
2020-06-18,Bahrain,BH,408,2,1641164,Asia,19961,49
2020-06-19,Bahrain,BH,469,6,1641164,Asia,20430,55
2020-06-20,Bahrain,BH,486,2,1641164,Asia,20916,57
2020-06-21,Bahrain,BH,415,3,1641164,Asia,21331,60
2020-06-22,Bahrain,BH,433,3,1641164,Asia,21764,63
2020-06-23,Bahrain,BH,643,2,1641164,Asia,22407,65
2020-06-24,Bahrain,BH,655,2,1641164,Asia,23062,67
2020-06-25,Bahrain,BH,508,2,1641164,Asia,23570,69
2020-06-26,Bahrain,BH,511,2,1641164,Asia,24081,71
2020-06-27,Bahrain,BH,724,7,1641164,Asia,24805,78
2020-06-28,Bahrain,BH,462,0,1641164,Asia,25267,78
2020-06-29,Bahrain,BH,438,5,1641164,Asia,25705,83
2020-06-30,Bahrain,BH,534,1,1641164,Asia,26239,84
2020-07-01,Bahrain,BH,519,3,1641164,Asia,26758,87
2020-07-02,Bahrain,BH,656,5,1641164,Asia,27414,92
2020-07-03,Bahrain,BH,423,2,1641164,Asia,27837,94
2020-07-04,Bahrain,BH,573,1,1641164,Asia,28410,95
2020-07-05,Bahrain,BH,447,2,1641164,Asia,28857,97
2020-07-06,Bahrain,BH,510,0,1641164,Asia,29367,97
2020-07-07,Bahrain,BH,454,1,1641164,Asia,29821,98
2020-07-08,Bahrain,BH,500,0,1641164,Asia,30321,98
2020-07-09,Bahrain,BH,610,2,1641164,Asia,30931,100
2020-07-10,Bahrain,BH,597,3,1641164,Asia,31528,103
2020-07-11,Bahrain,BH,511,1,1641164,Asia,32039,104
2020-07-12,Bahrain,BH,431,0,1641164,Asia,32470,104
2020-07-13,Bahrain,BH,471,5,1641164,Asia,32941,109
2020-07-14,Bahrain,BH,535,0,1641164,Asia,33476,109
2020-07-15,Bahrain,BH,602,2,1641164,Asia,34078,111
2020-07-16,Bahrain,BH,482,6,1641164,Asia,34560,117
2020-07-17,Bahrain,BH,524,4,1641164,Asia,35084,121
2020-07-18,Bahrain,BH,389,3,1641164,Asia,35473,124
2020-07-19,Bahrain,BH,531,0,1641164,Asia,36004,124
2020-07-20,Bahrain,BH,418,2,1641164,Asia,36422,126
2020-07-21,Bahrain,BH,514,2,1641164,Asia,36936,128
2020-07-22,Bahrain,BH,380,1,1641164,Asia,37316,129
2020-07-23,Bahrain,BH,321,1,1641164,Asia,37637,130
2020-07-24,Bahrain,BH,359,4,1641164,Asia,37996,134
2020-07-25,Bahrain,BH,462,2,1641164,Asia,38458,136
2020-07-26,Bahrain,BH,289,1,1641164,Asia,38747,137
2020-07-27,Bahrain,BH,384,3,1641164,Asia,39131,140
2020-07-28,Bahrain,BH,351,1,1641164,Asia,39482,141
2020-07-29,Bahrain,BH,439,0,1641164,Asia,39921,141
2020-07-30,Bahrain,BH,390,3,1641164,Asia,40311,144
2020-07-31,Bahrain,BH,444,2,1641164,Asia,40755,146
2020-08-01,Bahrain,BH,227,1,1641164,Asia,40982,147
2020-08-02,Bahrain,BH,208,0,1641164,Asia,41190,147
2020-08-03,Bahrain,BH,346,0,1641164,Asia,41536,147
2020-08-04,Bahrain,BH,299,3,1641164,Asia,41835,150
2020-08-05,Bahrain,BH,297,1,1641164,Asia,42132,151
2020-08-06,Bahrain,BH,382,3,1641164,Asia,42514,154
2020-08-07,Bahrain,BH,375,2,1641164,Asia,42889,156
2020-08-08,Bahrain,BH,418,3,1641164,Asia,43307,159
2020-08-09,Bahrain,BH,322,2,1641164,Asia,43629,161
2020-08-10,Bahrain,BH,382,1,1641164,Asia,44011,162
2020-08-11,Bahrain,BH,386,1,1641164,Asia,44397,163
2020-08-12,Bahrain,BH,407,2,1641164,Asia,44804,165
2020-08-13,Bahrain,BH,460,1,1641164,Asia,45264,166
2020-08-14,Bahrain,BH,462,1,1641164,Asia,45726,167
2020-08-15,Bahrain,BH,326,1,1641164,Asia,46052,168
2020-08-16,Bahrain,BH,378,2,1641164,Asia,46430,170
2020-08-17,Bahrain,BH,0,0,1641164,Asia,46430,170
2020-08-18,Bahrain,BH,755,3,1641164,Asia,47185,173
2020-08-19,Bahrain,BH,0,2,1641164,Asia,47185,175
2020-08-20,Bahrain,BH,0,0,1641164,Asia,47185,175
2020-08-21,Bahrain,BH,765,4,1641164,Asia,47950,179
2020-08-22,Bahrain,BH,353,0,1641164,Asia,48303,179
2020-08-23,Bahrain,BH,735,4,1641164,Asia,49038,183
2020-08-24,Bahrain,BH,0,1,1641164,Asia,49038,184
2020-08-25,Bahrain,BH,292,0,1641164,Asia,49330,184
2020-08-26,Bahrain,BH,746,2,1641164,Asia,50076,186
2020-08-27,Bahrain,BH,317,0,1641164,Asia,50393,186
2020-08-28,Bahrain,BH,363,2,1641164,Asia,50756,188
2020-08-29,Bahrain,BH,357,1,1641164,Asia,51113,189
2020-08-30,Bahrain,BH,278,0,1641164,Asia,51391,189
2020-08-31,Bahrain,BH,183,0,1641164,Asia,51574,189
2020-09-01,Bahrain,BH,0,1,1641164,Asia,51574,190
2020-09-02,Bahrain,BH,398,0,1641164,Asia,51972,190
2020-09-03,Bahrain,BH,468,0,1641164,Asia,52440,190
2020-09-04,Bahrain,BH,367,0,1641164,Asia,52807,190
2020-09-05,Bahrain,BH,626,4,1641164,Asia,53433,194
2020-09-06,Bahrain,BH,662,2,1641164,Asia,54095,196
2020-09-07,Bahrain,BH,676,2,1641164,Asia,54771,198
2020-09-08,Bahrain,BH,1305,2,1641164,Asia,56076,200
2020-09-09,Bahrain,BH,0,2,1641164,Asia,56076,202
2020-09-10,Bahrain,BH,702,1,1641164,Asia,56778,203
2020-09-11,Bahrain,BH,672,1,1641164,Asia,57450,204
2020-09-12,Bahrain,BH,757,4,1641164,Asia,58207,208
2020-09-13,Bahrain,BH,632,2,1641164,Asia,58839,210
2020-09-14,Bahrain,BH,747,2,1641164,Asia,59586,212
2020-09-15,Bahrain,BH,721,1,1641164,Asia,60307,213
2020-09-16,Bahrain,BH,658,0,1641164,Asia,60965,213
2020-09-17,Bahrain,BH,678,2,1641164,Asia,61643,215
2020-09-18,Bahrain,BH,841,1,1641164,Asia,62484,216
2020-09-19,Bahrain,BH,705,3,1641164,Asia,63189,219
2020-09-20,Bahrain,BH,690,1,1641164,Asia,63879,220
2020-09-21,Bahrain,BH,620,1,1641164,Asia,64499,221
2020-09-22,Bahrain,BH,540,0,1641164,Asia,65039,221
2020-09-23,Bahrain,BH,713,5,1641164,Asia,65752,226
2020-09-24,Bahrain,BH,650,5,1641164,Asia,66402,231
2020-09-25,Bahrain,BH,612,0,1641164,Asia,67014,231
2020-09-26,Bahrain,BH,687,4,1641164,Asia,67701,235
2020-09-27,Bahrain,BH,489,1,1641164,Asia,68190,236
2020-09-28,Bahrain,BH,585,6,1641164,Asia,68775,242
2020-09-29,Bahrain,BH,1073,3,1641164,Asia,69848,245
2020-09-30,Bahrain,BH,574,1,1641164,Asia,70422,246
2020-10-01,Bahrain,BH,442,6,1641164,Asia,70864,252
2020-10-02,Bahrain,BH,510,2,1641164,Asia,71374,254
2020-10-03,Bahrain,BH,429,1,1641164,Asia,71803,255
2020-10-04,Bahrain,BH,507,3,1641164,Asia,72310,258
2020-10-05,Bahrain,BH,352,2,1641164,Asia,72662,260
2020-10-06,Bahrain,BH,454,1,1641164,Asia,73116,261
2020-10-07,Bahrain,BH,360,1,1641164,Asia,73476,262
2020-10-08,Bahrain,BH,456,0,1641164,Asia,73932,262
2020-10-09,Bahrain,BH,490,2,1641164,Asia,74422,264
2020-10-10,Bahrain,BH,438,7,1641164,Asia,74860,271
2020-10-11,Bahrain,BH,427,2,1641164,Asia,75287,273
2020-10-12,Bahrain,BH,0,0,1641164,Asia,75287,273
2020-10-13,Bahrain,BH,661,7,1641164,Asia,75948,280
2020-10-14,Bahrain,BH,324,6,1641164,Asia,76272,286
2020-10-15,Bahrain,BH,349,1,1641164,Asia,76621,287
2020-10-16,Bahrain,BH,333,2,1641164,Asia,76954,289
2020-10-17,Bahrain,BH,371,3,1641164,Asia,77325,292
2020-10-18,Bahrain,BH,246,3,1641164,Asia,77571,295
2020-10-19,Bahrain,BH,331,5,1641164,Asia,77902,300
2020-10-20,Bahrain,BH,322,2,1641164,Asia,78224,302
2020-10-21,Bahrain,BH,309,3,1641164,Asia,78533,305
2020-10-22,Bahrain,BH,374,3,1641164,Asia,78907,308
2020-10-23,Bahrain,BH,304,0,1641164,Asia,79211,308
2020-10-24,Bahrain,BH,363,4,1641164,Asia,79574,312
2020-10-25,Bahrain,BH,401,0,1641164,Asia,79975,312
2020-10-26,Bahrain,BH,280,0,1641164,Asia,80255,312
2020-10-27,Bahrain,BH,278,4,1641164,Asia,80533,316
2020-10-28,Bahrain,BH,0,0,1641164,Asia,80533,316
2020-10-29,Bahrain,BH,489,1,1641164,Asia,81022,317
2020-10-30,Bahrain,BH,240,0,1641164,Asia,81262,317
2020-10-31,Bahrain,BH,204,2,1641164,Asia,81466,319
2020-11-01,Bahrain,BH,179,2,1641164,Asia,81645,321
2020-11-02,Bahrain,BH,278,0,1641164,Asia,81923,321
2020-11-03,Bahrain,BH,210,2,1641164,Asia,82133,323
2020-11-04,Bahrain,BH,230,1,1641164,Asia,82363,324
2020-11-05,Bahrain,BH,261,4,1641164,Asia,82624,328
2020-11-06,Bahrain,BH,162,0,1641164,Asia,82786,328
2020-11-07,Bahrain,BH,237,0,1641164,Asia,83023,328
2020-11-08,Bahrain,BH,241,1,1641164,Asia,83264,329
2020-11-09,Bahrain,BH,192,0,1641164,Asia,83456,329
2020-11-10,Bahrain,BH,176,1,1641164,Asia,83632,330
2020-11-11,Bahrain,BH,179,2,1641164,Asia,83811,332
2020-11-12,Bahrain,BH,231,0,1641164,Asia,84042,332
2020-11-13,Bahrain,BH,150,0,1641164,Asia,84192,332
2020-11-14,Bahrain,BH,157,0,1641164,Asia,84349,332
2020-11-15,Bahrain,BH,174,1,1641164,Asia,84523,333
2020-11-16,Bahrain,BH,180,2,1641164,Asia,84703,335
2020-11-17,Bahrain,BH,179,2,1641164,Asia,84882,337
2020-11-18,Bahrain,BH,126,0,1641164,Asia,85008,337
2020-11-19,Bahrain,BH,174,0,1641164,Asia,85182,337
2020-11-20,Bahrain,BH,135,0,1641164,Asia,85317,337
2020-11-21,Bahrain,BH,150,1,1641164,Asia,85467,338
2020-11-22,Bahrain,BH,124,0,1641164,Asia,85591,338
2020-11-23,Bahrain,BH,114,0,1641164,Asia,85705,338
2020-11-24,Bahrain,BH,181,1,1641164,Asia,85886,339
2020-11-25,Bahrain,BH,130,1,1641164,Asia,86016,340
2020-11-26,Bahrain,BH,169,0,1641164,Asia,86185,340
2020-11-27,Bahrain,BH,162,1,1641164,Asia,86347,341
2020-11-28,Bahrain,BH,168,0,1641164,Asia,86515,341
2020-11-29,Bahrain,BH,130,0,1641164,Asia,86645,341
2020-11-30,Bahrain,BH,142,0,1641164,Asia,86787,341
2020-12-01,Bahrain,BH,169,0,1641164,Asia,86956,341
2020-12-02,Bahrain,BH,181,0,1641164,Asia,87137,341
2020-12-03,Bahrain,BH,133,0,1641164,Asia,87270,341
2020-12-04,Bahrain,BH,162,0,1641164,Asia,87432,341
2020-12-05,Bahrain,BH,168,0,1641164,Asia,87600,341
2020-12-06,Bahrain,BH,132,0,1641164,Asia,87732,341
2020-12-07,Bahrain,BH,198,0,1641164,Asia,87930,341
2020-12-08,Bahrain,BH,181,0,1641164,Asia,88111,341
2020-12-09,Bahrain,BH,183,3,1641164,Asia,88294,344
2020-12-10,Bahrain,BH,201,3,1641164,Asia,88495,347
2020-12-11,Bahrain,BH,137,0,1641164,Asia,88632,347
2020-12-12,Bahrain,BH,188,0,1641164,Asia,88820,347
2020-12-13,Bahrain,BH,145,1,1641164,Asia,88965,348
2020-12-14,Bahrain,BH,178,0,1641164,Asia,89143,348
2020-04-01,Burundi,BI,2,0,11530577,Africa,2,0
2020-04-02,Burundi,BI,0,0,11530577,Africa,2,0
2020-04-03,Burundi,BI,1,0,11530577,Africa,3,0
2020-04-04,Burundi,BI,0,0,11530577,Africa,3,0
2020-04-05,Burundi,BI,0,0,11530577,Africa,3,0
2020-04-06,Burundi,BI,0,0,11530577,Africa,3,0
2020-04-07,Burundi,BI,0,0,11530577,Africa,3,0
2020-04-08,Burundi,BI,0,0,11530577,Africa,3,0
2020-04-09,Burundi,BI,0,0,11530577,Africa,3,0
2020-04-10,Burundi,BI,0,0,11530577,Africa,3,0
2020-04-11,Burundi,BI,0,0,11530577,Africa,3,0
2020-04-12,Burundi,BI,2,0,11530577,Africa,5,0
2020-04-13,Burundi,BI,0,0,11530577,Africa,5,0
2020-04-14,Burundi,BI,0,0,11530577,Africa,5,0
2020-04-15,Burundi,BI,0,1,11530577,Africa,5,1
2020-04-16,Burundi,BI,0,0,11530577,Africa,5,1
2020-04-17,Burundi,BI,0,0,11530577,Africa,5,1
2020-04-18,Burundi,BI,1,0,11530577,Africa,6,1
2020-04-19,Burundi,BI,0,0,11530577,Africa,6,1
2020-04-20,Burundi,BI,0,0,11530577,Africa,6,1
2020-04-21,Burundi,BI,0,0,11530577,Africa,6,1
2020-04-22,Burundi,BI,0,0,11530577,Africa,6,1
2020-04-23,Burundi,BI,5,0,11530577,Africa,11,1
2020-04-24,Burundi,BI,0,0,11530577,Africa,11,1
2020-04-25,Burundi,BI,1,0,11530577,Africa,12,1
2020-04-26,Burundi,BI,3,0,11530577,Africa,15,1
2020-04-27,Burundi,BI,0,0,11530577,Africa,15,1
2020-04-28,Burundi,BI,0,0,11530577,Africa,15,1
2020-04-29,Burundi,BI,0,0,11530577,Africa,15,1
2020-04-30,Burundi,BI,0,0,11530577,Africa,15,1
2020-05-01,Burundi,BI,0,0,11530577,Africa,15,1
2020-05-02,Burundi,BI,0,0,11530577,Africa,15,1
2020-05-03,Burundi,BI,4,0,11530577,Africa,19,1
2020-05-04,Burundi,BI,0,0,11530577,Africa,19,1
2020-05-05,Burundi,BI,0,0,11530577,Africa,19,1
2020-05-06,Burundi,BI,0,0,11530577,Africa,19,1
2020-05-07,Burundi,BI,0,0,11530577,Africa,19,1
2020-05-08,Burundi,BI,0,0,11530577,Africa,19,1
2020-05-09,Burundi,BI,0,0,11530577,Africa,19,1
2020-05-10,Burundi,BI,0,0,11530577,Africa,19,1
2020-05-11,Burundi,BI,0,0,11530577,Africa,19,1
2020-05-12,Burundi,BI,0,0,11530577,Africa,19,1
2020-05-13,Burundi,BI,8,0,11530577,Africa,27,1
2020-05-14,Burundi,BI,0,0,11530577,Africa,27,1
2020-05-15,Burundi,BI,0,0,11530577,Africa,27,1
2020-05-16,Burundi,BI,0,0,11530577,Africa,27,1
2020-05-17,Burundi,BI,0,0,11530577,Africa,27,1
2020-05-18,Burundi,BI,15,0,11530577,Africa,42,1
2020-05-19,Burundi,BI,0,0,11530577,Africa,42,1
2020-05-20,Burundi,BI,0,0,11530577,Africa,42,1
2020-05-21,Burundi,BI,0,0,11530577,Africa,42,1
2020-05-22,Burundi,BI,0,0,11530577,Africa,42,1
2020-05-23,Burundi,BI,0,0,11530577,Africa,42,1
2020-05-24,Burundi,BI,0,0,11530577,Africa,42,1
2020-05-25,Burundi,BI,0,0,11530577,Africa,42,1
2020-05-26,Burundi,BI,0,0,11530577,Africa,42,1
2020-05-27,Burundi,BI,0,0,11530577,Africa,42,1
2020-05-28,Burundi,BI,0,0,11530577,Africa,42,1
2020-05-29,Burundi,BI,0,0,11530577,Africa,42,1
2020-05-30,Burundi,BI,0,0,11530577,Africa,42,1
2020-05-31,Burundi,BI,0,0,11530577,Africa,42,1
2020-06-01,Burundi,BI,21,0,11530577,Africa,63,1
2020-06-02,Burundi,BI,0,0,11530577,Africa,63,1
2020-06-03,Burundi,BI,0,0,11530577,Africa,63,1
2020-06-04,Burundi,BI,0,0,11530577,Africa,63,1
2020-06-05,Burundi,BI,0,0,11530577,Africa,63,1
2020-06-06,Burundi,BI,0,0,11530577,Africa,63,1
2020-06-07,Burundi,BI,20,0,11530577,Africa,83,1
2020-06-08,Burundi,BI,0,0,11530577,Africa,83,1
2020-06-09,Burundi,BI,0,0,11530577,Africa,83,1
2020-06-10,Burundi,BI,0,0,11530577,Africa,83,1
2020-06-11,Burundi,BI,0,0,11530577,Africa,83,1
2020-06-12,Burundi,BI,11,0,11530577,Africa,94,1
2020-06-13,Burundi,BI,0,0,11530577,Africa,94,1
2020-06-14,Burundi,BI,0,0,11530577,Africa,94,1
2020-06-15,Burundi,BI,0,0,11530577,Africa,94,1
2020-06-16,Burundi,BI,10,0,11530577,Africa,104,1
2020-06-17,Burundi,BI,0,0,11530577,Africa,104,1
2020-06-18,Burundi,BI,0,0,11530577,Africa,104,1
2020-06-19,Burundi,BI,0,0,11530577,Africa,104,1
2020-06-20,Burundi,BI,0,0,11530577,Africa,104,1
2020-06-21,Burundi,BI,40,0,11530577,Africa,144,1
2020-06-22,Burundi,BI,0,0,11530577,Africa,144,1
2020-06-23,Burundi,BI,0,0,11530577,Africa,144,1
2020-06-24,Burundi,BI,0,0,11530577,Africa,144,1
2020-06-25,Burundi,BI,0,0,11530577,Africa,144,1
2020-06-26,Burundi,BI,0,0,11530577,Africa,144,1
2020-06-27,Burundi,BI,0,0,11530577,Africa,144,1
2020-06-28,Burundi,BI,0,0,11530577,Africa,144,1
2020-06-29,Burundi,BI,26,0,11530577,Africa,170,1
2020-06-30,Burundi,BI,0,0,11530577,Africa,170,1
2020-07-01,Burundi,BI,0,0,11530577,Africa,170,1
2020-07-02,Burundi,BI,0,0,11530577,Africa,170,1
2020-07-03,Burundi,BI,0,0,11530577,Africa,170,1
2020-07-04,Burundi,BI,21,0,11530577,Africa,191,1
2020-07-05,Burundi,BI,0,0,11530577,Africa,191,1
2020-07-06,Burundi,BI,0,0,11530577,Africa,191,1
2020-07-07,Burundi,BI,0,0,11530577,Africa,191,1
2020-07-08,Burundi,BI,0,0,11530577,Africa,191,1
2020-07-09,Burundi,BI,0,0,11530577,Africa,191,1
2020-07-10,Burundi,BI,28,0,11530577,Africa,219,1
2020-07-11,Burundi,BI,7,0,11530577,Africa,226,1
2020-07-12,Burundi,BI,24,0,11530577,Africa,250,1
2020-07-13,Burundi,BI,0,0,11530577,Africa,250,1
2020-07-14,Burundi,BI,19,0,11530577,Africa,269,1
2020-07-15,Burundi,BI,0,0,11530577,Africa,269,1
2020-07-16,Burundi,BI,0,0,11530577,Africa,269,1
2020-07-17,Burundi,BI,34,0,11530577,Africa,303,1
2020-07-18,Burundi,BI,7,0,11530577,Africa,310,1
2020-07-19,Burundi,BI,0,0,11530577,Africa,310,1
2020-07-20,Burundi,BI,0,0,11530577,Africa,310,1
2020-07-21,Burundi,BI,12,0,11530577,Africa,322,1
2020-07-22,Burundi,BI,6,0,11530577,Africa,328,1
2020-07-23,Burundi,BI,0,0,11530577,Africa,328,1
2020-07-24,Burundi,BI,17,0,11530577,Africa,345,1
2020-07-25,Burundi,BI,0,0,11530577,Africa,345,1
2020-07-26,Burundi,BI,16,0,11530577,Africa,361,1
2020-07-27,Burundi,BI,0,0,11530577,Africa,361,1
2020-07-28,Burundi,BI,17,0,11530577,Africa,378,1
2020-07-29,Burundi,BI,0,0,11530577,Africa,378,1
2020-07-30,Burundi,BI,9,0,11530577,Africa,387,1
2020-07-31,Burundi,BI,0,0,11530577,Africa,387,1
2020-08-01,Burundi,BI,4,0,11530577,Africa,391,1
2020-08-02,Burundi,BI,4,0,11530577,Africa,395,1
2020-08-03,Burundi,BI,0,0,11530577,Africa,395,1
2020-08-04,Burundi,BI,0,0,11530577,Africa,395,1
2020-08-05,Burundi,BI,0,0,11530577,Africa,395,1
2020-08-06,Burundi,BI,5,0,11530577,Africa,400,1
2020-08-07,Burundi,BI,0,0,11530577,Africa,400,1
2020-08-08,Burundi,BI,5,0,11530577,Africa,405,1
2020-08-09,Burundi,BI,3,0,11530577,Africa,408,1
2020-08-10,Burundi,BI,0,0,11530577,Africa,408,1
2020-08-11,Burundi,BI,0,0,11530577,Africa,408,1
2020-08-12,Burundi,BI,0,0,11530577,Africa,408,1
2020-08-13,Burundi,BI,2,0,11530577,Africa,410,1
2020-08-14,Burundi,BI,0,0,11530577,Africa,410,1
2020-08-15,Burundi,BI,2,0,11530577,Africa,412,1
2020-08-16,Burundi,BI,0,0,11530577,Africa,412,1
2020-08-17,Burundi,BI,1,0,11530577,Africa,413,1
2020-08-18,Burundi,BI,0,0,11530577,Africa,413,1
2020-08-19,Burundi,BI,3,0,11530577,Africa,416,1
2020-08-20,Burundi,BI,6,0,11530577,Africa,422,1
2020-08-21,Burundi,BI,0,0,11530577,Africa,422,1
2020-08-22,Burundi,BI,4,0,11530577,Africa,426,1
2020-08-23,Burundi,BI,3,0,11530577,Africa,429,1
2020-08-24,Burundi,BI,0,0,11530577,Africa,429,1
2020-08-25,Burundi,BI,1,0,11530577,Africa,430,1
2020-08-26,Burundi,BI,0,0,11530577,Africa,430,1
2020-08-27,Burundi,BI,0,0,11530577,Africa,430,1
2020-08-28,Burundi,BI,1,0,11530577,Africa,431,1
2020-08-29,Burundi,BI,2,0,11530577,Africa,433,1
2020-08-30,Burundi,BI,6,0,11530577,Africa,439,1
2020-08-31,Burundi,BI,6,0,11530577,Africa,445,1
2020-09-01,Burundi,BI,0,0,11530577,Africa,445,1
2020-09-02,Burundi,BI,0,0,11530577,Africa,445,1
2020-09-03,Burundi,BI,3,0,11530577,Africa,448,1
2020-09-04,Burundi,BI,0,0,11530577,Africa,448,1
2020-09-05,Burundi,BI,3,0,11530577,Africa,451,1
2020-09-06,Burundi,BI,9,0,11530577,Africa,460,1
2020-09-07,Burundi,BI,2,0,11530577,Africa,462,1
2020-09-08,Burundi,BI,4,0,11530577,Africa,466,1
2020-09-09,Burundi,BI,0,0,11530577,Africa,466,1
2020-09-10,Burundi,BI,0,0,11530577,Africa,466,1
2020-09-11,Burundi,BI,3,0,11530577,Africa,469,1
2020-09-12,Burundi,BI,0,0,11530577,Africa,469,1
2020-09-13,Burundi,BI,2,0,11530577,Africa,471,1
2020-09-14,Burundi,BI,1,0,11530577,Africa,472,1
2020-09-15,Burundi,BI,0,0,11530577,Africa,472,1
2020-09-16,Burundi,BI,0,0,11530577,Africa,472,1
2020-09-17,Burundi,BI,0,0,11530577,Africa,472,1
2020-09-18,Burundi,BI,1,0,11530577,Africa,473,1
2020-09-19,Burundi,BI,0,0,11530577,Africa,473,1
2020-09-20,Burundi,BI,0,0,11530577,Africa,473,1
2020-09-21,Burundi,BI,0,0,11530577,Africa,473,1
2020-09-22,Burundi,BI,1,0,11530577,Africa,474,1
2020-09-23,Burundi,BI,0,0,11530577,Africa,474,1
2020-09-24,Burundi,BI,2,0,11530577,Africa,476,1
2020-09-25,Burundi,BI,1,0,11530577,Africa,477,1
2020-09-26,Burundi,BI,6,0,11530577,Africa,483,1
2020-09-27,Burundi,BI,2,0,11530577,Africa,485,1
2020-09-28,Burundi,BI,0,0,11530577,Africa,485,1
2020-09-29,Burundi,BI,17,0,11530577,Africa,502,1
2020-09-30,Burundi,BI,4,0,11530577,Africa,506,1
2020-10-01,Burundi,BI,2,0,11530577,Africa,508,1
2020-10-02,Burundi,BI,2,0,11530577,Africa,510,1
2020-10-03,Burundi,BI,3,0,11530577,Africa,513,1
2020-10-04,Burundi,BI,0,0,11530577,Africa,513,1
2020-10-05,Burundi,BI,0,0,11530577,Africa,513,1
2020-10-06,Burundi,BI,1,0,11530577,Africa,514,1
2020-10-07,Burundi,BI,0,0,11530577,Africa,514,1
2020-10-08,Burundi,BI,1,0,11530577,Africa,515,1
2020-10-09,Burundi,BI,0,0,11530577,Africa,515,1
2020-10-10,Burundi,BI,0,0,11530577,Africa,515,1
2020-10-11,Burundi,BI,2,0,11530577,Africa,517,1
2020-10-12,Burundi,BI,7,0,11530577,Africa,524,1
2020-10-13,Burundi,BI,1,0,11530577,Africa,525,1
2020-10-14,Burundi,BI,4,0,11530577,Africa,529,1
2020-10-15,Burundi,BI,0,0,11530577,Africa,529,1
2020-10-16,Burundi,BI,0,0,11530577,Africa,529,1
2020-10-17,Burundi,BI,2,0,11530577,Africa,531,1
2020-10-18,Burundi,BI,5,0,11530577,Africa,536,1
2020-10-19,Burundi,BI,6,0,11530577,Africa,542,1
2020-10-20,Burundi,BI,7,0,11530577,Africa,549,1
2020-10-21,Burundi,BI,1,0,11530577,Africa,550,1
2020-10-22,Burundi,BI,0,0,11530577,Africa,550,1
2020-10-23,Burundi,BI,1,0,11530577,Africa,551,1
2020-10-24,Burundi,BI,2,0,11530577,Africa,553,1
2020-10-25,Burundi,BI,2,0,11530577,Africa,555,1
2020-10-26,Burundi,BI,1,0,11530577,Africa,556,1
2020-10-27,Burundi,BI,1,0,11530577,Africa,557,1
2020-10-28,Burundi,BI,1,0,11530577,Africa,558,1
2020-10-29,Burundi,BI,1,0,11530577,Africa,559,1
2020-10-30,Burundi,BI,1,0,11530577,Africa,560,1
2020-10-31,Burundi,BI,22,0,11530577,Africa,582,1
2020-11-01,Burundi,BI,3,0,11530577,Africa,585,1
2020-11-02,Burundi,BI,4,0,11530577,Africa,589,1
2020-11-03,Burundi,BI,0,0,11530577,Africa,589,1
2020-11-04,Burundi,BI,8,0,11530577,Africa,597,1
2020-11-05,Burundi,BI,2,0,11530577,Africa,599,1
2020-11-06,Burundi,BI,1,0,11530577,Africa,600,1
2020-11-07,Burundi,BI,5,0,11530577,Africa,605,1
2020-11-08,Burundi,BI,7,0,11530577,Africa,612,1
2020-11-09,Burundi,BI,2,0,11530577,Africa,614,1
2020-11-10,Burundi,BI,0,0,11530577,Africa,614,1
2020-11-11,Burundi,BI,1,0,11530577,Africa,615,1
2020-11-12,Burundi,BI,5,0,11530577,Africa,620,1
2020-11-13,Burundi,BI,3,0,11530577,Africa,623,1
2020-11-14,Burundi,BI,1,0,11530577,Africa,624,1
2020-11-15,Burundi,BI,3,0,11530577,Africa,627,1
2020-11-16,Burundi,BI,1,0,11530577,Africa,628,1
2020-11-17,Burundi,BI,2,0,11530577,Africa,630,1
2020-11-18,Burundi,BI,1,0,11530577,Africa,631,1
2020-11-19,Burundi,BI,11,0,11530577,Africa,642,1
2020-11-20,Burundi,BI,0,0,11530577,Africa,642,1
2020-11-21,Burundi,BI,7,0,11530577,Africa,649,1
2020-11-22,Burundi,BI,7,0,11530577,Africa,656,1
2020-11-23,Burundi,BI,6,0,11530577,Africa,662,1
2020-11-24,Burundi,BI,2,0,11530577,Africa,664,1
2020-11-25,Burundi,BI,9,0,11530577,Africa,673,1
2020-11-26,Burundi,BI,0,0,11530577,Africa,673,1
2020-11-27,Burundi,BI,4,0,11530577,Africa,677,1
2020-11-28,Burundi,BI,4,0,11530577,Africa,681,1
2020-11-29,Burundi,BI,0,0,11530577,Africa,681,1
2020-11-30,Burundi,BI,0,0,11530577,Africa,681,1
2020-12-01,Burundi,BI,7,0,11530577,Africa,688,1
2020-12-02,Burundi,BI,1,0,11530577,Africa,689,1
2020-12-03,Burundi,BI,0,0,11530577,Africa,689,1
2020-12-04,Burundi,BI,3,0,11530577,Africa,692,1
2020-12-05,Burundi,BI,0,0,11530577,Africa,692,1
2020-12-06,Burundi,BI,2,0,11530577,Africa,694,1
2020-12-07,Burundi,BI,0,0,11530577,Africa,694,1
2020-12-08,Burundi,BI,4,0,11530577,Africa,698,1
2020-12-09,Burundi,BI,18,0,11530577,Africa,716,1
2020-12-10,Burundi,BI,4,0,11530577,Africa,720,1
2020-12-11,Burundi,BI,1,0,11530577,Africa,721,1
2020-12-12,Burundi,BI,2,0,11530577,Africa,723,1
2020-12-13,Burundi,BI,5,0,11530577,Africa,728,1
2020-12-14,Burundi,BI,1,0,11530577,Africa,729,1
2020-03-17,Benin,BJ,1,0,11801151,Africa,1,0
2020-03-18,Benin,BJ,0,0,11801151,Africa,1,0
2020-03-19,Benin,BJ,0,0,11801151,Africa,1,0
2020-03-20,Benin,BJ,1,0,11801151,Africa,2,0
2020-03-21,Benin,BJ,0,0,11801151,Africa,2,0
2020-03-22,Benin,BJ,0,0,11801151,Africa,2,0
2020-03-23,Benin,BJ,0,0,11801151,Africa,2,0
2020-03-24,Benin,BJ,3,0,11801151,Africa,5,0
2020-03-25,Benin,BJ,0,0,11801151,Africa,5,0
2020-03-26,Benin,BJ,0,0,11801151,Africa,5,0
2020-03-27,Benin,BJ,1,0,11801151,Africa,6,0
2020-03-28,Benin,BJ,0,0,11801151,Africa,6,0
2020-03-29,Benin,BJ,0,0,11801151,Africa,6,0
2020-03-30,Benin,BJ,0,0,11801151,Africa,6,0
2020-03-31,Benin,BJ,0,0,11801151,Africa,6,0
2020-04-01,Benin,BJ,2,0,11801151,Africa,8,0
2020-04-02,Benin,BJ,5,0,11801151,Africa,13,0
2020-04-03,Benin,BJ,0,0,11801151,Africa,13,0
2020-04-04,Benin,BJ,3,0,11801151,Africa,16,0
2020-04-05,Benin,BJ,0,0,11801151,Africa,16,0
2020-04-06,Benin,BJ,6,0,11801151,Africa,22,0
2020-04-07,Benin,BJ,4,1,11801151,Africa,26,1
2020-04-08,Benin,BJ,0,0,11801151,Africa,26,1
2020-04-09,Benin,BJ,0,0,11801151,Africa,26,1
2020-04-10,Benin,BJ,4,0,11801151,Africa,30,1
2020-04-11,Benin,BJ,5,0,11801151,Africa,35,1
2020-04-12,Benin,BJ,0,0,11801151,Africa,35,1
2020-04-13,Benin,BJ,0,0,11801151,Africa,35,1
2020-04-14,Benin,BJ,0,0,11801151,Africa,35,1
2020-04-15,Benin,BJ,0,0,11801151,Africa,35,1
2020-04-16,Benin,BJ,0,0,11801151,Africa,35,1
2020-04-17,Benin,BJ,2,0,11801151,Africa,37,1
2020-04-18,Benin,BJ,0,0,11801151,Africa,37,1
2020-04-19,Benin,BJ,0,0,11801151,Africa,37,1
2020-04-20,Benin,BJ,0,0,11801151,Africa,37,1
2020-04-21,Benin,BJ,17,0,11801151,Africa,54,1
2020-04-22,Benin,BJ,0,0,11801151,Africa,54,1
2020-04-23,Benin,BJ,0,0,11801151,Africa,54,1
2020-04-24,Benin,BJ,4,0,11801151,Africa,58,1
2020-04-25,Benin,BJ,0,0,11801151,Africa,58,1
2020-04-26,Benin,BJ,0,0,11801151,Africa,58,1
2020-04-27,Benin,BJ,6,0,11801151,Africa,64,1
2020-04-28,Benin,BJ,0,0,11801151,Africa,64,1
2020-04-29,Benin,BJ,0,0,11801151,Africa,64,1
2020-04-30,Benin,BJ,5,1,11801151,Africa,69,2
2020-05-01,Benin,BJ,15,0,11801151,Africa,84,2
2020-05-02,Benin,BJ,6,0,11801151,Africa,90,2
2020-05-03,Benin,BJ,0,0,11801151,Africa,90,2
2020-05-04,Benin,BJ,0,0,11801151,Africa,90,2
2020-05-05,Benin,BJ,6,0,11801151,Africa,96,2
2020-05-06,Benin,BJ,0,0,11801151,Africa,96,2
2020-05-07,Benin,BJ,6,0,11801151,Africa,102,2
2020-05-08,Benin,BJ,38,0,11801151,Africa,140,2
2020-05-09,Benin,BJ,102,0,11801151,Africa,242,2
2020-05-10,Benin,BJ,42,0,11801151,Africa,284,2
2020-05-11,Benin,BJ,35,0,11801151,Africa,319,2
2020-05-12,Benin,BJ,0,0,11801151,Africa,319,2
2020-05-13,Benin,BJ,8,0,11801151,Africa,327,2
2020-05-14,Benin,BJ,0,0,11801151,Africa,327,2
2020-05-15,Benin,BJ,12,0,11801151,Africa,339,2
2020-05-16,Benin,BJ,0,0,11801151,Africa,339,2
2020-05-17,Benin,BJ,0,0,11801151,Africa,339,2
2020-05-18,Benin,BJ,0,0,11801151,Africa,339,2
2020-05-19,Benin,BJ,0,0,11801151,Africa,339,2
2020-05-20,Benin,BJ,-209,0,11801151,Africa,130,2
2020-05-21,Benin,BJ,0,0,11801151,Africa,130,2
2020-05-22,Benin,BJ,5,1,11801151,Africa,135,3
2020-05-23,Benin,BJ,0,0,11801151,Africa,135,3
2020-05-24,Benin,BJ,0,0,11801151,Africa,135,3
2020-05-25,Benin,BJ,56,0,11801151,Africa,191,3
2020-05-26,Benin,BJ,0,0,11801151,Africa,191,3
2020-05-27,Benin,BJ,17,0,11801151,Africa,208,3
2020-05-28,Benin,BJ,2,0,11801151,Africa,210,3
2020-05-29,Benin,BJ,0,0,11801151,Africa,210,3
2020-05-30,Benin,BJ,14,0,11801151,Africa,224,3
2020-05-31,Benin,BJ,8,0,11801151,Africa,232,3
2020-06-01,Benin,BJ,0,0,11801151,Africa,232,3
2020-06-02,Benin,BJ,11,0,11801151,Africa,243,3
2020-06-03,Benin,BJ,1,0,11801151,Africa,244,3
2020-06-04,Benin,BJ,0,0,11801151,Africa,244,3
2020-06-05,Benin,BJ,17,0,11801151,Africa,261,3
2020-06-06,Benin,BJ,0,0,11801151,Africa,261,3
2020-06-07,Benin,BJ,7,1,11801151,Africa,268,4
2020-06-08,Benin,BJ,0,0,11801151,Africa,268,4
2020-06-09,Benin,BJ,37,0,11801151,Africa,305,4
2020-06-10,Benin,BJ,0,0,11801151,Africa,305,4
2020-06-11,Benin,BJ,0,0,11801151,Africa,305,4
2020-06-12,Benin,BJ,0,0,11801151,Africa,305,4
2020-06-13,Benin,BJ,83,1,11801151,Africa,388,5
2020-06-14,Benin,BJ,24,1,11801151,Africa,412,6
2020-06-15,Benin,BJ,58,1,11801151,Africa,470,7
2020-06-16,Benin,BJ,13,2,11801151,Africa,483,9
2020-06-17,Benin,BJ,49,0,11801151,Africa,532,9
2020-06-18,Benin,BJ,40,0,11801151,Africa,572,9
2020-06-19,Benin,BJ,25,2,11801151,Africa,597,11
2020-06-20,Benin,BJ,53,0,11801151,Africa,650,11
2020-06-21,Benin,BJ,0,0,11801151,Africa,650,11
2020-06-22,Benin,BJ,115,2,11801151,Africa,765,13
2020-06-23,Benin,BJ,42,0,11801151,Africa,807,13
2020-06-24,Benin,BJ,43,0,11801151,Africa,850,13
2020-06-25,Benin,BJ,52,0,11801151,Africa,902,13
2020-06-26,Benin,BJ,115,1,11801151,Africa,1017,14
2020-06-27,Benin,BJ,36,0,11801151,Africa,1053,14
2020-06-28,Benin,BJ,71,0,11801151,Africa,1124,14
2020-06-29,Benin,BJ,25,2,11801151,Africa,1149,16
2020-06-30,Benin,BJ,38,3,11801151,Africa,1187,19
2020-07-01,Benin,BJ,12,2,11801151,Africa,1199,21
2020-07-02,Benin,BJ,0,0,11801151,Africa,1199,21
2020-07-03,Benin,BJ,0,0,11801151,Africa,1199,21
2020-07-04,Benin,BJ,0,0,11801151,Africa,1199,21
2020-07-05,Benin,BJ,0,0,11801151,Africa,1199,21
2020-07-06,Benin,BJ,0,0,11801151,Africa,1199,21
2020-07-07,Benin,BJ,0,0,11801151,Africa,1199,21
2020-07-08,Benin,BJ,0,0,11801151,Africa,1199,21
2020-07-09,Benin,BJ,86,2,11801151,Africa,1285,23
2020-07-10,Benin,BJ,0,0,11801151,Africa,1285,23
2020-07-11,Benin,BJ,0,0,11801151,Africa,1285,23
2020-07-12,Benin,BJ,93,3,11801151,Africa,1378,26
2020-07-13,Benin,BJ,0,0,11801151,Africa,1378,26
2020-07-14,Benin,BJ,0,0,11801151,Africa,1378,26
2020-07-15,Benin,BJ,0,0,11801151,Africa,1378,26
2020-07-16,Benin,BJ,0,0,11801151,Africa,1378,26
2020-07-17,Benin,BJ,85,2,11801151,Africa,1463,28
2020-07-18,Benin,BJ,139,3,11801151,Africa,1602,31
2020-07-19,Benin,BJ,0,0,11801151,Africa,1602,31
2020-07-20,Benin,BJ,0,0,11801151,Africa,1602,31
2020-07-21,Benin,BJ,0,0,11801151,Africa,1602,31
2020-07-22,Benin,BJ,0,0,11801151,Africa,1602,31
2020-07-23,Benin,BJ,0,0,11801151,Africa,1602,31
2020-07-24,Benin,BJ,92,3,11801151,Africa,1694,34
2020-07-25,Benin,BJ,0,0,11801151,Africa,1694,34
2020-07-26,Benin,BJ,0,0,11801151,Africa,1694,34
2020-07-27,Benin,BJ,76,1,11801151,Africa,1770,35
2020-07-28,Benin,BJ,0,0,11801151,Africa,1770,35
2020-07-29,Benin,BJ,0,0,11801151,Africa,1770,35
2020-07-30,Benin,BJ,0,0,11801151,Africa,1770,35
2020-07-31,Benin,BJ,0,0,11801151,Africa,1770,35
2020-08-01,Benin,BJ,35,1,11801151,Africa,1805,36
2020-08-02,Benin,BJ,0,0,11801151,Africa,1805,36
2020-08-03,Benin,BJ,0,0,11801151,Africa,1805,36
2020-08-04,Benin,BJ,0,0,11801151,Africa,1805,36
2020-08-05,Benin,BJ,109,2,11801151,Africa,1914,38
2020-08-06,Benin,BJ,0,0,11801151,Africa,1914,38
2020-08-07,Benin,BJ,22,0,11801151,Africa,1936,38
2020-08-08,Benin,BJ,0,0,11801151,Africa,1936,38
2020-08-09,Benin,BJ,0,0,11801151,Africa,1936,38
2020-08-10,Benin,BJ,0,0,11801151,Africa,1936,38
2020-08-11,Benin,BJ,0,0,11801151,Africa,1936,38
2020-08-12,Benin,BJ,65,0,11801151,Africa,2001,38
2020-08-13,Benin,BJ,0,0,11801151,Africa,2001,38
2020-08-14,Benin,BJ,0,0,11801151,Africa,2001,38
2020-08-15,Benin,BJ,0,0,11801151,Africa,2001,38
2020-08-16,Benin,BJ,62,1,11801151,Africa,2063,39
2020-08-17,Benin,BJ,0,0,11801151,Africa,2063,39
2020-08-18,Benin,BJ,0,0,11801151,Africa,2063,39
2020-08-19,Benin,BJ,0,0,11801151,Africa,2063,39
2020-08-20,Benin,BJ,0,0,11801151,Africa,2063,39
2020-08-21,Benin,BJ,32,0,11801151,Africa,2095,39
2020-08-22,Benin,BJ,0,0,11801151,Africa,2095,39
2020-08-23,Benin,BJ,20,0,11801151,Africa,2115,39
2020-08-24,Benin,BJ,0,0,11801151,Africa,2115,39
2020-08-25,Benin,BJ,0,0,11801151,Africa,2115,39
2020-08-26,Benin,BJ,0,0,11801151,Africa,2115,39
2020-08-27,Benin,BJ,30,1,11801151,Africa,2145,40
2020-08-28,Benin,BJ,0,0,11801151,Africa,2145,40
2020-08-29,Benin,BJ,0,0,11801151,Africa,2145,40
2020-08-30,Benin,BJ,0,0,11801151,Africa,2145,40
2020-08-31,Benin,BJ,0,0,11801151,Africa,2145,40
2020-09-01,Benin,BJ,0,0,11801151,Africa,2145,40
2020-09-02,Benin,BJ,0,0,11801151,Africa,2145,40
2020-09-03,Benin,BJ,49,0,11801151,Africa,2194,40
2020-09-04,Benin,BJ,0,0,11801151,Africa,2194,40
2020-09-05,Benin,BJ,0,0,11801151,Africa,2194,40
2020-09-06,Benin,BJ,19,0,11801151,Africa,2213,40
2020-09-07,Benin,BJ,0,0,11801151,Africa,2213,40
2020-09-08,Benin,BJ,0,0,11801151,Africa,2213,40
2020-09-09,Benin,BJ,0,0,11801151,Africa,2213,40
2020-09-10,Benin,BJ,29,0,11801151,Africa,2242,40
2020-09-11,Benin,BJ,0,0,11801151,Africa,2242,40
2020-09-12,Benin,BJ,0,0,11801151,Africa,2242,40
2020-09-13,Benin,BJ,0,0,11801151,Africa,2242,40
2020-09-14,Benin,BJ,25,0,11801151,Africa,2267,40
2020-09-15,Benin,BJ,0,0,11801151,Africa,2267,40
2020-09-16,Benin,BJ,0,0,11801151,Africa,2267,40
2020-09-17,Benin,BJ,13,0,11801151,Africa,2280,40
2020-09-18,Benin,BJ,0,0,11801151,Africa,2280,40
2020-09-19,Benin,BJ,0,0,11801151,Africa,2280,40
2020-09-20,Benin,BJ,0,0,11801151,Africa,2280,40
2020-09-21,Benin,BJ,0,0,11801151,Africa,2280,40
2020-09-22,Benin,BJ,14,0,11801151,Africa,2294,40
2020-09-23,Benin,BJ,0,0,11801151,Africa,2294,40
2020-09-24,Benin,BJ,31,0,11801151,Africa,2325,40
2020-09-25,Benin,BJ,0,0,11801151,Africa,2325,40
2020-09-26,Benin,BJ,0,0,11801151,Africa,2325,40
2020-09-27,Benin,BJ,0,0,11801151,Africa,2325,40
2020-09-28,Benin,BJ,15,0,11801151,Africa,2340,40
2020-09-29,Benin,BJ,0,0,11801151,Africa,2340,40
2020-09-30,Benin,BJ,0,0,11801151,Africa,2340,40
2020-10-01,Benin,BJ,17,1,11801151,Africa,2357,41
2020-10-02,Benin,BJ,0,0,11801151,Africa,2357,41
2020-10-03,Benin,BJ,0,0,11801151,Africa,2357,41
2020-10-04,Benin,BJ,0,0,11801151,Africa,2357,41
2020-10-05,Benin,BJ,0,0,11801151,Africa,2357,41
2020-10-06,Benin,BJ,0,0,11801151,Africa,2357,41
2020-10-07,Benin,BJ,0,0,11801151,Africa,2357,41
2020-10-08,Benin,BJ,54,0,11801151,Africa,2411,41
2020-10-09,Benin,BJ,0,0,11801151,Africa,2411,41
2020-10-10,Benin,BJ,0,0,11801151,Africa,2411,41
2020-10-11,Benin,BJ,0,0,11801151,Africa,2411,41
2020-10-12,Benin,BJ,0,0,11801151,Africa,2411,41
2020-10-13,Benin,BJ,0,0,11801151,Africa,2411,41
2020-10-14,Benin,BJ,0,0,11801151,Africa,2411,41
2020-10-15,Benin,BJ,67,0,11801151,Africa,2478,41
2020-10-16,Benin,BJ,18,0,11801151,Africa,2496,41
2020-10-17,Benin,BJ,0,0,11801151,Africa,2496,41
2020-10-18,Benin,BJ,0,0,11801151,Africa,2496,41
2020-10-19,Benin,BJ,0,0,11801151,Africa,2496,41
2020-10-20,Benin,BJ,0,0,11801151,Africa,2496,41
2020-10-21,Benin,BJ,0,0,11801151,Africa,2496,41
2020-10-22,Benin,BJ,61,0,11801151,Africa,2557,41
2020-10-23,Benin,BJ,0,0,11801151,Africa,2557,41
2020-10-24,Benin,BJ,0,0,11801151,Africa,2557,41
2020-10-25,Benin,BJ,0,0,11801151,Africa,2557,41
2020-10-26,Benin,BJ,0,0,11801151,Africa,2557,41
2020-10-27,Benin,BJ,0,0,11801151,Africa,2557,41
2020-10-28,Benin,BJ,0,0,11801151,Africa,2557,41
2020-10-29,Benin,BJ,86,0,11801151,Africa,2643,41
2020-10-30,Benin,BJ,0,0,11801151,Africa,2643,41
2020-10-31,Benin,BJ,0,0,11801151,Africa,2643,41
2020-11-01,Benin,BJ,0,0,11801151,Africa,2643,41
2020-11-02,Benin,BJ,0,0,11801151,Africa,2643,41
2020-11-03,Benin,BJ,40,0,11801151,Africa,2683,41
2020-11-04,Benin,BJ,0,0,11801151,Africa,2683,41
2020-11-05,Benin,BJ,62,2,11801151,Africa,2745,43
2020-11-06,Benin,BJ,0,0,11801151,Africa,2745,43
2020-11-07,Benin,BJ,0,0,11801151,Africa,2745,43
2020-11-08,Benin,BJ,0,0,11801151,Africa,2745,43
2020-11-09,Benin,BJ,0,0,11801151,Africa,2745,43
2020-11-10,Benin,BJ,0,0,11801151,Africa,2745,43
2020-11-11,Benin,BJ,36,0,11801151,Africa,2781,43
2020-11-12,Benin,BJ,63,0,11801151,Africa,2844,43
2020-11-13,Benin,BJ,0,0,11801151,Africa,2844,43
2020-11-14,Benin,BJ,0,0,11801151,Africa,2844,43
2020-11-15,Benin,BJ,0,0,11801151,Africa,2844,43
2020-11-16,Benin,BJ,0,0,11801151,Africa,2844,43
2020-11-17,Benin,BJ,0,0,11801151,Africa,2844,43
2020-11-18,Benin,BJ,0,0,11801151,Africa,2844,43
2020-11-19,Benin,BJ,72,0,11801151,Africa,2916,43
2020-11-20,Benin,BJ,0,0,11801151,Africa,2916,43
2020-11-21,Benin,BJ,0,0,11801151,Africa,2916,43
2020-11-22,Benin,BJ,0,0,11801151,Africa,2916,43
2020-11-23,Benin,BJ,0,0,11801151,Africa,2916,43
2020-11-24,Benin,BJ,0,0,11801151,Africa,2916,43
2020-11-25,Benin,BJ,0,0,11801151,Africa,2916,43
2020-11-26,Benin,BJ,58,0,11801151,Africa,2974,43
2020-11-27,Benin,BJ,0,0,11801151,Africa,2974,43
2020-11-28,Benin,BJ,0,0,11801151,Africa,2974,43
2020-11-29,Benin,BJ,0,0,11801151,Africa,2974,43
2020-11-30,Benin,BJ,0,0,11801151,Africa,2974,43
2020-12-01,Benin,BJ,41,0,11801151,Africa,3015,43
2020-12-02,Benin,BJ,0,0,11801151,Africa,3015,43
2020-12-03,Benin,BJ,40,1,11801151,Africa,3055,44
2020-12-04,Benin,BJ,0,0,11801151,Africa,3055,44
2020-12-05,Benin,BJ,0,0,11801151,Africa,3055,44
2020-12-06,Benin,BJ,0,0,11801151,Africa,3055,44
2020-12-07,Benin,BJ,0,0,11801151,Africa,3055,44
2020-12-08,Benin,BJ,18,0,11801151,Africa,3073,44
2020-12-09,Benin,BJ,0,0,11801151,Africa,3073,44
2020-12-10,Benin,BJ,17,0,11801151,Africa,3090,44
2020-12-11,Benin,BJ,0,0,11801151,Africa,3090,44
2020-12-12,Benin,BJ,0,0,11801151,Africa,3090,44
2020-12-13,Benin,BJ,0,0,11801151,Africa,3090,44
2020-12-14,Benin,BJ,0,0,11801151,Africa,3090,44
2020-03-20,Bermuda,BM,2,0,62508,America,2,0
2020-03-21,Bermuda,BM,0,0,62508,America,2,0
2020-03-22,Bermuda,BM,0,0,62508,America,2,0
2020-03-23,Bermuda,BM,4,0,62508,America,6,0
2020-03-24,Bermuda,BM,0,0,62508,America,6,0
2020-03-25,Bermuda,BM,0,0,62508,America,6,0
2020-03-26,Bermuda,BM,0,0,62508,America,6,0
2020-03-27,Bermuda,BM,9,0,62508,America,15,0
2020-03-28,Bermuda,BM,2,0,62508,America,17,0
2020-03-29,Bermuda,BM,5,0,62508,America,22,0
2020-03-30,Bermuda,BM,0,0,62508,America,22,0
2020-03-31,Bermuda,BM,5,0,62508,America,27,0
2020-04-01,Bermuda,BM,5,0,62508,America,32,0
2020-04-02,Bermuda,BM,0,0,62508,America,32,0
2020-04-03,Bermuda,BM,3,0,62508,America,35,0
2020-04-04,Bermuda,BM,0,0,62508,America,35,0
2020-04-05,Bermuda,BM,2,0,62508,America,37,0
2020-04-06,Bermuda,BM,0,0,62508,America,37,0
2020-04-07,Bermuda,BM,2,2,62508,America,39,2
2020-04-08,Bermuda,BM,0,0,62508,America,39,2
2020-04-09,Bermuda,BM,0,1,62508,America,39,3
2020-04-10,Bermuda,BM,9,1,62508,America,48,4
2020-04-11,Bermuda,BM,0,0,62508,America,48,4
2020-04-12,Bermuda,BM,2,0,62508,America,50,4
2020-04-13,Bermuda,BM,7,0,62508,America,57,4
2020-04-14,Bermuda,BM,0,0,62508,America,57,4
2020-04-15,Bermuda,BM,0,1,62508,America,57,5
2020-04-16,Bermuda,BM,24,0,62508,America,81,5
2020-04-17,Bermuda,BM,2,0,62508,America,83,5
2020-04-18,Bermuda,BM,0,0,62508,America,83,5
2020-04-19,Bermuda,BM,3,0,62508,America,86,5
2020-04-20,Bermuda,BM,0,0,62508,America,86,5
2020-04-21,Bermuda,BM,0,0,62508,America,86,5
2020-04-22,Bermuda,BM,12,0,62508,America,98,5
2020-04-23,Bermuda,BM,1,0,62508,America,99,5
2020-04-24,Bermuda,BM,0,0,62508,America,99,5
2020-04-25,Bermuda,BM,0,0,62508,America,99,5
2020-04-26,Bermuda,BM,0,0,62508,America,99,5
2020-04-27,Bermuda,BM,10,0,62508,America,109,5
2020-04-28,Bermuda,BM,1,1,62508,America,110,6
2020-04-29,Bermuda,BM,0,0,62508,America,110,6
2020-04-30,Bermuda,BM,1,0,62508,America,111,6
2020-05-01,Bermuda,BM,3,0,62508,America,114,6
2020-05-02,Bermuda,BM,0,0,62508,America,114,6
2020-05-03,Bermuda,BM,0,1,62508,America,114,7
2020-05-04,Bermuda,BM,1,0,62508,America,115,7
2020-05-05,Bermuda,BM,0,0,62508,America,115,7
2020-05-06,Bermuda,BM,0,0,62508,America,115,7
2020-05-07,Bermuda,BM,3,0,62508,America,118,7
2020-05-08,Bermuda,BM,0,0,62508,America,118,7
2020-05-09,Bermuda,BM,0,0,62508,America,118,7
2020-05-10,Bermuda,BM,0,0,62508,America,118,7
2020-05-11,Bermuda,BM,0,0,62508,America,118,7
2020-05-12,Bermuda,BM,1,1,62508,America,119,8
2020-05-13,Bermuda,BM,2,0,62508,America,121,8
2020-05-14,Bermuda,BM,0,0,62508,America,121,8
2020-05-15,Bermuda,BM,1,1,62508,America,122,9
2020-05-16,Bermuda,BM,1,0,62508,America,123,9
2020-05-17,Bermuda,BM,0,0,62508,America,123,9
2020-05-18,Bermuda,BM,0,0,62508,America,123,9
2020-05-19,Bermuda,BM,2,0,62508,America,125,9
2020-05-20,Bermuda,BM,0,0,62508,America,125,9
2020-05-21,Bermuda,BM,0,0,62508,America,125,9
2020-05-22,Bermuda,BM,0,0,62508,America,125,9
2020-05-23,Bermuda,BM,3,0,62508,America,128,9
2020-05-24,Bermuda,BM,5,0,62508,America,133,9
2020-05-25,Bermuda,BM,0,0,62508,America,133,9
2020-05-26,Bermuda,BM,0,0,62508,America,133,9
2020-05-27,Bermuda,BM,6,0,62508,America,139,9
2020-05-28,Bermuda,BM,0,0,62508,America,139,9
2020-05-29,Bermuda,BM,1,0,62508,America,140,9
2020-05-30,Bermuda,BM,0,0,62508,America,140,9
2020-05-31,Bermuda,BM,0,0,62508,America,140,9
2020-06-01,Bermuda,BM,0,0,62508,America,140,9
2020-06-02,Bermuda,BM,1,0,62508,America,141,9
2020-06-03,Bermuda,BM,0,0,62508,America,141,9
2020-06-04,Bermuda,BM,0,0,62508,America,141,9
2020-06-05,Bermuda,BM,0,0,62508,America,141,9
2020-06-06,Bermuda,BM,0,0,62508,America,141,9
2020-06-07,Bermuda,BM,0,0,62508,America,141,9
2020-06-08,Bermuda,BM,0,0,62508,America,141,9
2020-06-09,Bermuda,BM,0,0,62508,America,141,9
2020-06-10,Bermuda,BM,0,0,62508,America,141,9
2020-06-11,Bermuda,BM,0,0,62508,America,141,9
2020-06-12,Bermuda,BM,0,0,62508,America,141,9
2020-06-13,Bermuda,BM,1,0,62508,America,142,9
2020-06-14,Bermuda,BM,2,0,62508,America,144,9
2020-06-15,Bermuda,BM,0,0,62508,America,144,9
2020-06-16,Bermuda,BM,0,0,62508,America,144,9
2020-06-17,Bermuda,BM,0,0,62508,America,144,9
2020-06-18,Bermuda,BM,0,0,62508,America,144,9
2020-06-19,Bermuda,BM,0,0,62508,America,144,9
2020-06-20,Bermuda,BM,2,0,62508,America,146,9
2020-06-21,Bermuda,BM,0,0,62508,America,146,9
2020-06-22,Bermuda,BM,0,0,62508,America,146,9
2020-06-23,Bermuda,BM,0,0,62508,America,146,9
2020-06-24,Bermuda,BM,0,0,62508,America,146,9
2020-06-25,Bermuda,BM,0,0,62508,America,146,9
2020-06-26,Bermuda,BM,0,0,62508,America,146,9
2020-06-27,Bermuda,BM,0,0,62508,America,146,9
2020-06-28,Bermuda,BM,0,0,62508,America,146,9
2020-06-29,Bermuda,BM,0,0,62508,America,146,9
2020-06-30,Bermuda,BM,0,0,62508,America,146,9
2020-07-01,Bermuda,BM,0,0,62508,America,146,9
2020-07-02,Bermuda,BM,0,0,62508,America,146,9
2020-07-03,Bermuda,BM,0,0,62508,America,146,9
2020-07-04,Bermuda,BM,0,0,62508,America,146,9
2020-07-05,Bermuda,BM,0,0,62508,America,146,9
2020-07-06,Bermuda,BM,0,0,62508,America,146,9
2020-07-07,Bermuda,BM,0,0,62508,America,146,9
2020-07-08,Bermuda,BM,2,0,62508,America,148,9
2020-07-09,Bermuda,BM,1,0,62508,America,149,9
2020-07-10,Bermuda,BM,0,0,62508,America,149,9
2020-07-11,Bermuda,BM,1,0,62508,America,150,9
2020-07-12,Bermuda,BM,0,0,62508,America,150,9
2020-07-13,Bermuda,BM,0,0,62508,America,150,9
2020-07-14,Bermuda,BM,0,0,62508,America,150,9
2020-07-15,Bermuda,BM,0,0,62508,America,150,9
2020-07-16,Bermuda,BM,0,0,62508,America,150,9
2020-07-17,Bermuda,BM,2,0,62508,America,152,9
2020-07-18,Bermuda,BM,0,0,62508,America,152,9
2020-07-19,Bermuda,BM,1,0,62508,America,153,9
2020-07-20,Bermuda,BM,0,0,62508,America,153,9
2020-07-21,Bermuda,BM,0,0,62508,America,153,9
2020-07-22,Bermuda,BM,0,0,62508,America,153,9
2020-07-23,Bermuda,BM,0,0,62508,America,153,9
2020-07-24,Bermuda,BM,0,0,62508,America,153,9
2020-07-25,Bermuda,BM,0,0,62508,America,153,9
2020-07-26,Bermuda,BM,0,0,62508,America,153,9
2020-07-27,Bermuda,BM,1,0,62508,America,154,9
2020-07-28,Bermuda,BM,0,0,62508,America,154,9
2020-07-29,Bermuda,BM,2,0,62508,America,156,9
2020-07-30,Bermuda,BM,0,0,62508,America,156,9
2020-07-31,Bermuda,BM,0,0,62508,America,156,9
2020-08-01,Bermuda,BM,0,0,62508,America,156,9
2020-08-02,Bermuda,BM,0,0,62508,America,156,9
2020-08-03,Bermuda,BM,0,0,62508,America,156,9
2020-08-04,Bermuda,BM,1,0,62508,America,157,9
2020-08-05,Bermuda,BM,0,0,62508,America,157,9
2020-08-06,Bermuda,BM,0,0,62508,America,157,9
2020-08-07,Bermuda,BM,0,0,62508,America,157,9
2020-08-08,Bermuda,BM,0,0,62508,America,157,9
2020-08-09,Bermuda,BM,0,0,62508,America,157,9
2020-08-10,Bermuda,BM,1,0,62508,America,158,9
2020-08-11,Bermuda,BM,1,0,62508,America,159,9
2020-08-12,Bermuda,BM,0,0,62508,America,159,9
2020-08-13,Bermuda,BM,0,0,62508,America,159,9
2020-08-14,Bermuda,BM,0,0,62508,America,159,9
2020-08-15,Bermuda,BM,0,0,62508,America,159,9
2020-08-16,Bermuda,BM,3,0,62508,America,162,9
2020-08-17,Bermuda,BM,0,0,62508,America,162,9
2020-08-18,Bermuda,BM,4,0,62508,America,166,9
2020-08-19,Bermuda,BM,0,0,62508,America,166,9
2020-08-20,Bermuda,BM,0,0,62508,America,166,9
2020-08-21,Bermuda,BM,0,0,62508,America,166,9
2020-08-22,Bermuda,BM,1,0,62508,America,167,9
2020-08-23,Bermuda,BM,0,0,62508,America,167,9
2020-08-24,Bermuda,BM,0,0,62508,America,167,9
2020-08-25,Bermuda,BM,1,0,62508,America,168,9
2020-08-26,Bermuda,BM,0,0,62508,America,168,9
2020-08-27,Bermuda,BM,0,0,62508,America,168,9
2020-08-28,Bermuda,BM,0,0,62508,America,168,9
2020-08-29,Bermuda,BM,0,0,62508,America,168,9
2020-08-30,Bermuda,BM,1,0,62508,America,169,9
2020-08-31,Bermuda,BM,0,0,62508,America,169,9
2020-09-01,Bermuda,BM,3,0,62508,America,172,9
2020-09-02,Bermuda,BM,0,0,62508,America,172,9
2020-09-03,Bermuda,BM,0,0,62508,America,172,9
2020-09-04,Bermuda,BM,2,0,62508,America,174,9
2020-09-05,Bermuda,BM,0,0,62508,America,174,9
2020-09-06,Bermuda,BM,1,0,62508,America,175,9
2020-09-07,Bermuda,BM,0,0,62508,America,175,9
2020-09-08,Bermuda,BM,0,0,62508,America,175,9
2020-09-09,Bermuda,BM,0,0,62508,America,175,9
2020-09-10,Bermuda,BM,2,0,62508,America,177,9
2020-09-11,Bermuda,BM,0,0,62508,America,177,9
2020-09-12,Bermuda,BM,0,0,62508,America,177,9
2020-09-13,Bermuda,BM,0,0,62508,America,177,9
2020-09-14,Bermuda,BM,0,0,62508,America,177,9
2020-09-15,Bermuda,BM,0,0,62508,America,177,9
2020-09-16,Bermuda,BM,0,0,62508,America,177,9
2020-09-17,Bermuda,BM,1,0,62508,America,178,9
2020-09-18,Bermuda,BM,0,0,62508,America,178,9
2020-09-19,Bermuda,BM,0,0,62508,America,178,9
2020-09-20,Bermuda,BM,2,0,62508,America,180,9
2020-09-21,Bermuda,BM,0,0,62508,America,180,9
2020-09-22,Bermuda,BM,0,0,62508,America,180,9
2020-09-23,Bermuda,BM,0,0,62508,America,180,9
2020-09-24,Bermuda,BM,1,0,62508,America,181,9
2020-09-25,Bermuda,BM,0,0,62508,America,181,9
2020-09-26,Bermuda,BM,0,0,62508,America,181,9
2020-09-27,Bermuda,BM,0,0,62508,America,181,9
2020-09-28,Bermuda,BM,0,0,62508,America,181,9
2020-09-29,Bermuda,BM,0,0,62508,America,181,9
2020-09-30,Bermuda,BM,0,0,62508,America,181,9
2020-10-01,Bermuda,BM,0,0,62508,America,181,9
2020-10-02,Bermuda,BM,0,0,62508,America,181,9
2020-10-03,Bermuda,BM,0,0,62508,America,181,9
2020-10-04,Bermuda,BM,0,0,62508,America,181,9
2020-10-05,Bermuda,BM,0,0,62508,America,181,9
2020-10-06,Bermuda,BM,0,0,62508,America,181,9
2020-10-07,Bermuda,BM,0,0,62508,America,181,9
2020-10-08,Bermuda,BM,1,0,62508,America,182,9
2020-10-09,Bermuda,BM,2,0,62508,America,184,9
2020-10-10,Bermuda,BM,0,0,62508,America,184,9
2020-10-11,Bermuda,BM,0,0,62508,America,184,9
2020-10-12,Bermuda,BM,0,0,62508,America,184,9
2020-10-13,Bermuda,BM,0,0,62508,America,184,9
2020-10-14,Bermuda,BM,1,0,62508,America,185,9
2020-10-15,Bermuda,BM,0,0,62508,America,185,9
2020-10-16,Bermuda,BM,0,0,62508,America,185,9
2020-10-17,Bermuda,BM,0,0,62508,America,185,9
2020-10-18,Bermuda,BM,0,0,62508,America,185,9
2020-10-19,Bermuda,BM,0,0,62508,America,185,9
2020-10-20,Bermuda,BM,0,0,62508,America,185,9
2020-10-21,Bermuda,BM,3,0,62508,America,188,9
2020-10-22,Bermuda,BM,0,0,62508,America,188,9
2020-10-23,Bermuda,BM,0,0,62508,America,188,9
2020-10-24,Bermuda,BM,2,0,62508,America,190,9
2020-10-25,Bermuda,BM,1,0,62508,America,191,9
2020-10-26,Bermuda,BM,0,0,62508,America,191,9
2020-10-27,Bermuda,BM,2,0,62508,America,193,9
2020-10-28,Bermuda,BM,1,0,62508,America,194,9
2020-10-29,Bermuda,BM,0,0,62508,America,194,9
2020-10-30,Bermuda,BM,4,0,62508,America,198,9
2020-10-31,Bermuda,BM,1,0,62508,America,199,9
2020-11-01,Bermuda,BM,0,0,62508,America,199,9
2020-11-02,Bermuda,BM,0,0,62508,America,199,9
2020-11-03,Bermuda,BM,7,0,62508,America,206,9
2020-11-04,Bermuda,BM,0,0,62508,America,206,9
2020-11-05,Bermuda,BM,0,0,62508,America,206,9
2020-11-06,Bermuda,BM,1,0,62508,America,207,9
2020-11-07,Bermuda,BM,2,0,62508,America,209,9
2020-11-08,Bermuda,BM,0,0,62508,America,209,9
2020-11-09,Bermuda,BM,0,0,62508,America,209,9
2020-11-10,Bermuda,BM,5,0,62508,America,214,9
2020-11-11,Bermuda,BM,0,0,62508,America,214,9
2020-11-12,Bermuda,BM,1,0,62508,America,215,9
2020-11-13,Bermuda,BM,5,0,62508,America,220,9
2020-11-14,Bermuda,BM,2,0,62508,America,222,9
2020-11-15,Bermuda,BM,0,0,62508,America,222,9
2020-11-16,Bermuda,BM,0,0,62508,America,222,9
2020-11-17,Bermuda,BM,1,0,62508,America,223,9
2020-11-18,Bermuda,BM,0,0,62508,America,223,9
2020-11-19,Bermuda,BM,1,0,62508,America,224,9
2020-11-20,Bermuda,BM,2,0,62508,America,226,9
2020-11-21,Bermuda,BM,1,0,62508,America,227,9
2020-11-22,Bermuda,BM,0,0,62508,America,227,9
2020-11-23,Bermuda,BM,0,0,62508,America,227,9
2020-11-24,Bermuda,BM,0,0,62508,America,227,9
2020-11-25,Bermuda,BM,12,0,62508,America,239,9
2020-11-26,Bermuda,BM,0,0,62508,America,239,9
2020-11-27,Bermuda,BM,2,0,62508,America,241,9
2020-11-28,Bermuda,BM,1,0,62508,America,242,9
2020-11-29,Bermuda,BM,9,0,62508,America,251,9
2020-11-30,Bermuda,BM,0,0,62508,America,251,9
2020-12-01,Bermuda,BM,9,0,62508,America,260,9
2020-12-02,Bermuda,BM,2,0,62508,America,262,9
2020-12-03,Bermuda,BM,5,0,62508,America,267,9
2020-12-04,Bermuda,BM,5,0,62508,America,272,9
2020-12-05,Bermuda,BM,6,0,62508,America,278,9
2020-12-06,Bermuda,BM,10,0,62508,America,288,9
2020-12-07,Bermuda,BM,0,0,62508,America,288,9
2020-12-08,Bermuda,BM,18,0,62508,America,306,9
2020-12-09,Bermuda,BM,24,0,62508,America,330,9
2020-12-10,Bermuda,BM,10,0,62508,America,340,9
2020-12-11,Bermuda,BM,24,0,62508,America,364,9
2020-12-12,Bermuda,BM,27,0,62508,America,391,9
2020-12-13,Bermuda,BM,0,0,62508,America,391,9
2020-12-14,Bermuda,BM,40,0,62508,America,431,9
2020-03-10,Brunei_Darussalam,BN,1,0,433296,Asia,1,0
2020-03-12,Brunei_Darussalam,BN,10,0,433296,Asia,11,0
2020-03-13,Brunei_Darussalam,BN,14,0,433296,Asia,25,0
2020-03-14,Brunei_Darussalam,BN,12,0,433296,Asia,37,0
2020-03-15,Brunei_Darussalam,BN,3,0,433296,Asia,40,0
2020-03-16,Brunei_Darussalam,BN,10,0,433296,Asia,50,0
2020-03-17,Brunei_Darussalam,BN,4,0,433296,Asia,54,0
2020-03-18,Brunei_Darussalam,BN,2,0,433296,Asia,56,0
2020-03-19,Brunei_Darussalam,BN,12,0,433296,Asia,68,0
2020-03-20,Brunei_Darussalam,BN,5,0,433296,Asia,73,0
2020-03-21,Brunei_Darussalam,BN,5,0,433296,Asia,78,0
2020-03-22,Brunei_Darussalam,BN,5,0,433296,Asia,83,0
2020-03-23,Brunei_Darussalam,BN,5,0,433296,Asia,88,0
2020-03-24,Brunei_Darussalam,BN,3,0,433296,Asia,91,0
2020-03-25,Brunei_Darussalam,BN,13,0,433296,Asia,104,0
2020-03-26,Brunei_Darussalam,BN,3,0,433296,Asia,107,0
2020-03-27,Brunei_Darussalam,BN,7,0,433296,Asia,114,0
2020-03-28,Brunei_Darussalam,BN,1,0,433296,Asia,115,0
2020-03-29,Brunei_Darussalam,BN,5,1,433296,Asia,120,1
2020-03-30,Brunei_Darussalam,BN,6,0,433296,Asia,126,1
2020-03-31,Brunei_Darussalam,BN,1,0,433296,Asia,127,1
2020-04-01,Brunei_Darussalam,BN,2,0,433296,Asia,129,1
2020-04-02,Brunei_Darussalam,BN,2,0,433296,Asia,131,1
2020-04-03,Brunei_Darussalam,BN,2,0,433296,Asia,133,1
2020-04-04,Brunei_Darussalam,BN,0,0,433296,Asia,133,1
2020-04-05,Brunei_Darussalam,BN,2,0,433296,Asia,135,1
2020-04-06,Brunei_Darussalam,BN,0,0,433296,Asia,135,1
2020-04-07,Brunei_Darussalam,BN,0,0,433296,Asia,135,1
2020-04-08,Brunei_Darussalam,BN,0,0,433296,Asia,135,1
2020-04-09,Brunei_Darussalam,BN,0,0,433296,Asia,135,1
2020-04-10,Brunei_Darussalam,BN,0,0,433296,Asia,135,1
2020-04-11,Brunei_Darussalam,BN,1,0,433296,Asia,136,1
2020-04-12,Brunei_Darussalam,BN,0,0,433296,Asia,136,1
2020-04-13,Brunei_Darussalam,BN,0,0,433296,Asia,136,1
2020-04-14,Brunei_Darussalam,BN,0,0,433296,Asia,136,1
2020-04-15,Brunei_Darussalam,BN,0,0,433296,Asia,136,1
2020-04-16,Brunei_Darussalam,BN,0,0,433296,Asia,136,1
2020-04-17,Brunei_Darussalam,BN,0,0,433296,Asia,136,1
2020-04-18,Brunei_Darussalam,BN,0,0,433296,Asia,136,1
2020-04-19,Brunei_Darussalam,BN,1,0,433296,Asia,137,1
2020-04-20,Brunei_Darussalam,BN,1,0,433296,Asia,138,1
2020-04-21,Brunei_Darussalam,BN,0,0,433296,Asia,138,1
2020-04-22,Brunei_Darussalam,BN,0,0,433296,Asia,138,1
2020-04-23,Brunei_Darussalam,BN,0,0,433296,Asia,138,1
2020-04-24,Brunei_Darussalam,BN,0,0,433296,Asia,138,1
2020-04-25,Brunei_Darussalam,BN,0,0,433296,Asia,138,1
2020-04-26,Brunei_Darussalam,BN,0,0,433296,Asia,138,1
2020-04-27,Brunei_Darussalam,BN,0,0,433296,Asia,138,1
2020-04-28,Brunei_Darussalam,BN,0,0,433296,Asia,138,1
2020-04-29,Brunei_Darussalam,BN,0,0,433296,Asia,138,1
2020-04-30,Brunei_Darussalam,BN,0,0,433296,Asia,138,1
2020-05-01,Brunei_Darussalam,BN,0,0,433296,Asia,138,1
2020-05-02,Brunei_Darussalam,BN,0,0,433296,Asia,138,1
2020-05-03,Brunei_Darussalam,BN,0,0,433296,Asia,138,1
2020-05-04,Brunei_Darussalam,BN,0,0,433296,Asia,138,1
2020-05-05,Brunei_Darussalam,BN,0,0,433296,Asia,138,1
2020-05-06,Brunei_Darussalam,BN,0,0,433296,Asia,138,1
2020-05-07,Brunei_Darussalam,BN,1,0,433296,Asia,139,1
2020-05-08,Brunei_Darussalam,BN,2,0,433296,Asia,141,1
2020-05-09,Brunei_Darussalam,BN,0,0,433296,Asia,141,1
2020-05-10,Brunei_Darussalam,BN,0,0,433296,Asia,141,1
2020-05-11,Brunei_Darussalam,BN,0,0,433296,Asia,141,1
2020-05-12,Brunei_Darussalam,BN,0,0,433296,Asia,141,1
2020-05-13,Brunei_Darussalam,BN,0,0,433296,Asia,141,1
2020-05-14,Brunei_Darussalam,BN,0,0,433296,Asia,141,1
2020-05-15,Brunei_Darussalam,BN,0,0,433296,Asia,141,1
2020-05-16,Brunei_Darussalam,BN,0,0,433296,Asia,141,1
2020-05-17,Brunei_Darussalam,BN,0,0,433296,Asia,141,1
2020-05-18,Brunei_Darussalam,BN,0,0,433296,Asia,141,1
2020-05-19,Brunei_Darussalam,BN,0,0,433296,Asia,141,1
2020-05-20,Brunei_Darussalam,BN,0,0,433296,Asia,141,1
2020-05-21,Brunei_Darussalam,BN,0,0,433296,Asia,141,1
2020-05-22,Brunei_Darussalam,BN,0,0,433296,Asia,141,1
2020-05-23,Brunei_Darussalam,BN,0,0,433296,Asia,141,1
2020-05-24,Brunei_Darussalam,BN,0,0,433296,Asia,141,1
2020-05-25,Brunei_Darussalam,BN,0,0,433296,Asia,141,1
2020-05-26,Brunei_Darussalam,BN,0,0,433296,Asia,141,1
2020-05-27,Brunei_Darussalam,BN,0,0,433296,Asia,141,1
2020-05-28,Brunei_Darussalam,BN,0,1,433296,Asia,141,2
2020-05-29,Brunei_Darussalam,BN,0,0,433296,Asia,141,2
2020-05-30,Brunei_Darussalam,BN,0,0,433296,Asia,141,2
2020-05-31,Brunei_Darussalam,BN,0,0,433296,Asia,141,2
2020-06-01,Brunei_Darussalam,BN,0,0,433296,Asia,141,2
2020-06-02,Brunei_Darussalam,BN,0,0,433296,Asia,141,2
2020-06-03,Brunei_Darussalam,BN,0,0,433296,Asia,141,2
2020-06-04,Brunei_Darussalam,BN,0,0,433296,Asia,141,2
2020-06-05,Brunei_Darussalam,BN,0,0,433296,Asia,141,2
2020-06-06,Brunei_Darussalam,BN,0,0,433296,Asia,141,2
2020-06-07,Brunei_Darussalam,BN,0,0,433296,Asia,141,2
2020-06-08,Brunei_Darussalam,BN,0,0,433296,Asia,141,2
2020-06-09,Brunei_Darussalam,BN,0,0,433296,Asia,141,2
2020-06-10,Brunei_Darussalam,BN,0,0,433296,Asia,141,2
2020-06-11,Brunei_Darussalam,BN,0,0,433296,Asia,141,2
2020-06-12,Brunei_Darussalam,BN,0,0,433296,Asia,141,2
2020-06-13,Brunei_Darussalam,BN,0,0,433296,Asia,141,2
2020-06-14,Brunei_Darussalam,BN,0,0,433296,Asia,141,2
2020-06-15,Brunei_Darussalam,BN,0,0,433296,Asia,141,2
2020-06-16,Brunei_Darussalam,BN,0,0,433296,Asia,141,2
2020-06-17,Brunei_Darussalam,BN,0,1,433296,Asia,141,3
2020-06-18,Brunei_Darussalam,BN,0,0,433296,Asia,141,3
2020-06-19,Brunei_Darussalam,BN,0,0,433296,Asia,141,3
2020-06-20,Brunei_Darussalam,BN,0,0,433296,Asia,141,3
2020-06-21,Brunei_Darussalam,BN,0,0,433296,Asia,141,3
2020-06-22,Brunei_Darussalam,BN,0,0,433296,Asia,141,3
2020-06-23,Brunei_Darussalam,BN,0,0,433296,Asia,141,3
2020-06-24,Brunei_Darussalam,BN,0,0,433296,Asia,141,3
2020-06-25,Brunei_Darussalam,BN,0,0,433296,Asia,141,3
2020-06-26,Brunei_Darussalam,BN,0,0,433296,Asia,141,3
2020-06-27,Brunei_Darussalam,BN,0,0,433296,Asia,141,3
2020-06-28,Brunei_Darussalam,BN,0,0,433296,Asia,141,3
2020-06-29,Brunei_Darussalam,BN,0,0,433296,Asia,141,3
2020-06-30,Brunei_Darussalam,BN,0,0,433296,Asia,141,3
2020-07-01,Brunei_Darussalam,BN,0,0,433296,Asia,141,3
2020-07-02,Brunei_Darussalam,BN,0,0,433296,Asia,141,3
2020-07-03,Brunei_Darussalam,BN,0,0,433296,Asia,141,3
2020-07-04,Brunei_Darussalam,BN,0,0,433296,Asia,141,3
2020-07-05,Brunei_Darussalam,BN,0,0,433296,Asia,141,3
2020-07-06,Brunei_Darussalam,BN,0,0,433296,Asia,141,3
2020-07-07,Brunei_Darussalam,BN,0,0,433296,Asia,141,3
2020-07-08,Brunei_Darussalam,BN,0,0,433296,Asia,141,3
2020-07-09,Brunei_Darussalam,BN,0,0,433296,Asia,141,3
2020-07-10,Brunei_Darussalam,BN,0,0,433296,Asia,141,3
2020-07-11,Brunei_Darussalam,BN,0,0,433296,Asia,141,3
2020-07-12,Brunei_Darussalam,BN,0,0,433296,Asia,141,3
2020-07-13,Brunei_Darussalam,BN,0,0,433296,Asia,141,3
2020-07-14,Brunei_Darussalam,BN,0,0,433296,Asia,141,3
2020-07-15,Brunei_Darussalam,BN,0,0,433296,Asia,141,3
2020-07-16,Brunei_Darussalam,BN,0,0,433296,Asia,141,3
2020-07-17,Brunei_Darussalam,BN,0,0,433296,Asia,141,3
2020-07-18,Brunei_Darussalam,BN,0,0,433296,Asia,141,3
2020-07-19,Brunei_Darussalam,BN,0,0,433296,Asia,141,3
2020-07-20,Brunei_Darussalam,BN,0,0,433296,Asia,141,3
2020-07-21,Brunei_Darussalam,BN,0,0,433296,Asia,141,3
2020-07-22,Brunei_Darussalam,BN,0,0,433296,Asia,141,3
2020-07-23,Brunei_Darussalam,BN,0,0,433296,Asia,141,3
2020-07-24,Brunei_Darussalam,BN,0,0,433296,Asia,141,3
2020-07-25,Brunei_Darussalam,BN,0,0,433296,Asia,141,3
2020-07-26,Brunei_Darussalam,BN,0,0,433296,Asia,141,3
2020-07-27,Brunei_Darussalam,BN,0,0,433296,Asia,141,3
2020-07-28,Brunei_Darussalam,BN,0,0,433296,Asia,141,3
2020-07-29,Brunei_Darussalam,BN,0,0,433296,Asia,141,3
2020-07-30,Brunei_Darussalam,BN,0,0,433296,Asia,141,3
2020-07-31,Brunei_Darussalam,BN,0,0,433296,Asia,141,3
2020-08-01,Brunei_Darussalam,BN,0,0,433296,Asia,141,3
2020-08-02,Brunei_Darussalam,BN,0,0,433296,Asia,141,3
2020-08-03,Brunei_Darussalam,BN,0,0,433296,Asia,141,3
2020-08-04,Brunei_Darussalam,BN,0,0,433296,Asia,141,3
2020-08-05,Brunei_Darussalam,BN,0,0,433296,Asia,141,3
2020-08-06,Brunei_Darussalam,BN,0,0,433296,Asia,141,3
2020-08-07,Brunei_Darussalam,BN,0,0,433296,Asia,141,3
2020-08-08,Brunei_Darussalam,BN,1,0,433296,Asia,142,3
2020-08-09,Brunei_Darussalam,BN,0,0,433296,Asia,142,3
2020-08-10,Brunei_Darussalam,BN,0,0,433296,Asia,142,3
2020-08-11,Brunei_Darussalam,BN,0,0,433296,Asia,142,3
2020-08-12,Brunei_Darussalam,BN,0,0,433296,Asia,142,3
2020-08-13,Brunei_Darussalam,BN,0,0,433296,Asia,142,3
2020-08-14,Brunei_Darussalam,BN,0,0,433296,Asia,142,3
2020-08-15,Brunei_Darussalam,BN,0,0,433296,Asia,142,3
2020-08-16,Brunei_Darussalam,BN,0,0,433296,Asia,142,3
2020-08-17,Brunei_Darussalam,BN,0,0,433296,Asia,142,3
2020-08-18,Brunei_Darussalam,BN,0,0,433296,Asia,142,3
2020-08-19,Brunei_Darussalam,BN,0,0,433296,Asia,142,3
2020-08-20,Brunei_Darussalam,BN,0,0,433296,Asia,142,3
2020-08-21,Brunei_Darussalam,BN,1,0,433296,Asia,143,3
2020-08-22,Brunei_Darussalam,BN,0,0,433296,Asia,143,3
2020-08-23,Brunei_Darussalam,BN,0,0,433296,Asia,143,3
2020-08-24,Brunei_Darussalam,BN,0,0,433296,Asia,143,3
2020-08-25,Brunei_Darussalam,BN,0,0,433296,Asia,143,3
2020-08-26,Brunei_Darussalam,BN,1,0,433296,Asia,144,3
2020-08-27,Brunei_Darussalam,BN,0,0,433296,Asia,144,3
2020-08-28,Brunei_Darussalam,BN,0,0,433296,Asia,144,3
2020-08-29,Brunei_Darussalam,BN,0,0,433296,Asia,144,3
2020-08-30,Brunei_Darussalam,BN,0,0,433296,Asia,144,3
2020-08-31,Brunei_Darussalam,BN,0,0,433296,Asia,144,3
2020-09-01,Brunei_Darussalam,BN,0,0,433296,Asia,144,3
2020-09-02,Brunei_Darussalam,BN,0,0,433296,Asia,144,3
2020-09-03,Brunei_Darussalam,BN,0,0,433296,Asia,144,3
2020-09-04,Brunei_Darussalam,BN,0,0,433296,Asia,144,3
2020-09-05,Brunei_Darussalam,BN,1,0,433296,Asia,145,3
2020-09-06,Brunei_Darussalam,BN,0,0,433296,Asia,145,3
2020-09-07,Brunei_Darussalam,BN,0,0,433296,Asia,145,3
2020-09-08,Brunei_Darussalam,BN,0,0,433296,Asia,145,3
2020-09-09,Brunei_Darussalam,BN,0,0,433296,Asia,145,3
2020-09-10,Brunei_Darussalam,BN,0,0,433296,Asia,145,3
2020-09-11,Brunei_Darussalam,BN,0,0,433296,Asia,145,3
2020-09-12,Brunei_Darussalam,BN,0,0,433296,Asia,145,3
2020-09-13,Brunei_Darussalam,BN,0,0,433296,Asia,145,3
2020-09-14,Brunei_Darussalam,BN,0,0,433296,Asia,145,3
2020-09-15,Brunei_Darussalam,BN,0,0,433296,Asia,145,3
2020-09-16,Brunei_Darussalam,BN,0,0,433296,Asia,145,3
2020-09-17,Brunei_Darussalam,BN,0,0,433296,Asia,145,3
2020-09-18,Brunei_Darussalam,BN,0,0,433296,Asia,145,3
2020-09-19,Brunei_Darussalam,BN,0,0,433296,Asia,145,3
2020-09-20,Brunei_Darussalam,BN,0,0,433296,Asia,145,3
2020-09-21,Brunei_Darussalam,BN,0,0,433296,Asia,145,3
2020-09-22,Brunei_Darussalam,BN,0,0,433296,Asia,145,3
2020-09-23,Brunei_Darussalam,BN,0,0,433296,Asia,145,3
2020-09-24,Brunei_Darussalam,BN,0,0,433296,Asia,145,3
2020-09-25,Brunei_Darussalam,BN,0,0,433296,Asia,145,3
2020-09-26,Brunei_Darussalam,BN,0,0,433296,Asia,145,3
2020-09-27,Brunei_Darussalam,BN,1,0,433296,Asia,146,3
2020-09-28,Brunei_Darussalam,BN,0,0,433296,Asia,146,3
2020-09-29,Brunei_Darussalam,BN,0,0,433296,Asia,146,3
2020-09-30,Brunei_Darussalam,BN,0,0,433296,Asia,146,3
2020-10-01,Brunei_Darussalam,BN,0,0,433296,Asia,146,3
2020-10-02,Brunei_Darussalam,BN,0,0,433296,Asia,146,3
2020-10-03,Brunei_Darussalam,BN,0,0,433296,Asia,146,3
2020-10-04,Brunei_Darussalam,BN,0,0,433296,Asia,146,3
2020-10-05,Brunei_Darussalam,BN,0,0,433296,Asia,146,3
2020-10-06,Brunei_Darussalam,BN,0,0,433296,Asia,146,3
2020-10-07,Brunei_Darussalam,BN,0,0,433296,Asia,146,3
2020-10-08,Brunei_Darussalam,BN,0,0,433296,Asia,146,3
2020-10-09,Brunei_Darussalam,BN,0,0,433296,Asia,146,3
2020-10-10,Brunei_Darussalam,BN,0,0,433296,Asia,146,3
2020-10-11,Brunei_Darussalam,BN,0,0,433296,Asia,146,3
2020-10-12,Brunei_Darussalam,BN,0,0,433296,Asia,146,3
2020-10-13,Brunei_Darussalam,BN,0,0,433296,Asia,146,3
2020-10-14,Brunei_Darussalam,BN,0,0,433296,Asia,146,3
2020-10-15,Brunei_Darussalam,BN,1,0,433296,Asia,147,3
2020-10-16,Brunei_Darussalam,BN,0,0,433296,Asia,147,3
2020-10-17,Brunei_Darussalam,BN,0,0,433296,Asia,147,3
2020-10-18,Brunei_Darussalam,BN,0,0,433296,Asia,147,3
2020-10-19,Brunei_Darussalam,BN,0,0,433296,Asia,147,3
2020-10-20,Brunei_Darussalam,BN,0,0,433296,Asia,147,3
2020-10-21,Brunei_Darussalam,BN,0,0,433296,Asia,147,3
2020-10-22,Brunei_Darussalam,BN,0,0,433296,Asia,147,3
2020-10-23,Brunei_Darussalam,BN,1,0,433296,Asia,148,3
2020-10-24,Brunei_Darussalam,BN,0,0,433296,Asia,148,3
2020-10-25,Brunei_Darussalam,BN,0,0,433296,Asia,148,3
2020-10-26,Brunei_Darussalam,BN,0,0,433296,Asia,148,3
2020-10-27,Brunei_Darussalam,BN,0,0,433296,Asia,148,3
2020-10-28,Brunei_Darussalam,BN,0,0,433296,Asia,148,3
2020-10-29,Brunei_Darussalam,BN,0,0,433296,Asia,148,3
2020-10-30,Brunei_Darussalam,BN,0,0,433296,Asia,148,3
2020-10-31,Brunei_Darussalam,BN,0,0,433296,Asia,148,3
2020-11-01,Brunei_Darussalam,BN,0,0,433296,Asia,148,3
2020-11-02,Brunei_Darussalam,BN,0,0,433296,Asia,148,3
2020-11-03,Brunei_Darussalam,BN,0,0,433296,Asia,148,3
2020-11-04,Brunei_Darussalam,BN,0,0,433296,Asia,148,3
2020-11-05,Brunei_Darussalam,BN,0,0,433296,Asia,148,3
2020-11-06,Brunei_Darussalam,BN,0,0,433296,Asia,148,3
2020-11-07,Brunei_Darussalam,BN,0,0,433296,Asia,148,3
2020-11-08,Brunei_Darussalam,BN,0,0,433296,Asia,148,3
2020-11-09,Brunei_Darussalam,BN,0,0,433296,Asia,148,3
2020-11-10,Brunei_Darussalam,BN,0,0,433296,Asia,148,3
2020-11-11,Brunei_Darussalam,BN,0,0,433296,Asia,148,3
2020-11-12,Brunei_Darussalam,BN,0,0,433296,Asia,148,3
2020-11-13,Brunei_Darussalam,BN,0,0,433296,Asia,148,3
2020-11-14,Brunei_Darussalam,BN,0,0,433296,Asia,148,3
2020-11-15,Brunei_Darussalam,BN,0,0,433296,Asia,148,3
2020-11-16,Brunei_Darussalam,BN,0,0,433296,Asia,148,3
2020-11-17,Brunei_Darussalam,BN,0,0,433296,Asia,148,3
2020-11-18,Brunei_Darussalam,BN,0,0,433296,Asia,148,3
2020-11-19,Brunei_Darussalam,BN,0,0,433296,Asia,148,3
2020-11-20,Brunei_Darussalam,BN,0,0,433296,Asia,148,3
2020-11-21,Brunei_Darussalam,BN,0,0,433296,Asia,148,3
2020-11-22,Brunei_Darussalam,BN,0,0,433296,Asia,148,3
2020-11-23,Brunei_Darussalam,BN,0,0,433296,Asia,148,3
2020-11-24,Brunei_Darussalam,BN,0,0,433296,Asia,148,3
2020-11-25,Brunei_Darussalam,BN,1,0,433296,Asia,149,3
2020-11-26,Brunei_Darussalam,BN,1,0,433296,Asia,150,3
2020-11-27,Brunei_Darussalam,BN,0,0,433296,Asia,150,3
2020-11-28,Brunei_Darussalam,BN,0,0,433296,Asia,150,3
2020-11-29,Brunei_Darussalam,BN,0,0,433296,Asia,150,3
2020-11-30,Brunei_Darussalam,BN,0,0,433296,Asia,150,3
2020-12-01,Brunei_Darussalam,BN,0,0,433296,Asia,150,3
2020-12-02,Brunei_Darussalam,BN,0,0,433296,Asia,150,3
2020-12-03,Brunei_Darussalam,BN,1,0,433296,Asia,151,3
2020-12-04,Brunei_Darussalam,BN,0,0,433296,Asia,151,3
2020-12-05,Brunei_Darussalam,BN,0,0,433296,Asia,151,3
2020-12-06,Brunei_Darussalam,BN,0,0,433296,Asia,151,3
2020-12-07,Brunei_Darussalam,BN,0,0,433296,Asia,151,3
2020-12-08,Brunei_Darussalam,BN,0,0,433296,Asia,151,3
2020-12-09,Brunei_Darussalam,BN,0,0,433296,Asia,151,3
2020-12-10,Brunei_Darussalam,BN,1,0,433296,Asia,152,3
2020-12-11,Brunei_Darussalam,BN,0,0,433296,Asia,152,3
2020-12-12,Brunei_Darussalam,BN,0,0,433296,Asia,152,3
2020-12-13,Brunei_Darussalam,BN,0,0,433296,Asia,152,3
2020-12-14,Brunei_Darussalam,BN,0,0,433296,Asia,152,3
2020-03-12,Bolivia,BO,2,0,11513102,America,2,0
2020-03-13,Bolivia,BO,1,0,11513102,America,3,0
2020-03-14,Bolivia,BO,7,0,11513102,America,10,0
2020-03-15,Bolivia,BO,0,0,11513102,America,10,0
2020-03-17,Bolivia,BO,1,0,11513102,America,11,0
2020-03-18,Bolivia,BO,1,0,11513102,America,12,0
2020-03-19,Bolivia,BO,0,0,11513102,America,12,0
2020-03-20,Bolivia,BO,3,0,11513102,America,15,0
2020-03-21,Bolivia,BO,4,0,11513102,America,19,0
2020-03-22,Bolivia,BO,1,0,11513102,America,20,0
2020-03-23,Bolivia,BO,7,0,11513102,America,27,0
2020-03-24,Bolivia,BO,1,0,11513102,America,28,0
2020-03-25,Bolivia,BO,4,0,11513102,America,32,0
2020-03-26,Bolivia,BO,7,0,11513102,America,39,0
2020-03-27,Bolivia,BO,22,0,11513102,America,61,0
2020-03-28,Bolivia,BO,13,0,11513102,America,74,0
2020-03-29,Bolivia,BO,7,0,11513102,America,81,0
2020-03-30,Bolivia,BO,15,3,11513102,America,96,3
2020-03-31,Bolivia,BO,11,3,11513102,America,107,6
2020-04-01,Bolivia,BO,8,1,11513102,America,115,7
2020-04-02,Bolivia,BO,8,1,11513102,America,123,8
2020-04-03,Bolivia,BO,9,1,11513102,America,132,9
2020-04-04,Bolivia,BO,7,1,11513102,America,139,10
2020-04-05,Bolivia,BO,18,0,11513102,America,157,10
2020-04-06,Bolivia,BO,26,1,11513102,America,183,11
2020-04-07,Bolivia,BO,11,3,11513102,America,194,14
2020-04-08,Bolivia,BO,16,1,11513102,America,210,15
2020-04-09,Bolivia,BO,54,3,11513102,America,264,18
2020-04-10,Bolivia,BO,4,1,11513102,America,268,19
2020-04-11,Bolivia,BO,8,1,11513102,America,276,20
2020-04-12,Bolivia,BO,24,4,11513102,America,300,24
2020-04-13,Bolivia,BO,30,3,11513102,America,330,27
2020-04-14,Bolivia,BO,24,1,11513102,America,354,28
2020-04-15,Bolivia,BO,43,0,11513102,America,397,28
2020-04-16,Bolivia,BO,44,1,11513102,America,441,29
2020-04-17,Bolivia,BO,24,2,11513102,America,465,31
2020-04-18,Bolivia,BO,28,0,11513102,America,493,31
2020-04-19,Bolivia,BO,27,1,11513102,America,520,32
2020-04-20,Bolivia,BO,44,1,11513102,America,564,33
2020-04-21,Bolivia,BO,34,1,11513102,America,598,34
2020-04-22,Bolivia,BO,11,3,11513102,America,609,37
2020-04-23,Bolivia,BO,63,3,11513102,America,672,40
2020-04-24,Bolivia,BO,31,3,11513102,America,703,43
2020-04-25,Bolivia,BO,104,1,11513102,America,807,44
2020-04-26,Bolivia,BO,59,2,11513102,America,866,46
2020-04-27,Bolivia,BO,84,4,11513102,America,950,50
2020-04-28,Bolivia,BO,64,3,11513102,America,1014,53
2020-04-29,Bolivia,BO,39,2,11513102,America,1053,55
2020-04-30,Bolivia,BO,57,4,11513102,America,1110,59
2020-05-01,Bolivia,BO,57,3,11513102,America,1167,62
2020-05-02,Bolivia,BO,62,4,11513102,America,1229,66
2020-05-03,Bolivia,BO,241,5,11513102,America,1470,71
2020-05-04,Bolivia,BO,124,5,11513102,America,1594,76
2020-05-05,Bolivia,BO,87,6,11513102,America,1681,82
2020-05-06,Bolivia,BO,121,4,11513102,America,1802,86
2020-05-07,Bolivia,BO,84,5,11513102,America,1886,91
2020-05-08,Bolivia,BO,195,11,11513102,America,2081,102
2020-05-09,Bolivia,BO,185,4,11513102,America,2266,106
2020-05-10,Bolivia,BO,171,8,11513102,America,2437,114
2020-05-11,Bolivia,BO,119,4,11513102,America,2556,118
2020-05-12,Bolivia,BO,275,4,11513102,America,2831,122
2020-05-13,Bolivia,BO,133,6,11513102,America,2964,128
2020-05-14,Bolivia,BO,184,14,11513102,America,3148,142
2020-05-15,Bolivia,BO,224,10,11513102,America,3372,152
2020-05-16,Bolivia,BO,205,12,11513102,America,3577,164
2020-05-17,Bolivia,BO,249,1,11513102,America,3826,165
2020-05-18,Bolivia,BO,262,4,11513102,America,4088,169
2020-05-19,Bolivia,BO,175,5,11513102,America,4263,174
2020-05-20,Bolivia,BO,218,15,11513102,America,4481,189
2020-05-21,Bolivia,BO,438,10,11513102,America,4919,199
2020-05-22,Bolivia,BO,268,16,11513102,America,5187,215
2020-05-23,Bolivia,BO,392,15,11513102,America,5579,230
2020-05-24,Bolivia,BO,336,10,11513102,America,5915,240
2020-05-25,Bolivia,BO,348,10,11513102,America,6263,250
2020-05-26,Bolivia,BO,397,11,11513102,America,6660,261
2020-05-27,Bolivia,BO,476,13,11513102,America,7136,274
2020-05-28,Bolivia,BO,632,6,11513102,America,7768,280
2020-05-29,Bolivia,BO,619,13,11513102,America,8387,293
2020-05-30,Bolivia,BO,344,7,11513102,America,8731,300
2020-05-31,Bolivia,BO,861,10,11513102,America,9592,310
2020-06-01,Bolivia,BO,390,3,11513102,America,9982,313
2020-06-02,Bolivia,BO,549,30,11513102,America,10531,343
2020-06-03,Bolivia,BO,460,33,11513102,America,10991,376
2020-06-04,Bolivia,BO,647,24,11513102,America,11638,400
2020-06-05,Bolivia,BO,607,15,11513102,America,12245,415
2020-06-06,Bolivia,BO,483,12,11513102,America,12728,427
2020-06-07,Bolivia,BO,630,27,11513102,America,13358,454
2020-06-08,Bolivia,BO,285,11,11513102,America,13643,465
2020-06-09,Bolivia,BO,306,10,11513102,America,13949,475
2020-06-10,Bolivia,BO,695,12,11513102,America,14644,487
2020-06-11,Bolivia,BO,637,25,11513102,America,15281,512
2020-06-12,Bolivia,BO,884,21,11513102,America,16165,533
2020-06-13,Bolivia,BO,764,26,11513102,America,16929,559
2020-06-14,Bolivia,BO,913,26,11513102,America,17842,585
2020-06-15,Bolivia,BO,617,26,11513102,America,18459,611
2020-06-16,Bolivia,BO,614,21,11513102,America,19073,632
2020-06-17,Bolivia,BO,810,27,11513102,America,19883,659
2020-06-18,Bolivia,BO,802,20,11513102,America,20685,679
2020-06-19,Bolivia,BO,814,18,11513102,America,21499,697
2020-06-20,Bolivia,BO,977,18,11513102,America,22476,715
2020-06-21,Bolivia,BO,1036,25,11513102,America,23512,740
2020-06-22,Bolivia,BO,876,33,11513102,America,24388,773
2020-06-23,Bolivia,BO,1105,47,11513102,America,25493,820
2020-06-24,Bolivia,BO,896,26,11513102,America,26389,846
2020-06-25,Bolivia,BO,1098,30,11513102,America,27487,876
2020-06-26,Bolivia,BO,1016,37,11513102,America,28503,913
2020-06-27,Bolivia,BO,920,21,11513102,America,29423,934
2020-06-28,Bolivia,BO,1253,36,11513102,America,30676,970
2020-06-29,Bolivia,BO,848,44,11513102,America,31524,1014
2020-06-30,Bolivia,BO,601,57,11513102,America,32125,1071
2020-07-01,Bolivia,BO,1094,52,11513102,America,33219,1123
2020-07-02,Bolivia,BO,1008,78,11513102,America,34227,1201
2020-07-03,Bolivia,BO,1301,70,11513102,America,35528,1271
2020-07-04,Bolivia,BO,1290,49,11513102,America,36818,1320
2020-07-05,Bolivia,BO,1253,58,11513102,America,38071,1378
2020-07-06,Bolivia,BO,1226,56,11513102,America,39297,1434
2020-07-07,Bolivia,BO,1212,42,11513102,America,40509,1476
2020-07-08,Bolivia,BO,1036,54,11513102,America,41545,1530
2020-07-09,Bolivia,BO,1439,47,11513102,America,42984,1577
2020-07-10,Bolivia,BO,1129,61,11513102,America,44113,1638
2020-07-11,Bolivia,BO,1452,64,11513102,America,45565,1702
2020-07-12,Bolivia,BO,1635,52,11513102,America,47200,1754
2020-07-13,Bolivia,BO,987,53,11513102,America,48187,1807
2020-07-14,Bolivia,BO,1063,59,11513102,America,49250,1866
2020-07-15,Bolivia,BO,1617,32,11513102,America,50867,1898
2020-07-16,Bolivia,BO,1351,44,11513102,America,52218,1942
2020-07-17,Bolivia,BO,1938,42,11513102,America,54156,1984
2020-07-18,Bolivia,BO,1946,65,11513102,America,56102,2049
2020-07-19,Bolivia,BO,2036,57,11513102,America,58138,2106
2020-07-20,Bolivia,BO,1444,45,11513102,America,59582,2151
2020-07-21,Bolivia,BO,1409,67,11513102,America,60991,2218
2020-07-22,Bolivia,BO,1366,55,11513102,America,62357,2273
2020-07-23,Bolivia,BO,1778,55,11513102,America,64135,2328
2020-07-24,Bolivia,BO,1117,79,11513102,America,65252,2407
2020-07-25,Bolivia,BO,1204,66,11513102,America,66456,2473
2020-07-26,Bolivia,BO,1825,62,11513102,America,68281,2535
2020-07-27,Bolivia,BO,1148,48,11513102,America,69429,2583
2020-07-28,Bolivia,BO,2382,64,11513102,America,71811,2647
2020-07-29,Bolivia,BO,516,73,11513102,America,72327,2720
2020-07-30,Bolivia,BO,1207,88,11513102,America,73534,2808
2020-07-31,Bolivia,BO,1700,86,11513102,America,75234,2894
2020-08-01,Bolivia,BO,1555,83,11513102,America,76789,2977
2020-08-02,Bolivia,BO,2004,87,11513102,America,78793,3064
2020-08-03,Bolivia,BO,1360,89,11513102,America,80153,3153
2020-08-04,Bolivia,BO,1693,75,11513102,America,81846,3228
2020-08-05,Bolivia,BO,1515,92,11513102,America,83361,3320
2020-08-06,Bolivia,BO,1780,65,11513102,America,85141,3385
2020-08-07,Bolivia,BO,1282,80,11513102,America,86423,3465
2020-08-08,Bolivia,BO,1468,59,11513102,America,87891,3524
2020-08-09,Bolivia,BO,1164,63,11513102,America,89055,3587
2020-08-10,Bolivia,BO,944,53,11513102,America,89999,3640
2020-08-11,Bolivia,BO,1636,72,11513102,America,91635,3712
2020-08-12,Bolivia,BO,1693,49,11513102,America,93328,3761
2020-08-13,Bolivia,BO,1743,66,11513102,America,95071,3827
2020-08-14,Bolivia,BO,0,0,11513102,America,95071,3827
2020-08-15,Bolivia,BO,1388,57,11513102,America,96459,3884
2020-08-16,Bolivia,BO,2687,119,11513102,America,99146,4003
2020-08-17,Bolivia,BO,1198,45,11513102,America,100344,4048
2020-08-18,Bolivia,BO,879,75,11513102,America,101223,4123
2020-08-19,Bolivia,BO,1796,49,11513102,America,103019,4172
2020-08-20,Bolivia,BO,2031,61,11513102,America,105050,4233
2020-08-21,Bolivia,BO,1015,72,11513102,America,106065,4305
2020-08-22,Bolivia,BO,1370,61,11513102,America,107435,4366
2020-08-23,Bolivia,BO,992,76,11513102,America,108427,4442
2020-08-24,Bolivia,BO,722,67,11513102,America,109149,4509
2020-08-25,Bolivia,BO,999,69,11513102,America,110148,4578
2020-08-26,Bolivia,BO,851,86,11513102,America,110999,4664
2020-08-27,Bolivia,BO,1095,62,11513102,America,112094,4726
2020-08-28,Bolivia,BO,1035,65,11513102,America,113129,4791
2020-08-29,Bolivia,BO,1280,55,11513102,America,114409,4846
2020-08-30,Bolivia,BO,945,92,11513102,America,115354,4938
2020-08-31,Bolivia,BO,614,28,11513102,America,115968,4966
2020-09-01,Bolivia,BO,630,61,11513102,America,116598,5027
2020-09-02,Bolivia,BO,669,74,11513102,America,117267,5101
2020-09-03,Bolivia,BO,661,102,11513102,America,117928,5203
2020-09-04,Bolivia,BO,0,0,11513102,America,117928,5203
2020-09-05,Bolivia,BO,1652,140,11513102,America,119580,5343
2020-09-06,Bolivia,BO,661,55,11513102,America,120241,5398
2020-09-07,Bolivia,BO,528,1610,11513102,America,120769,7008
2020-09-08,Bolivia,BO,835,46,11513102,America,121604,7054
2020-09-09,Bolivia,BO,704,43,11513102,America,122308,7097
2020-09-10,Bolivia,BO,1037,49,11513102,America,123345,7146
2020-09-11,Bolivia,BO,860,47,11513102,America,124205,7193
2020-09-12,Bolivia,BO,967,57,11513102,America,125172,7250
2020-09-13,Bolivia,BO,810,47,11513102,America,125982,7297
2020-09-14,Bolivia,BO,809,47,11513102,America,126791,7344
2020-09-15,Bolivia,BO,828,50,11513102,America,127619,7394
2020-09-16,Bolivia,BO,667,53,11513102,America,128286,7447
2020-09-17,Bolivia,BO,586,31,11513102,America,128872,7478
2020-09-18,Bolivia,BO,547,33,11513102,America,129419,7511
2020-09-19,Bolivia,BO,632,39,11513102,America,130051,7550
2020-09-20,Bolivia,BO,419,36,11513102,America,130470,7586
2020-09-21,Bolivia,BO,206,31,11513102,America,130676,7617
2020-09-22,Bolivia,BO,310,37,11513102,America,130986,7654
2020-09-23,Bolivia,BO,467,39,11513102,America,131453,7693
2020-09-24,Bolivia,BO,537,38,11513102,America,131990,7731
2020-09-25,Bolivia,BO,628,34,11513102,America,132618,7765
2020-09-26,Bolivia,BO,604,35,11513102,America,133222,7800
2020-09-27,Bolivia,BO,370,28,11513102,America,133592,7828
2020-09-28,Bolivia,BO,309,30,11513102,America,133901,7858
2020-09-29,Bolivia,BO,407,42,11513102,America,134308,7900
2020-09-30,Bolivia,BO,333,31,11513102,America,134641,7931
2020-10-01,Bolivia,BO,670,34,11513102,America,135311,7965
2020-10-02,Bolivia,BO,405,36,11513102,America,135716,8001
2020-10-03,Bolivia,BO,503,44,11513102,America,136219,8045
2020-10-04,Bolivia,BO,350,28,11513102,America,136569,8073
2020-10-05,Bolivia,BO,299,28,11513102,America,136868,8101
2020-10-06,Bolivia,BO,239,28,11513102,America,137107,8129
2020-10-07,Bolivia,BO,361,27,11513102,America,137468,8156
2020-10-08,Bolivia,BO,238,36,11513102,America,137706,8192
2020-10-09,Bolivia,BO,263,36,11513102,America,137969,8228
2020-10-10,Bolivia,BO,257,34,11513102,America,138226,8262
2020-10-11,Bolivia,BO,237,30,11513102,America,138463,8292
2020-10-12,Bolivia,BO,111,16,11513102,America,138574,8308
2020-10-13,Bolivia,BO,121,18,11513102,America,138695,8326
2020-10-14,Bolivia,BO,227,25,11513102,America,138922,8351
2020-10-15,Bolivia,BO,219,26,11513102,America,139141,8377
2020-10-16,Bolivia,BO,178,30,11513102,America,139319,8407
2020-10-17,Bolivia,BO,243,32,11513102,America,139562,8439
2020-10-18,Bolivia,BO,148,24,11513102,America,139710,8463
2020-10-19,Bolivia,BO,61,18,11513102,America,139771,8481
2020-10-20,Bolivia,BO,119,21,11513102,America,139890,8502
2020-10-21,Bolivia,BO,147,24,11513102,America,140037,8526
2020-10-22,Bolivia,BO,191,32,11513102,America,140228,8558
2020-10-23,Bolivia,BO,217,26,11513102,America,140445,8584
2020-10-24,Bolivia,BO,167,24,11513102,America,140612,8608
2020-10-25,Bolivia,BO,167,19,11513102,America,140779,8627
2020-10-26,Bolivia,BO,74,18,11513102,America,140853,8645
2020-10-27,Bolivia,BO,99,13,11513102,America,140952,8658
2020-10-28,Bolivia,BO,172,14,11513102,America,141124,8672
2020-10-29,Bolivia,BO,197,22,11513102,America,141321,8694
2020-10-30,Bolivia,BO,163,11,11513102,America,141484,8705
2020-10-31,Bolivia,BO,147,10,11513102,America,141631,8715
2020-11-01,Bolivia,BO,126,10,11513102,America,141757,8725
2020-11-02,Bolivia,BO,76,6,11513102,America,141833,8731
2020-11-03,Bolivia,BO,34,10,11513102,America,141867,8741
2020-11-04,Bolivia,BO,69,10,11513102,America,141936,8751
2020-11-05,Bolivia,BO,126,7,11513102,America,142062,8758
2020-11-06,Bolivia,BO,139,10,11513102,America,142201,8768
2020-11-07,Bolivia,BO,142,13,11513102,America,142343,8781
2020-11-08,Bolivia,BO,84,9,11513102,America,142427,8790
2020-11-09,Bolivia,BO,48,5,11513102,America,142475,8795
2020-11-10,Bolivia,BO,86,7,11513102,America,142561,8802
2020-11-11,Bolivia,BO,103,6,11513102,America,142664,8808
2020-11-12,Bolivia,BO,112,10,11513102,America,142776,8818
2020-11-13,Bolivia,BO,113,7,11513102,America,142889,8825
2020-11-14,Bolivia,BO,180,10,11513102,America,143069,8835
2020-11-15,Bolivia,BO,112,6,11513102,America,143181,8841
2020-11-16,Bolivia,BO,65,8,11513102,America,143246,8849
2020-11-17,Bolivia,BO,0,0,11513102,America,143246,8849
2020-11-18,Bolivia,BO,227,17,11513102,America,143473,8866
2020-11-19,Bolivia,BO,96,9,11513102,America,143569,8875
2020-11-20,Bolivia,BO,186,14,11513102,America,143755,8889
2020-11-21,Bolivia,BO,0,0,11513102,America,143755,8889
2020-11-22,Bolivia,BO,167,15,11513102,America,143922,8904
2020-11-23,Bolivia,BO,0,0,11513102,America,143922,8904
2020-11-24,Bolivia,BO,56,3,11513102,America,143978,8907
2020-11-25,Bolivia,BO,169,21,11513102,America,144147,8928
2020-11-26,Bolivia,BO,129,5,11513102,America,144276,8933
2020-11-27,Bolivia,BO,114,6,11513102,America,144390,8939
2020-11-28,Bolivia,BO,104,4,11513102,America,144494,8943
2020-11-29,Bolivia,BO,98,6,11513102,America,144592,8949
2020-11-30,Bolivia,BO,30,3,11513102,America,144622,8952
2020-12-01,Bolivia,BO,86,5,11513102,America,144708,8957
2020-12-02,Bolivia,BO,102,6,11513102,America,144810,8963
2020-12-03,Bolivia,BO,184,9,11513102,America,144994,8972
2020-12-04,Bolivia,BO,192,10,11513102,America,145186,8982
2020-12-05,Bolivia,BO,139,5,11513102,America,145325,8987
2020-12-06,Bolivia,BO,167,5,11513102,America,145492,8992
2020-12-07,Bolivia,BO,68,3,11513102,America,145560,8995
2020-12-08,Bolivia,BO,97,2,11513102,America,145657,8997
2020-12-09,Bolivia,BO,189,5,11513102,America,145846,9002
2020-12-10,Bolivia,BO,214,2,11513102,America,146060,9004
2020-12-11,Bolivia,BO,325,4,11513102,America,146385,9008
2020-12-12,Bolivia,BO,312,5,11513102,America,146697,9013
2020-12-13,Bolivia,BO,333,1,11513102,America,147030,9014
2020-12-14,Bolivia,BO,120,4,11513102,America,147150,9018
2020-04-02,"Bonaire, Saint Eustatius and Saba",BQ,2,0,25983,America,2,0
2020-04-03,"Bonaire, Saint Eustatius and Saba",BQ,0,0,25983,America,2,0
2020-04-04,"Bonaire, Saint Eustatius and Saba",BQ,0,0,25983,America,2,0
2020-04-05,"Bonaire, Saint Eustatius and Saba",BQ,0,0,25983,America,2,0
2020-04-06,"Bonaire, Saint Eustatius and Saba",BQ,0,0,25983,America,2,0
2020-04-07,"Bonaire, Saint Eustatius and Saba",BQ,0,0,25983,America,2,0
2020-04-08,"Bonaire, Saint Eustatius and Saba",BQ,0,0,25983,America,2,0
2020-04-09,"Bonaire, Saint Eustatius and Saba",BQ,0,0,25983,America,2,0
2020-04-10,"Bonaire, Saint Eustatius and Saba",BQ,0,0,25983,America,2,0
2020-04-11,"Bonaire, Saint Eustatius and Saba",BQ,0,0,25983,America,2,0
2020-04-12,"Bonaire, Saint Eustatius and Saba",BQ,0,0,25983,America,2,0
2020-04-13,"Bonaire, Saint Eustatius and Saba",BQ,1,0,25983,America,3,0
2020-04-14,"Bonaire, Saint Eustatius and Saba",BQ,1,0,25983,America,4,0
2020-04-15,"Bonaire, Saint Eustatius and Saba",BQ,0,0,25983,America,4,0
2020-04-16,"Bonaire, Saint Eustatius and Saba",BQ,0,0,25983,America,4,0
2020-04-17,"Bonaire, Saint Eustatius and Saba",BQ,0,0,25983,America,4,0
2020-04-18,"Bonaire, Saint Eustatius and Saba",BQ,0,0,25983,America,4,0
2020-04-19,"Bonaire, Saint Eustatius and Saba",BQ,0,0,25983,America,4,0
2020-04-20,"Bonaire, Saint Eustatius and Saba",BQ,1,0,25983,America,5,0
2020-04-21,"Bonaire, Saint Eustatius and Saba",BQ,0,0,25983,America,5,0
2020-04-22,"Bonaire, Saint Eustatius and Saba",BQ,1,0,25983,America,6,0
2020-04-23,"Bonaire, Saint Eustatius and Saba",BQ,0,0,25983,America,6,0
2020-04-24,"Bonaire, Saint Eustatius and Saba",BQ,0,0,25983,America,6,0
2020-04-25,"Bonaire, Saint Eustatius and Saba",BQ,0,0,25983,America,6,0
2020-04-26,"Bonaire, Saint Eustatius and Saba",BQ,0,0,25983,America,6,0
2020-04-27,"Bonaire, Saint Eustatius and Saba",BQ,0,0,25983,America,6,0
2020-04-28,"Bonaire, Saint Eustatius and Saba",BQ,0,0,25983,America,6,0
2020-04-29,"Bonaire, Saint Eustatius and Saba",BQ,0,0,25983,America,6,0
2020-04-30,"Bonaire, Saint Eustatius and Saba",BQ,0,0,25983,America,6,0
2020-05-01,"Bonaire, Saint Eustatius and Saba",BQ,0,0,25983,America,6,0
2020-05-02,"Bonaire, Saint Eustatius and Saba",BQ,0,0,25983,America,6,0
2020-05-03,"Bonaire, Saint Eustatius and Saba",BQ,0,0,25983,America,6,0
2020-05-04,"Bonaire, Saint Eustatius and Saba",BQ,0,0,25983,America,6,0
2020-05-05,"Bonaire, Saint Eustatius and Saba",BQ,0,0,25983,America,6,0
2020-05-06,"Bonaire, Saint Eustatius and Saba",BQ,0,0,25983,America,6,0
2020-05-07,"Bonaire, Saint Eustatius and Saba",BQ,0,0,25983,America,6,0
2020-05-08,"Bonaire, Saint Eustatius and Saba",BQ,0,0,25983,America,6,0
2020-05-09,"Bonaire, Saint Eustatius and Saba",BQ,0,0,25983,America,6,0
2020-05-10,"Bonaire, Saint Eustatius and Saba",BQ,0,0,25983,America,6,0
2020-05-11,"Bonaire, Saint Eustatius and Saba",BQ,0,0,25983,America,6,0
2020-05-12,"Bonaire, Saint Eustatius and Saba",BQ,0,0,25983,America,6,0
2020-05-13,"Bonaire, Saint Eustatius and Saba",BQ,0,0,25983,America,6,0
2020-05-14,"Bonaire, Saint Eustatius and Saba",BQ,0,0,25983,America,6,0
2020-05-15,"Bonaire, Saint Eustatius and Saba",BQ,0,0,25983,America,6,0
2020-05-16,"Bonaire, Saint Eustatius and Saba",BQ,0,0,25983,America,6,0
2020-05-17,"Bonaire, Saint Eustatius and Saba",BQ,0,0,25983,America,6,0
2020-05-18,"Bonaire, Saint Eustatius and Saba",BQ,0,0,25983,America,6,0
2020-05-19,"Bonaire, Saint Eustatius and Saba",BQ,0,0,25983,America,6,0
2020-05-20,"Bonaire, Saint Eustatius and Saba",BQ,0,0,25983,America,6,0
2020-05-21,"Bonaire, Saint Eustatius and Saba",BQ,0,0,25983,America,6,0
2020-05-22,"Bonaire, Saint Eustatius and Saba",BQ,0,0,25983,America,6,0
2020-05-23,"Bonaire, Saint Eustatius and Saba",BQ,0,0,25983,America,6,0
2020-05-24,"Bonaire, Saint Eustatius and Saba",BQ,0,0,25983,America,6,0
2020-05-25,"Bonaire, Saint Eustatius and Saba",BQ,1,0,25983,America,7,0
2020-05-26,"Bonaire, Saint Eustatius and Saba",BQ,0,0,25983,America,7,0
2020-05-27,"Bonaire, Saint Eustatius and Saba",BQ,0,0,25983,America,7,0
2020-05-28,"Bonaire, Saint Eustatius and Saba",BQ,0,0,25983,America,7,0
2020-05-29,"Bonaire, Saint Eustatius and Saba",BQ,0,0,25983,America,7,0
2020-05-30,"Bonaire, Saint Eustatius and Saba",BQ,0,0,25983,America,7,0
2020-05-31,"Bonaire, Saint Eustatius and Saba",BQ,0,0,25983,America,7,0
2020-06-01,"Bonaire, Saint Eustatius and Saba",BQ,0,0,25983,America,7,0
2020-06-02,"Bonaire, Saint Eustatius and Saba",BQ,0,0,25983,America,7,0
2020-06-03,"Bonaire, Saint Eustatius and Saba",BQ,0,0,25983,America,7,0
2020-06-04,"Bonaire, Saint Eustatius and Saba",BQ,0,0,25983,America,7,0
2020-06-05,"Bonaire, Saint Eustatius and Saba",BQ,0,0,25983,America,7,0
2020-06-06,"Bonaire, Saint Eustatius and Saba",BQ,0,0,25983,America,7,0
2020-06-07,"Bonaire, Saint Eustatius and Saba",BQ,0,0,25983,America,7,0
2020-06-08,"Bonaire, Saint Eustatius and Saba",BQ,0,0,25983,America,7,0
2020-06-09,"Bonaire, Saint Eustatius and Saba",BQ,0,0,25983,America,7,0
2020-06-10,"Bonaire, Saint Eustatius and Saba",BQ,0,0,25983,America,7,0
2020-06-11,"Bonaire, Saint Eustatius and Saba",BQ,0,0,25983,America,7,0
2020-06-12,"Bonaire, Saint Eustatius and Saba",BQ,0,0,25983,America,7,0
2020-06-13,"Bonaire, Saint Eustatius and Saba",BQ,0,0,25983,America,7,0
2020-06-14,"Bonaire, Saint Eustatius and Saba",BQ,0,0,25983,America,7,0
2020-06-15,"Bonaire, Saint Eustatius and Saba",BQ,0,0,25983,America,7,0
2020-06-16,"Bonaire, Saint Eustatius and Saba",BQ,0,0,25983,America,7,0
2020-06-17,"Bonaire, Saint Eustatius and Saba",BQ,0,0,25983,America,7,0
2020-06-18,"Bonaire, Saint Eustatius and Saba",BQ,0,0,25983,America,7,0
2020-06-19,"Bonaire, Saint Eustatius and Saba",BQ,0,0,25983,America,7,0
2020-06-20,"Bonaire, Saint Eustatius and Saba",BQ,0,0,25983,America,7,0
2020-06-21,"Bonaire, Saint Eustatius and Saba",BQ,0,0,25983,America,7,0
2020-06-22,"Bonaire, Saint Eustatius and Saba",BQ,0,0,25983,America,7,0
2020-06-23,"Bonaire, Saint Eustatius and Saba",BQ,0,0,25983,America,7,0
2020-06-24,"Bonaire, Saint Eustatius and Saba",BQ,0,0,25983,America,7,0
2020-06-25,"Bonaire, Saint Eustatius and Saba",BQ,0,0,25983,America,7,0
2020-06-26,"Bonaire, Saint Eustatius and Saba",BQ,0,0,25983,America,7,0
2020-06-27,"Bonaire, Saint Eustatius and Saba",BQ,0,0,25983,America,7,0
2020-06-28,"Bonaire, Saint Eustatius and Saba",BQ,0,0,25983,America,7,0
2020-06-29,"Bonaire, Saint Eustatius and Saba",BQ,0,0,25983,America,7,0
2020-06-30,"Bonaire, Saint Eustatius and Saba",BQ,0,0,25983,America,7,0
2020-07-01,"Bonaire, Saint Eustatius and Saba",BQ,0,0,25983,America,7,0
2020-07-02,"Bonaire, Saint Eustatius and Saba",BQ,0,0,25983,America,7,0
2020-07-03,"Bonaire, Saint Eustatius and Saba",BQ,0,0,25983,America,7,0
2020-07-04,"Bonaire, Saint Eustatius and Saba",BQ,0,0,25983,America,7,0
2020-07-05,"Bonaire, Saint Eustatius and Saba",BQ,0,0,25983,America,7,0
2020-07-06,"Bonaire, Saint Eustatius and Saba",BQ,0,0,25983,America,7,0
2020-07-07,"Bonaire, Saint Eustatius and Saba",BQ,0,0,25983,America,7,0
2020-07-08,"Bonaire, Saint Eustatius and Saba",BQ,0,0,25983,America,7,0
2020-07-09,"Bonaire, Saint Eustatius and Saba",BQ,0,0,25983,America,7,0
2020-07-10,"Bonaire, Saint Eustatius and Saba",BQ,0,0,25983,America,7,0
2020-07-11,"Bonaire, Saint Eustatius and Saba",BQ,0,0,25983,America,7,0
2020-07-12,"Bonaire, Saint Eustatius and Saba",BQ,0,0,25983,America,7,0
2020-07-13,"Bonaire, Saint Eustatius and Saba",BQ,0,0,25983,America,7,0
2020-07-14,"Bonaire, Saint Eustatius and Saba",BQ,0,0,25983,America,7,0
2020-07-15,"Bonaire, Saint Eustatius and Saba",BQ,2,0,25983,America,9,0
2020-07-16,"Bonaire, Saint Eustatius and Saba",BQ,0,0,25983,America,9,0
2020-07-17,"Bonaire, Saint Eustatius and Saba",BQ,1,0,25983,America,10,0
2020-07-18,"Bonaire, Saint Eustatius and Saba",BQ,0,0,25983,America,10,0
2020-07-19,"Bonaire, Saint Eustatius and Saba",BQ,0,0,25983,America,10,0
2020-07-20,"Bonaire, Saint Eustatius and Saba",BQ,0,0,25983,America,10,0
2020-07-21,"Bonaire, Saint Eustatius and Saba",BQ,0,0,25983,America,10,0
2020-07-22,"Bonaire, Saint Eustatius and Saba",BQ,0,0,25983,America,10,0
2020-07-23,"Bonaire, Saint Eustatius and Saba",BQ,0,0,25983,America,10,0
2020-07-24,"Bonaire, Saint Eustatius and Saba",BQ,1,0,25983,America,11,0
2020-07-25,"Bonaire, Saint Eustatius and Saba",BQ,0,0,25983,America,11,0
2020-07-26,"Bonaire, Saint Eustatius and Saba",BQ,0,0,25983,America,11,0
2020-07-27,"Bonaire, Saint Eustatius and Saba",BQ,0,0,25983,America,11,0
2020-07-28,"Bonaire, Saint Eustatius and Saba",BQ,0,0,25983,America,11,0
2020-07-29,"Bonaire, Saint Eustatius and Saba",BQ,0,0,25983,America,11,0
2020-07-30,"Bonaire, Saint Eustatius and Saba",BQ,0,0,25983,America,11,0
2020-07-31,"Bonaire, Saint Eustatius and Saba",BQ,0,0,25983,America,11,0
2020-08-01,"Bonaire, Saint Eustatius and Saba",BQ,0,0,25983,America,11,0
2020-08-02,"Bonaire, Saint Eustatius and Saba",BQ,0,0,25983,America,11,0
2020-08-03,"Bonaire, Saint Eustatius and Saba",BQ,0,0,25983,America,11,0
2020-08-04,"Bonaire, Saint Eustatius and Saba",BQ,2,0,25983,America,13,0
2020-08-05,"Bonaire, Saint Eustatius and Saba",BQ,0,0,25983,America,13,0
2020-08-06,"Bonaire, Saint Eustatius and Saba",BQ,0,0,25983,America,13,0
2020-08-07,"Bonaire, Saint Eustatius and Saba",BQ,0,0,25983,America,13,0
2020-08-08,"Bonaire, Saint Eustatius and Saba",BQ,0,0,25983,America,13,0
2020-08-09,"Bonaire, Saint Eustatius and Saba",BQ,0,0,25983,America,13,0
2020-08-10,"Bonaire, Saint Eustatius and Saba",BQ,0,0,25983,America,13,0
2020-08-11,"Bonaire, Saint Eustatius and Saba",BQ,0,0,25983,America,13,0
2020-08-12,"Bonaire, Saint Eustatius and Saba",BQ,0,0,25983,America,13,0
2020-08-13,"Bonaire, Saint Eustatius and Saba",BQ,0,0,25983,America,13,0
2020-08-14,"Bonaire, Saint Eustatius and Saba",BQ,0,0,25983,America,13,0
2020-08-15,"Bonaire, Saint Eustatius and Saba",BQ,0,0,25983,America,13,0
2020-08-16,"Bonaire, Saint Eustatius and Saba",BQ,0,0,25983,America,13,0
2020-08-17,"Bonaire, Saint Eustatius and Saba",BQ,0,0,25983,America,13,0
2020-08-18,"Bonaire, Saint Eustatius and Saba",BQ,0,0,25983,America,13,0
2020-08-19,"Bonaire, Saint Eustatius and Saba",BQ,0,0,25983,America,13,0
2020-08-20,"Bonaire, Saint Eustatius and Saba",BQ,0,0,25983,America,13,0
2020-08-21,"Bonaire, Saint Eustatius and Saba",BQ,0,0,25983,America,13,0
2020-08-22,"Bonaire, Saint Eustatius and Saba",BQ,0,0,25983,America,13,0
2020-08-23,"Bonaire, Saint Eustatius and Saba",BQ,0,0,25983,America,13,0
2020-08-24,"Bonaire, Saint Eustatius and Saba",BQ,0,0,25983,America,13,0
2020-08-25,"Bonaire, Saint Eustatius and Saba",BQ,0,0,25983,America,13,0
2020-08-26,"Bonaire, Saint Eustatius and Saba",BQ,0,0,25983,America,13,0
2020-08-27,"Bonaire, Saint Eustatius and Saba",BQ,0,0,25983,America,13,0
2020-08-28,"Bonaire, Saint Eustatius and Saba",BQ,1,0,25983,America,14,0
2020-08-29,"Bonaire, Saint Eustatius and Saba",BQ,1,0,25983,America,15,0
2020-08-30,"Bonaire, Saint Eustatius and Saba",BQ,0,0,25983,America,15,0
2020-08-31,"Bonaire, Saint Eustatius and Saba",BQ,0,0,25983,America,15,0
2020-09-01,"Bonaire, Saint Eustatius and Saba",BQ,0,0,25983,America,15,0
2020-09-02,"Bonaire, Saint Eustatius and Saba",BQ,0,0,25983,America,15,0
2020-09-03,"Bonaire, Saint Eustatius and Saba",BQ,3,0,25983,America,18,0
2020-09-04,"Bonaire, Saint Eustatius and Saba",BQ,0,0,25983,America,18,0
2020-09-05,"Bonaire, Saint Eustatius and Saba",BQ,0,0,25983,America,18,0
2020-09-06,"Bonaire, Saint Eustatius and Saba",BQ,0,0,25983,America,18,0
2020-09-07,"Bonaire, Saint Eustatius and Saba",BQ,0,0,25983,America,18,0
2020-09-08,"Bonaire, Saint Eustatius and Saba",BQ,1,0,25983,America,19,0
2020-09-09,"Bonaire, Saint Eustatius and Saba",BQ,4,0,25983,America,23,0
2020-09-10,"Bonaire, Saint Eustatius and Saba",BQ,2,0,25983,America,25,0
2020-09-11,"Bonaire, Saint Eustatius and Saba",BQ,0,0,25983,America,25,0
2020-09-12,"Bonaire, Saint Eustatius and Saba",BQ,0,0,25983,America,25,0
2020-09-13,"Bonaire, Saint Eustatius and Saba",BQ,0,0,25983,America,25,0
2020-09-14,"Bonaire, Saint Eustatius and Saba",BQ,1,0,25983,America,26,0
2020-09-15,"Bonaire, Saint Eustatius and Saba",BQ,1,1,25983,America,27,1
2020-09-16,"Bonaire, Saint Eustatius and Saba",BQ,1,0,25983,America,28,1
2020-09-17,"Bonaire, Saint Eustatius and Saba",BQ,4,0,25983,America,32,1
2020-09-18,"Bonaire, Saint Eustatius and Saba",BQ,4,0,25983,America,36,1
2020-09-19,"Bonaire, Saint Eustatius and Saba",BQ,0,0,25983,America,36,1
2020-09-20,"Bonaire, Saint Eustatius and Saba",BQ,0,0,25983,America,36,1
2020-09-21,"Bonaire, Saint Eustatius and Saba",BQ,0,0,25983,America,36,1
2020-09-22,"Bonaire, Saint Eustatius and Saba",BQ,20,0,25983,America,56,1
2020-09-23,"Bonaire, Saint Eustatius and Saba",BQ,8,0,25983,America,64,1
2020-09-24,"Bonaire, Saint Eustatius and Saba",BQ,5,0,25983,America,69,1
2020-09-25,"Bonaire, Saint Eustatius and Saba",BQ,9,0,25983,America,78,1
2020-09-26,"Bonaire, Saint Eustatius and Saba",BQ,7,0,25983,America,85,1
2020-09-27,"Bonaire, Saint Eustatius and Saba",BQ,0,0,25983,America,85,1
2020-09-28,"Bonaire, Saint Eustatius and Saba",BQ,0,0,25983,America,85,1
2020-09-29,"Bonaire, Saint Eustatius and Saba",BQ,21,0,25983,America,106,1
2020-09-30,"Bonaire, Saint Eustatius and Saba",BQ,0,0,25983,America,106,1
2020-10-01,"Bonaire, Saint Eustatius and Saba",BQ,0,0,25983,America,106,1
2020-10-02,"Bonaire, Saint Eustatius and Saba",BQ,0,0,25983,America,106,1
2020-10-03,"Bonaire, Saint Eustatius and Saba",BQ,18,0,25983,America,124,1
2020-10-04,"Bonaire, Saint Eustatius and Saba",BQ,0,0,25983,America,124,1
2020-10-05,"Bonaire, Saint Eustatius and Saba",BQ,0,0,25983,America,124,1
2020-10-06,"Bonaire, Saint Eustatius and Saba",BQ,0,0,25983,America,124,1
2020-10-07,"Bonaire, Saint Eustatius and Saba",BQ,17,1,25983,America,141,2
2020-10-08,"Bonaire, Saint Eustatius and Saba",BQ,4,0,25983,America,145,2
2020-10-09,"Bonaire, Saint Eustatius and Saba",BQ,2,0,25983,America,147,2
2020-10-10,"Bonaire, Saint Eustatius and Saba",BQ,0,0,25983,America,147,2
2020-10-11,"Bonaire, Saint Eustatius and Saba",BQ,0,0,25983,America,147,2
2020-10-12,"Bonaire, Saint Eustatius and Saba",BQ,1,0,25983,America,148,2
2020-10-13,"Bonaire, Saint Eustatius and Saba",BQ,2,0,25983,America,150,2
2020-10-14,"Bonaire, Saint Eustatius and Saba",BQ,0,0,25983,America,150,2
2020-10-15,"Bonaire, Saint Eustatius and Saba",BQ,0,0,25983,America,150,2
2020-10-16,"Bonaire, Saint Eustatius and Saba",BQ,0,0,25983,America,150,2
2020-10-17,"Bonaire, Saint Eustatius and Saba",BQ,0,0,25983,America,150,2
2020-10-18,"Bonaire, Saint Eustatius and Saba",BQ,0,0,25983,America,150,2
2020-10-19,"Bonaire, Saint Eustatius and Saba",BQ,0,0,25983,America,150,2
2020-10-20,"Bonaire, Saint Eustatius and Saba",BQ,0,1,25983,America,150,3
2020-10-21,"Bonaire, Saint Eustatius and Saba",BQ,0,0,25983,America,150,3
2020-10-22,"Bonaire, Saint Eustatius and Saba",BQ,0,0,25983,America,150,3
2020-10-23,"Bonaire, Saint Eustatius and Saba",BQ,0,0,25983,America,150,3
2020-10-24,"Bonaire, Saint Eustatius and Saba",BQ,0,0,25983,America,150,3
2020-10-25,"Bonaire, Saint Eustatius and Saba",BQ,0,0,25983,America,150,3
2020-10-26,"Bonaire, Saint Eustatius and Saba",BQ,0,0,25983,America,150,3
2020-10-27,"Bonaire, Saint Eustatius and Saba",BQ,0,0,25983,America,150,3
2020-10-28,"Bonaire, Saint Eustatius and Saba",BQ,0,0,25983,America,150,3
2020-10-29,"Bonaire, Saint Eustatius and Saba",BQ,3,0,25983,America,153,3
2020-10-30,"Bonaire, Saint Eustatius and Saba",BQ,0,0,25983,America,153,3
2020-10-31,"Bonaire, Saint Eustatius and Saba",BQ,0,0,25983,America,153,3
2020-11-01,"Bonaire, Saint Eustatius and Saba",BQ,0,0,25983,America,153,3
2020-11-02,"Bonaire, Saint Eustatius and Saba",BQ,0,0,25983,America,153,3
2020-11-03,"Bonaire, Saint Eustatius and Saba",BQ,0,0,25983,America,153,3
2020-11-04,"Bonaire, Saint Eustatius and Saba",BQ,0,0,25983,America,153,3
2020-11-05,"Bonaire, Saint Eustatius and Saba",BQ,0,0,25983,America,153,3
2020-11-06,"Bonaire, Saint Eustatius and Saba",BQ,1,0,25983,America,154,3
2020-11-07,"Bonaire, Saint Eustatius and Saba",BQ,0,0,25983,America,154,3
2020-11-08,"Bonaire, Saint Eustatius and Saba",BQ,0,0,25983,America,154,3
2020-11-09,"Bonaire, Saint Eustatius and Saba",BQ,0,0,25983,America,154,3
2020-11-10,"Bonaire, Saint Eustatius and Saba",BQ,0,0,25983,America,154,3
2020-11-11,"Bonaire, Saint Eustatius and Saba",BQ,0,0,25983,America,154,3
2020-11-12,"Bonaire, Saint Eustatius and Saba",BQ,0,0,25983,America,154,3
2020-11-13,"Bonaire, Saint Eustatius and Saba",BQ,1,0,25983,America,155,3
2020-11-14,"Bonaire, Saint Eustatius and Saba",BQ,0,0,25983,America,155,3
2020-11-15,"Bonaire, Saint Eustatius and Saba",BQ,0,0,25983,America,155,3
2020-11-16,"Bonaire, Saint Eustatius and Saba",BQ,0,0,25983,America,155,3
2020-11-17,"Bonaire, Saint Eustatius and Saba",BQ,2,0,25983,America,157,3
2020-11-18,"Bonaire, Saint Eustatius and Saba",BQ,0,0,25983,America,157,3
2020-11-19,"Bonaire, Saint Eustatius and Saba",BQ,1,0,25983,America,158,3
2020-11-20,"Bonaire, Saint Eustatius and Saba",BQ,0,0,25983,America,158,3
2020-11-21,"Bonaire, Saint Eustatius and Saba",BQ,0,0,25983,America,158,3
2020-11-22,"Bonaire, Saint Eustatius and Saba",BQ,0,0,25983,America,158,3
2020-11-23,"Bonaire, Saint Eustatius and Saba",BQ,3,0,25983,America,161,3
2020-11-24,"Bonaire, Saint Eustatius and Saba",BQ,0,0,25983,America,161,3
2020-11-25,"Bonaire, Saint Eustatius and Saba",BQ,0,0,25983,America,161,3
2020-11-26,"Bonaire, Saint Eustatius and Saba",BQ,0,0,25983,America,161,3
2020-11-27,"Bonaire, Saint Eustatius and Saba",BQ,0,0,25983,America,161,3
2020-11-28,"Bonaire, Saint Eustatius and Saba",BQ,0,0,25983,America,161,3
2020-11-29,"Bonaire, Saint Eustatius and Saba",BQ,0,0,25983,America,161,3
2020-11-30,"Bonaire, Saint Eustatius and Saba",BQ,0,0,25983,America,161,3
2020-12-01,"Bonaire, Saint Eustatius and Saba",BQ,1,0,25983,America,162,3
2020-12-02,"Bonaire, Saint Eustatius and Saba",BQ,0,0,25983,America,162,3
2020-12-03,"Bonaire, Saint Eustatius and Saba",BQ,1,0,25983,America,163,3
2020-12-04,"Bonaire, Saint Eustatius and Saba",BQ,1,0,25983,America,164,3
2020-12-05,"Bonaire, Saint Eustatius and Saba",BQ,0,0,25983,America,164,3
2020-12-06,"Bonaire, Saint Eustatius and Saba",BQ,0,0,25983,America,164,3
2020-12-07,"Bonaire, Saint Eustatius and Saba",BQ,0,0,25983,America,164,3
2020-12-08,"Bonaire, Saint Eustatius and Saba",BQ,5,0,25983,America,169,3
2020-12-09,"Bonaire, Saint Eustatius and Saba",BQ,0,0,25983,America,169,3
2020-12-10,"Bonaire, Saint Eustatius and Saba",BQ,0,0,25983,America,169,3
2020-12-11,"Bonaire, Saint Eustatius and Saba",BQ,1,0,25983,America,170,3
2020-12-12,"Bonaire, Saint Eustatius and Saba",BQ,3,0,25983,America,173,3
2020-12-13,"Bonaire, Saint Eustatius and Saba",BQ,0,0,25983,America,173,3
2020-12-14,"Bonaire, Saint Eustatius and Saba",BQ,0,0,25983,America,173,3
2019-12-31,Brazil,BR,0,0,211049519,America,0,0
2020-01-01,Brazil,BR,0,0,211049519,America,0,0
2020-01-02,Brazil,BR,0,0,211049519,America,0,0
2020-01-03,Brazil,BR,0,0,211049519,America,0,0
2020-01-04,Brazil,BR,0,0,211049519,America,0,0
2020-01-05,Brazil,BR,0,0,211049519,America,0,0
2020-01-06,Brazil,BR,0,0,211049519,America,0,0
2020-01-07,Brazil,BR,0,0,211049519,America,0,0
2020-01-08,Brazil,BR,0,0,211049519,America,0,0
2020-01-09,Brazil,BR,0,0,211049519,America,0,0
2020-01-10,Brazil,BR,0,0,211049519,America,0,0
2020-01-11,Brazil,BR,0,0,211049519,America,0,0
2020-01-12,Brazil,BR,0,0,211049519,America,0,0
2020-01-13,Brazil,BR,0,0,211049519,America,0,0
2020-01-14,Brazil,BR,0,0,211049519,America,0,0
2020-01-15,Brazil,BR,0,0,211049519,America,0,0
2020-01-16,Brazil,BR,0,0,211049519,America,0,0
2020-01-17,Brazil,BR,0,0,211049519,America,0,0
2020-01-18,Brazil,BR,0,0,211049519,America,0,0
2020-01-19,Brazil,BR,0,0,211049519,America,0,0
2020-01-20,Brazil,BR,0,0,211049519,America,0,0
2020-01-21,Brazil,BR,0,0,211049519,America,0,0
2020-01-22,Brazil,BR,0,0,211049519,America,0,0
2020-01-23,Brazil,BR,0,0,211049519,America,0,0
2020-01-24,Brazil,BR,0,0,211049519,America,0,0
2020-01-25,Brazil,BR,0,0,211049519,America,0,0
2020-01-26,Brazil,BR,0,0,211049519,America,0,0
2020-01-27,Brazil,BR,0,0,211049519,America,0,0
2020-01-28,Brazil,BR,0,0,211049519,America,0,0
2020-01-29,Brazil,BR,0,0,211049519,America,0,0
2020-01-30,Brazil,BR,0,0,211049519,America,0,0
2020-01-31,Brazil,BR,0,0,211049519,America,0,0
2020-02-01,Brazil,BR,0,0,211049519,America,0,0
2020-02-02,Brazil,BR,0,0,211049519,America,0,0
2020-02-03,Brazil,BR,0,0,211049519,America,0,0
2020-02-04,Brazil,BR,0,0,211049519,America,0,0
2020-02-05,Brazil,BR,0,0,211049519,America,0,0
2020-02-06,Brazil,BR,0,0,211049519,America,0,0
2020-02-07,Brazil,BR,0,0,211049519,America,0,0
2020-02-08,Brazil,BR,0,0,211049519,America,0,0
2020-02-09,Brazil,BR,0,0,211049519,America,0,0
2020-02-10,Brazil,BR,0,0,211049519,America,0,0
2020-02-11,Brazil,BR,0,0,211049519,America,0,0
2020-02-12,Brazil,BR,0,0,211049519,America,0,0
2020-02-13,Brazil,BR,0,0,211049519,America,0,0
2020-02-14,Brazil,BR,0,0,211049519,America,0,0
2020-02-15,Brazil,BR,0,0,211049519,America,0,0
2020-02-16,Brazil,BR,0,0,211049519,America,0,0
2020-02-17,Brazil,BR,0,0,211049519,America,0,0
2020-02-18,Brazil,BR,0,0,211049519,America,0,0
2020-02-19,Brazil,BR,0,0,211049519,America,0,0
2020-02-20,Brazil,BR,0,0,211049519,America,0,0
2020-02-21,Brazil,BR,0,0,211049519,America,0,0
2020-02-22,Brazil,BR,0,0,211049519,America,0,0
2020-02-23,Brazil,BR,0,0,211049519,America,0,0
2020-02-24,Brazil,BR,0,0,211049519,America,0,0
2020-02-25,Brazil,BR,0,0,211049519,America,0,0
2020-02-26,Brazil,BR,1,0,211049519,America,1,0
2020-02-27,Brazil,BR,0,0,211049519,America,1,0
2020-02-28,Brazil,BR,0,0,211049519,America,1,0
2020-02-29,Brazil,BR,0,0,211049519,America,1,0
2020-03-01,Brazil,BR,1,0,211049519,America,2,0
2020-03-02,Brazil,BR,0,0,211049519,America,2,0
2020-03-03,Brazil,BR,0,0,211049519,America,2,0
2020-03-04,Brazil,BR,0,0,211049519,America,2,0
2020-03-05,Brazil,BR,1,0,211049519,America,3,0
2020-03-06,Brazil,BR,5,0,211049519,America,8,0
2020-03-07,Brazil,BR,5,0,211049519,America,13,0
2020-03-08,Brazil,BR,0,0,211049519,America,13,0
2020-03-09,Brazil,BR,12,0,211049519,America,25,0
2020-03-10,Brazil,BR,0,0,211049519,America,25,0
2020-03-11,Brazil,BR,9,0,211049519,America,34,0
2020-03-12,Brazil,BR,18,0,211049519,America,52,0
2020-03-13,Brazil,BR,25,0,211049519,America,77,0
2020-03-14,Brazil,BR,21,0,211049519,America,98,0
2020-03-15,Brazil,BR,23,0,211049519,America,121,0
2020-03-16,Brazil,BR,79,0,211049519,America,200,0
2020-03-17,Brazil,BR,34,0,211049519,America,234,0
2020-03-18,Brazil,BR,57,1,211049519,America,291,1
2020-03-19,Brazil,BR,137,3,211049519,America,428,4
2020-03-20,Brazil,BR,193,2,211049519,America,621,6
2020-03-21,Brazil,BR,283,5,211049519,America,904,11
2020-03-22,Brazil,BR,224,7,211049519,America,1128,18
2020-03-23,Brazil,BR,418,7,211049519,America,1546,25
2020-03-24,Brazil,BR,345,9,211049519,America,1891,34
2020-03-25,Brazil,BR,310,12,211049519,America,2201,46
2020-03-26,Brazil,BR,232,11,211049519,America,2433,57
2020-03-27,Brazil,BR,482,20,211049519,America,2915,77
2020-03-28,Brazil,BR,502,15,211049519,America,3417,92
2020-03-29,Brazil,BR,487,22,211049519,America,3904,114
2020-03-30,Brazil,BR,352,22,211049519,America,4256,136
2020-03-31,Brazil,BR,323,23,211049519,America,4579,159
2020-04-01,Brazil,BR,1138,42,211049519,America,5717,201
2020-04-02,Brazil,BR,1119,40,211049519,America,6836,241
2020-04-03,Brazil,BR,1074,58,211049519,America,7910,299
2020-04-04,Brazil,BR,1146,60,211049519,America,9056,359
2020-04-05,Brazil,BR,1222,73,211049519,America,10278,432
2020-04-06,Brazil,BR,852,54,211049519,America,11130,486
2020-04-07,Brazil,BR,926,67,211049519,America,12056,553
2020-04-08,Brazil,BR,1661,114,211049519,America,13717,667
2020-04-09,Brazil,BR,2210,133,211049519,America,15927,800
2020-04-10,Brazil,BR,1930,141,211049519,America,17857,941
2020-04-11,Brazil,BR,1781,115,211049519,America,19638,1056
2020-04-12,Brazil,BR,1089,68,211049519,America,20727,1124
2020-04-13,Brazil,BR,1442,99,211049519,America,22169,1223
2020-04-14,Brazil,BR,1261,105,211049519,America,23430,1328
2020-04-15,Brazil,BR,1832,204,211049519,America,25262,1532
2020-04-16,Brazil,BR,3058,204,211049519,America,28320,1736
2020-04-17,Brazil,BR,2105,188,211049519,America,30425,1924
2020-04-18,Brazil,BR,3257,217,211049519,America,33682,2141
2020-04-19,Brazil,BR,2917,206,211049519,America,36599,2347
2020-04-20,Brazil,BR,2055,115,211049519,America,38654,2462
2020-04-21,Brazil,BR,1927,113,211049519,America,40581,2575
2020-04-22,Brazil,BR,2498,166,211049519,America,43079,2741
2020-04-23,Brazil,BR,2678,165,211049519,America,45757,2906
2020-04-24,Brazil,BR,3735,407,211049519,America,49492,3313
2020-04-25,Brazil,BR,3503,357,211049519,America,52995,3670
2020-04-26,Brazil,BR,5514,346,211049519,America,58509,4016
2020-04-27,Brazil,BR,3379,189,211049519,America,61888,4205
2020-04-28,Brazil,BR,4613,338,211049519,America,66501,4543
2020-04-29,Brazil,BR,5385,474,211049519,America,71886,5017
2020-04-30,Brazil,BR,6276,449,211049519,America,78162,5466
2020-05-01,Brazil,BR,7218,435,211049519,America,85380,5901
2020-05-02,Brazil,BR,6209,428,211049519,America,91589,6329
2020-05-03,Brazil,BR,4970,421,211049519,America,96559,6750
2020-05-04,Brazil,BR,4588,275,211049519,America,101147,7025
2020-05-05,Brazil,BR,6633,296,211049519,America,107780,7321
2020-05-06,Brazil,BR,6935,600,211049519,America,114715,7921
2020-05-07,Brazil,BR,10503,615,211049519,America,125218,8536
2020-05-08,Brazil,BR,9888,610,211049519,America,135106,9146
2020-05-09,Brazil,BR,10222,751,211049519,America,145328,9897
2020-05-10,Brazil,BR,10611,730,211049519,America,155939,10627
2020-05-11,Brazil,BR,6760,496,211049519,America,162699,11123
2020-05-12,Brazil,BR,5632,396,211049519,America,168331,11519
2020-05-13,Brazil,BR,9258,881,211049519,America,177589,12400
2020-05-14,Brazil,BR,11385,749,211049519,America,188974,13149
2020-05-15,Brazil,BR,13944,844,211049519,America,202918,13993
2020-05-16,Brazil,BR,15305,824,211049519,America,218223,14817
2020-05-17,Brazil,BR,14919,816,211049519,America,233142,15633
2020-05-18,Brazil,BR,7938,485,211049519,America,241080,16118
2020-05-19,Brazil,BR,13140,674,211049519,America,254220,16792
2020-05-20,Brazil,BR,17408,1179,211049519,America,271628,17971
2020-05-21,Brazil,BR,19951,888,211049519,America,291579,18859
2020-05-22,Brazil,BR,18508,1188,211049519,America,310087,20047
2020-05-23,Brazil,BR,20803,1001,211049519,America,330890,21048
2020-05-24,Brazil,BR,16508,965,211049519,America,347398,22013
2020-05-25,Brazil,BR,15813,653,211049519,America,363211,22666
2020-05-26,Brazil,BR,11687,807,211049519,America,374898,23473
2020-05-27,Brazil,BR,16324,1039,211049519,America,391222,24512
2020-05-28,Brazil,BR,20599,1086,211049519,America,411821,25598
2020-05-29,Brazil,BR,26417,1156,211049519,America,438238,26754
2020-05-30,Brazil,BR,26928,1124,211049519,America,465166,27878
2020-05-31,Brazil,BR,33274,956,211049519,America,498440,28834
2020-06-01,Brazil,BR,16409,480,211049519,America,514849,29314
2020-06-02,Brazil,BR,11598,623,211049519,America,526447,29937
2020-06-03,Brazil,BR,28936,1262,211049519,America,555383,31199
2020-06-04,Brazil,BR,28633,1349,211049519,America,584016,32548
2020-06-05,Brazil,BR,30916,1473,211049519,America,614932,34021
2020-06-06,Brazil,BR,30830,1005,211049519,America,645762,35026
2020-06-07,Brazil,BR,27075,904,211049519,America,672837,35930
2020-06-08,Brazil,BR,18921,525,211049519,America,691758,36455
2020-06-09,Brazil,BR,15654,679,211049519,America,707412,37134
2020-06-10,Brazil,BR,32091,1272,211049519,America,739503,38406
2020-06-11,Brazil,BR,32913,1274,211049519,America,772416,39680
2020-06-12,Brazil,BR,30412,1239,211049519,America,802828,40919
2020-06-13,Brazil,BR,25982,909,211049519,America,828810,41828
2020-06-14,Brazil,BR,21704,892,211049519,America,850514,42720
2020-06-15,Brazil,BR,17110,612,211049519,America,867624,43332
2020-06-16,Brazil,BR,20647,627,211049519,America,888271,43959
2020-06-17,Brazil,BR,34918,1282,211049519,America,923189,45241
2020-06-18,Brazil,BR,32188,1269,211049519,America,955377,46510
2020-06-19,Brazil,BR,22765,1238,211049519,America,978142,47748
2020-06-20,Brazil,BR,54771,1206,211049519,America,1032913,48954
2020-06-21,Brazil,BR,34666,1022,211049519,America,1067579,49976
2020-06-22,Brazil,BR,17459,641,211049519,America,1085038,50617
2020-06-23,Brazil,BR,21432,654,211049519,America,1106470,51271
2020-06-24,Brazil,BR,39436,1374,211049519,America,1145906,52645
2020-06-25,Brazil,BR,42725,1185,211049519,America,1188631,53830
2020-06-26,Brazil,BR,39483,1141,211049519,America,1228114,54971
2020-06-27,Brazil,BR,46860,990,211049519,America,1274974,55961
2020-06-28,Brazil,BR,38693,1109,211049519,America,1313667,57070
2020-06-29,Brazil,BR,30476,552,211049519,America,1344143,57622
2020-06-30,Brazil,BR,24052,692,211049519,America,1368195,58314
2020-07-01,Brazil,BR,33846,1280,211049519,America,1402041,59594
2020-07-02,Brazil,BR,46712,1038,211049519,America,1448753,60632
2020-07-03,Brazil,BR,48105,1252,211049519,America,1496858,61884
2020-07-04,Brazil,BR,42223,1290,211049519,America,1539081,63174
2020-07-05,Brazil,BR,37923,1091,211049519,America,1577004,64265
2020-07-06,Brazil,BR,26051,602,211049519,America,1603055,64867
2020-07-07,Brazil,BR,20229,620,211049519,America,1623284,65487
2020-07-08,Brazil,BR,45305,1254,211049519,America,1668589,66741
2020-07-09,Brazil,BR,44571,1223,211049519,America,1713160,67964
2020-07-10,Brazil,BR,42619,1220,211049519,America,1755779,69184
2020-07-11,Brazil,BR,45048,1214,211049519,America,1800827,70398
2020-07-12,Brazil,BR,39023,1071,211049519,America,1839850,71469
2020-07-13,Brazil,BR,24831,631,211049519,America,1864681,72100
2020-07-14,Brazil,BR,20286,733,211049519,America,1884967,72833
2020-07-15,Brazil,BR,41857,1300,211049519,America,1926824,74133
2020-07-16,Brazil,BR,39924,1233,211049519,America,1966748,75366
2020-07-17,Brazil,BR,45403,1322,211049519,America,2012151,76688
2020-07-18,Brazil,BR,34177,1163,211049519,America,2046328,77851
2020-07-19,Brazil,BR,28532,921,211049519,America,2074860,78772
2020-07-20,Brazil,BR,23529,716,211049519,America,2098389,79488
2020-07-21,Brazil,BR,20257,632,211049519,America,2118646,80120
2020-07-22,Brazil,BR,41008,1367,211049519,America,2159654,81487
2020-07-23,Brazil,BR,67860,1284,211049519,America,2227514,82771
2020-07-24,Brazil,BR,59961,1311,211049519,America,2287475,84082
2020-07-25,Brazil,BR,55891,1156,211049519,America,2343366,85238
2020-07-26,Brazil,BR,51147,1211,211049519,America,2394513,86449
2020-07-27,Brazil,BR,24578,555,211049519,America,2419091,87004
2020-07-28,Brazil,BR,23284,614,211049519,America,2442375,87618
2020-07-29,Brazil,BR,40816,921,211049519,America,2483191,88539
2020-07-30,Brazil,BR,69074,1595,211049519,America,2552265,90134
2020-07-31,Brazil,BR,57837,1129,211049519,America,2610102,91263
2020-08-01,Brazil,BR,52383,1212,211049519,America,2662485,92475
2020-08-02,Brazil,BR,45392,1088,211049519,America,2707877,93563
2020-08-03,Brazil,BR,25800,541,211049519,America,2733677,94104
2020-08-04,Brazil,BR,16641,561,211049519,America,2750318,94665
2020-08-05,Brazil,BR,51603,1154,211049519,America,2801921,95819
2020-08-06,Brazil,BR,57152,1437,211049519,America,2859073,97256
2020-08-07,Brazil,BR,53139,1237,211049519,America,2912212,98493
2020-08-08,Brazil,BR,50230,1079,211049519,America,2962442,99572
2020-08-09,Brazil,BR,49970,905,211049519,America,3012412,100477
2020-08-10,Brazil,BR,23010,572,211049519,America,3035422,101049
2020-08-11,Brazil,BR,22048,703,211049519,America,3057470,101752
2020-08-12,Brazil,BR,52160,1274,211049519,America,3109630,103026
2020-08-13,Brazil,BR,55155,1175,211049519,America,3164785,104201
2020-08-14,Brazil,BR,60091,1262,211049519,America,3224876,105463
2020-08-15,Brazil,BR,50644,1060,211049519,America,3275520,106523
2020-08-16,Brazil,BR,41576,709,211049519,America,3317096,107232
2020-08-17,Brazil,BR,23101,620,211049519,America,3340197,107852
2020-08-18,Brazil,BR,19373,684,211049519,America,3359570,108536
2020-08-19,Brazil,BR,47784,1352,211049519,America,3407354,109888
2020-08-20,Brazil,BR,49298,1212,211049519,America,3456652,111100
2020-08-21,Brazil,BR,45323,1204,211049519,America,3501975,112304
2020-08-22,Brazil,BR,30355,1054,211049519,America,3532330,113358
2020-08-23,Brazil,BR,50032,892,211049519,America,3582362,114250
2020-08-24,Brazil,BR,23421,494,211049519,America,3605783,114744
2020-08-25,Brazil,BR,17078,565,211049519,America,3622861,115309
2020-08-26,Brazil,BR,47134,1271,211049519,America,3669995,116580
2020-08-27,Brazil,BR,47161,1085,211049519,America,3717156,117665
2020-08-28,Brazil,BR,44235,984,211049519,America,3761391,118649
2020-08-29,Brazil,BR,43412,855,211049519,America,3804803,119504
2020-08-30,Brazil,BR,41350,958,211049519,America,3846153,120462
2020-08-31,Brazil,BR,16158,366,211049519,America,3862311,120828
2020-09-01,Brazil,BR,45961,553,211049519,America,3908272,121381
2020-09-02,Brazil,BR,42659,1215,211049519,America,3950931,122596
2020-09-03,Brazil,BR,46934,1184,211049519,America,3997865,123780
2020-09-04,Brazil,BR,43773,834,211049519,America,4041638,124614
2020-09-05,Brazil,BR,51194,907,211049519,America,4092832,125521
2020-09-06,Brazil,BR,30168,682,211049519,America,4123000,126203
2020-09-07,Brazil,BR,14521,447,211049519,America,4137521,126650
2020-09-08,Brazil,BR,10273,310,211049519,America,4147794,126960
2020-09-09,Brazil,BR,14279,504,211049519,America,4162073,127464
2020-09-10,Brazil,BR,35816,1075,211049519,America,4197889,128539
2020-09-11,Brazil,BR,40557,983,211049519,America,4238446,129522
2020-09-12,Brazil,BR,43718,874,211049519,America,4282164,130396
2020-09-13,Brazil,BR,33523,814,211049519,America,4315687,131210
2020-09-14,Brazil,BR,14768,415,211049519,America,4330455,131625
2020-09-15,Brazil,BR,15155,381,211049519,America,4345610,132006
2020-09-16,Brazil,BR,36653,1113,211049519,America,4382263,133119
2020-09-17,Brazil,BR,36820,987,211049519,America,4419083,134106
2020-09-18,Brazil,BR,36303,829,211049519,America,4455386,134935
2020-09-19,Brazil,BR,39797,858,211049519,America,4495183,135793
2020-09-20,Brazil,BR,33057,739,211049519,America,4528240,136532
2020-09-21,Brazil,BR,16389,363,211049519,America,4544629,136895
2020-09-22,Brazil,BR,13439,377,211049519,America,4558068,137272
2020-09-23,Brazil,BR,33536,836,211049519,America,4591604,138108
2020-09-24,Brazil,BR,33281,869,211049519,America,4624885,138977
2020-09-25,Brazil,BR,32817,831,211049519,America,4657702,139808
2020-09-26,Brazil,BR,31911,729,211049519,America,4689613,140537
2020-09-27,Brazil,BR,28378,869,211049519,America,4717991,141406
2020-09-28,Brazil,BR,14318,335,211049519,America,4732309,141741
2020-09-29,Brazil,BR,13155,317,211049519,America,4745464,142058
2020-09-30,Brazil,BR,32058,863,211049519,America,4777522,142921
2020-10-01,Brazil,BR,33413,1031,211049519,America,4810935,143952
2020-10-02,Brazil,BR,36157,728,211049519,America,4847092,144680
2020-10-03,Brazil,BR,33431,708,211049519,America,4880523,145388
2020-10-04,Brazil,BR,26310,599,211049519,America,4906833,145987
2020-10-05,Brazil,BR,8456,365,211049519,America,4915289,146352
2020-10-06,Brazil,BR,11946,323,211049519,America,4927235,146675
2020-10-07,Brazil,BR,41906,819,211049519,America,4969141,147494
2020-10-08,Brazil,BR,31553,734,211049519,America,5000694,148228
2020-10-09,Brazil,BR,27750,729,211049519,America,5028444,148957
2020-10-10,Brazil,BR,27444,682,211049519,America,5055888,149639
2020-10-11,Brazil,BR,26749,559,211049519,America,5082637,150198
2020-10-12,Brazil,BR,12345,290,211049519,America,5094982,150488
2020-10-13,Brazil,BR,8426,201,211049519,America,5103408,150689
2020-10-14,Brazil,BR,10220,309,211049519,America,5113628,150998
2020-10-15,Brazil,BR,27235,749,211049519,America,5140863,151747
2020-10-16,Brazil,BR,28523,713,211049519,America,5169386,152460
2020-10-17,Brazil,BR,30914,754,211049519,America,5200300,153214
2020-10-18,Brazil,BR,24062,461,211049519,America,5224362,153675
2020-10-19,Brazil,BR,10982,230,211049519,America,5235344,153905
2020-10-20,Brazil,BR,15383,271,211049519,America,5250727,154176
2020-10-21,Brazil,BR,23227,661,211049519,America,5273954,154837
2020-10-22,Brazil,BR,24818,566,211049519,America,5298772,155403
2020-10-23,Brazil,BR,24858,497,211049519,America,5323630,155900
2020-10-24,Brazil,BR,30026,571,211049519,America,5353656,156471
2020-10-25,Brazil,BR,26979,432,211049519,America,5380635,156903
2020-10-26,Brazil,BR,13493,231,211049519,America,5394128,157134
2020-10-27,Brazil,BR,15726,263,211049519,America,5409854,157397
2020-10-28,Brazil,BR,29787,549,211049519,America,5439641,157946
2020-10-29,Brazil,BR,28629,510,211049519,America,5468270,158456
2020-10-30,Brazil,BR,26106,513,211049519,America,5494376,158969
2020-10-31,Brazil,BR,22282,508,211049519,America,5516658,159477
2020-11-01,Brazil,BR,18947,407,211049519,America,5535605,159884
2020-11-02,Brazil,BR,10100,190,211049519,America,5545705,160074
2020-11-03,Brazil,BR,8501,179,211049519,America,5554206,160253
2020-11-04,Brazil,BR,11843,243,211049519,America,5566049,160496
2020-11-05,Brazil,BR,23976,610,211049519,America,5590025,161106
2020-11-06,Brazil,BR,22294,630,211049519,America,5612319,161736
2020-11-07,Brazil,BR,21428,302,211049519,America,5633747,162038
2020-11-08,Brazil,BR,19814,231,211049519,America,5653561,162269
2020-11-09,Brazil,BR,10554,128,211049519,America,5664115,162397
2020-11-10,Brazil,BR,10917,231,211049519,America,5675032,162628
2020-11-11,Brazil,BR,25012,201,211049519,America,5700044,162829
2020-11-12,Brazil,BR,48331,544,211049519,America,5748375,163373
2020-11-13,Brazil,BR,33207,908,211049519,America,5781582,164281
2020-11-14,Brazil,BR,29070,456,211049519,America,5810652,164737
2020-11-15,Brazil,BR,38307,921,211049519,America,5848959,165658
2020-11-16,Brazil,BR,14134,140,211049519,America,5863093,165798
2020-11-17,Brazil,BR,13371,216,211049519,America,5876464,166014
2020-11-18,Brazil,BR,35294,685,211049519,America,5911758,166699
2020-11-19,Brazil,BR,34091,756,211049519,America,5945849,167455
2020-11-20,Brazil,BR,35918,606,211049519,America,5981767,168061
2020-11-21,Brazil,BR,38397,552,211049519,America,6020164,168613
2020-11-22,Brazil,BR,32622,376,211049519,America,6052786,168989
2020-11-23,Brazil,BR,18615,194,211049519,America,6071401,169183
2020-11-24,Brazil,BR,16207,302,211049519,America,6087608,169485
2020-11-25,Brazil,BR,31100,630,211049519,America,6118708,170115
2020-11-26,Brazil,BR,47898,654,211049519,America,6166606,170769
2020-11-27,Brazil,BR,37614,691,211049519,America,6204220,171460
2020-11-28,Brazil,BR,34130,514,211049519,America,6238350,171974
2020-11-29,Brazil,BR,51922,587,211049519,America,6290272,172561
2020-11-30,Brazil,BR,24468,272,211049519,America,6314740,172833
2020-12-01,Brazil,BR,21138,287,211049519,America,6335878,173120
2020-12-02,Brazil,BR,50909,697,211049519,America,6386787,173817
2020-12-03,Brazil,BR,49863,698,211049519,America,6436650,174515
2020-12-04,Brazil,BR,50434,755,211049519,America,6487084,175270
2020-12-05,Brazil,BR,46884,694,211049519,America,6533968,175964
2020-12-06,Brazil,BR,43209,664,211049519,America,6577177,176628
2020-12-07,Brazil,BR,26363,313,211049519,America,6603540,176941
2020-12-08,Brazil,BR,20371,376,211049519,America,6623911,177317
2020-12-09,Brazil,BR,51088,842,211049519,America,6674999,178159
2020-12-10,Brazil,BR,53453,836,211049519,America,6728452,178995
2020-12-11,Brazil,BR,53347,770,211049519,America,6781799,179765
2020-12-12,Brazil,BR,54428,672,211049519,America,6836227,180437
2020-12-13,Brazil,BR,43900,686,211049519,America,6880127,181123
2020-12-14,Brazil,BR,21825,279,211049519,America,6901952,181402
2020-03-16,Bahamas,BS,1,0,389486,America,1,0
2020-03-17,Bahamas,BS,0,0,389486,America,1,0
2020-03-20,Bahamas,BS,2,0,389486,America,3,0
2020-03-21,Bahamas,BS,1,0,389486,America,4,0
2020-03-22,Bahamas,BS,0,0,389486,America,4,0
2020-03-23,Bahamas,BS,0,0,389486,America,4,0
2020-03-24,Bahamas,BS,0,0,389486,America,4,0
2020-03-25,Bahamas,BS,0,0,389486,America,4,0
2020-03-26,Bahamas,BS,1,0,389486,America,5,0
2020-03-27,Bahamas,BS,4,0,389486,America,9,0
2020-03-28,Bahamas,BS,0,0,389486,America,9,0
2020-03-29,Bahamas,BS,2,0,389486,America,11,0
2020-03-30,Bahamas,BS,3,0,389486,America,14,0
2020-03-31,Bahamas,BS,0,0,389486,America,14,0
2020-04-01,Bahamas,BS,1,0,389486,America,15,0
2020-04-02,Bahamas,BS,6,1,389486,America,21,1
2020-04-03,Bahamas,BS,3,0,389486,America,24,1
2020-04-04,Bahamas,BS,0,2,389486,America,24,3
2020-04-05,Bahamas,BS,4,1,389486,America,28,4
2020-04-06,Bahamas,BS,1,1,389486,America,29,5
2020-04-07,Bahamas,BS,4,0,389486,America,33,5
2020-04-08,Bahamas,BS,3,1,389486,America,36,6
2020-04-09,Bahamas,BS,4,1,389486,America,40,7
2020-04-10,Bahamas,BS,1,1,389486,America,41,8
2020-04-11,Bahamas,BS,1,0,389486,America,42,8
2020-04-12,Bahamas,BS,4,0,389486,America,46,8
2020-04-13,Bahamas,BS,1,0,389486,America,47,8
2020-04-14,Bahamas,BS,2,0,389486,America,49,8
2020-04-15,Bahamas,BS,0,0,389486,America,49,8
2020-04-16,Bahamas,BS,4,0,389486,America,53,8
2020-04-17,Bahamas,BS,1,1,389486,America,54,9
2020-04-18,Bahamas,BS,1,0,389486,America,55,9
2020-04-19,Bahamas,BS,3,0,389486,America,58,9
2020-04-20,Bahamas,BS,2,0,389486,America,60,9
2020-04-21,Bahamas,BS,4,0,389486,America,64,9
2020-04-22,Bahamas,BS,1,0,389486,America,65,9
2020-04-23,Bahamas,BS,5,0,389486,America,70,9
2020-04-24,Bahamas,BS,2,2,389486,America,72,11
2020-04-25,Bahamas,BS,1,0,389486,America,73,11
2020-04-26,Bahamas,BS,5,0,389486,America,78,11
2020-04-27,Bahamas,BS,2,0,389486,America,80,11
2020-04-28,Bahamas,BS,0,0,389486,America,80,11
2020-04-29,Bahamas,BS,0,0,389486,America,80,11
2020-04-30,Bahamas,BS,0,0,389486,America,80,11
2020-05-01,Bahamas,BS,1,0,389486,America,81,11
2020-05-02,Bahamas,BS,1,0,389486,America,82,11
2020-05-03,Bahamas,BS,1,0,389486,America,83,11
2020-05-04,Bahamas,BS,0,0,389486,America,83,11
2020-05-05,Bahamas,BS,0,0,389486,America,83,11
2020-05-06,Bahamas,BS,6,0,389486,America,89,11
2020-05-07,Bahamas,BS,3,0,389486,America,92,11
2020-05-08,Bahamas,BS,0,0,389486,America,92,11
2020-05-09,Bahamas,BS,0,0,389486,America,92,11
2020-05-10,Bahamas,BS,0,0,389486,America,92,11
2020-05-11,Bahamas,BS,0,0,389486,America,92,11
2020-05-12,Bahamas,BS,1,0,389486,America,93,11
2020-05-13,Bahamas,BS,0,0,389486,America,93,11
2020-05-14,Bahamas,BS,1,0,389486,America,94,11
2020-05-15,Bahamas,BS,2,0,389486,America,96,11
2020-05-16,Bahamas,BS,0,0,389486,America,96,11
2020-05-17,Bahamas,BS,0,0,389486,America,96,11
2020-05-18,Bahamas,BS,0,0,389486,America,96,11
2020-05-19,Bahamas,BS,0,0,389486,America,96,11
2020-05-20,Bahamas,BS,0,0,389486,America,96,11
2020-05-21,Bahamas,BS,1,0,389486,America,97,11
2020-05-22,Bahamas,BS,0,0,389486,America,97,11
2020-05-23,Bahamas,BS,0,0,389486,America,97,11
2020-05-24,Bahamas,BS,3,0,389486,America,100,11
2020-05-25,Bahamas,BS,0,0,389486,America,100,11
2020-05-26,Bahamas,BS,0,0,389486,America,100,11
2020-05-27,Bahamas,BS,0,0,389486,America,100,11
2020-05-28,Bahamas,BS,0,0,389486,America,100,11
2020-05-29,Bahamas,BS,1,0,389486,America,101,11
2020-05-30,Bahamas,BS,1,0,389486,America,102,11
2020-05-31,Bahamas,BS,0,0,389486,America,102,11
2020-06-01,Bahamas,BS,0,0,389486,America,102,11
2020-06-02,Bahamas,BS,0,0,389486,America,102,11
2020-06-03,Bahamas,BS,0,0,389486,America,102,11
2020-06-04,Bahamas,BS,0,0,389486,America,102,11
2020-06-05,Bahamas,BS,0,0,389486,America,102,11
2020-06-06,Bahamas,BS,0,0,389486,America,102,11
2020-06-07,Bahamas,BS,1,0,389486,America,103,11
2020-06-08,Bahamas,BS,0,0,389486,America,103,11
2020-06-09,Bahamas,BS,0,0,389486,America,103,11
2020-06-10,Bahamas,BS,0,0,389486,America,103,11
2020-06-11,Bahamas,BS,0,0,389486,America,103,11
2020-06-12,Bahamas,BS,0,0,389486,America,103,11
2020-06-13,Bahamas,BS,0,0,389486,America,103,11
2020-06-14,Bahamas,BS,0,0,389486,America,103,11
2020-06-15,Bahamas,BS,0,0,389486,America,103,11
2020-06-16,Bahamas,BS,1,0,389486,America,104,11
2020-06-17,Bahamas,BS,0,0,389486,America,104,11
2020-06-18,Bahamas,BS,0,0,389486,America,104,11
2020-06-19,Bahamas,BS,0,0,389486,America,104,11
2020-06-20,Bahamas,BS,0,0,389486,America,104,11
2020-06-21,Bahamas,BS,0,0,389486,America,104,11
2020-06-22,Bahamas,BS,0,0,389486,America,104,11
2020-06-23,Bahamas,BS,0,0,389486,America,104,11
2020-06-24,Bahamas,BS,0,0,389486,America,104,11
2020-06-25,Bahamas,BS,0,0,389486,America,104,11
2020-06-26,Bahamas,BS,0,0,389486,America,104,11
2020-06-27,Bahamas,BS,0,0,389486,America,104,11
2020-06-28,Bahamas,BS,0,0,389486,America,104,11
2020-06-29,Bahamas,BS,0,0,389486,America,104,11
2020-06-30,Bahamas,BS,0,0,389486,America,104,11
2020-07-01,Bahamas,BS,0,0,389486,America,104,11
2020-07-02,Bahamas,BS,0,0,389486,America,104,11
2020-07-03,Bahamas,BS,0,0,389486,America,104,11
2020-07-04,Bahamas,BS,0,0,389486,America,104,11
2020-07-05,Bahamas,BS,0,0,389486,America,104,11
2020-07-06,Bahamas,BS,0,0,389486,America,104,11
2020-07-07,Bahamas,BS,0,0,389486,America,104,11
2020-07-08,Bahamas,BS,0,0,389486,America,104,11
2020-07-09,Bahamas,BS,2,0,389486,America,106,11
2020-07-10,Bahamas,BS,1,0,389486,America,107,11
2020-07-11,Bahamas,BS,1,0,389486,America,108,11
2020-07-12,Bahamas,BS,3,0,389486,America,111,11
2020-07-13,Bahamas,BS,0,0,389486,America,111,11
2020-07-14,Bahamas,BS,2,0,389486,America,113,11
2020-07-15,Bahamas,BS,3,0,389486,America,116,11
2020-07-16,Bahamas,BS,3,0,389486,America,119,11
2020-07-17,Bahamas,BS,5,0,389486,America,124,11
2020-07-18,Bahamas,BS,5,0,389486,America,129,11
2020-07-19,Bahamas,BS,9,0,389486,America,138,11
2020-07-20,Bahamas,BS,15,0,389486,America,153,11
2020-07-21,Bahamas,BS,21,0,389486,America,174,11
2020-07-22,Bahamas,BS,20,0,389486,America,194,11
2020-07-23,Bahamas,BS,25,0,389486,America,219,11
2020-07-24,Bahamas,BS,55,0,389486,America,274,11
2020-07-25,Bahamas,BS,42,0,389486,America,316,11
2020-07-26,Bahamas,BS,10,0,389486,America,326,11
2020-07-27,Bahamas,BS,16,0,389486,America,342,11
2020-07-28,Bahamas,BS,40,0,389486,America,382,11
2020-07-29,Bahamas,BS,65,0,389486,America,447,11
2020-07-30,Bahamas,BS,37,0,389486,America,484,11
2020-07-31,Bahamas,BS,24,3,389486,America,508,14
2020-08-01,Bahamas,BS,66,0,389486,America,574,14
2020-08-02,Bahamas,BS,25,0,389486,America,599,14
2020-08-03,Bahamas,BS,49,0,389486,America,648,14
2020-08-04,Bahamas,BS,31,0,389486,America,679,14
2020-08-05,Bahamas,BS,36,0,389486,America,715,14
2020-08-06,Bahamas,BS,36,0,389486,America,751,14
2020-08-07,Bahamas,BS,10,0,389486,America,761,14
2020-08-08,Bahamas,BS,69,0,389486,America,830,14
2020-08-09,Bahamas,BS,48,0,389486,America,878,14
2020-08-10,Bahamas,BS,20,1,389486,America,898,15
2020-08-11,Bahamas,BS,47,0,389486,America,945,15
2020-08-12,Bahamas,BS,44,0,389486,America,989,15
2020-08-13,Bahamas,BS,47,0,389486,America,1036,15
2020-08-14,Bahamas,BS,53,0,389486,America,1089,15
2020-08-15,Bahamas,BS,30,2,389486,America,1119,17
2020-08-16,Bahamas,BS,133,0,389486,America,1252,17
2020-08-17,Bahamas,BS,63,1,389486,America,1315,18
2020-08-18,Bahamas,BS,14,1,389486,America,1329,19
2020-08-19,Bahamas,BS,95,1,389486,America,1424,20
2020-08-20,Bahamas,BS,107,2,389486,America,1531,22
2020-08-21,Bahamas,BS,79,1,389486,America,1610,23
2020-08-22,Bahamas,BS,93,4,389486,America,1703,27
2020-08-23,Bahamas,BS,62,2,389486,America,1765,29
2020-08-24,Bahamas,BS,0,0,389486,America,1765,29
2020-08-25,Bahamas,BS,33,11,389486,America,1798,40
2020-08-26,Bahamas,BS,15,0,389486,America,1813,40
2020-08-27,Bahamas,BS,0,0,389486,America,1813,40
2020-08-28,Bahamas,BS,110,0,389486,America,1923,40
2020-08-29,Bahamas,BS,134,0,389486,America,2057,40
2020-08-30,Bahamas,BS,78,3,389486,America,2135,43
2020-08-31,Bahamas,BS,32,0,389486,America,2167,43
2020-09-01,Bahamas,BS,50,1,389486,America,2217,44
2020-09-02,Bahamas,BS,59,2,389486,America,2276,46
2020-09-03,Bahamas,BS,61,1,389486,America,2337,47
2020-09-04,Bahamas,BS,49,3,389486,America,2386,50
2020-09-05,Bahamas,BS,0,0,389486,America,2386,50
2020-09-06,Bahamas,BS,90,5,389486,America,2476,55
2020-09-07,Bahamas,BS,70,3,389486,America,2546,58
2020-09-08,Bahamas,BS,39,1,389486,America,2585,59
2020-09-09,Bahamas,BS,72,4,389486,America,2657,63
2020-09-10,Bahamas,BS,64,0,389486,America,2721,63
2020-09-11,Bahamas,BS,0,0,389486,America,2721,63
2020-09-12,Bahamas,BS,93,2,389486,America,2814,65
2020-09-13,Bahamas,BS,114,2,389486,America,2928,67
2020-09-14,Bahamas,BS,0,0,389486,America,2928,67
2020-09-15,Bahamas,BS,80,1,389486,America,3008,68
2020-09-16,Bahamas,BS,24,1,389486,America,3032,69
2020-09-17,Bahamas,BS,55,0,389486,America,3087,69
2020-09-18,Bahamas,BS,90,0,389486,America,3177,69
2020-09-19,Bahamas,BS,37,4,389486,America,3214,73
2020-09-20,Bahamas,BS,101,1,389486,America,3315,74
2020-09-21,Bahamas,BS,55,0,389486,America,3370,74
2020-09-22,Bahamas,BS,48,1,389486,America,3418,75
2020-09-23,Bahamas,BS,49,2,389486,America,3467,77
2020-09-24,Bahamas,BS,151,3,389486,America,3618,80
2020-09-25,Bahamas,BS,81,6,389486,America,3699,86
2020-09-26,Bahamas,BS,91,1,389486,America,3790,87
2020-09-27,Bahamas,BS,0,0,389486,America,3790,87
2020-09-28,Bahamas,BS,0,0,389486,America,3790,87
2020-09-29,Bahamas,BS,48,2,389486,America,3838,89
2020-09-30,Bahamas,BS,65,2,389486,America,3903,91
2020-10-01,Bahamas,BS,220,5,389486,America,4123,96
2020-10-02,Bahamas,BS,97,0,389486,America,4220,96
2020-10-03,Bahamas,BS,0,0,389486,America,4220,96
2020-10-04,Bahamas,BS,189,0,389486,America,4409,96
2020-10-05,Bahamas,BS,0,0,389486,America,4409,96
2020-10-06,Bahamas,BS,150,4,389486,America,4559,100
2020-10-07,Bahamas,BS,0,0,389486,America,4559,100
2020-10-08,Bahamas,BS,154,2,389486,America,4713,102
2020-10-09,Bahamas,BS,0,0,389486,America,4713,102
2020-10-10,Bahamas,BS,242,4,389486,America,4955,106
2020-10-11,Bahamas,BS,68,0,389486,America,5023,106
2020-10-12,Bahamas,BS,55,1,389486,America,5078,107
2020-10-13,Bahamas,BS,85,1,389486,America,5163,108
2020-10-14,Bahamas,BS,0,0,389486,America,5163,108
2020-10-15,Bahamas,BS,222,4,389486,America,5385,112
2020-10-16,Bahamas,BS,0,0,389486,America,5385,112
2020-10-17,Bahamas,BS,132,2,389486,America,5517,114
2020-10-18,Bahamas,BS,111,2,389486,America,5628,116
2020-10-19,Bahamas,BS,75,6,389486,America,5703,122
2020-10-20,Bahamas,BS,70,1,389486,America,5773,123
2020-10-21,Bahamas,BS,150,1,389486,America,5923,124
2020-10-22,Bahamas,BS,128,3,389486,America,6051,127
2020-10-23,Bahamas,BS,84,3,389486,America,6135,130
2020-10-24,Bahamas,BS,133,0,389486,America,6268,130
2020-10-25,Bahamas,BS,84,2,389486,America,6352,132
2020-10-26,Bahamas,BS,58,0,389486,America,6410,132
2020-10-27,Bahamas,BS,56,0,389486,America,6466,132
2020-10-28,Bahamas,BS,36,0,389486,America,6502,132
2020-10-29,Bahamas,BS,47,4,389486,America,6549,136
2020-10-30,Bahamas,BS,95,6,389486,America,6644,142
2020-10-31,Bahamas,BS,0,0,389486,America,6644,142
2020-11-01,Bahamas,BS,70,2,389486,America,6714,144
2020-11-02,Bahamas,BS,0,0,389486,America,6714,144
2020-11-03,Bahamas,BS,21,2,389486,America,6735,146
2020-11-04,Bahamas,BS,55,3,389486,America,6790,149
2020-11-05,Bahamas,BS,53,1,389486,America,6843,150
2020-11-06,Bahamas,BS,39,0,389486,America,6882,150
2020-11-07,Bahamas,BS,0,0,389486,America,6882,150
2020-11-08,Bahamas,BS,65,2,389486,America,6947,152
2020-11-09,Bahamas,BS,0,0,389486,America,6947,152
2020-11-10,Bahamas,BS,37,2,389486,America,6984,154
2020-11-11,Bahamas,BS,0,0,389486,America,6984,154
2020-11-12,Bahamas,BS,76,0,389486,America,7060,154
2020-11-13,Bahamas,BS,64,1,389486,America,7124,155
2020-11-14,Bahamas,BS,39,0,389486,America,7163,155
2020-11-15,Bahamas,BS,0,0,389486,America,7163,155
2020-11-16,Bahamas,BS,23,1,389486,America,7186,156
2020-11-17,Bahamas,BS,70,7,389486,America,7256,163
2020-11-18,Bahamas,BS,56,0,389486,America,7312,163
2020-11-19,Bahamas,BS,11,0,389486,America,7323,163
2020-11-20,Bahamas,BS,0,0,389486,America,7323,163
2020-11-21,Bahamas,BS,44,0,389486,America,7367,163
2020-11-22,Bahamas,BS,28,0,389486,America,7395,163
2020-11-23,Bahamas,BS,18,0,389486,America,7413,163
2020-11-24,Bahamas,BS,0,0,389486,America,7413,163
2020-11-25,Bahamas,BS,0,0,389486,America,7413,163
2020-11-26,Bahamas,BS,56,0,389486,America,7469,163
2020-11-27,Bahamas,BS,13,0,389486,America,7482,163
2020-11-28,Bahamas,BS,14,0,389486,America,7496,163
2020-11-29,Bahamas,BS,0,0,389486,America,7496,163
2020-11-30,Bahamas,BS,0,0,389486,America,7496,163
2020-12-01,Bahamas,BS,45,0,389486,America,7541,163
2020-12-02,Bahamas,BS,2,0,389486,America,7543,163
2020-12-03,Bahamas,BS,0,0,389486,America,7543,163
2020-12-04,Bahamas,BS,22,0,389486,America,7565,163
2020-12-05,Bahamas,BS,0,0,389486,America,7565,163
2020-12-06,Bahamas,BS,5,0,389486,America,7570,163
2020-12-07,Bahamas,BS,9,0,389486,America,7579,163
2020-12-08,Bahamas,BS,0,0,389486,America,7579,163
2020-12-09,Bahamas,BS,0,0,389486,America,7579,163
2020-12-10,Bahamas,BS,6,0,389486,America,7585,163
2020-12-11,Bahamas,BS,0,0,389486,America,7585,163
2020-12-12,Bahamas,BS,63,0,389486,America,7648,163
2020-12-13,Bahamas,BS,11,0,389486,America,7659,163
2020-12-14,Bahamas,BS,15,0,389486,America,7674,163
2020-03-06,Bhutan,BT,1,0,763094,Asia,1,0
2020-03-13,Bhutan,BT,0,0,763094,Asia,1,0
2020-03-15,Bhutan,BT,0,0,763094,Asia,1,0
2020-03-17,Bhutan,BT,0,0,763094,Asia,1,0
2020-03-18,Bhutan,BT,0,0,763094,Asia,1,0
2020-03-19,Bhutan,BT,0,0,763094,Asia,1,0
2020-03-20,Bhutan,BT,0,0,763094,Asia,1,0
2020-03-21,Bhutan,BT,1,0,763094,Asia,2,0
2020-03-22,Bhutan,BT,0,0,763094,Asia,2,0
2020-03-23,Bhutan,BT,0,0,763094,Asia,2,0
2020-03-24,Bhutan,BT,0,0,763094,Asia,2,0
2020-03-25,Bhutan,BT,0,0,763094,Asia,2,0
2020-03-26,Bhutan,BT,1,0,763094,Asia,3,0
2020-03-27,Bhutan,BT,0,0,763094,Asia,3,0
2020-03-28,Bhutan,BT,0,0,763094,Asia,3,0
2020-03-29,Bhutan,BT,1,0,763094,Asia,4,0
2020-03-30,Bhutan,BT,0,0,763094,Asia,4,0
2020-03-31,Bhutan,BT,0,0,763094,Asia,4,0
2020-04-01,Bhutan,BT,0,0,763094,Asia,4,0
2020-04-02,Bhutan,BT,1,0,763094,Asia,5,0
2020-04-03,Bhutan,BT,0,0,763094,Asia,5,0
2020-04-04,Bhutan,BT,0,0,763094,Asia,5,0
2020-04-05,Bhutan,BT,0,0,763094,Asia,5,0
2020-04-06,Bhutan,BT,0,0,763094,Asia,5,0
2020-04-07,Bhutan,BT,0,0,763094,Asia,5,0
2020-04-08,Bhutan,BT,0,0,763094,Asia,5,0
2020-04-09,Bhutan,BT,0,0,763094,Asia,5,0
2020-04-10,Bhutan,BT,0,0,763094,Asia,5,0
2020-04-11,Bhutan,BT,0,0,763094,Asia,5,0
2020-04-12,Bhutan,BT,0,0,763094,Asia,5,0
2020-04-13,Bhutan,BT,0,0,763094,Asia,5,0
2020-04-14,Bhutan,BT,0,0,763094,Asia,5,0
2020-04-15,Bhutan,BT,0,0,763094,Asia,5,0
2020-04-16,Bhutan,BT,0,0,763094,Asia,5,0
2020-04-17,Bhutan,BT,0,0,763094,Asia,5,0
2020-04-18,Bhutan,BT,0,0,763094,Asia,5,0
2020-04-19,Bhutan,BT,0,0,763094,Asia,5,0
2020-04-20,Bhutan,BT,0,0,763094,Asia,5,0
2020-04-21,Bhutan,BT,1,0,763094,Asia,6,0
2020-04-22,Bhutan,BT,0,0,763094,Asia,6,0
2020-04-23,Bhutan,BT,1,0,763094,Asia,7,0
2020-04-24,Bhutan,BT,0,0,763094,Asia,7,0
2020-04-25,Bhutan,BT,0,0,763094,Asia,7,0
2020-04-26,Bhutan,BT,0,0,763094,Asia,7,0
2020-04-27,Bhutan,BT,0,0,763094,Asia,7,0
2020-04-28,Bhutan,BT,0,0,763094,Asia,7,0
2020-04-29,Bhutan,BT,0,0,763094,Asia,7,0
2020-04-30,Bhutan,BT,0,0,763094,Asia,7,0
2020-05-01,Bhutan,BT,0,0,763094,Asia,7,0
2020-05-02,Bhutan,BT,0,0,763094,Asia,7,0
2020-05-03,Bhutan,BT,0,0,763094,Asia,7,0
2020-05-04,Bhutan,BT,0,0,763094,Asia,7,0
2020-05-05,Bhutan,BT,0,0,763094,Asia,7,0
2020-05-06,Bhutan,BT,0,0,763094,Asia,7,0
2020-05-07,Bhutan,BT,0,0,763094,Asia,7,0
2020-05-08,Bhutan,BT,0,0,763094,Asia,7,0
2020-05-09,Bhutan,BT,0,0,763094,Asia,7,0
2020-05-10,Bhutan,BT,0,0,763094,Asia,7,0
2020-05-11,Bhutan,BT,2,0,763094,Asia,9,0
2020-05-12,Bhutan,BT,2,0,763094,Asia,11,0
2020-05-13,Bhutan,BT,0,0,763094,Asia,11,0
2020-05-14,Bhutan,BT,4,0,763094,Asia,15,0
2020-05-15,Bhutan,BT,5,0,763094,Asia,20,0
2020-05-16,Bhutan,BT,1,0,763094,Asia,21,0
2020-05-17,Bhutan,BT,0,0,763094,Asia,21,0
2020-05-18,Bhutan,BT,0,0,763094,Asia,21,0
2020-05-19,Bhutan,BT,0,0,763094,Asia,21,0
2020-05-20,Bhutan,BT,0,0,763094,Asia,21,0
2020-05-21,Bhutan,BT,0,0,763094,Asia,21,0
2020-05-22,Bhutan,BT,0,0,763094,Asia,21,0
2020-05-23,Bhutan,BT,3,0,763094,Asia,24,0
2020-05-24,Bhutan,BT,0,0,763094,Asia,24,0
2020-05-25,Bhutan,BT,3,0,763094,Asia,27,0
2020-05-26,Bhutan,BT,0,0,763094,Asia,27,0
2020-05-27,Bhutan,BT,0,0,763094,Asia,27,0
2020-05-28,Bhutan,BT,1,0,763094,Asia,28,0
2020-05-29,Bhutan,BT,3,0,763094,Asia,31,0
2020-05-30,Bhutan,BT,2,0,763094,Asia,33,0
2020-05-31,Bhutan,BT,10,0,763094,Asia,43,0
2020-06-01,Bhutan,BT,0,0,763094,Asia,43,0
2020-06-02,Bhutan,BT,4,0,763094,Asia,47,0
2020-06-03,Bhutan,BT,0,0,763094,Asia,47,0
2020-06-04,Bhutan,BT,0,0,763094,Asia,47,0
2020-06-05,Bhutan,BT,1,0,763094,Asia,48,0
2020-06-06,Bhutan,BT,0,0,763094,Asia,48,0
2020-06-07,Bhutan,BT,0,0,763094,Asia,48,0
2020-06-08,Bhutan,BT,11,0,763094,Asia,59,0
2020-06-09,Bhutan,BT,0,0,763094,Asia,59,0
2020-06-10,Bhutan,BT,0,0,763094,Asia,59,0
2020-06-11,Bhutan,BT,3,0,763094,Asia,62,0
2020-06-12,Bhutan,BT,0,0,763094,Asia,62,0
2020-06-13,Bhutan,BT,0,0,763094,Asia,62,0
2020-06-14,Bhutan,BT,4,0,763094,Asia,66,0
2020-06-15,Bhutan,BT,0,0,763094,Asia,66,0
2020-06-16,Bhutan,BT,1,0,763094,Asia,67,0
2020-06-17,Bhutan,BT,0,0,763094,Asia,67,0
2020-06-18,Bhutan,BT,0,0,763094,Asia,67,0
2020-06-19,Bhutan,BT,0,0,763094,Asia,67,0
2020-06-20,Bhutan,BT,1,0,763094,Asia,68,0
2020-06-21,Bhutan,BT,0,0,763094,Asia,68,0
2020-06-22,Bhutan,BT,0,0,763094,Asia,68,0
2020-06-23,Bhutan,BT,1,0,763094,Asia,69,0
2020-06-24,Bhutan,BT,1,0,763094,Asia,70,0
2020-06-25,Bhutan,BT,0,0,763094,Asia,70,0
2020-06-26,Bhutan,BT,0,0,763094,Asia,70,0
2020-06-27,Bhutan,BT,5,0,763094,Asia,75,0
2020-06-28,Bhutan,BT,1,0,763094,Asia,76,0
2020-06-29,Bhutan,BT,0,0,763094,Asia,76,0
2020-06-30,Bhutan,BT,1,0,763094,Asia,77,0
2020-07-01,Bhutan,BT,0,0,763094,Asia,77,0
2020-07-02,Bhutan,BT,0,0,763094,Asia,77,0
2020-07-03,Bhutan,BT,0,0,763094,Asia,77,0
2020-07-04,Bhutan,BT,1,0,763094,Asia,78,0
2020-07-05,Bhutan,BT,0,0,763094,Asia,78,0
2020-07-06,Bhutan,BT,2,0,763094,Asia,80,0
2020-07-07,Bhutan,BT,0,0,763094,Asia,80,0
2020-07-08,Bhutan,BT,0,0,763094,Asia,80,0
2020-07-09,Bhutan,BT,0,0,763094,Asia,80,0
2020-07-10,Bhutan,BT,0,0,763094,Asia,80,0
2020-07-11,Bhutan,BT,2,0,763094,Asia,82,0
2020-07-12,Bhutan,BT,0,0,763094,Asia,82,0
2020-07-13,Bhutan,BT,2,0,763094,Asia,84,0
2020-07-14,Bhutan,BT,0,0,763094,Asia,84,0
2020-07-15,Bhutan,BT,0,0,763094,Asia,84,0
2020-07-16,Bhutan,BT,0,0,763094,Asia,84,0
2020-07-17,Bhutan,BT,2,0,763094,Asia,86,0
2020-07-18,Bhutan,BT,1,0,763094,Asia,87,0
2020-07-19,Bhutan,BT,0,0,763094,Asia,87,0
2020-07-20,Bhutan,BT,2,0,763094,Asia,89,0
2020-07-21,Bhutan,BT,1,0,763094,Asia,90,0
2020-07-22,Bhutan,BT,2,0,763094,Asia,92,0
2020-07-23,Bhutan,BT,0,0,763094,Asia,92,0
2020-07-24,Bhutan,BT,0,0,763094,Asia,92,0
2020-07-25,Bhutan,BT,0,0,763094,Asia,92,0
2020-07-26,Bhutan,BT,1,0,763094,Asia,93,0
2020-07-27,Bhutan,BT,2,0,763094,Asia,95,0
2020-07-28,Bhutan,BT,4,0,763094,Asia,99,0
2020-07-29,Bhutan,BT,0,0,763094,Asia,99,0
2020-07-30,Bhutan,BT,2,0,763094,Asia,101,0
2020-07-31,Bhutan,BT,0,0,763094,Asia,101,0
2020-08-01,Bhutan,BT,0,0,763094,Asia,101,0
2020-08-02,Bhutan,BT,1,0,763094,Asia,102,0
2020-08-03,Bhutan,BT,1,0,763094,Asia,103,0
2020-08-04,Bhutan,BT,0,0,763094,Asia,103,0
2020-08-05,Bhutan,BT,2,0,763094,Asia,105,0
2020-08-06,Bhutan,BT,0,0,763094,Asia,105,0
2020-08-07,Bhutan,BT,3,0,763094,Asia,108,0
2020-08-08,Bhutan,BT,0,0,763094,Asia,108,0
2020-08-09,Bhutan,BT,0,0,763094,Asia,108,0
2020-08-10,Bhutan,BT,2,0,763094,Asia,110,0
2020-08-11,Bhutan,BT,3,0,763094,Asia,113,0
2020-08-12,Bhutan,BT,0,0,763094,Asia,113,0
2020-08-13,Bhutan,BT,15,0,763094,Asia,128,0
2020-08-14,Bhutan,BT,3,0,763094,Asia,131,0
2020-08-15,Bhutan,BT,2,0,763094,Asia,133,0
2020-08-16,Bhutan,BT,0,0,763094,Asia,133,0
2020-08-17,Bhutan,BT,8,0,763094,Asia,141,0
2020-08-18,Bhutan,BT,5,0,763094,Asia,146,0
2020-08-19,Bhutan,BT,1,0,763094,Asia,147,0
2020-08-20,Bhutan,BT,3,0,763094,Asia,150,0
2020-08-21,Bhutan,BT,3,0,763094,Asia,153,0
2020-08-22,Bhutan,BT,0,0,763094,Asia,153,0
2020-08-23,Bhutan,BT,2,0,763094,Asia,155,0
2020-08-24,Bhutan,BT,0,0,763094,Asia,155,0
2020-08-25,Bhutan,BT,1,0,763094,Asia,156,0
2020-08-26,Bhutan,BT,17,0,763094,Asia,173,0
2020-08-27,Bhutan,BT,10,0,763094,Asia,183,0
2020-08-28,Bhutan,BT,1,0,763094,Asia,184,0
2020-08-29,Bhutan,BT,11,0,763094,Asia,195,0
2020-08-30,Bhutan,BT,0,0,763094,Asia,195,0
2020-08-31,Bhutan,BT,29,0,763094,Asia,224,0
2020-09-01,Bhutan,BT,1,0,763094,Asia,225,0
2020-09-02,Bhutan,BT,2,0,763094,Asia,227,0
2020-09-03,Bhutan,BT,0,0,763094,Asia,227,0
2020-09-04,Bhutan,BT,0,0,763094,Asia,227,0
2020-09-05,Bhutan,BT,1,0,763094,Asia,228,0
2020-09-06,Bhutan,BT,0,0,763094,Asia,228,0
2020-09-07,Bhutan,BT,2,0,763094,Asia,230,0
2020-09-08,Bhutan,BT,3,0,763094,Asia,233,0
2020-09-09,Bhutan,BT,1,0,763094,Asia,234,0
2020-09-10,Bhutan,BT,0,0,763094,Asia,234,0
2020-09-11,Bhutan,BT,4,0,763094,Asia,238,0
2020-09-12,Bhutan,BT,3,0,763094,Asia,241,0
2020-09-13,Bhutan,BT,3,0,763094,Asia,244,0
2020-09-14,Bhutan,BT,1,0,763094,Asia,245,0
2020-09-15,Bhutan,BT,1,0,763094,Asia,246,0
2020-09-16,Bhutan,BT,0,0,763094,Asia,246,0
2020-09-17,Bhutan,BT,0,0,763094,Asia,246,0
2020-09-18,Bhutan,BT,6,0,763094,Asia,252,0
2020-09-19,Bhutan,BT,6,0,763094,Asia,258,0
2020-09-20,Bhutan,BT,1,0,763094,Asia,259,0
2020-09-21,Bhutan,BT,2,0,763094,Asia,261,0
2020-09-22,Bhutan,BT,0,0,763094,Asia,261,0
2020-09-23,Bhutan,BT,0,0,763094,Asia,261,0
2020-09-24,Bhutan,BT,0,0,763094,Asia,261,0
2020-09-25,Bhutan,BT,2,0,763094,Asia,263,0
2020-09-26,Bhutan,BT,0,0,763094,Asia,263,0
2020-09-27,Bhutan,BT,8,0,763094,Asia,271,0
2020-09-28,Bhutan,BT,2,0,763094,Asia,273,0
2020-09-29,Bhutan,BT,7,0,763094,Asia,280,0
2020-09-30,Bhutan,BT,1,0,763094,Asia,281,0
2020-10-01,Bhutan,BT,1,0,763094,Asia,282,0
2020-10-02,Bhutan,BT,0,0,763094,Asia,282,0
2020-10-03,Bhutan,BT,1,0,763094,Asia,283,0
2020-10-04,Bhutan,BT,0,0,763094,Asia,283,0
2020-10-05,Bhutan,BT,15,0,763094,Asia,298,0
2020-10-06,Bhutan,BT,1,0,763094,Asia,299,0
2020-10-07,Bhutan,BT,1,0,763094,Asia,300,0
2020-10-08,Bhutan,BT,4,0,763094,Asia,304,0
2020-10-09,Bhutan,BT,0,0,763094,Asia,304,0
2020-10-10,Bhutan,BT,2,0,763094,Asia,306,0
2020-10-11,Bhutan,BT,0,0,763094,Asia,306,0
2020-10-12,Bhutan,BT,3,0,763094,Asia,309,0
2020-10-13,Bhutan,BT,0,0,763094,Asia,309,0
2020-10-14,Bhutan,BT,4,0,763094,Asia,313,0
2020-10-15,Bhutan,BT,3,0,763094,Asia,316,0
2020-10-16,Bhutan,BT,0,0,763094,Asia,316,0
2020-10-17,Bhutan,BT,0,0,763094,Asia,316,0
2020-10-18,Bhutan,BT,9,0,763094,Asia,325,0
2020-10-19,Bhutan,BT,2,0,763094,Asia,327,0
2020-10-20,Bhutan,BT,3,0,763094,Asia,330,0
2020-10-21,Bhutan,BT,1,0,763094,Asia,331,0
2020-10-22,Bhutan,BT,1,0,763094,Asia,332,0
2020-10-23,Bhutan,BT,4,0,763094,Asia,336,0
2020-10-24,Bhutan,BT,0,0,763094,Asia,336,0
2020-10-25,Bhutan,BT,4,0,763094,Asia,340,0
2020-10-26,Bhutan,BT,2,0,763094,Asia,342,0
2020-10-27,Bhutan,BT,0,0,763094,Asia,342,0
2020-10-28,Bhutan,BT,3,0,763094,Asia,345,0
2020-10-29,Bhutan,BT,1,0,763094,Asia,346,0
2020-10-30,Bhutan,BT,0,0,763094,Asia,346,0
2020-10-31,Bhutan,BT,2,0,763094,Asia,348,0
2020-11-01,Bhutan,BT,1,0,763094,Asia,349,0
2020-11-02,Bhutan,BT,5,0,763094,Asia,354,0
2020-11-03,Bhutan,BT,2,0,763094,Asia,356,0
2020-11-04,Bhutan,BT,2,0,763094,Asia,358,0
2020-11-05,Bhutan,BT,0,0,763094,Asia,358,0
2020-11-06,Bhutan,BT,0,0,763094,Asia,358,0
2020-11-07,Bhutan,BT,0,0,763094,Asia,358,0
2020-11-08,Bhutan,BT,1,0,763094,Asia,359,0
2020-11-09,Bhutan,BT,0,0,763094,Asia,359,0
2020-11-10,Bhutan,BT,5,0,763094,Asia,364,0
2020-11-11,Bhutan,BT,0,0,763094,Asia,364,0
2020-11-12,Bhutan,BT,0,0,763094,Asia,364,0
2020-11-13,Bhutan,BT,5,0,763094,Asia,369,0
2020-11-14,Bhutan,BT,0,0,763094,Asia,369,0
2020-11-15,Bhutan,BT,6,0,763094,Asia,375,0
2020-11-16,Bhutan,BT,0,0,763094,Asia,375,0
2020-11-17,Bhutan,BT,2,0,763094,Asia,377,0
2020-11-18,Bhutan,BT,1,0,763094,Asia,378,0
2020-11-19,Bhutan,BT,0,0,763094,Asia,378,0
2020-11-20,Bhutan,BT,0,0,763094,Asia,378,0
2020-11-21,Bhutan,BT,0,0,763094,Asia,378,0
2020-11-22,Bhutan,BT,1,0,763094,Asia,379,0
2020-11-23,Bhutan,BT,3,0,763094,Asia,382,0
2020-11-24,Bhutan,BT,4,0,763094,Asia,386,0
2020-11-25,Bhutan,BT,0,0,763094,Asia,386,0
2020-11-26,Bhutan,BT,0,0,763094,Asia,386,0
2020-11-27,Bhutan,BT,3,0,763094,Asia,389,0
2020-11-28,Bhutan,BT,6,0,763094,Asia,395,0
2020-11-29,Bhutan,BT,1,0,763094,Asia,396,0
2020-11-30,Bhutan,BT,0,0,763094,Asia,396,0
2020-12-01,Bhutan,BT,14,0,763094,Asia,410,0
2020-12-02,Bhutan,BT,4,0,763094,Asia,414,0
2020-12-03,Bhutan,BT,1,0,763094,Asia,415,0
2020-12-04,Bhutan,BT,3,0,763094,Asia,418,0
2020-12-05,Bhutan,BT,6,0,763094,Asia,424,0
2020-12-06,Bhutan,BT,2,0,763094,Asia,426,0
2020-12-07,Bhutan,BT,4,0,763094,Asia,430,0
2020-12-08,Bhutan,BT,2,0,763094,Asia,432,0
2020-12-09,Bhutan,BT,1,0,763094,Asia,433,0
2020-12-10,Bhutan,BT,0,0,763094,Asia,433,0
2020-12-11,Bhutan,BT,1,0,763094,Asia,434,0
2020-12-12,Bhutan,BT,2,0,763094,Asia,436,0
2020-12-13,Bhutan,BT,1,0,763094,Asia,437,0
2020-12-14,Bhutan,BT,1,0,763094,Asia,438,0
2020-04-01,Botswana,BW,3,0,2303703,Africa,3,0
2020-04-02,Botswana,BW,1,1,2303703,Africa,4,1
2020-04-03,Botswana,BW,0,0,2303703,Africa,4,1
2020-04-04,Botswana,BW,0,0,2303703,Africa,4,1
2020-04-05,Botswana,BW,0,0,2303703,Africa,4,1
2020-04-06,Botswana,BW,2,0,2303703,Africa,6,1
2020-04-07,Botswana,BW,0,0,2303703,Africa,6,1
2020-04-08,Botswana,BW,0,0,2303703,Africa,6,1
2020-04-09,Botswana,BW,1,0,2303703,Africa,7,1
2020-04-10,Botswana,BW,6,0,2303703,Africa,13,1
2020-04-11,Botswana,BW,0,0,2303703,Africa,13,1
2020-04-12,Botswana,BW,0,0,2303703,Africa,13,1
2020-04-13,Botswana,BW,0,0,2303703,Africa,13,1
2020-04-14,Botswana,BW,0,0,2303703,Africa,13,1
2020-04-15,Botswana,BW,0,0,2303703,Africa,13,1
2020-04-16,Botswana,BW,0,0,2303703,Africa,13,1
2020-04-17,Botswana,BW,2,0,2303703,Africa,15,1
2020-04-18,Botswana,BW,0,0,2303703,Africa,15,1
2020-04-19,Botswana,BW,0,0,2303703,Africa,15,1
2020-04-20,Botswana,BW,5,0,2303703,Africa,20,1
2020-04-21,Botswana,BW,0,0,2303703,Africa,20,1
2020-04-22,Botswana,BW,0,0,2303703,Africa,20,1
2020-04-23,Botswana,BW,2,0,2303703,Africa,22,1
2020-04-24,Botswana,BW,0,0,2303703,Africa,22,1
2020-04-25,Botswana,BW,0,0,2303703,Africa,22,1
2020-04-26,Botswana,BW,0,0,2303703,Africa,22,1
2020-04-27,Botswana,BW,0,0,2303703,Africa,22,1
2020-04-28,Botswana,BW,0,0,2303703,Africa,22,1
2020-04-29,Botswana,BW,1,0,2303703,Africa,23,1
2020-04-30,Botswana,BW,0,0,2303703,Africa,23,1
2020-05-01,Botswana,BW,0,0,2303703,Africa,23,1
2020-05-02,Botswana,BW,0,0,2303703,Africa,23,1
2020-05-03,Botswana,BW,0,0,2303703,Africa,23,1
2020-05-04,Botswana,BW,0,0,2303703,Africa,23,1
2020-05-05,Botswana,BW,0,0,2303703,Africa,23,1
2020-05-06,Botswana,BW,0,0,2303703,Africa,23,1
2020-05-07,Botswana,BW,0,0,2303703,Africa,23,1
2020-05-08,Botswana,BW,0,0,2303703,Africa,23,1
2020-05-09,Botswana,BW,0,0,2303703,Africa,23,1
2020-05-10,Botswana,BW,0,0,2303703,Africa,23,1
2020-05-11,Botswana,BW,0,0,2303703,Africa,23,1
2020-05-12,Botswana,BW,1,0,2303703,Africa,24,1
2020-05-13,Botswana,BW,0,0,2303703,Africa,24,1
2020-05-14,Botswana,BW,0,0,2303703,Africa,24,1
2020-05-15,Botswana,BW,0,0,2303703,Africa,24,1
2020-05-16,Botswana,BW,0,0,2303703,Africa,24,1
2020-05-17,Botswana,BW,0,0,2303703,Africa,24,1
2020-05-18,Botswana,BW,1,0,2303703,Africa,25,1
2020-05-19,Botswana,BW,0,0,2303703,Africa,25,1
2020-05-20,Botswana,BW,0,0,2303703,Africa,25,1
2020-05-21,Botswana,BW,4,0,2303703,Africa,29,1
2020-05-22,Botswana,BW,0,0,2303703,Africa,29,1
2020-05-23,Botswana,BW,1,0,2303703,Africa,30,1
2020-05-24,Botswana,BW,0,0,2303703,Africa,30,1
2020-05-25,Botswana,BW,5,0,2303703,Africa,35,1
2020-05-26,Botswana,BW,0,0,2303703,Africa,35,1
2020-05-27,Botswana,BW,0,0,2303703,Africa,35,1
2020-05-28,Botswana,BW,0,0,2303703,Africa,35,1
2020-05-29,Botswana,BW,0,0,2303703,Africa,35,1
2020-05-30,Botswana,BW,0,0,2303703,Africa,35,1
2020-05-31,Botswana,BW,0,0,2303703,Africa,35,1
2020-06-01,Botswana,BW,3,0,2303703,Africa,38,1
2020-06-02,Botswana,BW,0,0,2303703,Africa,38,1
2020-06-03,Botswana,BW,0,0,2303703,Africa,38,1
2020-06-04,Botswana,BW,2,0,2303703,Africa,40,1
2020-06-05,Botswana,BW,0,0,2303703,Africa,40,1
2020-06-06,Botswana,BW,0,0,2303703,Africa,40,1
2020-06-07,Botswana,BW,0,0,2303703,Africa,40,1
2020-06-08,Botswana,BW,0,0,2303703,Africa,40,1
2020-06-09,Botswana,BW,2,0,2303703,Africa,42,1
2020-06-10,Botswana,BW,0,0,2303703,Africa,42,1
2020-06-11,Botswana,BW,6,0,2303703,Africa,48,1
2020-06-12,Botswana,BW,0,0,2303703,Africa,48,1
2020-06-13,Botswana,BW,12,0,2303703,Africa,60,1
2020-06-14,Botswana,BW,0,0,2303703,Africa,60,1
2020-06-15,Botswana,BW,0,0,2303703,Africa,60,1
2020-06-16,Botswana,BW,0,0,2303703,Africa,60,1
2020-06-17,Botswana,BW,0,0,2303703,Africa,60,1
2020-06-18,Botswana,BW,0,0,2303703,Africa,60,1
2020-06-19,Botswana,BW,19,0,2303703,Africa,79,1
2020-06-20,Botswana,BW,10,0,2303703,Africa,89,1
2020-06-21,Botswana,BW,0,0,2303703,Africa,89,1
2020-06-22,Botswana,BW,0,0,2303703,Africa,89,1
2020-06-23,Botswana,BW,0,0,2303703,Africa,89,1
2020-06-24,Botswana,BW,0,0,2303703,Africa,89,1
2020-06-25,Botswana,BW,0,0,2303703,Africa,89,1
2020-06-26,Botswana,BW,0,0,2303703,Africa,89,1
2020-06-27,Botswana,BW,36,0,2303703,Africa,125,1
2020-06-28,Botswana,BW,0,0,2303703,Africa,125,1
2020-06-29,Botswana,BW,0,0,2303703,Africa,125,1
2020-06-30,Botswana,BW,50,0,2303703,Africa,175,1
2020-07-01,Botswana,BW,52,0,2303703,Africa,227,1
2020-07-02,Botswana,BW,0,0,2303703,Africa,227,1
2020-07-03,Botswana,BW,0,0,2303703,Africa,227,1
2020-07-04,Botswana,BW,48,0,2303703,Africa,275,1
2020-07-05,Botswana,BW,0,0,2303703,Africa,275,1
2020-07-06,Botswana,BW,0,0,2303703,Africa,275,1
2020-07-07,Botswana,BW,0,0,2303703,Africa,275,1
2020-07-08,Botswana,BW,39,0,2303703,Africa,314,1
2020-07-09,Botswana,BW,0,0,2303703,Africa,314,1
2020-07-10,Botswana,BW,0,0,2303703,Africa,314,1
2020-07-11,Botswana,BW,0,0,2303703,Africa,314,1
2020-07-12,Botswana,BW,0,0,2303703,Africa,314,1
2020-07-13,Botswana,BW,85,0,2303703,Africa,399,1
2020-07-14,Botswana,BW,0,0,2303703,Africa,399,1
2020-07-15,Botswana,BW,0,0,2303703,Africa,399,1
2020-07-16,Botswana,BW,0,0,2303703,Africa,399,1
2020-07-17,Botswana,BW,123,0,2303703,Africa,522,1
2020-07-18,Botswana,BW,0,0,2303703,Africa,522,1
2020-07-19,Botswana,BW,0,0,2303703,Africa,522,1
2020-07-20,Botswana,BW,0,0,2303703,Africa,522,1
2020-07-21,Botswana,BW,0,0,2303703,Africa,522,1
2020-07-22,Botswana,BW,0,0,2303703,Africa,522,1
2020-07-23,Botswana,BW,0,0,2303703,Africa,522,1
2020-07-24,Botswana,BW,164,0,2303703,Africa,686,1
2020-07-25,Botswana,BW,0,0,2303703,Africa,686,1
2020-07-26,Botswana,BW,0,0,2303703,Africa,686,1
2020-07-27,Botswana,BW,0,0,2303703,Africa,686,1
2020-07-28,Botswana,BW,53,1,2303703,Africa,739,2
2020-07-29,Botswana,BW,0,0,2303703,Africa,739,2
2020-07-30,Botswana,BW,65,0,2303703,Africa,804,2
2020-07-31,Botswana,BW,0,0,2303703,Africa,804,2
2020-08-01,Botswana,BW,0,0,2303703,Africa,804,2
2020-08-02,Botswana,BW,0,0,2303703,Africa,804,2
2020-08-03,Botswana,BW,0,0,2303703,Africa,804,2
2020-08-04,Botswana,BW,0,0,2303703,Africa,804,2
2020-08-05,Botswana,BW,0,0,2303703,Africa,804,2
2020-08-06,Botswana,BW,0,0,2303703,Africa,804,2
2020-08-07,Botswana,BW,105,0,2303703,Africa,909,2
2020-08-08,Botswana,BW,0,0,2303703,Africa,909,2
2020-08-09,Botswana,BW,0,0,2303703,Africa,909,2
2020-08-10,Botswana,BW,0,0,2303703,Africa,909,2
2020-08-11,Botswana,BW,157,0,2303703,Africa,1066,2
2020-08-12,Botswana,BW,0,0,2303703,Africa,1066,2
2020-08-13,Botswana,BW,0,0,2303703,Africa,1066,2
2020-08-14,Botswana,BW,148,1,2303703,Africa,1214,3
2020-08-15,Botswana,BW,0,0,2303703,Africa,1214,3
2020-08-16,Botswana,BW,0,0,2303703,Africa,1214,3
2020-08-17,Botswana,BW,0,0,2303703,Africa,1214,3
2020-08-18,Botswana,BW,94,0,2303703,Africa,1308,3
2020-08-19,Botswana,BW,0,0,2303703,Africa,1308,3
2020-08-20,Botswana,BW,0,0,2303703,Africa,1308,3
2020-08-21,Botswana,BW,0,0,2303703,Africa,1308,3
2020-08-22,Botswana,BW,0,0,2303703,Africa,1308,3
2020-08-23,Botswana,BW,0,0,2303703,Africa,1308,3
2020-08-24,Botswana,BW,0,0,2303703,Africa,1308,3
2020-08-25,Botswana,BW,254,0,2303703,Africa,1562,3
2020-08-26,Botswana,BW,0,0,2303703,Africa,1562,3
2020-08-27,Botswana,BW,71,3,2303703,Africa,1633,6
2020-08-28,Botswana,BW,0,0,2303703,Africa,1633,6
2020-08-29,Botswana,BW,0,0,2303703,Africa,1633,6
2020-08-30,Botswana,BW,0,0,2303703,Africa,1633,6
2020-08-31,Botswana,BW,0,0,2303703,Africa,1633,6
2020-09-01,Botswana,BW,91,0,2303703,Africa,1724,6
2020-09-02,Botswana,BW,0,0,2303703,Africa,1724,6
2020-09-03,Botswana,BW,0,0,2303703,Africa,1724,6
2020-09-04,Botswana,BW,0,0,2303703,Africa,1724,6
2020-09-05,Botswana,BW,278,2,2303703,Africa,2002,8
2020-09-06,Botswana,BW,0,0,2303703,Africa,2002,8
2020-09-07,Botswana,BW,0,0,2303703,Africa,2002,8
2020-09-08,Botswana,BW,124,1,2303703,Africa,2126,9
2020-09-09,Botswana,BW,0,0,2303703,Africa,2126,9
2020-09-10,Botswana,BW,0,0,2303703,Africa,2126,9
2020-09-11,Botswana,BW,126,1,2303703,Africa,2252,10
2020-09-12,Botswana,BW,0,0,2303703,Africa,2252,10
2020-09-13,Botswana,BW,0,0,2303703,Africa,2252,10
2020-09-14,Botswana,BW,0,0,2303703,Africa,2252,10
2020-09-15,Botswana,BW,211,1,2303703,Africa,2463,11
2020-09-16,Botswana,BW,0,0,2303703,Africa,2463,11
2020-09-17,Botswana,BW,0,0,2303703,Africa,2463,11
2020-09-18,Botswana,BW,104,2,2303703,Africa,2567,13
2020-09-19,Botswana,BW,0,0,2303703,Africa,2567,13
2020-09-20,Botswana,BW,0,0,2303703,Africa,2567,13
2020-09-21,Botswana,BW,0,0,2303703,Africa,2567,13
2020-09-22,Botswana,BW,0,0,2303703,Africa,2567,13
2020-09-23,Botswana,BW,0,0,2303703,Africa,2567,13
2020-09-24,Botswana,BW,0,0,2303703,Africa,2567,13
2020-09-25,Botswana,BW,354,3,2303703,Africa,2921,16
2020-09-26,Botswana,BW,0,0,2303703,Africa,2921,16
2020-09-27,Botswana,BW,0,0,2303703,Africa,2921,16
2020-09-28,Botswana,BW,0,0,2303703,Africa,2921,16
2020-09-29,Botswana,BW,251,0,2303703,Africa,3172,16
2020-09-30,Botswana,BW,0,0,2303703,Africa,3172,16
2020-10-01,Botswana,BW,0,0,2303703,Africa,3172,16
2020-10-02,Botswana,BW,0,0,2303703,Africa,3172,16
2020-10-03,Botswana,BW,0,0,2303703,Africa,3172,16
2020-10-04,Botswana,BW,0,0,2303703,Africa,3172,16
2020-10-05,Botswana,BW,0,0,2303703,Africa,3172,16
2020-10-06,Botswana,BW,0,0,2303703,Africa,3172,16
2020-10-07,Botswana,BW,0,0,2303703,Africa,3172,16
2020-10-08,Botswana,BW,0,0,2303703,Africa,3172,16
2020-10-09,Botswana,BW,1348,2,2303703,Africa,4520,18
2020-10-10,Botswana,BW,0,0,2303703,Africa,4520,18
2020-10-11,Botswana,BW,0,0,2303703,Africa,4520,18
2020-10-12,Botswana,BW,0,0,2303703,Africa,4520,18
2020-10-13,Botswana,BW,313,2,2303703,Africa,4833,20
2020-10-14,Botswana,BW,206,0,2303703,Africa,5039,20
2020-10-15,Botswana,BW,0,0,2303703,Africa,5039,20
2020-10-16,Botswana,BW,203,0,2303703,Africa,5242,20
2020-10-17,Botswana,BW,0,0,2303703,Africa,5242,20
2020-10-18,Botswana,BW,0,0,2303703,Africa,5242,20
2020-10-19,Botswana,BW,0,0,2303703,Africa,5242,20
2020-10-20,Botswana,BW,367,1,2303703,Africa,5609,21
2020-10-21,Botswana,BW,0,0,2303703,Africa,5609,21
2020-10-22,Botswana,BW,0,0,2303703,Africa,5609,21
2020-10-23,Botswana,BW,314,0,2303703,Africa,5923,21
2020-10-24,Botswana,BW,0,0,2303703,Africa,5923,21
2020-10-25,Botswana,BW,0,0,2303703,Africa,5923,21
2020-10-26,Botswana,BW,0,0,2303703,Africa,5923,21
2020-10-27,Botswana,BW,360,0,2303703,Africa,6283,21
2020-10-28,Botswana,BW,0,0,2303703,Africa,6283,21
2020-10-29,Botswana,BW,0,0,2303703,Africa,6283,21
2020-10-30,Botswana,BW,359,3,2303703,Africa,6642,24
2020-10-31,Botswana,BW,0,0,2303703,Africa,6642,24
2020-11-01,Botswana,BW,0,0,2303703,Africa,6642,24
2020-11-02,Botswana,BW,0,0,2303703,Africa,6642,24
2020-11-03,Botswana,BW,0,0,2303703,Africa,6642,24
2020-11-04,Botswana,BW,0,0,2303703,Africa,6642,24
2020-11-05,Botswana,BW,0,0,2303703,Africa,6642,24
2020-11-06,Botswana,BW,1193,3,2303703,Africa,7835,27
2020-11-07,Botswana,BW,0,0,2303703,Africa,7835,27
2020-11-08,Botswana,BW,0,0,2303703,Africa,7835,27
2020-11-09,Botswana,BW,0,0,2303703,Africa,7835,27
2020-11-10,Botswana,BW,0,0,2303703,Africa,7835,27
2020-11-11,Botswana,BW,0,0,2303703,Africa,7835,27
2020-11-12,Botswana,BW,0,0,2303703,Africa,7835,27
2020-11-13,Botswana,BW,390,0,2303703,Africa,8225,27
2020-11-14,Botswana,BW,0,0,2303703,Africa,8225,27
2020-11-15,Botswana,BW,0,0,2303703,Africa,8225,27
2020-11-16,Botswana,BW,0,0,2303703,Africa,8225,27
2020-11-17,Botswana,BW,878,3,2303703,Africa,9103,30
2020-11-18,Botswana,BW,0,0,2303703,Africa,9103,30
2020-11-19,Botswana,BW,0,0,2303703,Africa,9103,30
2020-11-20,Botswana,BW,491,1,2303703,Africa,9594,31
2020-11-21,Botswana,BW,0,0,2303703,Africa,9594,31
2020-11-22,Botswana,BW,0,0,2303703,Africa,9594,31
2020-11-23,Botswana,BW,0,0,2303703,Africa,9594,31
2020-11-24,Botswana,BW,0,0,2303703,Africa,9594,31
2020-11-25,Botswana,BW,398,0,2303703,Africa,9992,31
2020-11-26,Botswana,BW,0,0,2303703,Africa,9992,31
2020-11-27,Botswana,BW,0,0,2303703,Africa,9992,31
2020-11-28,Botswana,BW,0,0,2303703,Africa,9992,31
2020-11-29,Botswana,BW,0,0,2303703,Africa,9992,31
2020-11-30,Botswana,BW,0,0,2303703,Africa,9992,31
2020-12-01,Botswana,BW,0,0,2303703,Africa,9992,31
2020-12-02,Botswana,BW,0,0,2303703,Africa,9992,31
2020-12-03,Botswana,BW,0,0,2303703,Africa,9992,31
2020-12-04,Botswana,BW,18,3,2303703,Africa,10010,34
2020-12-05,Botswana,BW,0,0,2303703,Africa,10010,34
2020-12-06,Botswana,BW,1521,0,2303703,Africa,11531,34
2020-12-07,Botswana,BW,0,0,2303703,Africa,11531,34
2020-12-08,Botswana,BW,0,0,2303703,Africa,11531,34
2020-12-09,Botswana,BW,527,2,2303703,Africa,12058,36
2020-12-10,Botswana,BW,0,0,2303703,Africa,12058,36
2020-12-11,Botswana,BW,0,0,2303703,Africa,12058,36
2020-12-12,Botswana,BW,443,1,2303703,Africa,12501,37
2020-12-13,Botswana,BW,0,0,2303703,Africa,12501,37
2020-12-14,Botswana,BW,0,0,2303703,Africa,12501,37
2019-12-31,Belarus,BY,0,0,9452409,Europe,0,0
2020-01-01,Belarus,BY,0,0,9452409,Europe,0,0
2020-01-02,Belarus,BY,0,0,9452409,Europe,0,0
2020-01-03,Belarus,BY,0,0,9452409,Europe,0,0
2020-01-04,Belarus,BY,0,0,9452409,Europe,0,0
2020-01-05,Belarus,BY,0,0,9452409,Europe,0,0
2020-01-06,Belarus,BY,0,0,9452409,Europe,0,0
2020-01-07,Belarus,BY,0,0,9452409,Europe,0,0
2020-01-08,Belarus,BY,0,0,9452409,Europe,0,0
2020-01-09,Belarus,BY,0,0,9452409,Europe,0,0
2020-01-10,Belarus,BY,0,0,9452409,Europe,0,0
2020-01-11,Belarus,BY,0,0,9452409,Europe,0,0
2020-01-12,Belarus,BY,0,0,9452409,Europe,0,0
2020-01-13,Belarus,BY,0,0,9452409,Europe,0,0
2020-01-14,Belarus,BY,0,0,9452409,Europe,0,0
2020-01-15,Belarus,BY,0,0,9452409,Europe,0,0
2020-01-16,Belarus,BY,0,0,9452409,Europe,0,0
2020-01-17,Belarus,BY,0,0,9452409,Europe,0,0
2020-01-18,Belarus,BY,0,0,9452409,Europe,0,0
2020-01-19,Belarus,BY,0,0,9452409,Europe,0,0
2020-01-20,Belarus,BY,0,0,9452409,Europe,0,0
2020-01-21,Belarus,BY,0,0,9452409,Europe,0,0
2020-01-22,Belarus,BY,0,0,9452409,Europe,0,0
2020-01-23,Belarus,BY,0,0,9452409,Europe,0,0
2020-01-24,Belarus,BY,0,0,9452409,Europe,0,0
2020-01-25,Belarus,BY,0,0,9452409,Europe,0,0
2020-01-26,Belarus,BY,0,0,9452409,Europe,0,0
2020-01-27,Belarus,BY,0,0,9452409,Europe,0,0
2020-01-28,Belarus,BY,0,0,9452409,Europe,0,0
2020-01-29,Belarus,BY,0,0,9452409,Europe,0,0
2020-01-30,Belarus,BY,0,0,9452409,Europe,0,0
2020-01-31,Belarus,BY,0,0,9452409,Europe,0,0
2020-02-01,Belarus,BY,0,0,9452409,Europe,0,0
2020-02-02,Belarus,BY,0,0,9452409,Europe,0,0
2020-02-03,Belarus,BY,0,0,9452409,Europe,0,0
2020-02-04,Belarus,BY,0,0,9452409,Europe,0,0
2020-02-05,Belarus,BY,0,0,9452409,Europe,0,0
2020-02-06,Belarus,BY,0,0,9452409,Europe,0,0
2020-02-07,Belarus,BY,0,0,9452409,Europe,0,0
2020-02-08,Belarus,BY,0,0,9452409,Europe,0,0
2020-02-09,Belarus,BY,0,0,9452409,Europe,0,0
2020-02-10,Belarus,BY,0,0,9452409,Europe,0,0
2020-02-11,Belarus,BY,0,0,9452409,Europe,0,0
2020-02-12,Belarus,BY,0,0,9452409,Europe,0,0
2020-02-13,Belarus,BY,0,0,9452409,Europe,0,0
2020-02-14,Belarus,BY,0,0,9452409,Europe,0,0
2020-02-15,Belarus,BY,0,0,9452409,Europe,0,0
2020-02-16,Belarus,BY,0,0,9452409,Europe,0,0
2020-02-17,Belarus,BY,0,0,9452409,Europe,0,0
2020-02-18,Belarus,BY,0,0,9452409,Europe,0,0
2020-02-19,Belarus,BY,0,0,9452409,Europe,0,0
2020-02-20,Belarus,BY,0,0,9452409,Europe,0,0
2020-02-21,Belarus,BY,0,0,9452409,Europe,0,0
2020-02-22,Belarus,BY,0,0,9452409,Europe,0,0
2020-02-23,Belarus,BY,0,0,9452409,Europe,0,0
2020-02-24,Belarus,BY,0,0,9452409,Europe,0,0
2020-02-25,Belarus,BY,0,0,9452409,Europe,0,0
2020-02-26,Belarus,BY,0,0,9452409,Europe,0,0
2020-02-27,Belarus,BY,0,0,9452409,Europe,0,0
2020-02-28,Belarus,BY,1,0,9452409,Europe,1,0
2020-02-29,Belarus,BY,0,0,9452409,Europe,1,0
2020-03-01,Belarus,BY,0,0,9452409,Europe,1,0
2020-03-02,Belarus,BY,0,0,9452409,Europe,1,0
2020-03-04,Belarus,BY,3,0,9452409,Europe,4,0
2020-03-05,Belarus,BY,2,0,9452409,Europe,6,0
2020-03-11,Belarus,BY,3,0,9452409,Europe,9,0
2020-03-12,Belarus,BY,3,0,9452409,Europe,12,0
2020-03-13,Belarus,BY,9,0,9452409,Europe,21,0
2020-03-16,Belarus,BY,6,0,9452409,Europe,27,0
2020-03-17,Belarus,BY,9,0,9452409,Europe,36,0
2020-03-18,Belarus,BY,0,0,9452409,Europe,36,0
2020-03-19,Belarus,BY,10,0,9452409,Europe,46,0
2020-03-20,Belarus,BY,11,0,9452409,Europe,57,0
2020-03-21,Belarus,BY,0,0,9452409,Europe,57,0
2020-03-22,Belarus,BY,19,0,9452409,Europe,76,0
2020-03-23,Belarus,BY,0,0,9452409,Europe,76,0
2020-03-24,Belarus,BY,5,0,9452409,Europe,81,0
2020-03-25,Belarus,BY,0,0,9452409,Europe,81,0
2020-03-26,Belarus,BY,5,0,9452409,Europe,86,0
2020-03-27,Belarus,BY,0,0,9452409,Europe,86,0
2020-03-28,Belarus,BY,8,0,9452409,Europe,94,0
2020-03-29,Belarus,BY,0,0,9452409,Europe,94,0
2020-03-30,Belarus,BY,0,0,9452409,Europe,94,0
2020-03-31,Belarus,BY,11,0,9452409,Europe,105,0
2020-04-01,Belarus,BY,47,0,9452409,Europe,152,0
2020-04-02,Belarus,BY,0,0,9452409,Europe,152,0
2020-04-03,Belarus,BY,102,4,9452409,Europe,254,4
2020-04-04,Belarus,BY,97,0,9452409,Europe,351,4
2020-04-05,Belarus,BY,43,1,9452409,Europe,394,5
2020-04-06,Belarus,BY,170,3,9452409,Europe,564,8
2020-04-07,Belarus,BY,136,5,9452409,Europe,700,13
2020-04-08,Belarus,BY,161,0,9452409,Europe,861,13
2020-04-09,Belarus,BY,205,0,9452409,Europe,1066,13
2020-04-10,Belarus,BY,420,3,9452409,Europe,1486,16
2020-04-11,Belarus,BY,495,3,9452409,Europe,1981,19
2020-04-12,Belarus,BY,245,4,9452409,Europe,2226,23
2020-04-13,Belarus,BY,352,3,9452409,Europe,2578,26
2020-04-14,Belarus,BY,341,3,9452409,Europe,2919,29
2020-04-15,Belarus,BY,362,4,9452409,Europe,3281,33
2020-04-16,Belarus,BY,447,3,9452409,Europe,3728,36
2020-04-17,Belarus,BY,476,4,9452409,Europe,4204,40
2020-04-18,Belarus,BY,575,3,9452409,Europe,4779,43
2020-04-19,Belarus,BY,518,2,9452409,Europe,5297,45
2020-04-20,Belarus,BY,510,2,9452409,Europe,5807,47
2020-04-21,Belarus,BY,457,4,9452409,Europe,6264,51
2020-04-22,Belarus,BY,459,4,9452409,Europe,6723,55
2020-04-23,Belarus,BY,558,3,9452409,Europe,7281,58
2020-04-24,Belarus,BY,741,2,9452409,Europe,8022,60
2020-04-25,Belarus,BY,751,3,9452409,Europe,8773,63
2020-04-26,Belarus,BY,817,4,9452409,Europe,9590,67
2020-04-27,Belarus,BY,873,5,9452409,Europe,10463,72
2020-04-28,Belarus,BY,826,3,9452409,Europe,11289,75
2020-04-29,Belarus,BY,919,4,9452409,Europe,12208,79
2020-04-30,Belarus,BY,973,5,9452409,Europe,13181,84
2020-05-01,Belarus,BY,846,5,9452409,Europe,14027,89
2020-05-02,Belarus,BY,890,4,9452409,Europe,14917,93
2020-05-03,Belarus,BY,911,4,9452409,Europe,15828,97
2020-05-04,Belarus,BY,877,2,9452409,Europe,16705,99
2020-05-05,Belarus,BY,784,4,9452409,Europe,17489,103
2020-05-06,Belarus,BY,861,4,9452409,Europe,18350,107
2020-05-07,Belarus,BY,905,5,9452409,Europe,19255,112
2020-05-08,Belarus,BY,913,4,9452409,Europe,20168,116
2020-05-09,Belarus,BY,933,5,9452409,Europe,21101,121
2020-05-10,Belarus,BY,951,5,9452409,Europe,22052,126
2020-05-11,Belarus,BY,921,5,9452409,Europe,22973,131
2020-05-12,Belarus,BY,933,4,9452409,Europe,23906,135
2020-05-13,Belarus,BY,967,7,9452409,Europe,24873,142
2020-05-14,Belarus,BY,952,4,9452409,Europe,25825,146
2020-05-15,Belarus,BY,947,5,9452409,Europe,26772,151
2020-05-16,Belarus,BY,958,5,9452409,Europe,27730,156
2020-05-17,Belarus,BY,951,4,9452409,Europe,28681,160
2020-05-18,Belarus,BY,969,5,9452409,Europe,29650,165
2020-05-19,Belarus,BY,922,6,9452409,Europe,30572,171
2020-05-20,Belarus,BY,936,4,9452409,Europe,31508,175
2020-05-21,Belarus,BY,918,4,9452409,Europe,32426,179
2020-05-22,Belarus,BY,945,6,9452409,Europe,33371,185
2020-05-23,Belarus,BY,932,5,9452409,Europe,34303,190
2020-05-24,Belarus,BY,941,4,9452409,Europe,35244,194
2020-05-25,Belarus,BY,954,5,9452409,Europe,36198,199
2020-05-26,Belarus,BY,946,5,9452409,Europe,37144,204
2020-05-27,Belarus,BY,915,4,9452409,Europe,38059,208
2020-05-28,Belarus,BY,897,6,9452409,Europe,38956,214
2020-05-29,Belarus,BY,902,5,9452409,Europe,39858,219
2020-05-30,Belarus,BY,906,5,9452409,Europe,40764,224
2020-05-31,Belarus,BY,894,5,9452409,Europe,41658,229
2020-06-01,Belarus,BY,898,6,9452409,Europe,42556,235
2020-06-02,Belarus,BY,847,5,9452409,Europe,43403,240
2020-06-03,Belarus,BY,852,3,9452409,Europe,44255,243
2020-06-04,Belarus,BY,861,5,9452409,Europe,45116,248
2020-06-05,Belarus,BY,865,5,9452409,Europe,45981,253
2020-06-06,Belarus,BY,887,6,9452409,Europe,46868,259
2020-06-07,Belarus,BY,883,4,9452409,Europe,47751,263
2020-06-08,Belarus,BY,879,6,9452409,Europe,48630,269
2020-06-09,Belarus,BY,823,7,9452409,Europe,49453,276
2020-06-10,Belarus,BY,812,6,9452409,Europe,50265,282
2020-06-11,Belarus,BY,801,6,9452409,Europe,51066,288
2020-06-12,Belarus,BY,750,5,9452409,Europe,51816,293
2020-06-13,Belarus,BY,704,5,9452409,Europe,52520,298
2020-06-14,Belarus,BY,721,5,9452409,Europe,53241,303
2020-06-15,Belarus,BY,732,5,9452409,Europe,53973,308
2020-06-16,Belarus,BY,707,4,9452409,Europe,54680,312
2020-06-17,Belarus,BY,689,6,9452409,Europe,55369,318
2020-06-18,Belarus,BY,663,6,9452409,Europe,56032,324
2020-06-19,Belarus,BY,625,7,9452409,Europe,56657,331
2020-06-20,Belarus,BY,676,2,9452409,Europe,57333,333
2020-06-21,Belarus,BY,603,10,9452409,Europe,57936,343
2020-06-22,Belarus,BY,569,3,9452409,Europe,58505,346
2020-06-23,Belarus,BY,518,5,9452409,Europe,59023,351
2020-06-24,Belarus,BY,464,6,9452409,Europe,59487,357
2020-06-25,Belarus,BY,458,5,9452409,Europe,59945,362
2020-06-26,Belarus,BY,437,5,9452409,Europe,60382,367
2020-06-27,Belarus,BY,331,6,9452409,Europe,60713,373
2020-06-28,Belarus,BY,382,4,9452409,Europe,61095,377
2020-06-29,Belarus,BY,380,6,9452409,Europe,61475,383
2020-06-30,Belarus,BY,315,4,9452409,Europe,61790,387
2020-07-01,Belarus,BY,328,5,9452409,Europe,62118,392
2020-07-02,Belarus,BY,306,6,9452409,Europe,62424,398
2020-07-03,Belarus,BY,274,7,9452409,Europe,62698,405
2020-07-04,Belarus,BY,299,7,9452409,Europe,62997,412
2020-07-05,Belarus,BY,273,6,9452409,Europe,63270,418
2020-07-06,Belarus,BY,284,5,9452409,Europe,63554,423
2020-07-07,Belarus,BY,250,6,9452409,Europe,63804,429
2020-07-08,Belarus,BY,199,7,9452409,Europe,64003,436
2020-07-09,Belarus,BY,221,7,9452409,Europe,64224,443
2020-07-10,Belarus,BY,187,6,9452409,Europe,64411,449
2020-07-11,Belarus,BY,193,5,9452409,Europe,64604,454
2020-07-12,Belarus,BY,163,5,9452409,Europe,64767,459
2020-07-13,Belarus,BY,165,5,9452409,Europe,64932,464
2020-07-14,Belarus,BY,182,4,9452409,Europe,65114,468
2020-07-15,Belarus,BY,155,6,9452409,Europe,65269,474
2020-07-16,Belarus,BY,174,6,9452409,Europe,65443,480
2020-07-17,Belarus,BY,180,5,9452409,Europe,65623,485
2020-07-18,Belarus,BY,159,6,9452409,Europe,65782,491
2020-07-19,Belarus,BY,171,4,9452409,Europe,65953,495
2020-07-20,Belarus,BY,142,4,9452409,Europe,66095,499
2020-07-21,Belarus,BY,118,4,9452409,Europe,66213,503
2020-07-22,Belarus,BY,135,4,9452409,Europe,66348,507
2020-07-23,Belarus,BY,173,6,9452409,Europe,66521,513
2020-07-24,Belarus,BY,167,6,9452409,Europe,66688,519
2020-07-25,Belarus,BY,158,0,9452409,Europe,66846,519
2020-07-26,Belarus,BY,156,11,9452409,Europe,67002,530
2020-07-27,Belarus,BY,130,4,9452409,Europe,67132,534
2020-07-28,Belarus,BY,119,4,9452409,Europe,67251,538
2020-07-29,Belarus,BY,115,5,9452409,Europe,67366,543
2020-07-30,Belarus,BY,152,5,9452409,Europe,67518,548
2020-07-31,Belarus,BY,147,5,9452409,Europe,67665,553
2020-08-01,Belarus,BY,143,6,9452409,Europe,67808,559
2020-08-02,Belarus,BY,138,4,9452409,Europe,67946,563
2020-08-03,Belarus,BY,121,4,9452409,Europe,68067,567
2020-08-04,Belarus,BY,99,4,9452409,Europe,68166,571
2020-08-05,Belarus,BY,84,3,9452409,Europe,68250,574
2020-08-06,Belarus,BY,126,3,9452409,Europe,68376,577
2020-08-07,Belarus,BY,127,3,9452409,Europe,68503,580
2020-08-08,Belarus,BY,111,3,9452409,Europe,68614,583
2020-08-09,Belarus,BY,124,2,9452409,Europe,68738,585
2020-08-10,Belarus,BY,112,2,9452409,Europe,68850,587
2020-08-11,Belarus,BY,97,2,9452409,Europe,68947,589
2020-08-12,Belarus,BY,58,3,9452409,Europe,69005,592
2020-08-13,Belarus,BY,97,3,9452409,Europe,69102,595
2020-08-14,Belarus,BY,101,4,9452409,Europe,69203,599
2020-08-15,Belarus,BY,105,4,9452409,Europe,69308,603
2020-08-16,Belarus,BY,116,4,9452409,Europe,69424,607
2020-08-17,Belarus,BY,92,3,9452409,Europe,69516,610
2020-08-18,Belarus,BY,73,3,9452409,Europe,69589,613
2020-08-19,Belarus,BY,84,4,9452409,Europe,69673,617
2020-08-20,Belarus,BY,128,5,9452409,Europe,69801,622
2020-08-21,Belarus,BY,149,5,9452409,Europe,69950,627
2020-08-22,Belarus,BY,161,5,9452409,Europe,70111,632
2020-08-23,Belarus,BY,174,5,9452409,Europe,70285,637
2020-08-24,Belarus,BY,183,5,9452409,Europe,70468,642
2020-08-25,Belarus,BY,177,4,9452409,Europe,70645,646
2020-08-26,Belarus,BY,82,6,9452409,Europe,70727,652
2020-08-27,Belarus,BY,247,5,9452409,Europe,70974,657
2020-08-28,Belarus,BY,191,5,9452409,Europe,71165,662
2020-08-29,Belarus,BY,181,5,9452409,Europe,71346,667
2020-08-30,Belarus,BY,177,4,9452409,Europe,71523,671
2020-08-31,Belarus,BY,164,5,9452409,Europe,71687,676
2020-09-01,Belarus,BY,156,5,9452409,Europe,71843,681
2020-09-02,Belarus,BY,119,5,9452409,Europe,71962,686
2020-09-03,Belarus,BY,179,5,9452409,Europe,72141,691
2020-09-04,Belarus,BY,161,5,9452409,Europe,72302,696
2020-09-05,Belarus,BY,183,5,9452409,Europe,72485,701
2020-09-06,Belarus,BY,178,4,9452409,Europe,72663,705
2020-09-07,Belarus,BY,196,6,9452409,Europe,72859,711
2020-09-08,Belarus,BY,172,5,9452409,Europe,73031,716
2020-09-09,Belarus,BY,177,5,9452409,Europe,73208,721
2020-09-10,Belarus,BY,194,5,9452409,Europe,73402,726
2020-09-11,Belarus,BY,189,6,9452409,Europe,73591,732
2020-09-12,Belarus,BY,193,6,9452409,Europe,73784,738
2020-09-13,Belarus,BY,191,6,9452409,Europe,73975,744
2020-09-14,Belarus,BY,198,6,9452409,Europe,74173,750
2020-09-15,Belarus,BY,187,6,9452409,Europe,74360,756
2020-09-16,Belarus,BY,192,5,9452409,Europe,74552,761
2020-09-17,Belarus,BY,211,6,9452409,Europe,74763,767
2020-09-18,Belarus,BY,224,4,9452409,Europe,74987,771
2020-09-19,Belarus,BY,243,2,9452409,Europe,75230,773
2020-09-20,Belarus,BY,231,3,9452409,Europe,75461,776
2020-09-21,Belarus,BY,213,4,9452409,Europe,75674,780
2020-09-22,Belarus,BY,224,5,9452409,Europe,75898,785
2020-09-23,Belarus,BY,206,6,9452409,Europe,76104,791
2020-09-24,Belarus,BY,253,5,9452409,Europe,76357,796
2020-09-25,Belarus,BY,294,6,9452409,Europe,76651,802
2020-09-26,Belarus,BY,306,5,9452409,Europe,76957,807
2020-09-27,Belarus,BY,332,6,9452409,Europe,77289,813
2020-09-28,Belarus,BY,320,5,9452409,Europe,77609,818
2020-09-29,Belarus,BY,337,4,9452409,Europe,77946,822
2020-09-30,Belarus,BY,314,6,9452409,Europe,78260,828
2020-10-01,Belarus,BY,371,5,9452409,Europe,78631,833
2020-10-02,Belarus,BY,388,6,9452409,Europe,79019,839
2020-10-03,Belarus,BY,402,5,9452409,Europe,79421,844
2020-10-04,Belarus,BY,431,7,9452409,Europe,79852,851
2020-10-05,Belarus,BY,443,6,9452409,Europe,80295,857
2020-10-06,Belarus,BY,401,5,9452409,Europe,80696,862
2020-10-07,Belarus,BY,394,6,9452409,Europe,81090,868
2020-10-08,Belarus,BY,415,6,9452409,Europe,81505,874
2020-10-09,Belarus,BY,477,6,9452409,Europe,81982,880
2020-10-10,Belarus,BY,489,5,9452409,Europe,82471,885
2020-10-11,Belarus,BY,0,0,9452409,Europe,82471,885
2020-10-12,Belarus,BY,1063,11,9452409,Europe,83534,896
2020-10-13,Belarus,BY,464,5,9452409,Europe,83998,901
2020-10-14,Belarus,BY,526,5,9452409,Europe,84524,906
2020-10-15,Belarus,BY,597,5,9452409,Europe,85121,911
2020-10-16,Belarus,BY,613,5,9452409,Europe,85734,916
2020-10-17,Belarus,BY,658,5,9452409,Europe,86392,921
2020-10-18,Belarus,BY,0,0,9452409,Europe,86392,921
2020-10-19,Belarus,BY,1306,8,9452409,Europe,87698,929
2020-10-20,Belarus,BY,592,4,9452409,Europe,88290,933
2020-10-21,Belarus,BY,619,4,9452409,Europe,88909,937
2020-10-22,Belarus,BY,733,4,9452409,Europe,89642,941
2020-10-23,Belarus,BY,738,4,9452409,Europe,90380,945
2020-10-24,Belarus,BY,787,0,9452409,Europe,91167,945
2020-10-25,Belarus,BY,811,8,9452409,Europe,91978,953
2020-10-26,Belarus,BY,845,4,9452409,Europe,92823,957
2020-10-27,Belarus,BY,884,4,9452409,Europe,93707,961
2020-10-28,Belarus,BY,902,4,9452409,Europe,94609,965
2020-10-29,Belarus,BY,936,4,9452409,Europe,95545,969
2020-10-30,Belarus,BY,984,4,9452409,Europe,96529,973
2020-10-31,Belarus,BY,970,4,9452409,Europe,97499,977
2020-11-01,Belarus,BY,983,3,9452409,Europe,98482,980
2020-11-02,Belarus,BY,977,5,9452409,Europe,99459,985
2020-11-03,Belarus,BY,941,4,9452409,Europe,100400,989
2020-11-04,Belarus,BY,929,3,9452409,Europe,101329,992
2020-11-05,Belarus,BY,984,3,9452409,Europe,102313,995
2020-11-06,Belarus,BY,982,3,9452409,Europe,103295,998
2020-11-07,Belarus,BY,991,3,9452409,Europe,104286,1001
2020-11-08,Belarus,BY,997,3,9452409,Europe,105283,1004
2020-11-09,Belarus,BY,996,3,9452409,Europe,106279,1007
2020-11-10,Belarus,BY,983,4,9452409,Europe,107262,1011
2020-11-11,Belarus,BY,1038,5,9452409,Europe,108300,1016
2020-11-12,Belarus,BY,1057,6,9452409,Europe,109357,1022
2020-11-13,Belarus,BY,1098,5,9452409,Europe,110455,1027
2020-11-14,Belarus,BY,1167,6,9452409,Europe,111622,1033
2020-11-15,Belarus,BY,1248,6,9452409,Europe,112870,1039
2020-11-16,Belarus,BY,1315,7,9452409,Europe,114185,1046
2020-11-17,Belarus,BY,1263,7,9452409,Europe,115448,1053
2020-11-18,Belarus,BY,1251,7,9452409,Europe,116699,1060
2020-11-19,Belarus,BY,1309,7,9452409,Europe,118008,1067
2020-11-20,Belarus,BY,1382,7,9452409,Europe,119390,1074
2020-11-21,Belarus,BY,1457,7,9452409,Europe,120847,1081
2020-11-22,Belarus,BY,1588,8,9452409,Europe,122435,1089
2020-11-23,Belarus,BY,1564,7,9452409,Europe,123999,1096
2020-11-24,Belarus,BY,1483,8,9452409,Europe,125482,1104
2020-11-25,Belarus,BY,1471,8,9452409,Europe,126953,1112
2020-11-26,Belarus,BY,1496,7,9452409,Europe,128449,1119
2020-11-27,Belarus,BY,1563,9,9452409,Europe,130012,1128
2020-11-28,Belarus,BY,1621,8,9452409,Europe,131633,1136
2020-11-29,Belarus,BY,1691,7,9452409,Europe,133324,1143
2020-11-30,Belarus,BY,1684,8,9452409,Europe,135008,1151
2020-12-01,Belarus,BY,1639,7,9452409,Europe,136647,1158
2020-12-02,Belarus,BY,1572,8,9452409,Europe,138219,1166
2020-12-03,Belarus,BY,1689,8,9452409,Europe,139908,1174
2020-12-04,Belarus,BY,1701,7,9452409,Europe,141609,1181
2020-12-05,Belarus,BY,1774,9,9452409,Europe,143383,1190
2020-12-06,Belarus,BY,1896,8,9452409,Europe,145279,1198
2020-12-07,Belarus,BY,1878,9,9452409,Europe,147157,1207
2020-12-08,Belarus,BY,1796,8,9452409,Europe,148953,1215
2020-12-09,Belarus,BY,1649,7,9452409,Europe,150602,1222
2020-12-10,Belarus,BY,1851,8,9452409,Europe,152453,1230
2020-12-11,Belarus,BY,1939,8,9452409,Europe,154392,1238
2020-12-12,Belarus,BY,1967,8,9452409,Europe,156359,1246
2020-12-13,Belarus,BY,1975,8,9452409,Europe,158334,1254
2020-12-14,Belarus,BY,1961,9,9452409,Europe,160295,1263
2020-03-24,Belize,BZ,1,0,390351,America,1,0
2020-03-25,Belize,BZ,0,0,390351,America,1,0
2020-03-26,Belize,BZ,1,0,390351,America,2,0
2020-03-27,Belize,BZ,0,0,390351,America,2,0
2020-03-28,Belize,BZ,0,0,390351,America,2,0
2020-03-29,Belize,BZ,0,0,390351,America,2,0
2020-03-30,Belize,BZ,0,0,390351,America,2,0
2020-03-31,Belize,BZ,1,0,390351,America,3,0
2020-04-01,Belize,BZ,0,0,390351,America,3,0
2020-04-02,Belize,BZ,0,0,390351,America,3,0
2020-04-03,Belize,BZ,0,0,390351,America,3,0
2020-04-04,Belize,BZ,1,0,390351,America,4,0
2020-04-05,Belize,BZ,0,0,390351,America,4,0
2020-04-06,Belize,BZ,1,1,390351,America,5,1
2020-04-07,Belize,BZ,2,0,390351,America,7,1
2020-04-08,Belize,BZ,0,0,390351,America,7,1
2020-04-09,Belize,BZ,1,0,390351,America,8,1
2020-04-10,Belize,BZ,1,0,390351,America,9,1
2020-04-11,Belize,BZ,1,1,390351,America,10,2
2020-04-12,Belize,BZ,3,0,390351,America,13,2
2020-04-13,Belize,BZ,1,0,390351,America,14,2
2020-04-14,Belize,BZ,4,0,390351,America,18,2
2020-04-15,Belize,BZ,0,0,390351,America,18,2
2020-04-16,Belize,BZ,0,0,390351,America,18,2
2020-04-17,Belize,BZ,0,0,390351,America,18,2
2020-04-18,Belize,BZ,0,0,390351,America,18,2
2020-04-19,Belize,BZ,0,0,390351,America,18,2
2020-04-20,Belize,BZ,0,0,390351,America,18,2
2020-04-21,Belize,BZ,0,0,390351,America,18,2
2020-04-22,Belize,BZ,0,0,390351,America,18,2
2020-04-23,Belize,BZ,0,0,390351,America,18,2
2020-04-24,Belize,BZ,0,0,390351,America,18,2
2020-04-25,Belize,BZ,0,0,390351,America,18,2
2020-04-26,Belize,BZ,0,0,390351,America,18,2
2020-04-27,Belize,BZ,0,0,390351,America,18,2
2020-04-28,Belize,BZ,0,0,390351,America,18,2
2020-04-29,Belize,BZ,0,0,390351,America,18,2
2020-04-30,Belize,BZ,0,0,390351,America,18,2
2020-05-01,Belize,BZ,0,0,390351,America,18,2
2020-05-02,Belize,BZ,0,0,390351,America,18,2
2020-05-03,Belize,BZ,0,0,390351,America,18,2
2020-05-04,Belize,BZ,0,0,390351,America,18,2
2020-05-05,Belize,BZ,0,0,390351,America,18,2
2020-05-06,Belize,BZ,0,0,390351,America,18,2
2020-05-07,Belize,BZ,0,0,390351,America,18,2
2020-05-08,Belize,BZ,0,0,390351,America,18,2
2020-05-09,Belize,BZ,0,0,390351,America,18,2
2020-05-10,Belize,BZ,0,0,390351,America,18,2
2020-05-11,Belize,BZ,0,0,390351,America,18,2
2020-05-12,Belize,BZ,0,0,390351,America,18,2
2020-05-13,Belize,BZ,0,0,390351,America,18,2
2020-05-14,Belize,BZ,0,0,390351,America,18,2
2020-05-15,Belize,BZ,0,0,390351,America,18,2
2020-05-16,Belize,BZ,0,0,390351,America,18,2
2020-05-17,Belize,BZ,0,0,390351,America,18,2
2020-05-18,Belize,BZ,0,0,390351,America,18,2
2020-05-19,Belize,BZ,0,0,390351,America,18,2
2020-05-20,Belize,BZ,0,0,390351,America,18,2
2020-05-21,Belize,BZ,0,0,390351,America,18,2
2020-05-22,Belize,BZ,0,0,390351,America,18,2
2020-05-23,Belize,BZ,0,0,390351,America,18,2
2020-05-24,Belize,BZ,0,0,390351,America,18,2
2020-05-25,Belize,BZ,0,0,390351,America,18,2
2020-05-26,Belize,BZ,0,0,390351,America,18,2
2020-05-27,Belize,BZ,0,0,390351,America,18,2
2020-05-28,Belize,BZ,0,0,390351,America,18,2
2020-05-29,Belize,BZ,0,0,390351,America,18,2
2020-05-30,Belize,BZ,0,0,390351,America,18,2
2020-05-31,Belize,BZ,0,0,390351,America,18,2
2020-06-01,Belize,BZ,0,0,390351,America,18,2
2020-06-02,Belize,BZ,0,0,390351,America,18,2
2020-06-03,Belize,BZ,0,0,390351,America,18,2
2020-06-04,Belize,BZ,0,0,390351,America,18,2
2020-06-05,Belize,BZ,0,0,390351,America,18,2
2020-06-06,Belize,BZ,0,0,390351,America,18,2
2020-06-07,Belize,BZ,0,0,390351,America,18,2
2020-06-08,Belize,BZ,0,0,390351,America,18,2
2020-06-09,Belize,BZ,1,0,390351,America,19,2
2020-06-10,Belize,BZ,1,0,390351,America,20,2
2020-06-11,Belize,BZ,0,0,390351,America,20,2
2020-06-12,Belize,BZ,0,0,390351,America,20,2
2020-06-13,Belize,BZ,0,0,390351,America,20,2
2020-06-14,Belize,BZ,0,0,390351,America,20,2
2020-06-15,Belize,BZ,1,0,390351,America,21,2
2020-06-16,Belize,BZ,0,0,390351,America,21,2
2020-06-17,Belize,BZ,0,0,390351,America,21,2
2020-06-18,Belize,BZ,1,0,390351,America,22,2
2020-06-19,Belize,BZ,0,0,390351,America,22,2
2020-06-20,Belize,BZ,0,0,390351,America,22,2
2020-06-21,Belize,BZ,0,0,390351,America,22,2
2020-06-22,Belize,BZ,0,0,390351,America,22,2
2020-06-23,Belize,BZ,1,0,390351,America,23,2
2020-06-24,Belize,BZ,0,0,390351,America,23,2
2020-06-25,Belize,BZ,0,0,390351,America,23,2
2020-06-26,Belize,BZ,0,0,390351,America,23,2
2020-06-27,Belize,BZ,1,0,390351,America,24,2
2020-06-28,Belize,BZ,0,0,390351,America,24,2
2020-06-29,Belize,BZ,0,0,390351,America,24,2
2020-06-30,Belize,BZ,0,0,390351,America,24,2
2020-07-01,Belize,BZ,4,0,390351,America,28,2
2020-07-02,Belize,BZ,0,0,390351,America,28,2
2020-07-03,Belize,BZ,0,0,390351,America,28,2
2020-07-04,Belize,BZ,2,0,390351,America,30,2
2020-07-05,Belize,BZ,0,0,390351,America,30,2
2020-07-06,Belize,BZ,0,0,390351,America,30,2
2020-07-07,Belize,BZ,0,0,390351,America,30,2
2020-07-08,Belize,BZ,0,0,390351,America,30,2
2020-07-09,Belize,BZ,0,0,390351,America,30,2
2020-07-10,Belize,BZ,3,0,390351,America,33,2
2020-07-11,Belize,BZ,4,0,390351,America,37,2
2020-07-12,Belize,BZ,0,0,390351,America,37,2
2020-07-13,Belize,BZ,0,0,390351,America,37,2
2020-07-14,Belize,BZ,0,0,390351,America,37,2
2020-07-15,Belize,BZ,2,0,390351,America,39,2
2020-07-16,Belize,BZ,0,0,390351,America,39,2
2020-07-17,Belize,BZ,1,0,390351,America,40,2
2020-07-18,Belize,BZ,0,0,390351,America,40,2
2020-07-19,Belize,BZ,0,0,390351,America,40,2
2020-07-20,Belize,BZ,0,0,390351,America,40,2
2020-07-21,Belize,BZ,2,0,390351,America,42,2
2020-07-22,Belize,BZ,1,0,390351,America,43,2
2020-07-23,Belize,BZ,0,0,390351,America,43,2
2020-07-24,Belize,BZ,4,0,390351,America,47,2
2020-07-25,Belize,BZ,1,0,390351,America,48,2
2020-07-26,Belize,BZ,0,0,390351,America,48,2
2020-07-27,Belize,BZ,0,0,390351,America,48,2
2020-07-28,Belize,BZ,0,0,390351,America,48,2
2020-07-29,Belize,BZ,0,0,390351,America,48,2
2020-07-30,Belize,BZ,0,0,390351,America,48,2
2020-07-31,Belize,BZ,0,0,390351,America,48,2
2020-08-01,Belize,BZ,0,0,390351,America,48,2
2020-08-02,Belize,BZ,8,0,390351,America,56,2
2020-08-03,Belize,BZ,1,0,390351,America,57,2
2020-08-04,Belize,BZ,0,0,390351,America,57,2
2020-08-05,Belize,BZ,15,0,390351,America,72,2
2020-08-06,Belize,BZ,14,0,390351,America,86,2
2020-08-07,Belize,BZ,28,0,390351,America,114,2
2020-08-08,Belize,BZ,32,0,390351,America,146,2
2020-08-09,Belize,BZ,7,0,390351,America,153,2
2020-08-10,Belize,BZ,1,0,390351,America,154,2
2020-08-11,Belize,BZ,23,0,390351,America,177,2
2020-08-12,Belize,BZ,33,0,390351,America,210,2
2020-08-13,Belize,BZ,86,0,390351,America,296,2
2020-08-14,Belize,BZ,60,0,390351,America,356,2
2020-08-15,Belize,BZ,32,1,390351,America,388,3
2020-08-16,Belize,BZ,64,0,390351,America,452,3
2020-08-17,Belize,BZ,0,0,390351,America,452,3
2020-08-18,Belize,BZ,23,1,390351,America,475,4
2020-08-19,Belize,BZ,78,0,390351,America,553,4
2020-08-20,Belize,BZ,0,1,390351,America,553,5
2020-08-21,Belize,BZ,52,0,390351,America,605,5
2020-08-22,Belize,BZ,43,0,390351,America,648,5
2020-08-23,Belize,BZ,20,1,390351,America,668,6
2020-08-24,Belize,BZ,18,0,390351,America,686,6
2020-08-25,Belize,BZ,27,4,390351,America,713,10
2020-08-26,Belize,BZ,17,0,390351,America,730,10
2020-08-27,Belize,BZ,30,1,390351,America,760,11
2020-08-28,Belize,BZ,58,1,390351,America,818,12
2020-08-29,Belize,BZ,52,0,390351,America,870,12
2020-08-30,Belize,BZ,94,1,390351,America,964,13
2020-08-31,Belize,BZ,30,0,390351,America,994,13
2020-09-01,Belize,BZ,13,0,390351,America,1007,13
2020-09-02,Belize,BZ,43,0,390351,America,1050,13
2020-09-03,Belize,BZ,51,0,390351,America,1101,13
2020-09-04,Belize,BZ,17,0,390351,America,1118,13
2020-09-05,Belize,BZ,34,2,390351,America,1152,15
2020-09-06,Belize,BZ,42,0,390351,America,1194,15
2020-09-07,Belize,BZ,67,0,390351,America,1261,15
2020-09-08,Belize,BZ,46,1,390351,America,1307,16
2020-09-09,Belize,BZ,54,0,390351,America,1361,16
2020-09-10,Belize,BZ,4,2,390351,America,1365,18
2020-09-11,Belize,BZ,34,1,390351,America,1399,19
2020-09-12,Belize,BZ,36,0,390351,America,1435,19
2020-09-13,Belize,BZ,23,0,390351,America,1458,19
2020-09-14,Belize,BZ,22,0,390351,America,1480,19
2020-09-15,Belize,BZ,21,0,390351,America,1501,19
2020-09-16,Belize,BZ,27,0,390351,America,1528,19
2020-09-17,Belize,BZ,8,0,390351,America,1536,19
2020-09-18,Belize,BZ,31,0,390351,America,1567,19
2020-09-19,Belize,BZ,23,1,390351,America,1590,20
2020-09-20,Belize,BZ,16,0,390351,America,1606,20
2020-09-21,Belize,BZ,21,1,390351,America,1627,21
2020-09-22,Belize,BZ,8,0,390351,America,1635,21
2020-09-23,Belize,BZ,34,0,390351,America,1669,21
2020-09-24,Belize,BZ,37,1,390351,America,1706,22
2020-09-25,Belize,BZ,52,0,390351,America,1758,22
2020-09-26,Belize,BZ,50,1,390351,America,1808,23
2020-09-27,Belize,BZ,17,1,390351,America,1825,24
2020-09-28,Belize,BZ,29,0,390351,America,1854,24
2020-09-29,Belize,BZ,37,0,390351,America,1891,24
2020-09-30,Belize,BZ,52,2,390351,America,1943,26
2020-10-01,Belize,BZ,49,1,390351,America,1992,27
2020-10-02,Belize,BZ,34,0,390351,America,2026,27
2020-10-03,Belize,BZ,54,1,390351,America,2080,28
2020-10-04,Belize,BZ,51,1,390351,America,2131,29
2020-10-05,Belize,BZ,65,1,390351,America,2196,30
2020-10-06,Belize,BZ,8,0,390351,America,2204,30
2020-10-07,Belize,BZ,39,4,390351,America,2243,34
2020-10-08,Belize,BZ,67,0,390351,America,2310,34
2020-10-09,Belize,BZ,63,0,390351,America,2373,34
2020-10-10,Belize,BZ,0,0,390351,America,2373,34
2020-10-11,Belize,BZ,54,1,390351,America,2427,35
2020-10-12,Belize,BZ,0,0,390351,America,2427,35
2020-10-13,Belize,BZ,142,2,390351,America,2569,37
2020-10-14,Belize,BZ,16,2,390351,America,2585,39
2020-10-15,Belize,BZ,34,1,390351,America,2619,40
2020-10-16,Belize,BZ,63,1,390351,America,2682,41
2020-10-17,Belize,BZ,46,2,390351,America,2728,43
2020-10-18,Belize,BZ,47,0,390351,America,2775,43
2020-10-19,Belize,BZ,38,1,390351,America,2813,44
2020-10-20,Belize,BZ,20,1,390351,America,2833,45
2020-10-21,Belize,BZ,53,0,390351,America,2886,45
2020-10-22,Belize,BZ,51,1,390351,America,2937,46
2020-10-23,Belize,BZ,58,0,390351,America,2995,46
2020-10-24,Belize,BZ,55,0,390351,America,3050,46
2020-10-25,Belize,BZ,56,2,390351,America,3106,48
2020-10-26,Belize,BZ,39,2,390351,America,3145,50
2020-10-27,Belize,BZ,55,1,390351,America,3200,51
2020-10-28,Belize,BZ,32,0,390351,America,3232,51
2020-10-29,Belize,BZ,29,1,390351,America,3261,52
2020-10-30,Belize,BZ,121,4,390351,America,3382,56
2020-10-31,Belize,BZ,80,2,390351,America,3462,58
2020-11-01,Belize,BZ,0,0,390351,America,3462,58
2020-11-02,Belize,BZ,0,0,390351,America,3462,58
2020-11-03,Belize,BZ,162,1,390351,America,3624,59
2020-11-04,Belize,BZ,166,2,390351,America,3790,61
2020-11-05,Belize,BZ,115,3,390351,America,3905,64
2020-11-06,Belize,BZ,72,2,390351,America,3977,66
2020-11-07,Belize,BZ,39,1,390351,America,4016,67
2020-11-08,Belize,BZ,60,1,390351,America,4076,68
2020-11-09,Belize,BZ,100,2,390351,America,4176,70
2020-11-10,Belize,BZ,54,1,390351,America,4230,71
2020-11-11,Belize,BZ,184,2,390351,America,4414,73
2020-11-12,Belize,BZ,106,2,390351,America,4520,75
2020-11-13,Belize,BZ,76,0,390351,America,4596,75
2020-11-14,Belize,BZ,119,10,390351,America,4715,85
2020-11-15,Belize,BZ,68,3,390351,America,4783,88
2020-11-16,Belize,BZ,78,2,390351,America,4861,90
2020-11-17,Belize,BZ,22,4,390351,America,4883,94
2020-11-18,Belize,BZ,37,2,390351,America,4920,96
2020-11-19,Belize,BZ,38,4,390351,America,4958,100
2020-11-20,Belize,BZ,60,2,390351,America,5018,102
2020-11-21,Belize,BZ,38,5,390351,America,5056,107
2020-11-22,Belize,BZ,54,5,390351,America,5110,112
2020-11-23,Belize,BZ,73,4,390351,America,5183,116
2020-11-24,Belize,BZ,66,4,390351,America,5249,120
2020-11-25,Belize,BZ,86,5,390351,America,5335,125
2020-11-26,Belize,BZ,88,4,390351,America,5423,129
2020-11-27,Belize,BZ,92,2,390351,America,5515,131
2020-11-28,Belize,BZ,72,10,390351,America,5587,141
2020-11-29,Belize,BZ,60,3,390351,America,5647,144
2020-11-30,Belize,BZ,96,3,390351,America,5743,147
2020-12-01,Belize,BZ,111,1,390351,America,5854,148
2020-12-02,Belize,BZ,0,0,390351,America,5854,148
2020-12-03,Belize,BZ,0,0,390351,America,5854,148
2020-12-04,Belize,BZ,1382,16,390351,America,7236,164
2020-12-05,Belize,BZ,147,6,390351,America,7383,170
2020-12-06,Belize,BZ,218,2,390351,America,7601,172
2020-12-07,Belize,BZ,168,1,390351,America,7769,173
2020-12-08,Belize,BZ,184,3,390351,America,7953,176
2020-12-09,Belize,BZ,60,3,390351,America,8013,179
2020-12-10,Belize,BZ,506,4,390351,America,8519,183
2020-12-11,Belize,BZ,286,0,390351,America,8805,183
2020-12-12,Belize,BZ,160,2,390351,America,8965,185
2020-12-13,Belize,BZ,208,7,390351,America,9173,192
2020-12-14,Belize,BZ,122,3,390351,America,9295,195
2019-12-31,Canada,CA,0,0,37411038,America,0,0
2020-01-01,Canada,CA,0,0,37411038,America,0,0
2020-01-02,Canada,CA,0,0,37411038,America,0,0
2020-01-03,Canada,CA,0,0,37411038,America,0,0
2020-01-04,Canada,CA,0,0,37411038,America,0,0
2020-01-05,Canada,CA,0,0,37411038,America,0,0
2020-01-06,Canada,CA,0,0,37411038,America,0,0
2020-01-07,Canada,CA,0,0,37411038,America,0,0
2020-01-08,Canada,CA,0,0,37411038,America,0,0
2020-01-09,Canada,CA,0,0,37411038,America,0,0
2020-01-10,Canada,CA,0,0,37411038,America,0,0
2020-01-11,Canada,CA,0,0,37411038,America,0,0
2020-01-12,Canada,CA,0,0,37411038,America,0,0
2020-01-13,Canada,CA,0,0,37411038,America,0,0
2020-01-14,Canada,CA,0,0,37411038,America,0,0
2020-01-15,Canada,CA,0,0,37411038,America,0,0
2020-01-16,Canada,CA,0,0,37411038,America,0,0
2020-01-17,Canada,CA,0,0,37411038,America,0,0
2020-01-18,Canada,CA,0,0,37411038,America,0,0
2020-01-19,Canada,CA,0,0,37411038,America,0,0
2020-01-20,Canada,CA,0,0,37411038,America,0,0
2020-01-21,Canada,CA,0,0,37411038,America,0,0
2020-01-22,Canada,CA,0,0,37411038,America,0,0
2020-01-23,Canada,CA,0,0,37411038,America,0,0
2020-01-24,Canada,CA,0,0,37411038,America,0,0
2020-01-25,Canada,CA,0,0,37411038,America,0,0
2020-01-26,Canada,CA,1,0,37411038,America,1,0
2020-01-27,Canada,CA,0,0,37411038,America,1,0
2020-01-28,Canada,CA,1,0,37411038,America,2,0
2020-01-29,Canada,CA,1,0,37411038,America,3,0
2020-01-30,Canada,CA,0,0,37411038,America,3,0
2020-01-31,Canada,CA,0,0,37411038,America,3,0
2020-02-01,Canada,CA,1,0,37411038,America,4,0
2020-02-02,Canada,CA,0,0,37411038,America,4,0
2020-02-03,Canada,CA,0,0,37411038,America,4,0
2020-02-04,Canada,CA,0,0,37411038,America,4,0
2020-02-05,Canada,CA,1,0,37411038,America,5,0
2020-02-06,Canada,CA,0,0,37411038,America,5,0
2020-02-07,Canada,CA,2,0,37411038,America,7,0
2020-02-08,Canada,CA,0,0,37411038,America,7,0
2020-02-09,Canada,CA,0,0,37411038,America,7,0
2020-02-10,Canada,CA,0,0,37411038,America,7,0
2020-02-11,Canada,CA,0,0,37411038,America,7,0
2020-02-12,Canada,CA,0,0,37411038,America,7,0
2020-02-13,Canada,CA,0,0,37411038,America,7,0
2020-02-14,Canada,CA,0,0,37411038,America,7,0
2020-02-15,Canada,CA,1,0,37411038,America,8,0
2020-02-16,Canada,CA,0,0,37411038,America,8,0
2020-02-17,Canada,CA,0,0,37411038,America,8,0
2020-02-18,Canada,CA,0,0,37411038,America,8,0
2020-02-19,Canada,CA,0,0,37411038,America,8,0
2020-02-20,Canada,CA,0,0,37411038,America,8,0
2020-02-21,Canada,CA,1,0,37411038,America,9,0
2020-02-22,Canada,CA,0,0,37411038,America,9,0
2020-02-23,Canada,CA,0,0,37411038,America,9,0
2020-02-24,Canada,CA,0,0,37411038,America,9,0
2020-02-25,Canada,CA,2,0,37411038,America,11,0
2020-02-26,Canada,CA,0,0,37411038,America,11,0
2020-02-27,Canada,CA,1,0,37411038,America,12,0
2020-02-28,Canada,CA,2,0,37411038,America,14,0
2020-02-29,Canada,CA,2,0,37411038,America,16,0
2020-03-01,Canada,CA,4,0,37411038,America,20,0
2020-03-02,Canada,CA,4,0,37411038,America,24,0
2020-03-03,Canada,CA,3,0,37411038,America,27,0
2020-03-04,Canada,CA,3,0,37411038,America,30,0
2020-03-05,Canada,CA,3,0,37411038,America,33,0
2020-03-06,Canada,CA,12,0,37411038,America,45,0
2020-03-07,Canada,CA,6,0,37411038,America,51,0
2020-03-08,Canada,CA,6,0,37411038,America,57,0
2020-03-09,Canada,CA,5,0,37411038,America,62,0
2020-03-10,Canada,CA,15,1,37411038,America,77,1
2020-03-11,Canada,CA,16,0,37411038,America,93,1
2020-03-12,Canada,CA,10,0,37411038,America,103,1
2020-03-13,Canada,CA,35,0,37411038,America,138,1
2020-03-14,Canada,CA,38,0,37411038,America,176,1
2020-03-15,Canada,CA,68,0,37411038,America,244,1
2020-03-16,Canada,CA,60,0,37411038,America,304,1
2020-03-17,Canada,CA,120,3,37411038,America,424,4
2020-03-18,Canada,CA,145,4,37411038,America,569,8
2020-03-19,Canada,CA,121,1,37411038,America,690,9
2020-03-20,Canada,CA,156,1,37411038,America,846,10
2020-03-21,Canada,CA,125,2,37411038,America,971,12
2020-03-22,Canada,CA,331,6,37411038,America,1302,18
2020-03-23,Canada,CA,128,2,37411038,America,1430,20
2020-03-24,Canada,CA,216,4,37411038,America,1646,24
2020-03-25,Canada,CA,313,3,37411038,America,1959,27
2020-03-26,Canada,CA,1426,8,37411038,America,3385,35
2020-03-27,Canada,CA,633,4,37411038,America,4018,39
2020-03-28,Canada,CA,657,14,37411038,America,4675,53
2020-03-29,Canada,CA,711,7,37411038,America,5386,60
2020-03-30,Canada,CA,869,1,37411038,America,6255,61
2020-03-31,Canada,CA,1169,28,37411038,America,7424,89
2020-04-01,Canada,CA,1112,7,37411038,America,8536,96
2020-04-02,Canada,CA,1059,13,37411038,America,9595,109
2020-04-03,Canada,CA,1673,29,37411038,America,11268,138
2020-04-04,Canada,CA,1251,49,37411038,America,12519,187
2020-04-05,Canada,CA,1363,44,37411038,America,13882,231
2020-04-06,Canada,CA,1614,49,37411038,America,15496,280
2020-04-07,Canada,CA,1157,43,37411038,America,16653,323
2020-04-08,Canada,CA,1230,57,37411038,America,17883,380
2020-04-09,Canada,CA,1391,55,37411038,America,19274,435
2020-04-10,Canada,CA,1474,74,37411038,America,20748,509
2020-04-11,Canada,CA,1385,60,37411038,America,22133,569
2020-04-12,Canada,CA,1168,84,37411038,America,23301,653
2020-04-13,Canada,CA,1064,64,37411038,America,24365,717
2020-04-14,Canada,CA,1298,63,37411038,America,25663,780
2020-04-15,Canada,CA,1383,123,37411038,America,27046,903
2020-04-16,Canada,CA,1318,107,37411038,America,28364,1010
2020-04-17,Canada,CA,1717,183,37411038,America,30081,1193
2020-04-18,Canada,CA,1791,116,37411038,America,31872,1309
2020-04-19,Canada,CA,1469,158,37411038,America,33341,1467
2020-04-20,Canada,CA,1436,113,37411038,America,34777,1580
2020-04-21,Canada,CA,2046,110,37411038,America,36823,1690
2020-04-22,Canada,CA,1590,144,37411038,America,38413,1834
2020-04-23,Canada,CA,1766,140,37411038,America,40179,1974
2020-04-24,Canada,CA,1920,172,37411038,America,42099,2146
2020-04-25,Canada,CA,1778,156,37411038,America,43877,2302
2020-04-26,Canada,CA,1464,163,37411038,America,45341,2465
2020-04-27,Canada,CA,1543,95,37411038,America,46884,2560
2020-04-28,Canada,CA,1605,147,37411038,America,48489,2707
2020-04-29,Canada,CA,1526,152,37411038,America,50015,2859
2020-04-30,Canada,CA,1572,137,37411038,America,51587,2996
2020-05-01,Canada,CA,1649,188,37411038,America,53236,3184
2020-05-02,Canada,CA,1825,207,37411038,America,55061,3391
2020-05-03,Canada,CA,1653,175,37411038,America,56714,3566
2020-05-04,Canada,CA,2760,116,37411038,America,59474,3682
2020-05-05,Canada,CA,1298,172,37411038,America,60772,3854
2020-05-06,Canada,CA,1274,189,37411038,America,62046,4043
2020-05-07,Canada,CA,1450,189,37411038,America,63496,4232
2020-05-08,Canada,CA,1426,176,37411038,America,64922,4408
2020-05-09,Canada,CA,1512,161,37411038,America,66434,4569
2020-05-10,Canada,CA,1268,124,37411038,America,67702,4693
2020-05-11,Canada,CA,1146,178,37411038,America,68848,4871
2020-05-12,Canada,CA,1133,122,37411038,America,69981,4993
2020-05-13,Canada,CA,1176,176,37411038,America,71157,5169
2020-05-14,Canada,CA,1121,135,37411038,America,72278,5304
2020-05-15,Canada,CA,1123,168,37411038,America,73401,5472
2020-05-16,Canada,CA,1201,90,37411038,America,74602,5562
2020-05-17,Canada,CA,1251,117,37411038,America,75853,5679
2020-05-18,Canada,CA,1138,103,37411038,America,76991,5782
2020-05-19,Canada,CA,1070,60,37411038,America,78061,5842
2020-05-20,Canada,CA,1040,70,37411038,America,79101,5912
2020-05-21,Canada,CA,990,118,37411038,America,80091,6030
2020-05-22,Canada,CA,1222,122,37411038,America,81313,6152
2020-05-23,Canada,CA,1156,98,37411038,America,82469,6250
2020-05-24,Canada,CA,1141,105,37411038,America,83610,6355
2020-05-25,Canada,CA,1078,69,37411038,America,84688,6424
2020-05-26,Canada,CA,1012,121,37411038,America,85700,6545
2020-05-27,Canada,CA,936,94,37411038,America,86636,6639
2020-05-28,Canada,CA,872,126,37411038,America,87508,6765
2020-05-29,Canada,CA,993,112,37411038,America,88501,6877
2020-05-30,Canada,CA,906,102,37411038,America,89407,6979
2020-05-31,Canada,CA,772,94,37411038,America,90179,7073
2020-06-01,Canada,CA,757,222,37411038,America,90936,7295
2020-06-02,Canada,CA,758,31,37411038,America,91694,7326
2020-06-03,Canada,CA,705,69,37411038,America,92399,7395
2020-06-04,Canada,CA,675,103,37411038,America,93074,7498
2020-06-05,Canada,CA,641,139,37411038,America,93715,7637
2020-06-06,Canada,CA,609,66,37411038,America,94324,7703
2020-06-07,Canada,CA,722,70,37411038,America,95046,7773
2020-06-08,Canada,CA,642,27,37411038,America,95688,7800
2020-06-09,Canada,CA,545,35,37411038,America,96233,7835
2020-06-10,Canada,CA,409,62,37411038,America,96642,7897
2020-06-11,Canada,CA,472,63,37411038,America,97114,7960
2020-06-12,Canada,CA,405,34,37411038,America,97519,7994
2020-06-13,Canada,CA,413,55,37411038,America,97932,8049
2020-06-14,Canada,CA,467,58,37411038,America,98399,8107
2020-06-15,Canada,CA,377,39,37411038,America,98776,8146
2020-06-16,Canada,CA,360,29,37411038,America,99136,8175
2020-06-17,Canada,CA,320,38,37411038,America,99456,8213
2020-06-18,Canada,CA,386,41,37411038,America,99842,8254
2020-06-19,Canada,CA,367,46,37411038,America,100209,8300
2020-06-20,Canada,CA,409,46,37411038,America,100618,8346
2020-06-21,Canada,CA,390,64,37411038,America,101008,8410
2020-06-22,Canada,CA,318,20,37411038,America,101326,8430
2020-06-23,Canada,CA,311,6,37411038,America,101637,8436
2020-06-24,Canada,CA,326,18,37411038,America,101963,8454
2020-06-25,Canada,CA,279,30,37411038,America,102242,8484
2020-06-26,Canada,CA,369,20,37411038,America,102611,8504
2020-06-27,Canada,CA,172,4,37411038,America,102783,8508
2020-06-28,Canada,CA,238,8,37411038,America,103021,8516
2020-06-29,Canada,CA,218,6,37411038,America,103239,8522
2020-06-30,Canada,CA,668,44,37411038,America,103907,8566
2020-07-01,Canada,CA,286,25,37411038,America,104193,8591
2020-07-02,Canada,CA,0,0,37411038,America,104193,8591
2020-07-03,Canada,CA,567,51,37411038,America,104760,8642
2020-07-04,Canada,CA,319,21,37411038,America,105079,8663
2020-07-05,Canada,CA,226,11,37411038,America,105305,8674
2020-07-06,Canada,CA,219,10,37411038,America,105524,8684
2020-07-07,Canada,CA,399,9,37411038,America,105923,8693
2020-07-08,Canada,CA,232,18,37411038,America,106155,8711
2020-07-09,Canada,CA,267,26,37411038,America,106422,8737
2020-07-10,Canada,CA,371,12,37411038,America,106793,8749
2020-07-11,Canada,CA,321,10,37411038,America,107114,8759
2020-07-12,Canada,CA,221,14,37411038,America,107335,8773
2020-07-13,Canada,CA,244,10,37411038,America,107579,8783
2020-07-14,Canada,CA,565,7,37411038,America,108144,8790
2020-07-15,Canada,CA,331,8,37411038,America,108475,8798
2020-07-16,Canada,CA,341,12,37411038,America,108816,8810
2020-07-17,Canada,CA,437,17,37411038,America,109253,8827
2020-07-18,Canada,CA,405,12,37411038,America,109658,8839
2020-07-19,Canada,CA,0,0,37411038,America,109658,8839
2020-07-20,Canada,CA,680,13,37411038,America,110338,8852
2020-07-21,Canada,CA,775,6,37411038,America,111113,8858
2020-07-22,Canada,CA,571,4,37411038,America,111684,8862
2020-07-23,Canada,CA,543,8,37411038,America,112227,8870
2020-07-24,Canada,CA,432,4,37411038,America,112659,8874
2020-07-25,Canada,CA,534,7,37411038,America,113193,8881
2020-07-26,Canada,CA,350,4,37411038,America,113543,8885
2020-07-27,Canada,CA,355,5,37411038,America,113898,8890
2020-07-28,Canada,CA,699,11,37411038,America,114597,8901
2020-07-29,Canada,CA,383,11,37411038,America,114980,8912
2020-07-30,Canada,CA,476,5,37411038,America,115456,8917
2020-07-31,Canada,CA,329,12,37411038,America,115785,8929
2020-08-01,Canada,CA,513,6,37411038,America,116298,8935
2020-08-02,Canada,CA,287,6,37411038,America,116585,8941
2020-08-03,Canada,CA,285,4,37411038,America,116870,8945
2020-08-04,Canada,CA,147,2,37411038,America,117017,8947
2020-08-05,Canada,CA,760,11,37411038,America,117777,8958
2020-08-06,Canada,CA,395,4,37411038,America,118172,8962
2020-08-07,Canada,CA,374,4,37411038,America,118546,8966
2020-08-08,Canada,CA,424,4,37411038,America,118970,8970
2020-08-09,Canada,CA,236,6,37411038,America,119206,8976
2020-08-10,Canada,CA,245,5,37411038,America,119451,8981
2020-08-11,Canada,CA,666,6,37411038,America,120117,8987
2020-08-12,Canada,CA,289,4,37411038,America,120406,8991
2020-08-13,Canada,CA,423,15,37411038,America,120829,9006
2020-08-14,Canada,CA,405,9,37411038,America,121234,9015
2020-08-15,Canada,CA,418,5,37411038,America,121652,9020
2020-08-16,Canada,CA,237,4,37411038,America,121889,9024
2020-08-17,Canada,CA,198,2,37411038,America,122087,9026
2020-08-18,Canada,CA,785,6,37411038,America,122872,9032
2020-08-19,Canada,CA,282,13,37411038,America,123154,9045
2020-08-20,Canada,CA,336,4,37411038,America,123490,9049
2020-08-21,Canada,CA,383,5,37411038,America,123873,9054
2020-08-22,Canada,CA,499,10,37411038,America,124372,9064
2020-08-23,Canada,CA,257,7,37411038,America,124629,9071
2020-08-24,Canada,CA,267,2,37411038,America,124896,9073
2020-08-25,Canada,CA,751,10,37411038,America,125647,9083
2020-08-26,Canada,CA,322,7,37411038,America,125969,9090
2020-08-27,Canada,CA,448,4,37411038,America,126417,9094
2020-08-28,Canada,CA,431,8,37411038,America,126848,9102
2020-08-29,Canada,CA,510,6,37411038,America,127358,9108
2020-08-30,Canada,CA,315,5,37411038,America,127673,9113
2020-08-31,Canada,CA,267,4,37411038,America,127940,9117
2020-09-01,Canada,CA,1008,9,37411038,America,128948,9126
2020-09-02,Canada,CA,477,6,37411038,America,129425,9132
2020-09-03,Canada,CA,498,3,37411038,America,129923,9135
2020-09-04,Canada,CA,570,6,37411038,America,130493,9141
2020-09-05,Canada,CA,631,0,37411038,America,131124,9141
2020-09-06,Canada,CA,371,2,37411038,America,131495,9143
2020-09-07,Canada,CA,400,2,37411038,America,131895,9145
2020-09-08,Canada,CA,247,1,37411038,America,132142,9146
2020-09-09,Canada,CA,1606,7,37411038,America,133748,9153
2020-09-10,Canada,CA,546,2,37411038,America,134294,9155
2020-09-11,Canada,CA,630,8,37411038,America,134924,9163
2020-09-12,Canada,CA,702,0,37411038,America,135626,9163
2020-09-13,Canada,CA,515,7,37411038,America,136141,9170
2020-09-14,Canada,CA,518,1,37411038,America,136659,9171
2020-09-15,Canada,CA,1351,8,37411038,America,138010,9179
2020-09-16,Canada,CA,793,9,37411038,America,138803,9188
2020-09-17,Canada,CA,944,5,37411038,America,139747,9193
2020-09-18,Canada,CA,1120,7,37411038,America,140867,9200
2020-09-19,Canada,CA,1044,5,37411038,America,141911,9205
2020-09-20,Canada,CA,863,6,37411038,America,142774,9211
2020-09-21,Canada,CA,875,6,37411038,America,143649,9217
2020-09-22,Canada,CA,1766,11,37411038,America,145415,9228
2020-09-23,Canada,CA,1248,6,37411038,America,146663,9234
2020-09-24,Canada,CA,1090,9,37411038,America,147753,9243
2020-09-25,Canada,CA,1341,6,37411038,America,149094,9249
2020-09-26,Canada,CA,1362,6,37411038,America,150456,9255
2020-09-27,Canada,CA,1215,7,37411038,America,151671,9262
2020-09-28,Canada,CA,1454,6,37411038,America,153125,9268
2020-09-29,Canada,CA,2176,10,37411038,America,155301,9278
2020-09-30,Canada,CA,1660,13,37411038,America,156961,9291
2020-10-01,Canada,CA,1797,6,37411038,America,158758,9297
2020-10-02,Canada,CA,1777,22,37411038,America,160535,9319
2020-10-03,Canada,CA,2124,90,37411038,America,162659,9409
2020-10-04,Canada,CA,1812,53,37411038,America,164471,9462
2020-10-05,Canada,CA,1685,19,37411038,America,166156,9481
2020-10-06,Canada,CA,2804,23,37411038,America,168960,9504
2020-10-07,Canada,CA,2363,26,37411038,America,171323,9530
2020-10-08,Canada,CA,1800,11,37411038,America,173123,9541
2020-10-09,Canada,CA,2436,16,37411038,America,175559,9557
2020-10-10,Canada,CA,2558,28,37411038,America,178117,9585
2020-10-11,Canada,CA,0,0,37411038,America,178117,9585
2020-10-12,Canada,CA,0,0,37411038,America,178117,9585
2020-10-13,Canada,CA,4722,42,37411038,America,182839,9627
2020-10-14,Canada,CA,4042,27,37411038,America,186881,9654
2020-10-15,Canada,CA,2506,10,37411038,America,189387,9664
2020-10-16,Canada,CA,2345,35,37411038,America,191732,9699
2020-10-17,Canada,CA,2374,23,37411038,America,194106,9722
2020-10-18,Canada,CA,2215,24,37411038,America,196321,9746
2020-10-19,Canada,CA,1827,14,37411038,America,198148,9760
2020-10-20,Canada,CA,3289,18,37411038,America,201437,9778
2020-10-21,Canada,CA,2251,16,37411038,America,203688,9794
2020-10-22,Canada,CA,2672,35,37411038,America,206360,9829
2020-10-23,Canada,CA,2788,33,37411038,America,209148,9862
2020-10-24,Canada,CA,2584,26,37411038,America,211732,9888
2020-10-25,Canada,CA,2227,34,37411038,America,213959,9922
2020-10-26,Canada,CA,2145,24,37411038,America,216104,9946
2020-10-27,Canada,CA,4109,27,37411038,America,220213,9973
2020-10-28,Canada,CA,2674,28,37411038,America,222887,10001
2020-10-29,Canada,CA,2699,31,37411038,America,225586,10032
2020-10-30,Canada,CA,2956,42,37411038,America,228542,10074
2020-10-31,Canada,CA,3457,36,37411038,America,231999,10110
2020-11-01,Canada,CA,2512,26,37411038,America,234511,10136
2020-11-02,Canada,CA,2330,43,37411038,America,236841,10179
2020-11-03,Canada,CA,3422,29,37411038,America,240263,10208
2020-11-04,Canada,CA,4672,71,37411038,America,244935,10279
2020-11-05,Canada,CA,2768,52,37411038,America,247703,10331
2020-11-06,Canada,CA,3635,50,37411038,America,251338,10381
2020-11-07,Canada,CA,4471,55,37411038,America,255809,10436
2020-11-08,Canada,CA,4246,54,37411038,America,260055,10490
2020-11-09,Canada,CA,4058,32,37411038,America,264113,10522
2020-11-10,Canada,CA,4622,42,37411038,America,268735,10564
2020-11-11,Canada,CA,4302,68,37411038,America,273037,10632
2020-11-12,Canada,CA,4024,53,37411038,America,277061,10685
2020-11-13,Canada,CA,5516,83,37411038,America,282577,10768
2020-11-14,Canada,CA,4741,60,37411038,America,287318,10828
2020-11-15,Canada,CA,4613,63,37411038,America,291931,10891
2020-11-16,Canada,CA,4146,62,37411038,America,296077,10953
2020-11-17,Canada,CA,6115,74,37411038,America,302192,11027
2020-11-18,Canada,CA,4276,59,37411038,America,306468,11086
2020-11-19,Canada,CA,4641,100,37411038,America,311109,11186
2020-11-20,Canada,CA,4642,79,37411038,America,315751,11265
2020-11-21,Canada,CA,4968,69,37411038,America,320719,11334
2020-11-22,Canada,CA,4992,72,37411038,America,325711,11406
2020-11-23,Canada,CA,4792,49,37411038,America,330503,11455
2020-11-24,Canada,CA,7052,66,37411038,America,337555,11521
2020-11-25,Canada,CA,4889,97,37411038,America,342444,11618
2020-11-26,Canada,CA,5022,92,37411038,America,347466,11710
2020-11-27,Canada,CA,5631,89,37411038,America,353097,11799
2020-11-28,Canada,CA,5967,95,37411038,America,359064,11894
2020-11-29,Canada,CA,5746,82,37411038,America,364810,11976
2020-11-30,Canada,CA,5468,56,37411038,America,370278,12032
2020-12-01,Canada,CA,7861,98,37411038,America,378139,12130
2020-12-02,Canada,CA,5329,81,37411038,America,383468,12211
2020-12-03,Canada,CA,6307,114,37411038,America,389775,12325
2020-12-04,Canada,CA,6495,82,37411038,America,396270,12407
2020-12-05,Canada,CA,6299,89,37411038,America,402569,12496
2020-12-06,Canada,CA,6352,93,37411038,America,408921,12589
2020-12-07,Canada,CA,6261,76,37411038,America,415182,12665
2020-12-08,Canada,CA,7872,112,37411038,America,423054,12777
2020-12-09,Canada,CA,5981,90,37411038,America,429035,12867
2020-12-10,Canada,CA,6295,116,37411038,America,435330,12983
2020-12-11,Canada,CA,6739,126,37411038,America,442069,13109
2020-12-12,Canada,CA,6772,142,37411038,America,448841,13251
2020-12-13,Canada,CA,6011,99,37411038,America,454852,13350
2020-12-14,Canada,CA,5891,81,37411038,America,460743,13431
2020-03-11,Democratic_Republic_of_the_Congo,CD,1,0,86790568,Africa,1,0
2020-03-14,Democratic_Republic_of_the_Congo,CD,1,0,86790568,Africa,2,0
2020-03-15,Democratic_Republic_of_the_Congo,CD,0,0,86790568,Africa,2,0
2020-03-16,Democratic_Republic_of_the_Congo,CD,0,0,86790568,Africa,2,0
2020-03-17,Democratic_Republic_of_the_Congo,CD,1,0,86790568,Africa,3,0
2020-03-18,Democratic_Republic_of_the_Congo,CD,0,0,86790568,Africa,3,0
2020-03-19,Democratic_Republic_of_the_Congo,CD,11,0,86790568,Africa,14,0
2020-03-20,Democratic_Republic_of_the_Congo,CD,0,0,86790568,Africa,14,0
2020-03-21,Democratic_Republic_of_the_Congo,CD,0,0,86790568,Africa,14,0
2020-03-22,Democratic_Republic_of_the_Congo,CD,9,1,86790568,Africa,23,1
2020-03-23,Democratic_Republic_of_the_Congo,CD,3,1,86790568,Africa,26,2
2020-03-24,Democratic_Republic_of_the_Congo,CD,0,0,86790568,Africa,26,2
2020-03-25,Democratic_Republic_of_the_Congo,CD,19,1,86790568,Africa,45,3
2020-03-26,Democratic_Republic_of_the_Congo,CD,0,0,86790568,Africa,45,3
2020-03-27,Democratic_Republic_of_the_Congo,CD,9,1,86790568,Africa,54,4
2020-03-28,Democratic_Republic_of_the_Congo,CD,4,0,86790568,Africa,58,4
2020-03-29,Democratic_Republic_of_the_Congo,CD,0,2,86790568,Africa,58,6
2020-03-30,Democratic_Republic_of_the_Congo,CD,23,2,86790568,Africa,81,8
2020-03-31,Democratic_Republic_of_the_Congo,CD,17,0,86790568,Africa,98,8
2020-04-01,Democratic_Republic_of_the_Congo,CD,0,0,86790568,Africa,98,8
2020-04-02,Democratic_Republic_of_the_Congo,CD,25,3,86790568,Africa,123,11
2020-04-03,Democratic_Republic_of_the_Congo,CD,0,0,86790568,Africa,123,11
2020-04-04,Democratic_Republic_of_the_Congo,CD,11,2,86790568,Africa,134,13
2020-04-05,Democratic_Republic_of_the_Congo,CD,20,5,86790568,Africa,154,18
2020-04-06,Democratic_Republic_of_the_Congo,CD,0,0,86790568,Africa,154,18
2020-04-07,Democratic_Republic_of_the_Congo,CD,7,0,86790568,Africa,161,18
2020-04-08,Democratic_Republic_of_the_Congo,CD,19,0,86790568,Africa,180,18
2020-04-09,Democratic_Republic_of_the_Congo,CD,3,2,86790568,Africa,183,20
2020-04-10,Democratic_Republic_of_the_Congo,CD,32,0,86790568,Africa,215,20
2020-04-11,Democratic_Republic_of_the_Congo,CD,8,0,86790568,Africa,223,20
2020-04-12,Democratic_Republic_of_the_Congo,CD,11,0,86790568,Africa,234,20
2020-04-13,Democratic_Republic_of_the_Congo,CD,0,0,86790568,Africa,234,20
2020-04-14,Democratic_Republic_of_the_Congo,CD,1,0,86790568,Africa,235,20
2020-04-15,Democratic_Republic_of_the_Congo,CD,19,1,86790568,Africa,254,21
2020-04-16,Democratic_Republic_of_the_Congo,CD,13,1,86790568,Africa,267,22
2020-04-17,Democratic_Republic_of_the_Congo,CD,20,1,86790568,Africa,287,23
2020-04-18,Democratic_Republic_of_the_Congo,CD,20,2,86790568,Africa,307,25
2020-04-19,Democratic_Republic_of_the_Congo,CD,20,0,86790568,Africa,327,25
2020-04-20,Democratic_Republic_of_the_Congo,CD,5,0,86790568,Africa,332,25
2020-04-21,Democratic_Republic_of_the_Congo,CD,18,0,86790568,Africa,350,25
2020-04-22,Democratic_Republic_of_the_Congo,CD,9,0,86790568,Africa,359,25
2020-04-23,Democratic_Republic_of_the_Congo,CD,18,0,86790568,Africa,377,25
2020-04-24,Democratic_Republic_of_the_Congo,CD,17,0,86790568,Africa,394,25
2020-04-25,Democratic_Republic_of_the_Congo,CD,22,3,86790568,Africa,416,28
2020-04-26,Democratic_Republic_of_the_Congo,CD,26,0,86790568,Africa,442,28
2020-04-27,Democratic_Republic_of_the_Congo,CD,17,0,86790568,Africa,459,28
2020-04-28,Democratic_Republic_of_the_Congo,CD,12,2,86790568,Africa,471,30
2020-04-29,Democratic_Republic_of_the_Congo,CD,20,0,86790568,Africa,491,30
2020-04-30,Democratic_Republic_of_the_Congo,CD,9,1,86790568,Africa,500,31
2020-05-01,Democratic_Republic_of_the_Congo,CD,72,0,86790568,Africa,572,31
2020-05-02,Democratic_Republic_of_the_Congo,CD,32,1,86790568,Africa,604,32
2020-05-03,Democratic_Republic_of_the_Congo,CD,70,1,86790568,Africa,674,33
2020-05-04,Democratic_Republic_of_the_Congo,CD,10,1,86790568,Africa,684,34
2020-05-05,Democratic_Republic_of_the_Congo,CD,0,0,86790568,Africa,684,34
2020-05-06,Democratic_Republic_of_the_Congo,CD,21,0,86790568,Africa,705,34
2020-05-07,Democratic_Republic_of_the_Congo,CD,158,2,86790568,Africa,863,36
2020-05-08,Democratic_Republic_of_the_Congo,CD,34,0,86790568,Africa,897,36
2020-05-09,Democratic_Republic_of_the_Congo,CD,40,3,86790568,Africa,937,39
2020-05-10,Democratic_Republic_of_the_Congo,CD,54,2,86790568,Africa,991,41
2020-05-11,Democratic_Republic_of_the_Congo,CD,33,0,86790568,Africa,1024,41
2020-05-12,Democratic_Republic_of_the_Congo,CD,78,3,86790568,Africa,1102,44
2020-05-13,Democratic_Republic_of_the_Congo,CD,67,6,86790568,Africa,1169,50
2020-05-14,Democratic_Republic_of_the_Congo,CD,73,0,86790568,Africa,1242,50
2020-05-15,Democratic_Republic_of_the_Congo,CD,56,0,86790568,Africa,1298,50
2020-05-16,Democratic_Republic_of_the_Congo,CD,71,10,86790568,Africa,1369,60
2020-05-17,Democratic_Republic_of_the_Congo,CD,85,0,86790568,Africa,1454,60
2020-05-18,Democratic_Republic_of_the_Congo,CD,0,0,86790568,Africa,1454,60
2020-05-19,Democratic_Republic_of_the_Congo,CD,175,1,86790568,Africa,1629,61
2020-05-20,Democratic_Republic_of_the_Congo,CD,102,0,86790568,Africa,1731,61
2020-05-21,Democratic_Republic_of_the_Congo,CD,104,0,86790568,Africa,1835,61
2020-05-22,Democratic_Republic_of_the_Congo,CD,110,2,86790568,Africa,1945,63
2020-05-23,Democratic_Republic_of_the_Congo,CD,80,0,86790568,Africa,2025,63
2020-05-24,Democratic_Republic_of_the_Congo,CD,116,0,86790568,Africa,2141,63
2020-05-25,Democratic_Republic_of_the_Congo,CD,156,4,86790568,Africa,2297,67
2020-05-26,Democratic_Republic_of_the_Congo,CD,0,0,86790568,Africa,2297,67
2020-05-27,Democratic_Republic_of_the_Congo,CD,248,0,86790568,Africa,2545,67
2020-05-28,Democratic_Republic_of_the_Congo,CD,114,1,86790568,Africa,2659,68
2020-05-29,Democratic_Republic_of_the_Congo,CD,173,1,86790568,Africa,2832,69
2020-05-30,Democratic_Republic_of_the_Congo,CD,1,0,86790568,Africa,2833,69
2020-05-31,Democratic_Republic_of_the_Congo,CD,133,0,86790568,Africa,2966,69
2020-06-01,Democratic_Republic_of_the_Congo,CD,83,2,86790568,Africa,3049,71
2020-06-02,Democratic_Republic_of_the_Congo,CD,145,1,86790568,Africa,3194,72
2020-06-03,Democratic_Republic_of_the_Congo,CD,131,0,86790568,Africa,3325,72
2020-06-04,Democratic_Republic_of_the_Congo,CD,169,3,86790568,Africa,3494,75
2020-06-05,Democratic_Republic_of_the_Congo,CD,149,3,86790568,Africa,3643,78
2020-06-06,Democratic_Republic_of_the_Congo,CD,121,3,86790568,Africa,3764,81
2020-06-07,Democratic_Republic_of_the_Congo,CD,114,0,86790568,Africa,3878,81
2020-06-08,Democratic_Republic_of_the_Congo,CD,138,4,86790568,Africa,4016,85
2020-06-09,Democratic_Republic_of_the_Congo,CD,89,2,86790568,Africa,4105,87
2020-06-10,Democratic_Republic_of_the_Congo,CD,153,2,86790568,Africa,4258,89
2020-06-11,Democratic_Republic_of_the_Congo,CD,131,6,86790568,Africa,4389,95
2020-06-12,Democratic_Republic_of_the_Congo,CD,125,2,86790568,Africa,4514,97
2020-06-13,Democratic_Republic_of_the_Congo,CD,122,3,86790568,Africa,4636,100
2020-06-14,Democratic_Republic_of_the_Congo,CD,87,5,86790568,Africa,4723,105
2020-06-15,Democratic_Republic_of_the_Congo,CD,54,1,86790568,Africa,4777,106
2020-06-16,Democratic_Republic_of_the_Congo,CD,60,6,86790568,Africa,4837,112
2020-06-17,Democratic_Republic_of_the_Congo,CD,137,0,86790568,Africa,4974,112
2020-06-18,Democratic_Republic_of_the_Congo,CD,125,3,86790568,Africa,5099,115
2020-06-19,Democratic_Republic_of_the_Congo,CD,183,2,86790568,Africa,5282,117
2020-06-20,Democratic_Republic_of_the_Congo,CD,194,4,86790568,Africa,5476,121
2020-06-21,Democratic_Republic_of_the_Congo,CD,195,3,86790568,Africa,5671,124
2020-06-22,Democratic_Republic_of_the_Congo,CD,155,6,86790568,Africa,5826,130
2020-06-23,Democratic_Republic_of_the_Congo,CD,99,5,86790568,Africa,5925,135
2020-06-24,Democratic_Republic_of_the_Congo,CD,102,0,86790568,Africa,6027,135
2020-06-25,Democratic_Republic_of_the_Congo,CD,0,0,86790568,Africa,6027,135
2020-06-26,Democratic_Republic_of_the_Congo,CD,384,7,86790568,Africa,6411,142
2020-06-27,Democratic_Republic_of_the_Congo,CD,141,7,86790568,Africa,6552,149
2020-06-28,Democratic_Republic_of_the_Congo,CD,0,0,86790568,Africa,6552,149
2020-06-29,Democratic_Republic_of_the_Congo,CD,274,8,86790568,Africa,6826,157
2020-06-30,Democratic_Republic_of_the_Congo,CD,113,10,86790568,Africa,6939,167
2020-07-01,Democratic_Republic_of_the_Congo,CD,99,2,86790568,Africa,7038,169
2020-07-02,Democratic_Republic_of_the_Congo,CD,83,5,86790568,Africa,7121,174
2020-07-03,Democratic_Republic_of_the_Congo,CD,67,1,86790568,Africa,7188,175
2020-07-04,Democratic_Republic_of_the_Congo,CD,0,0,86790568,Africa,7188,175
2020-07-05,Democratic_Republic_of_the_Congo,CD,190,6,86790568,Africa,7378,181
2020-07-06,Democratic_Republic_of_the_Congo,CD,32,0,86790568,Africa,7410,181
2020-07-07,Democratic_Republic_of_the_Congo,CD,22,1,86790568,Africa,7432,182
2020-07-08,Democratic_Republic_of_the_Congo,CD,228,0,86790568,Africa,7660,182
2020-07-09,Democratic_Republic_of_the_Congo,CD,77,2,86790568,Africa,7737,184
2020-07-10,Democratic_Republic_of_the_Congo,CD,108,4,86790568,Africa,7845,188
2020-07-11,Democratic_Republic_of_the_Congo,CD,59,0,86790568,Africa,7904,188
2020-07-12,Democratic_Republic_of_the_Congo,CD,66,0,86790568,Africa,7970,188
2020-07-13,Democratic_Republic_of_the_Congo,CD,62,0,86790568,Africa,8032,188
2020-07-14,Democratic_Republic_of_the_Congo,CD,42,1,86790568,Africa,8074,189
2020-07-15,Democratic_Republic_of_the_Congo,CD,61,0,86790568,Africa,8135,189
2020-07-16,Democratic_Republic_of_the_Congo,CD,27,2,86790568,Africa,8162,191
2020-07-17,Democratic_Republic_of_the_Congo,CD,36,1,86790568,Africa,8198,192
2020-07-18,Democratic_Republic_of_the_Congo,CD,50,0,86790568,Africa,8248,192
2020-07-19,Democratic_Republic_of_the_Congo,CD,75,0,86790568,Africa,8323,192
2020-07-20,Democratic_Republic_of_the_Congo,CD,79,1,86790568,Africa,8402,193
2020-07-21,Democratic_Republic_of_the_Congo,CD,40,1,86790568,Africa,8442,194
2020-07-22,Democratic_Republic_of_the_Congo,CD,91,1,86790568,Africa,8533,195
2020-07-23,Democratic_Republic_of_the_Congo,CD,92,2,86790568,Africa,8625,197
2020-07-24,Democratic_Republic_of_the_Congo,CD,94,3,86790568,Africa,8719,200
2020-07-25,Democratic_Republic_of_the_Congo,CD,47,0,86790568,Africa,8766,200
2020-07-26,Democratic_Republic_of_the_Congo,CD,34,3,86790568,Africa,8800,203
2020-07-27,Democratic_Republic_of_the_Congo,CD,31,1,86790568,Africa,8831,204
2020-07-28,Democratic_Republic_of_the_Congo,CD,13,4,86790568,Africa,8844,208
2020-07-29,Democratic_Republic_of_the_Congo,CD,29,0,86790568,Africa,8873,208
2020-07-30,Democratic_Republic_of_the_Congo,CD,58,5,86790568,Africa,8931,213
2020-07-31,Democratic_Republic_of_the_Congo,CD,79,1,86790568,Africa,9010,214
2020-08-01,Democratic_Republic_of_the_Congo,CD,60,0,86790568,Africa,9070,214
2020-08-02,Democratic_Republic_of_the_Congo,CD,13,0,86790568,Africa,9083,214
2020-08-03,Democratic_Republic_of_the_Congo,CD,31,0,86790568,Africa,9114,214
2020-08-04,Democratic_Republic_of_the_Congo,CD,18,0,86790568,Africa,9132,214
2020-08-05,Democratic_Republic_of_the_Congo,CD,45,0,86790568,Africa,9177,214
2020-08-06,Democratic_Republic_of_the_Congo,CD,75,0,86790568,Africa,9252,214
2020-08-07,Democratic_Republic_of_the_Congo,CD,56,0,86790568,Africa,9308,214
2020-08-08,Democratic_Republic_of_the_Congo,CD,46,3,86790568,Africa,9354,217
2020-08-09,Democratic_Republic_of_the_Congo,CD,99,6,86790568,Africa,9453,223
2020-08-10,Democratic_Republic_of_the_Congo,CD,0,0,86790568,Africa,9453,223
2020-08-11,Democratic_Republic_of_the_Congo,CD,35,0,86790568,Africa,9488,223
2020-08-12,Democratic_Republic_of_the_Congo,CD,10,1,86790568,Africa,9498,224
2020-08-13,Democratic_Republic_of_the_Congo,CD,39,1,86790568,Africa,9537,225
2020-08-14,Democratic_Republic_of_the_Congo,CD,51,9,86790568,Africa,9588,234
2020-08-15,Democratic_Republic_of_the_Congo,CD,16,4,86790568,Africa,9604,238
2020-08-16,Democratic_Republic_of_the_Congo,CD,33,1,86790568,Africa,9637,239
2020-08-17,Democratic_Republic_of_the_Congo,CD,38,0,86790568,Africa,9675,239
2020-08-18,Democratic_Republic_of_the_Congo,CD,30,3,86790568,Africa,9705,242
2020-08-19,Democratic_Republic_of_the_Congo,CD,15,0,86790568,Africa,9720,242
2020-08-20,Democratic_Republic_of_the_Congo,CD,20,3,86790568,Africa,9740,245
2020-08-21,Democratic_Republic_of_the_Congo,CD,16,1,86790568,Africa,9756,246
2020-08-22,Democratic_Republic_of_the_Congo,CD,45,1,86790568,Africa,9801,247
2020-08-23,Democratic_Republic_of_the_Congo,CD,9,3,86790568,Africa,9810,250
2020-08-24,Democratic_Republic_of_the_Congo,CD,19,0,86790568,Africa,9829,250
2020-08-25,Democratic_Republic_of_the_Congo,CD,12,0,86790568,Africa,9841,250
2020-08-26,Democratic_Republic_of_the_Congo,CD,49,0,86790568,Africa,9890,250
2020-08-27,Democratic_Republic_of_the_Congo,CD,21,3,86790568,Africa,9911,253
2020-08-28,Democratic_Republic_of_the_Congo,CD,3,1,86790568,Africa,9914,254
2020-08-29,Democratic_Republic_of_the_Congo,CD,79,0,86790568,Africa,9993,254
2020-08-30,Democratic_Republic_of_the_Congo,CD,14,3,86790568,Africa,10007,257
2020-08-31,Democratic_Republic_of_the_Congo,CD,37,0,86790568,Africa,10044,257
2020-09-01,Democratic_Republic_of_the_Congo,CD,52,0,86790568,Africa,10096,257
2020-09-02,Democratic_Republic_of_the_Congo,CD,7,1,86790568,Africa,10103,258
2020-09-03,Democratic_Republic_of_the_Congo,CD,10,0,86790568,Africa,10113,258
2020-09-04,Democratic_Republic_of_the_Congo,CD,12,0,86790568,Africa,10125,258
2020-09-05,Democratic_Republic_of_the_Congo,CD,23,0,86790568,Africa,10148,258
2020-09-06,Democratic_Republic_of_the_Congo,CD,30,0,86790568,Africa,10178,258
2020-09-07,Democratic_Republic_of_the_Congo,CD,31,1,86790568,Africa,10209,259
2020-09-08,Democratic_Republic_of_the_Congo,CD,23,0,86790568,Africa,10232,259
2020-09-09,Democratic_Republic_of_the_Congo,CD,59,0,86790568,Africa,10291,259
2020-09-10,Democratic_Republic_of_the_Congo,CD,32,0,86790568,Africa,10323,259
2020-09-11,Democratic_Republic_of_the_Congo,CD,19,2,86790568,Africa,10342,261
2020-09-12,Democratic_Republic_of_the_Congo,CD,18,0,86790568,Africa,10360,261
2020-09-13,Democratic_Republic_of_the_Congo,CD,24,0,86790568,Africa,10384,261
2020-09-14,Democratic_Republic_of_the_Congo,CD,5,3,86790568,Africa,10389,264
2020-09-15,Democratic_Republic_of_the_Congo,CD,0,0,86790568,Africa,10389,264
2020-09-16,Democratic_Republic_of_the_Congo,CD,12,3,86790568,Africa,10401,267
2020-09-17,Democratic_Republic_of_the_Congo,CD,0,0,86790568,Africa,10401,267
2020-09-18,Democratic_Republic_of_the_Congo,CD,41,0,86790568,Africa,10442,267
2020-09-19,Democratic_Republic_of_the_Congo,CD,14,1,86790568,Africa,10456,268
2020-09-20,Democratic_Republic_of_the_Congo,CD,32,0,86790568,Africa,10488,268
2020-09-21,Democratic_Republic_of_the_Congo,CD,26,2,86790568,Africa,10514,270
2020-09-22,Democratic_Republic_of_the_Congo,CD,4,0,86790568,Africa,10518,270
2020-09-23,Democratic_Republic_of_the_Congo,CD,4,0,86790568,Africa,10522,270
2020-09-24,Democratic_Republic_of_the_Congo,CD,14,0,86790568,Africa,10536,270
2020-09-25,Democratic_Republic_of_the_Congo,CD,18,0,86790568,Africa,10554,270
2020-09-26,Democratic_Republic_of_the_Congo,CD,23,0,86790568,Africa,10577,270
2020-09-27,Democratic_Republic_of_the_Congo,CD,15,0,86790568,Africa,10592,270
2020-09-28,Democratic_Republic_of_the_Congo,CD,19,0,86790568,Africa,10611,270
2020-09-29,Democratic_Republic_of_the_Congo,CD,13,1,86790568,Africa,10624,271
2020-09-30,Democratic_Republic_of_the_Congo,CD,6,0,86790568,Africa,10630,271
2020-10-01,Democratic_Republic_of_the_Congo,CD,29,1,86790568,Africa,10659,272
2020-10-02,Democratic_Republic_of_the_Congo,CD,25,0,86790568,Africa,10684,272
2020-10-03,Democratic_Republic_of_the_Congo,CD,0,0,86790568,Africa,10684,272
2020-10-04,Democratic_Republic_of_the_Congo,CD,68,1,86790568,Africa,10752,273
2020-10-05,Democratic_Republic_of_the_Congo,CD,7,0,86790568,Africa,10759,273
2020-10-06,Democratic_Republic_of_the_Congo,CD,19,1,86790568,Africa,10778,274
2020-10-07,Democratic_Republic_of_the_Congo,CD,0,0,86790568,Africa,10778,274
2020-10-08,Democratic_Republic_of_the_Congo,CD,26,1,86790568,Africa,10804,275
2020-10-09,Democratic_Republic_of_the_Congo,CD,17,0,86790568,Africa,10821,275
2020-10-10,Democratic_Republic_of_the_Congo,CD,13,0,86790568,Africa,10834,275
2020-10-11,Democratic_Republic_of_the_Congo,CD,6,0,86790568,Africa,10840,275
2020-10-12,Democratic_Republic_of_the_Congo,CD,10,0,86790568,Africa,10850,275
2020-10-13,Democratic_Republic_of_the_Congo,CD,18,0,86790568,Africa,10868,275
2020-10-14,Democratic_Republic_of_the_Congo,CD,3,0,86790568,Africa,10871,275
2020-10-15,Democratic_Republic_of_the_Congo,CD,63,5,86790568,Africa,10934,280
2020-10-16,Democratic_Republic_of_the_Congo,CD,35,0,86790568,Africa,10969,280
2020-10-17,Democratic_Republic_of_the_Congo,CD,30,21,86790568,Africa,10999,301
2020-10-18,Democratic_Republic_of_the_Congo,CD,6,0,86790568,Africa,11005,301
2020-10-19,Democratic_Republic_of_the_Congo,CD,46,1,86790568,Africa,11051,302
2020-10-20,Democratic_Republic_of_the_Congo,CD,0,0,86790568,Africa,11051,302
2020-10-21,Democratic_Republic_of_the_Congo,CD,14,0,86790568,Africa,11065,302
2020-10-22,Democratic_Republic_of_the_Congo,CD,0,0,86790568,Africa,11065,302
2020-10-23,Democratic_Republic_of_the_Congo,CD,31,1,86790568,Africa,11096,303
2020-10-24,Democratic_Republic_of_the_Congo,CD,25,0,86790568,Africa,11121,303
2020-10-25,Democratic_Republic_of_the_Congo,CD,21,1,86790568,Africa,11142,304
2020-10-26,Democratic_Republic_of_the_Congo,CD,0,0,86790568,Africa,11142,304
2020-10-27,Democratic_Republic_of_the_Congo,CD,31,0,86790568,Africa,11173,304
2020-10-28,Democratic_Republic_of_the_Congo,CD,17,0,86790568,Africa,11190,304
2020-10-29,Democratic_Republic_of_the_Congo,CD,20,0,86790568,Africa,11210,304
2020-10-30,Democratic_Republic_of_the_Congo,CD,43,1,86790568,Africa,11253,305
2020-10-31,Democratic_Republic_of_the_Congo,CD,52,1,86790568,Africa,11305,306
2020-11-01,Democratic_Republic_of_the_Congo,CD,0,0,86790568,Africa,11305,306
2020-11-02,Democratic_Republic_of_the_Congo,CD,66,1,86790568,Africa,11371,307
2020-11-03,Democratic_Republic_of_the_Congo,CD,1,0,86790568,Africa,11372,307
2020-11-04,Democratic_Republic_of_the_Congo,CD,54,7,86790568,Africa,11426,314
2020-11-05,Democratic_Republic_of_the_Congo,CD,23,0,86790568,Africa,11449,314
2020-11-06,Democratic_Republic_of_the_Congo,CD,36,0,86790568,Africa,11485,314
2020-11-07,Democratic_Republic_of_the_Congo,CD,64,1,86790568,Africa,11549,315
2020-11-08,Democratic_Republic_of_the_Congo,CD,41,0,86790568,Africa,11590,315
2020-11-09,Democratic_Republic_of_the_Congo,CD,17,0,86790568,Africa,11607,315
2020-11-10,Democratic_Republic_of_the_Congo,CD,0,0,86790568,Africa,11607,315
2020-11-11,Democratic_Republic_of_the_Congo,CD,34,0,86790568,Africa,11641,315
2020-11-12,Democratic_Republic_of_the_Congo,CD,14,0,86790568,Africa,11655,315
2020-11-13,Democratic_Republic_of_the_Congo,CD,36,2,86790568,Africa,11691,317
2020-11-14,Democratic_Republic_of_the_Congo,CD,0,0,86790568,Africa,11691,317
2020-11-15,Democratic_Republic_of_the_Congo,CD,68,1,86790568,Africa,11759,318
2020-11-16,Democratic_Republic_of_the_Congo,CD,30,1,86790568,Africa,11789,319
2020-11-17,Democratic_Republic_of_the_Congo,CD,49,1,86790568,Africa,11838,320
2020-11-18,Democratic_Republic_of_the_Congo,CD,28,2,86790568,Africa,11866,322
2020-11-19,Democratic_Republic_of_the_Congo,CD,51,0,86790568,Africa,11917,322
2020-11-20,Democratic_Republic_of_the_Congo,CD,90,0,86790568,Africa,12007,322
2020-11-21,Democratic_Republic_of_the_Congo,CD,121,1,86790568,Africa,12128,323
2020-11-22,Democratic_Republic_of_the_Congo,CD,52,4,86790568,Africa,12180,327
2020-11-23,Democratic_Republic_of_the_Congo,CD,59,0,86790568,Africa,12239,327
2020-11-24,Democratic_Republic_of_the_Congo,CD,38,0,86790568,Africa,12277,327
2020-11-25,Democratic_Republic_of_the_Congo,CD,32,3,86790568,Africa,12309,330
2020-11-26,Democratic_Republic_of_the_Congo,CD,55,0,86790568,Africa,12364,330
2020-11-27,Democratic_Republic_of_the_Congo,CD,105,2,86790568,Africa,12469,332
2020-11-28,Democratic_Republic_of_the_Congo,CD,71,0,86790568,Africa,12540,332
2020-11-29,Democratic_Republic_of_the_Congo,CD,67,0,86790568,Africa,12607,332
2020-11-30,Democratic_Republic_of_the_Congo,CD,94,0,86790568,Africa,12701,332
2020-12-01,Democratic_Republic_of_the_Congo,CD,158,3,86790568,Africa,12859,335
2020-12-02,Democratic_Republic_of_the_Congo,CD,128,1,86790568,Africa,12987,336
2020-12-03,Democratic_Republic_of_the_Congo,CD,145,1,86790568,Africa,13132,337
2020-12-04,Democratic_Republic_of_the_Congo,CD,149,0,86790568,Africa,13281,337
2020-12-05,Democratic_Republic_of_the_Congo,CD,33,0,86790568,Africa,13314,337
2020-12-06,Democratic_Republic_of_the_Congo,CD,213,6,86790568,Africa,13527,343
2020-12-07,Democratic_Republic_of_the_Congo,CD,67,0,86790568,Africa,13594,343
2020-12-08,Democratic_Republic_of_the_Congo,CD,155,0,86790568,Africa,13749,343
2020-12-09,Democratic_Republic_of_the_Congo,CD,93,6,86790568,Africa,13842,349
2020-12-10,Democratic_Republic_of_the_Congo,CD,154,0,86790568,Africa,13996,349
2020-12-11,Democratic_Republic_of_the_Congo,CD,173,0,86790568,Africa,14169,349
2020-12-12,Democratic_Republic_of_the_Congo,CD,172,2,86790568,Africa,14341,351
2020-12-13,Democratic_Republic_of_the_Congo,CD,119,0,86790568,Africa,14460,351
2020-12-14,Democratic_Republic_of_the_Congo,CD,52,4,86790568,Africa,14512,355
2020-03-16,Central_African_Republic,CF,1,0,4745179,Africa,1,0
2020-03-17,Central_African_Republic,CF,0,0,4745179,Africa,1,0
2020-03-18,Central_African_Republic,CF,0,0,4745179,Africa,1,0
2020-03-19,Central_African_Republic,CF,0,0,4745179,Africa,1,0
2020-03-20,Central_African_Republic,CF,0,0,4745179,Africa,1,0
2020-03-21,Central_African_Republic,CF,0,0,4745179,Africa,1,0
2020-03-22,Central_African_Republic,CF,2,0,4745179,Africa,3,0
2020-03-23,Central_African_Republic,CF,1,0,4745179,Africa,4,0
2020-03-24,Central_African_Republic,CF,0,0,4745179,Africa,4,0
2020-03-25,Central_African_Republic,CF,0,0,4745179,Africa,4,0
2020-03-26,Central_African_Republic,CF,0,0,4745179,Africa,4,0
2020-03-27,Central_African_Republic,CF,1,0,4745179,Africa,5,0
2020-03-28,Central_African_Republic,CF,0,0,4745179,Africa,5,0
2020-03-29,Central_African_Republic,CF,1,0,4745179,Africa,6,0
2020-03-30,Central_African_Republic,CF,0,0,4745179,Africa,6,0
2020-03-31,Central_African_Republic,CF,0,0,4745179,Africa,6,0
2020-04-01,Central_African_Republic,CF,0,0,4745179,Africa,6,0
2020-04-02,Central_African_Republic,CF,2,0,4745179,Africa,8,0
2020-04-03,Central_African_Republic,CF,0,0,4745179,Africa,8,0
2020-04-04,Central_African_Republic,CF,0,0,4745179,Africa,8,0
2020-04-05,Central_African_Republic,CF,1,0,4745179,Africa,9,0
2020-04-06,Central_African_Republic,CF,0,0,4745179,Africa,9,0
2020-04-07,Central_African_Republic,CF,0,0,4745179,Africa,9,0
2020-04-08,Central_African_Republic,CF,0,0,4745179,Africa,9,0
2020-04-09,Central_African_Republic,CF,1,0,4745179,Africa,10,0
2020-04-10,Central_African_Republic,CF,1,0,4745179,Africa,11,0
2020-04-11,Central_African_Republic,CF,0,0,4745179,Africa,11,0
2020-04-12,Central_African_Republic,CF,0,0,4745179,Africa,11,0
2020-04-13,Central_African_Republic,CF,0,0,4745179,Africa,11,0
2020-04-14,Central_African_Republic,CF,0,0,4745179,Africa,11,0
2020-04-15,Central_African_Republic,CF,0,0,4745179,Africa,11,0
2020-04-16,Central_African_Republic,CF,0,0,4745179,Africa,11,0
2020-04-17,Central_African_Republic,CF,1,0,4745179,Africa,12,0
2020-04-18,Central_African_Republic,CF,0,0,4745179,Africa,12,0
2020-04-19,Central_African_Republic,CF,0,0,4745179,Africa,12,0
2020-04-20,Central_African_Republic,CF,0,0,4745179,Africa,12,0
2020-04-21,Central_African_Republic,CF,0,0,4745179,Africa,12,0
2020-04-22,Central_African_Republic,CF,2,0,4745179,Africa,14,0
2020-04-23,Central_African_Republic,CF,2,0,4745179,Africa,16,0
2020-04-24,Central_African_Republic,CF,1,0,4745179,Africa,17,0
2020-04-25,Central_African_Republic,CF,2,0,4745179,Africa,19,0
2020-04-26,Central_African_Republic,CF,0,0,4745179,Africa,19,0
2020-04-27,Central_African_Republic,CF,0,0,4745179,Africa,19,0
2020-04-28,Central_African_Republic,CF,31,0,4745179,Africa,50,0
2020-04-29,Central_African_Republic,CF,0,0,4745179,Africa,50,0
2020-04-30,Central_African_Republic,CF,0,0,4745179,Africa,50,0
2020-05-01,Central_African_Republic,CF,0,0,4745179,Africa,50,0
2020-05-02,Central_African_Republic,CF,22,0,4745179,Africa,72,0
2020-05-03,Central_African_Republic,CF,0,0,4745179,Africa,72,0
2020-05-04,Central_African_Republic,CF,0,0,4745179,Africa,72,0
2020-05-05,Central_African_Republic,CF,22,0,4745179,Africa,94,0
2020-05-06,Central_African_Republic,CF,0,0,4745179,Africa,94,0
2020-05-07,Central_African_Republic,CF,0,0,4745179,Africa,94,0
2020-05-08,Central_African_Republic,CF,0,0,4745179,Africa,94,0
2020-05-09,Central_African_Republic,CF,49,0,4745179,Africa,143,0
2020-05-10,Central_African_Republic,CF,0,0,4745179,Africa,143,0
2020-05-11,Central_African_Republic,CF,36,0,4745179,Africa,179,0
2020-05-12,Central_African_Republic,CF,0,0,4745179,Africa,179,0
2020-05-13,Central_African_Republic,CF,0,0,4745179,Africa,179,0
2020-05-14,Central_African_Republic,CF,18,0,4745179,Africa,197,0
2020-05-15,Central_African_Republic,CF,24,0,4745179,Africa,221,0
2020-05-16,Central_African_Republic,CF,80,0,4745179,Africa,301,0
2020-05-17,Central_African_Republic,CF,26,0,4745179,Africa,327,0
2020-05-18,Central_African_Republic,CF,0,0,4745179,Africa,327,0
2020-05-19,Central_African_Republic,CF,9,0,4745179,Africa,336,0
2020-05-20,Central_African_Republic,CF,75,0,4745179,Africa,411,0
2020-05-21,Central_African_Republic,CF,0,0,4745179,Africa,411,0
2020-05-22,Central_African_Republic,CF,25,0,4745179,Africa,436,0
2020-05-23,Central_African_Republic,CF,43,0,4745179,Africa,479,0
2020-05-24,Central_African_Republic,CF,73,1,4745179,Africa,552,1
2020-05-25,Central_African_Republic,CF,52,0,4745179,Africa,604,1
2020-05-26,Central_African_Republic,CF,48,0,4745179,Africa,652,1
2020-05-27,Central_African_Republic,CF,19,0,4745179,Africa,671,1
2020-05-28,Central_African_Republic,CF,31,0,4745179,Africa,702,1
2020-05-29,Central_African_Republic,CF,53,0,4745179,Africa,755,1
2020-05-30,Central_African_Republic,CF,119,0,4745179,Africa,874,1
2020-05-31,Central_African_Republic,CF,88,0,4745179,Africa,962,1
2020-06-01,Central_African_Republic,CF,49,1,4745179,Africa,1011,2
2020-06-02,Central_African_Republic,CF,58,2,4745179,Africa,1069,4
2020-06-03,Central_African_Republic,CF,104,0,4745179,Africa,1173,4
2020-06-04,Central_African_Republic,CF,16,0,4745179,Africa,1189,4
2020-06-05,Central_African_Republic,CF,99,0,4745179,Africa,1288,4
2020-06-06,Central_African_Republic,CF,163,0,4745179,Africa,1451,4
2020-06-07,Central_African_Republic,CF,119,1,4745179,Africa,1570,5
2020-06-08,Central_African_Republic,CF,64,0,4745179,Africa,1634,5
2020-06-09,Central_African_Republic,CF,216,0,4745179,Africa,1850,5
2020-06-10,Central_African_Republic,CF,38,0,4745179,Africa,1888,5
2020-06-11,Central_African_Republic,CF,64,1,4745179,Africa,1952,6
2020-06-12,Central_African_Republic,CF,92,1,4745179,Africa,2044,7
2020-06-13,Central_African_Republic,CF,13,0,4745179,Africa,2057,7
2020-06-14,Central_African_Republic,CF,0,0,4745179,Africa,2057,7
2020-06-15,Central_African_Republic,CF,165,0,4745179,Africa,2222,7
2020-06-16,Central_African_Republic,CF,67,3,4745179,Africa,2289,10
2020-06-17,Central_African_Republic,CF,121,4,4745179,Africa,2410,14
2020-06-18,Central_African_Republic,CF,154,4,4745179,Africa,2564,18
2020-06-19,Central_African_Republic,CF,41,1,4745179,Africa,2605,19
2020-06-20,Central_African_Republic,CF,0,0,4745179,Africa,2605,19
2020-06-21,Central_African_Republic,CF,203,4,4745179,Africa,2808,23
2020-06-22,Central_African_Republic,CF,0,0,4745179,Africa,2808,23
2020-06-23,Central_African_Republic,CF,155,7,4745179,Africa,2963,30
2020-06-24,Central_African_Republic,CF,88,7,4745179,Africa,3051,37
2020-06-25,Central_African_Republic,CF,48,1,4745179,Africa,3099,38
2020-06-26,Central_African_Republic,CF,145,2,4745179,Africa,3244,40
2020-06-27,Central_African_Republic,CF,96,0,4745179,Africa,3340,40
2020-06-28,Central_African_Republic,CF,89,5,4745179,Africa,3429,45
2020-06-29,Central_African_Republic,CF,0,0,4745179,Africa,3429,45
2020-06-30,Central_African_Republic,CF,184,2,4745179,Africa,3613,47
2020-07-01,Central_African_Republic,CF,132,0,4745179,Africa,3745,47
2020-07-02,Central_African_Republic,CF,0,0,4745179,Africa,3745,47
2020-07-03,Central_African_Republic,CF,78,1,4745179,Africa,3823,48
2020-07-04,Central_African_Republic,CF,95,0,4745179,Africa,3918,48
2020-07-05,Central_African_Republic,CF,51,0,4745179,Africa,3969,48
2020-07-06,Central_African_Republic,CF,0,0,4745179,Africa,3969,48
2020-07-07,Central_African_Republic,CF,64,4,4745179,Africa,4033,52
2020-07-08,Central_African_Republic,CF,38,0,4745179,Africa,4071,52
2020-07-09,Central_African_Republic,CF,38,0,4745179,Africa,4109,52
2020-07-10,Central_African_Republic,CF,91,0,4745179,Africa,4200,52
2020-07-11,Central_African_Republic,CF,59,1,4745179,Africa,4259,53
2020-07-12,Central_African_Republic,CF,29,0,4745179,Africa,4288,53
2020-07-13,Central_African_Republic,CF,0,0,4745179,Africa,4288,53
2020-07-14,Central_African_Republic,CF,33,0,4745179,Africa,4321,53
2020-07-15,Central_African_Republic,CF,35,0,4745179,Africa,4356,53
2020-07-16,Central_African_Republic,CF,6,0,4745179,Africa,4362,53
2020-07-17,Central_African_Republic,CF,11,0,4745179,Africa,4373,53
2020-07-18,Central_African_Republic,CF,16,0,4745179,Africa,4389,53
2020-07-19,Central_African_Republic,CF,96,2,4745179,Africa,4485,55
2020-07-20,Central_African_Republic,CF,0,0,4745179,Africa,4485,55
2020-07-21,Central_African_Republic,CF,63,0,4745179,Africa,4548,55
2020-07-22,Central_African_Republic,CF,13,0,4745179,Africa,4561,55
2020-07-23,Central_African_Republic,CF,13,2,4745179,Africa,4574,57
2020-07-24,Central_African_Republic,CF,16,1,4745179,Africa,4590,58
2020-07-25,Central_African_Republic,CF,3,1,4745179,Africa,4593,59
2020-07-26,Central_African_Republic,CF,5,0,4745179,Africa,4598,59
2020-07-27,Central_African_Republic,CF,1,0,4745179,Africa,4599,59
2020-07-28,Central_African_Republic,CF,0,0,4745179,Africa,4599,59
2020-07-29,Central_African_Republic,CF,0,0,4745179,Africa,4599,59
2020-07-30,Central_African_Republic,CF,6,0,4745179,Africa,4605,59
2020-07-31,Central_African_Republic,CF,0,0,4745179,Africa,4605,59
2020-08-01,Central_African_Republic,CF,3,0,4745179,Africa,4608,59
2020-08-02,Central_African_Republic,CF,6,0,4745179,Africa,4614,59
2020-08-03,Central_African_Republic,CF,0,0,4745179,Africa,4614,59
2020-08-04,Central_African_Republic,CF,0,0,4745179,Africa,4614,59
2020-08-05,Central_African_Republic,CF,4,0,4745179,Africa,4618,59
2020-08-06,Central_African_Republic,CF,0,0,4745179,Africa,4618,59
2020-08-07,Central_African_Republic,CF,2,0,4745179,Africa,4620,59
2020-08-08,Central_African_Republic,CF,21,0,4745179,Africa,4641,59
2020-08-09,Central_African_Republic,CF,0,1,4745179,Africa,4641,60
2020-08-10,Central_African_Republic,CF,0,0,4745179,Africa,4641,60
2020-08-11,Central_African_Republic,CF,0,0,4745179,Africa,4641,60
2020-08-12,Central_African_Republic,CF,6,1,4745179,Africa,4647,61
2020-08-13,Central_African_Republic,CF,5,0,4745179,Africa,4652,61
2020-08-14,Central_African_Republic,CF,0,0,4745179,Africa,4652,61
2020-08-15,Central_African_Republic,CF,0,0,4745179,Africa,4652,61
2020-08-16,Central_African_Republic,CF,0,0,4745179,Africa,4652,61
2020-08-17,Central_African_Republic,CF,0,0,4745179,Africa,4652,61
2020-08-18,Central_African_Republic,CF,15,0,4745179,Africa,4667,61
2020-08-19,Central_African_Republic,CF,12,0,4745179,Africa,4679,61
2020-08-20,Central_African_Republic,CF,0,0,4745179,Africa,4679,61
2020-08-21,Central_African_Republic,CF,0,0,4745179,Africa,4679,61
2020-08-22,Central_African_Republic,CF,0,0,4745179,Africa,4679,61
2020-08-23,Central_African_Republic,CF,0,0,4745179,Africa,4679,61
2020-08-24,Central_African_Republic,CF,0,0,4745179,Africa,4679,61
2020-08-25,Central_African_Republic,CF,0,0,4745179,Africa,4679,61
2020-08-26,Central_African_Republic,CF,12,0,4745179,Africa,4691,61
2020-08-27,Central_African_Republic,CF,7,0,4745179,Africa,4698,61
2020-08-28,Central_African_Republic,CF,0,0,4745179,Africa,4698,61
2020-08-29,Central_African_Republic,CF,2,0,4745179,Africa,4700,61
2020-08-30,Central_African_Republic,CF,0,0,4745179,Africa,4700,61
2020-08-31,Central_African_Republic,CF,0,0,4745179,Africa,4700,61
2020-09-01,Central_African_Republic,CF,11,1,4745179,Africa,4711,62
2020-09-02,Central_African_Republic,CF,0,0,4745179,Africa,4711,62
2020-09-03,Central_African_Republic,CF,1,0,4745179,Africa,4712,62
2020-09-04,Central_African_Republic,CF,17,0,4745179,Africa,4729,62
2020-09-05,Central_African_Republic,CF,0,0,4745179,Africa,4729,62
2020-09-06,Central_African_Republic,CF,0,0,4745179,Africa,4729,62
2020-09-07,Central_African_Republic,CF,0,0,4745179,Africa,4729,62
2020-09-08,Central_African_Republic,CF,0,0,4745179,Africa,4729,62
2020-09-09,Central_African_Republic,CF,7,0,4745179,Africa,4736,62
2020-09-10,Central_African_Republic,CF,0,0,4745179,Africa,4736,62
2020-09-11,Central_African_Republic,CF,11,0,4745179,Africa,4747,62
2020-09-12,Central_African_Republic,CF,2,0,4745179,Africa,4749,62
2020-09-13,Central_African_Republic,CF,0,0,4745179,Africa,4749,62
2020-09-14,Central_African_Republic,CF,0,0,4745179,Africa,4749,62
2020-09-15,Central_African_Republic,CF,23,0,4745179,Africa,4772,62
2020-09-16,Central_African_Republic,CF,0,0,4745179,Africa,4772,62
2020-09-17,Central_African_Republic,CF,10,0,4745179,Africa,4782,62
2020-09-18,Central_African_Republic,CF,0,0,4745179,Africa,4782,62
2020-09-19,Central_African_Republic,CF,4,0,4745179,Africa,4786,62
2020-09-20,Central_African_Republic,CF,0,0,4745179,Africa,4786,62
2020-09-21,Central_African_Republic,CF,7,0,4745179,Africa,4793,62
2020-09-22,Central_African_Republic,CF,0,0,4745179,Africa,4793,62
2020-09-23,Central_African_Republic,CF,9,0,4745179,Africa,4802,62
2020-09-24,Central_African_Republic,CF,0,0,4745179,Africa,4802,62
2020-09-25,Central_African_Republic,CF,2,0,4745179,Africa,4804,62
2020-09-26,Central_African_Republic,CF,2,0,4745179,Africa,4806,62
2020-09-27,Central_African_Republic,CF,0,0,4745179,Africa,4806,62
2020-09-28,Central_African_Republic,CF,0,0,4745179,Africa,4806,62
2020-09-29,Central_African_Republic,CF,0,0,4745179,Africa,4806,62
2020-09-30,Central_African_Republic,CF,19,0,4745179,Africa,4825,62
2020-10-01,Central_African_Republic,CF,4,0,4745179,Africa,4829,62
2020-10-02,Central_African_Republic,CF,0,0,4745179,Africa,4829,62
2020-10-03,Central_African_Republic,CF,0,0,4745179,Africa,4829,62
2020-10-04,Central_African_Republic,CF,16,0,4745179,Africa,4845,62
2020-10-05,Central_African_Republic,CF,0,0,4745179,Africa,4845,62
2020-10-06,Central_African_Republic,CF,0,0,4745179,Africa,4845,62
2020-10-07,Central_African_Republic,CF,7,0,4745179,Africa,4852,62
2020-10-08,Central_African_Republic,CF,0,0,4745179,Africa,4852,62
2020-10-09,Central_African_Republic,CF,0,0,4745179,Africa,4852,62
2020-10-10,Central_African_Republic,CF,0,0,4745179,Africa,4852,62
2020-10-11,Central_African_Republic,CF,2,0,4745179,Africa,4854,62
2020-10-12,Central_African_Republic,CF,0,0,4745179,Africa,4854,62
2020-10-13,Central_African_Republic,CF,0,0,4745179,Africa,4854,62
2020-10-14,Central_African_Republic,CF,1,0,4745179,Africa,4855,62
2020-10-15,Central_African_Republic,CF,0,0,4745179,Africa,4855,62
2020-10-16,Central_African_Republic,CF,0,0,4745179,Africa,4855,62
2020-10-17,Central_African_Republic,CF,0,0,4745179,Africa,4855,62
2020-10-18,Central_African_Republic,CF,0,0,4745179,Africa,4855,62
2020-10-19,Central_African_Republic,CF,0,0,4745179,Africa,4855,62
2020-10-20,Central_African_Republic,CF,1,0,4745179,Africa,4856,62
2020-10-21,Central_African_Republic,CF,2,0,4745179,Africa,4858,62
2020-10-22,Central_African_Republic,CF,0,0,4745179,Africa,4858,62
2020-10-23,Central_African_Republic,CF,4,0,4745179,Africa,4862,62
2020-10-24,Central_African_Republic,CF,0,0,4745179,Africa,4862,62
2020-10-25,Central_African_Republic,CF,0,0,4745179,Africa,4862,62
2020-10-26,Central_African_Republic,CF,0,0,4745179,Africa,4862,62
2020-10-27,Central_African_Republic,CF,1,0,4745179,Africa,4863,62
2020-10-28,Central_African_Republic,CF,0,0,4745179,Africa,4863,62
2020-10-29,Central_African_Republic,CF,0,0,4745179,Africa,4863,62
2020-10-30,Central_African_Republic,CF,0,0,4745179,Africa,4863,62
2020-10-31,Central_African_Republic,CF,3,0,4745179,Africa,4866,62
2020-11-01,Central_African_Republic,CF,0,0,4745179,Africa,4866,62
2020-11-02,Central_African_Republic,CF,0,0,4745179,Africa,4866,62
2020-11-03,Central_African_Republic,CF,0,0,4745179,Africa,4866,62
2020-11-04,Central_African_Republic,CF,0,0,4745179,Africa,4866,62
2020-11-05,Central_African_Republic,CF,9,0,4745179,Africa,4875,62
2020-11-06,Central_African_Republic,CF,0,0,4745179,Africa,4875,62
2020-11-07,Central_African_Republic,CF,0,0,4745179,Africa,4875,62
2020-11-08,Central_African_Republic,CF,4,0,4745179,Africa,4879,62
2020-11-09,Central_African_Republic,CF,0,0,4745179,Africa,4879,62
2020-11-10,Central_African_Republic,CF,1,0,4745179,Africa,4880,62
2020-11-11,Central_African_Republic,CF,4,0,4745179,Africa,4884,62
2020-11-12,Central_African_Republic,CF,0,0,4745179,Africa,4884,62
2020-11-13,Central_African_Republic,CF,4,0,4745179,Africa,4888,62
2020-11-14,Central_African_Republic,CF,0,0,4745179,Africa,4888,62
2020-11-15,Central_African_Republic,CF,8,1,4745179,Africa,4896,63
2020-11-16,Central_African_Republic,CF,4,0,4745179,Africa,4900,63
2020-11-17,Central_African_Republic,CF,0,0,4745179,Africa,4900,63
2020-11-18,Central_African_Republic,CF,0,0,4745179,Africa,4900,63
2020-11-19,Central_African_Republic,CF,0,0,4745179,Africa,4900,63
2020-11-20,Central_African_Republic,CF,7,0,4745179,Africa,4907,63
2020-11-21,Central_African_Republic,CF,4,0,4745179,Africa,4911,63
2020-11-22,Central_African_Republic,CF,0,0,4745179,Africa,4911,63
2020-11-23,Central_African_Republic,CF,0,0,4745179,Africa,4911,63
2020-11-24,Central_African_Republic,CF,0,0,4745179,Africa,4911,63
2020-11-25,Central_African_Republic,CF,0,0,4745179,Africa,4911,63
2020-11-26,Central_African_Republic,CF,0,0,4745179,Africa,4911,63
2020-11-27,Central_African_Republic,CF,2,0,4745179,Africa,4913,63
2020-11-28,Central_African_Republic,CF,0,0,4745179,Africa,4913,63
2020-11-29,Central_African_Republic,CF,0,0,4745179,Africa,4913,63
2020-11-30,Central_African_Republic,CF,0,0,4745179,Africa,4913,63
2020-12-01,Central_African_Republic,CF,0,0,4745179,Africa,4913,63
2020-12-02,Central_African_Republic,CF,5,0,4745179,Africa,4918,63
2020-12-03,Central_African_Republic,CF,0,0,4745179,Africa,4918,63
2020-12-04,Central_African_Republic,CF,0,0,4745179,Africa,4918,63
2020-12-05,Central_African_Republic,CF,0,0,4745179,Africa,4918,63
2020-12-06,Central_African_Republic,CF,4,0,4745179,Africa,4922,63
2020-12-07,Central_African_Republic,CF,0,0,4745179,Africa,4922,63
2020-12-08,Central_African_Republic,CF,0,0,4745179,Africa,4922,63
2020-12-09,Central_African_Republic,CF,5,0,4745179,Africa,4927,63
2020-12-10,Central_African_Republic,CF,0,0,4745179,Africa,4927,63
2020-12-11,Central_African_Republic,CF,5,0,4745179,Africa,4932,63
2020-12-12,Central_African_Republic,CF,4,0,4745179,Africa,4936,63
2020-12-13,Central_African_Republic,CF,0,0,4745179,Africa,4936,63
2020-12-14,Central_African_Republic,CF,0,0,4745179,Africa,4936,63
2020-03-16,Congo,CG,1,0,5380504,Africa,1,0
2020-03-17,Congo,CG,0,0,5380504,Africa,1,0
2020-03-18,Congo,CG,0,0,5380504,Africa,1,0
2020-03-19,Congo,CG,2,0,5380504,Africa,3,0
2020-03-20,Congo,CG,0,0,5380504,Africa,3,0
2020-03-21,Congo,CG,0,0,5380504,Africa,3,0
2020-03-22,Congo,CG,1,0,5380504,Africa,4,0
2020-03-23,Congo,CG,0,0,5380504,Africa,4,0
2020-03-24,Congo,CG,0,0,5380504,Africa,4,0
2020-03-25,Congo,CG,0,0,5380504,Africa,4,0
2020-03-26,Congo,CG,0,0,5380504,Africa,4,0
2020-03-27,Congo,CG,0,0,5380504,Africa,4,0
2020-03-28,Congo,CG,0,0,5380504,Africa,4,0
2020-03-29,Congo,CG,15,0,5380504,Africa,19,0
2020-03-30,Congo,CG,0,0,5380504,Africa,19,0
2020-03-31,Congo,CG,0,0,5380504,Africa,19,0
2020-04-01,Congo,CG,3,2,5380504,Africa,22,2
2020-04-02,Congo,CG,0,0,5380504,Africa,22,2
2020-04-03,Congo,CG,19,1,5380504,Africa,41,3
2020-04-04,Congo,CG,0,0,5380504,Africa,41,3
2020-04-05,Congo,CG,4,2,5380504,Africa,45,5
2020-04-06,Congo,CG,0,0,5380504,Africa,45,5
2020-04-07,Congo,CG,0,0,5380504,Africa,45,5
2020-04-08,Congo,CG,0,0,5380504,Africa,45,5
2020-04-09,Congo,CG,15,0,5380504,Africa,60,5
2020-04-10,Congo,CG,0,0,5380504,Africa,60,5
2020-04-11,Congo,CG,0,0,5380504,Africa,60,5
2020-04-12,Congo,CG,0,0,5380504,Africa,60,5
2020-04-13,Congo,CG,10,0,5380504,Africa,70,5
2020-04-14,Congo,CG,0,0,5380504,Africa,70,5
2020-04-15,Congo,CG,4,0,5380504,Africa,74,5
2020-04-16,Congo,CG,43,0,5380504,Africa,117,5
2020-04-17,Congo,CG,0,0,5380504,Africa,117,5
2020-04-18,Congo,CG,26,1,5380504,Africa,143,6
2020-04-19,Congo,CG,0,0,5380504,Africa,143,6
2020-04-20,Congo,CG,17,0,5380504,Africa,160,6
2020-04-21,Congo,CG,0,0,5380504,Africa,160,6
2020-04-22,Congo,CG,5,0,5380504,Africa,165,6
2020-04-23,Congo,CG,21,0,5380504,Africa,186,6
2020-04-24,Congo,CG,0,0,5380504,Africa,186,6
2020-04-25,Congo,CG,14,0,5380504,Africa,200,6
2020-04-26,Congo,CG,0,2,5380504,Africa,200,8
2020-04-27,Congo,CG,0,0,5380504,Africa,200,8
2020-04-28,Congo,CG,7,0,5380504,Africa,207,8
2020-04-29,Congo,CG,0,0,5380504,Africa,207,8
2020-04-30,Congo,CG,13,1,5380504,Africa,220,9
2020-05-01,Congo,CG,0,0,5380504,Africa,220,9
2020-05-02,Congo,CG,9,1,5380504,Africa,229,10
2020-05-03,Congo,CG,0,0,5380504,Africa,229,10
2020-05-04,Congo,CG,0,0,5380504,Africa,229,10
2020-05-05,Congo,CG,7,0,5380504,Africa,236,10
2020-05-06,Congo,CG,0,0,5380504,Africa,236,10
2020-05-07,Congo,CG,28,0,5380504,Africa,264,10
2020-05-08,Congo,CG,10,0,5380504,Africa,274,10
2020-05-09,Congo,CG,13,0,5380504,Africa,287,10
2020-05-10,Congo,CG,0,0,5380504,Africa,287,10
2020-05-11,Congo,CG,0,0,5380504,Africa,287,10
2020-05-12,Congo,CG,46,1,5380504,Africa,333,11
2020-05-13,Congo,CG,0,0,5380504,Africa,333,11
2020-05-14,Congo,CG,8,0,5380504,Africa,341,11
2020-05-15,Congo,CG,50,4,5380504,Africa,391,15
2020-05-16,Congo,CG,0,0,5380504,Africa,391,15
2020-05-17,Congo,CG,21,0,5380504,Africa,412,15
2020-05-18,Congo,CG,0,0,5380504,Africa,412,15
2020-05-19,Congo,CG,0,0,5380504,Africa,412,15
2020-05-20,Congo,CG,8,0,5380504,Africa,420,15
2020-05-21,Congo,CG,0,0,5380504,Africa,420,15
2020-05-22,Congo,CG,49,1,5380504,Africa,469,16
2020-05-23,Congo,CG,0,0,5380504,Africa,469,16
2020-05-24,Congo,CG,18,0,5380504,Africa,487,16
2020-05-25,Congo,CG,0,0,5380504,Africa,487,16
2020-05-26,Congo,CG,44,1,5380504,Africa,531,17
2020-05-27,Congo,CG,38,2,5380504,Africa,569,19
2020-05-28,Congo,CG,2,0,5380504,Africa,571,19
2020-05-29,Congo,CG,0,0,5380504,Africa,571,19
2020-05-30,Congo,CG,16,0,5380504,Africa,587,19
2020-05-31,Congo,CG,0,0,5380504,Africa,587,19
2020-06-01,Congo,CG,24,1,5380504,Africa,611,20
2020-06-02,Congo,CG,0,0,5380504,Africa,611,20
2020-06-03,Congo,CG,0,0,5380504,Africa,611,20
2020-06-04,Congo,CG,7,0,5380504,Africa,618,20
2020-06-05,Congo,CG,17,0,5380504,Africa,635,20
2020-06-06,Congo,CG,4,0,5380504,Africa,639,20
2020-06-07,Congo,CG,44,2,5380504,Africa,683,22
2020-06-08,Congo,CG,0,0,5380504,Africa,683,22
2020-06-09,Congo,CG,0,0,5380504,Africa,683,22
2020-06-10,Congo,CG,45,2,5380504,Africa,728,24
2020-06-11,Congo,CG,17,1,5380504,Africa,745,25
2020-06-12,Congo,CG,0,0,5380504,Africa,745,25
2020-06-13,Congo,CG,0,0,5380504,Africa,745,25
2020-06-14,Congo,CG,34,0,5380504,Africa,779,25
2020-06-15,Congo,CG,0,0,5380504,Africa,779,25
2020-06-16,Congo,CG,104,2,5380504,Africa,883,27
2020-06-17,Congo,CG,0,0,5380504,Africa,883,27
2020-06-18,Congo,CG,0,0,5380504,Africa,883,27
2020-06-19,Congo,CG,0,0,5380504,Africa,883,27
2020-06-20,Congo,CG,0,0,5380504,Africa,883,27
2020-06-21,Congo,CG,130,1,5380504,Africa,1013,28
2020-06-22,Congo,CG,0,0,5380504,Africa,1013,28
2020-06-23,Congo,CG,74,9,5380504,Africa,1087,37
2020-06-24,Congo,CG,0,0,5380504,Africa,1087,37
2020-06-25,Congo,CG,0,0,5380504,Africa,1087,37
2020-06-26,Congo,CG,117,1,5380504,Africa,1204,38
2020-06-27,Congo,CG,0,0,5380504,Africa,1204,38
2020-06-28,Congo,CG,41,2,5380504,Africa,1245,40
2020-06-29,Congo,CG,0,0,5380504,Africa,1245,40
2020-06-30,Congo,CG,0,0,5380504,Africa,1245,40
2020-07-01,Congo,CG,0,0,5380504,Africa,1245,40
2020-07-02,Congo,CG,137,1,5380504,Africa,1382,41
2020-07-03,Congo,CG,0,0,5380504,Africa,1382,41
2020-07-04,Congo,CG,175,3,5380504,Africa,1557,44
2020-07-05,Congo,CG,0,0,5380504,Africa,1557,44
2020-07-06,Congo,CG,0,0,5380504,Africa,1557,44
2020-07-07,Congo,CG,0,0,5380504,Africa,1557,44
2020-07-08,Congo,CG,0,0,5380504,Africa,1557,44
2020-07-09,Congo,CG,264,3,5380504,Africa,1821,47
2020-07-10,Congo,CG,0,0,5380504,Africa,1821,47
2020-07-11,Congo,CG,207,0,5380504,Africa,2028,47
2020-07-12,Congo,CG,0,0,5380504,Africa,2028,47
2020-07-13,Congo,CG,75,0,5380504,Africa,2103,47
2020-07-14,Congo,CG,0,0,5380504,Africa,2103,47
2020-07-15,Congo,CG,119,0,5380504,Africa,2222,47
2020-07-16,Congo,CG,136,1,5380504,Africa,2358,48
2020-07-17,Congo,CG,0,0,5380504,Africa,2358,48
2020-07-18,Congo,CG,275,1,5380504,Africa,2633,49
2020-07-19,Congo,CG,0,0,5380504,Africa,2633,49
2020-07-20,Congo,CG,0,0,5380504,Africa,2633,49
2020-07-21,Congo,CG,218,1,5380504,Africa,2851,50
2020-07-22,Congo,CG,0,0,5380504,Africa,2851,50
2020-07-23,Congo,CG,0,0,5380504,Africa,2851,50
2020-07-24,Congo,CG,187,1,5380504,Africa,3038,51
2020-07-25,Congo,CG,0,0,5380504,Africa,3038,51
2020-07-26,Congo,CG,0,0,5380504,Africa,3038,51
2020-07-27,Congo,CG,0,0,5380504,Africa,3038,51
2020-07-28,Congo,CG,162,3,5380504,Africa,3200,54
2020-07-29,Congo,CG,0,0,5380504,Africa,3200,54
2020-07-30,Congo,CG,0,0,5380504,Africa,3200,54
2020-07-31,Congo,CG,176,2,5380504,Africa,3376,56
2020-08-01,Congo,CG,0,0,5380504,Africa,3376,56
2020-08-02,Congo,CG,11,0,5380504,Africa,3387,56
2020-08-03,Congo,CG,0,0,5380504,Africa,3387,56
2020-08-04,Congo,CG,159,2,5380504,Africa,3546,58
2020-08-05,Congo,CG,0,0,5380504,Africa,3546,58
2020-08-06,Congo,CG,0,0,5380504,Africa,3546,58
2020-08-07,Congo,CG,91,0,5380504,Africa,3637,58
2020-08-08,Congo,CG,0,0,5380504,Africa,3637,58
2020-08-09,Congo,CG,27,0,5380504,Africa,3664,58
2020-08-10,Congo,CG,0,0,5380504,Africa,3664,58
2020-08-11,Congo,CG,0,0,5380504,Africa,3664,58
2020-08-12,Congo,CG,81,2,5380504,Africa,3745,60
2020-08-13,Congo,CG,0,0,5380504,Africa,3745,60
2020-08-14,Congo,CG,0,0,5380504,Africa,3745,60
2020-08-15,Congo,CG,0,0,5380504,Africa,3745,60
2020-08-16,Congo,CG,0,0,5380504,Africa,3745,60
2020-08-17,Congo,CG,90,16,5380504,Africa,3835,76
2020-08-18,Congo,CG,0,0,5380504,Africa,3835,76
2020-08-19,Congo,CG,0,0,5380504,Africa,3835,76
2020-08-20,Congo,CG,15,1,5380504,Africa,3850,77
2020-08-21,Congo,CG,0,0,5380504,Africa,3850,77
2020-08-22,Congo,CG,0,0,5380504,Africa,3850,77
2020-08-23,Congo,CG,0,0,5380504,Africa,3850,77
2020-08-24,Congo,CG,0,0,5380504,Africa,3850,77
2020-08-25,Congo,CG,0,0,5380504,Africa,3850,77
2020-08-26,Congo,CG,129,1,5380504,Africa,3979,78
2020-08-27,Congo,CG,0,0,5380504,Africa,3979,78
2020-08-28,Congo,CG,0,0,5380504,Africa,3979,78
2020-08-29,Congo,CG,0,0,5380504,Africa,3979,78
2020-08-30,Congo,CG,0,0,5380504,Africa,3979,78
2020-08-31,Congo,CG,0,0,5380504,Africa,3979,78
2020-09-01,Congo,CG,0,0,5380504,Africa,3979,78
2020-09-02,Congo,CG,649,4,5380504,Africa,4628,82
2020-09-03,Congo,CG,0,0,5380504,Africa,4628,82
2020-09-04,Congo,CG,0,0,5380504,Africa,4628,82
2020-09-05,Congo,CG,0,0,5380504,Africa,4628,82
2020-09-06,Congo,CG,0,0,5380504,Africa,4628,82
2020-09-07,Congo,CG,0,0,5380504,Africa,4628,82
2020-09-08,Congo,CG,263,1,5380504,Africa,4891,83
2020-09-09,Congo,CG,0,0,5380504,Africa,4891,83
2020-09-10,Congo,CG,0,0,5380504,Africa,4891,83
2020-09-11,Congo,CG,0,0,5380504,Africa,4891,83
2020-09-12,Congo,CG,37,5,5380504,Africa,4928,88
2020-09-13,Congo,CG,0,0,5380504,Africa,4928,88
2020-09-14,Congo,CG,6,0,5380504,Africa,4934,88
2020-09-15,Congo,CG,0,0,5380504,Africa,4934,88
2020-09-16,Congo,CG,0,0,5380504,Africa,4934,88
2020-09-17,Congo,CG,0,0,5380504,Africa,4934,88
2020-09-18,Congo,CG,46,1,5380504,Africa,4980,89
2020-09-19,Congo,CG,0,0,5380504,Africa,4980,89
2020-09-20,Congo,CG,6,0,5380504,Africa,4986,89
2020-09-21,Congo,CG,0,0,5380504,Africa,4986,89
2020-09-22,Congo,CG,16,0,5380504,Africa,5002,89
2020-09-23,Congo,CG,0,0,5380504,Africa,5002,89
2020-09-24,Congo,CG,3,0,5380504,Africa,5005,89
2020-09-25,Congo,CG,0,0,5380504,Africa,5005,89
2020-09-26,Congo,CG,0,0,5380504,Africa,5005,89
2020-09-27,Congo,CG,3,0,5380504,Africa,5008,89
2020-09-28,Congo,CG,0,0,5380504,Africa,5008,89
2020-09-29,Congo,CG,81,0,5380504,Africa,5089,89
2020-09-30,Congo,CG,0,0,5380504,Africa,5089,89
2020-10-01,Congo,CG,0,0,5380504,Africa,5089,89
2020-10-02,Congo,CG,0,0,5380504,Africa,5089,89
2020-10-03,Congo,CG,0,0,5380504,Africa,5089,89
2020-10-04,Congo,CG,0,0,5380504,Africa,5089,89
2020-10-05,Congo,CG,0,0,5380504,Africa,5089,89
2020-10-06,Congo,CG,0,0,5380504,Africa,5089,89
2020-10-07,Congo,CG,0,0,5380504,Africa,5089,89
2020-10-08,Congo,CG,29,1,5380504,Africa,5118,90
2020-10-09,Congo,CG,0,0,5380504,Africa,5118,90
2020-10-10,Congo,CG,0,0,5380504,Africa,5118,90
2020-10-11,Congo,CG,0,0,5380504,Africa,5118,90
2020-10-12,Congo,CG,0,0,5380504,Africa,5118,90
2020-10-13,Congo,CG,0,0,5380504,Africa,5118,90
2020-10-14,Congo,CG,38,2,5380504,Africa,5156,92
2020-10-15,Congo,CG,0,0,5380504,Africa,5156,92
2020-10-16,Congo,CG,0,0,5380504,Africa,5156,92
2020-10-17,Congo,CG,0,0,5380504,Africa,5156,92
2020-10-18,Congo,CG,0,0,5380504,Africa,5156,92
2020-10-19,Congo,CG,0,0,5380504,Africa,5156,92
2020-10-20,Congo,CG,0,0,5380504,Africa,5156,92
2020-10-21,Congo,CG,0,0,5380504,Africa,5156,92
2020-10-22,Congo,CG,0,0,5380504,Africa,5156,92
2020-10-23,Congo,CG,0,0,5380504,Africa,5156,92
2020-10-24,Congo,CG,0,0,5380504,Africa,5156,92
2020-10-25,Congo,CG,97,0,5380504,Africa,5253,92
2020-10-26,Congo,CG,0,0,5380504,Africa,5253,92
2020-10-27,Congo,CG,0,0,5380504,Africa,5253,92
2020-10-28,Congo,CG,0,0,5380504,Africa,5253,92
2020-10-29,Congo,CG,0,0,5380504,Africa,5253,92
2020-10-30,Congo,CG,37,0,5380504,Africa,5290,92
2020-10-31,Congo,CG,0,0,5380504,Africa,5290,92
2020-11-01,Congo,CG,0,0,5380504,Africa,5290,92
2020-11-02,Congo,CG,0,0,5380504,Africa,5290,92
2020-11-03,Congo,CG,0,0,5380504,Africa,5290,92
2020-11-04,Congo,CG,58,0,5380504,Africa,5348,92
2020-11-05,Congo,CG,31,0,5380504,Africa,5379,92
2020-11-06,Congo,CG,0,0,5380504,Africa,5379,92
2020-11-07,Congo,CG,0,0,5380504,Africa,5379,92
2020-11-08,Congo,CG,0,0,5380504,Africa,5379,92
2020-11-09,Congo,CG,0,0,5380504,Africa,5379,92
2020-11-10,Congo,CG,0,0,5380504,Africa,5379,92
2020-11-11,Congo,CG,0,0,5380504,Africa,5379,92
2020-11-12,Congo,CG,0,0,5380504,Africa,5379,92
2020-11-13,Congo,CG,0,0,5380504,Africa,5379,92
2020-11-14,Congo,CG,0,0,5380504,Africa,5379,92
2020-11-15,Congo,CG,0,0,5380504,Africa,5379,92
2020-11-16,Congo,CG,0,0,5380504,Africa,5379,92
2020-11-17,Congo,CG,136,0,5380504,Africa,5515,92
2020-11-18,Congo,CG,0,0,5380504,Africa,5515,92
2020-11-19,Congo,CG,0,0,5380504,Africa,5515,92
2020-11-20,Congo,CG,0,0,5380504,Africa,5515,92
2020-11-21,Congo,CG,117,0,5380504,Africa,5632,92
2020-11-22,Congo,CG,0,0,5380504,Africa,5632,92
2020-11-23,Congo,CG,0,0,5380504,Africa,5632,92
2020-11-24,Congo,CG,0,0,5380504,Africa,5632,92
2020-11-25,Congo,CG,0,0,5380504,Africa,5632,92
2020-11-26,Congo,CG,0,0,5380504,Africa,5632,92
2020-11-27,Congo,CG,0,1,5380504,Africa,5632,93
2020-11-28,Congo,CG,142,1,5380504,Africa,5774,94
2020-11-29,Congo,CG,0,0,5380504,Africa,5774,94
2020-11-30,Congo,CG,0,0,5380504,Africa,5774,94
2020-12-01,Congo,CG,0,0,5380504,Africa,5774,94
2020-12-02,Congo,CG,0,0,5380504,Africa,5774,94
2020-12-03,Congo,CG,0,0,5380504,Africa,5774,94
2020-12-04,Congo,CG,0,0,5380504,Africa,5774,94
2020-12-05,Congo,CG,0,0,5380504,Africa,5774,94
2020-12-06,Congo,CG,0,0,5380504,Africa,5774,94
2020-12-07,Congo,CG,0,0,5380504,Africa,5774,94
2020-12-08,Congo,CG,0,0,5380504,Africa,5774,94
2020-12-09,Congo,CG,0,0,5380504,Africa,5774,94
2020-12-10,Congo,CG,275,5,5380504,Africa,6049,99
2020-12-11,Congo,CG,0,0,5380504,Africa,6049,99
2020-12-12,Congo,CG,0,0,5380504,Africa,6049,99
2020-12-13,Congo,CG,0,0,5380504,Africa,6049,99
2020-12-14,Congo,CG,0,0,5380504,Africa,6049,99
2019-12-31,Switzerland,CH,0,0,8544527,Europe,0,0
2020-01-01,Switzerland,CH,0,0,8544527,Europe,0,0
2020-01-02,Switzerland,CH,0,0,8544527,Europe,0,0
2020-01-03,Switzerland,CH,0,0,8544527,Europe,0,0
2020-01-04,Switzerland,CH,0,0,8544527,Europe,0,0
2020-01-05,Switzerland,CH,0,0,8544527,Europe,0,0
2020-01-06,Switzerland,CH,0,0,8544527,Europe,0,0
2020-01-07,Switzerland,CH,0,0,8544527,Europe,0,0
2020-01-08,Switzerland,CH,0,0,8544527,Europe,0,0
2020-01-09,Switzerland,CH,0,0,8544527,Europe,0,0
2020-01-10,Switzerland,CH,0,0,8544527,Europe,0,0
2020-01-11,Switzerland,CH,0,0,8544527,Europe,0,0
2020-01-12,Switzerland,CH,0,0,8544527,Europe,0,0
2020-01-13,Switzerland,CH,0,0,8544527,Europe,0,0
2020-01-14,Switzerland,CH,0,0,8544527,Europe,0,0
2020-01-15,Switzerland,CH,0,0,8544527,Europe,0,0
2020-01-16,Switzerland,CH,0,0,8544527,Europe,0,0
2020-01-17,Switzerland,CH,0,0,8544527,Europe,0,0
2020-01-18,Switzerland,CH,0,0,8544527,Europe,0,0
2020-01-19,Switzerland,CH,0,0,8544527,Europe,0,0
2020-01-20,Switzerland,CH,0,0,8544527,Europe,0,0
2020-01-21,Switzerland,CH,0,0,8544527,Europe,0,0
2020-01-22,Switzerland,CH,0,0,8544527,Europe,0,0
2020-01-23,Switzerland,CH,0,0,8544527,Europe,0,0
2020-01-24,Switzerland,CH,0,0,8544527,Europe,0,0
2020-01-25,Switzerland,CH,0,0,8544527,Europe,0,0
2020-01-26,Switzerland,CH,0,0,8544527,Europe,0,0
2020-01-27,Switzerland,CH,0,0,8544527,Europe,0,0
2020-01-28,Switzerland,CH,0,0,8544527,Europe,0,0
2020-01-29,Switzerland,CH,0,0,8544527,Europe,0,0
2020-01-30,Switzerland,CH,0,0,8544527,Europe,0,0
2020-01-31,Switzerland,CH,0,0,8544527,Europe,0,0
2020-02-01,Switzerland,CH,0,0,8544527,Europe,0,0
2020-02-02,Switzerland,CH,0,0,8544527,Europe,0,0
2020-02-03,Switzerland,CH,0,0,8544527,Europe,0,0
2020-02-04,Switzerland,CH,0,0,8544527,Europe,0,0
2020-02-05,Switzerland,CH,0,0,8544527,Europe,0,0
2020-02-06,Switzerland,CH,0,0,8544527,Europe,0,0
2020-02-07,Switzerland,CH,0,0,8544527,Europe,0,0
2020-02-08,Switzerland,CH,0,0,8544527,Europe,0,0
2020-02-09,Switzerland,CH,0,0,8544527,Europe,0,0
2020-02-10,Switzerland,CH,0,0,8544527,Europe,0,0
2020-02-11,Switzerland,CH,0,0,8544527,Europe,0,0
2020-02-12,Switzerland,CH,0,0,8544527,Europe,0,0
2020-02-13,Switzerland,CH,0,0,8544527,Europe,0,0
2020-02-14,Switzerland,CH,0,0,8544527,Europe,0,0
2020-02-15,Switzerland,CH,0,0,8544527,Europe,0,0
2020-02-16,Switzerland,CH,0,0,8544527,Europe,0,0
2020-02-17,Switzerland,CH,0,0,8544527,Europe,0,0
2020-02-18,Switzerland,CH,0,0,8544527,Europe,0,0
2020-02-19,Switzerland,CH,0,0,8544527,Europe,0,0
2020-02-20,Switzerland,CH,0,0,8544527,Europe,0,0
2020-02-21,Switzerland,CH,0,0,8544527,Europe,0,0
2020-02-22,Switzerland,CH,0,0,8544527,Europe,0,0
2020-02-23,Switzerland,CH,0,0,8544527,Europe,0,0
2020-02-24,Switzerland,CH,0,0,8544527,Europe,0,0
2020-02-25,Switzerland,CH,0,0,8544527,Europe,0,0
2020-02-26,Switzerland,CH,1,0,8544527,Europe,1,0
2020-02-27,Switzerland,CH,0,0,8544527,Europe,1,0
2020-02-28,Switzerland,CH,7,0,8544527,Europe,8,0
2020-02-29,Switzerland,CH,4,0,8544527,Europe,12,0
2020-03-01,Switzerland,CH,6,0,8544527,Europe,18,0
2020-03-02,Switzerland,CH,6,0,8544527,Europe,24,0
2020-03-03,Switzerland,CH,6,0,8544527,Europe,30,0
2020-03-04,Switzerland,CH,7,0,8544527,Europe,37,0
2020-03-05,Switzerland,CH,20,0,8544527,Europe,57,0
2020-03-06,Switzerland,CH,30,1,8544527,Europe,87,1
2020-03-07,Switzerland,CH,122,0,8544527,Europe,209,1
2020-03-08,Switzerland,CH,55,0,8544527,Europe,264,1
2020-03-09,Switzerland,CH,68,1,8544527,Europe,332,2
2020-03-10,Switzerland,CH,42,0,8544527,Europe,374,2
2020-03-11,Switzerland,CH,116,1,8544527,Europe,490,3
2020-03-12,Switzerland,CH,152,1,8544527,Europe,642,4
2020-03-13,Switzerland,CH,212,0,8544527,Europe,854,4
2020-03-14,Switzerland,CH,267,3,8544527,Europe,1121,7
2020-03-15,Switzerland,CH,238,4,8544527,Europe,1359,11
2020-03-16,Switzerland,CH,841,2,8544527,Europe,2200,13
2020-03-17,Switzerland,CH,0,1,8544527,Europe,2200,14
2020-03-18,Switzerland,CH,450,5,8544527,Europe,2650,19
2020-03-19,Switzerland,CH,353,6,8544527,Europe,3003,25
2020-03-20,Switzerland,CH,860,8,8544527,Europe,3863,33
2020-03-21,Switzerland,CH,943,10,8544527,Europe,4806,43
2020-03-22,Switzerland,CH,1271,13,8544527,Europe,6077,56
2020-03-23,Switzerland,CH,894,4,8544527,Europe,6971,60
2020-03-24,Switzerland,CH,1044,6,8544527,Europe,8015,66
2020-03-25,Switzerland,CH,774,20,8544527,Europe,8789,86
2020-03-26,Switzerland,CH,925,17,8544527,Europe,9714,103
2020-03-27,Switzerland,CH,1000,58,8544527,Europe,10714,161
2020-03-28,Switzerland,CH,1390,36,8544527,Europe,12104,197
2020-03-29,Switzerland,CH,1048,38,8544527,Europe,13152,235
2020-03-30,Switzerland,CH,1122,22,8544527,Europe,14274,257
2020-03-31,Switzerland,CH,1138,38,8544527,Europe,15412,295
2020-04-01,Switzerland,CH,696,78,8544527,Europe,16108,373
2020-04-02,Switzerland,CH,962,5,8544527,Europe,17070,378
2020-04-03,Switzerland,CH,1124,54,8544527,Europe,18194,432
2020-04-04,Switzerland,CH,1033,52,8544527,Europe,19227,484
2020-04-05,Switzerland,CH,974,56,8544527,Europe,20201,540
2020-04-06,Switzerland,CH,821,19,8544527,Europe,21022,559
2020-04-07,Switzerland,CH,552,25,8544527,Europe,21574,584
2020-04-08,Switzerland,CH,590,57,8544527,Europe,22164,641
2020-04-09,Switzerland,CH,546,64,8544527,Europe,22710,705
2020-04-10,Switzerland,CH,785,51,8544527,Europe,23495,756
2020-04-11,Switzerland,CH,733,49,8544527,Europe,24228,805
2020-04-12,Switzerland,CH,592,26,8544527,Europe,24820,831
2020-04-13,Switzerland,CH,400,27,8544527,Europe,25220,858
2020-04-14,Switzerland,CH,279,0,8544527,Europe,25499,858
2020-04-15,Switzerland,CH,254,42,8544527,Europe,25753,900
2020-04-16,Switzerland,CH,583,73,8544527,Europe,26336,973
2020-04-17,Switzerland,CH,315,43,8544527,Europe,26651,1016
2020-04-18,Switzerland,CH,346,42,8544527,Europe,26997,1058
2020-04-19,Switzerland,CH,325,52,8544527,Europe,27322,1110
2020-04-20,Switzerland,CH,336,24,8544527,Europe,27658,1134
2020-04-21,Switzerland,CH,168,7,8544527,Europe,27826,1141
2020-04-22,Switzerland,CH,155,45,8544527,Europe,27981,1186
2020-04-23,Switzerland,CH,205,30,8544527,Europe,28186,1216
2020-04-24,Switzerland,CH,228,51,8544527,Europe,28414,1267
2020-04-25,Switzerland,CH,181,41,8544527,Europe,28595,1308
2020-04-26,Switzerland,CH,216,20,8544527,Europe,28811,1328
2020-04-27,Switzerland,CH,167,8,8544527,Europe,28978,1336
2020-04-28,Switzerland,CH,103,16,8544527,Europe,29081,1352
2020-04-29,Switzerland,CH,100,27,8544527,Europe,29181,1379
2020-04-30,Switzerland,CH,143,28,8544527,Europe,29324,1407
2020-05-01,Switzerland,CH,179,15,8544527,Europe,29503,1422
2020-05-02,Switzerland,CH,119,12,8544527,Europe,29622,1434
2020-05-03,Switzerland,CH,112,32,8544527,Europe,29734,1466
2020-05-04,Switzerland,CH,88,6,8544527,Europe,29822,1472
2020-05-05,Switzerland,CH,76,4,8544527,Europe,29898,1476
2020-05-06,Switzerland,CH,28,6,8544527,Europe,29926,1482
2020-05-07,Switzerland,CH,51,22,8544527,Europe,29977,1504
2020-05-08,Switzerland,CH,66,13,8544527,Europe,30043,1517
2020-05-09,Switzerland,CH,81,8,8544527,Europe,30124,1525
2020-05-10,Switzerland,CH,44,6,8544527,Europe,30168,1531
2020-05-11,Switzerland,CH,54,6,8544527,Europe,30222,1537
2020-05-12,Switzerland,CH,39,5,8544527,Europe,30261,1542
2020-05-13,Switzerland,CH,36,18,8544527,Europe,30297,1560
2020-05-14,Switzerland,CH,33,3,8544527,Europe,30330,1563
2020-05-15,Switzerland,CH,50,25,8544527,Europe,30380,1588
2020-05-16,Switzerland,CH,51,6,8544527,Europe,30431,1594
2020-05-17,Switzerland,CH,58,7,8544527,Europe,30489,1601
2020-05-18,Switzerland,CH,15,1,8544527,Europe,30504,1602
2020-05-19,Switzerland,CH,10,0,8544527,Europe,30514,1602
2020-05-20,Switzerland,CH,21,11,8544527,Europe,30535,1613
2020-05-21,Switzerland,CH,40,16,8544527,Europe,30575,1629
2020-05-22,Switzerland,CH,36,8,8544527,Europe,30611,1637
2020-05-23,Switzerland,CH,13,0,8544527,Europe,30624,1637
2020-05-24,Switzerland,CH,18,4,8544527,Europe,30642,1641
2020-05-25,Switzerland,CH,11,0,8544527,Europe,30653,1641
2020-05-26,Switzerland,CH,10,0,8544527,Europe,30663,1641
2020-05-27,Switzerland,CH,15,6,8544527,Europe,30678,1647
2020-05-28,Switzerland,CH,0,0,8544527,Europe,30678,1647
2020-05-29,Switzerland,CH,35,7,8544527,Europe,30713,1654
2020-05-30,Switzerland,CH,32,2,8544527,Europe,30745,1656
2020-05-31,Switzerland,CH,17,0,8544527,Europe,30762,1656
2020-06-01,Switzerland,CH,17,0,8544527,Europe,30779,1656
2020-06-02,Switzerland,CH,9,0,8544527,Europe,30788,1656
2020-06-03,Switzerland,CH,3,0,8544527,Europe,30791,1656
2020-06-04,Switzerland,CH,19,3,8544527,Europe,30810,1659
2020-06-05,Switzerland,CH,20,0,8544527,Europe,30830,1659
2020-06-06,Switzerland,CH,23,0,8544527,Europe,30853,1659
2020-06-07,Switzerland,CH,20,1,8544527,Europe,30873,1660
2020-06-08,Switzerland,CH,9,0,8544527,Europe,30882,1660
2020-06-09,Switzerland,CH,7,0,8544527,Europe,30889,1660
2020-06-10,Switzerland,CH,16,2,8544527,Europe,30905,1662
2020-06-11,Switzerland,CH,23,12,8544527,Europe,30928,1674
2020-06-12,Switzerland,CH,33,0,8544527,Europe,30961,1674
2020-06-13,Switzerland,CH,19,2,8544527,Europe,30980,1676
2020-06-14,Switzerland,CH,31,0,8544527,Europe,31011,1676
2020-06-15,Switzerland,CH,23,0,8544527,Europe,31034,1676
2020-06-16,Switzerland,CH,14,0,8544527,Europe,31048,1676
2020-06-17,Switzerland,CH,15,1,8544527,Europe,31063,1677
2020-06-18,Switzerland,CH,37,0,8544527,Europe,31100,1677
2020-06-19,Switzerland,CH,17,0,8544527,Europe,31117,1677
2020-06-20,Switzerland,CH,92,0,8544527,Europe,31209,1677
2020-06-21,Switzerland,CH,0,0,8544527,Europe,31209,1677
2020-06-22,Switzerland,CH,0,2,8544527,Europe,31209,1679
2020-06-23,Switzerland,CH,18,0,8544527,Europe,31227,1679
2020-06-24,Switzerland,CH,22,0,8544527,Europe,31249,1679
2020-06-25,Switzerland,CH,44,2,8544527,Europe,31293,1681
2020-06-26,Switzerland,CH,52,0,8544527,Europe,31345,1681
2020-06-27,Switzerland,CH,58,0,8544527,Europe,31403,1681
2020-06-28,Switzerland,CH,69,0,8544527,Europe,31472,1681
2020-06-29,Switzerland,CH,62,0,8544527,Europe,31534,1681
2020-06-30,Switzerland,CH,35,0,8544527,Europe,31569,1681
2020-07-01,Switzerland,CH,62,2,8544527,Europe,31631,1683
2020-07-02,Switzerland,CH,220,1,8544527,Europe,31851,1684
2020-07-03,Switzerland,CH,33,1,8544527,Europe,31884,1685
2020-07-04,Switzerland,CH,133,0,8544527,Europe,32017,1685
2020-07-05,Switzerland,CH,97,0,8544527,Europe,32114,1685
2020-07-06,Switzerland,CH,70,0,8544527,Europe,32184,1685
2020-07-07,Switzerland,CH,46,0,8544527,Europe,32230,1685
2020-07-08,Switzerland,CH,54,0,8544527,Europe,32284,1685
2020-07-09,Switzerland,CH,129,0,8544527,Europe,32413,1685
2020-07-10,Switzerland,CH,88,0,8544527,Europe,32501,1685
2020-07-11,Switzerland,CH,104,0,8544527,Europe,32605,1685
2020-07-12,Switzerland,CH,108,0,8544527,Europe,32713,1685
2020-07-13,Switzerland,CH,85,0,8544527,Europe,32798,1685
2020-07-14,Switzerland,CH,63,0,8544527,Europe,32861,1685
2020-07-15,Switzerland,CH,70,2,8544527,Europe,32931,1687
2020-07-16,Switzerland,CH,132,0,8544527,Europe,33063,1687
2020-07-17,Switzerland,CH,142,0,8544527,Europe,33205,1687
2020-07-18,Switzerland,CH,91,0,8544527,Europe,33296,1687
2020-07-19,Switzerland,CH,110,0,8544527,Europe,33406,1687
2020-07-20,Switzerland,CH,98,0,8544527,Europe,33504,1687
2020-07-21,Switzerland,CH,43,0,8544527,Europe,33547,1687
2020-07-22,Switzerland,CH,108,3,8544527,Europe,33655,1690
2020-07-23,Switzerland,CH,141,2,8544527,Europe,33796,1692
2020-07-24,Switzerland,CH,117,1,8544527,Europe,33913,1693
2020-07-25,Switzerland,CH,154,6,8544527,Europe,34067,1699
2020-07-26,Switzerland,CH,148,0,8544527,Europe,34215,1699
2020-07-27,Switzerland,CH,110,1,8544527,Europe,34325,1700
2020-07-28,Switzerland,CH,65,0,8544527,Europe,34390,1700
2020-07-29,Switzerland,CH,132,2,8544527,Europe,34522,1702
2020-07-30,Switzerland,CH,192,0,8544527,Europe,34714,1702
2020-07-31,Switzerland,CH,219,1,8544527,Europe,34933,1703
2020-08-01,Switzerland,CH,137,0,8544527,Europe,35070,1703
2020-08-02,Switzerland,CH,342,2,8544527,Europe,35412,1705
2020-08-03,Switzerland,CH,49,0,8544527,Europe,35461,1705
2020-08-04,Switzerland,CH,66,0,8544527,Europe,35527,1705
2020-08-05,Switzerland,CH,130,0,8544527,Europe,35657,1705
2020-08-06,Switzerland,CH,181,0,8544527,Europe,35838,1705
2020-08-07,Switzerland,CH,181,3,8544527,Europe,36019,1708
2020-08-08,Switzerland,CH,161,3,8544527,Europe,36180,1711
2020-08-09,Switzerland,CH,182,0,8544527,Europe,36362,1711
2020-08-10,Switzerland,CH,152,0,8544527,Europe,36514,1711
2020-08-11,Switzerland,CH,105,0,8544527,Europe,36619,1711
2020-08-12,Switzerland,CH,187,1,8544527,Europe,36806,1712
2020-08-13,Switzerland,CH,273,1,8544527,Europe,37079,1713
2020-08-14,Switzerland,CH,233,1,8544527,Europe,37312,1714
2020-08-15,Switzerland,CH,268,0,8544527,Europe,37580,1714
2020-08-16,Switzerland,CH,251,0,8544527,Europe,37831,1714
2020-08-17,Switzerland,CH,200,1,8544527,Europe,38031,1715
2020-08-18,Switzerland,CH,125,0,8544527,Europe,38156,1715
2020-08-19,Switzerland,CH,196,1,8544527,Europe,38352,1716
2020-08-20,Switzerland,CH,310,2,8544527,Europe,38662,1718
2020-08-21,Switzerland,CH,264,0,8544527,Europe,38926,1718
2020-08-22,Switzerland,CH,306,0,8544527,Europe,39232,1718
2020-08-23,Switzerland,CH,294,1,8544527,Europe,39526,1719
2020-08-24,Switzerland,CH,276,0,8544527,Europe,39802,1719
2020-08-25,Switzerland,CH,157,1,8544527,Europe,39959,1720
2020-08-26,Switzerland,CH,202,2,8544527,Europe,40161,1722
2020-08-27,Switzerland,CH,379,0,8544527,Europe,40540,1722
2020-08-28,Switzerland,CH,360,1,8544527,Europe,40900,1723
2020-08-29,Switzerland,CH,340,1,8544527,Europe,41240,1724
2020-08-30,Switzerland,CH,375,0,8544527,Europe,41615,1724
2020-08-31,Switzerland,CH,291,0,8544527,Europe,41906,1724
2020-09-01,Switzerland,CH,163,1,8544527,Europe,42069,1725
2020-09-02,Switzerland,CH,216,1,8544527,Europe,42285,1726
2020-09-03,Switzerland,CH,370,0,8544527,Europe,42655,1726
2020-09-04,Switzerland,CH,472,4,8544527,Europe,43127,1730
2020-09-05,Switzerland,CH,297,1,8544527,Europe,43424,1731
2020-09-06,Switzerland,CH,425,0,8544527,Europe,43849,1731
2020-09-07,Switzerland,CH,444,1,8544527,Europe,44293,1732
2020-09-08,Switzerland,CH,191,2,8544527,Europe,44484,1734
2020-09-09,Switzerland,CH,245,0,8544527,Europe,44729,1734
2020-09-10,Switzerland,CH,468,0,8544527,Europe,45197,1734
2020-09-11,Switzerland,CH,405,2,8544527,Europe,45602,1736
2020-09-12,Switzerland,CH,528,3,8544527,Europe,46130,1739
2020-09-13,Switzerland,CH,465,3,8544527,Europe,46595,1742
2020-09-14,Switzerland,CH,473,4,8544527,Europe,47068,1746
2020-09-15,Switzerland,CH,257,0,8544527,Europe,47325,1746
2020-09-16,Switzerland,CH,315,1,8544527,Europe,47640,1747
2020-09-17,Switzerland,CH,514,7,8544527,Europe,48154,1754
2020-09-18,Switzerland,CH,530,8,8544527,Europe,48684,1762
2020-09-19,Switzerland,CH,487,2,8544527,Europe,49171,1764
2020-09-20,Switzerland,CH,0,0,8544527,Europe,49171,1764
2020-09-21,Switzerland,CH,0,0,8544527,Europe,49171,1764
2020-09-22,Switzerland,CH,1093,5,8544527,Europe,50264,1769
2020-09-23,Switzerland,CH,284,3,8544527,Europe,50548,1772
2020-09-24,Switzerland,CH,436,0,8544527,Europe,50984,1772
2020-09-25,Switzerland,CH,508,4,8544527,Europe,51492,1776
2020-09-26,Switzerland,CH,255,1,8544527,Europe,51747,1777
2020-09-27,Switzerland,CH,117,1,8544527,Europe,51864,1778
2020-09-28,Switzerland,CH,0,0,8544527,Europe,51864,1778
2020-09-29,Switzerland,CH,664,1,8544527,Europe,52528,1779
2020-09-30,Switzerland,CH,223,2,8544527,Europe,52751,1781
2020-10-01,Switzerland,CH,411,1,8544527,Europe,53162,1782
2020-10-02,Switzerland,CH,550,1,8544527,Europe,53712,1783
2020-10-03,Switzerland,CH,551,0,8544527,Europe,54263,1783
2020-10-04,Switzerland,CH,0,0,8544527,Europe,54263,1783
2020-10-05,Switzerland,CH,0,0,8544527,Europe,54263,1783
2020-10-06,Switzerland,CH,1540,3,8544527,Europe,55803,1786
2020-10-07,Switzerland,CH,699,0,8544527,Europe,56502,1786
2020-10-08,Switzerland,CH,0,0,8544527,Europe,56502,1786
2020-10-09,Switzerland,CH,2243,4,8544527,Europe,58745,1790
2020-10-10,Switzerland,CH,1485,3,8544527,Europe,60230,1793
2020-10-11,Switzerland,CH,0,0,8544527,Europe,60230,1793
2020-10-12,Switzerland,CH,0,0,8544527,Europe,60230,1793
2020-10-13,Switzerland,CH,4057,7,8544527,Europe,64287,1800
2020-10-14,Switzerland,CH,1439,7,8544527,Europe,65726,1807
2020-10-15,Switzerland,CH,2724,7,8544527,Europe,68450,1814
2020-10-16,Switzerland,CH,2690,3,8544527,Europe,71140,1817
2020-10-17,Switzerland,CH,3087,5,8544527,Europe,74227,1822
2020-10-18,Switzerland,CH,0,0,8544527,Europe,74227,1822
2020-10-19,Switzerland,CH,195,1,8544527,Europe,74422,1823
2020-10-20,Switzerland,CH,8737,14,8544527,Europe,83159,1837
2020-10-21,Switzerland,CH,3008,7,8544527,Europe,86167,1844
2020-10-22,Switzerland,CH,5596,11,8544527,Europe,91763,1855
2020-10-23,Switzerland,CH,4968,11,8544527,Europe,96731,1866
2020-10-24,Switzerland,CH,6592,10,8544527,Europe,103323,1876
2020-10-25,Switzerland,CH,0,0,8544527,Europe,103323,1876
2020-10-26,Switzerland,CH,0,0,8544527,Europe,103323,1876
2020-10-27,Switzerland,CH,17357,37,8544527,Europe,120680,1913
2020-10-28,Switzerland,CH,6362,16,8544527,Europe,127042,1929
2020-10-29,Switzerland,CH,8155,24,8544527,Europe,135197,1953
2020-10-30,Switzerland,CH,9361,31,8544527,Europe,144558,1984
2020-10-31,Switzerland,CH,9170,51,8544527,Europe,153728,2035
2020-11-01,Switzerland,CH,0,0,8544527,Europe,153728,2035
2020-11-02,Switzerland,CH,0,0,8544527,Europe,153728,2035
2020-11-03,Switzerland,CH,21842,93,8544527,Europe,175570,2128
2020-11-04,Switzerland,CH,6090,72,8544527,Europe,181660,2200
2020-11-05,Switzerland,CH,10043,72,8544527,Europe,191703,2272
2020-11-06,Switzerland,CH,10098,62,8544527,Europe,201801,2334
2020-11-07,Switzerland,CH,9359,70,8544527,Europe,211160,2404
2020-11-08,Switzerland,CH,0,0,8544527,Europe,211160,2404
2020-11-09,Switzerland,CH,0,0,8544527,Europe,211160,2404
2020-11-10,Switzerland,CH,17245,169,8544527,Europe,228405,2573
2020-11-11,Switzerland,CH,5935,106,8544527,Europe,234340,2679
2020-11-12,Switzerland,CH,8238,86,8544527,Europe,242578,2765
2020-11-13,Switzerland,CH,6893,98,8544527,Europe,249471,2863
2020-11-14,Switzerland,CH,6715,93,8544527,Europe,256186,2956
2020-11-15,Switzerland,CH,0,0,8544527,Europe,256186,2956
2020-11-16,Switzerland,CH,0,0,8544527,Europe,256186,2956
2020-11-17,Switzerland,CH,12779,197,8544527,Europe,268965,3153
2020-11-18,Switzerland,CH,4522,140,8544527,Europe,273487,3293
2020-11-19,Switzerland,CH,6085,84,8544527,Europe,279572,3377
2020-11-20,Switzerland,CH,4988,79,8544527,Europe,284560,3456
2020-11-21,Switzerland,CH,4923,111,8544527,Europe,289483,3567
2020-11-22,Switzerland,CH,0,0,8544527,Europe,289483,3567
2020-11-23,Switzerland,CH,0,0,8544527,Europe,289483,3567
2020-11-24,Switzerland,CH,9688,213,8544527,Europe,299171,3780
2020-11-25,Switzerland,CH,4221,150,8544527,Europe,303392,3930
2020-11-26,Switzerland,CH,4862,86,8544527,Europe,308254,4016
2020-11-27,Switzerland,CH,4468,79,8544527,Europe,312722,4095
2020-11-28,Switzerland,CH,4295,141,8544527,Europe,317017,4236
2020-11-29,Switzerland,CH,0,0,8544527,Europe,317017,4236
2020-11-30,Switzerland,CH,0,0,8544527,Europe,317017,4236
2020-12-01,Switzerland,CH,8753,194,8544527,Europe,325770,4430
2020-12-02,Switzerland,CH,3760,107,8544527,Europe,329530,4537
2020-12-03,Switzerland,CH,6130,130,8544527,Europe,335660,4667
2020-12-04,Switzerland,CH,3071,65,8544527,Europe,338731,4732
2020-12-05,Switzerland,CH,4370,100,8544527,Europe,343101,4832
2020-12-06,Switzerland,CH,0,0,8544527,Europe,343101,4832
2020-12-07,Switzerland,CH,0,0,8544527,Europe,343101,4832
2020-12-08,Switzerland,CH,9774,175,8544527,Europe,352875,5007
2020-12-09,Switzerland,CH,4246,92,8544527,Europe,357121,5099
2020-12-10,Switzerland,CH,5059,87,8544527,Europe,362180,5186
2020-12-11,Switzerland,CH,5038,87,8544527,Europe,367218,5273
2020-12-12,Switzerland,CH,5111,105,8544527,Europe,372329,5378
2020-12-13,Switzerland,CH,0,0,8544527,Europe,372329,5378
2020-12-14,Switzerland,CH,0,0,8544527,Europe,372329,5378
2020-03-12,Cote_dIvoire,CI,1,0,25716554,Africa,1,0
2020-03-15,Cote_dIvoire,CI,3,0,25716554,Africa,4,0
2020-03-16,Cote_dIvoire,CI,0,0,25716554,Africa,4,0
2020-03-17,Cote_dIvoire,CI,1,0,25716554,Africa,5,0
2020-03-18,Cote_dIvoire,CI,0,0,25716554,Africa,5,0
2020-03-19,Cote_dIvoire,CI,1,0,25716554,Africa,6,0
2020-03-20,Cote_dIvoire,CI,3,0,25716554,Africa,9,0
2020-03-21,Cote_dIvoire,CI,5,0,25716554,Africa,14,0
2020-03-22,Cote_dIvoire,CI,3,0,25716554,Africa,17,0
2020-03-23,Cote_dIvoire,CI,8,0,25716554,Africa,25,0
2020-03-24,Cote_dIvoire,CI,0,0,25716554,Africa,25,0
2020-03-25,Cote_dIvoire,CI,48,0,25716554,Africa,73,0
2020-03-26,Cote_dIvoire,CI,7,0,25716554,Africa,80,0
2020-03-27,Cote_dIvoire,CI,16,0,25716554,Africa,96,0
2020-03-28,Cote_dIvoire,CI,5,0,25716554,Africa,101,0
2020-03-29,Cote_dIvoire,CI,39,0,25716554,Africa,140,0
2020-03-30,Cote_dIvoire,CI,25,1,25716554,Africa,165,1
2020-03-31,Cote_dIvoire,CI,3,0,25716554,Africa,168,1
2020-04-01,Cote_dIvoire,CI,0,0,25716554,Africa,168,1
2020-04-02,Cote_dIvoire,CI,22,0,25716554,Africa,190,1
2020-04-03,Cote_dIvoire,CI,4,0,25716554,Africa,194,1
2020-04-04,Cote_dIvoire,CI,24,0,25716554,Africa,218,1
2020-04-05,Cote_dIvoire,CI,27,1,25716554,Africa,245,2
2020-04-06,Cote_dIvoire,CI,16,1,25716554,Africa,261,3
2020-04-07,Cote_dIvoire,CI,62,0,25716554,Africa,323,3
2020-04-08,Cote_dIvoire,CI,26,0,25716554,Africa,349,3
2020-04-09,Cote_dIvoire,CI,35,0,25716554,Africa,384,3
2020-04-10,Cote_dIvoire,CI,60,0,25716554,Africa,444,3
2020-04-11,Cote_dIvoire,CI,36,0,25716554,Africa,480,3
2020-04-12,Cote_dIvoire,CI,53,1,25716554,Africa,533,4
2020-04-13,Cote_dIvoire,CI,41,1,25716554,Africa,574,5
2020-04-14,Cote_dIvoire,CI,52,1,25716554,Africa,626,6
2020-04-15,Cote_dIvoire,CI,0,0,25716554,Africa,626,6
2020-04-16,Cote_dIvoire,CI,28,0,25716554,Africa,654,6
2020-04-17,Cote_dIvoire,CI,34,0,25716554,Africa,688,6
2020-04-18,Cote_dIvoire,CI,54,0,25716554,Africa,742,6
2020-04-19,Cote_dIvoire,CI,59,2,25716554,Africa,801,8
2020-04-20,Cote_dIvoire,CI,46,1,25716554,Africa,847,9
2020-04-21,Cote_dIvoire,CI,32,1,25716554,Africa,879,10
2020-04-22,Cote_dIvoire,CI,37,3,25716554,Africa,916,13
2020-04-23,Cote_dIvoire,CI,36,1,25716554,Africa,952,14
2020-04-24,Cote_dIvoire,CI,52,0,25716554,Africa,1004,14
2020-04-25,Cote_dIvoire,CI,73,0,25716554,Africa,1077,14
2020-04-26,Cote_dIvoire,CI,34,0,25716554,Africa,1111,14
2020-04-27,Cote_dIvoire,CI,39,0,25716554,Africa,1150,14
2020-04-28,Cote_dIvoire,CI,14,0,25716554,Africa,1164,14
2020-04-29,Cote_dIvoire,CI,19,0,25716554,Africa,1183,14
2020-04-30,Cote_dIvoire,CI,55,0,25716554,Africa,1238,14
2020-05-01,Cote_dIvoire,CI,37,0,25716554,Africa,1275,14
2020-05-02,Cote_dIvoire,CI,58,1,25716554,Africa,1333,15
2020-05-03,Cote_dIvoire,CI,29,0,25716554,Africa,1362,15
2020-05-04,Cote_dIvoire,CI,36,2,25716554,Africa,1398,17
2020-05-05,Cote_dIvoire,CI,34,0,25716554,Africa,1432,17
2020-05-06,Cote_dIvoire,CI,32,1,25716554,Africa,1464,18
2020-05-07,Cote_dIvoire,CI,52,0,25716554,Africa,1516,18
2020-05-08,Cote_dIvoire,CI,55,2,25716554,Africa,1571,20
2020-05-09,Cote_dIvoire,CI,31,0,25716554,Africa,1602,20
2020-05-10,Cote_dIvoire,CI,65,1,25716554,Africa,1667,21
2020-05-11,Cote_dIvoire,CI,33,0,25716554,Africa,1700,21
2020-05-12,Cote_dIvoire,CI,30,0,25716554,Africa,1730,21
2020-05-13,Cote_dIvoire,CI,127,0,25716554,Africa,1857,21
2020-05-14,Cote_dIvoire,CI,55,3,25716554,Africa,1912,24
2020-05-15,Cote_dIvoire,CI,59,0,25716554,Africa,1971,24
2020-05-16,Cote_dIvoire,CI,46,0,25716554,Africa,2017,24
2020-05-17,Cote_dIvoire,CI,44,1,25716554,Africa,2061,25
2020-05-18,Cote_dIvoire,CI,48,2,25716554,Africa,2109,27
2020-05-19,Cote_dIvoire,CI,10,1,25716554,Africa,2119,28
2020-05-20,Cote_dIvoire,CI,34,0,25716554,Africa,2153,28
2020-05-21,Cote_dIvoire,CI,78,1,25716554,Africa,2231,29
2020-05-22,Cote_dIvoire,CI,0,0,25716554,Africa,2231,29
2020-05-23,Cote_dIvoire,CI,70,0,25716554,Africa,2301,29
2020-05-24,Cote_dIvoire,CI,65,1,25716554,Africa,2366,30
2020-05-25,Cote_dIvoire,CI,10,0,25716554,Africa,2376,30
2020-05-26,Cote_dIvoire,CI,47,0,25716554,Africa,2423,30
2020-05-27,Cote_dIvoire,CI,54,0,25716554,Africa,2477,30
2020-05-28,Cote_dIvoire,CI,79,1,25716554,Africa,2556,31
2020-05-29,Cote_dIvoire,CI,85,1,25716554,Africa,2641,32
2020-05-30,Cote_dIvoire,CI,109,0,25716554,Africa,2750,32
2020-05-31,Cote_dIvoire,CI,49,1,25716554,Africa,2799,33
2020-06-01,Cote_dIvoire,CI,34,0,25716554,Africa,2833,33
2020-06-02,Cote_dIvoire,CI,118,0,25716554,Africa,2951,33
2020-06-03,Cote_dIvoire,CI,73,0,25716554,Africa,3024,33
2020-06-04,Cote_dIvoire,CI,0,0,25716554,Africa,3024,33
2020-06-05,Cote_dIvoire,CI,238,2,25716554,Africa,3262,35
2020-06-06,Cote_dIvoire,CI,169,1,25716554,Africa,3431,36
2020-06-07,Cote_dIvoire,CI,126,0,25716554,Africa,3557,36
2020-06-08,Cote_dIvoire,CI,182,0,25716554,Africa,3739,36
2020-06-09,Cote_dIvoire,CI,142,2,25716554,Africa,3881,38
2020-06-10,Cote_dIvoire,CI,114,0,25716554,Africa,3995,38
2020-06-11,Cote_dIvoire,CI,186,3,25716554,Africa,4181,41
2020-06-12,Cote_dIvoire,CI,223,0,25716554,Africa,4404,41
2020-06-13,Cote_dIvoire,CI,280,4,25716554,Africa,4684,45
2020-06-14,Cote_dIvoire,CI,164,0,25716554,Africa,4848,45
2020-06-15,Cote_dIvoire,CI,236,0,25716554,Africa,5084,45
2020-06-16,Cote_dIvoire,CI,355,1,25716554,Africa,5439,46
2020-06-17,Cote_dIvoire,CI,240,0,25716554,Africa,5679,46
2020-06-18,Cote_dIvoire,CI,384,2,25716554,Africa,6063,48
2020-06-19,Cote_dIvoire,CI,0,0,25716554,Africa,6063,48
2020-06-20,Cote_dIvoire,CI,381,1,25716554,Africa,6444,49
2020-06-21,Cote_dIvoire,CI,430,0,25716554,Africa,6874,49
2020-06-22,Cote_dIvoire,CI,618,2,25716554,Africa,7492,51
2020-06-23,Cote_dIvoire,CI,0,3,25716554,Africa,7492,54
2020-06-24,Cote_dIvoire,CI,412,4,25716554,Africa,7904,58
2020-06-25,Cote_dIvoire,CI,0,0,25716554,Africa,7904,58
2020-06-26,Cote_dIvoire,CI,260,0,25716554,Africa,8164,58
2020-06-27,Cote_dIvoire,CI,170,2,25716554,Africa,8334,60
2020-06-28,Cote_dIvoire,CI,405,4,25716554,Africa,8739,64
2020-06-29,Cote_dIvoire,CI,205,2,25716554,Africa,8944,66
2020-06-30,Cote_dIvoire,CI,270,0,25716554,Africa,9214,66
2020-07-01,Cote_dIvoire,CI,285,2,25716554,Africa,9499,68
2020-07-02,Cote_dIvoire,CI,203,0,25716554,Africa,9702,68
2020-07-03,Cote_dIvoire,CI,290,0,25716554,Africa,9992,68
2020-07-04,Cote_dIvoire,CI,252,2,25716554,Africa,10244,70
2020-07-05,Cote_dIvoire,CI,218,2,25716554,Africa,10462,72
2020-07-06,Cote_dIvoire,CI,310,2,25716554,Africa,10772,74
2020-07-07,Cote_dIvoire,CI,194,1,25716554,Africa,10966,75
2020-07-08,Cote_dIvoire,CI,0,0,25716554,Africa,10966,75
2020-07-09,Cote_dIvoire,CI,538,3,25716554,Africa,11504,78
2020-07-10,Cote_dIvoire,CI,246,1,25716554,Africa,11750,79
2020-07-11,Cote_dIvoire,CI,302,2,25716554,Africa,12052,81
2020-07-12,Cote_dIvoire,CI,391,1,25716554,Africa,12443,82
2020-07-13,Cote_dIvoire,CI,323,2,25716554,Africa,12766,84
2020-07-14,Cote_dIvoire,CI,106,0,25716554,Africa,12872,84
2020-07-15,Cote_dIvoire,CI,165,3,25716554,Africa,13037,87
2020-07-16,Cote_dIvoire,CI,366,0,25716554,Africa,13403,87
2020-07-17,Cote_dIvoire,CI,151,0,25716554,Africa,13554,87
2020-07-18,Cote_dIvoire,CI,142,0,25716554,Africa,13696,87
2020-07-19,Cote_dIvoire,CI,216,4,25716554,Africa,13912,91
2020-07-20,Cote_dIvoire,CI,207,1,25716554,Africa,14119,92
2020-07-21,Cote_dIvoire,CI,193,0,25716554,Africa,14312,92
2020-07-22,Cote_dIvoire,CI,219,1,25716554,Africa,14531,93
2020-07-23,Cote_dIvoire,CI,0,0,25716554,Africa,14531,93
2020-07-24,Cote_dIvoire,CI,470,0,25716554,Africa,15001,93
2020-07-25,Cote_dIvoire,CI,252,1,25716554,Africa,15253,94
2020-07-26,Cote_dIvoire,CI,241,0,25716554,Africa,15494,94
2020-07-27,Cote_dIvoire,CI,102,2,25716554,Africa,15596,96
2020-07-28,Cote_dIvoire,CI,59,0,25716554,Africa,15655,96
2020-07-29,Cote_dIvoire,CI,58,2,25716554,Africa,15713,98
2020-07-30,Cote_dIvoire,CI,100,1,25716554,Africa,15813,99
2020-07-31,Cote_dIvoire,CI,165,1,25716554,Africa,15978,100
2020-08-01,Cote_dIvoire,CI,69,2,25716554,Africa,16047,102
2020-08-02,Cote_dIvoire,CI,62,0,25716554,Africa,16109,102
2020-08-03,Cote_dIvoire,CI,73,0,25716554,Africa,16182,102
2020-08-04,Cote_dIvoire,CI,38,0,25716554,Africa,16220,102
2020-08-05,Cote_dIvoire,CI,73,1,25716554,Africa,16293,103
2020-08-06,Cote_dIvoire,CI,56,0,25716554,Africa,16349,103
2020-08-07,Cote_dIvoire,CI,98,0,25716554,Africa,16447,103
2020-08-08,Cote_dIvoire,CI,77,1,25716554,Africa,16524,104
2020-08-09,Cote_dIvoire,CI,96,0,25716554,Africa,16620,104
2020-08-10,Cote_dIvoire,CI,95,1,25716554,Africa,16715,105
2020-08-11,Cote_dIvoire,CI,83,0,25716554,Africa,16798,105
2020-08-12,Cote_dIvoire,CI,49,0,25716554,Africa,16847,105
2020-08-13,Cote_dIvoire,CI,0,0,25716554,Africa,16847,105
2020-08-14,Cote_dIvoire,CI,42,0,25716554,Africa,16889,105
2020-08-15,Cote_dIvoire,CI,46,1,25716554,Africa,16935,106
2020-08-16,Cote_dIvoire,CI,58,2,25716554,Africa,16993,108
2020-08-17,Cote_dIvoire,CI,33,2,25716554,Africa,17026,110
2020-08-18,Cote_dIvoire,CI,0,0,25716554,Africa,17026,110
2020-08-19,Cote_dIvoire,CI,124,0,25716554,Africa,17150,110
2020-08-20,Cote_dIvoire,CI,82,1,25716554,Africa,17232,111
2020-08-21,Cote_dIvoire,CI,17,1,25716554,Africa,17249,112
2020-08-22,Cote_dIvoire,CI,61,0,25716554,Africa,17310,112
2020-08-23,Cote_dIvoire,CI,64,1,25716554,Africa,17374,113
2020-08-24,Cote_dIvoire,CI,97,0,25716554,Africa,17471,113
2020-08-25,Cote_dIvoire,CI,35,1,25716554,Africa,17506,114
2020-08-26,Cote_dIvoire,CI,56,0,25716554,Africa,17562,114
2020-08-27,Cote_dIvoire,CI,41,0,25716554,Africa,17603,114
2020-08-28,Cote_dIvoire,CI,99,1,25716554,Africa,17702,115
2020-08-29,Cote_dIvoire,CI,95,0,25716554,Africa,17797,115
2020-08-30,Cote_dIvoire,CI,96,0,25716554,Africa,17893,115
2020-08-31,Cote_dIvoire,CI,55,0,25716554,Africa,17948,115
2020-09-01,Cote_dIvoire,CI,119,2,25716554,Africa,18067,117
2020-09-02,Cote_dIvoire,CI,36,0,25716554,Africa,18103,117
2020-09-03,Cote_dIvoire,CI,58,0,25716554,Africa,18161,117
2020-09-04,Cote_dIvoire,CI,47,2,25716554,Africa,18208,119
2020-09-05,Cote_dIvoire,CI,61,0,25716554,Africa,18269,119
2020-09-06,Cote_dIvoire,CI,203,0,25716554,Africa,18472,119
2020-09-07,Cote_dIvoire,CI,116,0,25716554,Africa,18588,119
2020-09-08,Cote_dIvoire,CI,113,0,25716554,Africa,18701,119
2020-09-09,Cote_dIvoire,CI,77,0,25716554,Africa,18778,119
2020-09-10,Cote_dIvoire,CI,37,0,25716554,Africa,18815,119
2020-09-11,Cote_dIvoire,CI,54,0,25716554,Africa,18869,119
2020-09-12,Cote_dIvoire,CI,47,0,25716554,Africa,18916,119
2020-09-13,Cote_dIvoire,CI,71,1,25716554,Africa,18987,120
2020-09-14,Cote_dIvoire,CI,26,0,25716554,Africa,19013,120
2020-09-15,Cote_dIvoire,CI,53,0,25716554,Africa,19066,120
2020-09-16,Cote_dIvoire,CI,34,0,25716554,Africa,19100,120
2020-09-17,Cote_dIvoire,CI,32,0,25716554,Africa,19132,120
2020-09-18,Cote_dIvoire,CI,26,0,25716554,Africa,19158,120
2020-09-19,Cote_dIvoire,CI,42,0,25716554,Africa,19200,120
2020-09-20,Cote_dIvoire,CI,69,0,25716554,Africa,19269,120
2020-09-21,Cote_dIvoire,CI,51,0,25716554,Africa,19320,120
2020-09-22,Cote_dIvoire,CI,7,0,25716554,Africa,19327,120
2020-09-23,Cote_dIvoire,CI,16,0,25716554,Africa,19343,120
2020-09-24,Cote_dIvoire,CI,87,0,25716554,Africa,19430,120
2020-09-25,Cote_dIvoire,CI,71,0,25716554,Africa,19501,120
2020-09-26,Cote_dIvoire,CI,55,0,25716554,Africa,19556,120
2020-09-27,Cote_dIvoire,CI,44,0,25716554,Africa,19600,120
2020-09-28,Cote_dIvoire,CI,29,0,25716554,Africa,19629,120
2020-09-29,Cote_dIvoire,CI,12,0,25716554,Africa,19641,120
2020-09-30,Cote_dIvoire,CI,28,0,25716554,Africa,19669,120
2020-10-01,Cote_dIvoire,CI,55,0,25716554,Africa,19724,120
2020-10-02,Cote_dIvoire,CI,31,0,25716554,Africa,19755,120
2020-10-03,Cote_dIvoire,CI,38,0,25716554,Africa,19793,120
2020-10-04,Cote_dIvoire,CI,56,0,25716554,Africa,19849,120
2020-10-05,Cote_dIvoire,CI,33,0,25716554,Africa,19882,120
2020-10-06,Cote_dIvoire,CI,3,0,25716554,Africa,19885,120
2020-10-07,Cote_dIvoire,CI,18,0,25716554,Africa,19903,120
2020-10-08,Cote_dIvoire,CI,32,0,25716554,Africa,19935,120
2020-10-09,Cote_dIvoire,CI,47,0,25716554,Africa,19982,120
2020-10-10,Cote_dIvoire,CI,54,0,25716554,Africa,20036,120
2020-10-11,Cote_dIvoire,CI,92,0,25716554,Africa,20128,120
2020-10-12,Cote_dIvoire,CI,26,0,25716554,Africa,20154,120
2020-10-13,Cote_dIvoire,CI,1,0,25716554,Africa,20155,120
2020-10-14,Cote_dIvoire,CI,28,0,25716554,Africa,20183,120
2020-10-15,Cote_dIvoire,CI,34,1,25716554,Africa,20217,121
2020-10-16,Cote_dIvoire,CI,40,0,25716554,Africa,20257,121
2020-10-17,Cote_dIvoire,CI,18,0,25716554,Africa,20275,121
2020-10-18,Cote_dIvoire,CI,26,0,25716554,Africa,20301,121
2020-10-19,Cote_dIvoire,CI,22,0,25716554,Africa,20323,121
2020-10-20,Cote_dIvoire,CI,1,0,25716554,Africa,20324,121
2020-10-21,Cote_dIvoire,CI,18,0,25716554,Africa,20342,121
2020-10-22,Cote_dIvoire,CI,21,0,25716554,Africa,20363,121
2020-10-23,Cote_dIvoire,CI,27,0,25716554,Africa,20390,121
2020-10-24,Cote_dIvoire,CI,15,0,25716554,Africa,20405,121
2020-10-25,Cote_dIvoire,CI,24,0,25716554,Africa,20429,121
2020-10-26,Cote_dIvoire,CI,41,1,25716554,Africa,20470,122
2020-10-27,Cote_dIvoire,CI,16,0,25716554,Africa,20486,122
2020-10-28,Cote_dIvoire,CI,2,0,25716554,Africa,20488,122
2020-10-29,Cote_dIvoire,CI,67,2,25716554,Africa,20555,124
2020-10-30,Cote_dIvoire,CI,73,0,25716554,Africa,20628,124
2020-10-31,Cote_dIvoire,CI,64,0,25716554,Africa,20692,124
2020-11-01,Cote_dIvoire,CI,24,2,25716554,Africa,20716,126
2020-11-02,Cote_dIvoire,CI,0,0,25716554,Africa,20716,126
2020-11-03,Cote_dIvoire,CI,37,0,25716554,Africa,20753,126
2020-11-04,Cote_dIvoire,CI,12,0,25716554,Africa,20765,126
2020-11-05,Cote_dIvoire,CI,13,0,25716554,Africa,20778,126
2020-11-06,Cote_dIvoire,CI,11,0,25716554,Africa,20789,126
2020-11-07,Cote_dIvoire,CI,12,0,25716554,Africa,20801,126
2020-11-08,Cote_dIvoire,CI,12,0,25716554,Africa,20813,126
2020-11-09,Cote_dIvoire,CI,19,0,25716554,Africa,20832,126
2020-11-10,Cote_dIvoire,CI,3,0,25716554,Africa,20835,126
2020-11-11,Cote_dIvoire,CI,12,0,25716554,Africa,20847,126
2020-11-12,Cote_dIvoire,CI,8,1,25716554,Africa,20855,127
2020-11-13,Cote_dIvoire,CI,27,0,25716554,Africa,20882,127
2020-11-14,Cote_dIvoire,CI,17,0,25716554,Africa,20899,127
2020-11-15,Cote_dIvoire,CI,46,1,25716554,Africa,20945,128
2020-11-16,Cote_dIvoire,CI,31,0,25716554,Africa,20976,128
2020-11-17,Cote_dIvoire,CI,12,0,25716554,Africa,20988,128
2020-11-18,Cote_dIvoire,CI,16,1,25716554,Africa,21004,129
2020-11-19,Cote_dIvoire,CI,41,0,25716554,Africa,21045,129
2020-11-20,Cote_dIvoire,CI,38,0,25716554,Africa,21083,129
2020-11-21,Cote_dIvoire,CI,16,0,25716554,Africa,21099,129
2020-11-22,Cote_dIvoire,CI,27,0,25716554,Africa,21126,129
2020-11-23,Cote_dIvoire,CI,12,2,25716554,Africa,21138,131
2020-11-24,Cote_dIvoire,CI,10,0,25716554,Africa,21148,131
2020-11-25,Cote_dIvoire,CI,8,0,25716554,Africa,21156,131
2020-11-26,Cote_dIvoire,CI,12,0,25716554,Africa,21168,131
2020-11-27,Cote_dIvoire,CI,31,0,25716554,Africa,21199,131
2020-11-28,Cote_dIvoire,CI,33,0,25716554,Africa,21232,131
2020-11-29,Cote_dIvoire,CI,29,0,25716554,Africa,21261,131
2020-11-30,Cote_dIvoire,CI,49,0,25716554,Africa,21310,131
2020-12-01,Cote_dIvoire,CI,21,1,25716554,Africa,21331,132
2020-12-02,Cote_dIvoire,CI,3,0,25716554,Africa,21334,132
2020-12-03,Cote_dIvoire,CI,27,0,25716554,Africa,21361,132
2020-12-04,Cote_dIvoire,CI,28,0,25716554,Africa,21389,132
2020-12-05,Cote_dIvoire,CI,23,0,25716554,Africa,21412,132
2020-12-06,Cote_dIvoire,CI,29,0,25716554,Africa,21441,132
2020-12-07,Cote_dIvoire,CI,44,0,25716554,Africa,21485,132
2020-12-08,Cote_dIvoire,CI,22,0,25716554,Africa,21507,132
2020-12-09,Cote_dIvoire,CI,6,0,25716554,Africa,21513,132
2020-12-10,Cote_dIvoire,CI,34,1,25716554,Africa,21547,133
2020-12-11,Cote_dIvoire,CI,43,0,25716554,Africa,21590,133
2020-12-12,Cote_dIvoire,CI,28,0,25716554,Africa,21618,133
2020-12-13,Cote_dIvoire,CI,21,0,25716554,Africa,21639,133
2020-12-14,Cote_dIvoire,CI,41,0,25716554,Africa,21680,133
2020-03-04,Chile,CL,1,0,18952035,America,1,0
2020-03-05,Chile,CL,2,0,18952035,America,3,0
2020-03-06,Chile,CL,1,0,18952035,America,4,0
2020-03-07,Chile,CL,1,0,18952035,America,5,0
2020-03-09,Chile,CL,5,0,18952035,America,10,0
2020-03-10,Chile,CL,3,0,18952035,America,13,0
2020-03-11,Chile,CL,4,0,18952035,America,17,0
2020-03-12,Chile,CL,6,0,18952035,America,23,0
2020-03-13,Chile,CL,10,0,18952035,America,33,0
2020-03-14,Chile,CL,10,0,18952035,America,43,0
2020-03-15,Chile,CL,18,0,18952035,America,61,0
2020-03-16,Chile,CL,14,0,18952035,America,75,0
2020-03-17,Chile,CL,81,0,18952035,America,156,0
2020-03-18,Chile,CL,45,0,18952035,America,201,0
2020-03-19,Chile,CL,37,0,18952035,America,238,0
2020-03-20,Chile,CL,104,0,18952035,America,342,0
2020-03-21,Chile,CL,92,0,18952035,America,434,0
2020-03-22,Chile,CL,103,0,18952035,America,537,0
2020-03-23,Chile,CL,95,1,18952035,America,632,1
2020-03-24,Chile,CL,114,1,18952035,America,746,2
2020-03-25,Chile,CL,176,0,18952035,America,922,2
2020-03-26,Chile,CL,220,1,18952035,America,1142,3
2020-03-27,Chile,CL,164,1,18952035,America,1306,4
2020-03-28,Chile,CL,304,1,18952035,America,1610,5
2020-03-29,Chile,CL,299,1,18952035,America,1909,6
2020-03-30,Chile,CL,230,1,18952035,America,2139,7
2020-03-31,Chile,CL,310,1,18952035,America,2449,8
2020-04-01,Chile,CL,289,4,18952035,America,2738,12
2020-04-02,Chile,CL,293,4,18952035,America,3031,16
2020-04-03,Chile,CL,373,2,18952035,America,3404,18
2020-04-04,Chile,CL,333,4,18952035,America,3737,22
2020-04-05,Chile,CL,424,5,18952035,America,4161,27
2020-04-06,Chile,CL,310,7,18952035,America,4471,34
2020-04-07,Chile,CL,344,3,18952035,America,4815,37
2020-04-08,Chile,CL,301,6,18952035,America,5116,43
2020-04-09,Chile,CL,430,5,18952035,America,5546,48
2020-04-10,Chile,CL,426,9,18952035,America,5972,57
2020-04-11,Chile,CL,529,8,18952035,America,6501,65
2020-04-12,Chile,CL,426,8,18952035,America,6927,73
2020-04-13,Chile,CL,286,7,18952035,America,7213,80
2020-04-14,Chile,CL,312,2,18952035,America,7525,82
2020-04-15,Chile,CL,392,10,18952035,America,7917,92
2020-04-16,Chile,CL,356,2,18952035,America,8273,94
2020-04-17,Chile,CL,534,11,18952035,America,8807,105
2020-04-18,Chile,CL,445,11,18952035,America,9252,116
2020-04-19,Chile,CL,478,10,18952035,America,9730,126
2020-04-20,Chile,CL,358,7,18952035,America,10088,133
2020-04-21,Chile,CL,419,6,18952035,America,10507,139
2020-04-22,Chile,CL,325,8,18952035,America,10832,147
2020-04-23,Chile,CL,464,13,18952035,America,11296,160
2020-04-24,Chile,CL,516,8,18952035,America,11812,168
2020-04-25,Chile,CL,494,6,18952035,America,12306,174
2020-04-26,Chile,CL,552,7,18952035,America,12858,181
2020-04-27,Chile,CL,473,8,18952035,America,13331,189
2020-04-28,Chile,CL,482,9,18952035,America,13813,198
2020-04-29,Chile,CL,552,9,18952035,America,14365,207
2020-04-30,Chile,CL,520,9,18952035,America,14885,216
2020-05-01,Chile,CL,1138,11,18952035,America,16023,227
2020-05-02,Chile,CL,985,7,18952035,America,17008,234
2020-05-03,Chile,CL,1427,13,18952035,America,18435,247
2020-05-04,Chile,CL,1228,13,18952035,America,19663,260
2020-05-05,Chile,CL,980,10,18952035,America,20643,270
2020-05-06,Chile,CL,1373,5,18952035,America,22016,275
2020-05-07,Chile,CL,1032,6,18952035,America,23048,281
2020-05-08,Chile,CL,1533,4,18952035,America,24581,285
2020-05-09,Chile,CL,1391,9,18952035,America,25972,294
2020-05-10,Chile,CL,1247,10,18952035,America,27219,304
2020-05-11,Chile,CL,1647,8,18952035,America,28866,312
2020-05-12,Chile,CL,1197,11,18952035,America,30063,323
2020-05-13,Chile,CL,1658,12,18952035,America,31721,335
2020-05-14,Chile,CL,2660,11,18952035,America,34381,346
2020-05-15,Chile,CL,2659,12,18952035,America,37040,358
2020-05-16,Chile,CL,2502,36,18952035,America,39542,394
2020-05-17,Chile,CL,1886,27,18952035,America,41428,421
2020-05-18,Chile,CL,2353,29,18952035,America,43781,450
2020-05-19,Chile,CL,2278,28,18952035,America,46059,478
2020-05-20,Chile,CL,3520,31,18952035,America,49579,509
2020-05-21,Chile,CL,4038,35,18952035,America,53617,544
2020-05-22,Chile,CL,3964,45,18952035,America,57581,589
2020-05-23,Chile,CL,4276,41,18952035,America,61857,630
2020-05-24,Chile,CL,3536,43,18952035,America,65393,673
2020-05-25,Chile,CL,3709,45,18952035,America,69102,718
2020-05-26,Chile,CL,4895,43,18952035,America,73997,761
2020-05-27,Chile,CL,3964,45,18952035,America,77961,806
2020-05-28,Chile,CL,4328,35,18952035,America,82289,841
2020-05-29,Chile,CL,4654,49,18952035,America,86943,890
2020-05-30,Chile,CL,3695,54,18952035,America,90638,944
2020-05-31,Chile,CL,4220,53,18952035,America,94858,997
2020-06-01,Chile,CL,4830,57,18952035,America,99688,1054
2020-06-02,Chile,CL,5471,59,18952035,America,105159,1113
2020-06-03,Chile,CL,3527,75,18952035,America,108686,1188
2020-06-04,Chile,CL,4942,87,18952035,America,113628,1275
2020-06-05,Chile,CL,4664,81,18952035,America,118292,1356
2020-06-06,Chile,CL,4207,92,18952035,America,122499,1448
2020-06-07,Chile,CL,5246,93,18952035,America,127745,1541
2020-06-08,Chile,CL,6405,649,18952035,America,134150,2190
2020-06-09,Chile,CL,4696,74,18952035,America,138846,2264
2020-06-10,Chile,CL,3913,19,18952035,America,142759,2283
2020-06-11,Chile,CL,5737,192,18952035,America,148496,2475
2020-06-12,Chile,CL,5596,173,18952035,America,154092,2648
2020-06-13,Chile,CL,6754,222,18952035,America,160846,2870
2020-06-14,Chile,CL,6509,231,18952035,America,167355,3101
2020-06-15,Chile,CL,6938,222,18952035,America,174293,3323
2020-06-16,Chile,CL,5143,39,18952035,America,179436,3362
2020-06-17,Chile,CL,5013,21,18952035,America,184449,3383
2020-06-18,Chile,CL,36179,232,18952035,America,220628,3615
2020-06-19,Chile,CL,4475,226,18952035,America,225103,3841
2020-06-20,Chile,CL,6290,252,18952035,America,231393,4093
2020-06-21,Chile,CL,5355,202,18952035,America,236748,4295
2020-06-22,Chile,CL,5607,184,18952035,America,242355,4479
2020-06-23,Chile,CL,4608,23,18952035,America,246963,4502
2020-06-24,Chile,CL,3804,3,18952035,America,250767,4505
2020-06-25,Chile,CL,3649,226,18952035,America,254416,4731
2020-06-26,Chile,CL,4648,172,18952035,America,259064,4903
2020-06-27,Chile,CL,4296,165,18952035,America,263360,5068
2020-06-28,Chile,CL,4406,279,18952035,America,267766,5347
2020-06-29,Chile,CL,4216,162,18952035,America,271982,5509
2020-06-30,Chile,CL,4017,66,18952035,America,275999,5575
2020-07-01,Chile,CL,3394,113,18952035,America,279393,5688
2020-07-02,Chile,CL,2650,65,18952035,America,282043,5753
2020-07-03,Chile,CL,2498,167,18952035,America,284541,5920
2020-07-04,Chile,CL,3548,131,18952035,America,288089,6051
2020-07-05,Chile,CL,3758,141,18952035,America,291847,6192
2020-07-06,Chile,CL,3685,116,18952035,America,295532,6308
2020-07-07,Chile,CL,3025,76,18952035,America,298557,6384
2020-07-08,Chile,CL,2462,50,18952035,America,301019,6434
2020-07-09,Chile,CL,2064,139,18952035,America,303083,6573
2020-07-10,Chile,CL,3133,109,18952035,America,306216,6682
2020-07-11,Chile,CL,3058,99,18952035,America,309274,6781
2020-07-12,Chile,CL,2755,100,18952035,America,312029,6881
2020-07-13,Chile,CL,3012,98,18952035,America,315041,6979
2020-07-14,Chile,CL,2616,45,18952035,America,317657,7024
2020-07-15,Chile,CL,1836,45,18952035,America,319493,7069
2020-07-16,Chile,CL,1712,117,18952035,America,321205,7186
2020-07-17,Chile,CL,2493,104,18952035,America,323698,7290
2020-07-18,Chile,CL,2841,1057,18952035,America,326539,8347
2020-07-19,Chile,CL,2307,98,18952035,America,328846,8445
2020-07-20,Chile,CL,2084,58,18952035,America,330930,8503
2020-07-21,Chile,CL,2099,130,18952035,America,333029,8633
2020-07-22,Chile,CL,1654,44,18952035,America,334683,8677
2020-07-23,Chile,CL,1719,45,18952035,America,336402,8722
2020-07-24,Chile,CL,2357,116,18952035,America,338759,8838
2020-07-25,Chile,CL,2545,76,18952035,America,341304,8914
2020-07-26,Chile,CL,2288,106,18952035,America,343592,9020
2020-07-27,Chile,CL,2198,92,18952035,America,345790,9112
2020-07-28,Chile,CL,2133,75,18952035,America,347923,9187
2020-07-29,Chile,CL,1877,53,18952035,America,349800,9240
2020-07-30,Chile,CL,1775,38,18952035,America,351575,9278
2020-07-31,Chile,CL,1961,99,18952035,America,353536,9377
2020-08-01,Chile,CL,2131,80,18952035,America,355667,9457
2020-08-02,Chile,CL,1991,76,18952035,America,357658,9533
2020-08-03,Chile,CL,2073,75,18952035,America,359731,9608
2020-08-04,Chile,CL,1762,99,18952035,America,361493,9707
2020-08-05,Chile,CL,1469,38,18952035,America,362962,9745
2020-08-06,Chile,CL,1761,47,18952035,America,364723,9792
2020-08-07,Chile,CL,1948,97,18952035,America,366671,9889
2020-08-08,Chile,CL,2154,69,18952035,America,368825,9958
2020-08-09,Chile,CL,2198,53,18952035,America,371023,10011
2020-08-10,Chile,CL,2033,66,18952035,America,373056,10077
2020-08-11,Chile,CL,1988,62,18952035,America,375044,10139
2020-08-12,Chile,CL,1572,39,18952035,America,376616,10178
2020-08-13,Chile,CL,1552,27,18952035,America,378168,10205
2020-08-14,Chile,CL,1866,94,18952035,America,380034,10299
2020-08-15,Chile,CL,2077,41,18952035,America,382111,10340
2020-08-16,Chile,CL,1791,55,18952035,America,383902,10395
2020-08-17,Chile,CL,2044,57,18952035,America,385946,10452
2020-08-18,Chile,CL,1556,61,18952035,America,387502,10513
2020-08-19,Chile,CL,1353,33,18952035,America,388855,10546
2020-08-20,Chile,CL,1182,32,18952035,America,390037,10578
2020-08-21,Chile,CL,1812,93,18952035,America,391849,10671
2020-08-22,Chile,CL,1920,52,18952035,America,393769,10723
2020-08-23,Chile,CL,1939,69,18952035,America,395708,10792
2020-08-24,Chile,CL,1957,60,18952035,America,397665,10852
2020-08-25,Chile,CL,1903,64,18952035,America,399568,10916
2020-08-26,Chile,CL,1417,42,18952035,America,400985,10958
2020-08-27,Chile,CL,1380,32,18952035,America,402365,10990
2020-08-28,Chile,CL,1737,82,18952035,America,404102,11072
2020-08-29,Chile,CL,1870,60,18952035,America,405972,11132
2020-08-30,Chile,CL,2037,49,18952035,America,408009,11181
2020-08-31,Chile,CL,1965,63,18952035,America,409974,11244
2020-09-01,Chile,CL,1752,45,18952035,America,411726,11289
2020-09-02,Chile,CL,1419,32,18952035,America,413145,11321
2020-09-03,Chile,CL,1594,23,18952035,America,414739,11344
2020-09-04,Chile,CL,1762,78,18952035,America,416501,11422
2020-09-05,Chile,CL,1968,72,18952035,America,418469,11494
2020-09-06,Chile,CL,1965,57,18952035,America,420434,11551
2020-09-07,Chile,CL,2076,41,18952035,America,422510,11592
2020-09-08,Chile,CL,1764,60,18952035,America,424274,11652
2020-09-09,Chile,CL,1267,30,18952035,America,425541,11682
2020-09-10,Chile,CL,1486,20,18952035,America,427027,11702
2020-09-11,Chile,CL,1642,79,18952035,America,428669,11781
2020-09-12,Chile,CL,1866,69,18952035,America,430535,11850
2020-09-13,Chile,CL,2131,45,18952035,America,432666,11895
2020-09-14,Chile,CL,2082,54,18952035,America,434748,11949
2020-09-15,Chile,CL,1685,64,18952035,America,436433,12013
2020-09-16,Chile,CL,1550,27,18952035,America,437983,12040
2020-09-17,Chile,CL,1304,18,18952035,America,439287,12058
2020-09-18,Chile,CL,1863,84,18952035,America,441150,12142
2020-09-19,Chile,CL,1677,57,18952035,America,442827,12199
2020-09-20,Chile,CL,1847,55,18952035,America,444674,12254
2020-09-21,Chile,CL,1600,32,18952035,America,446274,12286
2020-09-22,Chile,CL,1194,12,18952035,America,447468,12298
2020-09-23,Chile,CL,1055,23,18952035,America,448523,12321
2020-09-24,Chile,CL,1380,24,18952035,America,449903,12345
2020-09-25,Chile,CL,1731,124,18952035,America,451634,12469
2020-09-26,Chile,CL,2234,58,18952035,America,453868,12527
2020-09-27,Chile,CL,2111,64,18952035,America,455979,12591
2020-09-28,Chile,CL,1922,50,18952035,America,457901,12641
2020-09-29,Chile,CL,1770,57,18952035,America,459671,12698
2020-09-30,Chile,CL,1629,27,18952035,America,461300,12725
2020-10-01,Chile,CL,1691,16,18952035,America,462991,12741
2020-10-02,Chile,CL,1759,81,18952035,America,464750,12822
2020-10-03,Chile,CL,1840,45,18952035,America,466590,12867
2020-10-04,Chile,CL,1881,52,18952035,America,468471,12919
2020-10-05,Chile,CL,1708,60,18952035,America,470179,12979
2020-10-06,Chile,CL,1567,58,18952035,America,471746,13037
2020-10-07,Chile,CL,1560,33,18952035,America,473306,13070
2020-10-08,Chile,CL,1134,20,18952035,America,474440,13090
2020-10-09,Chile,CL,1576,77,18952035,America,476016,13167
2020-10-10,Chile,CL,1753,53,18952035,America,477769,13220
2020-10-11,Chile,CL,1826,52,18952035,America,479595,13272
2020-10-12,Chile,CL,1776,46,18952035,America,481371,13318
2020-10-13,Chile,CL,1517,61,18952035,America,482888,13379
2020-10-14,Chile,CL,1392,17,18952035,America,484280,13396
2020-10-15,Chile,CL,1092,19,18952035,America,485372,13415
2020-10-16,Chile,CL,1124,19,18952035,America,486496,13434
2020-10-17,Chile,CL,1694,95,18952035,America,488190,13529
2020-10-18,Chile,CL,1813,59,18952035,America,490003,13588
2020-10-19,Chile,CL,1757,47,18952035,America,491760,13635
2020-10-20,Chile,CL,1545,41,18952035,America,493305,13676
2020-10-21,Chile,CL,1173,26,18952035,America,494478,13702
2020-10-22,Chile,CL,1159,17,18952035,America,495637,13719
2020-10-23,Chile,CL,1494,73,18952035,America,497131,13792
2020-10-24,Chile,CL,1775,52,18952035,America,498906,13844
2020-10-25,Chile,CL,1636,48,18952035,America,500542,13892
2020-10-26,Chile,CL,1521,52,18952035,America,502063,13944
2020-10-27,Chile,CL,1535,59,18952035,America,503598,14003
2020-10-28,Chile,CL,927,23,18952035,America,504525,14026
2020-10-29,Chile,CL,1005,6,18952035,America,505530,14032
2020-10-30,Chile,CL,1520,86,18952035,America,507050,14118
2020-10-31,Chile,CL,1521,40,18952035,America,508571,14158
2020-11-01,Chile,CL,1685,49,18952035,America,510256,14207
2020-11-02,Chile,CL,1608,40,18952035,America,511864,14247
2020-11-03,Chile,CL,1324,55,18952035,America,513188,14302
2020-11-04,Chile,CL,1014,17,18952035,America,514202,14319
2020-11-05,Chile,CL,840,21,18952035,America,515042,14340
2020-11-06,Chile,CL,1540,64,18952035,America,516582,14404
2020-11-07,Chile,CL,1808,46,18952035,America,518390,14450
2020-11-08,Chile,CL,1587,49,18952035,America,519977,14499
2020-11-09,Chile,CL,1581,44,18952035,America,521558,14543
2020-11-10,Chile,CL,1321,45,18952035,America,522879,14588
2020-11-11,Chile,CL,1028,23,18952035,America,523907,14611
2020-11-12,Chile,CL,897,22,18952035,America,524804,14633
2020-11-13,Chile,CL,1634,66,18952035,America,526438,14699
2020-11-14,Chile,CL,1592,39,18952035,America,528030,14738
2020-11-15,Chile,CL,1646,39,18952035,America,529676,14777
2020-11-16,Chile,CL,1597,42,18952035,America,531273,14819
2020-11-17,Chile,CL,1331,44,18952035,America,532604,14863
2020-11-18,Chile,CL,1006,20,18952035,America,533610,14883
2020-11-19,Chile,CL,948,14,18952035,America,534558,14897
2020-11-20,Chile,CL,1454,58,18952035,America,536012,14955
2020-11-21,Chile,CL,1573,48,18952035,America,537585,15003
2020-11-22,Chile,CL,1558,27,18952035,America,539143,15030
2020-11-23,Chile,CL,1497,39,18952035,America,540640,15069
2020-11-24,Chile,CL,1440,37,18952035,America,542080,15106
2020-11-25,Chile,CL,1007,25,18952035,America,543087,15131
2020-11-26,Chile,CL,1005,7,18952035,America,544092,15138
2020-11-27,Chile,CL,1570,97,18952035,America,545662,15235
2020-11-28,Chile,CL,1561,43,18952035,America,547223,15278
2020-11-29,Chile,CL,1718,44,18952035,America,548941,15322
2020-11-30,Chile,CL,1489,34,18952035,America,550430,15356
2020-12-01,Chile,CL,1313,54,18952035,America,551743,15410
2020-12-02,Chile,CL,1121,20,18952035,America,552864,15430
2020-12-03,Chile,CL,1034,8,18952035,America,553898,15438
2020-12-04,Chile,CL,1508,81,18952035,America,555406,15519
2020-12-05,Chile,CL,1729,39,18952035,America,557135,15558
2020-12-06,Chile,CL,1533,34,18952035,America,558668,15592
2020-12-07,Chile,CL,1714,36,18952035,America,560382,15628
2020-12-08,Chile,CL,1760,35,18952035,America,562142,15663
2020-12-09,Chile,CL,1392,17,18952035,America,563534,15680
2020-12-10,Chile,CL,1244,10,18952035,America,564778,15690
2020-12-11,Chile,CL,1662,84,18952035,America,566440,15774
2020-12-12,Chile,CL,1534,8,18952035,America,567974,15782
2020-12-13,Chile,CL,1807,64,18952035,America,569781,15846
2020-12-14,Chile,CL,2138,40,18952035,America,571919,15886
2020-03-07,Cameroon,CM,1,0,25876387,Africa,1,0
2020-03-09,Cameroon,CM,1,0,25876387,Africa,2,0
2020-03-15,Cameroon,CM,1,0,25876387,Africa,3,0
2020-03-16,Cameroon,CM,1,0,25876387,Africa,4,0
2020-03-17,Cameroon,CM,0,0,25876387,Africa,4,0
2020-03-18,Cameroon,CM,6,0,25876387,Africa,10,0
2020-03-19,Cameroon,CM,0,0,25876387,Africa,10,0
2020-03-20,Cameroon,CM,4,0,25876387,Africa,14,0
2020-03-21,Cameroon,CM,13,0,25876387,Africa,27,0
2020-03-22,Cameroon,CM,0,0,25876387,Africa,27,0
2020-03-23,Cameroon,CM,0,0,25876387,Africa,27,0
2020-03-24,Cameroon,CM,29,0,25876387,Africa,56,0
2020-03-25,Cameroon,CM,16,1,25876387,Africa,72,1
2020-03-26,Cameroon,CM,0,0,25876387,Africa,72,1
2020-03-27,Cameroon,CM,16,0,25876387,Africa,88,1
2020-03-28,Cameroon,CM,0,0,25876387,Africa,88,1
2020-03-29,Cameroon,CM,11,1,25876387,Africa,99,2
2020-03-30,Cameroon,CM,0,0,25876387,Africa,99,2
2020-03-31,Cameroon,CM,43,0,25876387,Africa,142,2
2020-04-01,Cameroon,CM,51,4,25876387,Africa,193,6
2020-04-02,Cameroon,CM,40,0,25876387,Africa,233,6
2020-04-03,Cameroon,CM,38,1,25876387,Africa,271,7
2020-04-04,Cameroon,CM,238,1,25876387,Africa,509,8
2020-04-05,Cameroon,CM,46,1,25876387,Africa,555,9
2020-04-06,Cameroon,CM,95,0,25876387,Africa,650,9
2020-04-07,Cameroon,CM,8,0,25876387,Africa,658,9
2020-04-08,Cameroon,CM,27,0,25876387,Africa,685,9
2020-04-09,Cameroon,CM,45,1,25876387,Africa,730,10
2020-04-10,Cameroon,CM,0,0,25876387,Africa,730,10
2020-04-11,Cameroon,CM,73,0,25876387,Africa,803,10
2020-04-12,Cameroon,CM,17,1,25876387,Africa,820,11
2020-04-13,Cameroon,CM,0,1,25876387,Africa,820,12
2020-04-14,Cameroon,CM,0,0,25876387,Africa,820,12
2020-04-15,Cameroon,CM,35,5,25876387,Africa,855,17
2020-04-16,Cameroon,CM,0,0,25876387,Africa,855,17
2020-04-17,Cameroon,CM,0,4,25876387,Africa,855,21
2020-04-18,Cameroon,CM,161,0,25876387,Africa,1016,21
2020-04-19,Cameroon,CM,0,0,25876387,Africa,1016,21
2020-04-20,Cameroon,CM,0,21,25876387,Africa,1016,42
2020-04-21,Cameroon,CM,1,0,25876387,Africa,1017,42
2020-04-22,Cameroon,CM,146,0,25876387,Africa,1163,42
2020-04-23,Cameroon,CM,0,1,25876387,Africa,1163,43
2020-04-24,Cameroon,CM,238,6,25876387,Africa,1401,49
2020-04-25,Cameroon,CM,2,0,25876387,Africa,1403,49
2020-04-26,Cameroon,CM,115,4,25876387,Africa,1518,53
2020-04-27,Cameroon,CM,103,3,25876387,Africa,1621,56
2020-04-28,Cameroon,CM,0,2,25876387,Africa,1621,58
2020-04-29,Cameroon,CM,185,1,25876387,Africa,1806,59
2020-04-30,Cameroon,CM,26,2,25876387,Africa,1832,61
2020-05-01,Cameroon,CM,0,0,25876387,Africa,1832,61
2020-05-02,Cameroon,CM,237,0,25876387,Africa,2069,61
2020-05-03,Cameroon,CM,8,3,25876387,Africa,2077,64
2020-05-04,Cameroon,CM,0,0,25876387,Africa,2077,64
2020-05-05,Cameroon,CM,27,0,25876387,Africa,2104,64
2020-05-06,Cameroon,CM,0,0,25876387,Africa,2104,64
2020-05-07,Cameroon,CM,161,44,25876387,Africa,2265,108
2020-05-08,Cameroon,CM,0,0,25876387,Africa,2265,108
2020-05-09,Cameroon,CM,0,0,25876387,Africa,2265,108
2020-05-10,Cameroon,CM,9,0,25876387,Africa,2274,108
2020-05-11,Cameroon,CM,305,6,25876387,Africa,2579,114
2020-05-12,Cameroon,CM,110,11,25876387,Africa,2689,125
2020-05-13,Cameroon,CM,0,0,25876387,Africa,2689,125
2020-05-14,Cameroon,CM,111,11,25876387,Africa,2800,136
2020-05-15,Cameroon,CM,154,3,25876387,Africa,2954,139
2020-05-16,Cameroon,CM,151,1,25876387,Africa,3105,140
2020-05-17,Cameroon,CM,187,0,25876387,Africa,3292,140
2020-05-18,Cameroon,CM,0,0,25876387,Africa,3292,140
2020-05-19,Cameroon,CM,0,0,25876387,Africa,3292,140
2020-05-20,Cameroon,CM,237,0,25876387,Africa,3529,140
2020-05-21,Cameroon,CM,204,6,25876387,Africa,3733,146
2020-05-22,Cameroon,CM,555,10,25876387,Africa,4288,156
2020-05-23,Cameroon,CM,112,3,25876387,Africa,4400,159
2020-05-24,Cameroon,CM,197,0,25876387,Africa,4597,159
2020-05-25,Cameroon,CM,293,6,25876387,Africa,4890,165
2020-05-26,Cameroon,CM,154,6,25876387,Africa,5044,171
2020-05-27,Cameroon,CM,312,4,25876387,Africa,5356,175
2020-05-28,Cameroon,CM,0,2,25876387,Africa,5356,177
2020-05-29,Cameroon,CM,0,0,25876387,Africa,5356,177
2020-05-30,Cameroon,CM,80,0,25876387,Africa,5436,177
2020-05-31,Cameroon,CM,468,14,25876387,Africa,5904,191
2020-06-01,Cameroon,CM,0,0,25876387,Africa,5904,191
2020-06-02,Cameroon,CM,493,8,25876387,Africa,6397,199
2020-06-03,Cameroon,CM,188,1,25876387,Africa,6585,200
2020-06-04,Cameroon,CM,167,0,25876387,Africa,6752,200
2020-06-05,Cameroon,CM,37,3,25876387,Africa,6789,203
2020-06-06,Cameroon,CM,810,0,25876387,Africa,7599,203
2020-06-07,Cameroon,CM,0,0,25876387,Africa,7599,203
2020-06-08,Cameroon,CM,309,0,25876387,Africa,7908,203
2020-06-09,Cameroon,CM,404,5,25876387,Africa,8312,208
2020-06-10,Cameroon,CM,369,0,25876387,Africa,8681,208
2020-06-11,Cameroon,CM,248,6,25876387,Africa,8929,214
2020-06-12,Cameroon,CM,0,0,25876387,Africa,8929,214
2020-06-13,Cameroon,CM,267,59,25876387,Africa,9196,273
2020-06-14,Cameroon,CM,376,2,25876387,Africa,9572,275
2020-06-15,Cameroon,CM,292,1,25876387,Africa,9864,276
2020-06-16,Cameroon,CM,0,0,25876387,Africa,9864,276
2020-06-17,Cameroon,CM,0,0,25876387,Africa,9864,276
2020-06-18,Cameroon,CM,0,0,25876387,Africa,9864,276
2020-06-19,Cameroon,CM,774,6,25876387,Africa,10638,282
2020-06-20,Cameroon,CM,643,18,25876387,Africa,11281,300
2020-06-21,Cameroon,CM,0,0,25876387,Africa,11281,300
2020-06-22,Cameroon,CM,329,1,25876387,Africa,11610,301
2020-06-23,Cameroon,CM,282,2,25876387,Africa,11892,303
2020-06-24,Cameroon,CM,149,5,25876387,Africa,12041,308
2020-06-25,Cameroon,CM,229,5,25876387,Africa,12270,313
2020-06-26,Cameroon,CM,322,0,25876387,Africa,12592,313
2020-06-27,Cameroon,CM,0,0,25876387,Africa,12592,313
2020-06-28,Cameroon,CM,0,0,25876387,Africa,12592,313
2020-06-29,Cameroon,CM,0,0,25876387,Africa,12592,313
2020-06-30,Cameroon,CM,0,0,25876387,Africa,12592,313
2020-07-01,Cameroon,CM,0,0,25876387,Africa,12592,313
2020-07-02,Cameroon,CM,0,0,25876387,Africa,12592,313
2020-07-03,Cameroon,CM,0,0,25876387,Africa,12592,313
2020-07-04,Cameroon,CM,0,0,25876387,Africa,12592,313
2020-07-05,Cameroon,CM,0,0,25876387,Africa,12592,313
2020-07-06,Cameroon,CM,1119,15,25876387,Africa,13711,328
2020-07-07,Cameroon,CM,326,2,25876387,Africa,14037,330
2020-07-08,Cameroon,CM,879,29,25876387,Africa,14916,359
2020-07-09,Cameroon,CM,0,0,25876387,Africa,14916,359
2020-07-10,Cameroon,CM,0,0,25876387,Africa,14916,359
2020-07-11,Cameroon,CM,0,0,25876387,Africa,14916,359
2020-07-12,Cameroon,CM,0,0,25876387,Africa,14916,359
2020-07-13,Cameroon,CM,257,0,25876387,Africa,15173,359
2020-07-14,Cameroon,CM,0,0,25876387,Africa,15173,359
2020-07-15,Cameroon,CM,0,0,25876387,Africa,15173,359
2020-07-16,Cameroon,CM,0,0,25876387,Africa,15173,359
2020-07-17,Cameroon,CM,984,14,25876387,Africa,16157,373
2020-07-18,Cameroon,CM,0,0,25876387,Africa,16157,373
2020-07-19,Cameroon,CM,0,0,25876387,Africa,16157,373
2020-07-20,Cameroon,CM,0,0,25876387,Africa,16157,373
2020-07-21,Cameroon,CM,0,0,25876387,Africa,16157,373
2020-07-22,Cameroon,CM,0,0,25876387,Africa,16157,373
2020-07-23,Cameroon,CM,365,9,25876387,Africa,16522,382
2020-07-24,Cameroon,CM,186,3,25876387,Africa,16708,385
2020-07-25,Cameroon,CM,0,0,25876387,Africa,16708,385
2020-07-26,Cameroon,CM,0,0,25876387,Africa,16708,385
2020-07-27,Cameroon,CM,0,0,25876387,Africa,16708,385
2020-07-28,Cameroon,CM,0,0,25876387,Africa,16708,385
2020-07-29,Cameroon,CM,0,0,25876387,Africa,16708,385
2020-07-30,Cameroon,CM,547,2,25876387,Africa,17255,387
2020-07-31,Cameroon,CM,0,0,25876387,Africa,17255,387
2020-08-01,Cameroon,CM,0,0,25876387,Africa,17255,387
2020-08-02,Cameroon,CM,0,0,25876387,Africa,17255,387
2020-08-03,Cameroon,CM,0,0,25876387,Africa,17255,387
2020-08-04,Cameroon,CM,0,0,25876387,Africa,17255,387
2020-08-05,Cameroon,CM,463,4,25876387,Africa,17718,391
2020-08-06,Cameroon,CM,0,0,25876387,Africa,17718,391
2020-08-07,Cameroon,CM,0,0,25876387,Africa,17718,391
2020-08-08,Cameroon,CM,0,0,25876387,Africa,17718,391
2020-08-09,Cameroon,CM,0,0,25876387,Africa,17718,391
2020-08-10,Cameroon,CM,324,4,25876387,Africa,18042,395
2020-08-11,Cameroon,CM,0,0,25876387,Africa,18042,395
2020-08-12,Cameroon,CM,171,3,25876387,Africa,18213,398
2020-08-13,Cameroon,CM,50,3,25876387,Africa,18263,401
2020-08-14,Cameroon,CM,45,0,25876387,Africa,18308,401
2020-08-15,Cameroon,CM,161,0,25876387,Africa,18469,401
2020-08-16,Cameroon,CM,0,0,25876387,Africa,18469,401
2020-08-17,Cameroon,CM,0,0,25876387,Africa,18469,401
2020-08-18,Cameroon,CM,113,2,25876387,Africa,18582,403
2020-08-19,Cameroon,CM,17,3,25876387,Africa,18599,406
2020-08-20,Cameroon,CM,25,0,25876387,Africa,18624,406
2020-08-21,Cameroon,CM,138,2,25876387,Africa,18762,408
2020-08-22,Cameroon,CM,0,0,25876387,Africa,18762,408
2020-08-23,Cameroon,CM,0,0,25876387,Africa,18762,408
2020-08-24,Cameroon,CM,0,0,25876387,Africa,18762,408
2020-08-25,Cameroon,CM,0,0,25876387,Africa,18762,408
2020-08-26,Cameroon,CM,211,2,25876387,Africa,18973,410
2020-08-27,Cameroon,CM,0,0,25876387,Africa,18973,410
2020-08-28,Cameroon,CM,169,1,25876387,Africa,19142,411
2020-08-29,Cameroon,CM,0,0,25876387,Africa,19142,411
2020-08-30,Cameroon,CM,0,0,25876387,Africa,19142,411
2020-08-31,Cameroon,CM,0,0,25876387,Africa,19142,411
2020-09-01,Cameroon,CM,0,0,25876387,Africa,19142,411
2020-09-02,Cameroon,CM,267,3,25876387,Africa,19409,414
2020-09-03,Cameroon,CM,51,0,25876387,Africa,19460,414
2020-09-04,Cameroon,CM,144,0,25876387,Africa,19604,414
2020-09-05,Cameroon,CM,0,0,25876387,Africa,19604,414
2020-09-06,Cameroon,CM,0,0,25876387,Africa,19604,414
2020-09-07,Cameroon,CM,0,0,25876387,Africa,19604,414
2020-09-08,Cameroon,CM,0,0,25876387,Africa,19604,414
2020-09-09,Cameroon,CM,0,0,25876387,Africa,19604,414
2020-09-10,Cameroon,CM,244,1,25876387,Africa,19848,415
2020-09-11,Cameroon,CM,161,0,25876387,Africa,20009,415
2020-09-12,Cameroon,CM,0,0,25876387,Africa,20009,415
2020-09-13,Cameroon,CM,0,0,25876387,Africa,20009,415
2020-09-14,Cameroon,CM,158,0,25876387,Africa,20167,415
2020-09-15,Cameroon,CM,61,0,25876387,Africa,20228,415
2020-09-16,Cameroon,CM,43,0,25876387,Africa,20271,415
2020-09-17,Cameroon,CM,32,0,25876387,Africa,20303,415
2020-09-18,Cameroon,CM,68,1,25876387,Africa,20371,416
2020-09-19,Cameroon,CM,0,0,25876387,Africa,20371,416
2020-09-20,Cameroon,CM,60,0,25876387,Africa,20431,416
2020-09-21,Cameroon,CM,0,0,25876387,Africa,20431,416
2020-09-22,Cameroon,CM,167,0,25876387,Africa,20598,416
2020-09-23,Cameroon,CM,0,0,25876387,Africa,20598,416
2020-09-24,Cameroon,CM,92,0,25876387,Africa,20690,416
2020-09-25,Cameroon,CM,22,2,25876387,Africa,20712,418
2020-09-26,Cameroon,CM,0,0,25876387,Africa,20712,418
2020-09-27,Cameroon,CM,23,0,25876387,Africa,20735,418
2020-09-28,Cameroon,CM,0,0,25876387,Africa,20735,418
2020-09-29,Cameroon,CM,103,0,25876387,Africa,20838,418
2020-09-30,Cameroon,CM,0,0,25876387,Africa,20838,418
2020-10-01,Cameroon,CM,0,0,25876387,Africa,20838,418
2020-10-02,Cameroon,CM,0,0,25876387,Africa,20838,418
2020-10-03,Cameroon,CM,86,2,25876387,Africa,20924,420
2020-10-04,Cameroon,CM,0,0,25876387,Africa,20924,420
2020-10-05,Cameroon,CM,0,0,25876387,Africa,20924,420
2020-10-06,Cameroon,CM,0,0,25876387,Africa,20924,420
2020-10-07,Cameroon,CM,0,0,25876387,Africa,20924,420
2020-10-08,Cameroon,CM,0,0,25876387,Africa,20924,420
2020-10-09,Cameroon,CM,279,3,25876387,Africa,21203,423
2020-10-10,Cameroon,CM,0,0,25876387,Africa,21203,423
2020-10-11,Cameroon,CM,0,0,25876387,Africa,21203,423
2020-10-12,Cameroon,CM,0,0,25876387,Africa,21203,423
2020-10-13,Cameroon,CM,0,0,25876387,Africa,21203,423
2020-10-14,Cameroon,CM,130,0,25876387,Africa,21333,423
2020-10-15,Cameroon,CM,108,0,25876387,Africa,21441,423
2020-10-16,Cameroon,CM,0,0,25876387,Africa,21441,423
2020-10-17,Cameroon,CM,0,0,25876387,Africa,21441,423
2020-10-18,Cameroon,CM,0,0,25876387,Africa,21441,423
2020-10-19,Cameroon,CM,0,0,25876387,Africa,21441,423
2020-10-20,Cameroon,CM,65,1,25876387,Africa,21506,424
2020-10-21,Cameroon,CM,64,1,25876387,Africa,21570,425
2020-10-22,Cameroon,CM,0,0,25876387,Africa,21570,425
2020-10-23,Cameroon,CM,0,0,25876387,Africa,21570,425
2020-10-24,Cameroon,CM,0,0,25876387,Africa,21570,425
2020-10-25,Cameroon,CM,0,0,25876387,Africa,21570,425
2020-10-26,Cameroon,CM,0,0,25876387,Africa,21570,425
2020-10-27,Cameroon,CM,223,1,25876387,Africa,21793,426
2020-10-28,Cameroon,CM,0,0,25876387,Africa,21793,426
2020-10-29,Cameroon,CM,0,0,25876387,Africa,21793,426
2020-10-30,Cameroon,CM,0,0,25876387,Africa,21793,426
2020-10-31,Cameroon,CM,0,0,25876387,Africa,21793,426
2020-11-01,Cameroon,CM,0,0,25876387,Africa,21793,426
2020-11-02,Cameroon,CM,0,0,25876387,Africa,21793,426
2020-11-03,Cameroon,CM,0,0,25876387,Africa,21793,426
2020-11-04,Cameroon,CM,310,3,25876387,Africa,22103,429
2020-11-05,Cameroon,CM,0,0,25876387,Africa,22103,429
2020-11-06,Cameroon,CM,0,0,25876387,Africa,22103,429
2020-11-07,Cameroon,CM,0,0,25876387,Africa,22103,429
2020-11-08,Cameroon,CM,239,0,25876387,Africa,22342,429
2020-11-09,Cameroon,CM,79,4,25876387,Africa,22421,433
2020-11-10,Cameroon,CM,0,0,25876387,Africa,22421,433
2020-11-11,Cameroon,CM,0,0,25876387,Africa,22421,433
2020-11-12,Cameroon,CM,0,0,25876387,Africa,22421,433
2020-11-13,Cameroon,CM,0,0,25876387,Africa,22421,433
2020-11-14,Cameroon,CM,0,0,25876387,Africa,22421,433
2020-11-15,Cameroon,CM,0,0,25876387,Africa,22421,433
2020-11-16,Cameroon,CM,271,0,25876387,Africa,22692,433
2020-11-17,Cameroon,CM,0,0,25876387,Africa,22692,433
2020-11-18,Cameroon,CM,204,0,25876387,Africa,22896,433
2020-11-19,Cameroon,CM,0,0,25876387,Africa,22896,433
2020-11-20,Cameroon,CM,0,0,25876387,Africa,22896,433
2020-11-21,Cameroon,CM,632,2,25876387,Africa,23528,435
2020-11-22,Cameroon,CM,0,0,25876387,Africa,23528,435
2020-11-23,Cameroon,CM,0,0,25876387,Africa,23528,435
2020-11-24,Cameroon,CM,0,0,25876387,Africa,23528,435
2020-11-25,Cameroon,CM,341,1,25876387,Africa,23869,436
2020-11-26,Cameroon,CM,46,1,25876387,Africa,23915,437
2020-11-27,Cameroon,CM,107,0,25876387,Africa,24022,437
2020-11-28,Cameroon,CM,95,0,25876387,Africa,24117,437
2020-11-29,Cameroon,CM,0,0,25876387,Africa,24117,437
2020-11-30,Cameroon,CM,0,0,25876387,Africa,24117,437
2020-12-01,Cameroon,CM,328,0,25876387,Africa,24445,437
2020-12-02,Cameroon,CM,42,4,25876387,Africa,24487,441
2020-12-03,Cameroon,CM,0,0,25876387,Africa,24487,441
2020-12-04,Cameroon,CM,0,0,25876387,Africa,24487,441
2020-12-05,Cameroon,CM,265,2,25876387,Africa,24752,443
2020-12-06,Cameroon,CM,0,0,25876387,Africa,24752,443
2020-12-07,Cameroon,CM,0,0,25876387,Africa,24752,443
2020-12-08,Cameroon,CM,0,0,25876387,Africa,24752,443
2020-12-09,Cameroon,CM,0,0,25876387,Africa,24752,443
2020-12-10,Cameroon,CM,211,0,25876387,Africa,24963,443
2020-12-11,Cameroon,CM,124,0,25876387,Africa,25087,443
2020-12-12,Cameroon,CM,56,0,25876387,Africa,25143,443
2020-12-13,Cameroon,CM,0,0,25876387,Africa,25143,443
2020-12-14,Cameroon,CM,0,0,25876387,Africa,25143,443
2019-12-31,China,CN,27,0,1433783692,Asia,27,0
2020-01-01,China,CN,0,0,1433783692,Asia,27,0
2020-01-02,China,CN,0,0,1433783692,Asia,27,0
2020-01-03,China,CN,17,0,1433783692,Asia,44,0
2020-01-04,China,CN,0,0,1433783692,Asia,44,0
2020-01-05,China,CN,15,0,1433783692,Asia,59,0
2020-01-06,China,CN,0,0,1433783692,Asia,59,0
2020-01-07,China,CN,0,0,1433783692,Asia,59,0
2020-01-08,China,CN,0,0,1433783692,Asia,59,0
2020-01-09,China,CN,0,0,1433783692,Asia,59,0
2020-01-10,China,CN,0,0,1433783692,Asia,59,0
2020-01-11,China,CN,0,1,1433783692,Asia,59,1
2020-01-12,China,CN,0,0,1433783692,Asia,59,1
2020-01-13,China,CN,0,0,1433783692,Asia,59,1
2020-01-14,China,CN,0,0,1433783692,Asia,59,1
2020-01-15,China,CN,0,1,1433783692,Asia,59,2
2020-01-16,China,CN,0,0,1433783692,Asia,59,2
2020-01-17,China,CN,4,0,1433783692,Asia,63,2
2020-01-18,China,CN,17,0,1433783692,Asia,80,2
2020-01-19,China,CN,136,1,1433783692,Asia,216,3
2020-01-20,China,CN,19,0,1433783692,Asia,235,3
2020-01-21,China,CN,151,3,1433783692,Asia,386,6
2020-01-22,China,CN,140,11,1433783692,Asia,526,17
2020-01-23,China,CN,97,0,1433783692,Asia,623,17
2020-01-24,China,CN,259,9,1433783692,Asia,882,26
2020-01-25,China,CN,441,15,1433783692,Asia,1323,41
2020-01-26,China,CN,665,15,1433783692,Asia,1988,56
2020-01-27,China,CN,787,25,1433783692,Asia,2775,81
2020-01-28,China,CN,1753,25,1433783692,Asia,4528,106
2020-01-29,China,CN,1466,26,1433783692,Asia,5994,132
2020-01-30,China,CN,1740,38,1433783692,Asia,7734,170
2020-01-31,China,CN,1980,43,1433783692,Asia,9714,213
2020-02-01,China,CN,2095,46,1433783692,Asia,11809,259
2020-02-02,China,CN,2590,45,1433783692,Asia,14399,304
2020-02-03,China,CN,2812,57,1433783692,Asia,17211,361
2020-02-04,China,CN,3237,65,1433783692,Asia,20448,426
2020-02-05,China,CN,3872,66,1433783692,Asia,24320,492
2020-02-06,China,CN,3727,72,1433783692,Asia,28047,564
2020-02-07,China,CN,3160,73,1433783692,Asia,31207,637
2020-02-08,China,CN,3418,86,1433783692,Asia,34625,723
2020-02-09,China,CN,2607,89,1433783692,Asia,37232,812
2020-02-10,China,CN,2974,97,1433783692,Asia,40206,909
2020-02-11,China,CN,2490,108,1433783692,Asia,42696,1017
2020-02-12,China,CN,2028,97,1433783692,Asia,44724,1114
2020-02-13,China,CN,15141,254,1433783692,Asia,59865,1368
2020-02-14,China,CN,4156,13,1433783692,Asia,64021,1381
2020-02-15,China,CN,2538,143,1433783692,Asia,66559,1524
2020-02-16,China,CN,2007,142,1433783692,Asia,68566,1666
2020-02-17,China,CN,2052,105,1433783692,Asia,70618,1771
2020-02-18,China,CN,1890,98,1433783692,Asia,72508,1869
2020-02-19,China,CN,1750,139,1433783692,Asia,74258,2008
2020-02-20,China,CN,394,112,1433783692,Asia,74652,2120
2020-02-21,China,CN,891,118,1433783692,Asia,75543,2238
2020-02-22,China,CN,826,109,1433783692,Asia,76369,2347
2020-02-23,China,CN,647,98,1433783692,Asia,77016,2445
2020-02-24,China,CN,218,150,1433783692,Asia,77234,2595
2020-02-25,China,CN,515,70,1433783692,Asia,77749,2665
2020-02-26,China,CN,410,52,1433783692,Asia,78159,2717
2020-02-27,China,CN,439,29,1433783692,Asia,78598,2746
2020-02-28,China,CN,329,44,1433783692,Asia,78927,2790
2020-02-29,China,CN,428,47,1433783692,Asia,79355,2837
2020-03-01,China,CN,574,35,1433783692,Asia,79929,2872
2020-03-02,China,CN,205,42,1433783692,Asia,80134,2914
2020-03-03,China,CN,127,32,1433783692,Asia,80261,2946
2020-03-04,China,CN,119,37,1433783692,Asia,80380,2983
2020-03-05,China,CN,117,31,1433783692,Asia,80497,3014
2020-03-06,China,CN,170,30,1433783692,Asia,80667,3044
2020-03-07,China,CN,101,28,1433783692,Asia,80768,3072
2020-03-08,China,CN,46,27,1433783692,Asia,80814,3099
2020-03-09,China,CN,45,23,1433783692,Asia,80859,3122
2020-03-10,China,CN,20,17,1433783692,Asia,80879,3139
2020-03-11,China,CN,29,22,1433783692,Asia,80908,3161
2020-03-12,China,CN,24,11,1433783692,Asia,80932,3172
2020-03-13,China,CN,22,7,1433783692,Asia,80954,3179
2020-03-14,China,CN,19,15,1433783692,Asia,80973,3194
2020-03-15,China,CN,22,9,1433783692,Asia,80995,3203
2020-03-16,China,CN,25,13,1433783692,Asia,81020,3216
2020-03-17,China,CN,43,9,1433783692,Asia,81063,3225
2020-03-18,China,CN,23,16,1433783692,Asia,81086,3241
2020-03-19,China,CN,44,8,1433783692,Asia,81130,3249
2020-03-20,China,CN,99,4,1433783692,Asia,81229,3253
2020-03-21,China,CN,52,6,1433783692,Asia,81281,3259
2020-03-22,China,CN,65,6,1433783692,Asia,81346,3265
2020-03-23,China,CN,138,9,1433783692,Asia,81484,3274
2020-03-24,China,CN,69,7,1433783692,Asia,81553,3281
2020-03-25,China,CN,78,4,1433783692,Asia,81631,3285
2020-03-26,China,CN,102,6,1433783692,Asia,81733,3291
2020-03-27,China,CN,94,5,1433783692,Asia,81827,3296
2020-03-28,China,CN,119,3,1433783692,Asia,81946,3299
2020-03-29,China,CN,113,5,1433783692,Asia,82059,3304
2020-03-30,China,CN,98,2,1433783692,Asia,82157,3306
2020-03-31,China,CN,84,3,1433783692,Asia,82241,3309
2020-04-01,China,CN,54,1,1433783692,Asia,82295,3310
2020-04-02,China,CN,100,6,1433783692,Asia,82395,3316
2020-04-03,China,CN,70,10,1433783692,Asia,82465,3326
2020-04-04,China,CN,62,4,1433783692,Asia,82527,3330
2020-04-05,China,CN,48,3,1433783692,Asia,82575,3333
2020-04-06,China,CN,67,2,1433783692,Asia,82642,3335
2020-04-07,China,CN,56,0,1433783692,Asia,82698,3335
2020-04-08,China,CN,86,2,1433783692,Asia,82784,3337
2020-04-09,China,CN,86,2,1433783692,Asia,82870,3339
2020-04-10,China,CN,55,1,1433783692,Asia,82925,3340
2020-04-11,China,CN,79,3,1433783692,Asia,83004,3343
2020-04-12,China,CN,93,0,1433783692,Asia,83097,3343
2020-04-13,China,CN,112,2,1433783692,Asia,83209,3345
2020-04-14,China,CN,94,0,1433783692,Asia,83303,3345
2020-04-15,China,CN,49,1,1433783692,Asia,83352,3346
2020-04-16,China,CN,50,0,1433783692,Asia,83402,3346
2020-04-17,China,CN,352,1290,1433783692,Asia,83754,4636
2020-04-18,China,CN,31,0,1433783692,Asia,83785,4636
2020-04-19,China,CN,18,0,1433783692,Asia,83803,4636
2020-04-20,China,CN,14,0,1433783692,Asia,83817,4636
2020-04-21,China,CN,32,0,1433783692,Asia,83849,4636
2020-04-22,China,CN,15,0,1433783692,Asia,83864,4636
2020-04-23,China,CN,12,0,1433783692,Asia,83876,4636
2020-04-24,China,CN,8,0,1433783692,Asia,83884,4636
2020-04-25,China,CN,15,0,1433783692,Asia,83899,4636
2020-04-26,China,CN,10,0,1433783692,Asia,83909,4636
2020-04-27,China,CN,3,1,1433783692,Asia,83912,4637
2020-04-28,China,CN,26,0,1433783692,Asia,83938,4637
2020-04-29,China,CN,2,0,1433783692,Asia,83940,4637
2020-04-30,China,CN,4,0,1433783692,Asia,83944,4637
2020-05-01,China,CN,12,0,1433783692,Asia,83956,4637
2020-05-02,China,CN,3,0,1433783692,Asia,83959,4637
2020-05-03,China,CN,2,0,1433783692,Asia,83961,4637
2020-05-04,China,CN,3,0,1433783692,Asia,83964,4637
2020-05-05,China,CN,2,0,1433783692,Asia,83966,4637
2020-05-06,China,CN,2,0,1433783692,Asia,83968,4637
2020-05-07,China,CN,2,0,1433783692,Asia,83970,4637
2020-05-08,China,CN,6,0,1433783692,Asia,83976,4637
2020-05-09,China,CN,0,0,1433783692,Asia,83976,4637
2020-05-10,China,CN,15,0,1433783692,Asia,83991,4637
2020-05-11,China,CN,19,0,1433783692,Asia,84010,4637
2020-05-12,China,CN,1,0,1433783692,Asia,84011,4637
2020-05-13,China,CN,7,0,1433783692,Asia,84018,4637
2020-05-14,China,CN,6,0,1433783692,Asia,84024,4637
2020-05-15,China,CN,5,0,1433783692,Asia,84029,4637
2020-05-16,China,CN,9,0,1433783692,Asia,84038,4637
2020-05-17,China,CN,6,1,1433783692,Asia,84044,4638
2020-05-18,China,CN,10,0,1433783692,Asia,84054,4638
2020-05-19,China,CN,9,0,1433783692,Asia,84063,4638
2020-05-20,China,CN,2,0,1433783692,Asia,84065,4638
2020-05-21,China,CN,2,0,1433783692,Asia,84067,4638
2020-05-22,China,CN,12,0,1433783692,Asia,84079,4638
2020-05-23,China,CN,2,0,1433783692,Asia,84081,4638
2020-05-24,China,CN,3,0,1433783692,Asia,84084,4638
2020-05-25,China,CN,11,0,1433783692,Asia,84095,4638
2020-05-26,China,CN,7,0,1433783692,Asia,84102,4638
2020-05-27,China,CN,1,0,1433783692,Asia,84103,4638
2020-05-28,China,CN,3,0,1433783692,Asia,84106,4638
2020-05-29,China,CN,0,0,1433783692,Asia,84106,4638
2020-05-30,China,CN,17,0,1433783692,Asia,84123,4638
2020-05-31,China,CN,5,0,1433783692,Asia,84128,4638
2020-06-01,China,CN,19,0,1433783692,Asia,84147,4638
2020-06-02,China,CN,7,0,1433783692,Asia,84154,4638
2020-06-03,China,CN,5,0,1433783692,Asia,84159,4638
2020-06-04,China,CN,1,0,1433783692,Asia,84160,4638
2020-06-05,China,CN,11,0,1433783692,Asia,84171,4638
2020-06-06,China,CN,6,0,1433783692,Asia,84177,4638
2020-06-07,China,CN,9,0,1433783692,Asia,84186,4638
2020-06-08,China,CN,5,0,1433783692,Asia,84191,4638
2020-06-09,China,CN,3,0,1433783692,Asia,84194,4638
2020-06-10,China,CN,4,0,1433783692,Asia,84198,4638
2020-06-11,China,CN,11,0,1433783692,Asia,84209,4638
2020-06-12,China,CN,7,0,1433783692,Asia,84216,4638
2020-06-13,China,CN,12,0,1433783692,Asia,84228,4638
2020-06-14,China,CN,60,0,1433783692,Asia,84288,4638
2020-06-15,China,CN,47,0,1433783692,Asia,84335,4638
2020-06-16,China,CN,43,0,1433783692,Asia,84378,4638
2020-06-17,China,CN,44,0,1433783692,Asia,84422,4638
2020-06-18,China,CN,36,0,1433783692,Asia,84458,4638
2020-06-19,China,CN,36,0,1433783692,Asia,84494,4638
2020-06-20,China,CN,30,0,1433783692,Asia,84524,4638
2020-06-21,China,CN,29,1,1433783692,Asia,84553,4639
2020-06-22,China,CN,19,0,1433783692,Asia,84572,4639
2020-06-23,China,CN,52,0,1433783692,Asia,84624,4639
2020-06-24,China,CN,29,1,1433783692,Asia,84653,4640
2020-06-25,China,CN,20,0,1433783692,Asia,84673,4640
2020-06-26,China,CN,28,1,1433783692,Asia,84701,4641
2020-06-27,China,CN,24,0,1433783692,Asia,84725,4641
2020-06-28,China,CN,18,0,1433783692,Asia,84743,4641
2020-06-29,China,CN,14,0,1433783692,Asia,84757,4641
2020-06-30,China,CN,23,0,1433783692,Asia,84780,4641
2020-07-01,China,CN,5,0,1433783692,Asia,84785,4641
2020-07-02,China,CN,31,0,1433783692,Asia,84816,4641
2020-07-03,China,CN,14,0,1433783692,Asia,84830,4641
2020-07-04,China,CN,9,0,1433783692,Asia,84839,4641
2020-07-05,China,CN,18,0,1433783692,Asia,84857,4641
2020-07-06,China,CN,14,0,1433783692,Asia,84871,4641
2020-07-07,China,CN,25,0,1433783692,Asia,84896,4641
2020-07-08,China,CN,21,0,1433783692,Asia,84917,4641
2020-07-09,China,CN,33,0,1433783692,Asia,84950,4641
2020-07-10,China,CN,46,0,1433783692,Asia,84996,4641
2020-07-11,China,CN,40,0,1433783692,Asia,85036,4641
2020-07-12,China,CN,35,0,1433783692,Asia,85071,4641
2020-07-13,China,CN,46,0,1433783692,Asia,85117,4641
2020-07-14,China,CN,55,1,1433783692,Asia,85172,4642
2020-07-15,China,CN,54,0,1433783692,Asia,85226,4642
2020-07-16,China,CN,20,2,1433783692,Asia,85246,4644
2020-07-17,China,CN,77,0,1433783692,Asia,85323,4644
2020-07-18,China,CN,80,1,1433783692,Asia,85403,4645
2020-07-19,China,CN,80,1,1433783692,Asia,85483,4646
2020-07-20,China,CN,130,0,1433783692,Asia,85613,4646
2020-07-21,China,CN,84,0,1433783692,Asia,85697,4646
2020-07-22,China,CN,74,2,1433783692,Asia,85771,4648
2020-07-23,China,CN,135,0,1433783692,Asia,85906,4648
2020-07-24,China,CN,139,1,1433783692,Asia,86045,4649
2020-07-25,China,CN,157,1,1433783692,Asia,86202,4650
2020-07-26,China,CN,179,2,1433783692,Asia,86381,4652
2020-07-27,China,CN,189,0,1433783692,Asia,86570,4652
2020-07-28,China,CN,213,4,1433783692,Asia,86783,4656
2020-07-29,China,CN,207,1,1433783692,Asia,86990,4657
2020-07-30,China,CN,223,2,1433783692,Asia,87213,4659
2020-07-31,China,CN,276,0,1433783692,Asia,87489,4659
2020-08-01,China,CN,166,2,1433783692,Asia,87655,4661
2020-08-02,China,CN,172,6,1433783692,Asia,87827,4667
2020-08-03,China,CN,158,2,1433783692,Asia,87985,4669
2020-08-04,China,CN,114,3,1433783692,Asia,88099,4672
2020-08-05,China,CN,107,4,1433783692,Asia,88206,4676
2020-08-06,China,CN,122,1,1433783692,Asia,88328,4677
2020-08-07,China,CN,132,3,1433783692,Asia,88460,4680
2020-08-08,China,CN,120,1,1433783692,Asia,88580,4681
2020-08-09,China,CN,92,0,1433783692,Asia,88672,4681
2020-08-10,China,CN,121,5,1433783692,Asia,88793,4686
2020-08-11,China,CN,113,4,1433783692,Asia,88906,4690
2020-08-12,China,CN,58,3,1433783692,Asia,88964,4693
2020-08-13,China,CN,81,4,1433783692,Asia,89045,4697
2020-08-14,China,CN,99,3,1433783692,Asia,89144,4700
2020-08-15,China,CN,70,1,1433783692,Asia,89214,4701
2020-08-16,China,CN,65,2,1433783692,Asia,89279,4703
2020-08-17,China,CN,96,0,1433783692,Asia,89375,4703
2020-08-18,China,CN,66,0,1433783692,Asia,89441,4703
2020-08-19,China,CN,53,2,1433783692,Asia,89494,4705
2020-08-20,China,CN,33,1,1433783692,Asia,89527,4706
2020-08-21,China,CN,40,3,1433783692,Asia,89567,4709
2020-08-22,China,CN,49,2,1433783692,Asia,89616,4711
2020-08-23,China,CN,38,0,1433783692,Asia,89654,4711
2020-08-24,China,CN,41,0,1433783692,Asia,89695,4711
2020-08-25,China,CN,23,0,1433783692,Asia,89718,4711
2020-08-26,China,CN,34,1,1433783692,Asia,89752,4712
2020-08-27,China,CN,32,1,1433783692,Asia,89784,4713
2020-08-28,China,CN,30,2,1433783692,Asia,89814,4715
2020-08-29,China,CN,22,3,1433783692,Asia,89836,4718
2020-08-30,China,CN,27,3,1433783692,Asia,89863,4721
2020-08-31,China,CN,32,1,1433783692,Asia,89895,4722
2020-09-01,China,CN,19,1,1433783692,Asia,89914,4723
2020-09-02,China,CN,20,1,1433783692,Asia,89934,4724
2020-09-03,China,CN,19,3,1433783692,Asia,89953,4727
2020-09-04,China,CN,33,1,1433783692,Asia,89986,4728
2020-09-05,China,CN,22,0,1433783692,Asia,90008,4728
2020-09-06,China,CN,17,0,1433783692,Asia,90025,4728
2020-09-07,China,CN,33,2,1433783692,Asia,90058,4730
2020-09-08,China,CN,21,2,1433783692,Asia,90079,4732
2020-09-09,China,CN,8,1,1433783692,Asia,90087,4733
2020-09-10,China,CN,13,0,1433783692,Asia,90100,4733
2020-09-11,China,CN,27,0,1433783692,Asia,90127,4733
2020-09-12,China,CN,18,0,1433783692,Asia,90145,4733
2020-09-13,China,CN,23,1,1433783692,Asia,90168,4734
2020-09-14,China,CN,29,0,1433783692,Asia,90197,4734
2020-09-15,China,CN,22,1,1433783692,Asia,90219,4735
2020-09-16,China,CN,24,1,1433783692,Asia,90243,4736
2020-09-17,China,CN,7,0,1433783692,Asia,90250,4736
2020-09-18,China,CN,44,0,1433783692,Asia,90294,4736
2020-09-19,China,CN,14,1,1433783692,Asia,90308,4737
2020-09-20,China,CN,25,0,1433783692,Asia,90333,4737
2020-09-21,China,CN,36,0,1433783692,Asia,90369,4737
2020-09-22,China,CN,12,0,1433783692,Asia,90381,4737
2020-09-23,China,CN,18,0,1433783692,Asia,90399,4737
2020-09-24,China,CN,10,1,1433783692,Asia,90409,4738
2020-09-25,China,CN,15,0,1433783692,Asia,90424,4738
2020-09-26,China,CN,17,1,1433783692,Asia,90441,4739
2020-09-27,China,CN,15,0,1433783692,Asia,90456,4739
2020-09-28,China,CN,27,0,1433783692,Asia,90483,4739
2020-09-29,China,CN,22,0,1433783692,Asia,90505,4739
2020-09-30,China,CN,23,0,1433783692,Asia,90528,4739
2020-10-01,China,CN,0,0,1433783692,Asia,90528,4739
2020-10-02,China,CN,39,0,1433783692,Asia,90567,4739
2020-10-03,China,CN,17,0,1433783692,Asia,90584,4739
2020-10-04,China,CN,20,0,1433783692,Asia,90604,4739
2020-10-05,China,CN,25,0,1433783692,Asia,90629,4739
2020-10-06,China,CN,23,0,1433783692,Asia,90652,4739
2020-10-07,China,CN,15,0,1433783692,Asia,90667,4739
2020-10-08,China,CN,22,0,1433783692,Asia,90689,4739
2020-10-09,China,CN,39,0,1433783692,Asia,90728,4739
2020-10-10,China,CN,29,0,1433783692,Asia,90757,4739
2020-10-11,China,CN,21,0,1433783692,Asia,90778,4739
2020-10-12,China,CN,34,0,1433783692,Asia,90812,4739
2020-10-13,China,CN,18,0,1433783692,Asia,90830,4739
2020-10-14,China,CN,28,0,1433783692,Asia,90858,4739
2020-10-15,China,CN,11,0,1433783692,Asia,90869,4739
2020-10-16,China,CN,36,0,1433783692,Asia,90905,4739
2020-10-17,China,CN,20,0,1433783692,Asia,90925,4739
2020-10-18,China,CN,30,0,1433783692,Asia,90955,4739
2020-10-19,China,CN,17,0,1433783692,Asia,90972,4739
2020-10-20,China,CN,34,0,1433783692,Asia,91006,4739
2020-10-21,China,CN,16,0,1433783692,Asia,91022,4739
2020-10-22,China,CN,22,0,1433783692,Asia,91044,4739
2020-10-23,China,CN,29,0,1433783692,Asia,91073,4739
2020-10-24,China,CN,33,0,1433783692,Asia,91106,4739
2020-10-25,China,CN,19,0,1433783692,Asia,91125,4739
2020-10-26,China,CN,26,0,1433783692,Asia,91151,4739
2020-10-27,China,CN,24,0,1433783692,Asia,91175,4739
2020-10-28,China,CN,42,0,1433783692,Asia,91217,4739
2020-10-29,China,CN,24,0,1433783692,Asia,91241,4739
2020-10-30,China,CN,25,0,1433783692,Asia,91266,4739
2020-10-31,China,CN,33,0,1433783692,Asia,91299,4739
2020-11-01,China,CN,24,0,1433783692,Asia,91323,4739
2020-11-02,China,CN,24,0,1433783692,Asia,91347,4739
2020-11-03,China,CN,49,0,1433783692,Asia,91396,4739
2020-11-04,China,CN,16,0,1433783692,Asia,91412,4739
2020-11-05,China,CN,27,0,1433783692,Asia,91439,4739
2020-11-06,China,CN,32,0,1433783692,Asia,91471,4739
2020-11-07,China,CN,33,0,1433783692,Asia,91504,4739
2020-11-08,China,CN,24,0,1433783692,Asia,91528,4739
2020-11-09,China,CN,32,0,1433783692,Asia,91560,4739
2020-11-10,China,CN,20,0,1433783692,Asia,91580,4739
2020-11-11,China,CN,13,0,1433783692,Asia,91593,4739
2020-11-12,China,CN,10,0,1433783692,Asia,91603,4739
2020-11-13,China,CN,0,0,1433783692,Asia,91603,4739
2020-11-14,China,CN,15,0,1433783692,Asia,91618,4739
2020-11-15,China,CN,11,0,1433783692,Asia,91629,4739
2020-11-16,China,CN,7,0,1433783692,Asia,91636,4739
2020-11-17,China,CN,15,0,1433783692,Asia,91651,4739
2020-11-18,China,CN,8,0,1433783692,Asia,91659,4739
2020-11-19,China,CN,12,0,1433783692,Asia,91671,4739
2020-11-20,China,CN,17,0,1433783692,Asia,91688,4739
2020-11-21,China,CN,16,0,1433783692,Asia,91704,4739
2020-11-22,China,CN,16,0,1433783692,Asia,91720,4739
2020-11-23,China,CN,11,0,1433783692,Asia,91731,4739
2020-11-24,China,CN,22,0,1433783692,Asia,91753,4739
2020-11-25,China,CN,5,0,1433783692,Asia,91758,4739
2020-11-26,China,CN,21,0,1433783692,Asia,91779,4739
2020-11-27,China,CN,5,0,1433783692,Asia,91784,4739
2020-11-28,China,CN,6,0,1433783692,Asia,91790,4739
2020-11-29,China,CN,6,0,1433783692,Asia,91796,4739
2020-11-30,China,CN,18,0,1433783692,Asia,91814,4739
2020-12-01,China,CN,12,0,1433783692,Asia,91826,4739
2020-12-02,China,CN,9,0,1433783692,Asia,91835,4739
2020-12-03,China,CN,16,0,1433783692,Asia,91851,4739
2020-12-04,China,CN,17,0,1433783692,Asia,91868,4739
2020-12-05,China,CN,17,0,1433783692,Asia,91885,4739
2020-12-06,China,CN,18,0,1433783692,Asia,91903,4739
2020-12-07,China,CN,15,0,1433783692,Asia,91918,4739
2020-12-08,China,CN,12,0,1433783692,Asia,91930,4739
2020-12-09,China,CN,15,0,1433783692,Asia,91945,4739
2020-12-10,China,CN,12,0,1433783692,Asia,91957,4739
2020-12-11,China,CN,15,0,1433783692,Asia,91972,4739
2020-12-12,China,CN,13,0,1433783692,Asia,91985,4739
2020-12-13,China,CN,24,0,1433783692,Asia,92009,4739
2020-12-14,China,CN,12,0,1433783692,Asia,92021,4739
2020-03-07,Colombia,CO,1,0,50339443,America,1,0
2020-03-10,Colombia,CO,2,0,50339443,America,3,0
2020-03-12,Colombia,CO,6,0,50339443,America,9,0
2020-03-14,Colombia,CO,7,0,50339443,America,16,0
2020-03-15,Colombia,CO,18,0,50339443,America,34,0
2020-03-16,Colombia,CO,11,0,50339443,America,45,0
2020-03-17,Colombia,CO,12,0,50339443,America,57,0
2020-03-18,Colombia,CO,8,0,50339443,America,65,0
2020-03-19,Colombia,CO,37,0,50339443,America,102,0
2020-03-20,Colombia,CO,26,0,50339443,America,128,0
2020-03-21,Colombia,CO,30,0,50339443,America,158,0
2020-03-22,Colombia,CO,52,1,50339443,America,210,1
2020-03-23,Colombia,CO,25,1,50339443,America,235,2
2020-03-24,Colombia,CO,71,1,50339443,America,306,3
2020-03-25,Colombia,CO,72,0,50339443,America,378,3
2020-03-26,Colombia,CO,92,1,50339443,America,470,4
2020-03-27,Colombia,CO,21,2,50339443,America,491,6
2020-03-28,Colombia,CO,48,0,50339443,America,539,6
2020-03-29,Colombia,CO,69,0,50339443,America,608,6
2020-03-30,Colombia,CO,94,4,50339443,America,702,10
2020-03-31,Colombia,CO,96,4,50339443,America,798,14
2020-04-01,Colombia,CO,108,2,50339443,America,906,16
2020-04-02,Colombia,CO,159,1,50339443,America,1065,17
2020-04-03,Colombia,CO,96,2,50339443,America,1161,19
2020-04-04,Colombia,CO,106,6,50339443,America,1267,25
2020-04-05,Colombia,CO,139,7,50339443,America,1406,32
2020-04-06,Colombia,CO,79,3,50339443,America,1485,35
2020-04-07,Colombia,CO,94,11,50339443,America,1579,46
2020-04-08,Colombia,CO,201,4,50339443,America,1780,50
2020-04-09,Colombia,CO,274,5,50339443,America,2054,55
2020-04-10,Colombia,CO,169,14,50339443,America,2223,69
2020-04-11,Colombia,CO,250,11,50339443,America,2473,80
2020-04-12,Colombia,CO,236,20,50339443,America,2709,100
2020-04-13,Colombia,CO,67,9,50339443,America,2776,109
2020-04-14,Colombia,CO,76,3,50339443,America,2852,112
2020-04-15,Colombia,CO,127,15,50339443,America,2979,127
2020-04-16,Colombia,CO,126,4,50339443,America,3105,131
2020-04-17,Colombia,CO,128,13,50339443,America,3233,144
2020-04-18,Colombia,CO,206,9,50339443,America,3439,153
2020-04-19,Colombia,CO,182,13,50339443,America,3621,166
2020-04-20,Colombia,CO,171,13,50339443,America,3792,179
2020-04-21,Colombia,CO,185,10,50339443,America,3977,189
2020-04-22,Colombia,CO,172,7,50339443,America,4149,196
2020-04-23,Colombia,CO,207,10,50339443,America,4356,206
2020-04-24,Colombia,CO,205,9,50339443,America,4561,215
2020-04-25,Colombia,CO,320,10,50339443,America,4881,225
2020-04-26,Colombia,CO,261,8,50339443,America,5142,233
2020-04-27,Colombia,CO,237,10,50339443,America,5379,243
2020-04-28,Colombia,CO,218,10,50339443,America,5597,253
2020-04-29,Colombia,CO,352,16,50339443,America,5949,269
2020-04-30,Colombia,CO,262,9,50339443,America,6211,278
2020-05-01,Colombia,CO,296,15,50339443,America,6507,293
2020-05-02,Colombia,CO,499,21,50339443,America,7006,314
2020-05-03,Colombia,CO,279,10,50339443,America,7285,324
2020-05-04,Colombia,CO,383,16,50339443,America,7668,340
2020-05-05,Colombia,CO,305,18,50339443,America,7973,358
2020-05-06,Colombia,CO,640,20,50339443,America,8613,378
2020-05-07,Colombia,CO,346,19,50339443,America,8959,397
2020-05-08,Colombia,CO,497,10,50339443,America,9456,407
2020-05-09,Colombia,CO,595,21,50339443,America,10051,428
2020-05-10,Colombia,CO,444,17,50339443,America,10495,445
2020-05-11,Colombia,CO,568,18,50339443,America,11063,463
2020-05-12,Colombia,CO,550,16,50339443,America,11613,479
2020-05-13,Colombia,CO,659,14,50339443,America,12272,493
2020-05-14,Colombia,CO,658,16,50339443,America,12930,509
2020-05-15,Colombia,CO,680,16,50339443,America,13610,525
2020-05-16,Colombia,CO,606,21,50339443,America,14216,546
2020-05-17,Colombia,CO,723,16,50339443,America,14939,562
2020-05-18,Colombia,CO,635,12,50339443,America,15574,574
2020-05-19,Colombia,CO,721,18,50339443,America,16295,592
2020-05-20,Colombia,CO,640,21,50339443,America,16935,613
2020-05-21,Colombia,CO,752,17,50339443,America,17687,630
2020-05-22,Colombia,CO,643,22,50339443,America,18330,652
2020-05-23,Colombia,CO,801,30,50339443,America,19131,682
2020-05-24,Colombia,CO,1046,23,50339443,America,20177,705
2020-05-25,Colombia,CO,998,22,50339443,America,21175,727
2020-05-26,Colombia,CO,806,23,50339443,America,21981,750
2020-05-27,Colombia,CO,1022,26,50339443,America,23003,776
2020-05-28,Colombia,CO,1101,27,50339443,America,24104,803
2020-05-29,Colombia,CO,1262,19,50339443,America,25366,822
2020-05-30,Colombia,CO,1322,31,50339443,America,26688,853
2020-05-31,Colombia,CO,1548,37,50339443,America,28236,890
2020-06-01,Colombia,CO,1147,49,50339443,America,29383,939
2020-06-02,Colombia,CO,1110,30,50339443,America,30493,969
2020-06-03,Colombia,CO,1340,40,50339443,America,31833,1009
2020-06-04,Colombia,CO,1521,36,50339443,America,33354,1045
2020-06-05,Colombia,CO,1766,42,50339443,America,35120,1087
2020-06-06,Colombia,CO,1515,58,50339443,America,36635,1145
2020-06-07,Colombia,CO,1392,60,50339443,America,38027,1205
2020-06-08,Colombia,CO,1209,54,50339443,America,39236,1259
2020-06-09,Colombia,CO,1483,49,50339443,America,40719,1308
2020-06-10,Colombia,CO,1359,64,50339443,America,42078,1372
2020-06-11,Colombia,CO,1604,61,50339443,America,43682,1433
2020-06-12,Colombia,CO,0,0,50339443,America,43682,1433
2020-06-13,Colombia,CO,3176,112,50339443,America,46858,1545
2020-06-14,Colombia,CO,1888,47,50339443,America,48746,1592
2020-06-15,Colombia,CO,2193,75,50339443,America,50939,1667
2020-06-16,Colombia,CO,2124,59,50339443,America,53063,1726
2020-06-17,Colombia,CO,1868,75,50339443,America,54931,1801
2020-06-18,Colombia,CO,2115,63,50339443,America,57046,1864
2020-06-19,Colombia,CO,3171,86,50339443,America,60217,1950
2020-06-20,Colombia,CO,3059,95,50339443,America,63276,2045
2020-06-21,Colombia,CO,2357,81,50339443,America,65633,2126
2020-06-22,Colombia,CO,3019,111,50339443,America,68652,2237
2020-06-23,Colombia,CO,2531,73,50339443,America,71183,2310
2020-06-24,Colombia,CO,2389,94,50339443,America,73572,2404
2020-06-25,Colombia,CO,3541,87,50339443,America,77113,2491
2020-06-26,Colombia,CO,3486,163,50339443,America,80599,2654
2020-06-27,Colombia,CO,3843,157,50339443,America,84442,2811
2020-06-28,Colombia,CO,4149,128,50339443,America,88591,2939
2020-06-29,Colombia,CO,3178,167,50339443,America,91769,3106
2020-06-30,Colombia,CO,3274,117,50339443,America,95043,3223
2020-07-01,Colombia,CO,2803,111,50339443,America,97846,3334
2020-07-02,Colombia,CO,4163,136,50339443,America,102009,3470
2020-07-03,Colombia,CO,4101,171,50339443,America,106110,3641
2020-07-04,Colombia,CO,3395,136,50339443,America,109505,3777
2020-07-05,Colombia,CO,3884,165,50339443,America,113389,3942
2020-07-06,Colombia,CO,3721,122,50339443,America,117110,4064
2020-07-07,Colombia,CO,3171,146,50339443,America,120281,4210
2020-07-08,Colombia,CO,4213,149,50339443,America,124494,4359
2020-07-09,Colombia,CO,4144,168,50339443,America,128638,4527
2020-07-10,Colombia,CO,5335,187,50339443,America,133973,4714
2020-07-11,Colombia,CO,6803,211,50339443,America,140776,4925
2020-07-12,Colombia,CO,4586,194,50339443,America,145362,5119
2020-07-13,Colombia,CO,5083,188,50339443,America,150445,5307
2020-07-14,Colombia,CO,3782,148,50339443,America,154227,5455
2020-07-15,Colombia,CO,5671,170,50339443,America,159898,5625
2020-07-16,Colombia,CO,5271,189,50339443,America,165169,5814
2020-07-17,Colombia,CO,8037,215,50339443,America,173206,6029
2020-07-18,Colombia,CO,8934,259,50339443,America,182140,6288
2020-07-19,Colombia,CO,8560,228,50339443,America,190700,6516
2020-07-20,Colombia,CO,6578,220,50339443,America,197278,6736
2020-07-21,Colombia,CO,6727,193,50339443,America,204005,6929
2020-07-22,Colombia,CO,7033,237,50339443,America,211038,7166
2020-07-23,Colombia,CO,7390,207,50339443,America,218428,7373
2020-07-24,Colombia,CO,7945,315,50339443,America,226373,7688
2020-07-25,Colombia,CO,7168,287,50339443,America,233541,7975
2020-07-26,Colombia,CO,7254,294,50339443,America,240795,8269
2020-07-27,Colombia,CO,8181,256,50339443,America,248976,8525
2020-07-28,Colombia,CO,8125,252,50339443,America,257101,8777
2020-07-29,Colombia,CO,10284,297,50339443,America,267385,9074
2020-07-30,Colombia,CO,8670,380,50339443,America,276055,9454
2020-07-31,Colombia,CO,9965,356,50339443,America,286020,9810
2020-08-01,Colombia,CO,9488,295,50339443,America,295508,10105
2020-08-02,Colombia,CO,10673,225,50339443,America,306181,10330
2020-08-03,Colombia,CO,11470,320,50339443,America,317651,10650
2020-08-04,Colombia,CO,10199,367,50339443,America,327850,11017
2020-08-05,Colombia,CO,7129,298,50339443,America,334979,11315
2020-08-06,Colombia,CO,10735,309,50339443,America,345714,11624
2020-08-07,Colombia,CO,11996,315,50339443,America,357710,11939
2020-08-08,Colombia,CO,9486,311,50339443,America,367196,12250
2020-08-09,Colombia,CO,9674,290,50339443,America,376870,12540
2020-08-10,Colombia,CO,10611,302,50339443,America,387481,12842
2020-08-11,Colombia,CO,10142,312,50339443,America,397623,13154
2020-08-12,Colombia,CO,12830,321,50339443,America,410453,13475
2020-08-13,Colombia,CO,12066,362,50339443,America,422519,13837
2020-08-14,Colombia,CO,11286,308,50339443,America,433805,14145
2020-08-15,Colombia,CO,11306,347,50339443,America,445111,14492
2020-08-16,Colombia,CO,11578,318,50339443,America,456689,14810
2020-08-17,Colombia,CO,11643,287,50339443,America,468332,15097
2020-08-18,Colombia,CO,8328,275,50339443,America,476660,15372
2020-08-19,Colombia,CO,12462,247,50339443,America,489122,15619
2020-08-20,Colombia,CO,13056,360,50339443,America,502178,15979
2020-08-21,Colombia,CO,11541,204,50339443,America,513719,16183
2020-08-22,Colombia,CO,8419,385,50339443,America,522138,16568
2020-08-23,Colombia,CO,10965,400,50339443,America,533103,16968
2020-08-24,Colombia,CO,8044,348,50339443,America,541147,17316
2020-08-25,Colombia,CO,10549,296,50339443,America,551696,17612
2020-08-26,Colombia,CO,10432,277,50339443,America,562128,17889
2020-08-27,Colombia,CO,10142,295,50339443,America,572270,18184
2020-08-28,Colombia,CO,9752,284,50339443,America,582022,18468
2020-08-29,Colombia,CO,8498,299,50339443,America,590520,18767
2020-08-30,Colombia,CO,9394,297,50339443,America,599914,19064
2020-08-31,Colombia,CO,8024,300,50339443,America,607938,19364
2020-09-01,Colombia,CO,7230,299,50339443,America,615168,19663
2020-09-02,Colombia,CO,8901,389,50339443,America,624069,20052
2020-09-03,Colombia,CO,9270,296,50339443,America,633339,20348
2020-09-04,Colombia,CO,8235,270,50339443,America,641574,20618
2020-09-05,Colombia,CO,8488,270,50339443,America,650062,20888
2020-09-06,Colombia,CO,8394,268,50339443,America,658456,21156
2020-09-07,Colombia,CO,8065,256,50339443,America,666521,21412
2020-09-08,Colombia,CO,5327,203,50339443,America,671848,21615
2020-09-09,Colombia,CO,7665,202,50339443,America,679513,21817
2020-09-10,Colombia,CO,7343,236,50339443,America,686856,22053
2020-09-11,Colombia,CO,7808,222,50339443,America,694664,22275
2020-09-12,Colombia,CO,7424,243,50339443,America,702088,22518
2020-09-13,Colombia,CO,6876,216,50339443,America,708964,22734
2020-09-14,Colombia,CO,7355,190,50339443,America,716319,22924
2020-09-15,Colombia,CO,5573,199,50339443,America,721892,23123
2020-09-16,Colombia,CO,6698,165,50339443,America,728590,23288
2020-09-17,Colombia,CO,7787,190,50339443,America,736377,23478
2020-09-18,Colombia,CO,7568,187,50339443,America,743945,23665
2020-09-19,Colombia,CO,6526,185,50339443,America,750471,23850
2020-09-20,Colombia,CO,7927,189,50339443,America,758398,24039
2020-09-21,Colombia,CO,6678,169,50339443,America,765076,24208
2020-09-22,Colombia,CO,5359,189,50339443,America,770435,24397
2020-09-23,Colombia,CO,7102,173,50339443,America,777537,24570
2020-09-24,Colombia,CO,6731,176,50339443,America,784268,24746
2020-09-25,Colombia,CO,6555,178,50339443,America,790823,24924
2020-09-26,Colombia,CO,7494,179,50339443,America,798317,25103
2020-09-27,Colombia,CO,7721,193,50339443,America,806038,25296
2020-09-28,Colombia,CO,7018,192,50339443,America,813056,25488
2020-09-29,Colombia,CO,5147,153,50339443,America,818203,25641
2020-09-30,Colombia,CO,5839,187,50339443,America,824042,25828
2020-10-01,Colombia,CO,5637,170,50339443,America,829679,25998
2020-10-02,Colombia,CO,5660,198,50339443,America,835339,26196
2020-10-03,Colombia,CO,6192,201,50339443,America,841531,26397
2020-10-04,Colombia,CO,6616,159,50339443,America,848147,26556
2020-10-05,Colombia,CO,6905,156,50339443,America,855052,26712
2020-10-06,Colombia,CO,7106,132,50339443,America,862158,26844
2020-10-07,Colombia,CO,7650,173,50339443,America,869808,27017
2020-10-08,Colombia,CO,7875,163,50339443,America,877683,27180
2020-10-09,Colombia,CO,8496,151,50339443,America,886179,27331
2020-10-10,Colombia,CO,8121,164,50339443,America,894300,27495
2020-10-11,Colombia,CO,8447,165,50339443,America,902747,27660
2020-10-12,Colombia,CO,8569,174,50339443,America,911316,27834
2020-10-13,Colombia,CO,7767,151,50339443,America,919083,27985
2020-10-14,Colombia,CO,5015,156,50339443,America,924098,28141
2020-10-15,Colombia,CO,6061,165,50339443,America,930159,28306
2020-10-16,Colombia,CO,6823,151,50339443,America,936982,28457
2020-10-17,Colombia,CO,8372,159,50339443,America,945354,28616
2020-10-18,Colombia,CO,7017,187,50339443,America,952371,28803
2020-10-19,Colombia,CO,7201,167,50339443,America,959572,28970
2020-10-20,Colombia,CO,6311,132,50339443,America,965883,29102
2020-10-21,Colombia,CO,8256,170,50339443,America,974139,29272
2020-10-22,Colombia,CO,7561,192,50339443,America,981700,29464
2020-10-23,Colombia,CO,8570,172,50339443,America,990270,29636
2020-10-24,Colombia,CO,8672,166,50339443,America,998942,29802
2020-10-25,Colombia,CO,8769,198,50339443,America,1007711,30000
2020-10-26,Colombia,CO,8174,154,50339443,America,1015885,30154
2020-10-27,Colombia,CO,9167,194,50339443,America,1025052,30348
2020-10-28,Colombia,CO,8166,217,50339443,America,1033218,30565
2020-10-29,Colombia,CO,8717,188,50339443,America,1041935,30753
2020-10-30,Colombia,CO,11187,173,50339443,America,1053122,30926
2020-10-31,Colombia,CO,10029,209,50339443,America,1063151,31135
2020-11-01,Colombia,CO,11033,179,50339443,America,1074184,31314
2020-11-02,Colombia,CO,9137,201,50339443,America,1083321,31515
2020-11-03,Colombia,CO,9935,155,50339443,America,1093256,31670
2020-11-04,Colombia,CO,6136,177,50339443,America,1099392,31847
2020-11-05,Colombia,CO,8692,166,50339443,America,1108084,32013
2020-11-06,Colombia,CO,9893,196,50339443,America,1117977,32209
2020-11-07,Colombia,CO,9756,196,50339443,America,1127733,32405
2020-11-08,Colombia,CO,8714,190,50339443,America,1136447,32595
2020-11-09,Colombia,CO,7440,196,50339443,America,1143887,32791
2020-11-10,Colombia,CO,5176,183,50339443,America,1149063,32974
2020-11-11,Colombia,CO,7612,174,50339443,America,1156675,33148
2020-11-12,Colombia,CO,8651,164,50339443,America,1165326,33312
2020-11-13,Colombia,CO,8686,179,50339443,America,1174012,33491
2020-11-14,Colombia,CO,8685,178,50339443,America,1182697,33669
2020-11-15,Colombia,CO,8307,160,50339443,America,1191004,33829
2020-11-16,Colombia,CO,7742,202,50339443,America,1198746,34031
2020-11-17,Colombia,CO,6471,192,50339443,America,1205217,34223
2020-11-18,Colombia,CO,5911,158,50339443,America,1211128,34381
2020-11-19,Colombia,CO,6875,182,50339443,America,1218003,34563
2020-11-20,Colombia,CO,7487,198,50339443,America,1225490,34761
2020-11-21,Colombia,CO,7954,168,50339443,America,1233444,34929
2020-11-22,Colombia,CO,7049,175,50339443,America,1240493,35104
2020-11-23,Colombia,CO,7924,183,50339443,America,1248417,35287
2020-11-24,Colombia,CO,6562,192,50339443,America,1254979,35479
2020-11-25,Colombia,CO,7515,198,50339443,America,1262494,35677
2020-11-26,Colombia,CO,8497,183,50339443,America,1270991,35860
2020-11-27,Colombia,CO,9496,159,50339443,America,1280487,36019
2020-11-28,Colombia,CO,10023,195,50339443,America,1290510,36214
2020-11-29,Colombia,CO,9103,187,50339443,America,1299613,36401
2020-11-30,Colombia,CO,8763,183,50339443,America,1308376,36584
2020-12-01,Colombia,CO,8430,182,50339443,America,1316806,36766
2020-12-02,Colombia,CO,7986,168,50339443,America,1324792,36934
2020-12-03,Colombia,CO,9297,183,50339443,America,1334089,37117
2020-12-04,Colombia,CO,9233,188,50339443,America,1343322,37305
2020-12-05,Colombia,CO,9285,162,50339443,America,1352607,37467
2020-12-06,Colombia,CO,9642,166,50339443,America,1362249,37633
2020-12-07,Colombia,CO,8854,175,50339443,America,1371103,37808
2020-12-08,Colombia,CO,5997,187,50339443,America,1377100,37995
2020-12-09,Colombia,CO,7510,163,50339443,America,1384610,38158
2020-12-10,Colombia,CO,7523,150,50339443,America,1392133,38308
2020-12-11,Colombia,CO,7778,176,50339443,America,1399911,38484
2020-12-12,Colombia,CO,8998,185,50339443,America,1408909,38669
2020-12-13,Colombia,CO,8163,197,50339443,America,1417072,38866
2020-12-14,Colombia,CO,8702,187,50339443,America,1425774,39053
2020-03-07,Costa_Rica,CR,1,0,5047561,America,1,0
2020-03-09,Costa_Rica,CR,4,0,5047561,America,5,0
2020-03-10,Costa_Rica,CR,4,0,5047561,America,9,0
2020-03-11,Costa_Rica,CR,4,0,5047561,America,13,0
2020-03-12,Costa_Rica,CR,9,0,5047561,America,22,0
2020-03-13,Costa_Rica,CR,1,0,5047561,America,23,0
2020-03-14,Costa_Rica,CR,3,0,5047561,America,26,0
2020-03-15,Costa_Rica,CR,1,0,5047561,America,27,0
2020-03-16,Costa_Rica,CR,8,0,5047561,America,35,0
2020-03-17,Costa_Rica,CR,6,0,5047561,America,41,0
2020-03-18,Costa_Rica,CR,9,0,5047561,America,50,0
2020-03-19,Costa_Rica,CR,19,1,5047561,America,69,1
2020-03-20,Costa_Rica,CR,18,0,5047561,America,87,1
2020-03-21,Costa_Rica,CR,26,1,5047561,America,113,2
2020-03-22,Costa_Rica,CR,4,0,5047561,America,117,2
2020-03-23,Costa_Rica,CR,17,0,5047561,America,134,2
2020-03-24,Costa_Rica,CR,24,0,5047561,America,158,2
2020-03-25,Costa_Rica,CR,19,0,5047561,America,177,2
2020-03-26,Costa_Rica,CR,24,0,5047561,America,201,2
2020-03-27,Costa_Rica,CR,30,0,5047561,America,231,2
2020-03-28,Costa_Rica,CR,32,0,5047561,America,263,2
2020-03-29,Costa_Rica,CR,32,0,5047561,America,295,2
2020-03-30,Costa_Rica,CR,19,0,5047561,America,314,2
2020-03-31,Costa_Rica,CR,16,0,5047561,America,330,2
2020-04-01,Costa_Rica,CR,17,0,5047561,America,347,2
2020-04-02,Costa_Rica,CR,28,0,5047561,America,375,2
2020-04-03,Costa_Rica,CR,21,0,5047561,America,396,2
2020-04-04,Costa_Rica,CR,20,0,5047561,America,416,2
2020-04-05,Costa_Rica,CR,19,0,5047561,America,435,2
2020-04-06,Costa_Rica,CR,19,0,5047561,America,454,2
2020-04-07,Costa_Rica,CR,13,0,5047561,America,467,2
2020-04-08,Costa_Rica,CR,16,0,5047561,America,483,2
2020-04-09,Costa_Rica,CR,19,0,5047561,America,502,2
2020-04-10,Costa_Rica,CR,37,1,5047561,America,539,3
2020-04-11,Costa_Rica,CR,19,0,5047561,America,558,3
2020-04-12,Costa_Rica,CR,19,0,5047561,America,577,3
2020-04-13,Costa_Rica,CR,18,0,5047561,America,595,3
2020-04-14,Costa_Rica,CR,17,0,5047561,America,612,3
2020-04-15,Costa_Rica,CR,6,0,5047561,America,618,3
2020-04-16,Costa_Rica,CR,8,1,5047561,America,626,4
2020-04-17,Costa_Rica,CR,16,0,5047561,America,642,4
2020-04-18,Costa_Rica,CR,7,0,5047561,America,649,4
2020-04-19,Costa_Rica,CR,6,0,5047561,America,655,4
2020-04-20,Costa_Rica,CR,5,0,5047561,America,660,4
2020-04-21,Costa_Rica,CR,2,2,5047561,America,662,6
2020-04-22,Costa_Rica,CR,7,0,5047561,America,669,6
2020-04-23,Costa_Rica,CR,12,0,5047561,America,681,6
2020-04-24,Costa_Rica,CR,6,0,5047561,America,687,6
2020-04-25,Costa_Rica,CR,0,0,5047561,America,687,6
2020-04-26,Costa_Rica,CR,6,0,5047561,America,693,6
2020-04-27,Costa_Rica,CR,2,0,5047561,America,695,6
2020-04-28,Costa_Rica,CR,2,0,5047561,America,697,6
2020-04-29,Costa_Rica,CR,8,0,5047561,America,705,6
2020-04-30,Costa_Rica,CR,8,0,5047561,America,713,6
2020-05-01,Costa_Rica,CR,6,0,5047561,America,719,6
2020-05-02,Costa_Rica,CR,6,0,5047561,America,725,6
2020-05-03,Costa_Rica,CR,8,0,5047561,America,733,6
2020-05-04,Costa_Rica,CR,6,0,5047561,America,739,6
2020-05-05,Costa_Rica,CR,3,0,5047561,America,742,6
2020-05-06,Costa_Rica,CR,13,0,5047561,America,755,6
2020-05-07,Costa_Rica,CR,6,0,5047561,America,761,6
2020-05-08,Costa_Rica,CR,4,0,5047561,America,765,6
2020-05-09,Costa_Rica,CR,8,0,5047561,America,773,6
2020-05-10,Costa_Rica,CR,7,0,5047561,America,780,6
2020-05-11,Costa_Rica,CR,12,0,5047561,America,792,6
2020-05-12,Costa_Rica,CR,9,1,5047561,America,801,7
2020-05-13,Costa_Rica,CR,3,0,5047561,America,804,7
2020-05-14,Costa_Rica,CR,11,0,5047561,America,815,7
2020-05-15,Costa_Rica,CR,15,1,5047561,America,830,8
2020-05-16,Costa_Rica,CR,13,0,5047561,America,843,8
2020-05-17,Costa_Rica,CR,10,2,5047561,America,853,10
2020-05-18,Costa_Rica,CR,10,0,5047561,America,863,10
2020-05-19,Costa_Rica,CR,3,0,5047561,America,866,10
2020-05-20,Costa_Rica,CR,16,0,5047561,America,882,10
2020-05-21,Costa_Rica,CR,15,0,5047561,America,897,10
2020-05-22,Costa_Rica,CR,6,0,5047561,America,903,10
2020-05-23,Costa_Rica,CR,8,0,5047561,America,911,10
2020-05-24,Costa_Rica,CR,7,0,5047561,America,918,10
2020-05-25,Costa_Rica,CR,12,0,5047561,America,930,10
2020-05-26,Costa_Rica,CR,21,0,5047561,America,951,10
2020-05-27,Costa_Rica,CR,5,0,5047561,America,956,10
2020-05-28,Costa_Rica,CR,28,0,5047561,America,984,10
2020-05-29,Costa_Rica,CR,16,0,5047561,America,1000,10
2020-05-30,Costa_Rica,CR,22,0,5047561,America,1022,10
2020-05-31,Costa_Rica,CR,25,0,5047561,America,1047,10
2020-06-01,Costa_Rica,CR,9,0,5047561,America,1056,10
2020-06-02,Costa_Rica,CR,28,0,5047561,America,1084,10
2020-06-03,Costa_Rica,CR,21,0,5047561,America,1105,10
2020-06-04,Costa_Rica,CR,52,0,5047561,America,1157,10
2020-06-05,Costa_Rica,CR,37,0,5047561,America,1194,10
2020-06-06,Costa_Rica,CR,34,0,5047561,America,1228,10
2020-06-07,Costa_Rica,CR,35,0,5047561,America,1263,10
2020-06-08,Costa_Rica,CR,55,0,5047561,America,1318,10
2020-06-09,Costa_Rica,CR,24,0,5047561,America,1342,10
2020-06-10,Costa_Rica,CR,33,1,5047561,America,1375,11
2020-06-11,Costa_Rica,CR,86,1,5047561,America,1461,12
2020-06-12,Costa_Rica,CR,77,0,5047561,America,1538,12
2020-06-13,Costa_Rica,CR,74,0,5047561,America,1612,12
2020-06-14,Costa_Rica,CR,50,0,5047561,America,1662,12
2020-06-15,Costa_Rica,CR,53,0,5047561,America,1715,12
2020-06-16,Costa_Rica,CR,29,0,5047561,America,1744,12
2020-06-17,Costa_Rica,CR,25,0,5047561,America,1769,12
2020-06-18,Costa_Rica,CR,102,0,5047561,America,1871,12
2020-06-19,Costa_Rica,CR,68,0,5047561,America,1939,12
2020-06-20,Costa_Rica,CR,119,0,5047561,America,2058,12
2020-06-21,Costa_Rica,CR,69,0,5047561,America,2127,12
2020-06-22,Costa_Rica,CR,86,0,5047561,America,2213,12
2020-06-23,Costa_Rica,CR,64,0,5047561,America,2277,12
2020-06-24,Costa_Rica,CR,91,0,5047561,America,2368,12
2020-06-25,Costa_Rica,CR,147,0,5047561,America,2515,12
2020-06-26,Costa_Rica,CR,169,0,5047561,America,2684,12
2020-06-27,Costa_Rica,CR,152,0,5047561,America,2836,12
2020-06-28,Costa_Rica,CR,143,0,5047561,America,2979,12
2020-06-29,Costa_Rica,CR,151,3,5047561,America,3130,15
2020-06-30,Costa_Rica,CR,139,0,5047561,America,3269,15
2020-07-01,Costa_Rica,CR,190,1,5047561,America,3459,16
2020-07-02,Costa_Rica,CR,294,1,5047561,America,3753,17
2020-07-03,Costa_Rica,CR,270,0,5047561,America,4023,17
2020-07-04,Costa_Rica,CR,288,1,5047561,America,4311,18
2020-07-05,Costa_Rica,CR,310,0,5047561,America,4621,18
2020-07-06,Costa_Rica,CR,375,1,5047561,America,4996,19
2020-07-07,Costa_Rica,CR,245,4,5047561,America,5241,23
2020-07-08,Costa_Rica,CR,245,0,5047561,America,5486,23
2020-07-09,Costa_Rica,CR,350,1,5047561,America,5836,24
2020-07-10,Costa_Rica,CR,649,1,5047561,America,6485,25
2020-07-11,Costa_Rica,CR,360,1,5047561,America,6845,26
2020-07-12,Costa_Rica,CR,386,2,5047561,America,7231,28
2020-07-13,Costa_Rica,CR,365,2,5047561,America,7596,30
2020-07-14,Costa_Rica,CR,440,1,5047561,America,8036,31
2020-07-15,Costa_Rica,CR,446,5,5047561,America,8482,36
2020-07-16,Costa_Rica,CR,504,4,5047561,America,8986,40
2020-07-17,Costa_Rica,CR,560,2,5047561,America,9546,42
2020-07-18,Costa_Rica,CR,423,5,5047561,America,9969,47
2020-07-19,Costa_Rica,CR,582,7,5047561,America,10551,54
2020-07-20,Costa_Rica,CR,563,8,5047561,America,11114,62
2020-07-21,Costa_Rica,CR,420,4,5047561,America,11534,66
2020-07-22,Costa_Rica,CR,277,2,5047561,America,11811,68
2020-07-23,Costa_Rica,CR,550,3,5047561,America,12361,71
2020-07-24,Costa_Rica,CR,768,9,5047561,America,13129,80
2020-07-25,Costa_Rica,CR,540,7,5047561,America,13669,87
2020-07-26,Costa_Rica,CR,931,11,5047561,America,14600,98
2020-07-27,Costa_Rica,CR,629,6,5047561,America,15229,104
2020-07-28,Costa_Rica,CR,612,11,5047561,America,15841,115
2020-07-29,Costa_Rica,CR,503,10,5047561,America,16344,125
2020-07-30,Costa_Rica,CR,456,8,5047561,America,16800,133
2020-07-31,Costa_Rica,CR,490,7,5047561,America,17290,140
2020-08-01,Costa_Rica,CR,530,10,5047561,America,17820,150
2020-08-02,Costa_Rica,CR,367,4,5047561,America,18187,154
2020-08-03,Costa_Rica,CR,788,8,5047561,America,18975,162
2020-08-04,Costa_Rica,CR,427,9,5047561,America,19402,171
2020-08-05,Costa_Rica,CR,435,10,5047561,America,19837,181
2020-08-06,Costa_Rica,CR,580,10,5047561,America,20417,191
2020-08-07,Costa_Rica,CR,653,9,5047561,America,21070,200
2020-08-08,Costa_Rica,CR,1011,18,5047561,America,22081,218
2020-08-09,Costa_Rica,CR,1,10,5047561,America,22082,228
2020-08-10,Costa_Rica,CR,1204,7,5047561,America,23286,235
2020-08-11,Costa_Rica,CR,586,9,5047561,America,23872,244
2020-08-12,Costa_Rica,CR,636,11,5047561,America,24508,255
2020-08-13,Costa_Rica,CR,549,8,5047561,America,25057,263
2020-08-14,Costa_Rica,CR,1072,9,5047561,America,26129,272
2020-08-15,Costa_Rica,CR,802,9,5047561,America,26931,281
2020-08-16,Costa_Rica,CR,806,10,5047561,America,27737,291
2020-08-17,Costa_Rica,CR,728,3,5047561,America,28465,294
2020-08-18,Costa_Rica,CR,619,10,5047561,America,29084,304
2020-08-19,Costa_Rica,CR,559,10,5047561,America,29643,314
2020-08-20,Costa_Rica,CR,766,7,5047561,America,30409,321
2020-08-21,Costa_Rica,CR,666,12,5047561,America,31075,333
2020-08-22,Costa_Rica,CR,1059,7,5047561,America,32134,340
2020-08-23,Costa_Rica,CR,950,8,5047561,America,33084,348
2020-08-24,Costa_Rica,CR,736,7,5047561,America,33820,355
2020-08-25,Costa_Rica,CR,643,7,5047561,America,34463,362
2020-08-26,Costa_Rica,CR,842,14,5047561,America,35305,376
2020-08-27,Costa_Rica,CR,1002,10,5047561,America,36307,386
2020-08-28,Costa_Rica,CR,985,11,5047561,America,37292,397
2020-08-29,Costa_Rica,CR,1193,10,5047561,America,38485,407
2020-08-30,Costa_Rica,CR,1214,11,5047561,America,39699,418
2020-08-31,Costa_Rica,CR,0,0,5047561,America,39699,418
2020-09-01,Costa_Rica,CR,1588,18,5047561,America,41287,436
2020-09-02,Costa_Rica,CR,897,7,5047561,America,42184,443
2020-09-03,Costa_Rica,CR,1121,10,5047561,America,43305,453
2020-09-04,Costa_Rica,CR,1153,7,5047561,America,44458,460
2020-09-05,Costa_Rica,CR,1222,9,5047561,America,45680,469
2020-09-06,Costa_Rica,CR,1240,9,5047561,America,46920,478
2020-09-07,Costa_Rica,CR,0,0,5047561,America,46920,478
2020-09-08,Costa_Rica,CR,1860,32,5047561,America,48780,510
2020-09-09,Costa_Rica,CR,1117,21,5047561,America,49897,531
2020-09-10,Costa_Rica,CR,1327,12,5047561,America,51224,543
2020-09-11,Costa_Rica,CR,1325,24,5047561,America,52549,567
2020-09-12,Costa_Rica,CR,1420,16,5047561,America,53969,583
2020-09-13,Costa_Rica,CR,1485,7,5047561,America,55454,590
2020-09-14,Costa_Rica,CR,0,0,5047561,America,55454,590
2020-09-15,Costa_Rica,CR,1897,31,5047561,America,57351,621
2020-09-16,Costa_Rica,CR,787,12,5047561,America,58138,633
2020-09-17,Costa_Rica,CR,1378,16,5047561,America,59516,649
2020-09-18,Costa_Rica,CR,1302,17,5047561,America,60818,666
2020-09-19,Costa_Rica,CR,1556,20,5047561,America,62374,686
2020-09-20,Costa_Rica,CR,1338,20,5047561,America,63712,706
2020-09-21,Costa_Rica,CR,0,0,5047561,America,63712,706
2020-09-22,Costa_Rica,CR,1890,39,5047561,America,65602,745
2020-09-23,Costa_Rica,CR,1087,15,5047561,America,66689,760
2020-09-24,Costa_Rica,CR,1370,21,5047561,America,68059,781
2020-09-25,Costa_Rica,CR,1400,14,5047561,America,69459,795
2020-09-26,Costa_Rica,CR,1357,17,5047561,America,70816,812
2020-09-27,Costa_Rica,CR,1233,16,5047561,America,72049,828
2020-09-28,Costa_Rica,CR,0,0,5047561,America,72049,828
2020-09-29,Costa_Rica,CR,1665,33,5047561,America,73714,861
2020-09-30,Costa_Rica,CR,890,19,5047561,America,74604,880
2020-10-01,Costa_Rica,CR,1156,24,5047561,America,75760,904
2020-10-02,Costa_Rica,CR,1068,13,5047561,America,76828,917
2020-10-03,Costa_Rica,CR,1001,13,5047561,America,77829,930
2020-10-04,Costa_Rica,CR,1353,20,5047561,America,79182,950
2020-10-05,Costa_Rica,CR,0,0,5047561,America,79182,950
2020-10-06,Costa_Rica,CR,1947,37,5047561,America,81129,987
2020-10-07,Costa_Rica,CR,1013,17,5047561,America,82142,1004
2020-10-08,Costa_Rica,CR,1355,20,5047561,America,83497,1024
2020-10-09,Costa_Rica,CR,1331,16,5047561,America,84828,1040
2020-10-10,Costa_Rica,CR,1225,15,5047561,America,86053,1055
2020-10-11,Costa_Rica,CR,1386,21,5047561,America,87439,1076
2020-10-12,Costa_Rica,CR,0,0,5047561,America,87439,1076
2020-10-13,Costa_Rica,CR,1784,32,5047561,America,89223,1108
2020-10-14,Costa_Rica,CR,1015,16,5047561,America,90238,1124
2020-10-15,Costa_Rica,CR,1542,10,5047561,America,91780,1134
2020-10-16,Costa_Rica,CR,1372,25,5047561,America,93152,1159
2020-10-17,Costa_Rica,CR,1196,9,5047561,America,94348,1168
2020-10-18,Costa_Rica,CR,1166,15,5047561,America,95514,1183
2020-10-19,Costa_Rica,CR,0,0,5047561,America,95514,1183
2020-10-20,Costa_Rica,CR,1561,21,5047561,America,97075,1204
2020-10-21,Costa_Rica,CR,847,18,5047561,America,97922,1222
2020-10-22,Costa_Rica,CR,1503,14,5047561,America,99425,1236
2020-10-23,Costa_Rica,CR,1191,15,5047561,America,100616,1251
2020-10-24,Costa_Rica,CR,1210,14,5047561,America,101826,1265
2020-10-25,Costa_Rica,CR,1262,17,5047561,America,103088,1282
2020-10-26,Costa_Rica,CR,0,0,5047561,America,103088,1282
2020-10-27,Costa_Rica,CR,1372,30,5047561,America,104460,1312
2020-10-28,Costa_Rica,CR,862,17,5047561,America,105322,1329
2020-10-29,Costa_Rica,CR,1231,11,5047561,America,106553,1340
2020-10-30,Costa_Rica,CR,1017,17,5047561,America,107570,1357
2020-10-31,Costa_Rica,CR,1296,14,5047561,America,108866,1371
2020-11-01,Costa_Rica,CR,1105,14,5047561,America,109971,1385
2020-11-02,Costa_Rica,CR,0,0,5047561,America,109971,1385
2020-11-03,Costa_Rica,CR,1286,19,5047561,America,111257,1404
2020-11-04,Costa_Rica,CR,863,15,5047561,America,112120,1419
2020-11-05,Costa_Rica,CR,1141,12,5047561,America,113261,1431
2020-11-06,Costa_Rica,CR,1106,13,5047561,America,114367,1444
2020-11-07,Costa_Rica,CR,1050,9,5047561,America,115417,1453
2020-11-08,Costa_Rica,CR,946,11,5047561,America,116363,1464
2020-11-09,Costa_Rica,CR,0,0,5047561,America,116363,1464
2020-11-10,Costa_Rica,CR,1224,27,5047561,America,117587,1491
2020-11-11,Costa_Rica,CR,979,11,5047561,America,118566,1502
2020-11-12,Costa_Rica,CR,1202,11,5047561,America,119768,1513
2020-11-13,Costa_Rica,CR,1171,14,5047561,America,120939,1527
2020-11-14,Costa_Rica,CR,1184,10,5047561,America,122123,1537
2020-11-15,Costa_Rica,CR,1100,9,5047561,America,123223,1546
2020-11-16,Costa_Rica,CR,0,0,5047561,America,123223,1546
2020-11-17,Costa_Rica,CR,1369,20,5047561,America,124592,1566
2020-11-18,Costa_Rica,CR,998,12,5047561,America,125590,1578
2020-11-19,Costa_Rica,CR,1422,10,5047561,America,127012,1588
2020-11-20,Costa_Rica,CR,1219,11,5047561,America,128231,1599
2020-11-21,Costa_Rica,CR,1187,9,5047561,America,129418,1608
2020-11-22,Costa_Rica,CR,0,0,5047561,America,129418,1608
2020-11-23,Costa_Rica,CR,0,0,5047561,America,129418,1608
2020-11-24,Costa_Rica,CR,2877,33,5047561,America,132295,1641
2020-11-25,Costa_Rica,CR,895,21,5047561,America,133190,1662
2020-11-26,Costa_Rica,CR,1330,12,5047561,America,134520,1674
2020-11-27,Costa_Rica,CR,1222,5,5047561,America,135742,1679
2020-11-28,Costa_Rica,CR,1351,11,5047561,America,137093,1690
2020-11-29,Costa_Rica,CR,0,0,5047561,America,137093,1690
2020-11-30,Costa_Rica,CR,0,0,5047561,America,137093,1690
2020-12-01,Costa_Rica,CR,2545,36,5047561,America,139638,1726
2020-12-02,Costa_Rica,CR,534,5,5047561,America,140172,1731
2020-12-03,Costa_Rica,CR,1168,8,5047561,America,141340,1739
2020-12-04,Costa_Rica,CR,1165,18,5047561,America,142505,1757
2020-12-05,Costa_Rica,CR,1180,16,5047561,America,143685,1773
2020-12-06,Costa_Rica,CR,0,0,5047561,America,143685,1773
2020-12-07,Costa_Rica,CR,0,0,5047561,America,143685,1773
2020-12-08,Costa_Rica,CR,2736,52,5047561,America,146421,1825
2020-12-09,Costa_Rica,CR,1009,21,5047561,America,147430,1846
2020-12-10,Costa_Rica,CR,1258,18,5047561,America,148688,1864
2020-12-11,Costa_Rica,CR,1127,18,5047561,America,149815,1882
2020-12-12,Costa_Rica,CR,1132,13,5047561,America,150947,1895
2020-12-13,Costa_Rica,CR,0,0,5047561,America,150947,1895
2020-12-14,Costa_Rica,CR,0,0,5047561,America,150947,1895
2020-03-12,Cuba,CU,3,0,11333484,America,3,0
2020-03-14,Cuba,CU,1,0,11333484,America,4,0
2020-03-15,Cuba,CU,0,0,11333484,America,4,0
2020-03-18,Cuba,CU,3,0,11333484,America,7,0
2020-03-19,Cuba,CU,4,1,11333484,America,11,1
2020-03-20,Cuba,CU,5,0,11333484,America,16,1
2020-03-21,Cuba,CU,5,0,11333484,America,21,1
2020-03-22,Cuba,CU,4,0,11333484,America,25,1
2020-03-23,Cuba,CU,10,0,11333484,America,35,1
2020-03-24,Cuba,CU,5,0,11333484,America,40,1
2020-03-25,Cuba,CU,8,0,11333484,America,48,1
2020-03-26,Cuba,CU,9,0,11333484,America,57,1
2020-03-27,Cuba,CU,10,1,11333484,America,67,2
2020-03-28,Cuba,CU,13,0,11333484,America,80,2
2020-03-29,Cuba,CU,39,1,11333484,America,119,3
2020-03-30,Cuba,CU,20,0,11333484,America,139,3
2020-03-31,Cuba,CU,31,1,11333484,America,170,4
2020-04-01,Cuba,CU,16,2,11333484,America,186,6
2020-04-02,Cuba,CU,26,0,11333484,America,212,6
2020-04-03,Cuba,CU,21,0,11333484,America,233,6
2020-04-04,Cuba,CU,36,0,11333484,America,269,6
2020-04-05,Cuba,CU,19,0,11333484,America,288,6
2020-04-06,Cuba,CU,32,2,11333484,America,320,8
2020-04-07,Cuba,CU,30,1,11333484,America,350,9
2020-04-08,Cuba,CU,46,2,11333484,America,396,11
2020-04-09,Cuba,CU,61,1,11333484,America,457,12
2020-04-10,Cuba,CU,58,3,11333484,America,515,15
2020-04-11,Cuba,CU,49,0,11333484,America,564,15
2020-04-12,Cuba,CU,56,1,11333484,America,620,16
2020-04-13,Cuba,CU,49,2,11333484,America,669,18
2020-04-14,Cuba,CU,57,3,11333484,America,726,21
2020-04-15,Cuba,CU,40,0,11333484,America,766,21
2020-04-16,Cuba,CU,48,3,11333484,America,814,24
2020-04-17,Cuba,CU,48,3,11333484,America,862,27
2020-04-18,Cuba,CU,61,4,11333484,America,923,31
2020-04-19,Cuba,CU,63,1,11333484,America,986,32
2020-04-20,Cuba,CU,49,2,11333484,America,1035,34
2020-04-21,Cuba,CU,52,2,11333484,America,1087,36
2020-04-22,Cuba,CU,50,2,11333484,America,1137,38
2020-04-23,Cuba,CU,52,2,11333484,America,1189,40
2020-04-24,Cuba,CU,46,3,11333484,America,1235,43
2020-04-25,Cuba,CU,50,6,11333484,America,1285,49
2020-04-26,Cuba,CU,52,2,11333484,America,1337,51
2020-04-27,Cuba,CU,32,3,11333484,America,1369,54
2020-04-28,Cuba,CU,20,2,11333484,America,1389,56
2020-04-29,Cuba,CU,48,2,11333484,America,1437,58
2020-04-30,Cuba,CU,30,0,11333484,America,1467,58
2020-05-01,Cuba,CU,34,3,11333484,America,1501,61
2020-05-02,Cuba,CU,36,3,11333484,America,1537,64
2020-05-03,Cuba,CU,74,2,11333484,America,1611,66
2020-05-04,Cuba,CU,38,1,11333484,America,1649,67
2020-05-05,Cuba,CU,19,2,11333484,America,1668,69
2020-05-06,Cuba,CU,17,0,11333484,America,1685,69
2020-05-07,Cuba,CU,18,0,11333484,America,1703,69
2020-05-08,Cuba,CU,26,4,11333484,America,1729,73
2020-05-09,Cuba,CU,12,1,11333484,America,1741,74
2020-05-10,Cuba,CU,13,0,11333484,America,1754,74
2020-05-11,Cuba,CU,12,3,11333484,America,1766,77
2020-05-12,Cuba,CU,17,0,11333484,America,1783,77
2020-05-13,Cuba,CU,21,1,11333484,America,1804,78
2020-05-14,Cuba,CU,6,1,11333484,America,1810,79
2020-05-15,Cuba,CU,20,0,11333484,America,1830,79
2020-05-16,Cuba,CU,10,0,11333484,America,1840,79
2020-05-17,Cuba,CU,22,0,11333484,America,1862,79
2020-05-18,Cuba,CU,10,0,11333484,America,1872,79
2020-05-19,Cuba,CU,9,0,11333484,America,1881,79
2020-05-20,Cuba,CU,6,0,11333484,America,1887,79
2020-05-21,Cuba,CU,13,0,11333484,America,1900,79
2020-05-22,Cuba,CU,8,1,11333484,America,1908,80
2020-05-23,Cuba,CU,8,1,11333484,America,1916,81
2020-05-24,Cuba,CU,15,0,11333484,America,1931,81
2020-05-25,Cuba,CU,10,1,11333484,America,1941,82
2020-05-26,Cuba,CU,6,0,11333484,America,1947,82
2020-05-27,Cuba,CU,16,0,11333484,America,1963,82
2020-05-28,Cuba,CU,11,0,11333484,America,1974,82
2020-05-29,Cuba,CU,9,0,11333484,America,1983,82
2020-05-30,Cuba,CU,22,0,11333484,America,2005,82
2020-05-31,Cuba,CU,20,1,11333484,America,2025,83
2020-06-01,Cuba,CU,20,0,11333484,America,2045,83
2020-06-02,Cuba,CU,38,0,11333484,America,2083,83
2020-06-03,Cuba,CU,9,0,11333484,America,2092,83
2020-06-04,Cuba,CU,15,0,11333484,America,2107,83
2020-06-05,Cuba,CU,12,0,11333484,America,2119,83
2020-06-06,Cuba,CU,14,0,11333484,America,2133,83
2020-06-07,Cuba,CU,40,0,11333484,America,2173,83
2020-06-08,Cuba,CU,18,0,11333484,America,2191,83
2020-06-09,Cuba,CU,9,0,11333484,America,2200,83
2020-06-10,Cuba,CU,5,0,11333484,America,2205,83
2020-06-11,Cuba,CU,6,0,11333484,America,2211,83
2020-06-12,Cuba,CU,8,1,11333484,America,2219,84
2020-06-13,Cuba,CU,14,0,11333484,America,2233,84
2020-06-14,Cuba,CU,5,0,11333484,America,2238,84
2020-06-15,Cuba,CU,10,0,11333484,America,2248,84
2020-06-16,Cuba,CU,14,0,11333484,America,2262,84
2020-06-17,Cuba,CU,11,0,11333484,America,2273,84
2020-06-18,Cuba,CU,7,0,11333484,America,2280,84
2020-06-19,Cuba,CU,15,1,11333484,America,2295,85
2020-06-20,Cuba,CU,10,0,11333484,America,2305,85
2020-06-21,Cuba,CU,4,0,11333484,America,2309,85
2020-06-22,Cuba,CU,3,0,11333484,America,2312,85
2020-06-23,Cuba,CU,3,0,11333484,America,2315,85
2020-06-24,Cuba,CU,3,0,11333484,America,2318,85
2020-06-25,Cuba,CU,1,0,11333484,America,2319,85
2020-06-26,Cuba,CU,2,0,11333484,America,2321,85
2020-06-27,Cuba,CU,4,0,11333484,America,2325,85
2020-06-28,Cuba,CU,5,1,11333484,America,2330,86
2020-06-29,Cuba,CU,2,0,11333484,America,2332,86
2020-06-30,Cuba,CU,8,0,11333484,America,2340,86
2020-07-01,Cuba,CU,1,0,11333484,America,2341,86
2020-07-02,Cuba,CU,7,0,11333484,America,2348,86
2020-07-03,Cuba,CU,5,0,11333484,America,2353,86
2020-07-04,Cuba,CU,8,0,11333484,America,2361,86
2020-07-05,Cuba,CU,8,0,11333484,America,2369,86
2020-07-06,Cuba,CU,3,0,11333484,America,2372,86
2020-07-07,Cuba,CU,8,0,11333484,America,2380,86
2020-07-08,Cuba,CU,15,0,11333484,America,2395,86
2020-07-09,Cuba,CU,4,0,11333484,America,2399,86
2020-07-10,Cuba,CU,4,0,11333484,America,2403,86
2020-07-11,Cuba,CU,10,0,11333484,America,2413,86
2020-07-12,Cuba,CU,7,1,11333484,America,2420,87
2020-07-13,Cuba,CU,6,0,11333484,America,2426,87
2020-07-14,Cuba,CU,2,0,11333484,America,2428,87
2020-07-15,Cuba,CU,4,0,11333484,America,2432,87
2020-07-16,Cuba,CU,6,0,11333484,America,2438,87
2020-07-17,Cuba,CU,2,0,11333484,America,2440,87
2020-07-18,Cuba,CU,4,0,11333484,America,2444,87
2020-07-19,Cuba,CU,1,0,11333484,America,2445,87
2020-07-20,Cuba,CU,1,0,11333484,America,2446,87
2020-07-21,Cuba,CU,0,0,11333484,America,2446,87
2020-07-22,Cuba,CU,3,0,11333484,America,2449,87
2020-07-23,Cuba,CU,13,0,11333484,America,2462,87
2020-07-24,Cuba,CU,4,0,11333484,America,2466,87
2020-07-25,Cuba,CU,3,0,11333484,America,2469,87
2020-07-26,Cuba,CU,9,0,11333484,America,2478,87
2020-07-27,Cuba,CU,17,0,11333484,America,2495,87
2020-07-28,Cuba,CU,37,0,11333484,America,2532,87
2020-07-29,Cuba,CU,23,0,11333484,America,2555,87
2020-07-30,Cuba,CU,33,0,11333484,America,2588,87
2020-07-31,Cuba,CU,9,0,11333484,America,2597,87
2020-08-01,Cuba,CU,11,0,11333484,America,2608,87
2020-08-02,Cuba,CU,25,0,11333484,America,2633,87
2020-08-03,Cuba,CU,13,0,11333484,America,2646,87
2020-08-04,Cuba,CU,24,0,11333484,America,2670,87
2020-08-05,Cuba,CU,31,1,11333484,America,2701,88
2020-08-06,Cuba,CU,25,0,11333484,America,2726,88
2020-08-07,Cuba,CU,49,0,11333484,America,2775,88
2020-08-08,Cuba,CU,54,0,11333484,America,2829,88
2020-08-09,Cuba,CU,59,0,11333484,America,2888,88
2020-08-10,Cuba,CU,65,0,11333484,America,2953,88
2020-08-11,Cuba,CU,93,0,11333484,America,3046,88
2020-08-12,Cuba,CU,47,0,11333484,America,3093,88
2020-08-13,Cuba,CU,35,0,11333484,America,3128,88
2020-08-14,Cuba,CU,46,0,11333484,America,3174,88
2020-08-15,Cuba,CU,55,0,11333484,America,3229,88
2020-08-16,Cuba,CU,63,0,11333484,America,3292,88
2020-08-17,Cuba,CU,24,0,11333484,America,3316,88
2020-08-18,Cuba,CU,48,0,11333484,America,3364,88
2020-08-19,Cuba,CU,44,0,11333484,America,3408,88
2020-08-20,Cuba,CU,74,0,11333484,America,3482,88
2020-08-21,Cuba,CU,83,0,11333484,America,3565,88
2020-08-22,Cuba,CU,17,1,11333484,America,3582,89
2020-08-23,Cuba,CU,35,0,11333484,America,3617,89
2020-08-24,Cuba,CU,65,2,11333484,America,3682,91
2020-08-25,Cuba,CU,35,0,11333484,America,3717,91
2020-08-26,Cuba,CU,27,0,11333484,America,3744,91
2020-08-27,Cuba,CU,15,1,11333484,America,3759,92
2020-08-28,Cuba,CU,47,0,11333484,America,3806,92
2020-08-29,Cuba,CU,60,0,11333484,America,3866,92
2020-08-30,Cuba,CU,59,2,11333484,America,3925,94
2020-08-31,Cuba,CU,48,0,11333484,America,3973,94
2020-09-01,Cuba,CU,59,0,11333484,America,4032,94
2020-09-02,Cuba,CU,33,1,11333484,America,4065,95
2020-09-03,Cuba,CU,61,3,11333484,America,4126,98
2020-09-04,Cuba,CU,88,2,11333484,America,4214,100
2020-09-05,Cuba,CU,52,0,11333484,America,4266,100
2020-09-06,Cuba,CU,32,0,11333484,America,4298,100
2020-09-07,Cuba,CU,11,1,11333484,America,4309,101
2020-09-08,Cuba,CU,43,1,11333484,America,4352,102
2020-09-09,Cuba,CU,25,2,11333484,America,4377,104
2020-09-10,Cuba,CU,82,0,11333484,America,4459,104
2020-09-11,Cuba,CU,92,2,11333484,America,4551,106
2020-09-12,Cuba,CU,42,0,11333484,America,4593,106
2020-09-13,Cuba,CU,60,2,11333484,America,4653,108
2020-09-14,Cuba,CU,31,0,11333484,America,4684,108
2020-09-15,Cuba,CU,42,0,11333484,America,4726,108
2020-09-16,Cuba,CU,77,0,11333484,America,4803,108
2020-09-17,Cuba,CU,73,1,11333484,America,4876,109
2020-09-18,Cuba,CU,57,0,11333484,America,4933,109
2020-09-19,Cuba,CU,71,2,11333484,America,5004,111
2020-09-20,Cuba,CU,51,2,11333484,America,5055,113
2020-09-21,Cuba,CU,36,2,11333484,America,5091,115
2020-09-22,Cuba,CU,50,1,11333484,America,5141,116
2020-09-23,Cuba,CU,81,1,11333484,America,5222,117
2020-09-24,Cuba,CU,48,1,11333484,America,5270,118
2020-09-25,Cuba,CU,40,0,11333484,America,5310,118
2020-09-26,Cuba,CU,40,0,11333484,America,5350,118
2020-09-27,Cuba,CU,62,2,11333484,America,5412,120
2020-09-28,Cuba,CU,45,2,11333484,America,5457,122
2020-09-29,Cuba,CU,26,0,11333484,America,5483,122
2020-09-30,Cuba,CU,48,0,11333484,America,5531,122
2020-10-01,Cuba,CU,66,0,11333484,America,5597,122
2020-10-02,Cuba,CU,73,0,11333484,America,5670,122
2020-10-03,Cuba,CU,48,0,11333484,America,5718,122
2020-10-04,Cuba,CU,62,0,11333484,America,5780,122
2020-10-05,Cuba,CU,29,0,11333484,America,5809,122
2020-10-06,Cuba,CU,36,1,11333484,America,5845,123
2020-10-07,Cuba,CU,38,0,11333484,America,5883,123
2020-10-08,Cuba,CU,15,0,11333484,America,5898,123
2020-10-09,Cuba,CU,19,0,11333484,America,5917,123
2020-10-10,Cuba,CU,26,0,11333484,America,5943,123
2020-10-11,Cuba,CU,5,0,11333484,America,5948,123
2020-10-12,Cuba,CU,30,0,11333484,America,5978,123
2020-10-13,Cuba,CU,22,0,11333484,America,6000,123
2020-10-14,Cuba,CU,17,0,11333484,America,6017,123
2020-10-15,Cuba,CU,18,0,11333484,America,6035,123
2020-10-16,Cuba,CU,27,0,11333484,America,6062,123
2020-10-17,Cuba,CU,56,1,11333484,America,6118,124
2020-10-18,Cuba,CU,52,1,11333484,America,6170,125
2020-10-19,Cuba,CU,50,0,11333484,America,6220,125
2020-10-20,Cuba,CU,38,2,11333484,America,6258,127
2020-10-21,Cuba,CU,47,0,11333484,America,6305,127
2020-10-22,Cuba,CU,63,0,11333484,America,6368,127
2020-10-23,Cuba,CU,53,1,11333484,America,6421,128
2020-10-24,Cuba,CU,58,0,11333484,America,6479,128
2020-10-25,Cuba,CU,55,0,11333484,America,6534,128
2020-10-26,Cuba,CU,32,0,11333484,America,6566,128
2020-10-27,Cuba,CU,29,0,11333484,America,6595,128
2020-10-28,Cuba,CU,83,0,11333484,America,6678,128
2020-10-29,Cuba,CU,49,0,11333484,America,6727,128
2020-10-30,Cuba,CU,39,0,11333484,America,6766,128
2020-10-31,Cuba,CU,35,0,11333484,America,6801,128
2020-11-01,Cuba,CU,86,0,11333484,America,6887,128
2020-11-02,Cuba,CU,48,0,11333484,America,6935,128
2020-11-03,Cuba,CU,35,1,11333484,America,6970,129
2020-11-04,Cuba,CU,65,0,11333484,America,7035,129
2020-11-05,Cuba,CU,109,0,11333484,America,7144,129
2020-11-06,Cuba,CU,40,0,11333484,America,7184,129
2020-11-07,Cuba,CU,44,1,11333484,America,7228,130
2020-11-08,Cuba,CU,39,0,11333484,America,7267,130
2020-11-09,Cuba,CU,30,0,11333484,America,7297,130
2020-11-10,Cuba,CU,52,0,11333484,America,7349,130
2020-11-11,Cuba,CU,43,0,11333484,America,7392,130
2020-11-12,Cuba,CU,37,0,11333484,America,7429,130
2020-11-13,Cuba,CU,58,1,11333484,America,7487,131
2020-11-14,Cuba,CU,54,0,11333484,America,7541,131
2020-11-15,Cuba,CU,27,0,11333484,America,7568,131
2020-11-16,Cuba,CU,22,0,11333484,America,7590,131
2020-11-17,Cuba,CU,49,0,11333484,America,7639,131
2020-11-18,Cuba,CU,28,0,11333484,America,7667,131
2020-11-19,Cuba,CU,37,0,11333484,America,7704,131
2020-11-20,Cuba,CU,21,0,11333484,America,7725,131
2020-11-21,Cuba,CU,38,0,11333484,America,7763,131
2020-11-22,Cuba,CU,35,1,11333484,America,7798,132
2020-11-23,Cuba,CU,48,0,11333484,America,7846,132
2020-11-24,Cuba,CU,33,0,11333484,America,7879,132
2020-11-25,Cuba,CU,71,1,11333484,America,7950,133
2020-11-26,Cuba,CU,76,0,11333484,America,8026,133
2020-11-27,Cuba,CU,49,0,11333484,America,8075,133
2020-11-28,Cuba,CU,35,0,11333484,America,8110,133
2020-11-29,Cuba,CU,63,0,11333484,America,8173,133
2020-11-30,Cuba,CU,60,1,11333484,America,8233,134
2020-12-01,Cuba,CU,51,1,11333484,America,8284,135
2020-12-02,Cuba,CU,97,1,11333484,America,8381,136
2020-12-03,Cuba,CU,75,0,11333484,America,8456,136
2020-12-04,Cuba,CU,75,0,11333484,America,8531,136
2020-12-05,Cuba,CU,79,0,11333484,America,8610,136
2020-12-06,Cuba,CU,104,0,11333484,America,8714,136
2020-12-07,Cuba,CU,68,0,11333484,America,8782,136
2020-12-08,Cuba,CU,124,0,11333484,America,8906,136
2020-12-09,Cuba,CU,76,0,11333484,America,8982,136
2020-12-10,Cuba,CU,124,0,11333484,America,9106,136
2020-12-11,Cuba,CU,75,0,11333484,America,9181,136
2020-12-12,Cuba,CU,86,0,11333484,America,9267,136
2020-12-13,Cuba,CU,87,1,11333484,America,9354,137
2020-12-14,Cuba,CU,69,0,11333484,America,9423,137
2020-03-21,Cape_Verde,CV,2,0,549936,Africa,2,0
2020-03-22,Cape_Verde,CV,1,0,549936,Africa,3,0
2020-03-23,Cape_Verde,CV,0,0,549936,Africa,3,0
2020-03-24,Cape_Verde,CV,0,0,549936,Africa,3,0
2020-03-25,Cape_Verde,CV,0,1,549936,Africa,3,1
2020-03-26,Cape_Verde,CV,1,0,549936,Africa,4,1
2020-03-27,Cape_Verde,CV,1,0,549936,Africa,5,1
2020-03-28,Cape_Verde,CV,0,0,549936,Africa,5,1
2020-03-29,Cape_Verde,CV,0,0,549936,Africa,5,1
2020-03-30,Cape_Verde,CV,0,0,549936,Africa,5,1
2020-03-31,Cape_Verde,CV,0,0,549936,Africa,5,1
2020-04-01,Cape_Verde,CV,1,0,549936,Africa,6,1
2020-04-02,Cape_Verde,CV,0,0,549936,Africa,6,1
2020-04-03,Cape_Verde,CV,0,0,549936,Africa,6,1
2020-04-04,Cape_Verde,CV,0,0,549936,Africa,6,1
2020-04-05,Cape_Verde,CV,1,0,549936,Africa,7,1
2020-04-06,Cape_Verde,CV,0,0,549936,Africa,7,1
2020-04-07,Cape_Verde,CV,0,0,549936,Africa,7,1
2020-04-08,Cape_Verde,CV,0,0,549936,Africa,7,1
2020-04-09,Cape_Verde,CV,0,0,549936,Africa,7,1
2020-04-10,Cape_Verde,CV,0,0,549936,Africa,7,1
2020-04-11,Cape_Verde,CV,0,0,549936,Africa,7,1
2020-04-12,Cape_Verde,CV,1,0,549936,Africa,8,1
2020-04-13,Cape_Verde,CV,2,0,549936,Africa,10,1
2020-04-14,Cape_Verde,CV,0,0,549936,Africa,10,1
2020-04-15,Cape_Verde,CV,1,0,549936,Africa,11,1
2020-04-16,Cape_Verde,CV,44,0,549936,Africa,55,1
2020-04-17,Cape_Verde,CV,0,0,549936,Africa,55,1
2020-04-18,Cape_Verde,CV,1,0,549936,Africa,56,1
2020-04-19,Cape_Verde,CV,2,0,549936,Africa,58,1
2020-04-20,Cape_Verde,CV,3,0,549936,Africa,61,1
2020-04-21,Cape_Verde,CV,6,0,549936,Africa,67,1
2020-04-22,Cape_Verde,CV,0,0,549936,Africa,67,1
2020-04-23,Cape_Verde,CV,6,0,549936,Africa,73,1
2020-04-24,Cape_Verde,CV,9,0,549936,Africa,82,1
2020-04-25,Cape_Verde,CV,6,0,549936,Africa,88,1
2020-04-26,Cape_Verde,CV,2,0,549936,Africa,90,1
2020-04-27,Cape_Verde,CV,16,0,549936,Africa,106,1
2020-04-28,Cape_Verde,CV,3,0,549936,Africa,109,1
2020-04-29,Cape_Verde,CV,4,0,549936,Africa,113,1
2020-04-30,Cape_Verde,CV,0,0,549936,Africa,113,1
2020-05-01,Cape_Verde,CV,8,0,549936,Africa,121,1
2020-05-02,Cape_Verde,CV,2,1,549936,Africa,123,2
2020-05-03,Cape_Verde,CV,29,0,549936,Africa,152,2
2020-05-04,Cape_Verde,CV,13,0,549936,Africa,165,2
2020-05-05,Cape_Verde,CV,10,0,549936,Africa,175,2
2020-05-06,Cape_Verde,CV,11,0,549936,Africa,186,2
2020-05-07,Cape_Verde,CV,5,0,549936,Africa,191,2
2020-05-08,Cape_Verde,CV,27,0,549936,Africa,218,2
2020-05-09,Cape_Verde,CV,12,0,549936,Africa,230,2
2020-05-10,Cape_Verde,CV,6,0,549936,Africa,236,2
2020-05-11,Cape_Verde,CV,10,0,549936,Africa,246,2
2020-05-12,Cape_Verde,CV,14,0,549936,Africa,260,2
2020-05-13,Cape_Verde,CV,10,0,549936,Africa,270,2
2020-05-14,Cape_Verde,CV,19,0,549936,Africa,289,2
2020-05-15,Cape_Verde,CV,26,0,549936,Africa,315,2
2020-05-16,Cape_Verde,CV,11,0,549936,Africa,326,2
2020-05-17,Cape_Verde,CV,2,1,549936,Africa,328,3
2020-05-18,Cape_Verde,CV,0,0,549936,Africa,328,3
2020-05-19,Cape_Verde,CV,0,0,549936,Africa,328,3
2020-05-20,Cape_Verde,CV,7,0,549936,Africa,335,3
2020-05-21,Cape_Verde,CV,14,0,549936,Africa,349,3
2020-05-22,Cape_Verde,CV,7,0,549936,Africa,356,3
2020-05-23,Cape_Verde,CV,6,0,549936,Africa,362,3
2020-05-24,Cape_Verde,CV,9,0,549936,Africa,371,3
2020-05-25,Cape_Verde,CV,9,0,549936,Africa,380,3
2020-05-26,Cape_Verde,CV,10,0,549936,Africa,390,3
2020-05-27,Cape_Verde,CV,0,1,549936,Africa,390,4
2020-05-28,Cape_Verde,CV,0,0,549936,Africa,390,4
2020-05-29,Cape_Verde,CV,0,0,549936,Africa,390,4
2020-05-30,Cape_Verde,CV,15,0,549936,Africa,405,4
2020-05-31,Cape_Verde,CV,16,0,549936,Africa,421,4
2020-06-01,Cape_Verde,CV,14,0,549936,Africa,435,4
2020-06-02,Cape_Verde,CV,23,0,549936,Africa,458,4
2020-06-03,Cape_Verde,CV,8,1,549936,Africa,466,5
2020-06-04,Cape_Verde,CV,11,0,549936,Africa,477,5
2020-06-05,Cape_Verde,CV,25,0,549936,Africa,502,5
2020-06-06,Cape_Verde,CV,34,0,549936,Africa,536,5
2020-06-07,Cape_Verde,CV,6,0,549936,Africa,542,5
2020-06-08,Cape_Verde,CV,12,0,549936,Africa,554,5
2020-06-09,Cape_Verde,CV,13,0,549936,Africa,567,5
2020-06-10,Cape_Verde,CV,18,0,549936,Africa,585,5
2020-06-11,Cape_Verde,CV,30,0,549936,Africa,615,5
2020-06-12,Cape_Verde,CV,42,1,549936,Africa,657,6
2020-06-13,Cape_Verde,CV,40,0,549936,Africa,697,6
2020-06-14,Cape_Verde,CV,29,0,549936,Africa,726,6
2020-06-15,Cape_Verde,CV,24,0,549936,Africa,750,6
2020-06-16,Cape_Verde,CV,10,1,549936,Africa,760,7
2020-06-17,Cape_Verde,CV,21,0,549936,Africa,781,7
2020-06-18,Cape_Verde,CV,11,0,549936,Africa,792,7
2020-06-19,Cape_Verde,CV,31,0,549936,Africa,823,7
2020-06-20,Cape_Verde,CV,25,1,549936,Africa,848,8
2020-06-21,Cape_Verde,CV,15,0,549936,Africa,863,8
2020-06-22,Cape_Verde,CV,27,0,549936,Africa,890,8
2020-06-23,Cape_Verde,CV,54,0,549936,Africa,944,8
2020-06-24,Cape_Verde,CV,38,0,549936,Africa,982,8
2020-06-25,Cape_Verde,CV,17,0,549936,Africa,999,8
2020-06-26,Cape_Verde,CV,4,0,549936,Africa,1003,8
2020-06-27,Cape_Verde,CV,24,2,549936,Africa,1027,10
2020-06-28,Cape_Verde,CV,64,2,549936,Africa,1091,12
2020-06-29,Cape_Verde,CV,64,0,549936,Africa,1155,12
2020-06-30,Cape_Verde,CV,10,0,549936,Africa,1165,12
2020-07-01,Cape_Verde,CV,62,3,549936,Africa,1227,15
2020-07-02,Cape_Verde,CV,40,0,549936,Africa,1267,15
2020-07-03,Cape_Verde,CV,34,0,549936,Africa,1301,15
2020-07-04,Cape_Verde,CV,81,0,549936,Africa,1382,15
2020-07-05,Cape_Verde,CV,38,1,549936,Africa,1420,16
2020-07-06,Cape_Verde,CV,31,1,549936,Africa,1451,17
2020-07-07,Cape_Verde,CV,12,0,549936,Africa,1463,17
2020-07-08,Cape_Verde,CV,36,1,549936,Africa,1499,18
2020-07-09,Cape_Verde,CV,43,0,549936,Africa,1542,18
2020-07-10,Cape_Verde,CV,11,1,549936,Africa,1553,19
2020-07-11,Cape_Verde,CV,0,0,549936,Africa,1553,19
2020-07-12,Cape_Verde,CV,38,0,549936,Africa,1591,19
2020-07-13,Cape_Verde,CV,107,0,549936,Africa,1698,19
2020-07-14,Cape_Verde,CV,24,0,549936,Africa,1722,19
2020-07-15,Cape_Verde,CV,58,0,549936,Africa,1780,19
2020-07-16,Cape_Verde,CV,57,0,549936,Africa,1837,19
2020-07-17,Cape_Verde,CV,57,0,549936,Africa,1894,19
2020-07-18,Cape_Verde,CV,45,1,549936,Africa,1939,20
2020-07-19,Cape_Verde,CV,75,1,549936,Africa,2014,21
2020-07-20,Cape_Verde,CV,29,0,549936,Africa,2043,21
2020-07-21,Cape_Verde,CV,28,0,549936,Africa,2071,21
2020-07-22,Cape_Verde,CV,36,0,549936,Africa,2107,21
2020-07-23,Cape_Verde,CV,47,0,549936,Africa,2154,21
2020-07-24,Cape_Verde,CV,36,0,549936,Africa,2190,21
2020-07-25,Cape_Verde,CV,30,1,549936,Africa,2220,22
2020-07-26,Cape_Verde,CV,38,0,549936,Africa,2258,22
2020-07-27,Cape_Verde,CV,49,0,549936,Africa,2307,22
2020-07-28,Cape_Verde,CV,21,0,549936,Africa,2328,22
2020-07-29,Cape_Verde,CV,26,0,549936,Africa,2354,22
2020-07-30,Cape_Verde,CV,19,1,549936,Africa,2373,23
2020-07-31,Cape_Verde,CV,0,0,549936,Africa,2373,23
2020-08-01,Cape_Verde,CV,78,0,549936,Africa,2451,23
2020-08-02,Cape_Verde,CV,29,1,549936,Africa,2480,24
2020-08-03,Cape_Verde,CV,67,0,549936,Africa,2547,24
2020-08-04,Cape_Verde,CV,36,1,549936,Africa,2583,25
2020-08-05,Cape_Verde,CV,48,1,549936,Africa,2631,26
2020-08-06,Cape_Verde,CV,58,1,549936,Africa,2689,27
2020-08-07,Cape_Verde,CV,45,0,549936,Africa,2734,27
2020-08-08,Cape_Verde,CV,46,2,549936,Africa,2780,29
2020-08-09,Cape_Verde,CV,55,3,549936,Africa,2835,32
2020-08-10,Cape_Verde,CV,23,0,549936,Africa,2858,32
2020-08-11,Cape_Verde,CV,25,0,549936,Africa,2883,32
2020-08-12,Cape_Verde,CV,37,1,549936,Africa,2920,33
2020-08-13,Cape_Verde,CV,80,0,549936,Africa,3000,33
2020-08-14,Cape_Verde,CV,73,0,549936,Africa,3073,33
2020-08-15,Cape_Verde,CV,63,0,549936,Africa,3136,33
2020-08-16,Cape_Verde,CV,27,1,549936,Africa,3163,34
2020-08-17,Cape_Verde,CV,16,1,549936,Africa,3179,35
2020-08-18,Cape_Verde,CV,24,1,549936,Africa,3203,36
2020-08-19,Cape_Verde,CV,50,0,549936,Africa,3253,36
2020-08-20,Cape_Verde,CV,68,0,549936,Africa,3321,36
2020-08-21,Cape_Verde,CV,47,1,549936,Africa,3368,37
2020-08-22,Cape_Verde,CV,44,0,549936,Africa,3412,37
2020-08-23,Cape_Verde,CV,43,0,549936,Africa,3455,37
2020-08-24,Cape_Verde,CV,54,0,549936,Africa,3509,37
2020-08-25,Cape_Verde,CV,23,0,549936,Africa,3532,37
2020-08-26,Cape_Verde,CV,36,0,549936,Africa,3568,37
2020-08-27,Cape_Verde,CV,62,1,549936,Africa,3630,38
2020-08-28,Cape_Verde,CV,69,0,549936,Africa,3699,38
2020-08-29,Cape_Verde,CV,46,0,549936,Africa,3745,38
2020-08-30,Cape_Verde,CV,33,1,549936,Africa,3778,39
2020-08-31,Cape_Verde,CV,74,1,549936,Africa,3852,40
2020-09-01,Cape_Verde,CV,32,0,549936,Africa,3884,40
2020-09-02,Cape_Verde,CV,86,0,549936,Africa,3970,40
2020-09-03,Cape_Verde,CV,78,1,549936,Africa,4048,41
2020-09-04,Cape_Verde,CV,77,0,549936,Africa,4125,41
2020-09-05,Cape_Verde,CV,75,0,549936,Africa,4200,41
2020-09-06,Cape_Verde,CV,75,1,549936,Africa,4275,42
2020-09-07,Cape_Verde,CV,55,0,549936,Africa,4330,42
2020-09-08,Cape_Verde,CV,28,0,549936,Africa,4358,42
2020-09-09,Cape_Verde,CV,42,0,549936,Africa,4400,42
2020-09-10,Cape_Verde,CV,73,1,549936,Africa,4473,43
2020-09-11,Cape_Verde,CV,84,0,549936,Africa,4557,43
2020-09-12,Cape_Verde,CV,94,1,549936,Africa,4651,44
2020-09-13,Cape_Verde,CV,60,0,549936,Africa,4711,44
2020-09-14,Cape_Verde,CV,102,0,549936,Africa,4813,44
2020-09-15,Cape_Verde,CV,26,1,549936,Africa,4839,45
2020-09-16,Cape_Verde,CV,65,1,549936,Africa,4904,46
2020-09-17,Cape_Verde,CV,74,1,549936,Africa,4978,47
2020-09-18,Cape_Verde,CV,85,2,549936,Africa,5063,49
2020-09-19,Cape_Verde,CV,78,1,549936,Africa,5141,50
2020-09-20,Cape_Verde,CV,45,0,549936,Africa,5186,50
2020-09-21,Cape_Verde,CV,71,1,549936,Africa,5257,51
2020-09-22,Cape_Verde,CV,0,0,549936,Africa,5257,51
2020-09-23,Cape_Verde,CV,24,1,549936,Africa,5281,52
2020-09-24,Cape_Verde,CV,131,2,549936,Africa,5412,54
2020-09-25,Cape_Verde,CV,67,1,549936,Africa,5479,55
2020-09-26,Cape_Verde,CV,149,0,549936,Africa,5628,55
2020-09-27,Cape_Verde,CV,73,1,549936,Africa,5701,56
2020-09-28,Cape_Verde,CV,70,1,549936,Africa,5771,57
2020-09-29,Cape_Verde,CV,46,2,549936,Africa,5817,59
2020-09-30,Cape_Verde,CV,83,0,549936,Africa,5900,59
2020-10-01,Cape_Verde,CV,124,1,549936,Africa,6024,60
2020-10-02,Cape_Verde,CV,102,1,549936,Africa,6126,61
2020-10-03,Cape_Verde,CV,79,1,549936,Africa,6205,62
2020-10-04,Cape_Verde,CV,91,0,549936,Africa,6296,62
2020-10-05,Cape_Verde,CV,64,3,549936,Africa,6360,65
2020-10-06,Cape_Verde,CV,73,3,549936,Africa,6433,68
2020-10-07,Cape_Verde,CV,85,1,549936,Africa,6518,69
2020-10-08,Cape_Verde,CV,106,2,549936,Africa,6624,71
2020-10-09,Cape_Verde,CV,93,0,549936,Africa,6717,71
2020-10-10,Cape_Verde,CV,92,2,549936,Africa,6809,73
2020-10-11,Cape_Verde,CV,104,1,549936,Africa,6913,74
2020-10-12,Cape_Verde,CV,159,1,549936,Africa,7072,75
2020-10-13,Cape_Verde,CV,83,0,549936,Africa,7155,75
2020-10-14,Cape_Verde,CV,99,2,549936,Africa,7254,77
2020-10-15,Cape_Verde,CV,117,2,549936,Africa,7371,79
2020-10-16,Cape_Verde,CV,73,0,549936,Africa,7444,79
2020-10-17,Cape_Verde,CV,82,3,549936,Africa,7526,82
2020-10-18,Cape_Verde,CV,112,3,549936,Africa,7638,85
2020-10-19,Cape_Verde,CV,114,1,549936,Africa,7752,86
2020-10-20,Cape_Verde,CV,48,1,549936,Africa,7800,87
2020-10-21,Cape_Verde,CV,101,0,549936,Africa,7901,87
2020-10-22,Cape_Verde,CV,132,3,549936,Africa,8033,90
2020-10-23,Cape_Verde,CV,89,1,549936,Africa,8122,91
2020-10-24,Cape_Verde,CV,76,3,549936,Africa,8198,94
2020-10-25,Cape_Verde,CV,124,0,549936,Africa,8322,94
2020-10-26,Cape_Verde,CV,74,0,549936,Africa,8396,94
2020-10-27,Cape_Verde,CV,27,0,549936,Africa,8423,94
2020-10-28,Cape_Verde,CV,49,0,549936,Africa,8472,94
2020-10-29,Cape_Verde,CV,76,0,549936,Africa,8548,94
2020-10-30,Cape_Verde,CV,0,0,549936,Africa,8548,94
2020-10-31,Cape_Verde,CV,146,1,549936,Africa,8694,95
2020-11-01,Cape_Verde,CV,99,0,549936,Africa,8793,95
2020-11-02,Cape_Verde,CV,55,0,549936,Africa,8848,95
2020-11-03,Cape_Verde,CV,34,0,549936,Africa,8882,95
2020-11-04,Cape_Verde,CV,62,0,549936,Africa,8944,95
2020-11-05,Cape_Verde,CV,109,0,549936,Africa,9053,95
2020-11-06,Cape_Verde,CV,96,2,549936,Africa,9149,97
2020-11-07,Cape_Verde,CV,75,3,549936,Africa,9224,100
2020-11-08,Cape_Verde,CV,67,0,549936,Africa,9291,100
2020-11-09,Cape_Verde,CV,78,0,549936,Africa,9369,100
2020-11-10,Cape_Verde,CV,50,0,549936,Africa,9419,100
2020-11-11,Cape_Verde,CV,80,1,549936,Africa,9499,101
2020-11-12,Cape_Verde,CV,61,1,549936,Africa,9560,102
2020-11-13,Cape_Verde,CV,134,0,549936,Africa,9694,102
2020-11-14,Cape_Verde,CV,47,0,549936,Africa,9741,102
2020-11-15,Cape_Verde,CV,39,0,549936,Africa,9780,102
2020-11-16,Cape_Verde,CV,42,1,549936,Africa,9822,103
2020-11-17,Cape_Verde,CV,18,0,549936,Africa,9840,103
2020-11-18,Cape_Verde,CV,120,0,549936,Africa,9960,103
2020-11-19,Cape_Verde,CV,40,1,549936,Africa,10000,104
2020-11-20,Cape_Verde,CV,0,0,549936,Africa,10000,104
2020-11-21,Cape_Verde,CV,152,0,549936,Africa,10152,104
2020-11-22,Cape_Verde,CV,82,0,549936,Africa,10234,104
2020-11-23,Cape_Verde,CV,42,0,549936,Africa,10276,104
2020-11-24,Cape_Verde,CV,26,0,549936,Africa,10302,104
2020-11-25,Cape_Verde,CV,98,0,549936,Africa,10400,104
2020-11-26,Cape_Verde,CV,126,0,549936,Africa,10526,104
2020-11-27,Cape_Verde,CV,0,0,549936,Africa,10526,104
2020-11-28,Cape_Verde,CV,0,0,549936,Africa,10526,104
2020-11-29,Cape_Verde,CV,0,0,549936,Africa,10526,104
2020-11-30,Cape_Verde,CV,0,0,549936,Africa,10526,104
2020-12-01,Cape_Verde,CV,0,0,549936,Africa,10526,104
2020-12-02,Cape_Verde,CV,290,2,549936,Africa,10816,106
2020-12-03,Cape_Verde,CV,51,0,549936,Africa,10867,106
2020-12-04,Cape_Verde,CV,71,1,549936,Africa,10938,107
2020-12-05,Cape_Verde,CV,58,1,549936,Africa,10996,108
2020-12-06,Cape_Verde,CV,40,1,549936,Africa,11036,109
2020-12-07,Cape_Verde,CV,27,0,549936,Africa,11063,109
2020-12-08,Cape_Verde,CV,0,0,549936,Africa,11063,109
2020-12-09,Cape_Verde,CV,55,0,549936,Africa,11118,109
2020-12-10,Cape_Verde,CV,74,0,549936,Africa,11192,109
2020-12-11,Cape_Verde,CV,11,0,549936,Africa,11203,109
2020-12-12,Cape_Verde,CV,59,1,549936,Africa,11262,110
2020-12-13,Cape_Verde,CV,40,0,549936,Africa,11302,110
2020-12-14,Cape_Verde,CV,55,0,549936,Africa,11357,110
2020-03-13,CuraÃ§ao,CW,1,0,163423,America,1,0
2020-03-20,CuraÃ§ao,CW,2,0,163423,America,3,0
2020-03-24,CuraÃ§ao,CW,3,0,163423,America,6,0
2020-03-26,CuraÃ§ao,CW,0,1,163423,America,6,1
2020-03-27,CuraÃ§ao,CW,1,0,163423,America,7,1
2020-03-28,CuraÃ§ao,CW,1,0,163423,America,8,1
2020-03-29,CuraÃ§ao,CW,0,0,163423,America,8,1
2020-03-30,CuraÃ§ao,CW,1,0,163423,America,9,1
2020-04-01,CuraÃ§ao,CW,2,0,163423,America,11,1
2020-04-02,CuraÃ§ao,CW,0,0,163423,America,11,1
2020-04-03,CuraÃ§ao,CW,0,0,163423,America,11,1
2020-04-04,CuraÃ§ao,CW,0,0,163423,America,11,1
2020-04-05,CuraÃ§ao,CW,0,0,163423,America,11,1
2020-04-06,CuraÃ§ao,CW,0,0,163423,America,11,1
2020-04-07,CuraÃ§ao,CW,2,0,163423,America,13,1
2020-04-08,CuraÃ§ao,CW,0,0,163423,America,13,1
2020-04-09,CuraÃ§ao,CW,1,0,163423,America,14,1
2020-04-10,CuraÃ§ao,CW,0,0,163423,America,14,1
2020-04-11,CuraÃ§ao,CW,0,0,163423,America,14,1
2020-04-12,CuraÃ§ao,CW,0,0,163423,America,14,1
2020-04-13,CuraÃ§ao,CW,0,0,163423,America,14,1
2020-04-14,CuraÃ§ao,CW,0,0,163423,America,14,1
2020-04-15,CuraÃ§ao,CW,0,0,163423,America,14,1
2020-04-16,CuraÃ§ao,CW,0,0,163423,America,14,1
2020-04-17,CuraÃ§ao,CW,0,0,163423,America,14,1
2020-04-18,CuraÃ§ao,CW,0,0,163423,America,14,1
2020-04-19,CuraÃ§ao,CW,0,0,163423,America,14,1
2020-04-20,CuraÃ§ao,CW,0,0,163423,America,14,1
2020-04-21,CuraÃ§ao,CW,0,0,163423,America,14,1
2020-04-22,CuraÃ§ao,CW,0,0,163423,America,14,1
2020-04-23,CuraÃ§ao,CW,0,0,163423,America,14,1
2020-04-24,CuraÃ§ao,CW,0,0,163423,America,14,1
2020-04-25,CuraÃ§ao,CW,2,0,163423,America,16,1
2020-04-26,CuraÃ§ao,CW,0,0,163423,America,16,1
2020-04-27,CuraÃ§ao,CW,0,0,163423,America,16,1
2020-04-28,CuraÃ§ao,CW,0,0,163423,America,16,1
2020-04-29,CuraÃ§ao,CW,0,0,163423,America,16,1
2020-04-30,CuraÃ§ao,CW,0,0,163423,America,16,1
2020-05-01,CuraÃ§ao,CW,0,0,163423,America,16,1
2020-05-02,CuraÃ§ao,CW,0,0,163423,America,16,1
2020-05-03,CuraÃ§ao,CW,0,0,163423,America,16,1
2020-05-04,CuraÃ§ao,CW,0,0,163423,America,16,1
2020-05-05,CuraÃ§ao,CW,0,0,163423,America,16,1
2020-05-06,CuraÃ§ao,CW,0,0,163423,America,16,1
2020-05-07,CuraÃ§ao,CW,0,0,163423,America,16,1
2020-05-08,CuraÃ§ao,CW,0,0,163423,America,16,1
2020-05-09,CuraÃ§ao,CW,0,0,163423,America,16,1
2020-05-10,CuraÃ§ao,CW,0,0,163423,America,16,1
2020-05-11,CuraÃ§ao,CW,0,0,163423,America,16,1
2020-05-12,CuraÃ§ao,CW,0,0,163423,America,16,1
2020-05-13,CuraÃ§ao,CW,0,0,163423,America,16,1
2020-05-14,CuraÃ§ao,CW,0,0,163423,America,16,1
2020-05-15,CuraÃ§ao,CW,0,0,163423,America,16,1
2020-05-16,CuraÃ§ao,CW,0,0,163423,America,16,1
2020-05-17,CuraÃ§ao,CW,0,0,163423,America,16,1
2020-05-18,CuraÃ§ao,CW,0,0,163423,America,16,1
2020-05-19,CuraÃ§ao,CW,0,0,163423,America,16,1
2020-05-20,CuraÃ§ao,CW,0,0,163423,America,16,1
2020-05-21,CuraÃ§ao,CW,0,0,163423,America,16,1
2020-05-22,CuraÃ§ao,CW,0,0,163423,America,16,1
2020-05-23,CuraÃ§ao,CW,0,0,163423,America,16,1
2020-05-24,CuraÃ§ao,CW,0,0,163423,America,16,1
2020-05-25,CuraÃ§ao,CW,1,0,163423,America,17,1
2020-05-26,CuraÃ§ao,CW,1,0,163423,America,18,1
2020-05-27,CuraÃ§ao,CW,0,0,163423,America,18,1
2020-05-28,CuraÃ§ao,CW,0,0,163423,America,18,1
2020-05-29,CuraÃ§ao,CW,1,0,163423,America,19,1
2020-05-30,CuraÃ§ao,CW,0,0,163423,America,19,1
2020-05-31,CuraÃ§ao,CW,0,0,163423,America,19,1
2020-06-01,CuraÃ§ao,CW,0,0,163423,America,19,1
2020-06-02,CuraÃ§ao,CW,1,0,163423,America,20,1
2020-06-03,CuraÃ§ao,CW,0,0,163423,America,20,1
2020-06-04,CuraÃ§ao,CW,0,0,163423,America,20,1
2020-06-05,CuraÃ§ao,CW,1,0,163423,America,21,1
2020-06-06,CuraÃ§ao,CW,0,0,163423,America,21,1
2020-06-07,CuraÃ§ao,CW,0,0,163423,America,21,1
2020-06-08,CuraÃ§ao,CW,0,0,163423,America,21,1
2020-06-09,CuraÃ§ao,CW,0,0,163423,America,21,1
2020-06-10,CuraÃ§ao,CW,0,0,163423,America,21,1
2020-06-11,CuraÃ§ao,CW,0,0,163423,America,21,1
2020-06-12,CuraÃ§ao,CW,1,0,163423,America,22,1
2020-06-13,CuraÃ§ao,CW,0,0,163423,America,22,1
2020-06-14,CuraÃ§ao,CW,0,0,163423,America,22,1
2020-06-15,CuraÃ§ao,CW,0,0,163423,America,22,1
2020-06-16,CuraÃ§ao,CW,0,0,163423,America,22,1
2020-06-17,CuraÃ§ao,CW,0,0,163423,America,22,1
2020-06-18,CuraÃ§ao,CW,1,0,163423,America,23,1
2020-06-19,CuraÃ§ao,CW,0,0,163423,America,23,1
2020-06-20,CuraÃ§ao,CW,0,0,163423,America,23,1
2020-06-21,CuraÃ§ao,CW,0,0,163423,America,23,1
2020-06-22,CuraÃ§ao,CW,0,0,163423,America,23,1
2020-06-23,CuraÃ§ao,CW,0,0,163423,America,23,1
2020-06-24,CuraÃ§ao,CW,1,0,163423,America,24,1
2020-06-25,CuraÃ§ao,CW,0,0,163423,America,24,1
2020-06-26,CuraÃ§ao,CW,0,0,163423,America,24,1
2020-06-27,CuraÃ§ao,CW,0,0,163423,America,24,1
2020-06-28,CuraÃ§ao,CW,0,0,163423,America,24,1
2020-06-29,CuraÃ§ao,CW,0,0,163423,America,24,1
2020-06-30,CuraÃ§ao,CW,0,0,163423,America,24,1
2020-07-01,CuraÃ§ao,CW,1,0,163423,America,25,1
2020-07-02,CuraÃ§ao,CW,0,0,163423,America,25,1
2020-07-03,CuraÃ§ao,CW,0,0,163423,America,25,1
2020-07-04,CuraÃ§ao,CW,0,0,163423,America,25,1
2020-07-05,CuraÃ§ao,CW,0,0,163423,America,25,1
2020-07-06,CuraÃ§ao,CW,0,0,163423,America,25,1
2020-07-07,CuraÃ§ao,CW,0,0,163423,America,25,1
2020-07-08,CuraÃ§ao,CW,0,0,163423,America,25,1
2020-07-09,CuraÃ§ao,CW,0,0,163423,America,25,1
2020-07-10,CuraÃ§ao,CW,0,0,163423,America,25,1
2020-07-11,CuraÃ§ao,CW,0,0,163423,America,25,1
2020-07-12,CuraÃ§ao,CW,0,0,163423,America,25,1
2020-07-13,CuraÃ§ao,CW,0,0,163423,America,25,1
2020-07-14,CuraÃ§ao,CW,1,0,163423,America,26,1
2020-07-15,CuraÃ§ao,CW,0,0,163423,America,26,1
2020-07-16,CuraÃ§ao,CW,0,0,163423,America,26,1
2020-07-17,CuraÃ§ao,CW,0,0,163423,America,26,1
2020-07-18,CuraÃ§ao,CW,0,0,163423,America,26,1
2020-07-19,CuraÃ§ao,CW,0,0,163423,America,26,1
2020-07-20,CuraÃ§ao,CW,2,0,163423,America,28,1
2020-07-21,CuraÃ§ao,CW,0,0,163423,America,28,1
2020-07-22,CuraÃ§ao,CW,0,0,163423,America,28,1
2020-07-23,CuraÃ§ao,CW,0,0,163423,America,28,1
2020-07-24,CuraÃ§ao,CW,0,0,163423,America,28,1
2020-07-25,CuraÃ§ao,CW,1,0,163423,America,29,1
2020-07-26,CuraÃ§ao,CW,0,0,163423,America,29,1
2020-07-27,CuraÃ§ao,CW,0,0,163423,America,29,1
2020-07-28,CuraÃ§ao,CW,0,0,163423,America,29,1
2020-07-29,CuraÃ§ao,CW,0,0,163423,America,29,1
2020-07-30,CuraÃ§ao,CW,0,0,163423,America,29,1
2020-07-31,CuraÃ§ao,CW,0,0,163423,America,29,1
2020-08-01,CuraÃ§ao,CW,0,0,163423,America,29,1
2020-08-02,CuraÃ§ao,CW,0,0,163423,America,29,1
2020-08-03,CuraÃ§ao,CW,0,0,163423,America,29,1
2020-08-04,CuraÃ§ao,CW,0,0,163423,America,29,1
2020-08-05,CuraÃ§ao,CW,0,0,163423,America,29,1
2020-08-06,CuraÃ§ao,CW,2,0,163423,America,31,1
2020-08-07,CuraÃ§ao,CW,0,0,163423,America,31,1
2020-08-08,CuraÃ§ao,CW,0,0,163423,America,31,1
2020-08-09,CuraÃ§ao,CW,0,0,163423,America,31,1
2020-08-10,CuraÃ§ao,CW,0,0,163423,America,31,1
2020-08-11,CuraÃ§ao,CW,1,0,163423,America,32,1
2020-08-12,CuraÃ§ao,CW,0,0,163423,America,32,1
2020-08-13,CuraÃ§ao,CW,0,0,163423,America,32,1
2020-08-14,CuraÃ§ao,CW,0,0,163423,America,32,1
2020-08-15,CuraÃ§ao,CW,0,0,163423,America,32,1
2020-08-16,CuraÃ§ao,CW,1,0,163423,America,33,1
2020-08-17,CuraÃ§ao,CW,1,0,163423,America,34,1
2020-08-18,CuraÃ§ao,CW,1,0,163423,America,35,1
2020-08-19,CuraÃ§ao,CW,0,0,163423,America,35,1
2020-08-20,CuraÃ§ao,CW,0,0,163423,America,35,1
2020-08-21,CuraÃ§ao,CW,0,0,163423,America,35,1
2020-08-22,CuraÃ§ao,CW,2,0,163423,America,37,1
2020-08-23,CuraÃ§ao,CW,0,0,163423,America,37,1
2020-08-24,CuraÃ§ao,CW,6,0,163423,America,43,1
2020-08-25,CuraÃ§ao,CW,4,0,163423,America,47,1
2020-08-26,CuraÃ§ao,CW,0,0,163423,America,47,1
2020-08-27,CuraÃ§ao,CW,2,0,163423,America,49,1
2020-08-28,CuraÃ§ao,CW,4,0,163423,America,53,1
2020-08-29,CuraÃ§ao,CW,4,0,163423,America,57,1
2020-08-30,CuraÃ§ao,CW,0,0,163423,America,57,1
2020-08-31,CuraÃ§ao,CW,0,0,163423,America,57,1
2020-09-01,CuraÃ§ao,CW,11,0,163423,America,68,1
2020-09-02,CuraÃ§ao,CW,0,0,163423,America,68,1
2020-09-03,CuraÃ§ao,CW,0,0,163423,America,68,1
2020-09-04,CuraÃ§ao,CW,7,0,163423,America,75,1
2020-09-05,CuraÃ§ao,CW,3,0,163423,America,78,1
2020-09-06,CuraÃ§ao,CW,10,0,163423,America,88,1
2020-09-07,CuraÃ§ao,CW,4,0,163423,America,92,1
2020-09-08,CuraÃ§ao,CW,10,0,163423,America,102,1
2020-09-09,CuraÃ§ao,CW,5,0,163423,America,107,1
2020-09-10,CuraÃ§ao,CW,9,0,163423,America,116,1
2020-09-11,CuraÃ§ao,CW,15,0,163423,America,131,1
2020-09-12,CuraÃ§ao,CW,4,0,163423,America,135,1
2020-09-13,CuraÃ§ao,CW,10,0,163423,America,145,1
2020-09-14,CuraÃ§ao,CW,12,0,163423,America,157,1
2020-09-15,CuraÃ§ao,CW,0,0,163423,America,157,1
2020-09-16,CuraÃ§ao,CW,12,0,163423,America,169,1
2020-09-17,CuraÃ§ao,CW,23,0,163423,America,192,1
2020-09-18,CuraÃ§ao,CW,18,0,163423,America,210,1
2020-09-19,CuraÃ§ao,CW,18,0,163423,America,228,1
2020-09-20,CuraÃ§ao,CW,19,0,163423,America,247,1
2020-09-21,CuraÃ§ao,CW,21,0,163423,America,268,1
2020-09-22,CuraÃ§ao,CW,14,0,163423,America,282,1
2020-09-23,CuraÃ§ao,CW,9,0,163423,America,291,1
2020-09-24,CuraÃ§ao,CW,10,0,163423,America,301,1
2020-09-25,CuraÃ§ao,CW,14,0,163423,America,315,1
2020-09-26,CuraÃ§ao,CW,14,0,163423,America,329,1
2020-09-27,CuraÃ§ao,CW,8,0,163423,America,337,1
2020-09-28,CuraÃ§ao,CW,23,0,163423,America,360,1
2020-09-29,CuraÃ§ao,CW,4,0,163423,America,364,1
2020-09-30,CuraÃ§ao,CW,6,0,163423,America,370,1
2020-10-01,CuraÃ§ao,CW,22,0,163423,America,392,1
2020-10-02,CuraÃ§ao,CW,7,0,163423,America,399,1
2020-10-03,CuraÃ§ao,CW,12,0,163423,America,411,1
2020-10-04,CuraÃ§ao,CW,18,0,163423,America,429,1
2020-10-05,CuraÃ§ao,CW,23,0,163423,America,452,1
2020-10-06,CuraÃ§ao,CW,0,0,163423,America,452,1
2020-10-07,CuraÃ§ao,CW,10,0,163423,America,462,1
2020-10-08,CuraÃ§ao,CW,14,0,163423,America,476,1
2020-10-09,CuraÃ§ao,CW,29,0,163423,America,505,1
2020-10-10,CuraÃ§ao,CW,0,0,163423,America,505,1
2020-10-11,CuraÃ§ao,CW,66,0,163423,America,571,1
2020-10-12,CuraÃ§ao,CW,12,0,163423,America,583,1
2020-10-13,CuraÃ§ao,CW,2,0,163423,America,585,1
2020-10-14,CuraÃ§ao,CW,34,0,163423,America,619,1
2020-10-15,CuraÃ§ao,CW,26,0,163423,America,645,1
2020-10-16,CuraÃ§ao,CW,28,0,163423,America,673,1
2020-10-17,CuraÃ§ao,CW,25,0,163423,America,698,1
2020-10-18,CuraÃ§ao,CW,17,0,163423,America,715,1
2020-10-19,CuraÃ§ao,CW,29,0,163423,America,744,1
2020-10-20,CuraÃ§ao,CW,7,0,163423,America,751,1
2020-10-21,CuraÃ§ao,CW,8,0,163423,America,759,1
2020-10-22,CuraÃ§ao,CW,26,0,163423,America,785,1
2020-10-23,CuraÃ§ao,CW,19,0,163423,America,804,1
2020-10-24,CuraÃ§ao,CW,14,0,163423,America,818,1
2020-10-25,CuraÃ§ao,CW,19,0,163423,America,837,1
2020-10-26,CuraÃ§ao,CW,21,0,163423,America,858,1
2020-10-27,CuraÃ§ao,CW,15,0,163423,America,873,1
2020-10-28,CuraÃ§ao,CW,0,0,163423,America,873,1
2020-10-29,CuraÃ§ao,CW,11,0,163423,America,884,1
2020-10-30,CuraÃ§ao,CW,23,0,163423,America,907,1
2020-10-31,CuraÃ§ao,CW,37,0,163423,America,944,1
2020-11-01,CuraÃ§ao,CW,26,0,163423,America,970,1
2020-11-02,CuraÃ§ao,CW,17,0,163423,America,987,1
2020-11-03,CuraÃ§ao,CW,8,0,163423,America,995,1
2020-11-04,CuraÃ§ao,CW,5,0,163423,America,1000,1
2020-11-05,CuraÃ§ao,CW,21,1,163423,America,1021,2
2020-11-06,CuraÃ§ao,CW,9,0,163423,America,1030,2
2020-11-07,CuraÃ§ao,CW,23,0,163423,America,1053,2
2020-11-08,CuraÃ§ao,CW,24,0,163423,America,1077,2
2020-11-09,CuraÃ§ao,CW,20,0,163423,America,1097,2
2020-11-10,CuraÃ§ao,CW,5,0,163423,America,1102,2
2020-11-11,CuraÃ§ao,CW,29,0,163423,America,1131,2
2020-11-12,CuraÃ§ao,CW,51,0,163423,America,1182,2
2020-11-13,CuraÃ§ao,CW,33,0,163423,America,1215,2
2020-11-14,CuraÃ§ao,CW,46,0,163423,America,1261,2
2020-11-15,CuraÃ§ao,CW,46,0,163423,America,1307,2
2020-11-16,CuraÃ§ao,CW,33,0,163423,America,1340,2
2020-11-17,CuraÃ§ao,CW,34,0,163423,America,1374,2
2020-11-18,CuraÃ§ao,CW,41,0,163423,America,1415,2
2020-11-19,CuraÃ§ao,CW,67,0,163423,America,1482,2
2020-11-20,CuraÃ§ao,CW,79,1,163423,America,1561,3
2020-11-21,CuraÃ§ao,CW,59,0,163423,America,1620,3
2020-11-22,CuraÃ§ao,CW,62,0,163423,America,1682,3
2020-11-23,CuraÃ§ao,CW,67,0,163423,America,1749,3
2020-11-24,CuraÃ§ao,CW,24,0,163423,America,1773,3
2020-11-25,CuraÃ§ao,CW,54,0,163423,America,1827,3
2020-11-26,CuraÃ§ao,CW,102,0,163423,America,1929,3
2020-11-27,CuraÃ§ao,CW,117,0,163423,America,2046,3
2020-11-28,CuraÃ§ao,CW,111,0,163423,America,2157,3
2020-11-29,CuraÃ§ao,CW,101,1,163423,America,2258,4
2020-11-30,CuraÃ§ao,CW,106,0,163423,America,2364,4
2020-12-01,CuraÃ§ao,CW,15,0,163423,America,2379,4
2020-12-02,CuraÃ§ao,CW,124,3,163423,America,2503,7
2020-12-03,CuraÃ§ao,CW,155,0,163423,America,2658,7
2020-12-04,CuraÃ§ao,CW,82,0,163423,America,2740,7
2020-12-05,CuraÃ§ao,CW,150,0,163423,America,2890,7
2020-12-06,CuraÃ§ao,CW,121,0,163423,America,3011,7
2020-12-07,CuraÃ§ao,CW,125,0,163423,America,3136,7
2020-12-08,CuraÃ§ao,CW,0,0,163423,America,3136,7
2020-12-09,CuraÃ§ao,CW,38,1,163423,America,3174,8
2020-12-10,CuraÃ§ao,CW,72,0,163423,America,3246,8
2020-12-11,CuraÃ§ao,CW,79,0,163423,America,3325,8
2020-12-12,CuraÃ§ao,CW,79,0,163423,America,3404,8
2020-12-13,CuraÃ§ao,CW,172,2,163423,America,3576,10
2020-12-14,CuraÃ§ao,CW,48,1,163423,America,3624,11
2020-03-10,Cyprus,CY,2,0,875899,Europe,2,0
2020-03-12,Cyprus,CY,4,0,875899,Europe,6,0
2020-03-14,Cyprus,CY,8,0,875899,Europe,14,0
2020-03-15,Cyprus,CY,7,0,875899,Europe,21,0
2020-03-16,Cyprus,CY,9,0,875899,Europe,30,0
2020-03-17,Cyprus,CY,10,0,875899,Europe,40,0
2020-03-18,Cyprus,CY,0,0,875899,Europe,40,0
2020-03-19,Cyprus,CY,18,0,875899,Europe,58,0
2020-03-20,Cyprus,CY,0,0,875899,Europe,58,0
2020-03-21,Cyprus,CY,9,0,875899,Europe,67,0
2020-03-22,Cyprus,CY,17,0,875899,Europe,84,0
2020-03-23,Cyprus,CY,11,0,875899,Europe,95,0
2020-03-24,Cyprus,CY,21,0,875899,Europe,116,0
2020-03-25,Cyprus,CY,8,3,875899,Europe,124,3
2020-03-26,Cyprus,CY,8,0,875899,Europe,132,3
2020-03-27,Cyprus,CY,14,0,875899,Europe,146,3
2020-03-28,Cyprus,CY,16,2,875899,Europe,162,5
2020-03-29,Cyprus,CY,17,0,875899,Europe,179,5
2020-03-30,Cyprus,CY,35,1,875899,Europe,214,6
2020-03-31,Cyprus,CY,16,1,875899,Europe,230,7
2020-04-01,Cyprus,CY,32,1,875899,Europe,262,8
2020-04-02,Cyprus,CY,58,1,875899,Europe,320,9
2020-04-03,Cyprus,CY,36,0,875899,Europe,356,9
2020-04-04,Cyprus,CY,40,0,875899,Europe,396,9
2020-04-05,Cyprus,CY,30,0,875899,Europe,426,9
2020-04-06,Cyprus,CY,20,0,875899,Europe,446,9
2020-04-07,Cyprus,CY,19,0,875899,Europe,465,9
2020-04-08,Cyprus,CY,29,0,875899,Europe,494,9
2020-04-09,Cyprus,CY,32,0,875899,Europe,526,9
2020-04-10,Cyprus,CY,38,1,875899,Europe,564,10
2020-04-11,Cyprus,CY,31,0,875899,Europe,595,10
2020-04-12,Cyprus,CY,21,0,875899,Europe,616,10
2020-04-13,Cyprus,CY,17,1,875899,Europe,633,11
2020-04-14,Cyprus,CY,29,1,875899,Europe,662,12
2020-04-15,Cyprus,CY,33,0,875899,Europe,695,12
2020-04-16,Cyprus,CY,20,0,875899,Europe,715,12
2020-04-17,Cyprus,CY,20,0,875899,Europe,735,12
2020-04-18,Cyprus,CY,0,0,875899,Europe,735,12
2020-04-19,Cyprus,CY,26,0,875899,Europe,761,12
2020-04-20,Cyprus,CY,6,0,875899,Europe,767,12
2020-04-21,Cyprus,CY,5,0,875899,Europe,772,12
2020-04-22,Cyprus,CY,12,0,875899,Europe,784,12
2020-04-23,Cyprus,CY,6,2,875899,Europe,790,14
2020-04-24,Cyprus,CY,5,0,875899,Europe,795,14
2020-04-25,Cyprus,CY,9,0,875899,Europe,804,14
2020-04-26,Cyprus,CY,6,0,875899,Europe,810,14
2020-04-27,Cyprus,CY,7,0,875899,Europe,817,14
2020-04-28,Cyprus,CY,5,1,875899,Europe,822,15
2020-04-29,Cyprus,CY,15,0,875899,Europe,837,15
2020-04-30,Cyprus,CY,6,0,875899,Europe,843,15
2020-05-01,Cyprus,CY,7,0,875899,Europe,850,15
2020-05-02,Cyprus,CY,7,0,875899,Europe,857,15
2020-05-03,Cyprus,CY,7,0,875899,Europe,864,15
2020-05-04,Cyprus,CY,8,0,875899,Europe,872,15
2020-05-05,Cyprus,CY,2,0,875899,Europe,874,15
2020-05-06,Cyprus,CY,4,0,875899,Europe,878,15
2020-05-07,Cyprus,CY,5,0,875899,Europe,883,15
2020-05-08,Cyprus,CY,6,0,875899,Europe,889,15
2020-05-09,Cyprus,CY,2,0,875899,Europe,891,15
2020-05-10,Cyprus,CY,1,0,875899,Europe,892,15
2020-05-11,Cyprus,CY,6,1,875899,Europe,898,16
2020-05-12,Cyprus,CY,3,0,875899,Europe,901,16
2020-05-13,Cyprus,CY,2,0,875899,Europe,903,16
2020-05-14,Cyprus,CY,2,1,875899,Europe,905,17
2020-05-15,Cyprus,CY,2,0,875899,Europe,907,17
2020-05-16,Cyprus,CY,3,0,875899,Europe,910,17
2020-05-17,Cyprus,CY,4,0,875899,Europe,914,17
2020-05-18,Cyprus,CY,2,0,875899,Europe,916,17
2020-05-19,Cyprus,CY,1,0,875899,Europe,917,17
2020-05-20,Cyprus,CY,1,0,875899,Europe,918,17
2020-05-21,Cyprus,CY,4,0,875899,Europe,922,17
2020-05-22,Cyprus,CY,1,0,875899,Europe,923,17
2020-05-23,Cyprus,CY,4,0,875899,Europe,927,17
2020-05-24,Cyprus,CY,0,0,875899,Europe,927,17
2020-05-25,Cyprus,CY,8,0,875899,Europe,935,17
2020-05-26,Cyprus,CY,2,0,875899,Europe,937,17
2020-05-27,Cyprus,CY,2,0,875899,Europe,939,17
2020-05-28,Cyprus,CY,0,0,875899,Europe,939,17
2020-05-29,Cyprus,CY,2,0,875899,Europe,941,17
2020-05-30,Cyprus,CY,0,0,875899,Europe,941,17
2020-05-31,Cyprus,CY,2,0,875899,Europe,943,17
2020-06-01,Cyprus,CY,1,0,875899,Europe,944,17
2020-06-02,Cyprus,CY,5,0,875899,Europe,949,17
2020-06-03,Cyprus,CY,3,0,875899,Europe,952,17
2020-06-04,Cyprus,CY,6,0,875899,Europe,958,17
2020-06-05,Cyprus,CY,0,0,875899,Europe,958,17
2020-06-06,Cyprus,CY,2,0,875899,Europe,960,17
2020-06-07,Cyprus,CY,0,1,875899,Europe,960,18
2020-06-08,Cyprus,CY,4,0,875899,Europe,964,18
2020-06-09,Cyprus,CY,6,0,875899,Europe,970,18
2020-06-10,Cyprus,CY,2,0,875899,Europe,972,18
2020-06-11,Cyprus,CY,2,0,875899,Europe,974,18
2020-06-12,Cyprus,CY,1,0,875899,Europe,975,18
2020-06-13,Cyprus,CY,5,0,875899,Europe,980,18
2020-06-14,Cyprus,CY,0,0,875899,Europe,980,18
2020-06-15,Cyprus,CY,3,0,875899,Europe,983,18
2020-06-16,Cyprus,CY,2,0,875899,Europe,985,18
2020-06-17,Cyprus,CY,0,0,875899,Europe,985,18
2020-06-18,Cyprus,CY,0,0,875899,Europe,985,18
2020-06-19,Cyprus,CY,0,1,875899,Europe,985,19
2020-06-20,Cyprus,CY,0,0,875899,Europe,985,19
2020-06-21,Cyprus,CY,0,0,875899,Europe,985,19
2020-06-22,Cyprus,CY,1,0,875899,Europe,986,19
2020-06-23,Cyprus,CY,2,0,875899,Europe,988,19
2020-06-24,Cyprus,CY,2,0,875899,Europe,990,19
2020-06-25,Cyprus,CY,1,0,875899,Europe,991,19
2020-06-26,Cyprus,CY,1,0,875899,Europe,992,19
2020-06-27,Cyprus,CY,0,0,875899,Europe,992,19
2020-06-28,Cyprus,CY,2,0,875899,Europe,994,19
2020-06-29,Cyprus,CY,0,0,875899,Europe,994,19
2020-06-30,Cyprus,CY,2,0,875899,Europe,996,19
2020-07-01,Cyprus,CY,2,0,875899,Europe,998,19
2020-07-02,Cyprus,CY,1,0,875899,Europe,999,19
2020-07-03,Cyprus,CY,0,0,875899,Europe,999,19
2020-07-04,Cyprus,CY,0,0,875899,Europe,999,19
2020-07-05,Cyprus,CY,3,0,875899,Europe,1002,19
2020-07-06,Cyprus,CY,1,0,875899,Europe,1003,19
2020-07-07,Cyprus,CY,1,0,875899,Europe,1004,19
2020-07-08,Cyprus,CY,1,0,875899,Europe,1005,19
2020-07-09,Cyprus,CY,3,0,875899,Europe,1008,19
2020-07-10,Cyprus,CY,2,0,875899,Europe,1010,19
2020-07-11,Cyprus,CY,3,0,875899,Europe,1013,19
2020-07-12,Cyprus,CY,1,0,875899,Europe,1014,19
2020-07-13,Cyprus,CY,7,0,875899,Europe,1021,19
2020-07-14,Cyprus,CY,1,0,875899,Europe,1022,19
2020-07-15,Cyprus,CY,0,0,875899,Europe,1022,19
2020-07-16,Cyprus,CY,1,0,875899,Europe,1023,19
2020-07-17,Cyprus,CY,8,0,875899,Europe,1031,19
2020-07-18,Cyprus,CY,0,0,875899,Europe,1031,19
2020-07-19,Cyprus,CY,6,0,875899,Europe,1037,19
2020-07-20,Cyprus,CY,1,0,875899,Europe,1038,19
2020-07-21,Cyprus,CY,0,0,875899,Europe,1038,19
2020-07-22,Cyprus,CY,2,0,875899,Europe,1040,19
2020-07-23,Cyprus,CY,0,0,875899,Europe,1040,19
2020-07-24,Cyprus,CY,5,0,875899,Europe,1045,19
2020-07-25,Cyprus,CY,2,0,875899,Europe,1047,19
2020-07-26,Cyprus,CY,6,0,875899,Europe,1053,19
2020-07-27,Cyprus,CY,4,0,875899,Europe,1057,19
2020-07-28,Cyprus,CY,3,0,875899,Europe,1060,19
2020-07-29,Cyprus,CY,7,0,875899,Europe,1067,19
2020-07-30,Cyprus,CY,13,0,875899,Europe,1080,19
2020-07-31,Cyprus,CY,4,0,875899,Europe,1084,19
2020-08-01,Cyprus,CY,30,0,875899,Europe,1114,19
2020-08-02,Cyprus,CY,10,0,875899,Europe,1124,19
2020-08-03,Cyprus,CY,26,0,875899,Europe,1150,19
2020-08-04,Cyprus,CY,5,0,875899,Europe,1155,19
2020-08-05,Cyprus,CY,25,0,875899,Europe,1180,19
2020-08-06,Cyprus,CY,15,0,875899,Europe,1195,19
2020-08-07,Cyprus,CY,13,0,875899,Europe,1208,19
2020-08-08,Cyprus,CY,14,0,875899,Europe,1222,19
2020-08-09,Cyprus,CY,11,0,875899,Europe,1233,19
2020-08-10,Cyprus,CY,9,0,875899,Europe,1242,19
2020-08-11,Cyprus,CY,10,0,875899,Europe,1252,19
2020-08-12,Cyprus,CY,25,1,875899,Europe,1277,20
2020-08-13,Cyprus,CY,14,0,875899,Europe,1291,20
2020-08-14,Cyprus,CY,14,0,875899,Europe,1305,20
2020-08-15,Cyprus,CY,13,0,875899,Europe,1318,20
2020-08-16,Cyprus,CY,14,0,875899,Europe,1332,20
2020-08-17,Cyprus,CY,0,0,875899,Europe,1332,20
2020-08-18,Cyprus,CY,19,0,875899,Europe,1351,20
2020-08-19,Cyprus,CY,8,0,875899,Europe,1359,20
2020-08-20,Cyprus,CY,26,1,875899,Europe,1385,21
2020-08-21,Cyprus,CY,10,0,875899,Europe,1395,21
2020-08-22,Cyprus,CY,11,0,875899,Europe,1406,21
2020-08-23,Cyprus,CY,11,0,875899,Europe,1417,21
2020-08-24,Cyprus,CY,4,0,875899,Europe,1421,21
2020-08-25,Cyprus,CY,30,0,875899,Europe,1451,21
2020-08-26,Cyprus,CY,23,0,875899,Europe,1474,21
2020-08-27,Cyprus,CY,7,0,875899,Europe,1481,21
2020-08-28,Cyprus,CY,0,0,875899,Europe,1481,21
2020-08-29,Cyprus,CY,0,0,875899,Europe,1481,21
2020-08-30,Cyprus,CY,2,0,875899,Europe,1483,21
2020-08-31,Cyprus,CY,4,0,875899,Europe,1487,21
2020-09-01,Cyprus,CY,1,0,875899,Europe,1488,21
2020-09-02,Cyprus,CY,2,0,875899,Europe,1490,21
2020-09-03,Cyprus,CY,5,0,875899,Europe,1495,21
2020-09-04,Cyprus,CY,3,0,875899,Europe,1498,21
2020-09-05,Cyprus,CY,0,0,875899,Europe,1498,21
2020-09-06,Cyprus,CY,9,0,875899,Europe,1507,21
2020-09-07,Cyprus,CY,2,0,875899,Europe,1509,21
2020-09-08,Cyprus,CY,1,0,875899,Europe,1510,21
2020-09-09,Cyprus,CY,1,0,875899,Europe,1511,21
2020-09-10,Cyprus,CY,3,0,875899,Europe,1514,21
2020-09-11,Cyprus,CY,3,0,875899,Europe,1517,21
2020-09-12,Cyprus,CY,3,0,875899,Europe,1520,21
2020-09-13,Cyprus,CY,3,0,875899,Europe,1523,21
2020-09-14,Cyprus,CY,3,0,875899,Europe,1526,21
2020-09-15,Cyprus,CY,8,1,875899,Europe,1534,22
2020-09-16,Cyprus,CY,6,0,875899,Europe,1540,22
2020-09-17,Cyprus,CY,8,0,875899,Europe,1548,22
2020-09-18,Cyprus,CY,10,0,875899,Europe,1558,22
2020-09-19,Cyprus,CY,7,0,875899,Europe,1565,22
2020-09-20,Cyprus,CY,15,0,875899,Europe,1580,22
2020-09-21,Cyprus,CY,20,0,875899,Europe,1600,22
2020-09-22,Cyprus,CY,3,0,875899,Europe,1603,22
2020-09-23,Cyprus,CY,15,0,875899,Europe,1618,22
2020-09-24,Cyprus,CY,36,0,875899,Europe,1654,22
2020-09-25,Cyprus,CY,9,0,875899,Europe,1663,22
2020-09-26,Cyprus,CY,8,0,875899,Europe,1671,22
2020-09-27,Cyprus,CY,13,0,875899,Europe,1684,22
2020-09-28,Cyprus,CY,12,0,875899,Europe,1696,22
2020-09-29,Cyprus,CY,17,0,875899,Europe,1713,22
2020-09-30,Cyprus,CY,30,0,875899,Europe,1743,22
2020-10-01,Cyprus,CY,12,0,875899,Europe,1755,22
2020-10-02,Cyprus,CY,17,0,875899,Europe,1772,22
2020-10-03,Cyprus,CY,17,0,875899,Europe,1789,22
2020-10-04,Cyprus,CY,22,0,875899,Europe,1811,22
2020-10-05,Cyprus,CY,13,0,875899,Europe,1824,22
2020-10-06,Cyprus,CY,23,0,875899,Europe,1847,22
2020-10-07,Cyprus,CY,29,1,875899,Europe,1876,23
2020-10-08,Cyprus,CY,21,1,875899,Europe,1897,24
2020-10-09,Cyprus,CY,21,0,875899,Europe,1918,24
2020-10-10,Cyprus,CY,33,1,875899,Europe,1951,25
2020-10-11,Cyprus,CY,35,0,875899,Europe,1986,25
2020-10-12,Cyprus,CY,0,0,875899,Europe,1986,25
2020-10-13,Cyprus,CY,61,0,875899,Europe,2047,25
2020-10-14,Cyprus,CY,0,0,875899,Europe,2047,25
2020-10-15,Cyprus,CY,83,0,875899,Europe,2130,25
2020-10-16,Cyprus,CY,51,0,875899,Europe,2181,25
2020-10-17,Cyprus,CY,198,0,875899,Europe,2379,25
2020-10-18,Cyprus,CY,0,0,875899,Europe,2379,25
2020-10-19,Cyprus,CY,265,0,875899,Europe,2644,25
2020-10-20,Cyprus,CY,43,0,875899,Europe,2687,25
2020-10-21,Cyprus,CY,152,0,875899,Europe,2839,25
2020-10-22,Cyprus,CY,127,0,875899,Europe,2966,25
2020-10-23,Cyprus,CY,188,0,875899,Europe,3154,25
2020-10-24,Cyprus,CY,160,0,875899,Europe,3314,25
2020-10-25,Cyprus,CY,130,0,875899,Europe,3444,25
2020-10-26,Cyprus,CY,101,0,875899,Europe,3545,25
2020-10-27,Cyprus,CY,91,0,875899,Europe,3636,25
2020-10-28,Cyprus,CY,181,0,875899,Europe,3817,25
2020-10-29,Cyprus,CY,0,0,875899,Europe,3817,25
2020-10-30,Cyprus,CY,234,0,875899,Europe,4051,25
2020-10-31,Cyprus,CY,166,0,875899,Europe,4217,25
2020-11-01,Cyprus,CY,149,1,875899,Europe,4366,26
2020-11-02,Cyprus,CY,197,0,875899,Europe,4563,26
2020-11-03,Cyprus,CY,197,0,875899,Europe,4760,26
2020-11-04,Cyprus,CY,174,0,875899,Europe,4934,26
2020-11-05,Cyprus,CY,166,0,875899,Europe,5100,26
2020-11-06,Cyprus,CY,233,0,875899,Europe,5333,26
2020-11-07,Cyprus,CY,224,0,875899,Europe,5557,26
2020-11-08,Cyprus,CY,314,1,875899,Europe,5871,27
2020-11-09,Cyprus,CY,116,0,875899,Europe,5987,27
2020-11-10,Cyprus,CY,111,0,875899,Europe,6098,27
2020-11-11,Cyprus,CY,198,2,875899,Europe,6296,29
2020-11-12,Cyprus,CY,165,3,875899,Europe,6461,32
2020-11-13,Cyprus,CY,185,2,875899,Europe,6646,34
2020-11-14,Cyprus,CY,207,4,875899,Europe,6853,38
2020-11-15,Cyprus,CY,198,1,875899,Europe,7051,39
2020-11-16,Cyprus,CY,127,1,875899,Europe,7178,40
2020-11-17,Cyprus,CY,107,0,875899,Europe,7285,40
2020-11-18,Cyprus,CY,228,0,875899,Europe,7513,40
2020-11-19,Cyprus,CY,198,1,875899,Europe,7711,41
2020-11-20,Cyprus,CY,268,0,875899,Europe,7979,41
2020-11-21,Cyprus,CY,232,2,875899,Europe,8211,43
2020-11-22,Cyprus,CY,245,0,875899,Europe,8456,43
2020-11-23,Cyprus,CY,187,1,875899,Europe,8643,44
2020-11-24,Cyprus,CY,304,0,875899,Europe,8947,44
2020-11-25,Cyprus,CY,252,2,875899,Europe,9199,46
2020-11-26,Cyprus,CY,254,1,875899,Europe,9453,47
2020-11-27,Cyprus,CY,220,1,875899,Europe,9673,48
2020-11-28,Cyprus,CY,310,0,875899,Europe,9983,48
2020-11-29,Cyprus,CY,248,0,875899,Europe,10231,48
2020-11-30,Cyprus,CY,152,0,875899,Europe,10383,48
2020-12-01,Cyprus,CY,182,1,875899,Europe,10565,49
2020-12-02,Cyprus,CY,318,0,875899,Europe,10883,49
2020-12-03,Cyprus,CY,292,3,875899,Europe,11175,52
2020-12-04,Cyprus,CY,348,2,875899,Europe,11523,54
2020-12-05,Cyprus,CY,289,3,875899,Europe,11812,57
2020-12-06,Cyprus,CY,369,2,875899,Europe,12181,59
2020-12-07,Cyprus,CY,270,2,875899,Europe,12451,61
2020-12-08,Cyprus,CY,416,2,875899,Europe,12867,63
2020-12-09,Cyprus,CY,419,5,875899,Europe,13286,68
2020-12-10,Cyprus,CY,363,2,875899,Europe,13649,70
2020-12-11,Cyprus,CY,403,2,875899,Europe,14052,72
2020-12-12,Cyprus,CY,424,3,875899,Europe,14476,75
2020-12-13,Cyprus,CY,324,2,875899,Europe,14800,77
2020-12-14,Cyprus,CY,301,1,875899,Europe,15101,78
2019-12-31,Czechia,CZ,0,0,10649800,Europe,0,0
2020-01-01,Czechia,CZ,0,0,10649800,Europe,0,0
2020-01-02,Czechia,CZ,0,0,10649800,Europe,0,0
2020-01-03,Czechia,CZ,0,0,10649800,Europe,0,0
2020-01-04,Czechia,CZ,0,0,10649800,Europe,0,0
2020-01-05,Czechia,CZ,0,0,10649800,Europe,0,0
2020-01-06,Czechia,CZ,0,0,10649800,Europe,0,0
2020-01-07,Czechia,CZ,0,0,10649800,Europe,0,0
2020-01-08,Czechia,CZ,0,0,10649800,Europe,0,0
2020-01-09,Czechia,CZ,0,0,10649800,Europe,0,0
2020-01-10,Czechia,CZ,0,0,10649800,Europe,0,0
2020-01-11,Czechia,CZ,0,0,10649800,Europe,0,0
2020-01-12,Czechia,CZ,0,0,10649800,Europe,0,0
2020-01-13,Czechia,CZ,0,0,10649800,Europe,0,0
2020-01-14,Czechia,CZ,0,0,10649800,Europe,0,0
2020-01-15,Czechia,CZ,0,0,10649800,Europe,0,0
2020-01-16,Czechia,CZ,0,0,10649800,Europe,0,0
2020-01-17,Czechia,CZ,0,0,10649800,Europe,0,0
2020-01-18,Czechia,CZ,0,0,10649800,Europe,0,0
2020-01-19,Czechia,CZ,0,0,10649800,Europe,0,0
2020-01-20,Czechia,CZ,0,0,10649800,Europe,0,0
2020-01-21,Czechia,CZ,0,0,10649800,Europe,0,0
2020-01-22,Czechia,CZ,0,0,10649800,Europe,0,0
2020-01-23,Czechia,CZ,0,0,10649800,Europe,0,0
2020-01-24,Czechia,CZ,0,0,10649800,Europe,0,0
2020-01-25,Czechia,CZ,0,0,10649800,Europe,0,0
2020-01-26,Czechia,CZ,0,0,10649800,Europe,0,0
2020-01-27,Czechia,CZ,0,0,10649800,Europe,0,0
2020-01-28,Czechia,CZ,0,0,10649800,Europe,0,0
2020-01-29,Czechia,CZ,0,0,10649800,Europe,0,0
2020-01-30,Czechia,CZ,0,0,10649800,Europe,0,0
2020-01-31,Czechia,CZ,0,0,10649800,Europe,0,0
2020-02-01,Czechia,CZ,0,0,10649800,Europe,0,0
2020-02-02,Czechia,CZ,0,0,10649800,Europe,0,0
2020-02-03,Czechia,CZ,0,0,10649800,Europe,0,0
2020-02-04,Czechia,CZ,0,0,10649800,Europe,0,0
2020-02-05,Czechia,CZ,0,0,10649800,Europe,0,0
2020-02-06,Czechia,CZ,0,0,10649800,Europe,0,0
2020-02-07,Czechia,CZ,0,0,10649800,Europe,0,0
2020-02-08,Czechia,CZ,0,0,10649800,Europe,0,0
2020-02-09,Czechia,CZ,0,0,10649800,Europe,0,0
2020-02-10,Czechia,CZ,0,0,10649800,Europe,0,0
2020-02-11,Czechia,CZ,0,0,10649800,Europe,0,0
2020-02-12,Czechia,CZ,0,0,10649800,Europe,0,0
2020-02-13,Czechia,CZ,0,0,10649800,Europe,0,0
2020-02-14,Czechia,CZ,0,0,10649800,Europe,0,0
2020-02-15,Czechia,CZ,0,0,10649800,Europe,0,0
2020-02-16,Czechia,CZ,0,0,10649800,Europe,0,0
2020-02-17,Czechia,CZ,0,0,10649800,Europe,0,0
2020-02-18,Czechia,CZ,0,0,10649800,Europe,0,0
2020-02-19,Czechia,CZ,0,0,10649800,Europe,0,0
2020-02-20,Czechia,CZ,0,0,10649800,Europe,0,0
2020-02-21,Czechia,CZ,0,0,10649800,Europe,0,0
2020-02-22,Czechia,CZ,0,0,10649800,Europe,0,0
2020-02-23,Czechia,CZ,0,0,10649800,Europe,0,0
2020-02-24,Czechia,CZ,0,0,10649800,Europe,0,0
2020-02-25,Czechia,CZ,0,0,10649800,Europe,0,0
2020-02-26,Czechia,CZ,0,0,10649800,Europe,0,0
2020-02-27,Czechia,CZ,0,0,10649800,Europe,0,0
2020-02-28,Czechia,CZ,0,0,10649800,Europe,0,0
2020-02-29,Czechia,CZ,0,0,10649800,Europe,0,0
2020-03-01,Czechia,CZ,0,0,10649800,Europe,0,0
2020-03-02,Czechia,CZ,3,0,10649800,Europe,3,0
2020-03-03,Czechia,CZ,2,0,10649800,Europe,5,0
2020-03-04,Czechia,CZ,0,0,10649800,Europe,5,0
2020-03-05,Czechia,CZ,3,0,10649800,Europe,8,0
2020-03-06,Czechia,CZ,4,0,10649800,Europe,12,0
2020-03-07,Czechia,CZ,7,0,10649800,Europe,19,0
2020-03-08,Czechia,CZ,7,0,10649800,Europe,26,0
2020-03-09,Czechia,CZ,6,0,10649800,Europe,32,0
2020-03-10,Czechia,CZ,8,0,10649800,Europe,40,0
2020-03-11,Czechia,CZ,23,0,10649800,Europe,63,0
2020-03-12,Czechia,CZ,31,0,10649800,Europe,94,0
2020-03-13,Czechia,CZ,22,0,10649800,Europe,116,0
2020-03-14,Czechia,CZ,34,0,10649800,Europe,150,0
2020-03-15,Czechia,CZ,64,0,10649800,Europe,214,0
2020-03-16,Czechia,CZ,84,0,10649800,Europe,298,0
2020-03-17,Czechia,CZ,46,0,10649800,Europe,344,0
2020-03-18,Czechia,CZ,90,0,10649800,Europe,434,0
2020-03-19,Czechia,CZ,88,0,10649800,Europe,522,0
2020-03-20,Czechia,CZ,172,0,10649800,Europe,694,0
2020-03-21,Czechia,CZ,210,0,10649800,Europe,904,0
2020-03-22,Czechia,CZ,91,0,10649800,Europe,995,0
2020-03-23,Czechia,CZ,170,1,10649800,Europe,1165,1
2020-03-24,Czechia,CZ,71,0,10649800,Europe,1236,1
2020-03-25,Czechia,CZ,158,2,10649800,Europe,1394,3
2020-03-26,Czechia,CZ,260,3,10649800,Europe,1654,6
2020-03-27,Czechia,CZ,408,3,10649800,Europe,2062,9
2020-03-28,Czechia,CZ,217,0,10649800,Europe,2279,9
2020-03-29,Czechia,CZ,384,2,10649800,Europe,2663,11
2020-03-30,Czechia,CZ,166,5,10649800,Europe,2829,16
2020-03-31,Czechia,CZ,173,8,10649800,Europe,3002,24
2020-04-01,Czechia,CZ,306,7,10649800,Europe,3308,31
2020-04-02,Czechia,CZ,281,8,10649800,Europe,3589,39
2020-04-03,Czechia,CZ,269,5,10649800,Europe,3858,44
2020-04-04,Czechia,CZ,332,9,10649800,Europe,4190,53
2020-04-05,Czechia,CZ,282,6,10649800,Europe,4472,59
2020-04-06,Czechia,CZ,115,8,10649800,Europe,4587,67
2020-04-07,Czechia,CZ,235,11,10649800,Europe,4822,78
2020-04-08,Czechia,CZ,195,10,10649800,Europe,5017,88
2020-04-09,Czechia,CZ,295,11,10649800,Europe,5312,99
2020-04-10,Czechia,CZ,257,13,10649800,Europe,5569,112
2020-04-11,Czechia,CZ,163,7,10649800,Europe,5732,119
2020-04-12,Czechia,CZ,170,10,10649800,Europe,5902,129
2020-04-13,Czechia,CZ,89,9,10649800,Europe,5991,138
2020-04-14,Czechia,CZ,68,5,10649800,Europe,6059,143
2020-04-15,Czechia,CZ,82,18,10649800,Europe,6141,161
2020-04-16,Czechia,CZ,162,5,10649800,Europe,6303,166
2020-04-17,Czechia,CZ,130,3,10649800,Europe,6433,169
2020-04-18,Czechia,CZ,116,4,10649800,Europe,6549,173
2020-04-19,Czechia,CZ,105,8,10649800,Europe,6654,181
2020-04-20,Czechia,CZ,133,7,10649800,Europe,6787,188
2020-04-21,Czechia,CZ,127,8,10649800,Europe,6914,196
2020-04-22,Czechia,CZ,127,5,10649800,Europe,7041,201
2020-04-23,Czechia,CZ,95,9,10649800,Europe,7136,210
2020-04-24,Czechia,CZ,52,3,10649800,Europe,7188,213
2020-04-25,Czechia,CZ,85,2,10649800,Europe,7273,215
2020-04-26,Czechia,CZ,79,3,10649800,Europe,7352,218
2020-04-27,Czechia,CZ,52,3,10649800,Europe,7404,221
2020-04-28,Czechia,CZ,45,2,10649800,Europe,7449,223
2020-04-29,Czechia,CZ,55,4,10649800,Europe,7504,227
2020-04-30,Czechia,CZ,75,0,10649800,Europe,7579,227
2020-05-01,Czechia,CZ,103,9,10649800,Europe,7682,236
2020-05-02,Czechia,CZ,55,4,10649800,Europe,7737,240
2020-05-03,Czechia,CZ,18,5,10649800,Europe,7755,245
2020-05-04,Czechia,CZ,26,3,10649800,Europe,7781,248
2020-05-05,Czechia,CZ,38,4,10649800,Europe,7819,252
2020-05-06,Czechia,CZ,77,5,10649800,Europe,7896,257
2020-05-07,Czechia,CZ,78,5,10649800,Europe,7974,262
2020-05-08,Czechia,CZ,57,8,10649800,Europe,8031,270
2020-05-09,Czechia,CZ,46,3,10649800,Europe,8077,273
2020-05-10,Czechia,CZ,18,3,10649800,Europe,8095,276
2020-05-11,Czechia,CZ,28,4,10649800,Europe,8123,280
2020-05-12,Czechia,CZ,53,2,10649800,Europe,8176,282
2020-05-13,Czechia,CZ,45,1,10649800,Europe,8221,283
2020-05-14,Czechia,CZ,48,7,10649800,Europe,8269,290
2020-05-15,Czechia,CZ,82,3,10649800,Europe,8351,293
2020-05-16,Czechia,CZ,55,2,10649800,Europe,8406,295
2020-05-17,Czechia,CZ,49,1,10649800,Europe,8455,296
2020-05-18,Czechia,CZ,20,1,10649800,Europe,8475,297
2020-05-19,Czechia,CZ,111,0,10649800,Europe,8586,297
2020-05-20,Czechia,CZ,61,5,10649800,Europe,8647,302
2020-05-21,Czechia,CZ,74,2,10649800,Europe,8721,304
2020-05-22,Czechia,CZ,33,2,10649800,Europe,8754,306
2020-05-23,Czechia,CZ,59,6,10649800,Europe,8813,312
2020-05-24,Czechia,CZ,77,2,10649800,Europe,8890,314
2020-05-25,Czechia,CZ,67,1,10649800,Europe,8957,315
2020-05-26,Czechia,CZ,47,2,10649800,Europe,9004,317
2020-05-27,Czechia,CZ,46,0,10649800,Europe,9050,317
2020-05-28,Czechia,CZ,36,0,10649800,Europe,9086,317
2020-05-29,Czechia,CZ,54,2,10649800,Europe,9140,319
2020-05-30,Czechia,CZ,56,0,10649800,Europe,9196,319
2020-05-31,Czechia,CZ,34,0,10649800,Europe,9230,319
2020-06-01,Czechia,CZ,43,1,10649800,Europe,9273,320
2020-06-02,Czechia,CZ,29,1,10649800,Europe,9302,321
2020-06-03,Czechia,CZ,62,2,10649800,Europe,9364,323
2020-06-04,Czechia,CZ,74,1,10649800,Europe,9438,324
2020-06-05,Czechia,CZ,56,2,10649800,Europe,9494,326
2020-06-06,Czechia,CZ,35,1,10649800,Europe,9529,327
2020-06-07,Czechia,CZ,38,0,10649800,Europe,9567,327
2020-06-08,Czechia,CZ,61,0,10649800,Europe,9628,327
2020-06-09,Czechia,CZ,69,1,10649800,Europe,9697,328
2020-06-10,Czechia,CZ,54,0,10649800,Europe,9751,328
2020-06-11,Czechia,CZ,73,0,10649800,Europe,9824,328
2020-06-12,Czechia,CZ,62,1,10649800,Europe,9886,329
2020-06-13,Czechia,CZ,52,0,10649800,Europe,9938,329
2020-06-14,Czechia,CZ,53,0,10649800,Europe,9991,329
2020-06-15,Czechia,CZ,33,0,10649800,Europe,10024,329
2020-06-16,Czechia,CZ,40,1,10649800,Europe,10064,330
2020-06-17,Czechia,CZ,47,1,10649800,Europe,10111,331
2020-06-18,Czechia,CZ,51,2,10649800,Europe,10162,333
2020-06-19,Czechia,CZ,68,1,10649800,Europe,10230,334
2020-06-20,Czechia,CZ,176,1,10649800,Europe,10406,335
2020-06-21,Czechia,CZ,42,1,10649800,Europe,10448,336
2020-06-22,Czechia,CZ,50,0,10649800,Europe,10498,336
2020-06-23,Czechia,CZ,63,0,10649800,Europe,10561,336
2020-06-24,Czechia,CZ,89,3,10649800,Europe,10650,339
2020-06-25,Czechia,CZ,127,4,10649800,Europe,10777,343
2020-06-26,Czechia,CZ,93,2,10649800,Europe,10870,345
2020-06-27,Czechia,CZ,168,0,10649800,Europe,11038,345
2020-06-28,Czechia,CZ,260,2,10649800,Europe,11298,347
2020-06-29,Czechia,CZ,305,1,10649800,Europe,11603,348
2020-06-30,Czechia,CZ,202,0,10649800,Europe,11805,348
2020-07-01,Czechia,CZ,149,1,10649800,Europe,11954,349
2020-07-02,Czechia,CZ,92,0,10649800,Europe,12046,349
2020-07-03,Czechia,CZ,132,2,10649800,Europe,12178,351
2020-07-04,Czechia,CZ,141,1,10649800,Europe,12319,352
2020-07-05,Czechia,CZ,121,-1,10649800,Europe,12440,351
2020-07-06,Czechia,CZ,75,-3,10649800,Europe,12515,348
2020-07-07,Czechia,CZ,51,2,10649800,Europe,12566,350
2020-07-08,Czechia,CZ,119,1,10649800,Europe,12685,351
2020-07-09,Czechia,CZ,129,0,10649800,Europe,12814,351
2020-07-10,Czechia,CZ,105,1,10649800,Europe,12919,352
2020-07-11,Czechia,CZ,143,0,10649800,Europe,13062,352
2020-07-12,Czechia,CZ,53,0,10649800,Europe,13115,352
2020-07-13,Czechia,CZ,59,0,10649800,Europe,13174,352
2020-07-14,Czechia,CZ,64,1,10649800,Europe,13238,353
2020-07-15,Czechia,CZ,103,2,10649800,Europe,13341,355
2020-07-16,Czechia,CZ,134,0,10649800,Europe,13475,355
2020-07-17,Czechia,CZ,137,0,10649800,Europe,13612,355
2020-07-18,Czechia,CZ,130,3,10649800,Europe,13742,358
2020-07-19,Czechia,CZ,113,0,10649800,Europe,13855,358
2020-07-20,Czechia,CZ,90,1,10649800,Europe,13945,359
2020-07-21,Czechia,CZ,153,0,10649800,Europe,14098,359
2020-07-22,Czechia,CZ,226,1,10649800,Europe,14324,360
2020-07-23,Czechia,CZ,246,4,10649800,Europe,14570,364
2020-07-24,Czechia,CZ,230,1,10649800,Europe,14800,365
2020-07-25,Czechia,CZ,281,3,10649800,Europe,15081,368
2020-07-26,Czechia,CZ,131,0,10649800,Europe,15212,368
2020-07-27,Czechia,CZ,112,3,10649800,Europe,15324,371
2020-07-28,Czechia,CZ,192,2,10649800,Europe,15516,373
2020-07-29,Czechia,CZ,283,0,10649800,Europe,15799,373
2020-07-30,Czechia,CZ,294,1,10649800,Europe,16093,374
2020-07-31,Czechia,CZ,249,5,10649800,Europe,16342,379
2020-08-01,Czechia,CZ,232,3,10649800,Europe,16574,382
2020-08-02,Czechia,CZ,125,1,10649800,Europe,16699,383
2020-08-03,Czechia,CZ,101,0,10649800,Europe,16800,383
2020-08-04,Czechia,CZ,208,0,10649800,Europe,17008,383
2020-08-05,Czechia,CZ,278,0,10649800,Europe,17286,383
2020-08-06,Czechia,CZ,243,5,10649800,Europe,17529,388
2020-08-07,Czechia,CZ,211,1,10649800,Europe,17740,389
2020-08-08,Czechia,CZ,320,0,10649800,Europe,18060,389
2020-08-09,Czechia,CZ,175,0,10649800,Europe,18235,389
2020-08-10,Czechia,CZ,120,0,10649800,Europe,18355,389
2020-08-11,Czechia,CZ,139,0,10649800,Europe,18494,389
2020-08-12,Czechia,CZ,289,2,10649800,Europe,18783,391
2020-08-13,Czechia,CZ,292,0,10649800,Europe,19075,391
2020-08-14,Czechia,CZ,326,0,10649800,Europe,19401,391
2020-08-15,Czechia,CZ,292,3,10649800,Europe,19693,394
2020-08-16,Czechia,CZ,198,1,10649800,Europe,19891,395
2020-08-17,Czechia,CZ,121,2,10649800,Europe,20012,397
2020-08-18,Czechia,CZ,190,2,10649800,Europe,20202,399
2020-08-19,Czechia,CZ,281,2,10649800,Europe,20483,401
2020-08-20,Czechia,CZ,315,3,10649800,Europe,20798,404
2020-08-21,Czechia,CZ,247,2,10649800,Europe,21045,406
2020-08-22,Czechia,CZ,506,5,10649800,Europe,21551,411
2020-08-23,Czechia,CZ,239,0,10649800,Europe,21790,411
2020-08-24,Czechia,CZ,133,1,10649800,Europe,21923,412
2020-08-25,Czechia,CZ,258,3,10649800,Europe,22181,415
2020-08-26,Czechia,CZ,367,1,10649800,Europe,22548,416
2020-08-27,Czechia,CZ,403,2,10649800,Europe,22951,418
2020-08-28,Czechia,CZ,349,0,10649800,Europe,23300,418
2020-08-29,Czechia,CZ,477,1,10649800,Europe,23777,419
2020-08-30,Czechia,CZ,317,2,10649800,Europe,24094,421
2020-08-31,Czechia,CZ,273,2,10649800,Europe,24367,423
2020-09-01,Czechia,CZ,251,1,10649800,Europe,24618,424
2020-09-02,Czechia,CZ,499,1,10649800,Europe,25117,425
2020-09-03,Czechia,CZ,656,0,10649800,Europe,25773,425
2020-09-04,Czechia,CZ,679,1,10649800,Europe,26452,426
2020-09-05,Czechia,CZ,797,3,10649800,Europe,27249,429
2020-09-06,Czechia,CZ,503,2,10649800,Europe,27752,431
2020-09-07,Czechia,CZ,404,5,10649800,Europe,28156,436
2020-09-08,Czechia,CZ,560,1,10649800,Europe,28716,437
2020-09-09,Czechia,CZ,1161,4,10649800,Europe,29877,441
2020-09-10,Czechia,CZ,1159,3,10649800,Europe,31036,444
2020-09-11,Czechia,CZ,1377,4,10649800,Europe,32413,448
2020-09-12,Czechia,CZ,1447,2,10649800,Europe,33860,450
2020-09-13,Czechia,CZ,1541,3,10649800,Europe,35401,453
2020-09-14,Czechia,CZ,787,3,10649800,Europe,36188,456
2020-09-15,Czechia,CZ,1034,9,10649800,Europe,37222,465
2020-09-16,Czechia,CZ,1674,11,10649800,Europe,38896,476
2020-09-17,Czechia,CZ,2136,6,10649800,Europe,41032,482
2020-09-18,Czechia,CZ,3123,7,10649800,Europe,44155,489
2020-09-19,Czechia,CZ,2107,6,10649800,Europe,46262,495
2020-09-20,Czechia,CZ,2044,4,10649800,Europe,48306,499
2020-09-21,Czechia,CZ,934,4,10649800,Europe,49240,503
2020-09-22,Czechia,CZ,1524,19,10649800,Europe,50764,522
2020-09-23,Czechia,CZ,2394,9,10649800,Europe,53158,531
2020-09-24,Czechia,CZ,2306,24,10649800,Europe,55464,555
2020-09-25,Czechia,CZ,2910,12,10649800,Europe,58374,567
2020-09-26,Czechia,CZ,2944,14,10649800,Europe,61318,581
2020-09-27,Czechia,CZ,1976,10,10649800,Europe,63294,591
2020-09-28,Czechia,CZ,1303,15,10649800,Europe,64597,606
2020-09-29,Czechia,CZ,1286,12,10649800,Europe,65883,618
2020-09-30,Czechia,CZ,1960,18,10649800,Europe,67843,636
2020-10-01,Czechia,CZ,1076,19,10649800,Europe,68919,655
2020-10-02,Czechia,CZ,5336,23,10649800,Europe,74255,678
2020-10-03,Czechia,CZ,3796,21,10649800,Europe,78051,699
2020-10-04,Czechia,CZ,2554,12,10649800,Europe,80605,711
2020-10-05,Czechia,CZ,1841,16,10649800,Europe,82446,727
2020-10-06,Czechia,CZ,3120,31,10649800,Europe,85566,758
2020-10-07,Czechia,CZ,4456,36,10649800,Europe,90022,794
2020-10-08,Czechia,CZ,5338,35,10649800,Europe,95360,829
2020-10-09,Czechia,CZ,5397,40,10649800,Europe,100757,869
2020-10-10,Czechia,CZ,8617,36,10649800,Europe,109374,905
2020-10-11,Czechia,CZ,4633,90,10649800,Europe,114007,995
2020-10-12,Czechia,CZ,3103,39,10649800,Europe,117110,1034
2020-10-13,Czechia,CZ,4311,17,10649800,Europe,121421,1051
2020-10-14,Czechia,CZ,8326,55,10649800,Europe,129747,1106
2020-10-15,Czechia,CZ,9543,66,10649800,Europe,139290,1172
2020-10-16,Czechia,CZ,9720,58,10649800,Europe,149010,1230
2020-10-17,Czechia,CZ,11102,53,10649800,Europe,160112,1283
2020-10-18,Czechia,CZ,8715,69,10649800,Europe,168827,1352
2020-10-19,Czechia,CZ,5058,70,10649800,Europe,173885,1422
2020-10-20,Czechia,CZ,8077,91,10649800,Europe,181962,1513
2020-10-21,Czechia,CZ,11984,106,10649800,Europe,193946,1619
2020-10-22,Czechia,CZ,14969,120,10649800,Europe,208915,1739
2020-10-23,Czechia,CZ,14150,106,10649800,Europe,223065,1845
2020-10-24,Czechia,CZ,15258,126,10649800,Europe,238323,1971
2020-10-25,Czechia,CZ,12474,106,10649800,Europe,250797,2077
2020-10-26,Czechia,CZ,7300,124,10649800,Europe,258097,2201
2020-10-27,Czechia,CZ,10273,164,10649800,Europe,268370,2365
2020-10-28,Czechia,CZ,15663,182,10649800,Europe,284033,2547
2020-10-29,Czechia,CZ,12980,128,10649800,Europe,297013,2675
2020-10-30,Czechia,CZ,13055,187,10649800,Europe,310068,2862
2020-10-31,Czechia,CZ,13605,216,10649800,Europe,323673,3078
2020-11-01,Czechia,CZ,11429,173,10649800,Europe,335102,3251
2020-11-02,Czechia,CZ,6542,178,10649800,Europe,341644,3429
2020-11-03,Czechia,CZ,9252,225,10649800,Europe,350896,3654
2020-11-04,Czechia,CZ,12089,259,10649800,Europe,362985,3913
2020-11-05,Czechia,CZ,15731,220,10649800,Europe,378716,4133
2020-11-06,Czechia,CZ,13229,197,10649800,Europe,391945,4330
2020-11-07,Czechia,CZ,11552,196,10649800,Europe,403497,4526
2020-11-08,Czechia,CZ,7723,155,10649800,Europe,411220,4681
2020-11-09,Czechia,CZ,3608,177,10649800,Europe,414828,4858
2020-11-10,Czechia,CZ,6047,216,10649800,Europe,420875,5074
2020-11-11,Czechia,CZ,9005,249,10649800,Europe,429880,5323
2020-11-12,Czechia,CZ,8925,247,10649800,Europe,438805,5570
2020-11-13,Czechia,CZ,7870,185,10649800,Europe,446675,5755
2020-11-14,Czechia,CZ,7355,171,10649800,Europe,454030,5926
2020-11-15,Czechia,CZ,4199,132,10649800,Europe,458229,6058
2020-11-16,Czechia,CZ,1887,150,10649800,Europe,460116,6208
2020-11-17,Czechia,CZ,5407,208,10649800,Europe,465523,6416
2020-11-18,Czechia,CZ,4246,142,10649800,Europe,469769,6558
2020-11-19,Czechia,CZ,5515,182,10649800,Europe,475284,6740
2020-11-20,Czechia,CZ,6471,134,10649800,Europe,481755,6874
2020-11-21,Czechia,CZ,5808,147,10649800,Europe,487563,7021
2020-11-22,Czechia,CZ,3187,74,10649800,Europe,490750,7095
2020-11-23,Czechia,CZ,1513,101,10649800,Europe,492263,7196
2020-11-24,Czechia,CZ,4375,164,10649800,Europe,496638,7360
2020-11-25,Czechia,CZ,5896,139,10649800,Europe,502534,7499
2020-11-26,Czechia,CZ,2681,112,10649800,Europe,505215,7611
2020-11-27,Czechia,CZ,6305,168,10649800,Europe,511520,7779
2020-11-28,Czechia,CZ,4464,188,10649800,Europe,515984,7967
2020-11-29,Czechia,CZ,2665,87,10649800,Europe,518649,8054
2020-11-30,Czechia,CZ,1074,84,10649800,Europe,519723,8138
2020-12-01,Czechia,CZ,3575,157,10649800,Europe,523298,8295
2020-12-02,Czechia,CZ,5176,112,10649800,Europe,528474,8407
2020-12-03,Czechia,CZ,4568,108,10649800,Europe,533042,8515
2020-12-04,Czechia,CZ,4621,126,10649800,Europe,537663,8641
2020-12-05,Czechia,CZ,4743,97,10649800,Europe,542406,8738
2020-12-06,Czechia,CZ,1773,77,10649800,Europe,544179,8815
2020-12-07,Czechia,CZ,2654,87,10649800,Europe,546833,8902
2020-12-08,Czechia,CZ,4237,134,10649800,Europe,551070,9036
2020-12-09,Czechia,CZ,5857,100,10649800,Europe,556927,9136
2020-12-10,Czechia,CZ,6406,90,10649800,Europe,563333,9226
2020-12-11,Czechia,CZ,5872,115,10649800,Europe,569205,9341
2020-12-12,Czechia,CZ,6217,109,10649800,Europe,575422,9450
2020-12-13,Czechia,CZ,3657,85,10649800,Europe,579079,9535
2020-12-14,Czechia,CZ,2000,74,10649800,Europe,581079,9609
2019-12-31,Germany,DE,0,0,83019213,Europe,0,0
2020-01-01,Germany,DE,0,0,83019213,Europe,0,0
2020-01-02,Germany,DE,0,0,83019213,Europe,0,0
2020-01-03,Germany,DE,0,0,83019213,Europe,0,0
2020-01-04,Germany,DE,0,0,83019213,Europe,0,0
2020-01-05,Germany,DE,0,0,83019213,Europe,0,0
2020-01-06,Germany,DE,0,0,83019213,Europe,0,0
2020-01-07,Germany,DE,0,0,83019213,Europe,0,0
2020-01-08,Germany,DE,0,0,83019213,Europe,0,0
2020-01-09,Germany,DE,0,0,83019213,Europe,0,0
2020-01-10,Germany,DE,0,0,83019213,Europe,0,0
2020-01-11,Germany,DE,0,0,83019213,Europe,0,0
2020-01-12,Germany,DE,0,0,83019213,Europe,0,0
2020-01-13,Germany,DE,0,0,83019213,Europe,0,0
2020-01-14,Germany,DE,0,0,83019213,Europe,0,0
2020-01-15,Germany,DE,0,0,83019213,Europe,0,0
2020-01-16,Germany,DE,0,0,83019213,Europe,0,0
2020-01-17,Germany,DE,0,0,83019213,Europe,0,0
2020-01-18,Germany,DE,0,0,83019213,Europe,0,0
2020-01-19,Germany,DE,0,0,83019213,Europe,0,0
2020-01-20,Germany,DE,0,0,83019213,Europe,0,0
2020-01-21,Germany,DE,0,0,83019213,Europe,0,0
2020-01-22,Germany,DE,0,0,83019213,Europe,0,0
2020-01-23,Germany,DE,0,0,83019213,Europe,0,0
2020-01-24,Germany,DE,0,0,83019213,Europe,0,0
2020-01-25,Germany,DE,0,0,83019213,Europe,0,0
2020-01-26,Germany,DE,0,0,83019213,Europe,0,0
2020-01-27,Germany,DE,0,0,83019213,Europe,0,0
2020-01-28,Germany,DE,1,0,83019213,Europe,1,0
2020-01-29,Germany,DE,3,0,83019213,Europe,4,0
2020-01-30,Germany,DE,0,0,83019213,Europe,4,0
2020-01-31,Germany,DE,1,0,83019213,Europe,5,0
2020-02-01,Germany,DE,2,0,83019213,Europe,7,0
2020-02-02,Germany,DE,1,0,83019213,Europe,8,0
2020-02-03,Germany,DE,1,0,83019213,Europe,9,0
2020-02-04,Germany,DE,2,0,83019213,Europe,11,0
2020-02-05,Germany,DE,0,0,83019213,Europe,11,0
2020-02-06,Germany,DE,0,0,83019213,Europe,11,0
2020-02-07,Germany,DE,1,0,83019213,Europe,12,0
2020-02-08,Germany,DE,1,0,83019213,Europe,13,0
2020-02-09,Germany,DE,0,0,83019213,Europe,13,0
2020-02-10,Germany,DE,0,0,83019213,Europe,13,0
2020-02-11,Germany,DE,0,0,83019213,Europe,13,0
2020-02-12,Germany,DE,2,0,83019213,Europe,15,0
2020-02-13,Germany,DE,0,0,83019213,Europe,15,0
2020-02-14,Germany,DE,0,0,83019213,Europe,15,0
2020-02-15,Germany,DE,0,0,83019213,Europe,15,0
2020-02-16,Germany,DE,0,0,83019213,Europe,15,0
2020-02-17,Germany,DE,0,0,83019213,Europe,15,0
2020-02-18,Germany,DE,0,0,83019213,Europe,15,0
2020-02-19,Germany,DE,0,0,83019213,Europe,15,0
2020-02-20,Germany,DE,0,0,83019213,Europe,15,0
2020-02-21,Germany,DE,0,0,83019213,Europe,15,0
2020-02-22,Germany,DE,0,0,83019213,Europe,15,0
2020-02-23,Germany,DE,0,0,83019213,Europe,15,0
2020-02-24,Germany,DE,0,0,83019213,Europe,15,0
2020-02-25,Germany,DE,0,0,83019213,Europe,15,0
2020-02-26,Germany,DE,2,0,83019213,Europe,17,0
2020-02-27,Germany,DE,4,0,83019213,Europe,21,0
2020-02-28,Germany,DE,26,0,83019213,Europe,47,0
2020-02-29,Germany,DE,10,0,83019213,Europe,57,0
2020-03-01,Germany,DE,54,0,83019213,Europe,111,0
2020-03-02,Germany,DE,18,0,83019213,Europe,129,0
2020-03-03,Germany,DE,28,0,83019213,Europe,157,0
2020-03-04,Germany,DE,39,0,83019213,Europe,196,0
2020-03-05,Germany,DE,66,0,83019213,Europe,262,0
2020-03-06,Germany,DE,138,0,83019213,Europe,400,0
2020-03-07,Germany,DE,284,0,83019213,Europe,684,0
2020-03-08,Germany,DE,163,0,83019213,Europe,847,0
2020-03-09,Germany,DE,55,0,83019213,Europe,902,0
2020-03-10,Germany,DE,237,2,83019213,Europe,1139,2
2020-03-11,Germany,DE,157,0,83019213,Europe,1296,2
2020-03-12,Germany,DE,271,1,83019213,Europe,1567,3
2020-03-13,Germany,DE,802,2,83019213,Europe,2369,5
2020-03-14,Germany,DE,693,0,83019213,Europe,3062,5
2020-03-15,Germany,DE,733,3,83019213,Europe,3795,8
2020-03-16,Germany,DE,1043,4,83019213,Europe,4838,12
2020-03-17,Germany,DE,1174,1,83019213,Europe,6012,13
2020-03-18,Germany,DE,1144,0,83019213,Europe,7156,13
2020-03-19,Germany,DE,1042,0,83019213,Europe,8198,13
2020-03-20,Germany,DE,5940,30,83019213,Europe,14138,43
2020-03-21,Germany,DE,4049,2,83019213,Europe,18187,45
2020-03-22,Germany,DE,3276,22,83019213,Europe,21463,67
2020-03-23,Germany,DE,3311,27,83019213,Europe,24774,94
2020-03-24,Germany,DE,4438,32,83019213,Europe,29212,126
2020-03-25,Germany,DE,2342,23,83019213,Europe,31554,149
2020-03-26,Germany,DE,4954,49,83019213,Europe,36508,198
2020-03-27,Germany,DE,5780,55,83019213,Europe,42288,253
2020-03-28,Germany,DE,6294,72,83019213,Europe,48582,325
2020-03-29,Germany,DE,3965,64,83019213,Europe,52547,389
2020-03-30,Germany,DE,4751,66,83019213,Europe,57298,455
2020-03-31,Germany,DE,4615,128,83019213,Europe,61913,583
2020-04-01,Germany,DE,5453,149,83019213,Europe,67366,732
2020-04-02,Germany,DE,6156,140,83019213,Europe,73522,872
2020-04-03,Germany,DE,6174,145,83019213,Europe,79696,1017
2020-04-04,Germany,DE,6082,141,83019213,Europe,85778,1158
2020-04-05,Germany,DE,5936,184,83019213,Europe,91714,1342
2020-04-06,Germany,DE,3677,92,83019213,Europe,95391,1434
2020-04-07,Germany,DE,3834,173,83019213,Europe,99225,1607
2020-04-08,Germany,DE,4003,254,83019213,Europe,103228,1861
2020-04-09,Germany,DE,4974,246,83019213,Europe,108202,2107
2020-04-10,Germany,DE,5323,266,83019213,Europe,113525,2373
2020-04-11,Germany,DE,4133,171,83019213,Europe,117658,2544
2020-04-12,Germany,DE,2821,129,83019213,Europe,120479,2673
2020-04-13,Germany,DE,2537,126,83019213,Europe,123016,2799
2020-04-14,Germany,DE,2082,170,83019213,Europe,125098,2969
2020-04-15,Germany,DE,2486,285,83019213,Europe,127584,3254
2020-04-16,Germany,DE,2866,315,83019213,Europe,130450,3569
2020-04-17,Germany,DE,3380,299,83019213,Europe,133830,3868
2020-04-18,Germany,DE,3609,242,83019213,Europe,137439,4110
2020-04-19,Germany,DE,2458,184,83019213,Europe,139897,4294
2020-04-20,Germany,DE,1775,110,83019213,Europe,141672,4404
2020-04-21,Germany,DE,1785,194,83019213,Europe,143457,4598
2020-04-22,Germany,DE,2237,281,83019213,Europe,145694,4879
2020-04-23,Germany,DE,2352,215,83019213,Europe,148046,5094
2020-04-24,Germany,DE,2337,227,83019213,Europe,150383,5321
2020-04-25,Germany,DE,2055,179,83019213,Europe,152438,5500
2020-04-26,Germany,DE,1737,140,83019213,Europe,154175,5640
2020-04-27,Germany,DE,1018,110,83019213,Europe,155193,5750
2020-04-28,Germany,DE,1144,163,83019213,Europe,156337,5913
2020-04-29,Germany,DE,1304,202,83019213,Europe,157641,6115
2020-04-30,Germany,DE,1478,173,83019213,Europe,159119,6288
2020-05-01,Germany,DE,1639,193,83019213,Europe,160758,6481
2020-05-02,Germany,DE,945,94,83019213,Europe,161703,6575
2020-05-03,Germany,DE,793,74,83019213,Europe,162496,6649
2020-05-04,Germany,DE,679,43,83019213,Europe,163175,6692
2020-05-05,Germany,DE,685,139,83019213,Europe,163860,6831
2020-05-06,Germany,DE,947,165,83019213,Europe,164807,6996
2020-05-07,Germany,DE,1284,123,83019213,Europe,166091,7119
2020-05-08,Germany,DE,1209,147,83019213,Europe,167300,7266
2020-05-09,Germany,DE,1251,103,83019213,Europe,168551,7369
2020-05-10,Germany,DE,667,26,83019213,Europe,169218,7395
2020-05-11,Germany,DE,357,22,83019213,Europe,169575,7417
2020-05-12,Germany,DE,933,116,83019213,Europe,170508,7533
2020-05-13,Germany,DE,798,101,83019213,Europe,171306,7634
2020-05-14,Germany,DE,933,89,83019213,Europe,172239,7723
2020-05-15,Germany,DE,913,101,83019213,Europe,173152,7824
2020-05-16,Germany,DE,620,57,83019213,Europe,173772,7881
2020-05-17,Germany,DE,583,33,83019213,Europe,174355,7914
2020-05-18,Germany,DE,342,21,83019213,Europe,174697,7935
2020-05-19,Germany,DE,513,72,83019213,Europe,175210,8007
2020-05-20,Germany,DE,797,83,83019213,Europe,176007,8090
2020-05-21,Germany,DE,745,57,83019213,Europe,176752,8147
2020-05-22,Germany,DE,460,27,83019213,Europe,177212,8174
2020-05-23,Germany,DE,638,42,83019213,Europe,177850,8216
2020-05-24,Germany,DE,431,31,83019213,Europe,178281,8247
2020-05-25,Germany,DE,289,10,83019213,Europe,178570,8257
2020-05-26,Germany,DE,432,45,83019213,Europe,179002,8302
2020-05-27,Germany,DE,362,47,83019213,Europe,179364,8349
2020-05-28,Germany,DE,353,62,83019213,Europe,179717,8411
2020-05-29,Germany,DE,741,39,83019213,Europe,180458,8450
2020-05-30,Germany,DE,738,39,83019213,Europe,181196,8489
2020-05-31,Germany,DE,286,11,83019213,Europe,181482,8500
2020-06-01,Germany,DE,333,11,83019213,Europe,181815,8511
2020-06-02,Germany,DE,213,11,83019213,Europe,182028,8522
2020-06-03,Germany,DE,342,29,83019213,Europe,182370,8551
2020-06-04,Germany,DE,394,30,83019213,Europe,182764,8581
2020-06-05,Germany,DE,507,32,83019213,Europe,183271,8613
2020-06-06,Germany,DE,407,33,83019213,Europe,183678,8646
2020-06-07,Germany,DE,301,22,83019213,Europe,183979,8668
2020-06-08,Germany,DE,214,6,83019213,Europe,184193,8674
2020-06-09,Germany,DE,350,37,83019213,Europe,184543,8711
2020-06-10,Germany,DE,318,18,83019213,Europe,184861,8729
2020-06-11,Germany,DE,555,26,83019213,Europe,185416,8755
2020-06-12,Germany,DE,258,8,83019213,Europe,185674,8763
2020-06-13,Germany,DE,348,18,83019213,Europe,186022,8781
2020-06-14,Germany,DE,247,6,83019213,Europe,186269,8787
2020-06-15,Germany,DE,192,4,83019213,Europe,186461,8791
2020-06-16,Germany,DE,378,9,83019213,Europe,186839,8800
2020-06-17,Germany,DE,345,30,83019213,Europe,187184,8830
2020-06-18,Germany,DE,580,26,83019213,Europe,187764,8856
2020-06-19,Germany,DE,770,16,83019213,Europe,188534,8872
2020-06-20,Germany,DE,601,10,83019213,Europe,189135,8882
2020-06-21,Germany,DE,687,0,83019213,Europe,189822,8882
2020-06-22,Germany,DE,537,3,83019213,Europe,190359,8885
2020-06-23,Germany,DE,503,10,83019213,Europe,190862,8895
2020-06-24,Germany,DE,587,19,83019213,Europe,191449,8914
2020-06-25,Germany,DE,630,13,83019213,Europe,192079,8927
2020-06-26,Germany,DE,477,21,83019213,Europe,192556,8948
2020-06-27,Germany,DE,687,6,83019213,Europe,193243,8954
2020-06-28,Germany,DE,256,3,83019213,Europe,193499,8957
2020-06-29,Germany,DE,262,4,83019213,Europe,193761,8961
2020-06-30,Germany,DE,498,12,83019213,Europe,194259,8973
2020-07-01,Germany,DE,466,12,83019213,Europe,194725,8985
2020-07-02,Germany,DE,503,9,83019213,Europe,195228,8994
2020-07-03,Germany,DE,446,9,83019213,Europe,195674,9003
2020-07-04,Germany,DE,422,7,83019213,Europe,196096,9010
2020-07-05,Germany,DE,239,2,83019213,Europe,196335,9012
2020-07-06,Germany,DE,219,4,83019213,Europe,196554,9016
2020-07-07,Germany,DE,390,8,83019213,Europe,196944,9024
2020-07-08,Germany,DE,397,12,83019213,Europe,197341,9036
2020-07-09,Germany,DE,442,12,83019213,Europe,197783,9048
2020-07-10,Germany,DE,395,6,83019213,Europe,198178,9054
2020-07-11,Germany,DE,378,6,83019213,Europe,198556,9060
2020-07-12,Germany,DE,248,3,83019213,Europe,198804,9063
2020-07-13,Germany,DE,159,1,83019213,Europe,198963,9064
2020-07-14,Germany,DE,412,4,83019213,Europe,199375,9068
2020-07-15,Germany,DE,351,3,83019213,Europe,199726,9071
2020-07-16,Germany,DE,534,7,83019213,Europe,200260,9078
2020-07-17,Germany,DE,583,4,83019213,Europe,200843,9082
2020-07-18,Germany,DE,529,1,83019213,Europe,201372,9083
2020-07-19,Germany,DE,202,1,83019213,Europe,201574,9084
2020-07-20,Germany,DE,249,2,83019213,Europe,201823,9086
2020-07-21,Germany,DE,522,4,83019213,Europe,202345,9090
2020-07-22,Germany,DE,454,5,83019213,Europe,202799,9095
2020-07-23,Germany,DE,569,6,83019213,Europe,203368,9101
2020-07-24,Germany,DE,815,10,83019213,Europe,204183,9111
2020-07-25,Germany,DE,781,7,83019213,Europe,204964,9118
2020-07-26,Germany,DE,305,0,83019213,Europe,205269,9118
2020-07-27,Germany,DE,340,0,83019213,Europe,205609,9118
2020-07-28,Germany,DE,633,4,83019213,Europe,206242,9122
2020-07-29,Germany,DE,684,6,83019213,Europe,206926,9128
2020-07-30,Germany,DE,902,6,83019213,Europe,207828,9134
2020-07-31,Germany,DE,870,7,83019213,Europe,208698,9141
2020-08-01,Germany,DE,955,0,83019213,Europe,209653,9141
2020-08-02,Germany,DE,240,0,83019213,Europe,209893,9141
2020-08-03,Germany,DE,509,7,83019213,Europe,210402,9148
2020-08-04,Germany,DE,879,8,83019213,Europe,211281,9156
2020-08-05,Germany,DE,741,12,83019213,Europe,212022,9168
2020-08-06,Germany,DE,1045,7,83019213,Europe,213067,9175
2020-08-07,Germany,DE,1147,8,83019213,Europe,214214,9183
2020-08-08,Germany,DE,1122,12,83019213,Europe,215336,9195
2020-08-09,Germany,DE,555,1,83019213,Europe,215891,9196
2020-08-10,Germany,DE,436,1,83019213,Europe,216327,9197
2020-08-11,Germany,DE,966,4,83019213,Europe,217293,9201
2020-08-12,Germany,DE,1226,6,83019213,Europe,218519,9207
2020-08-13,Germany,DE,1445,4,83019213,Europe,219964,9211
2020-08-14,Germany,DE,1449,14,83019213,Europe,221413,9225
2020-08-15,Germany,DE,1415,6,83019213,Europe,222828,9231
2020-08-16,Germany,DE,625,0,83019213,Europe,223453,9231
2020-08-17,Germany,DE,561,1,83019213,Europe,224014,9232
2020-08-18,Germany,DE,1390,4,83019213,Europe,225404,9236
2020-08-19,Germany,DE,1510,7,83019213,Europe,226914,9243
2020-08-20,Germany,DE,1707,10,83019213,Europe,228621,9253
2020-08-21,Germany,DE,1427,7,83019213,Europe,230048,9260
2020-08-22,Germany,DE,2034,7,83019213,Europe,232082,9267
2020-08-23,Germany,DE,782,2,83019213,Europe,232864,9269
2020-08-24,Germany,DE,711,3,83019213,Europe,233575,9272
2020-08-25,Germany,DE,1278,5,83019213,Europe,234853,9277
2020-08-26,Germany,DE,1576,3,83019213,Europe,236429,9280
2020-08-27,Germany,DE,1507,5,83019213,Europe,237936,9285
2020-08-28,Germany,DE,1571,3,83019213,Europe,239507,9288
2020-08-29,Germany,DE,1479,1,83019213,Europe,240986,9289
2020-08-30,Germany,DE,785,6,83019213,Europe,241771,9295
2020-08-31,Germany,DE,610,3,83019213,Europe,242381,9298
2020-09-01,Germany,DE,1218,4,83019213,Europe,243599,9302
2020-09-02,Germany,DE,1256,11,83019213,Europe,244855,9313
2020-09-03,Germany,DE,1311,8,83019213,Europe,246166,9321
2020-09-04,Germany,DE,1453,1,83019213,Europe,247619,9322
2020-09-05,Germany,DE,1378,2,83019213,Europe,248997,9324
2020-09-06,Germany,DE,988,1,83019213,Europe,249985,9325
2020-09-07,Germany,DE,814,0,83019213,Europe,250799,9325
2020-09-08,Germany,DE,1499,4,83019213,Europe,252298,9329
2020-09-09,Germany,DE,1176,9,83019213,Europe,253474,9338
2020-09-10,Germany,DE,1892,3,83019213,Europe,255366,9341
2020-09-11,Germany,DE,1484,1,83019213,Europe,256850,9342
2020-09-12,Germany,DE,1630,5,83019213,Europe,258480,9347
2020-09-13,Germany,DE,948,2,83019213,Europe,259428,9349
2020-09-14,Germany,DE,927,1,83019213,Europe,260355,9350
2020-09-15,Germany,DE,1407,12,83019213,Europe,261762,9362
2020-09-16,Germany,DE,1901,6,83019213,Europe,263663,9368
2020-09-17,Germany,DE,2194,3,83019213,Europe,265857,9371
2020-09-18,Germany,DE,1916,7,83019213,Europe,267773,9378
2020-09-19,Germany,DE,2297,6,83019213,Europe,270070,9384
2020-09-20,Germany,DE,1345,2,83019213,Europe,271415,9386
2020-09-21,Germany,DE,922,0,83019213,Europe,272337,9386
2020-09-22,Germany,DE,1821,10,83019213,Europe,274158,9396
2020-09-23,Germany,DE,1769,13,83019213,Europe,275927,9409
2020-09-24,Germany,DE,2143,19,83019213,Europe,278070,9428
2020-09-25,Germany,DE,2153,15,83019213,Europe,280223,9443
2020-09-26,Germany,DE,2507,9,83019213,Europe,282730,9452
2020-09-27,Germany,DE,1410,5,83019213,Europe,284140,9457
2020-09-28,Germany,DE,1192,3,83019213,Europe,285332,9460
2020-09-29,Germany,DE,2089,11,83019213,Europe,287421,9471
2020-09-30,Germany,DE,1798,17,83019213,Europe,289219,9488
2020-10-01,Germany,DE,2503,12,83019213,Europe,291722,9500
2020-10-02,Germany,DE,2673,8,83019213,Europe,294395,9508
2020-10-03,Germany,DE,2563,19,83019213,Europe,296958,9527
2020-10-04,Germany,DE,2279,2,83019213,Europe,299237,9529
2020-10-05,Germany,DE,1382,5,83019213,Europe,300619,9534
2020-10-06,Germany,DE,2639,12,83019213,Europe,303258,9546
2020-10-07,Germany,DE,2828,16,83019213,Europe,306086,9562
2020-10-08,Germany,DE,4058,16,83019213,Europe,310144,9578
2020-10-09,Germany,DE,4516,11,83019213,Europe,314660,9589
2020-10-10,Germany,DE,4721,15,83019213,Europe,319381,9604
2020-10-11,Germany,DE,3483,11,83019213,Europe,322864,9615
2020-10-12,Germany,DE,2467,6,83019213,Europe,325331,9621
2020-10-13,Germany,DE,4122,13,83019213,Europe,329453,9634
2020-10-14,Germany,DE,5132,43,83019213,Europe,334585,9677
2020-10-15,Germany,DE,6638,33,83019213,Europe,341223,9710
2020-10-16,Germany,DE,7334,24,83019213,Europe,348557,9734
2020-10-17,Germany,DE,7830,33,83019213,Europe,356387,9767
2020-10-18,Germany,DE,5587,10,83019213,Europe,361974,9777
2020-10-19,Germany,DE,4325,12,83019213,Europe,366299,9789
2020-10-20,Germany,DE,6868,47,83019213,Europe,373167,9836
2020-10-21,Germany,DE,7595,39,83019213,Europe,380762,9875
2020-10-22,Germany,DE,11287,30,83019213,Europe,392049,9905
2020-10-23,Germany,DE,11242,49,83019213,Europe,403291,9954
2020-10-24,Germany,DE,14714,49,83019213,Europe,418005,10003
2020-10-25,Germany,DE,11176,29,83019213,Europe,429181,10032
2020-10-26,Germany,DE,8685,24,83019213,Europe,437866,10056
2020-10-27,Germany,DE,11409,42,83019213,Europe,449275,10098
2020-10-28,Germany,DE,14964,85,83019213,Europe,464239,10183
2020-10-29,Germany,DE,16774,89,83019213,Europe,481013,10272
2020-10-30,Germany,DE,18681,77,83019213,Europe,499694,10349
2020-10-31,Germany,DE,19059,103,83019213,Europe,518753,10452
2020-11-01,Germany,DE,14177,29,83019213,Europe,532930,10481
2020-11-02,Germany,DE,12097,49,83019213,Europe,545027,10530
2020-11-03,Germany,DE,15352,131,83019213,Europe,560379,10661
2020-11-04,Germany,DE,17214,151,83019213,Europe,577593,10812
2020-11-05,Germany,DE,19990,118,83019213,Europe,597583,10930
2020-11-06,Germany,DE,21506,166,83019213,Europe,619089,11096
2020-11-07,Germany,DE,23399,130,83019213,Europe,642488,11226
2020-11-08,Germany,DE,16017,63,83019213,Europe,658505,11289
2020-11-09,Germany,DE,13363,63,83019213,Europe,671868,11352
2020-11-10,Germany,DE,15332,154,83019213,Europe,687200,11506
2020-11-11,Germany,DE,18487,261,83019213,Europe,705687,11767
2020-11-12,Germany,DE,21866,215,83019213,Europe,727553,11982
2020-11-13,Germany,DE,23542,218,83019213,Europe,751095,12200
2020-11-14,Germany,DE,22461,178,83019213,Europe,773556,12378
2020-11-15,Germany,DE,16947,107,83019213,Europe,790503,12485
2020-11-16,Germany,DE,10824,62,83019213,Europe,801327,12547
2020-11-17,Germany,DE,14419,267,83019213,Europe,815746,12814
2020-11-18,Germany,DE,17561,305,83019213,Europe,833307,13119
2020-11-19,Germany,DE,22609,251,83019213,Europe,855916,13370
2020-11-20,Germany,DE,23648,260,83019213,Europe,879564,13630
2020-11-21,Germany,DE,22964,254,83019213,Europe,902528,13884
2020-11-22,Germany,DE,15741,138,83019213,Europe,918269,14022
2020-11-23,Germany,DE,10864,90,83019213,Europe,929133,14112
2020-11-24,Germany,DE,13554,249,83019213,Europe,942687,14361
2020-11-25,Germany,DE,18633,410,83019213,Europe,961320,14771
2020-11-26,Germany,DE,22268,389,83019213,Europe,983588,15160
2020-11-27,Germany,DE,22806,426,83019213,Europe,1006394,15586
2020-11-28,Germany,DE,21695,379,83019213,Europe,1028089,15965
2020-11-29,Germany,DE,14611,158,83019213,Europe,1042700,16123
2020-11-30,Germany,DE,11169,125,83019213,Europe,1053869,16248
2020-12-01,Germany,DE,13604,388,83019213,Europe,1067473,16636
2020-12-02,Germany,DE,17270,487,83019213,Europe,1084743,17123
2020-12-03,Germany,DE,22046,479,83019213,Europe,1106789,17602
2020-12-04,Germany,DE,23448,432,83019213,Europe,1130237,18034
2020-12-05,Germany,DE,23318,483,83019213,Europe,1153555,18517
2020-12-06,Germany,DE,17767,255,83019213,Europe,1171322,18772
2020-12-07,Germany,DE,12332,147,83019213,Europe,1183654,18919
2020-12-08,Germany,DE,14055,423,83019213,Europe,1197709,19342
2020-12-09,Germany,DE,20815,590,83019213,Europe,1218524,19932
2020-12-10,Germany,DE,23679,440,83019213,Europe,1242203,20372
2020-12-11,Germany,DE,29875,598,83019213,Europe,1272078,20970
2020-12-12,Germany,DE,28438,496,83019213,Europe,1300516,21466
2020-12-13,Germany,DE,20200,321,83019213,Europe,1320716,21787
2020-12-14,Germany,DE,16362,188,83019213,Europe,1337078,21975
2020-03-19,Djibouti,DJ,1,0,973557,Africa,1,0
2020-03-20,Djibouti,DJ,0,0,973557,Africa,1,0
2020-03-21,Djibouti,DJ,0,0,973557,Africa,1,0
2020-03-22,Djibouti,DJ,0,0,973557,Africa,1,0
2020-03-23,Djibouti,DJ,0,0,973557,Africa,1,0
2020-03-24,Djibouti,DJ,2,0,973557,Africa,3,0
2020-03-25,Djibouti,DJ,0,0,973557,Africa,3,0
2020-03-26,Djibouti,DJ,9,0,973557,Africa,12,0
2020-03-27,Djibouti,DJ,0,0,973557,Africa,12,0
2020-03-28,Djibouti,DJ,1,0,973557,Africa,13,0
2020-03-29,Djibouti,DJ,2,0,973557,Africa,15,0
2020-03-30,Djibouti,DJ,4,0,973557,Africa,19,0
2020-03-31,Djibouti,DJ,7,0,973557,Africa,26,0
2020-04-01,Djibouti,DJ,5,0,973557,Africa,31,0
2020-04-02,Djibouti,DJ,3,0,973557,Africa,34,0
2020-04-03,Djibouti,DJ,7,0,973557,Africa,41,0
2020-04-04,Djibouti,DJ,0,0,973557,Africa,41,0
2020-04-05,Djibouti,DJ,10,0,973557,Africa,51,0
2020-04-06,Djibouti,DJ,8,0,973557,Africa,59,0
2020-04-07,Djibouti,DJ,31,0,973557,Africa,90,0
2020-04-08,Djibouti,DJ,31,0,973557,Africa,121,0
2020-04-09,Djibouti,DJ,14,0,973557,Africa,135,0
2020-04-10,Djibouti,DJ,5,1,973557,Africa,140,1
2020-04-11,Djibouti,DJ,10,0,973557,Africa,150,1
2020-04-12,Djibouti,DJ,37,1,973557,Africa,187,2
2020-04-13,Djibouti,DJ,27,0,973557,Africa,214,2
2020-04-14,Djibouti,DJ,84,0,973557,Africa,298,2
2020-04-15,Djibouti,DJ,65,0,973557,Africa,363,2
2020-04-16,Djibouti,DJ,72,0,973557,Africa,435,2
2020-04-17,Djibouti,DJ,156,0,973557,Africa,591,2
2020-04-18,Djibouti,DJ,141,0,973557,Africa,732,2
2020-04-19,Djibouti,DJ,0,0,973557,Africa,732,2
2020-04-20,Djibouti,DJ,114,0,973557,Africa,846,2
2020-04-21,Djibouti,DJ,0,0,973557,Africa,846,2
2020-04-22,Djibouti,DJ,99,0,973557,Africa,945,2
2020-04-23,Djibouti,DJ,29,0,973557,Africa,974,2
2020-04-24,Djibouti,DJ,12,0,973557,Africa,986,2
2020-04-25,Djibouti,DJ,13,0,973557,Africa,999,2
2020-04-26,Djibouti,DJ,9,0,973557,Africa,1008,2
2020-04-27,Djibouti,DJ,15,0,973557,Africa,1023,2
2020-04-28,Djibouti,DJ,12,0,973557,Africa,1035,2
2020-04-29,Djibouti,DJ,37,0,973557,Africa,1072,2
2020-04-30,Djibouti,DJ,5,0,973557,Africa,1077,2
2020-05-01,Djibouti,DJ,12,0,973557,Africa,1089,2
2020-05-02,Djibouti,DJ,8,0,973557,Africa,1097,2
2020-05-03,Djibouti,DJ,15,0,973557,Africa,1112,2
2020-05-04,Djibouti,DJ,0,0,973557,Africa,1112,2
2020-05-05,Djibouti,DJ,4,0,973557,Africa,1116,2
2020-05-06,Djibouti,DJ,4,0,973557,Africa,1120,2
2020-05-07,Djibouti,DJ,0,1,973557,Africa,1120,3
2020-05-08,Djibouti,DJ,13,0,973557,Africa,1133,3
2020-05-09,Djibouti,DJ,2,0,973557,Africa,1135,3
2020-05-10,Djibouti,DJ,54,0,973557,Africa,1189,3
2020-05-11,Djibouti,DJ,21,0,973557,Africa,1210,3
2020-05-12,Djibouti,DJ,17,0,973557,Africa,1227,3
2020-05-13,Djibouti,DJ,29,0,973557,Africa,1256,3
2020-05-14,Djibouti,DJ,12,0,973557,Africa,1268,3
2020-05-15,Djibouti,DJ,16,0,973557,Africa,1284,3
2020-05-16,Djibouti,DJ,25,1,973557,Africa,1309,4
2020-05-17,Djibouti,DJ,22,0,973557,Africa,1331,4
2020-05-18,Djibouti,DJ,70,0,973557,Africa,1401,4
2020-05-19,Djibouti,DJ,117,3,973557,Africa,1518,7
2020-05-20,Djibouti,DJ,0,0,973557,Africa,1518,7
2020-05-21,Djibouti,DJ,310,2,973557,Africa,1828,9
2020-05-22,Djibouti,DJ,219,1,973557,Africa,2047,10
2020-05-23,Djibouti,DJ,223,0,973557,Africa,2270,10
2020-05-24,Djibouti,DJ,0,0,973557,Africa,2270,10
2020-05-25,Djibouti,DJ,0,0,973557,Africa,2270,10
2020-05-26,Djibouti,DJ,198,4,973557,Africa,2468,14
2020-05-27,Djibouti,DJ,0,0,973557,Africa,2468,14
2020-05-28,Djibouti,DJ,229,4,973557,Africa,2697,18
2020-05-29,Djibouti,DJ,217,2,973557,Africa,2914,20
2020-05-30,Djibouti,DJ,0,0,973557,Africa,2914,20
2020-05-31,Djibouti,DJ,280,2,973557,Africa,3194,22
2020-06-01,Djibouti,DJ,160,2,973557,Africa,3354,24
2020-06-02,Djibouti,DJ,215,0,973557,Africa,3569,24
2020-06-03,Djibouti,DJ,210,1,973557,Africa,3779,25
2020-06-04,Djibouti,DJ,156,1,973557,Africa,3935,26
2020-06-05,Djibouti,DJ,119,0,973557,Africa,4054,26
2020-06-06,Djibouti,DJ,69,0,973557,Africa,4123,26
2020-06-07,Djibouti,DJ,46,0,973557,Africa,4169,26
2020-06-08,Djibouti,DJ,38,2,973557,Africa,4207,28
2020-06-09,Djibouti,DJ,71,3,973557,Africa,4278,31
2020-06-10,Djibouti,DJ,53,3,973557,Africa,4331,34
2020-06-11,Djibouti,DJ,42,0,973557,Africa,4373,34
2020-06-12,Djibouti,DJ,25,3,973557,Africa,4398,37
2020-06-13,Djibouti,DJ,43,1,973557,Africa,4441,38
2020-06-14,Djibouti,DJ,8,3,973557,Africa,4449,41
2020-06-15,Djibouti,DJ,16,2,973557,Africa,4465,43
2020-06-16,Djibouti,DJ,36,0,973557,Africa,4501,43
2020-06-17,Djibouti,DJ,38,0,973557,Africa,4539,43
2020-06-18,Djibouti,DJ,6,0,973557,Africa,4545,43
2020-06-19,Djibouti,DJ,12,0,973557,Africa,4557,43
2020-06-20,Djibouti,DJ,8,2,973557,Africa,4565,45
2020-06-21,Djibouti,DJ,0,0,973557,Africa,4565,45
2020-06-22,Djibouti,DJ,17,0,973557,Africa,4582,45
2020-06-23,Djibouti,DJ,17,3,973557,Africa,4599,48
2020-06-24,Djibouti,DJ,18,1,973557,Africa,4617,49
2020-06-25,Djibouti,DJ,13,3,973557,Africa,4630,52
2020-06-26,Djibouti,DJ,5,0,973557,Africa,4635,52
2020-06-27,Djibouti,DJ,8,0,973557,Africa,4643,52
2020-06-28,Djibouti,DJ,0,0,973557,Africa,4643,52
2020-06-29,Djibouti,DJ,0,0,973557,Africa,4643,52
2020-06-30,Djibouti,DJ,13,1,973557,Africa,4656,53
2020-07-01,Djibouti,DJ,26,1,973557,Africa,4682,54
2020-07-02,Djibouti,DJ,22,1,973557,Africa,4704,55
2020-07-03,Djibouti,DJ,11,0,973557,Africa,4715,55
2020-07-04,Djibouti,DJ,21,0,973557,Africa,4736,55
2020-07-05,Djibouti,DJ,0,0,973557,Africa,4736,55
2020-07-06,Djibouti,DJ,56,0,973557,Africa,4792,55
2020-07-07,Djibouti,DJ,30,0,973557,Africa,4822,55
2020-07-08,Djibouti,DJ,56,0,973557,Africa,4878,55
2020-07-09,Djibouti,DJ,11,0,973557,Africa,4889,55
2020-07-10,Djibouti,DJ,66,1,973557,Africa,4955,56
2020-07-11,Djibouti,DJ,0,0,973557,Africa,4955,56
2020-07-12,Djibouti,DJ,0,0,973557,Africa,4955,56
2020-07-13,Djibouti,DJ,17,0,973557,Africa,4972,56
2020-07-14,Djibouti,DJ,5,0,973557,Africa,4977,56
2020-07-15,Djibouti,DJ,2,0,973557,Africa,4979,56
2020-07-16,Djibouti,DJ,6,0,973557,Africa,4985,56
2020-07-17,Djibouti,DJ,8,0,973557,Africa,4993,56
2020-07-18,Djibouti,DJ,10,0,973557,Africa,5003,56
2020-07-19,Djibouti,DJ,0,0,973557,Africa,5003,56
2020-07-20,Djibouti,DJ,8,0,973557,Africa,5011,56
2020-07-21,Djibouti,DJ,9,0,973557,Africa,5020,56
2020-07-22,Djibouti,DJ,7,0,973557,Africa,5027,56
2020-07-23,Djibouti,DJ,3,2,973557,Africa,5030,58
2020-07-24,Djibouti,DJ,1,0,973557,Africa,5031,58
2020-07-25,Djibouti,DJ,8,0,973557,Africa,5039,58
2020-07-26,Djibouti,DJ,0,0,973557,Africa,5039,58
2020-07-27,Djibouti,DJ,11,0,973557,Africa,5050,58
2020-07-28,Djibouti,DJ,9,0,973557,Africa,5059,58
2020-07-29,Djibouti,DJ,9,0,973557,Africa,5068,58
2020-07-30,Djibouti,DJ,13,0,973557,Africa,5081,58
2020-07-31,Djibouti,DJ,0,0,973557,Africa,5081,58
2020-08-01,Djibouti,DJ,0,0,973557,Africa,5081,58
2020-08-02,Djibouti,DJ,0,0,973557,Africa,5081,58
2020-08-03,Djibouti,DJ,80,1,973557,Africa,5161,59
2020-08-04,Djibouti,DJ,79,0,973557,Africa,5240,59
2020-08-05,Djibouti,DJ,8,0,973557,Africa,5248,59
2020-08-06,Djibouti,DJ,82,0,973557,Africa,5330,59
2020-08-07,Djibouti,DJ,4,0,973557,Africa,5334,59
2020-08-08,Djibouti,DJ,4,0,973557,Africa,5338,59
2020-08-09,Djibouti,DJ,0,0,973557,Africa,5338,59
2020-08-10,Djibouti,DJ,6,0,973557,Africa,5344,59
2020-08-11,Djibouti,DJ,3,0,973557,Africa,5347,59
2020-08-12,Djibouti,DJ,1,0,973557,Africa,5348,59
2020-08-13,Djibouti,DJ,10,0,973557,Africa,5358,59
2020-08-14,Djibouti,DJ,0,0,973557,Africa,5358,59
2020-08-15,Djibouti,DJ,9,0,973557,Africa,5367,59
2020-08-16,Djibouti,DJ,0,0,973557,Africa,5367,59
2020-08-17,Djibouti,DJ,2,0,973557,Africa,5369,59
2020-08-18,Djibouti,DJ,3,0,973557,Africa,5372,59
2020-08-19,Djibouti,DJ,2,0,973557,Africa,5374,59
2020-08-20,Djibouti,DJ,0,0,973557,Africa,5374,59
2020-08-21,Djibouti,DJ,0,0,973557,Africa,5374,59
2020-08-22,Djibouti,DJ,8,1,973557,Africa,5382,60
2020-08-23,Djibouti,DJ,0,0,973557,Africa,5382,60
2020-08-24,Djibouti,DJ,0,0,973557,Africa,5382,60
2020-08-25,Djibouti,DJ,1,0,973557,Africa,5383,60
2020-08-26,Djibouti,DJ,0,0,973557,Africa,5383,60
2020-08-27,Djibouti,DJ,0,0,973557,Africa,5383,60
2020-08-28,Djibouti,DJ,0,0,973557,Africa,5383,60
2020-08-29,Djibouti,DJ,0,0,973557,Africa,5383,60
2020-08-30,Djibouti,DJ,2,0,973557,Africa,5385,60
2020-08-31,Djibouti,DJ,0,0,973557,Africa,5385,60
2020-09-01,Djibouti,DJ,2,0,973557,Africa,5387,60
2020-09-02,Djibouti,DJ,0,0,973557,Africa,5387,60
2020-09-03,Djibouti,DJ,0,0,973557,Africa,5387,60
2020-09-04,Djibouti,DJ,0,0,973557,Africa,5387,60
2020-09-05,Djibouti,DJ,0,0,973557,Africa,5387,60
2020-09-06,Djibouti,DJ,0,0,973557,Africa,5387,60
2020-09-07,Djibouti,DJ,1,1,973557,Africa,5388,61
2020-09-08,Djibouti,DJ,0,0,973557,Africa,5388,61
2020-09-09,Djibouti,DJ,0,0,973557,Africa,5388,61
2020-09-10,Djibouti,DJ,3,0,973557,Africa,5391,61
2020-09-11,Djibouti,DJ,3,0,973557,Africa,5394,61
2020-09-12,Djibouti,DJ,0,0,973557,Africa,5394,61
2020-09-13,Djibouti,DJ,0,0,973557,Africa,5394,61
2020-09-14,Djibouti,DJ,1,0,973557,Africa,5395,61
2020-09-15,Djibouti,DJ,1,0,973557,Africa,5396,61
2020-09-16,Djibouti,DJ,0,0,973557,Africa,5396,61
2020-09-17,Djibouti,DJ,3,0,973557,Africa,5399,61
2020-09-18,Djibouti,DJ,2,0,973557,Africa,5401,61
2020-09-19,Djibouti,DJ,2,0,973557,Africa,5403,61
2020-09-20,Djibouti,DJ,0,0,973557,Africa,5403,61
2020-09-21,Djibouti,DJ,0,0,973557,Africa,5403,61
2020-09-22,Djibouti,DJ,1,0,973557,Africa,5404,61
2020-09-23,Djibouti,DJ,3,0,973557,Africa,5407,61
2020-09-24,Djibouti,DJ,0,0,973557,Africa,5407,61
2020-09-25,Djibouti,DJ,0,0,973557,Africa,5407,61
2020-09-26,Djibouti,DJ,2,0,973557,Africa,5409,61
2020-09-27,Djibouti,DJ,0,0,973557,Africa,5409,61
2020-09-28,Djibouti,DJ,0,0,973557,Africa,5409,61
2020-09-29,Djibouti,DJ,1,0,973557,Africa,5410,61
2020-09-30,Djibouti,DJ,6,0,973557,Africa,5416,61
2020-10-01,Djibouti,DJ,0,0,973557,Africa,5416,61
2020-10-02,Djibouti,DJ,1,0,973557,Africa,5417,61
2020-10-03,Djibouti,DJ,0,0,973557,Africa,5417,61
2020-10-04,Djibouti,DJ,1,0,973557,Africa,5418,61
2020-10-05,Djibouti,DJ,1,0,973557,Africa,5419,61
2020-10-06,Djibouti,DJ,2,0,973557,Africa,5421,61
2020-10-07,Djibouti,DJ,2,0,973557,Africa,5423,61
2020-10-08,Djibouti,DJ,0,0,973557,Africa,5423,61
2020-10-09,Djibouti,DJ,0,0,973557,Africa,5423,61
2020-10-10,Djibouti,DJ,0,0,973557,Africa,5423,61
2020-10-11,Djibouti,DJ,0,0,973557,Africa,5423,61
2020-10-12,Djibouti,DJ,0,0,973557,Africa,5423,61
2020-10-13,Djibouti,DJ,3,0,973557,Africa,5426,61
2020-10-14,Djibouti,DJ,2,0,973557,Africa,5428,61
2020-10-15,Djibouti,DJ,12,0,973557,Africa,5440,61
2020-10-16,Djibouti,DJ,3,0,973557,Africa,5443,61
2020-10-17,Djibouti,DJ,6,0,973557,Africa,5449,61
2020-10-18,Djibouti,DJ,3,0,973557,Africa,5452,61
2020-10-19,Djibouti,DJ,7,0,973557,Africa,5459,61
2020-10-20,Djibouti,DJ,10,0,973557,Africa,5469,61
2020-10-21,Djibouti,DJ,30,0,973557,Africa,5499,61
2020-10-22,Djibouti,DJ,13,0,973557,Africa,5512,61
2020-10-23,Djibouti,DJ,10,0,973557,Africa,5522,61
2020-10-24,Djibouti,DJ,6,0,973557,Africa,5528,61
2020-10-25,Djibouti,DJ,2,0,973557,Africa,5530,61
2020-10-26,Djibouti,DJ,6,0,973557,Africa,5536,61
2020-10-27,Djibouti,DJ,5,0,973557,Africa,5541,61
2020-10-28,Djibouti,DJ,3,0,973557,Africa,5544,61
2020-10-29,Djibouti,DJ,11,0,973557,Africa,5555,61
2020-10-30,Djibouti,DJ,3,0,973557,Africa,5558,61
2020-10-31,Djibouti,DJ,1,0,973557,Africa,5559,61
2020-11-01,Djibouti,DJ,2,0,973557,Africa,5561,61
2020-11-02,Djibouti,DJ,2,0,973557,Africa,5563,61
2020-11-03,Djibouti,DJ,10,0,973557,Africa,5573,61
2020-11-04,Djibouti,DJ,2,0,973557,Africa,5575,61
2020-11-05,Djibouti,DJ,5,0,973557,Africa,5580,61
2020-11-06,Djibouti,DJ,19,0,973557,Africa,5599,61
2020-11-07,Djibouti,DJ,5,0,973557,Africa,5604,61
2020-11-08,Djibouti,DJ,1,0,973557,Africa,5605,61
2020-11-09,Djibouti,DJ,3,0,973557,Africa,5608,61
2020-11-10,Djibouti,DJ,19,0,973557,Africa,5627,61
2020-11-11,Djibouti,DJ,6,0,973557,Africa,5633,61
2020-11-12,Djibouti,DJ,2,0,973557,Africa,5635,61
2020-11-13,Djibouti,DJ,6,0,973557,Africa,5641,61
2020-11-14,Djibouti,DJ,3,0,973557,Africa,5644,61
2020-11-15,Djibouti,DJ,1,0,973557,Africa,5645,61
2020-11-16,Djibouti,DJ,4,0,973557,Africa,5649,61
2020-11-17,Djibouti,DJ,6,0,973557,Africa,5655,61
2020-11-18,Djibouti,DJ,1,0,973557,Africa,5656,61
2020-11-19,Djibouti,DJ,2,0,973557,Africa,5658,61
2020-11-20,Djibouti,DJ,0,0,973557,Africa,5658,61
2020-11-21,Djibouti,DJ,2,0,973557,Africa,5660,61
2020-11-22,Djibouti,DJ,1,0,973557,Africa,5661,61
2020-11-23,Djibouti,DJ,7,0,973557,Africa,5668,61
2020-11-24,Djibouti,DJ,0,0,973557,Africa,5668,61
2020-11-25,Djibouti,DJ,1,0,973557,Africa,5669,61
2020-11-26,Djibouti,DJ,1,0,973557,Africa,5670,61
2020-11-27,Djibouti,DJ,6,0,973557,Africa,5676,61
2020-11-28,Djibouti,DJ,0,0,973557,Africa,5676,61
2020-11-29,Djibouti,DJ,0,0,973557,Africa,5676,61
2020-11-30,Djibouti,DJ,1,0,973557,Africa,5677,61
2020-12-01,Djibouti,DJ,2,0,973557,Africa,5679,61
2020-12-02,Djibouti,DJ,1,0,973557,Africa,5680,61
2020-12-03,Djibouti,DJ,2,0,973557,Africa,5682,61
2020-12-04,Djibouti,DJ,7,0,973557,Africa,5689,61
2020-12-05,Djibouti,DJ,1,0,973557,Africa,5690,61
2020-12-06,Djibouti,DJ,2,0,973557,Africa,5692,61
2020-12-07,Djibouti,DJ,9,0,973557,Africa,5701,61
2020-12-08,Djibouti,DJ,7,0,973557,Africa,5708,61
2020-12-09,Djibouti,DJ,6,0,973557,Africa,5714,61
2020-12-10,Djibouti,DJ,3,0,973557,Africa,5717,61
2020-12-11,Djibouti,DJ,0,0,973557,Africa,5717,61
2020-12-12,Djibouti,DJ,4,0,973557,Africa,5721,61
2020-12-13,Djibouti,DJ,4,0,973557,Africa,5725,61
2020-12-14,Djibouti,DJ,3,0,973557,Africa,5728,61
2019-12-31,Denmark,DK,0,0,5806081,Europe,0,0
2020-01-01,Denmark,DK,0,0,5806081,Europe,0,0
2020-01-02,Denmark,DK,0,0,5806081,Europe,0,0
2020-01-03,Denmark,DK,0,0,5806081,Europe,0,0
2020-01-04,Denmark,DK,0,0,5806081,Europe,0,0
2020-01-05,Denmark,DK,0,0,5806081,Europe,0,0
2020-01-06,Denmark,DK,0,0,5806081,Europe,0,0
2020-01-07,Denmark,DK,0,0,5806081,Europe,0,0
2020-01-08,Denmark,DK,0,0,5806081,Europe,0,0
2020-01-09,Denmark,DK,0,0,5806081,Europe,0,0
2020-01-10,Denmark,DK,0,0,5806081,Europe,0,0
2020-01-11,Denmark,DK,0,0,5806081,Europe,0,0
2020-01-12,Denmark,DK,0,0,5806081,Europe,0,0
2020-01-13,Denmark,DK,0,0,5806081,Europe,0,0
2020-01-14,Denmark,DK,0,0,5806081,Europe,0,0
2020-01-15,Denmark,DK,0,0,5806081,Europe,0,0
2020-01-16,Denmark,DK,0,0,5806081,Europe,0,0
2020-01-17,Denmark,DK,0,0,5806081,Europe,0,0
2020-01-18,Denmark,DK,0,0,5806081,Europe,0,0
2020-01-19,Denmark,DK,0,0,5806081,Europe,0,0
2020-01-20,Denmark,DK,0,0,5806081,Europe,0,0
2020-01-21,Denmark,DK,0,0,5806081,Europe,0,0
2020-01-22,Denmark,DK,0,0,5806081,Europe,0,0
2020-01-23,Denmark,DK,0,0,5806081,Europe,0,0
2020-01-24,Denmark,DK,0,0,5806081,Europe,0,0
2020-01-25,Denmark,DK,0,0,5806081,Europe,0,0
2020-01-26,Denmark,DK,0,0,5806081,Europe,0,0
2020-01-27,Denmark,DK,0,0,5806081,Europe,0,0
2020-01-28,Denmark,DK,0,0,5806081,Europe,0,0
2020-01-29,Denmark,DK,0,0,5806081,Europe,0,0
2020-01-30,Denmark,DK,0,0,5806081,Europe,0,0
2020-01-31,Denmark,DK,0,0,5806081,Europe,0,0
2020-02-01,Denmark,DK,0,0,5806081,Europe,0,0
2020-02-02,Denmark,DK,0,0,5806081,Europe,0,0
2020-02-03,Denmark,DK,0,0,5806081,Europe,0,0
2020-02-04,Denmark,DK,0,0,5806081,Europe,0,0
2020-02-05,Denmark,DK,0,0,5806081,Europe,0,0
2020-02-06,Denmark,DK,0,0,5806081,Europe,0,0
2020-02-07,Denmark,DK,0,0,5806081,Europe,0,0
2020-02-08,Denmark,DK,0,0,5806081,Europe,0,0
2020-02-09,Denmark,DK,0,0,5806081,Europe,0,0
2020-02-10,Denmark,DK,0,0,5806081,Europe,0,0
2020-02-11,Denmark,DK,0,0,5806081,Europe,0,0
2020-02-12,Denmark,DK,0,0,5806081,Europe,0,0
2020-02-13,Denmark,DK,0,0,5806081,Europe,0,0
2020-02-14,Denmark,DK,0,0,5806081,Europe,0,0
2020-02-15,Denmark,DK,0,0,5806081,Europe,0,0
2020-02-16,Denmark,DK,0,0,5806081,Europe,0,0
2020-02-17,Denmark,DK,0,0,5806081,Europe,0,0
2020-02-18,Denmark,DK,0,0,5806081,Europe,0,0
2020-02-19,Denmark,DK,0,0,5806081,Europe,0,0
2020-02-20,Denmark,DK,0,0,5806081,Europe,0,0
2020-02-21,Denmark,DK,0,0,5806081,Europe,0,0
2020-02-22,Denmark,DK,0,0,5806081,Europe,0,0
2020-02-23,Denmark,DK,0,0,5806081,Europe,0,0
2020-02-24,Denmark,DK,0,0,5806081,Europe,0,0
2020-02-25,Denmark,DK,0,0,5806081,Europe,0,0
2020-02-26,Denmark,DK,0,0,5806081,Europe,0,0
2020-02-27,Denmark,DK,1,0,5806081,Europe,1,0
2020-02-28,Denmark,DK,0,0,5806081,Europe,1,0
2020-02-29,Denmark,DK,1,0,5806081,Europe,2,0
2020-03-01,Denmark,DK,1,0,5806081,Europe,3,0
2020-03-02,Denmark,DK,1,0,5806081,Europe,4,0
2020-03-03,Denmark,DK,1,0,5806081,Europe,5,0
2020-03-04,Denmark,DK,3,0,5806081,Europe,8,0
2020-03-05,Denmark,DK,2,0,5806081,Europe,10,0
2020-03-06,Denmark,DK,10,0,5806081,Europe,20,0
2020-03-07,Denmark,DK,3,0,5806081,Europe,23,0
2020-03-08,Denmark,DK,8,0,5806081,Europe,31,0
2020-03-09,Denmark,DK,7,0,5806081,Europe,38,0
2020-03-10,Denmark,DK,75,0,5806081,Europe,113,0
2020-03-11,Denmark,DK,151,0,5806081,Europe,264,0
2020-03-12,Denmark,DK,252,0,5806081,Europe,516,0
2020-03-13,Denmark,DK,160,0,5806081,Europe,676,0
2020-03-14,Denmark,DK,128,0,5806081,Europe,804,0
2020-03-15,Denmark,DK,23,0,5806081,Europe,827,0
2020-03-16,Denmark,DK,48,1,5806081,Europe,875,1
2020-03-17,Denmark,DK,57,0,5806081,Europe,932,1
2020-03-18,Denmark,DK,92,3,5806081,Europe,1024,4
2020-03-19,Denmark,DK,91,0,5806081,Europe,1115,4
2020-03-20,Denmark,DK,36,2,5806081,Europe,1151,6
2020-03-21,Denmark,DK,104,3,5806081,Europe,1255,9
2020-03-22,Denmark,DK,71,4,5806081,Europe,1326,13
2020-03-23,Denmark,DK,69,0,5806081,Europe,1395,13
2020-03-24,Denmark,DK,65,11,5806081,Europe,1460,24
2020-03-25,Denmark,DK,131,8,5806081,Europe,1591,32
2020-03-26,Denmark,DK,133,2,5806081,Europe,1724,34
2020-03-27,Denmark,DK,153,7,5806081,Europe,1877,41
2020-03-28,Denmark,DK,169,11,5806081,Europe,2046,52
2020-03-29,Denmark,DK,155,13,5806081,Europe,2201,65
2020-03-30,Denmark,DK,194,7,5806081,Europe,2395,72
2020-03-31,Denmark,DK,182,5,5806081,Europe,2577,77
2020-04-01,Denmark,DK,283,13,5806081,Europe,2860,90
2020-04-02,Denmark,DK,247,14,5806081,Europe,3107,104
2020-04-03,Denmark,DK,279,19,5806081,Europe,3386,123
2020-04-04,Denmark,DK,371,16,5806081,Europe,3757,139
2020-04-05,Denmark,DK,320,22,5806081,Europe,4077,161
2020-04-06,Denmark,DK,292,18,5806081,Europe,4369,179
2020-04-07,Denmark,DK,312,8,5806081,Europe,4681,187
2020-04-08,Denmark,DK,390,16,5806081,Europe,5071,203
2020-04-09,Denmark,DK,331,15,5806081,Europe,5402,218
2020-04-10,Denmark,DK,233,19,5806081,Europe,5635,237
2020-04-11,Denmark,DK,184,10,5806081,Europe,5819,247
2020-04-12,Denmark,DK,177,13,5806081,Europe,5996,260
2020-04-13,Denmark,DK,178,13,5806081,Europe,6174,273
2020-04-14,Denmark,DK,144,12,5806081,Europe,6318,285
2020-04-15,Denmark,DK,193,14,5806081,Europe,6511,299
2020-04-16,Denmark,DK,170,10,5806081,Europe,6681,309
2020-04-17,Denmark,DK,198,12,5806081,Europe,6879,321
2020-04-18,Denmark,DK,194,15,5806081,Europe,7073,336
2020-04-19,Denmark,DK,169,10,5806081,Europe,7242,346
2020-04-20,Denmark,DK,142,9,5806081,Europe,7384,355
2020-04-21,Denmark,DK,131,9,5806081,Europe,7515,364
2020-04-22,Denmark,DK,180,6,5806081,Europe,7695,370
2020-04-23,Denmark,DK,217,14,5806081,Europe,7912,384
2020-04-24,Denmark,DK,161,10,5806081,Europe,8073,394
2020-04-25,Denmark,DK,137,9,5806081,Europe,8210,403
2020-04-26,Denmark,DK,235,15,5806081,Europe,8445,418
2020-04-27,Denmark,DK,130,4,5806081,Europe,8575,422
2020-04-28,Denmark,DK,123,5,5806081,Europe,8698,427
2020-04-29,Denmark,DK,153,7,5806081,Europe,8851,434
2020-04-30,Denmark,DK,157,9,5806081,Europe,9008,443
2020-05-01,Denmark,DK,150,9,5806081,Europe,9158,452
2020-05-02,Denmark,DK,153,10,5806081,Europe,9311,462
2020-05-03,Denmark,DK,96,11,5806081,Europe,9407,473
2020-05-04,Denmark,DK,116,8,5806081,Europe,9523,481
2020-05-05,Denmark,DK,147,9,5806081,Europe,9670,490
2020-05-06,Denmark,DK,151,7,5806081,Europe,9821,497
2020-05-07,Denmark,DK,162,3,5806081,Europe,9983,500
2020-05-08,Denmark,DK,100,6,5806081,Europe,10083,506
2020-05-09,Denmark,DK,135,6,5806081,Europe,10218,512
2020-05-10,Denmark,DK,101,4,5806081,Europe,10319,516
2020-05-11,Denmark,DK,110,3,5806081,Europe,10429,519
2020-05-12,Denmark,DK,84,5,5806081,Europe,10513,524
2020-05-13,Denmark,DK,78,4,5806081,Europe,10591,528
2020-05-14,Denmark,DK,76,6,5806081,Europe,10667,534
2020-05-15,Denmark,DK,46,4,5806081,Europe,10713,538
2020-05-16,Denmark,DK,78,0,5806081,Europe,10791,538
2020-05-17,Denmark,DK,67,5,5806081,Europe,10858,543
2020-05-18,Denmark,DK,69,4,5806081,Europe,10927,547
2020-05-19,Denmark,DK,41,1,5806081,Europe,10968,548
2020-05-20,Denmark,DK,76,3,5806081,Europe,11044,551
2020-05-21,Denmark,DK,73,3,5806081,Europe,11117,554
2020-05-22,Denmark,DK,65,7,5806081,Europe,11182,561
2020-05-23,Denmark,DK,48,0,5806081,Europe,11230,561
2020-05-24,Denmark,DK,59,0,5806081,Europe,11289,561
2020-05-25,Denmark,DK,71,1,5806081,Europe,11360,562
2020-05-26,Denmark,DK,27,1,5806081,Europe,11387,563
2020-05-27,Denmark,DK,41,0,5806081,Europe,11428,563
2020-05-28,Denmark,DK,52,2,5806081,Europe,11480,565
2020-05-29,Denmark,DK,32,3,5806081,Europe,11512,568
2020-05-30,Denmark,DK,81,0,5806081,Europe,11593,568
2020-05-31,Denmark,DK,40,3,5806081,Europe,11633,571
2020-06-01,Denmark,DK,36,3,5806081,Europe,11669,574
2020-06-02,Denmark,DK,30,2,5806081,Europe,11699,576
2020-06-03,Denmark,DK,35,4,5806081,Europe,11734,580
2020-06-04,Denmark,DK,37,0,5806081,Europe,11771,580
2020-06-05,Denmark,DK,40,2,5806081,Europe,11811,582
2020-06-06,Denmark,DK,64,4,5806081,Europe,11875,586
2020-06-07,Denmark,DK,49,1,5806081,Europe,11924,587
2020-06-08,Denmark,DK,24,2,5806081,Europe,11948,589
2020-06-09,Denmark,DK,14,4,5806081,Europe,11962,593
2020-06-10,Denmark,DK,39,0,5806081,Europe,12001,593
2020-06-11,Denmark,DK,15,0,5806081,Europe,12016,593
2020-06-12,Denmark,DK,19,0,5806081,Europe,12035,593
2020-06-13,Denmark,DK,64,1,5806081,Europe,12099,594
2020-06-14,Denmark,DK,40,3,5806081,Europe,12139,597
2020-06-15,Denmark,DK,54,0,5806081,Europe,12193,597
2020-06-16,Denmark,DK,24,1,5806081,Europe,12217,598
2020-06-17,Denmark,DK,33,0,5806081,Europe,12250,598
2020-06-18,Denmark,DK,44,0,5806081,Europe,12294,598
2020-06-19,Denmark,DK,50,2,5806081,Europe,12344,600
2020-06-20,Denmark,DK,47,0,5806081,Europe,12391,600
2020-06-21,Denmark,DK,0,0,5806081,Europe,12391,600
2020-06-22,Denmark,DK,0,0,5806081,Europe,12391,600
2020-06-23,Denmark,DK,136,2,5806081,Europe,12527,602
2020-06-24,Denmark,DK,34,1,5806081,Europe,12561,603
2020-06-25,Denmark,DK,54,0,5806081,Europe,12615,603
2020-06-26,Denmark,DK,21,0,5806081,Europe,12636,603
2020-06-27,Denmark,DK,39,1,5806081,Europe,12675,604
2020-06-28,Denmark,DK,0,0,5806081,Europe,12675,604
2020-06-29,Denmark,DK,0,0,5806081,Europe,12675,604
2020-06-30,Denmark,DK,76,1,5806081,Europe,12751,605
2020-07-01,Denmark,DK,17,0,5806081,Europe,12768,605
2020-07-02,Denmark,DK,26,1,5806081,Europe,12794,606
2020-07-03,Denmark,DK,21,0,5806081,Europe,12815,606
2020-07-04,Denmark,DK,17,0,5806081,Europe,12832,606
2020-07-05,Denmark,DK,0,0,5806081,Europe,12832,606
2020-07-06,Denmark,DK,0,0,5806081,Europe,12832,606
2020-07-07,Denmark,DK,46,1,5806081,Europe,12878,607
2020-07-08,Denmark,DK,10,2,5806081,Europe,12888,609
2020-07-09,Denmark,DK,12,0,5806081,Europe,12900,609
2020-07-10,Denmark,DK,16,0,5806081,Europe,12916,609
2020-07-11,Denmark,DK,30,0,5806081,Europe,12946,609
2020-07-12,Denmark,DK,0,0,5806081,Europe,12946,609
2020-07-13,Denmark,DK,0,0,5806081,Europe,12946,609
2020-07-14,Denmark,DK,91,1,5806081,Europe,13037,610
2020-07-15,Denmark,DK,24,0,5806081,Europe,13061,610
2020-07-16,Denmark,DK,31,0,5806081,Europe,13092,610
2020-07-17,Denmark,DK,32,0,5806081,Europe,13124,610
2020-07-18,Denmark,DK,49,1,5806081,Europe,13173,611
2020-07-19,Denmark,DK,0,0,5806081,Europe,13173,611
2020-07-20,Denmark,DK,0,0,5806081,Europe,13173,611
2020-07-21,Denmark,DK,89,0,5806081,Europe,13262,611
2020-07-22,Denmark,DK,40,0,5806081,Europe,13302,611
2020-07-23,Denmark,DK,48,0,5806081,Europe,13350,611
2020-07-24,Denmark,DK,40,1,5806081,Europe,13390,612
2020-07-25,Denmark,DK,48,1,5806081,Europe,13438,613
2020-07-26,Denmark,DK,0,0,5806081,Europe,13438,613
2020-07-27,Denmark,DK,0,0,5806081,Europe,13438,613
2020-07-28,Denmark,DK,109,0,5806081,Europe,13547,613
2020-07-29,Denmark,DK,30,0,5806081,Europe,13577,613
2020-07-30,Denmark,DK,57,1,5806081,Europe,13634,614
2020-07-31,Denmark,DK,91,1,5806081,Europe,13725,615
2020-08-01,Denmark,DK,64,0,5806081,Europe,13789,615
2020-08-02,Denmark,DK,0,0,5806081,Europe,13789,615
2020-08-03,Denmark,DK,0,0,5806081,Europe,13789,615
2020-08-04,Denmark,DK,207,1,5806081,Europe,13996,616
2020-08-05,Denmark,DK,77,0,5806081,Europe,14073,616
2020-08-06,Denmark,DK,112,0,5806081,Europe,14185,616
2020-08-07,Denmark,DK,121,1,5806081,Europe,14306,617
2020-08-08,Denmark,DK,136,0,5806081,Europe,14442,617
2020-08-09,Denmark,DK,0,0,5806081,Europe,14442,617
2020-08-10,Denmark,DK,0,0,5806081,Europe,14442,617
2020-08-11,Denmark,DK,373,3,5806081,Europe,14815,620
2020-08-12,Denmark,DK,144,1,5806081,Europe,14959,621
2020-08-13,Denmark,DK,111,0,5806081,Europe,15070,621
2020-08-14,Denmark,DK,144,0,5806081,Europe,15214,621
2020-08-15,Denmark,DK,165,0,5806081,Europe,15379,621
2020-08-16,Denmark,DK,104,0,5806081,Europe,15483,621
2020-08-17,Denmark,DK,134,0,5806081,Europe,15617,621
2020-08-18,Denmark,DK,123,0,5806081,Europe,15740,621
2020-08-19,Denmark,DK,115,0,5806081,Europe,15855,621
2020-08-20,Denmark,DK,85,0,5806081,Europe,15940,621
2020-08-21,Denmark,DK,116,0,5806081,Europe,16056,621
2020-08-22,Denmark,DK,71,0,5806081,Europe,16127,621
2020-08-23,Denmark,DK,0,0,5806081,Europe,16127,621
2020-08-24,Denmark,DK,0,0,5806081,Europe,16127,621
2020-08-25,Denmark,DK,270,2,5806081,Europe,16397,623
2020-08-26,Denmark,DK,83,0,5806081,Europe,16480,623
2020-08-27,Denmark,DK,57,0,5806081,Europe,16537,623
2020-08-28,Denmark,DK,90,1,5806081,Europe,16627,624
2020-08-29,Denmark,DK,73,0,5806081,Europe,16700,624
2020-08-30,Denmark,DK,0,0,5806081,Europe,16700,624
2020-08-31,Denmark,DK,0,0,5806081,Europe,16700,624
2020-09-01,Denmark,DK,285,0,5806081,Europe,16985,624
2020-09-02,Denmark,DK,99,1,5806081,Europe,17084,625
2020-09-03,Denmark,DK,111,1,5806081,Europe,17195,626
2020-09-04,Denmark,DK,179,0,5806081,Europe,17374,626
2020-09-05,Denmark,DK,173,1,5806081,Europe,17547,627
2020-09-06,Denmark,DK,0,0,5806081,Europe,17547,627
2020-09-07,Denmark,DK,0,0,5806081,Europe,17547,627
2020-09-08,Denmark,DK,566,1,5806081,Europe,18113,628
2020-09-09,Denmark,DK,243,0,5806081,Europe,18356,628
2020-09-10,Denmark,DK,251,0,5806081,Europe,18607,628
2020-09-11,Denmark,DK,317,1,5806081,Europe,18924,629
2020-09-12,Denmark,DK,292,0,5806081,Europe,19216,629
2020-09-13,Denmark,DK,0,0,5806081,Europe,19216,629
2020-09-14,Denmark,DK,0,0,5806081,Europe,19216,629
2020-09-15,Denmark,DK,584,4,5806081,Europe,19800,633
2020-09-16,Denmark,DK,329,0,5806081,Europe,20129,633
2020-09-17,Denmark,DK,442,0,5806081,Europe,20571,633
2020-09-18,Denmark,DK,822,2,5806081,Europe,21393,635
2020-09-19,Denmark,DK,454,0,5806081,Europe,21847,635
2020-09-20,Denmark,DK,0,0,5806081,Europe,21847,635
2020-09-21,Denmark,DK,0,0,5806081,Europe,21847,635
2020-09-22,Denmark,DK,1476,5,5806081,Europe,23323,640
2020-09-23,Denmark,DK,476,1,5806081,Europe,23799,641
2020-09-24,Denmark,DK,558,2,5806081,Europe,24357,643
2020-09-25,Denmark,DK,559,2,5806081,Europe,24916,645
2020-09-26,Denmark,DK,678,2,5806081,Europe,25594,647
2020-09-27,Denmark,DK,619,1,5806081,Europe,26213,648
2020-09-28,Denmark,DK,424,1,5806081,Europe,26637,649
2020-09-29,Denmark,DK,435,0,5806081,Europe,27072,649
2020-09-30,Denmark,DK,392,1,5806081,Europe,27464,650
2020-10-01,Denmark,DK,534,0,5806081,Europe,27998,650
2020-10-02,Denmark,DK,398,1,5806081,Europe,28396,651
2020-10-03,Denmark,DK,536,1,5806081,Europe,28932,652
2020-10-04,Denmark,DK,370,2,5806081,Europe,29302,654
2020-10-05,Denmark,DK,378,4,5806081,Europe,29680,658
2020-10-06,Denmark,DK,377,1,5806081,Europe,30057,659
2020-10-07,Denmark,DK,322,4,5806081,Europe,30379,663
2020-10-08,Denmark,DK,331,0,5806081,Europe,30710,663
2020-10-09,Denmark,DK,446,2,5806081,Europe,31156,665
2020-10-10,Denmark,DK,482,0,5806081,Europe,31638,665
2020-10-11,Denmark,DK,444,2,5806081,Europe,32082,667
2020-10-12,Denmark,DK,340,2,5806081,Europe,32422,669
2020-10-13,Denmark,DK,389,2,5806081,Europe,32811,671
2020-10-14,Denmark,DK,290,3,5806081,Europe,33101,674
2020-10-15,Denmark,DK,492,1,5806081,Europe,33593,675
2020-10-16,Denmark,DK,430,2,5806081,Europe,34023,677
2020-10-17,Denmark,DK,418,0,5806081,Europe,34441,677
2020-10-18,Denmark,DK,500,2,5806081,Europe,34941,679
2020-10-19,Denmark,DK,451,1,5806081,Europe,35392,680
2020-10-20,Denmark,DK,452,6,5806081,Europe,35844,686
2020-10-21,Denmark,DK,529,2,5806081,Europe,36373,688
2020-10-22,Denmark,DK,630,2,5806081,Europe,37003,690
2020-10-23,Denmark,DK,760,4,5806081,Europe,37763,694
2020-10-24,Denmark,DK,859,3,5806081,Europe,38622,697
2020-10-25,Denmark,DK,789,3,5806081,Europe,39411,700
2020-10-26,Denmark,DK,945,2,5806081,Europe,40356,702
2020-10-27,Denmark,DK,1056,6,5806081,Europe,41412,708
2020-10-28,Denmark,DK,745,1,5806081,Europe,42157,709
2020-10-29,Denmark,DK,1017,6,5806081,Europe,43174,715
2020-10-30,Denmark,DK,860,1,5806081,Europe,44034,716
2020-10-31,Denmark,DK,1191,3,5806081,Europe,45225,719
2020-11-01,Denmark,DK,1126,2,5806081,Europe,46351,721
2020-11-02,Denmark,DK,948,2,5806081,Europe,47299,723
2020-11-03,Denmark,DK,942,1,5806081,Europe,48241,724
2020-11-04,Denmark,DK,1353,4,5806081,Europe,49594,728
2020-11-05,Denmark,DK,936,1,5806081,Europe,50530,729
2020-11-06,Denmark,DK,1223,4,5806081,Europe,51753,733
2020-11-07,Denmark,DK,1427,5,5806081,Europe,53180,738
2020-11-08,Denmark,DK,1050,2,5806081,Europe,54230,740
2020-11-09,Denmark,DK,891,3,5806081,Europe,55121,743
2020-11-10,Denmark,DK,771,4,5806081,Europe,55892,747
2020-11-11,Denmark,DK,1066,3,5806081,Europe,56958,750
2020-11-12,Denmark,DK,994,3,5806081,Europe,57952,753
2020-11-13,Denmark,DK,1011,2,5806081,Europe,58963,755
2020-11-14,Denmark,DK,1037,1,5806081,Europe,60000,756
2020-11-15,Denmark,DK,1078,1,5806081,Europe,61078,757
2020-11-16,Denmark,DK,1058,3,5806081,Europe,62136,760
2020-11-17,Denmark,DK,1195,4,5806081,Europe,63331,764
2020-11-18,Denmark,DK,1220,4,5806081,Europe,64551,768
2020-11-19,Denmark,DK,1257,2,5806081,Europe,65808,770
2020-11-20,Denmark,DK,1297,3,5806081,Europe,67105,773
2020-11-21,Denmark,DK,1257,5,5806081,Europe,68362,778
2020-11-22,Denmark,DK,1273,3,5806081,Europe,69635,781
2020-11-23,Denmark,DK,850,3,5806081,Europe,70485,784
2020-11-24,Denmark,DK,1169,5,5806081,Europe,71654,789
2020-11-25,Denmark,DK,1367,8,5806081,Europe,73021,797
2020-11-26,Denmark,DK,1183,5,5806081,Europe,74204,802
2020-11-27,Denmark,DK,1191,9,5806081,Europe,75395,811
2020-11-28,Denmark,DK,1323,5,5806081,Europe,76718,816
2020-11-29,Denmark,DK,1636,7,5806081,Europe,78354,823
2020-11-30,Denmark,DK,998,6,5806081,Europe,79352,829
2020-12-01,Denmark,DK,1129,8,5806081,Europe,80481,837
2020-12-02,Denmark,DK,1468,9,5806081,Europe,81949,846
2020-12-03,Denmark,DK,1586,6,5806081,Europe,83535,852
2020-12-04,Denmark,DK,1605,6,5806081,Europe,85140,858
2020-12-05,Denmark,DK,1603,9,5806081,Europe,86743,867
2020-12-06,Denmark,DK,2115,11,5806081,Europe,88858,878
2020-12-07,Denmark,DK,1745,7,5806081,Europe,90603,885
2020-12-08,Denmark,DK,2046,9,5806081,Europe,92649,894
2020-12-09,Denmark,DK,2150,7,5806081,Europe,94799,901
2020-12-10,Denmark,DK,2558,3,5806081,Europe,97357,904
2020-12-11,Denmark,DK,3132,14,5806081,Europe,100489,918
2020-12-12,Denmark,DK,3075,9,5806081,Europe,103564,927
2020-12-13,Denmark,DK,3552,8,5806081,Europe,107116,935
2020-12-14,Denmark,DK,2642,6,5806081,Europe,109758,941
2020-03-23,Dominica,DM,1,0,71808,America,1,0
2020-03-24,Dominica,DM,0,0,71808,America,1,0
2020-03-25,Dominica,DM,1,0,71808,America,2,0
2020-03-26,Dominica,DM,5,0,71808,America,7,0
2020-03-27,Dominica,DM,4,0,71808,America,11,0
2020-03-28,Dominica,DM,0,0,71808,America,11,0
2020-03-29,Dominica,DM,0,0,71808,America,11,0
2020-03-30,Dominica,DM,0,0,71808,America,11,0
2020-03-31,Dominica,DM,0,0,71808,America,11,0
2020-04-01,Dominica,DM,0,0,71808,America,11,0
2020-04-02,Dominica,DM,1,0,71808,America,12,0
2020-04-03,Dominica,DM,0,0,71808,America,12,0
2020-04-04,Dominica,DM,2,0,71808,America,14,0
2020-04-05,Dominica,DM,0,0,71808,America,14,0
2020-04-06,Dominica,DM,0,0,71808,America,14,0
2020-04-07,Dominica,DM,1,0,71808,America,15,0
2020-04-08,Dominica,DM,0,0,71808,America,15,0
2020-04-09,Dominica,DM,0,0,71808,America,15,0
2020-04-10,Dominica,DM,1,0,71808,America,16,0
2020-04-11,Dominica,DM,0,0,71808,America,16,0
2020-04-12,Dominica,DM,0,0,71808,America,16,0
2020-04-13,Dominica,DM,0,0,71808,America,16,0
2020-04-14,Dominica,DM,0,0,71808,America,16,0
2020-04-15,Dominica,DM,0,0,71808,America,16,0
2020-04-16,Dominica,DM,0,0,71808,America,16,0
2020-04-17,Dominica,DM,0,0,71808,America,16,0
2020-04-18,Dominica,DM,0,0,71808,America,16,0
2020-04-19,Dominica,DM,0,0,71808,America,16,0
2020-04-20,Dominica,DM,0,0,71808,America,16,0
2020-04-21,Dominica,DM,0,0,71808,America,16,0
2020-04-22,Dominica,DM,0,0,71808,America,16,0
2020-04-23,Dominica,DM,0,0,71808,America,16,0
2020-04-24,Dominica,DM,0,0,71808,America,16,0
2020-04-25,Dominica,DM,0,0,71808,America,16,0
2020-04-26,Dominica,DM,0,0,71808,America,16,0
2020-04-27,Dominica,DM,0,0,71808,America,16,0
2020-04-28,Dominica,DM,0,0,71808,America,16,0
2020-04-29,Dominica,DM,0,0,71808,America,16,0
2020-04-30,Dominica,DM,0,0,71808,America,16,0
2020-05-01,Dominica,DM,0,0,71808,America,16,0
2020-05-02,Dominica,DM,0,0,71808,America,16,0
2020-05-03,Dominica,DM,0,0,71808,America,16,0
2020-05-04,Dominica,DM,0,0,71808,America,16,0
2020-05-05,Dominica,DM,0,0,71808,America,16,0
2020-05-06,Dominica,DM,0,0,71808,America,16,0
2020-05-07,Dominica,DM,0,0,71808,America,16,0
2020-05-08,Dominica,DM,0,0,71808,America,16,0
2020-05-09,Dominica,DM,0,0,71808,America,16,0
2020-05-10,Dominica,DM,0,0,71808,America,16,0
2020-05-11,Dominica,DM,0,0,71808,America,16,0
2020-05-12,Dominica,DM,0,0,71808,America,16,0
2020-05-13,Dominica,DM,0,0,71808,America,16,0
2020-05-14,Dominica,DM,0,0,71808,America,16,0
2020-05-15,Dominica,DM,0,0,71808,America,16,0
2020-05-16,Dominica,DM,0,0,71808,America,16,0
2020-05-17,Dominica,DM,0,0,71808,America,16,0
2020-05-18,Dominica,DM,0,0,71808,America,16,0
2020-05-19,Dominica,DM,0,0,71808,America,16,0
2020-05-20,Dominica,DM,0,0,71808,America,16,0
2020-05-21,Dominica,DM,0,0,71808,America,16,0
2020-05-22,Dominica,DM,0,0,71808,America,16,0
2020-05-23,Dominica,DM,0,0,71808,America,16,0
2020-05-24,Dominica,DM,0,0,71808,America,16,0
2020-05-25,Dominica,DM,0,0,71808,America,16,0
2020-05-26,Dominica,DM,0,0,71808,America,16,0
2020-05-27,Dominica,DM,0,0,71808,America,16,0
2020-05-28,Dominica,DM,0,0,71808,America,16,0
2020-05-29,Dominica,DM,0,0,71808,America,16,0
2020-05-30,Dominica,DM,0,0,71808,America,16,0
2020-05-31,Dominica,DM,0,0,71808,America,16,0
2020-06-01,Dominica,DM,0,0,71808,America,16,0
2020-06-02,Dominica,DM,2,0,71808,America,18,0
2020-06-03,Dominica,DM,0,0,71808,America,18,0
2020-06-04,Dominica,DM,0,0,71808,America,18,0
2020-06-05,Dominica,DM,0,0,71808,America,18,0
2020-06-06,Dominica,DM,0,0,71808,America,18,0
2020-06-07,Dominica,DM,0,0,71808,America,18,0
2020-06-08,Dominica,DM,0,0,71808,America,18,0
2020-06-09,Dominica,DM,0,0,71808,America,18,0
2020-06-10,Dominica,DM,0,0,71808,America,18,0
2020-06-11,Dominica,DM,0,0,71808,America,18,0
2020-06-12,Dominica,DM,0,0,71808,America,18,0
2020-06-13,Dominica,DM,0,0,71808,America,18,0
2020-06-14,Dominica,DM,0,0,71808,America,18,0
2020-06-15,Dominica,DM,0,0,71808,America,18,0
2020-06-16,Dominica,DM,0,0,71808,America,18,0
2020-06-17,Dominica,DM,0,0,71808,America,18,0
2020-06-18,Dominica,DM,0,0,71808,America,18,0
2020-06-19,Dominica,DM,0,0,71808,America,18,0
2020-06-20,Dominica,DM,0,0,71808,America,18,0
2020-06-21,Dominica,DM,0,0,71808,America,18,0
2020-06-22,Dominica,DM,0,0,71808,America,18,0
2020-06-23,Dominica,DM,0,0,71808,America,18,0
2020-06-24,Dominica,DM,0,0,71808,America,18,0
2020-06-25,Dominica,DM,0,0,71808,America,18,0
2020-06-26,Dominica,DM,0,0,71808,America,18,0
2020-06-27,Dominica,DM,0,0,71808,America,18,0
2020-06-28,Dominica,DM,0,0,71808,America,18,0
2020-06-29,Dominica,DM,0,0,71808,America,18,0
2020-06-30,Dominica,DM,0,0,71808,America,18,0
2020-07-01,Dominica,DM,0,0,71808,America,18,0
2020-07-02,Dominica,DM,0,0,71808,America,18,0
2020-07-03,Dominica,DM,0,0,71808,America,18,0
2020-07-04,Dominica,DM,0,0,71808,America,18,0
2020-07-05,Dominica,DM,0,0,71808,America,18,0
2020-07-06,Dominica,DM,0,0,71808,America,18,0
2020-07-07,Dominica,DM,0,0,71808,America,18,0
2020-07-08,Dominica,DM,0,0,71808,America,18,0
2020-07-09,Dominica,DM,0,0,71808,America,18,0
2020-07-10,Dominica,DM,0,0,71808,America,18,0
2020-07-11,Dominica,DM,0,0,71808,America,18,0
2020-07-12,Dominica,DM,0,0,71808,America,18,0
2020-07-13,Dominica,DM,0,0,71808,America,18,0
2020-07-14,Dominica,DM,0,0,71808,America,18,0
2020-07-15,Dominica,DM,0,0,71808,America,18,0
2020-07-16,Dominica,DM,0,0,71808,America,18,0
2020-07-17,Dominica,DM,0,0,71808,America,18,0
2020-07-18,Dominica,DM,0,0,71808,America,18,0
2020-07-19,Dominica,DM,0,0,71808,America,18,0
2020-07-20,Dominica,DM,0,0,71808,America,18,0
2020-07-21,Dominica,DM,0,0,71808,America,18,0
2020-07-22,Dominica,DM,0,0,71808,America,18,0
2020-07-23,Dominica,DM,0,0,71808,America,18,0
2020-07-24,Dominica,DM,0,0,71808,America,18,0
2020-07-25,Dominica,DM,0,0,71808,America,18,0
2020-07-26,Dominica,DM,0,0,71808,America,18,0
2020-07-27,Dominica,DM,0,0,71808,America,18,0
2020-07-28,Dominica,DM,0,0,71808,America,18,0
2020-07-29,Dominica,DM,0,0,71808,America,18,0
2020-07-30,Dominica,DM,0,0,71808,America,18,0
2020-07-31,Dominica,DM,0,0,71808,America,18,0
2020-08-01,Dominica,DM,0,0,71808,America,18,0
2020-08-02,Dominica,DM,0,0,71808,America,18,0
2020-08-03,Dominica,DM,0,0,71808,America,18,0
2020-08-04,Dominica,DM,0,0,71808,America,18,0
2020-08-05,Dominica,DM,0,0,71808,America,18,0
2020-08-06,Dominica,DM,0,0,71808,America,18,0
2020-08-07,Dominica,DM,0,0,71808,America,18,0
2020-08-08,Dominica,DM,0,0,71808,America,18,0
2020-08-09,Dominica,DM,0,0,71808,America,18,0
2020-08-10,Dominica,DM,0,0,71808,America,18,0
2020-08-11,Dominica,DM,0,0,71808,America,18,0
2020-08-12,Dominica,DM,0,0,71808,America,18,0
2020-08-13,Dominica,DM,0,0,71808,America,18,0
2020-08-14,Dominica,DM,0,0,71808,America,18,0
2020-08-15,Dominica,DM,0,0,71808,America,18,0
2020-08-16,Dominica,DM,0,0,71808,America,18,0
2020-08-17,Dominica,DM,0,0,71808,America,18,0
2020-08-18,Dominica,DM,0,0,71808,America,18,0
2020-08-19,Dominica,DM,0,0,71808,America,18,0
2020-08-20,Dominica,DM,0,0,71808,America,18,0
2020-08-21,Dominica,DM,0,0,71808,America,18,0
2020-08-22,Dominica,DM,1,0,71808,America,19,0
2020-08-23,Dominica,DM,0,0,71808,America,19,0
2020-08-24,Dominica,DM,0,0,71808,America,19,0
2020-08-25,Dominica,DM,1,0,71808,America,20,0
2020-08-26,Dominica,DM,0,0,71808,America,20,0
2020-08-27,Dominica,DM,0,0,71808,America,20,0
2020-08-28,Dominica,DM,0,0,71808,America,20,0
2020-08-29,Dominica,DM,0,0,71808,America,20,0
2020-08-30,Dominica,DM,0,0,71808,America,20,0
2020-08-31,Dominica,DM,0,0,71808,America,20,0
2020-09-01,Dominica,DM,0,0,71808,America,20,0
2020-09-02,Dominica,DM,0,0,71808,America,20,0
2020-09-03,Dominica,DM,0,0,71808,America,20,0
2020-09-04,Dominica,DM,0,0,71808,America,20,0
2020-09-05,Dominica,DM,0,0,71808,America,20,0
2020-09-06,Dominica,DM,0,0,71808,America,20,0
2020-09-07,Dominica,DM,0,0,71808,America,20,0
2020-09-08,Dominica,DM,0,0,71808,America,20,0
2020-09-09,Dominica,DM,0,0,71808,America,20,0
2020-09-10,Dominica,DM,4,0,71808,America,24,0
2020-09-11,Dominica,DM,0,0,71808,America,24,0
2020-09-12,Dominica,DM,0,0,71808,America,24,0
2020-09-13,Dominica,DM,0,0,71808,America,24,0
2020-09-14,Dominica,DM,0,0,71808,America,24,0
2020-09-15,Dominica,DM,0,0,71808,America,24,0
2020-09-16,Dominica,DM,0,0,71808,America,24,0
2020-09-17,Dominica,DM,0,0,71808,America,24,0
2020-09-18,Dominica,DM,0,0,71808,America,24,0
2020-09-19,Dominica,DM,0,0,71808,America,24,0
2020-09-20,Dominica,DM,0,0,71808,America,24,0
2020-09-21,Dominica,DM,0,0,71808,America,24,0
2020-09-22,Dominica,DM,0,0,71808,America,24,0
2020-09-23,Dominica,DM,0,0,71808,America,24,0
2020-09-24,Dominica,DM,0,0,71808,America,24,0
2020-09-25,Dominica,DM,0,0,71808,America,24,0
2020-09-26,Dominica,DM,0,0,71808,America,24,0
2020-09-27,Dominica,DM,0,0,71808,America,24,0
2020-09-28,Dominica,DM,0,0,71808,America,24,0
2020-09-29,Dominica,DM,0,0,71808,America,24,0
2020-09-30,Dominica,DM,0,0,71808,America,24,0
2020-10-01,Dominica,DM,7,0,71808,America,31,0
2020-10-02,Dominica,DM,0,0,71808,America,31,0
2020-10-03,Dominica,DM,0,0,71808,America,31,0
2020-10-04,Dominica,DM,0,0,71808,America,31,0
2020-10-05,Dominica,DM,0,0,71808,America,31,0
2020-10-06,Dominica,DM,0,0,71808,America,31,0
2020-10-07,Dominica,DM,0,0,71808,America,31,0
2020-10-08,Dominica,DM,0,0,71808,America,31,0
2020-10-09,Dominica,DM,0,0,71808,America,31,0
2020-10-10,Dominica,DM,0,0,71808,America,31,0
2020-10-11,Dominica,DM,1,0,71808,America,32,0
2020-10-12,Dominica,DM,0,0,71808,America,32,0
2020-10-13,Dominica,DM,0,0,71808,America,32,0
2020-10-14,Dominica,DM,0,0,71808,America,32,0
2020-10-15,Dominica,DM,0,0,71808,America,32,0
2020-10-16,Dominica,DM,1,0,71808,America,33,0
2020-10-17,Dominica,DM,0,0,71808,America,33,0
2020-10-18,Dominica,DM,0,0,71808,America,33,0
2020-10-19,Dominica,DM,0,0,71808,America,33,0
2020-10-20,Dominica,DM,0,0,71808,America,33,0
2020-10-21,Dominica,DM,0,0,71808,America,33,0
2020-10-22,Dominica,DM,0,0,71808,America,33,0
2020-10-23,Dominica,DM,0,0,71808,America,33,0
2020-10-24,Dominica,DM,4,0,71808,America,37,0
2020-10-25,Dominica,DM,0,0,71808,America,37,0
2020-10-26,Dominica,DM,1,0,71808,America,38,0
2020-10-27,Dominica,DM,0,0,71808,America,38,0
2020-10-28,Dominica,DM,0,0,71808,America,38,0
2020-10-29,Dominica,DM,4,0,71808,America,42,0
2020-10-30,Dominica,DM,0,0,71808,America,42,0
2020-10-31,Dominica,DM,0,0,71808,America,42,0
2020-11-01,Dominica,DM,0,0,71808,America,42,0
2020-11-02,Dominica,DM,0,0,71808,America,42,0
2020-11-03,Dominica,DM,0,0,71808,America,42,0
2020-11-04,Dominica,DM,0,0,71808,America,42,0
2020-11-05,Dominica,DM,0,0,71808,America,42,0
2020-11-06,Dominica,DM,0,0,71808,America,42,0
2020-11-07,Dominica,DM,0,0,71808,America,42,0
2020-11-08,Dominica,DM,0,0,71808,America,42,0
2020-11-09,Dominica,DM,0,0,71808,America,42,0
2020-11-10,Dominica,DM,0,0,71808,America,42,0
2020-11-11,Dominica,DM,0,0,71808,America,42,0
2020-11-12,Dominica,DM,0,0,71808,America,42,0
2020-11-13,Dominica,DM,26,0,71808,America,68,0
2020-11-14,Dominica,DM,0,0,71808,America,68,0
2020-11-15,Dominica,DM,0,0,71808,America,68,0
2020-11-16,Dominica,DM,0,0,71808,America,68,0
2020-11-17,Dominica,DM,0,0,71808,America,68,0
2020-11-18,Dominica,DM,0,0,71808,America,68,0
2020-11-19,Dominica,DM,0,0,71808,America,68,0
2020-11-20,Dominica,DM,4,0,71808,America,72,0
2020-11-21,Dominica,DM,0,0,71808,America,72,0
2020-11-22,Dominica,DM,0,0,71808,America,72,0
2020-11-23,Dominica,DM,5,0,71808,America,77,0
2020-11-24,Dominica,DM,0,0,71808,America,77,0
2020-11-25,Dominica,DM,0,0,71808,America,77,0
2020-11-26,Dominica,DM,0,0,71808,America,77,0
2020-11-27,Dominica,DM,3,0,71808,America,80,0
2020-11-28,Dominica,DM,5,0,71808,America,85,0
2020-11-29,Dominica,DM,0,0,71808,America,85,0
2020-11-30,Dominica,DM,0,0,71808,America,85,0
2020-12-01,Dominica,DM,0,0,71808,America,85,0
2020-12-02,Dominica,DM,0,0,71808,America,85,0
2020-12-03,Dominica,DM,0,0,71808,America,85,0
2020-12-04,Dominica,DM,0,0,71808,America,85,0
2020-12-05,Dominica,DM,0,0,71808,America,85,0
2020-12-06,Dominica,DM,0,0,71808,America,85,0
2020-12-07,Dominica,DM,0,0,71808,America,85,0
2020-12-08,Dominica,DM,0,0,71808,America,85,0
2020-12-09,Dominica,DM,0,0,71808,America,85,0
2020-12-10,Dominica,DM,0,0,71808,America,85,0
2020-12-11,Dominica,DM,0,0,71808,America,85,0
2020-12-12,Dominica,DM,2,0,71808,America,87,0
2020-12-13,Dominica,DM,0,0,71808,America,87,0
2020-12-14,Dominica,DM,0,0,71808,America,87,0
2019-12-31,Dominican_Republic,DO,0,0,10738957,America,0,0
2020-01-01,Dominican_Republic,DO,0,0,10738957,America,0,0
2020-01-02,Dominican_Republic,DO,0,0,10738957,America,0,0
2020-01-03,Dominican_Republic,DO,0,0,10738957,America,0,0
2020-01-04,Dominican_Republic,DO,0,0,10738957,America,0,0
2020-01-05,Dominican_Republic,DO,0,0,10738957,America,0,0
2020-01-06,Dominican_Republic,DO,0,0,10738957,America,0,0
2020-01-07,Dominican_Republic,DO,0,0,10738957,America,0,0
2020-01-08,Dominican_Republic,DO,0,0,10738957,America,0,0
2020-01-09,Dominican_Republic,DO,0,0,10738957,America,0,0
2020-01-10,Dominican_Republic,DO,0,0,10738957,America,0,0
2020-01-11,Dominican_Republic,DO,0,0,10738957,America,0,0
2020-01-12,Dominican_Republic,DO,0,0,10738957,America,0,0
2020-01-13,Dominican_Republic,DO,0,0,10738957,America,0,0
2020-01-14,Dominican_Republic,DO,0,0,10738957,America,0,0
2020-01-15,Dominican_Republic,DO,0,0,10738957,America,0,0
2020-01-16,Dominican_Republic,DO,0,0,10738957,America,0,0
2020-01-17,Dominican_Republic,DO,0,0,10738957,America,0,0
2020-01-18,Dominican_Republic,DO,0,0,10738957,America,0,0
2020-01-19,Dominican_Republic,DO,0,0,10738957,America,0,0
2020-01-20,Dominican_Republic,DO,0,0,10738957,America,0,0
2020-01-21,Dominican_Republic,DO,0,0,10738957,America,0,0
2020-01-22,Dominican_Republic,DO,0,0,10738957,America,0,0
2020-01-23,Dominican_Republic,DO,0,0,10738957,America,0,0
2020-01-24,Dominican_Republic,DO,0,0,10738957,America,0,0
2020-01-25,Dominican_Republic,DO,0,0,10738957,America,0,0
2020-01-26,Dominican_Republic,DO,0,0,10738957,America,0,0
2020-01-27,Dominican_Republic,DO,0,0,10738957,America,0,0
2020-01-28,Dominican_Republic,DO,0,0,10738957,America,0,0
2020-01-29,Dominican_Republic,DO,0,0,10738957,America,0,0
2020-01-30,Dominican_Republic,DO,0,0,10738957,America,0,0
2020-01-31,Dominican_Republic,DO,0,0,10738957,America,0,0
2020-02-01,Dominican_Republic,DO,0,0,10738957,America,0,0
2020-02-02,Dominican_Republic,DO,0,0,10738957,America,0,0
2020-02-03,Dominican_Republic,DO,0,0,10738957,America,0,0
2020-02-04,Dominican_Republic,DO,0,0,10738957,America,0,0
2020-02-05,Dominican_Republic,DO,0,0,10738957,America,0,0
2020-02-06,Dominican_Republic,DO,0,0,10738957,America,0,0
2020-02-07,Dominican_Republic,DO,0,0,10738957,America,0,0
2020-02-08,Dominican_Republic,DO,0,0,10738957,America,0,0
2020-02-09,Dominican_Republic,DO,0,0,10738957,America,0,0
2020-02-10,Dominican_Republic,DO,0,0,10738957,America,0,0
2020-02-11,Dominican_Republic,DO,0,0,10738957,America,0,0
2020-02-12,Dominican_Republic,DO,0,0,10738957,America,0,0
2020-02-13,Dominican_Republic,DO,0,0,10738957,America,0,0
2020-02-14,Dominican_Republic,DO,0,0,10738957,America,0,0
2020-02-15,Dominican_Republic,DO,0,0,10738957,America,0,0
2020-02-16,Dominican_Republic,DO,0,0,10738957,America,0,0
2020-02-17,Dominican_Republic,DO,0,0,10738957,America,0,0
2020-02-18,Dominican_Republic,DO,0,0,10738957,America,0,0
2020-02-19,Dominican_Republic,DO,0,0,10738957,America,0,0
2020-02-20,Dominican_Republic,DO,0,0,10738957,America,0,0
2020-02-21,Dominican_Republic,DO,0,0,10738957,America,0,0
2020-02-22,Dominican_Republic,DO,0,0,10738957,America,0,0
2020-02-23,Dominican_Republic,DO,0,0,10738957,America,0,0
2020-02-24,Dominican_Republic,DO,0,0,10738957,America,0,0
2020-02-25,Dominican_Republic,DO,0,0,10738957,America,0,0
2020-02-26,Dominican_Republic,DO,0,0,10738957,America,0,0
2020-02-27,Dominican_Republic,DO,0,0,10738957,America,0,0
2020-02-28,Dominican_Republic,DO,0,0,10738957,America,0,0
2020-02-29,Dominican_Republic,DO,0,0,10738957,America,0,0
2020-03-01,Dominican_Republic,DO,0,0,10738957,America,0,0
2020-03-02,Dominican_Republic,DO,1,0,10738957,America,1,0
2020-03-07,Dominican_Republic,DO,1,0,10738957,America,2,0
2020-03-10,Dominican_Republic,DO,3,0,10738957,America,5,0
2020-03-14,Dominican_Republic,DO,6,0,10738957,America,11,0
2020-03-15,Dominican_Republic,DO,0,0,10738957,America,11,0
2020-03-16,Dominican_Republic,DO,0,0,10738957,America,11,0
2020-03-17,Dominican_Republic,DO,0,0,10738957,America,11,0
2020-03-18,Dominican_Republic,DO,0,0,10738957,America,11,0
2020-03-19,Dominican_Republic,DO,10,0,10738957,America,21,0
2020-03-20,Dominican_Republic,DO,0,0,10738957,America,21,0
2020-03-21,Dominican_Republic,DO,13,2,10738957,America,34,2
2020-03-22,Dominican_Republic,DO,78,1,10738957,America,112,3
2020-03-23,Dominican_Republic,DO,90,0,10738957,America,202,3
2020-03-24,Dominican_Republic,DO,43,0,10738957,America,245,3
2020-03-25,Dominican_Republic,DO,67,3,10738957,America,312,6
2020-03-26,Dominican_Republic,DO,80,4,10738957,America,392,10
2020-03-27,Dominican_Republic,DO,96,0,10738957,America,488,10
2020-03-28,Dominican_Republic,DO,93,10,10738957,America,581,20
2020-03-29,Dominican_Republic,DO,138,8,10738957,America,719,28
2020-03-30,Dominican_Republic,DO,140,11,10738957,America,859,39
2020-03-31,Dominican_Republic,DO,42,3,10738957,America,901,42
2020-04-01,Dominican_Republic,DO,208,9,10738957,America,1109,51
2020-04-02,Dominican_Republic,DO,175,6,10738957,America,1284,57
2020-04-03,Dominican_Republic,DO,96,3,10738957,America,1380,60
2020-04-04,Dominican_Republic,DO,108,8,10738957,America,1488,68
2020-04-05,Dominican_Republic,DO,90,9,10738957,America,1578,77
2020-04-06,Dominican_Republic,DO,167,5,10738957,America,1745,82
2020-04-07,Dominican_Republic,DO,83,4,10738957,America,1828,86
2020-04-08,Dominican_Republic,DO,128,12,10738957,America,1956,98
2020-04-09,Dominican_Republic,DO,155,10,10738957,America,2111,108
2020-04-10,Dominican_Republic,DO,238,10,10738957,America,2349,118
2020-04-11,Dominican_Republic,DO,271,8,10738957,America,2620,126
2020-04-12,Dominican_Republic,DO,139,9,10738957,America,2759,135
2020-04-13,Dominican_Republic,DO,208,38,10738957,America,2967,173
2020-04-14,Dominican_Republic,DO,200,4,10738957,America,3167,177
2020-04-15,Dominican_Republic,DO,119,6,10738957,America,3286,183
2020-04-16,Dominican_Republic,DO,328,6,10738957,America,3614,189
2020-04-17,Dominican_Republic,DO,141,7,10738957,America,3755,196
2020-04-18,Dominican_Republic,DO,371,4,10738957,America,4126,200
2020-04-19,Dominican_Republic,DO,209,17,10738957,America,4335,217
2020-04-20,Dominican_Republic,DO,345,9,10738957,America,4680,226
2020-04-21,Dominican_Republic,DO,284,9,10738957,America,4964,235
2020-04-22,Dominican_Republic,DO,80,10,10738957,America,5044,245
2020-04-23,Dominican_Republic,DO,256,15,10738957,America,5300,260
2020-04-24,Dominican_Republic,DO,243,5,10738957,America,5543,265
2020-04-25,Dominican_Republic,DO,206,2,10738957,America,5749,267
2020-04-26,Dominican_Republic,DO,177,6,10738957,America,5926,273
2020-04-27,Dominican_Republic,DO,209,5,10738957,America,6135,278
2020-04-28,Dominican_Republic,DO,0,0,10738957,America,6135,278
2020-04-29,Dominican_Republic,DO,281,8,10738957,America,6416,286
2020-04-30,Dominican_Republic,DO,236,7,10738957,America,6652,293
2020-05-01,Dominican_Republic,DO,320,8,10738957,America,6972,301
2020-05-02,Dominican_Republic,DO,316,12,10738957,America,7288,313
2020-05-03,Dominican_Republic,DO,290,13,10738957,America,7578,326
2020-05-04,Dominican_Republic,DO,376,7,10738957,America,7954,333
2020-05-05,Dominican_Republic,DO,281,13,10738957,America,8235,346
2020-05-06,Dominican_Republic,DO,245,8,10738957,America,8480,354
2020-05-07,Dominican_Republic,DO,327,8,10738957,America,8807,362
2020-05-08,Dominican_Republic,DO,288,11,10738957,America,9095,373
2020-05-09,Dominican_Republic,DO,281,7,10738957,America,9376,380
2020-05-10,Dominican_Republic,DO,506,5,10738957,America,9882,385
2020-05-11,Dominican_Republic,DO,465,3,10738957,America,10347,388
2020-05-12,Dominican_Republic,DO,287,5,10738957,America,10634,393
2020-05-13,Dominican_Republic,DO,266,9,10738957,America,10900,402
2020-05-14,Dominican_Republic,DO,296,7,10738957,America,11196,409
2020-05-15,Dominican_Republic,DO,124,13,10738957,America,11320,422
2020-05-16,Dominican_Republic,DO,419,2,10738957,America,11739,424
2020-05-17,Dominican_Republic,DO,154,0,10738957,America,11893,424
2020-05-18,Dominican_Republic,DO,421,4,10738957,America,12314,428
2020-05-19,Dominican_Republic,DO,411,6,10738957,America,12725,434
2020-05-20,Dominican_Republic,DO,498,7,10738957,America,13223,441
2020-05-21,Dominican_Republic,DO,254,5,10738957,America,13477,446
2020-05-22,Dominican_Republic,DO,180,2,10738957,America,13657,448
2020-05-23,Dominican_Republic,DO,332,8,10738957,America,13989,456
2020-05-24,Dominican_Republic,DO,433,2,10738957,America,14422,458
2020-05-25,Dominican_Republic,DO,0,0,10738957,America,14422,458
2020-05-26,Dominican_Republic,DO,651,2,10738957,America,15073,460
2020-05-27,Dominican_Republic,DO,191,8,10738957,America,15264,468
2020-05-28,Dominican_Republic,DO,459,6,10738957,America,15723,474
2020-05-29,Dominican_Republic,DO,345,11,10738957,America,16068,485
2020-05-30,Dominican_Republic,DO,463,3,10738957,America,16531,488
2020-05-31,Dominican_Republic,DO,377,10,10738957,America,16908,498
2020-06-01,Dominican_Republic,DO,377,4,10738957,America,17285,502
2020-06-02,Dominican_Republic,DO,287,0,10738957,America,17572,502
2020-06-03,Dominican_Republic,DO,180,13,10738957,America,17752,515
2020-06-04,Dominican_Republic,DO,288,1,10738957,America,18040,516
2020-06-05,Dominican_Republic,DO,279,4,10738957,America,18319,520
2020-06-06,Dominican_Republic,DO,389,5,10738957,America,18708,525
2020-06-07,Dominican_Republic,DO,487,11,10738957,America,19195,536
2020-06-08,Dominican_Republic,DO,405,2,10738957,America,19600,538
2020-06-09,Dominican_Republic,DO,526,1,10738957,America,20126,539
2020-06-10,Dominican_Republic,DO,289,5,10738957,America,20415,544
2020-06-11,Dominican_Republic,DO,393,6,10738957,America,20808,550
2020-06-12,Dominican_Republic,DO,629,11,10738957,America,21437,561
2020-06-13,Dominican_Republic,DO,571,7,10738957,America,22008,568
2020-06-14,Dominican_Republic,DO,564,9,10738957,America,22572,577
2020-06-15,Dominican_Republic,DO,390,15,10738957,America,22962,592
2020-06-16,Dominican_Republic,DO,309,13,10738957,America,23271,605
2020-06-17,Dominican_Republic,DO,415,10,10738957,America,23686,615
2020-06-18,Dominican_Republic,DO,419,18,10738957,America,24105,633
2020-06-19,Dominican_Republic,DO,540,2,10738957,America,24645,635
2020-06-20,Dominican_Republic,DO,423,12,10738957,America,25068,647
2020-06-21,Dominican_Republic,DO,710,8,10738957,America,25778,655
2020-06-22,Dominican_Republic,DO,899,7,10738957,America,26677,662
2020-06-23,Dominican_Republic,DO,693,7,10738957,America,27370,669
2020-06-24,Dominican_Republic,DO,566,6,10738957,America,27936,675
2020-06-25,Dominican_Republic,DO,695,16,10738957,America,28631,691
2020-06-26,Dominican_Republic,DO,510,7,10738957,America,29141,698
2020-06-27,Dominican_Republic,DO,623,14,10738957,America,29764,712
2020-06-28,Dominican_Republic,DO,855,6,10738957,America,30619,718
2020-06-29,Dominican_Republic,DO,754,8,10738957,America,31373,726
2020-06-30,Dominican_Republic,DO,443,7,10738957,America,31816,733
2020-07-01,Dominican_Republic,DO,752,14,10738957,America,32568,747
2020-07-02,Dominican_Republic,DO,819,7,10738957,America,33387,754
2020-07-03,Dominican_Republic,DO,810,11,10738957,America,34197,765
2020-07-04,Dominican_Republic,DO,951,10,10738957,America,35148,775
2020-07-05,Dominican_Republic,DO,1036,11,10738957,America,36184,786
2020-07-06,Dominican_Republic,DO,1241,8,10738957,America,37425,794
2020-07-07,Dominican_Republic,DO,703,10,10738957,America,38128,804
2020-07-08,Dominican_Republic,DO,302,17,10738957,America,38430,821
2020-07-09,Dominican_Republic,DO,1158,8,10738957,America,39588,829
2020-07-10,Dominican_Republic,DO,1202,13,10738957,America,40790,842
2020-07-11,Dominican_Republic,DO,1125,22,10738957,America,41915,864
2020-07-12,Dominican_Republic,DO,1199,16,10738957,America,43114,880
2020-07-13,Dominican_Republic,DO,1418,17,10738957,America,44532,897
2020-07-14,Dominican_Republic,DO,974,6,10738957,America,45506,903
2020-07-15,Dominican_Republic,DO,799,7,10738957,America,46305,910
2020-07-16,Dominican_Republic,DO,1366,19,10738957,America,47671,929
2020-07-17,Dominican_Republic,DO,1072,12,10738957,America,48743,941
2020-07-18,Dominican_Republic,DO,1370,1,10738957,America,50113,942
2020-07-19,Dominican_Republic,DO,1406,29,10738957,America,51519,971
2020-07-20,Dominican_Republic,DO,1336,10,10738957,America,52855,981
2020-07-21,Dominican_Republic,DO,1101,12,10738957,America,53956,993
2020-07-22,Dominican_Republic,DO,841,6,10738957,America,54797,999
2020-07-23,Dominican_Republic,DO,1246,6,10738957,America,56043,1005
2020-07-24,Dominican_Republic,DO,1572,1,10738957,America,57615,1006
2020-07-25,Dominican_Republic,DO,1462,30,10738957,America,59077,1036
2020-07-26,Dominican_Republic,DO,1819,19,10738957,America,60896,1055
2020-07-27,Dominican_Republic,DO,2012,8,10738957,America,62908,1063
2020-07-28,Dominican_Republic,DO,1248,20,10738957,America,64156,1083
2020-07-29,Dominican_Republic,DO,534,18,10738957,America,64690,1101
2020-07-30,Dominican_Republic,DO,1492,22,10738957,America,66182,1123
2020-07-31,Dominican_Republic,DO,1733,23,10738957,America,67915,1146
2020-08-01,Dominican_Republic,DO,1734,14,10738957,America,69649,1160
2020-08-02,Dominican_Republic,DO,1766,10,10738957,America,71415,1170
2020-08-03,Dominican_Republic,DO,828,8,10738957,America,72243,1178
2020-08-04,Dominican_Republic,DO,874,5,10738957,America,73117,1183
2020-08-05,Dominican_Republic,DO,1178,30,10738957,America,74295,1213
2020-08-06,Dominican_Republic,DO,1365,9,10738957,America,75660,1222
2020-08-07,Dominican_Republic,DO,876,24,10738957,America,76536,1246
2020-08-08,Dominican_Republic,DO,1173,13,10738957,America,77709,1259
2020-08-09,Dominican_Republic,DO,1069,30,10738957,America,78778,1289
2020-08-10,Dominican_Republic,DO,954,20,10738957,America,79732,1309
2020-08-11,Dominican_Republic,DO,767,19,10738957,America,80499,1328
2020-08-12,Dominican_Republic,DO,595,18,10738957,America,81094,1346
2020-08-13,Dominican_Republic,DO,1130,25,10738957,America,82224,1371
2020-08-14,Dominican_Republic,DO,910,22,10738957,America,83134,1393
2020-08-15,Dominican_Republic,DO,1354,16,10738957,America,84488,1409
2020-08-16,Dominican_Republic,DO,1057,29,10738957,America,85545,1438
2020-08-17,Dominican_Republic,DO,764,15,10738957,America,86309,1453
2020-08-18,Dominican_Republic,DO,428,28,10738957,America,86737,1481
2020-08-19,Dominican_Republic,DO,386,8,10738957,America,87123,1489
2020-08-20,Dominican_Republic,DO,1004,12,10738957,America,88127,1501
2020-08-21,Dominican_Republic,DO,883,4,10738957,America,89010,1505
2020-08-22,Dominican_Republic,DO,857,28,10738957,America,89867,1533
2020-08-23,Dominican_Republic,DO,694,21,10738957,America,90561,1554
2020-08-24,Dominican_Republic,DO,600,13,10738957,America,91161,1567
2020-08-25,Dominican_Republic,DO,447,6,10738957,America,91608,1573
2020-08-26,Dominican_Republic,DO,609,12,10738957,America,92217,1585
2020-08-27,Dominican_Republic,DO,340,28,10738957,America,92557,1613
2020-08-28,Dominican_Republic,DO,407,17,10738957,America,92964,1630
2020-08-29,Dominican_Republic,DO,426,18,10738957,America,93390,1648
2020-08-30,Dominican_Republic,DO,342,25,10738957,America,93732,1673
2020-08-31,Dominican_Republic,DO,509,8,10738957,America,94241,1681
2020-09-01,Dominican_Republic,DO,474,29,10738957,America,94715,1710
2020-09-02,Dominican_Republic,DO,264,28,10738957,America,94979,1738
2020-09-03,Dominican_Republic,DO,648,27,10738957,America,95627,1765
2020-09-04,Dominican_Republic,DO,1002,36,10738957,America,96629,1801
2020-09-05,Dominican_Republic,DO,0,0,10738957,America,96629,1801
2020-09-06,Dominican_Republic,DO,2147,39,10738957,America,98776,1840
2020-09-07,Dominican_Republic,DO,557,5,10738957,America,99333,1845
2020-09-08,Dominican_Republic,DO,565,19,10738957,America,99898,1864
2020-09-09,Dominican_Republic,DO,233,25,10738957,America,100131,1889
2020-09-10,Dominican_Republic,DO,806,25,10738957,America,100937,1914
2020-09-11,Dominican_Republic,DO,779,12,10738957,America,101716,1926
2020-09-12,Dominican_Republic,DO,516,15,10738957,America,102232,1941
2020-09-13,Dominican_Republic,DO,860,12,10738957,America,103092,1953
2020-09-14,Dominican_Republic,DO,568,15,10738957,America,103660,1968
2020-09-15,Dominican_Republic,DO,450,16,10738957,America,104110,1984
2020-09-16,Dominican_Republic,DO,693,14,10738957,America,104803,1998
2020-09-17,Dominican_Republic,DO,718,11,10738957,America,105521,2009
2020-09-18,Dominican_Republic,DO,615,13,10738957,America,106136,2022
2020-09-19,Dominican_Republic,DO,596,12,10738957,America,106732,2034
2020-09-20,Dominican_Republic,DO,968,10,10738957,America,107700,2044
2020-09-21,Dominican_Republic,DO,589,3,10738957,America,108289,2047
2020-09-22,Dominican_Republic,DO,494,7,10738957,America,108783,2054
2020-09-23,Dominican_Republic,DO,486,10,10738957,America,109269,2064
2020-09-24,Dominican_Republic,DO,468,10,10738957,America,109737,2074
2020-09-25,Dominican_Republic,DO,385,2,10738957,America,110122,2076
2020-09-26,Dominican_Republic,DO,475,11,10738957,America,110597,2087
2020-09-27,Dominican_Republic,DO,360,6,10738957,America,110957,2093
2020-09-28,Dominican_Republic,DO,429,2,10738957,America,111386,2095
2020-09-29,Dominican_Republic,DO,280,3,10738957,America,111666,2098
2020-09-30,Dominican_Republic,DO,234,3,10738957,America,111900,2101
2020-10-01,Dominican_Republic,DO,309,4,10738957,America,112209,2105
2020-10-02,Dominican_Republic,DO,519,3,10738957,America,112728,2108
2020-10-03,Dominican_Republic,DO,622,9,10738957,America,113350,2117
2020-10-04,Dominican_Republic,DO,576,11,10738957,America,113926,2128
2020-10-05,Dominican_Republic,DO,554,6,10738957,America,114480,2134
2020-10-06,Dominican_Republic,DO,574,10,10738957,America,115054,2144
2020-10-07,Dominican_Republic,DO,317,5,10738957,America,115371,2149
2020-10-08,Dominican_Republic,DO,777,10,10738957,America,116148,2159
2020-10-09,Dominican_Republic,DO,724,4,10738957,America,116872,2163
2020-10-10,Dominican_Republic,DO,585,2,10738957,America,117457,2165
2020-10-11,Dominican_Republic,DO,557,2,10738957,America,118014,2167
2020-10-12,Dominican_Republic,DO,463,6,10738957,America,118477,2173
2020-10-13,Dominican_Republic,DO,366,6,10738957,America,118843,2179
2020-10-14,Dominican_Republic,DO,165,4,10738957,America,119008,2183
2020-10-15,Dominican_Republic,DO,654,3,10738957,America,119662,2186
2020-10-16,Dominican_Republic,DO,404,3,10738957,America,120066,2189
2020-10-17,Dominican_Republic,DO,384,3,10738957,America,120450,2192
2020-10-18,Dominican_Republic,DO,475,3,10738957,America,120925,2195
2020-10-19,Dominican_Republic,DO,422,4,10738957,America,121347,2199
2020-10-20,Dominican_Republic,DO,320,4,10738957,America,121667,2203
2020-10-21,Dominican_Republic,DO,306,1,10738957,America,121973,2204
2020-10-22,Dominican_Republic,DO,425,2,10738957,America,122398,2206
2020-10-23,Dominican_Republic,DO,475,6,10738957,America,122873,2212
2020-10-24,Dominican_Republic,DO,511,2,10738957,America,123384,2214
2020-10-25,Dominican_Republic,DO,634,6,10738957,America,124018,2220
2020-10-26,Dominican_Republic,DO,509,3,10738957,America,124527,2223
2020-10-27,Dominican_Republic,DO,316,2,10738957,America,124843,2225
2020-10-28,Dominican_Republic,DO,165,1,10738957,America,125008,2226
2020-10-29,Dominican_Republic,DO,562,6,10738957,America,125570,2232
2020-10-30,Dominican_Republic,DO,343,2,10738957,America,125913,2234
2020-10-31,Dominican_Republic,DO,419,2,10738957,America,126332,2236
2020-11-01,Dominican_Republic,DO,686,9,10738957,America,127018,2245
2020-11-02,Dominican_Republic,DO,314,4,10738957,America,127332,2249
2020-11-03,Dominican_Republic,DO,259,1,10738957,America,127591,2250
2020-11-04,Dominican_Republic,DO,257,2,10738957,America,127848,2252
2020-11-05,Dominican_Republic,DO,430,5,10738957,America,128278,2257
2020-11-06,Dominican_Republic,DO,546,3,10738957,America,128824,2260
2020-11-07,Dominican_Republic,DO,476,1,10738957,America,129300,2261
2020-11-08,Dominican_Republic,DO,345,2,10738957,America,129645,2263
2020-11-09,Dominican_Republic,DO,537,2,10738957,America,130182,2265
2020-11-10,Dominican_Republic,DO,421,2,10738957,America,130603,2267
2020-11-11,Dominican_Republic,DO,528,2,10738957,America,131131,2269
2020-11-12,Dominican_Republic,DO,134,3,10738957,America,131265,2272
2020-11-13,Dominican_Republic,DO,371,2,10738957,America,131636,2274
2020-11-14,Dominican_Republic,DO,918,6,10738957,America,132554,2280
2020-11-15,Dominican_Republic,DO,671,2,10738957,America,133225,2282
2020-11-16,Dominican_Republic,DO,499,3,10738957,America,133724,2285
2020-11-17,Dominican_Republic,DO,479,1,10738957,America,134203,2286
2020-11-18,Dominican_Republic,DO,494,4,10738957,America,134697,2290
2020-11-19,Dominican_Republic,DO,460,3,10738957,America,135157,2293
2020-11-20,Dominican_Republic,DO,1026,8,10738957,America,136183,2301
2020-11-21,Dominican_Republic,DO,601,5,10738957,America,136784,2306
2020-11-22,Dominican_Republic,DO,0,0,10738957,America,136784,2306
2020-11-23,Dominican_Republic,DO,1626,4,10738957,America,138410,2310
2020-11-24,Dominican_Republic,DO,419,1,10738957,America,138829,2311
2020-11-25,Dominican_Republic,DO,282,2,10738957,America,139111,2313
2020-11-26,Dominican_Republic,DO,285,2,10738957,America,139396,2315
2020-11-27,Dominican_Republic,DO,1526,2,10738957,America,140922,2317
2020-11-28,Dominican_Republic,DO,855,7,10738957,America,141777,2324
2020-11-29,Dominican_Republic,DO,876,4,10738957,America,142653,2328
2020-11-30,Dominican_Republic,DO,820,2,10738957,America,143473,2330
2020-12-01,Dominican_Republic,DO,515,1,10738957,America,143988,2331
2020-12-02,Dominican_Republic,DO,314,2,10738957,America,144302,2333
2020-12-03,Dominican_Republic,DO,895,1,10738957,America,145197,2334
2020-12-04,Dominican_Republic,DO,812,1,10738957,America,146009,2335
2020-12-05,Dominican_Republic,DO,671,8,10738957,America,146680,2343
2020-12-06,Dominican_Republic,DO,975,2,10738957,America,147655,2345
2020-12-07,Dominican_Republic,DO,798,0,10738957,America,148453,2345
2020-12-08,Dominican_Republic,DO,685,1,10738957,America,149138,2346
2020-12-09,Dominican_Republic,DO,492,1,10738957,America,149630,2347
2020-12-10,Dominican_Republic,DO,531,3,10738957,America,150161,2350
2020-12-11,Dominican_Republic,DO,1560,8,10738957,America,151721,2358
2020-12-12,Dominican_Republic,DO,731,1,10738957,America,152452,2359
2020-12-13,Dominican_Republic,DO,1133,1,10738957,America,153585,2360
2020-12-14,Dominican_Republic,DO,1107,1,10738957,America,154692,2361
2019-12-31,Algeria,DZ,0,0,43053054,Africa,0,0
2020-01-01,Algeria,DZ,0,0,43053054,Africa,0,0
2020-01-02,Algeria,DZ,0,0,43053054,Africa,0,0
2020-01-03,Algeria,DZ,0,0,43053054,Africa,0,0
2020-01-04,Algeria,DZ,0,0,43053054,Africa,0,0
2020-01-05,Algeria,DZ,0,0,43053054,Africa,0,0
2020-01-06,Algeria,DZ,0,0,43053054,Africa,0,0
2020-01-07,Algeria,DZ,0,0,43053054,Africa,0,0
2020-01-08,Algeria,DZ,0,0,43053054,Africa,0,0
2020-01-09,Algeria,DZ,0,0,43053054,Africa,0,0
2020-01-10,Algeria,DZ,0,0,43053054,Africa,0,0
2020-01-11,Algeria,DZ,0,0,43053054,Africa,0,0
2020-01-12,Algeria,DZ,0,0,43053054,Africa,0,0
2020-01-13,Algeria,DZ,0,0,43053054,Africa,0,0
2020-01-14,Algeria,DZ,0,0,43053054,Africa,0,0
2020-01-15,Algeria,DZ,0,0,43053054,Africa,0,0
2020-01-16,Algeria,DZ,0,0,43053054,Africa,0,0
2020-01-17,Algeria,DZ,0,0,43053054,Africa,0,0
2020-01-18,Algeria,DZ,0,0,43053054,Africa,0,0
2020-01-19,Algeria,DZ,0,0,43053054,Africa,0,0
2020-01-20,Algeria,DZ,0,0,43053054,Africa,0,0
2020-01-21,Algeria,DZ,0,0,43053054,Africa,0,0
2020-01-22,Algeria,DZ,0,0,43053054,Africa,0,0
2020-01-23,Algeria,DZ,0,0,43053054,Africa,0,0
2020-01-24,Algeria,DZ,0,0,43053054,Africa,0,0
2020-01-25,Algeria,DZ,0,0,43053054,Africa,0,0
2020-01-26,Algeria,DZ,0,0,43053054,Africa,0,0
2020-01-27,Algeria,DZ,0,0,43053054,Africa,0,0
2020-01-28,Algeria,DZ,0,0,43053054,Africa,0,0
2020-01-29,Algeria,DZ,0,0,43053054,Africa,0,0
2020-01-30,Algeria,DZ,0,0,43053054,Africa,0,0
2020-01-31,Algeria,DZ,0,0,43053054,Africa,0,0
2020-02-01,Algeria,DZ,0,0,43053054,Africa,0,0
2020-02-02,Algeria,DZ,0,0,43053054,Africa,0,0
2020-02-03,Algeria,DZ,0,0,43053054,Africa,0,0
2020-02-04,Algeria,DZ,0,0,43053054,Africa,0,0
2020-02-05,Algeria,DZ,0,0,43053054,Africa,0,0
2020-02-06,Algeria,DZ,0,0,43053054,Africa,0,0
2020-02-07,Algeria,DZ,0,0,43053054,Africa,0,0
2020-02-08,Algeria,DZ,0,0,43053054,Africa,0,0
2020-02-09,Algeria,DZ,0,0,43053054,Africa,0,0
2020-02-10,Algeria,DZ,0,0,43053054,Africa,0,0
2020-02-11,Algeria,DZ,0,0,43053054,Africa,0,0
2020-02-12,Algeria,DZ,0,0,43053054,Africa,0,0
2020-02-13,Algeria,DZ,0,0,43053054,Africa,0,0
2020-02-14,Algeria,DZ,0,0,43053054,Africa,0,0
2020-02-15,Algeria,DZ,0,0,43053054,Africa,0,0
2020-02-16,Algeria,DZ,0,0,43053054,Africa,0,0
2020-02-17,Algeria,DZ,0,0,43053054,Africa,0,0
2020-02-18,Algeria,DZ,0,0,43053054,Africa,0,0
2020-02-19,Algeria,DZ,0,0,43053054,Africa,0,0
2020-02-20,Algeria,DZ,0,0,43053054,Africa,0,0
2020-02-21,Algeria,DZ,0,0,43053054,Africa,0,0
2020-02-22,Algeria,DZ,0,0,43053054,Africa,0,0
2020-02-23,Algeria,DZ,0,0,43053054,Africa,0,0
2020-02-24,Algeria,DZ,0,0,43053054,Africa,0,0
2020-02-25,Algeria,DZ,0,0,43053054,Africa,0,0
2020-02-26,Algeria,DZ,1,0,43053054,Africa,1,0
2020-02-27,Algeria,DZ,0,0,43053054,Africa,1,0
2020-02-28,Algeria,DZ,0,0,43053054,Africa,1,0
2020-02-29,Algeria,DZ,0,0,43053054,Africa,1,0
2020-03-01,Algeria,DZ,2,0,43053054,Africa,3,0
2020-03-02,Algeria,DZ,0,0,43053054,Africa,3,0
2020-03-04,Algeria,DZ,2,0,43053054,Africa,5,0
2020-03-05,Algeria,DZ,7,0,43053054,Africa,12,0
2020-03-06,Algeria,DZ,5,0,43053054,Africa,17,0
2020-03-09,Algeria,DZ,3,0,43053054,Africa,20,0
2020-03-12,Algeria,DZ,0,0,43053054,Africa,20,0
2020-03-13,Algeria,DZ,5,1,43053054,Africa,25,1
2020-03-14,Algeria,DZ,1,1,43053054,Africa,26,2
2020-03-15,Algeria,DZ,11,0,43053054,Africa,37,2
2020-03-16,Algeria,DZ,11,2,43053054,Africa,48,4
2020-03-17,Algeria,DZ,10,0,43053054,Africa,58,4
2020-03-18,Algeria,DZ,2,1,43053054,Africa,60,5
2020-03-19,Algeria,DZ,12,1,43053054,Africa,72,6
2020-03-20,Algeria,DZ,18,1,43053054,Africa,90,7
2020-03-21,Algeria,DZ,12,3,43053054,Africa,102,10
2020-03-22,Algeria,DZ,37,5,43053054,Africa,139,15
2020-03-23,Algeria,DZ,62,2,43053054,Africa,201,17
2020-03-24,Algeria,DZ,29,0,43053054,Africa,230,17
2020-03-25,Algeria,DZ,34,2,43053054,Africa,264,19
2020-03-26,Algeria,DZ,38,2,43053054,Africa,302,21
2020-03-27,Algeria,DZ,65,4,43053054,Africa,367,25
2020-03-28,Algeria,DZ,42,1,43053054,Africa,409,26
2020-03-29,Algeria,DZ,45,3,43053054,Africa,454,29
2020-03-30,Algeria,DZ,57,2,43053054,Africa,511,31
2020-03-31,Algeria,DZ,73,4,43053054,Africa,584,35
2020-04-01,Algeria,DZ,132,9,43053054,Africa,716,44
2020-04-02,Algeria,DZ,131,14,43053054,Africa,847,58
2020-04-03,Algeria,DZ,139,5,43053054,Africa,986,63
2020-04-04,Algeria,DZ,185,42,43053054,Africa,1171,105
2020-04-05,Algeria,DZ,80,25,43053054,Africa,1251,130
2020-04-06,Algeria,DZ,69,22,43053054,Africa,1320,152
2020-04-07,Algeria,DZ,103,21,43053054,Africa,1423,173
2020-04-08,Algeria,DZ,45,20,43053054,Africa,1468,193
2020-04-09,Algeria,DZ,104,12,43053054,Africa,1572,205
2020-04-10,Algeria,DZ,94,30,43053054,Africa,1666,235
2020-04-11,Algeria,DZ,95,21,43053054,Africa,1761,256
2020-04-12,Algeria,DZ,64,19,43053054,Africa,1825,275
2020-04-13,Algeria,DZ,89,18,43053054,Africa,1914,293
2020-04-14,Algeria,DZ,69,20,43053054,Africa,1983,313
2020-04-15,Algeria,DZ,87,12,43053054,Africa,2070,325
2020-04-16,Algeria,DZ,90,11,43053054,Africa,2160,336
2020-04-17,Algeria,DZ,108,12,43053054,Africa,2268,348
2020-04-18,Algeria,DZ,150,16,43053054,Africa,2418,364
2020-04-19,Algeria,DZ,117,3,43053054,Africa,2535,367
2020-04-20,Algeria,DZ,94,8,43053054,Africa,2629,375
2020-04-21,Algeria,DZ,89,9,43053054,Africa,2718,384
2020-04-22,Algeria,DZ,93,8,43053054,Africa,2811,392
2020-04-23,Algeria,DZ,99,10,43053054,Africa,2910,402
2020-04-24,Algeria,DZ,97,5,43053054,Africa,3007,407
2020-04-25,Algeria,DZ,120,8,43053054,Africa,3127,415
2020-04-26,Algeria,DZ,129,4,43053054,Africa,3256,419
2020-04-27,Algeria,DZ,126,6,43053054,Africa,3382,425
2020-04-28,Algeria,DZ,135,7,43053054,Africa,3517,432
2020-04-29,Algeria,DZ,132,5,43053054,Africa,3649,437
2020-04-30,Algeria,DZ,199,7,43053054,Africa,3848,444
2020-05-01,Algeria,DZ,158,6,43053054,Africa,4006,450
2020-05-02,Algeria,DZ,148,3,43053054,Africa,4154,453
2020-05-03,Algeria,DZ,141,6,43053054,Africa,4295,459
2020-05-04,Algeria,DZ,179,4,43053054,Africa,4474,463
2020-05-05,Algeria,DZ,174,2,43053054,Africa,4648,465
2020-05-06,Algeria,DZ,190,5,43053054,Africa,4838,470
2020-05-07,Algeria,DZ,159,6,43053054,Africa,4997,476
2020-05-08,Algeria,DZ,185,7,43053054,Africa,5182,483
2020-05-09,Algeria,DZ,187,5,43053054,Africa,5369,488
2020-05-10,Algeria,DZ,189,6,43053054,Africa,5558,494
2020-05-11,Algeria,DZ,165,8,43053054,Africa,5723,502
2020-05-12,Algeria,DZ,168,5,43053054,Africa,5891,507
2020-05-13,Algeria,DZ,176,8,43053054,Africa,6067,515
2020-05-14,Algeria,DZ,186,7,43053054,Africa,6253,522
2020-05-15,Algeria,DZ,189,7,43053054,Africa,6442,529
2020-05-16,Algeria,DZ,187,7,43053054,Africa,6629,536
2020-05-17,Algeria,DZ,192,6,43053054,Africa,6821,542
2020-05-18,Algeria,DZ,198,6,43053054,Africa,7019,548
2020-05-19,Algeria,DZ,182,7,43053054,Africa,7201,555
2020-05-20,Algeria,DZ,176,6,43053054,Africa,7377,561
2020-05-21,Algeria,DZ,165,7,43053054,Africa,7542,568
2020-05-22,Algeria,DZ,186,7,43053054,Africa,7728,575
2020-05-23,Algeria,DZ,190,7,43053054,Africa,7918,582
2020-05-24,Algeria,DZ,195,10,43053054,Africa,8113,592
2020-05-25,Algeria,DZ,193,8,43053054,Africa,8306,600
2020-05-26,Algeria,DZ,197,9,43053054,Africa,8503,609
2020-05-27,Algeria,DZ,194,8,43053054,Africa,8697,617
2020-05-28,Algeria,DZ,160,6,43053054,Africa,8857,623
2020-05-29,Algeria,DZ,140,7,43053054,Africa,8997,630
2020-05-30,Algeria,DZ,137,8,43053054,Africa,9134,638
2020-05-31,Algeria,DZ,133,8,43053054,Africa,9267,646
2020-06-01,Algeria,DZ,127,7,43053054,Africa,9394,653
2020-06-02,Algeria,DZ,119,8,43053054,Africa,9513,661
2020-06-03,Algeria,DZ,113,6,43053054,Africa,9626,667
2020-06-04,Algeria,DZ,0,0,43053054,Africa,9626,667
2020-06-05,Algeria,DZ,205,14,43053054,Africa,9831,681
2020-06-06,Algeria,DZ,104,9,43053054,Africa,9935,690
2020-06-07,Algeria,DZ,115,8,43053054,Africa,10050,698
2020-06-08,Algeria,DZ,104,9,43053054,Africa,10154,707
2020-06-09,Algeria,DZ,111,8,43053054,Africa,10265,715
2020-06-10,Algeria,DZ,117,9,43053054,Africa,10382,724
2020-06-11,Algeria,DZ,102,8,43053054,Africa,10484,732
2020-06-12,Algeria,DZ,105,9,43053054,Africa,10589,741
2020-06-13,Algeria,DZ,109,10,43053054,Africa,10698,751
2020-06-14,Algeria,DZ,112,9,43053054,Africa,10810,760
2020-06-15,Algeria,DZ,109,7,43053054,Africa,10919,767
2020-06-16,Algeria,DZ,112,10,43053054,Africa,11031,777
2020-06-17,Algeria,DZ,116,11,43053054,Africa,11147,788
2020-06-18,Algeria,DZ,121,11,43053054,Africa,11268,799
2020-06-19,Algeria,DZ,117,12,43053054,Africa,11385,811
2020-06-20,Algeria,DZ,119,14,43053054,Africa,11504,825
2020-06-21,Algeria,DZ,127,12,43053054,Africa,11631,837
2020-06-22,Algeria,DZ,140,8,43053054,Africa,11771,845
2020-06-23,Algeria,DZ,149,7,43053054,Africa,11920,852
2020-06-24,Algeria,DZ,156,9,43053054,Africa,12076,861
2020-06-25,Algeria,DZ,172,8,43053054,Africa,12248,869
2020-06-26,Algeria,DZ,197,9,43053054,Africa,12445,878
2020-06-27,Algeria,DZ,240,7,43053054,Africa,12685,885
2020-06-28,Algeria,DZ,283,7,43053054,Africa,12968,892
2020-06-29,Algeria,DZ,305,5,43053054,Africa,13273,897
2020-06-30,Algeria,DZ,298,8,43053054,Africa,13571,905
2020-07-01,Algeria,DZ,336,7,43053054,Africa,13907,912
2020-07-02,Algeria,DZ,365,8,43053054,Africa,14272,920
2020-07-03,Algeria,DZ,385,8,43053054,Africa,14657,928
2020-07-04,Algeria,DZ,413,9,43053054,Africa,15070,937
2020-07-05,Algeria,DZ,430,9,43053054,Africa,15500,946
2020-07-06,Algeria,DZ,441,6,43053054,Africa,15941,952
2020-07-07,Algeria,DZ,463,7,43053054,Africa,16404,959
2020-07-08,Algeria,DZ,475,9,43053054,Africa,16879,968
2020-07-09,Algeria,DZ,469,10,43053054,Africa,17348,978
2020-07-10,Algeria,DZ,460,10,43053054,Africa,17808,988
2020-07-11,Algeria,DZ,434,8,43053054,Africa,18242,996
2020-07-12,Algeria,DZ,470,8,43053054,Africa,18712,1004
2020-07-13,Algeria,DZ,483,7,43053054,Africa,19195,1011
2020-07-14,Algeria,DZ,494,7,43053054,Africa,19689,1018
2020-07-15,Algeria,DZ,527,10,43053054,Africa,20216,1028
2020-07-16,Algeria,DZ,554,12,43053054,Africa,20770,1040
2020-07-17,Algeria,DZ,585,12,43053054,Africa,21355,1052
2020-07-18,Algeria,DZ,593,5,43053054,Africa,21948,1057
2020-07-19,Algeria,DZ,601,11,43053054,Africa,22549,1068
2020-07-20,Algeria,DZ,535,10,43053054,Africa,23084,1078
2020-07-21,Algeria,DZ,607,9,43053054,Africa,23691,1087
2020-07-22,Algeria,DZ,587,13,43053054,Africa,24278,1100
2020-07-23,Algeria,DZ,594,11,43053054,Africa,24872,1111
2020-07-24,Algeria,DZ,612,13,43053054,Africa,25484,1124
2020-07-25,Algeria,DZ,675,12,43053054,Africa,26159,1136
2020-07-26,Algeria,DZ,605,10,43053054,Africa,26764,1146
2020-07-27,Algeria,DZ,593,9,43053054,Africa,27357,1155
2020-07-28,Algeria,DZ,616,8,43053054,Africa,27973,1163
2020-07-29,Algeria,DZ,642,11,43053054,Africa,28615,1174
2020-07-30,Algeria,DZ,614,12,43053054,Africa,29229,1186
2020-07-31,Algeria,DZ,602,14,43053054,Africa,29831,1200
2020-08-01,Algeria,DZ,563,10,43053054,Africa,30394,1210
2020-08-02,Algeria,DZ,556,13,43053054,Africa,30950,1223
2020-08-03,Algeria,DZ,515,8,43053054,Africa,31465,1231
2020-08-04,Algeria,DZ,507,8,43053054,Africa,31972,1239
2020-08-05,Algeria,DZ,532,9,43053054,Africa,32504,1248
2020-08-06,Algeria,DZ,551,13,43053054,Africa,33055,1261
2020-08-07,Algeria,DZ,571,12,43053054,Africa,33626,1273
2020-08-08,Algeria,DZ,529,9,43053054,Africa,34155,1282
2020-08-09,Algeria,DZ,538,11,43053054,Africa,34693,1293
2020-08-10,Algeria,DZ,521,9,43053054,Africa,35214,1302
2020-08-11,Algeria,DZ,498,10,43053054,Africa,35712,1312
2020-08-12,Algeria,DZ,492,10,43053054,Africa,36204,1322
2020-08-13,Algeria,DZ,495,11,43053054,Africa,36699,1333
2020-08-14,Algeria,DZ,488,8,43053054,Africa,37187,1341
2020-08-15,Algeria,DZ,477,10,43053054,Africa,37664,1351
2020-08-16,Algeria,DZ,469,9,43053054,Africa,38133,1360
2020-08-17,Algeria,DZ,450,10,43053054,Africa,38583,1370
2020-08-18,Algeria,DZ,442,9,43053054,Africa,39025,1379
2020-08-19,Algeria,DZ,419,12,43053054,Africa,39444,1391
2020-08-20,Algeria,DZ,403,11,43053054,Africa,39847,1402
2020-08-21,Algeria,DZ,411,9,43053054,Africa,40258,1411
2020-08-22,Algeria,DZ,409,7,43053054,Africa,40667,1418
2020-08-23,Algeria,DZ,401,6,43053054,Africa,41068,1424
2020-08-24,Algeria,DZ,392,11,43053054,Africa,41460,1435
2020-08-25,Algeria,DZ,398,11,43053054,Africa,41858,1446
2020-08-26,Algeria,DZ,370,10,43053054,Africa,42228,1456
2020-08-27,Algeria,DZ,391,9,43053054,Africa,42619,1465
2020-08-28,Algeria,DZ,397,10,43053054,Africa,43016,1475
2020-08-29,Algeria,DZ,387,8,43053054,Africa,43403,1483
2020-08-30,Algeria,DZ,379,8,43053054,Africa,43782,1491
2020-08-31,Algeria,DZ,364,10,43053054,Africa,44146,1501
2020-09-01,Algeria,DZ,348,9,43053054,Africa,44494,1510
2020-09-02,Algeria,DZ,339,8,43053054,Africa,44833,1518
2020-09-03,Algeria,DZ,325,7,43053054,Africa,45158,1525
2020-09-04,Algeria,DZ,311,6,43053054,Africa,45469,1531
2020-09-05,Algeria,DZ,304,8,43053054,Africa,45773,1539
2020-09-06,Algeria,DZ,298,10,43053054,Africa,46071,1549
2020-09-07,Algeria,DZ,293,7,43053054,Africa,46364,1556
2020-09-08,Algeria,DZ,289,6,43053054,Africa,46653,1562
2020-09-09,Algeria,DZ,285,9,43053054,Africa,46938,1571
2020-09-10,Algeria,DZ,278,10,43053054,Africa,47216,1581
2020-09-11,Algeria,DZ,272,10,43053054,Africa,47488,1591
2020-09-12,Algeria,DZ,264,8,43053054,Africa,47752,1599
2020-09-13,Algeria,DZ,255,6,43053054,Africa,48007,1605
2020-09-14,Algeria,DZ,247,7,43053054,Africa,48254,1612
2020-09-15,Algeria,DZ,242,8,43053054,Africa,48496,1620
2020-09-16,Algeria,DZ,238,12,43053054,Africa,48734,1632
2020-09-17,Algeria,DZ,232,13,43053054,Africa,48966,1645
2020-09-18,Algeria,DZ,228,9,43053054,Africa,49194,1654
2020-09-19,Algeria,DZ,219,5,43053054,Africa,49413,1659
2020-09-20,Algeria,DZ,210,6,43053054,Africa,49623,1665
2020-09-21,Algeria,DZ,203,7,43053054,Africa,49826,1672
2020-09-22,Algeria,DZ,197,7,43053054,Africa,50023,1679
2020-09-23,Algeria,DZ,191,10,43053054,Africa,50214,1689
2020-09-24,Algeria,DZ,186,9,43053054,Africa,50400,1698
2020-09-25,Algeria,DZ,179,5,43053054,Africa,50579,1703
2020-09-26,Algeria,DZ,175,4,43053054,Africa,50754,1707
2020-09-27,Algeria,DZ,160,4,43053054,Africa,50914,1711
2020-09-28,Algeria,DZ,153,3,43053054,Africa,51067,1714
2020-09-29,Algeria,DZ,146,5,43053054,Africa,51213,1719
2020-09-30,Algeria,DZ,155,7,43053054,Africa,51368,1726
2020-10-01,Algeria,DZ,162,8,43053054,Africa,51530,1734
2020-10-02,Algeria,DZ,160,7,43053054,Africa,51690,1741
2020-10-03,Algeria,DZ,157,8,43053054,Africa,51847,1749
2020-10-04,Algeria,DZ,148,7,43053054,Africa,51995,1756
2020-10-05,Algeria,DZ,141,4,43053054,Africa,52136,1760
2020-10-06,Algeria,DZ,134,8,43053054,Africa,52270,1768
2020-10-07,Algeria,DZ,129,5,43053054,Africa,52399,1773
2020-10-08,Algeria,DZ,121,6,43053054,Africa,52520,1779
2020-10-09,Algeria,DZ,138,4,43053054,Africa,52658,1783
2020-10-10,Algeria,DZ,146,6,43053054,Africa,52804,1789
2020-10-11,Algeria,DZ,136,6,43053054,Africa,52940,1795
2020-10-12,Algeria,DZ,132,6,43053054,Africa,53072,1801
2020-10-13,Algeria,DZ,153,8,43053054,Africa,53225,1809
2020-10-14,Algeria,DZ,174,9,43053054,Africa,53399,1818
2020-10-15,Algeria,DZ,185,9,43053054,Africa,53584,1827
2020-10-16,Algeria,DZ,193,9,43053054,Africa,53777,1836
2020-10-17,Algeria,DZ,211,5,43053054,Africa,53988,1841
2020-10-18,Algeria,DZ,215,5,43053054,Africa,54203,1846
2020-10-19,Algeria,DZ,199,10,43053054,Africa,54402,1856
2020-10-20,Algeria,DZ,214,9,43053054,Africa,54616,1865
2020-10-21,Algeria,DZ,223,0,43053054,Africa,54839,1865
2020-10-22,Algeria,DZ,252,15,43053054,Africa,55091,1880
2020-10-23,Algeria,DZ,266,8,43053054,Africa,55357,1888
2020-10-24,Algeria,DZ,273,9,43053054,Africa,55630,1897
2020-10-25,Algeria,DZ,250,10,43053054,Africa,55880,1907
2020-10-26,Algeria,DZ,263,7,43053054,Africa,56143,1914
2020-10-27,Algeria,DZ,276,8,43053054,Africa,56419,1922
2020-10-28,Algeria,DZ,287,9,43053054,Africa,56706,1931
2020-10-29,Algeria,DZ,320,10,43053054,Africa,57026,1941
2020-10-30,Algeria,DZ,306,8,43053054,Africa,57332,1949
2020-10-31,Algeria,DZ,319,7,43053054,Africa,57651,1956
2020-11-01,Algeria,DZ,291,8,43053054,Africa,57942,1964
2020-11-02,Algeria,DZ,330,9,43053054,Africa,58272,1973
2020-11-03,Algeria,DZ,302,7,43053054,Africa,58574,1980
2020-11-04,Algeria,DZ,405,9,43053054,Africa,58979,1989
2020-11-05,Algeria,DZ,548,10,43053054,Africa,59527,1999
2020-11-06,Algeria,DZ,642,12,43053054,Africa,60169,2011
2020-11-07,Algeria,DZ,631,13,43053054,Africa,60800,2024
2020-11-08,Algeria,DZ,581,12,43053054,Africa,61381,2036
2020-11-09,Algeria,DZ,670,12,43053054,Africa,62051,2048
2020-11-10,Algeria,DZ,642,14,43053054,Africa,62693,2062
2020-11-11,Algeria,DZ,753,15,43053054,Africa,63446,2077
2020-11-12,Algeria,DZ,811,16,43053054,Africa,64257,2093
2020-11-13,Algeria,DZ,851,18,43053054,Africa,65108,2111
2020-11-14,Algeria,DZ,867,14,43053054,Africa,65975,2125
2020-11-15,Algeria,DZ,844,14,43053054,Africa,66819,2139
2020-11-16,Algeria,DZ,860,15,43053054,Africa,67679,2154
2020-11-17,Algeria,DZ,910,14,43053054,Africa,68589,2168
2020-11-18,Algeria,DZ,1002,18,43053054,Africa,69591,2186
2020-11-19,Algeria,DZ,1038,20,43053054,Africa,70629,2206
2020-11-20,Algeria,DZ,1023,18,43053054,Africa,71652,2224
2020-11-21,Algeria,DZ,1103,15,43053054,Africa,72755,2239
2020-11-22,Algeria,DZ,1019,1,43053054,Africa,73774,2240
2020-11-23,Algeria,DZ,1088,35,43053054,Africa,74862,2275
2020-11-24,Algeria,DZ,1005,19,43053054,Africa,75867,2294
2020-11-25,Algeria,DZ,1133,15,43053054,Africa,77000,2309
2020-11-26,Algeria,DZ,1025,20,43053054,Africa,78025,2329
2020-11-27,Algeria,DZ,1085,23,43053054,Africa,79110,2352
2020-11-28,Algeria,DZ,1058,20,43053054,Africa,80168,2372
2020-11-29,Algeria,DZ,1044,21,43053054,Africa,81212,2393
2020-11-30,Algeria,DZ,1009,17,43053054,Africa,82221,2410
2020-12-01,Algeria,DZ,968,21,43053054,Africa,83189,2431
2020-12-02,Algeria,DZ,963,16,43053054,Africa,84152,2447
2020-12-03,Algeria,DZ,932,17,43053054,Africa,85084,2464
2020-12-04,Algeria,DZ,843,16,43053054,Africa,85927,2480
2020-12-05,Algeria,DZ,803,12,43053054,Africa,86730,2492
2020-12-06,Algeria,DZ,772,9,43053054,Africa,87502,2501
2020-12-07,Algeria,DZ,750,15,43053054,Africa,88252,2516
2020-12-08,Algeria,DZ,573,11,43053054,Africa,88825,2527
2020-12-09,Algeria,DZ,591,12,43053054,Africa,89416,2539
2020-12-10,Algeria,DZ,598,15,43053054,Africa,90014,2554
2020-12-11,Algeria,DZ,565,10,43053054,Africa,90579,2564
2020-12-12,Algeria,DZ,542,11,43053054,Africa,91121,2575
2020-12-13,Algeria,DZ,517,9,43053054,Africa,91638,2584
2020-12-14,Algeria,DZ,464,12,43053054,Africa,92102,2596
2019-12-31,Ecuador,EC,0,0,17373657,America,0,0
2020-01-01,Ecuador,EC,0,0,17373657,America,0,0
2020-01-02,Ecuador,EC,0,0,17373657,America,0,0
2020-01-03,Ecuador,EC,0,0,17373657,America,0,0
2020-01-04,Ecuador,EC,0,0,17373657,America,0,0
2020-01-05,Ecuador,EC,0,0,17373657,America,0,0
2020-01-06,Ecuador,EC,0,0,17373657,America,0,0
2020-01-07,Ecuador,EC,0,0,17373657,America,0,0
2020-01-08,Ecuador,EC,0,0,17373657,America,0,0
2020-01-09,Ecuador,EC,0,0,17373657,America,0,0
2020-01-10,Ecuador,EC,0,0,17373657,America,0,0
2020-01-11,Ecuador,EC,0,0,17373657,America,0,0
2020-01-12,Ecuador,EC,0,0,17373657,America,0,0
2020-01-13,Ecuador,EC,0,0,17373657,America,0,0
2020-01-14,Ecuador,EC,0,0,17373657,America,0,0
2020-01-15,Ecuador,EC,0,0,17373657,America,0,0
2020-01-16,Ecuador,EC,0,0,17373657,America,0,0
2020-01-17,Ecuador,EC,0,0,17373657,America,0,0
2020-01-18,Ecuador,EC,0,0,17373657,America,0,0
2020-01-19,Ecuador,EC,0,0,17373657,America,0,0
2020-01-20,Ecuador,EC,0,0,17373657,America,0,0
2020-01-21,Ecuador,EC,0,0,17373657,America,0,0
2020-01-22,Ecuador,EC,0,0,17373657,America,0,0
2020-01-23,Ecuador,EC,0,0,17373657,America,0,0
2020-01-24,Ecuador,EC,0,0,17373657,America,0,0
2020-01-25,Ecuador,EC,0,0,17373657,America,0,0
2020-01-26,Ecuador,EC,0,0,17373657,America,0,0
2020-01-27,Ecuador,EC,0,0,17373657,America,0,0
2020-01-28,Ecuador,EC,0,0,17373657,America,0,0
2020-01-29,Ecuador,EC,0,0,17373657,America,0,0
2020-01-30,Ecuador,EC,0,0,17373657,America,0,0
2020-01-31,Ecuador,EC,0,0,17373657,America,0,0
2020-02-01,Ecuador,EC,0,0,17373657,America,0,0
2020-02-02,Ecuador,EC,0,0,17373657,America,0,0
2020-02-03,Ecuador,EC,0,0,17373657,America,0,0
2020-02-04,Ecuador,EC,0,0,17373657,America,0,0
2020-02-05,Ecuador,EC,0,0,17373657,America,0,0
2020-02-06,Ecuador,EC,0,0,17373657,America,0,0
2020-02-07,Ecuador,EC,0,0,17373657,America,0,0
2020-02-08,Ecuador,EC,0,0,17373657,America,0,0
2020-02-09,Ecuador,EC,0,0,17373657,America,0,0
2020-02-10,Ecuador,EC,0,0,17373657,America,0,0
2020-02-11,Ecuador,EC,0,0,17373657,America,0,0
2020-02-12,Ecuador,EC,0,0,17373657,America,0,0
2020-02-13,Ecuador,EC,0,0,17373657,America,0,0
2020-02-14,Ecuador,EC,0,0,17373657,America,0,0
2020-02-15,Ecuador,EC,0,0,17373657,America,0,0
2020-02-16,Ecuador,EC,0,0,17373657,America,0,0
2020-02-17,Ecuador,EC,0,0,17373657,America,0,0
2020-02-18,Ecuador,EC,0,0,17373657,America,0,0
2020-02-19,Ecuador,EC,0,0,17373657,America,0,0
2020-02-20,Ecuador,EC,0,0,17373657,America,0,0
2020-02-21,Ecuador,EC,0,0,17373657,America,0,0
2020-02-22,Ecuador,EC,0,0,17373657,America,0,0
2020-02-23,Ecuador,EC,0,0,17373657,America,0,0
2020-02-24,Ecuador,EC,0,0,17373657,America,0,0
2020-02-25,Ecuador,EC,0,0,17373657,America,0,0
2020-02-26,Ecuador,EC,0,0,17373657,America,0,0
2020-02-27,Ecuador,EC,0,0,17373657,America,0,0
2020-02-28,Ecuador,EC,0,0,17373657,America,0,0
2020-02-29,Ecuador,EC,0,0,17373657,America,0,0
2020-03-01,Ecuador,EC,1,0,17373657,America,1,0
2020-03-02,Ecuador,EC,5,0,17373657,America,6,0
2020-03-03,Ecuador,EC,1,0,17373657,America,7,0
2020-03-05,Ecuador,EC,3,0,17373657,America,10,0
2020-03-06,Ecuador,EC,3,0,17373657,America,13,0
2020-03-09,Ecuador,EC,1,0,17373657,America,14,0
2020-03-10,Ecuador,EC,1,0,17373657,America,15,0
2020-03-11,Ecuador,EC,2,0,17373657,America,17,0
2020-03-14,Ecuador,EC,6,1,17373657,America,23,1
2020-03-15,Ecuador,EC,5,1,17373657,America,28,2
2020-03-16,Ecuador,EC,9,0,17373657,America,37,2
2020-03-17,Ecuador,EC,21,0,17373657,America,58,2
2020-03-18,Ecuador,EC,53,0,17373657,America,111,2
2020-03-19,Ecuador,EC,57,1,17373657,America,168,3
2020-03-20,Ecuador,EC,31,0,17373657,America,199,3
2020-03-21,Ecuador,EC,227,4,17373657,America,426,7
2020-03-22,Ecuador,EC,106,0,17373657,America,532,7
2020-03-23,Ecuador,EC,257,7,17373657,America,789,14
2020-03-24,Ecuador,EC,192,4,17373657,America,981,18
2020-03-25,Ecuador,EC,101,9,17373657,America,1082,27
2020-03-26,Ecuador,EC,129,2,17373657,America,1211,29
2020-03-27,Ecuador,EC,192,5,17373657,America,1403,34
2020-03-28,Ecuador,EC,224,7,17373657,America,1627,41
2020-03-29,Ecuador,EC,208,7,17373657,America,1835,48
2020-03-30,Ecuador,EC,55,10,17373657,America,1890,58
2020-03-31,Ecuador,EC,76,4,17373657,America,1966,62
2020-04-01,Ecuador,EC,336,17,17373657,America,2302,79
2020-04-02,Ecuador,EC,456,41,17373657,America,2758,120
2020-04-03,Ecuador,EC,405,0,17373657,America,3163,120
2020-04-04,Ecuador,EC,205,25,17373657,America,3368,145
2020-04-05,Ecuador,EC,97,27,17373657,America,3465,172
2020-04-06,Ecuador,EC,181,8,17373657,America,3646,180
2020-04-07,Ecuador,EC,101,11,17373657,America,3747,191
2020-04-08,Ecuador,EC,248,29,17373657,America,3995,220
2020-04-09,Ecuador,EC,455,22,17373657,America,4450,242
2020-04-10,Ecuador,EC,515,30,17373657,America,4965,272
2020-04-11,Ecuador,EC,2196,25,17373657,America,7161,297
2020-04-12,Ecuador,EC,96,18,17373657,America,7257,315
2020-04-13,Ecuador,EC,209,18,17373657,America,7466,333
2020-04-14,Ecuador,EC,63,22,17373657,America,7529,355
2020-04-15,Ecuador,EC,74,0,17373657,America,7603,355
2020-04-16,Ecuador,EC,255,33,17373657,America,7858,388
2020-04-17,Ecuador,EC,367,15,17373657,America,8225,403
2020-04-18,Ecuador,EC,225,18,17373657,America,8450,421
2020-04-19,Ecuador,EC,572,35,17373657,America,9022,456
2020-04-20,Ecuador,EC,446,18,17373657,America,9468,474
2020-04-21,Ecuador,EC,660,33,17373657,America,10128,507
2020-04-22,Ecuador,EC,270,13,17373657,America,10398,520
2020-04-23,Ecuador,EC,452,17,17373657,America,10850,537
2020-04-24,Ecuador,EC,333,23,17373657,America,11183,560
2020-04-25,Ecuador,EC,0,16,17373657,America,11183,576
2020-04-26,Ecuador,EC,0,0,17373657,America,11183,576
2020-04-27,Ecuador,EC,11536,0,17373657,America,22719,576
2020-04-28,Ecuador,EC,521,87,17373657,America,23240,663
2020-04-29,Ecuador,EC,1018,208,17373657,America,24258,871
2020-04-30,Ecuador,EC,417,12,17373657,America,24675,883
2020-05-01,Ecuador,EC,259,17,17373657,America,24934,900
2020-05-02,Ecuador,EC,1402,163,17373657,America,26336,1063
2020-05-03,Ecuador,EC,1128,308,17373657,America,27464,1371
2020-05-04,Ecuador,EC,2074,193,17373657,America,29538,1564
2020-05-05,Ecuador,EC,2343,5,17373657,America,31881,1569
2020-05-06,Ecuador,EC,0,0,17373657,America,31881,1569
2020-05-07,Ecuador,EC,-2461,49,17373657,America,29420,1618
2020-05-08,Ecuador,EC,878,36,17373657,America,30298,1654
2020-05-09,Ecuador,EC,-1480,50,17373657,America,28818,1704
2020-05-10,Ecuador,EC,253,13,17373657,America,29071,1717
2020-05-11,Ecuador,EC,488,410,17373657,America,29559,2127
2020-05-12,Ecuador,EC,-50,18,17373657,America,29509,2145
2020-05-13,Ecuador,EC,910,182,17373657,America,30419,2327
2020-05-14,Ecuador,EC,67,7,17373657,America,30486,2334
2020-05-15,Ecuador,EC,16,4,17373657,America,30502,2338
2020-05-16,Ecuador,EC,965,256,17373657,America,31467,2594
2020-05-17,Ecuador,EC,1296,94,17373657,America,32763,2688
2020-05-18,Ecuador,EC,419,48,17373657,America,33182,2736
2020-05-19,Ecuador,EC,400,63,17373657,America,33582,2799
2020-05-20,Ecuador,EC,569,40,17373657,America,34151,2839
2020-05-21,Ecuador,EC,703,49,17373657,America,34854,2888
2020-05-22,Ecuador,EC,452,51,17373657,America,35306,2939
2020-05-23,Ecuador,EC,522,117,17373657,America,35828,3056
2020-05-24,Ecuador,EC,430,40,17373657,America,36258,3096
2020-05-25,Ecuador,EC,498,12,17373657,America,36756,3108
2020-05-26,Ecuador,EC,599,95,17373657,America,37355,3203
2020-05-27,Ecuador,EC,0,0,17373657,America,37355,3203
2020-05-28,Ecuador,EC,748,72,17373657,America,38103,3275
2020-05-29,Ecuador,EC,368,38,17373657,America,38471,3313
2020-05-30,Ecuador,EC,100,21,17373657,America,38571,3334
2020-05-31,Ecuador,EC,0,0,17373657,America,38571,3334
2020-06-01,Ecuador,EC,527,24,17373657,America,39098,3358
2020-06-02,Ecuador,EC,896,36,17373657,America,39994,3394
2020-06-03,Ecuador,EC,420,44,17373657,America,40414,3438
2020-06-04,Ecuador,EC,552,48,17373657,America,40966,3486
2020-06-05,Ecuador,EC,0,0,17373657,America,40966,3486
2020-06-06,Ecuador,EC,609,48,17373657,America,41575,3534
2020-06-07,Ecuador,EC,1153,74,17373657,America,42728,3608
2020-06-08,Ecuador,EC,392,13,17373657,America,43120,3621
2020-06-09,Ecuador,EC,258,21,17373657,America,43378,3642
2020-06-10,Ecuador,EC,539,48,17373657,America,43917,3690
2020-06-11,Ecuador,EC,523,30,17373657,America,44440,3720
2020-06-12,Ecuador,EC,0,0,17373657,America,44440,3720
2020-06-13,Ecuador,EC,1338,108,17373657,America,45778,3828
2020-06-14,Ecuador,EC,578,46,17373657,America,46356,3874
2020-06-15,Ecuador,EC,395,22,17373657,America,46751,3896
2020-06-16,Ecuador,EC,571,33,17373657,America,47322,3929
2020-06-17,Ecuador,EC,621,41,17373657,America,47943,3970
2020-06-18,Ecuador,EC,547,37,17373657,America,48490,4007
2020-06-19,Ecuador,EC,607,80,17373657,America,49097,4087
2020-06-20,Ecuador,EC,634,69,17373657,America,49731,4156
2020-06-21,Ecuador,EC,452,43,17373657,America,50183,4199
2020-06-22,Ecuador,EC,457,24,17373657,America,50640,4223
2020-06-23,Ecuador,EC,0,0,17373657,America,50640,4223
2020-06-24,Ecuador,EC,1003,51,17373657,America,51643,4274
2020-06-25,Ecuador,EC,691,35,17373657,America,52334,4309
2020-06-26,Ecuador,EC,822,34,17373657,America,53156,4343
2020-06-27,Ecuador,EC,700,63,17373657,America,53856,4406
2020-06-28,Ecuador,EC,718,18,17373657,America,54574,4424
2020-06-29,Ecuador,EC,681,5,17373657,America,55255,4429
2020-06-30,Ecuador,EC,410,73,17373657,America,55665,4502
2020-07-01,Ecuador,EC,767,25,17373657,America,56432,4527
2020-07-02,Ecuador,EC,1825,49,17373657,America,58257,4576
2020-07-03,Ecuador,EC,1211,63,17373657,America,59468,4639
2020-07-04,Ecuador,EC,1189,61,17373657,America,60657,4700
2020-07-05,Ecuador,EC,878,69,17373657,America,61535,4769
2020-07-06,Ecuador,EC,423,12,17373657,America,61958,4781
2020-07-07,Ecuador,EC,422,40,17373657,America,62380,4821
2020-07-08,Ecuador,EC,865,52,17373657,America,63245,4873
2020-07-09,Ecuador,EC,976,27,17373657,America,64221,4900
2020-07-10,Ecuador,EC,797,39,17373657,America,65018,4939
2020-07-11,Ecuador,EC,783,44,17373657,America,65801,4983
2020-07-12,Ecuador,EC,1408,48,17373657,America,67209,5031
2020-07-13,Ecuador,EC,661,16,17373657,America,67870,5047
2020-07-14,Ecuador,EC,589,16,17373657,America,68459,5063
2020-07-15,Ecuador,EC,1111,67,17373657,America,69570,5130
2020-07-16,Ecuador,EC,759,28,17373657,America,70329,5158
2020-07-17,Ecuador,EC,1036,49,17373657,America,71365,5207
2020-07-18,Ecuador,EC,1079,43,17373657,America,72444,5250
2020-07-19,Ecuador,EC,938,32,17373657,America,73382,5282
2020-07-20,Ecuador,EC,631,31,17373657,America,74013,5313
2020-07-21,Ecuador,EC,607,5,17373657,America,74620,5318
2020-07-22,Ecuador,EC,1597,48,17373657,America,76217,5366
2020-07-23,Ecuador,EC,1040,52,17373657,America,77257,5418
2020-07-24,Ecuador,EC,891,21,17373657,America,78148,5439
2020-07-25,Ecuador,EC,901,29,17373657,America,79049,5468
2020-07-26,Ecuador,EC,987,39,17373657,America,80036,5507
2020-07-27,Ecuador,EC,658,8,17373657,America,80694,5515
2020-07-28,Ecuador,EC,467,17,17373657,America,81161,5532
2020-07-29,Ecuador,EC,1118,52,17373657,America,82279,5584
2020-07-30,Ecuador,EC,914,39,17373657,America,83193,5623
2020-07-31,Ecuador,EC,1177,34,17373657,America,84370,5657
2020-08-01,Ecuador,EC,985,45,17373657,America,85355,5702
2020-08-02,Ecuador,EC,877,34,17373657,America,86232,5736
2020-08-03,Ecuador,EC,292,14,17373657,America,86524,5750
2020-08-04,Ecuador,EC,517,17,17373657,America,87041,5767
2020-08-05,Ecuador,EC,922,41,17373657,America,87963,5808
2020-08-06,Ecuador,EC,903,39,17373657,America,88866,5847
2020-08-07,Ecuador,EC,1671,40,17373657,America,90537,5887
2020-08-08,Ecuador,EC,1432,10,17373657,America,91969,5897
2020-08-09,Ecuador,EC,1603,19,17373657,America,93572,5916
2020-08-10,Ecuador,EC,887,6,17373657,America,94459,5922
2020-08-11,Ecuador,EC,242,10,17373657,America,94701,5932
2020-08-12,Ecuador,EC,862,19,17373657,America,95563,5951
2020-08-13,Ecuador,EC,1547,33,17373657,America,97110,5984
2020-08-14,Ecuador,EC,1233,26,17373657,America,98343,6010
2020-08-15,Ecuador,EC,1066,20,17373657,America,99409,6030
2020-08-16,Ecuador,EC,1279,35,17373657,America,100688,6065
2020-08-17,Ecuador,EC,854,5,17373657,America,101542,6070
2020-08-18,Ecuador,EC,209,13,17373657,America,101751,6083
2020-08-19,Ecuador,EC,1190,22,17373657,America,102941,6105
2020-08-20,Ecuador,EC,1534,41,17373657,America,104475,6146
2020-08-21,Ecuador,EC,1033,54,17373657,America,105508,6200
2020-08-22,Ecuador,EC,973,48,17373657,America,106481,6248
2020-08-23,Ecuador,EC,608,29,17373657,America,107089,6277
2020-08-24,Ecuador,EC,680,33,17373657,America,107769,6310
2020-08-25,Ecuador,EC,520,12,17373657,America,108289,6322
2020-08-26,Ecuador,EC,741,46,17373657,America,109030,6368
2020-08-27,Ecuador,EC,1519,42,17373657,America,110549,6410
2020-08-28,Ecuador,EC,670,61,17373657,America,111219,6471
2020-08-29,Ecuador,EC,922,33,17373657,America,112141,6504
2020-08-30,Ecuador,EC,765,33,17373657,America,112906,6537
2020-08-31,Ecuador,EC,742,18,17373657,America,113648,6555
2020-09-01,Ecuador,EC,119,1,17373657,America,113767,6556
2020-09-02,Ecuador,EC,542,15,17373657,America,114309,6571
2020-09-03,Ecuador,EC,1148,48,17373657,America,115457,6619
2020-09-04,Ecuador,EC,903,29,17373657,America,116360,6648
2020-09-05,Ecuador,EC,815,26,17373657,America,117175,6674
2020-09-06,Ecuador,EC,870,50,17373657,America,118045,6724
2020-09-07,Ecuador,EC,-8261,3800,17373657,America,109784,10524
2020-09-08,Ecuador,EC,308,52,17373657,America,110092,10576
2020-09-09,Ecuador,EC,665,51,17373657,America,110757,10627
2020-09-10,Ecuador,EC,1409,74,17373657,America,112166,10701
2020-09-11,Ecuador,EC,1040,48,17373657,America,113206,10749
2020-09-12,Ecuador,EC,1526,87,17373657,America,114732,10836
2020-09-13,Ecuador,EC,1719,28,17373657,America,116451,10864
2020-09-14,Ecuador,EC,2143,39,17373657,America,118594,10903
2020-09-15,Ecuador,EC,317,19,17373657,America,118911,10922
2020-09-16,Ecuador,EC,642,41,17373657,America,119553,10963
2020-09-17,Ecuador,EC,1972,33,17373657,America,121525,10996
2020-09-18,Ecuador,EC,732,33,17373657,America,122257,11029
2020-09-19,Ecuador,EC,1872,15,17373657,America,124129,11044
2020-09-20,Ecuador,EC,1491,40,17373657,America,125620,11084
2020-09-21,Ecuador,EC,799,6,17373657,America,126419,11090
2020-09-22,Ecuador,EC,292,5,17373657,America,126711,11095
2020-09-23,Ecuador,EC,932,31,17373657,America,127643,11126
2020-09-24,Ecuador,EC,2249,45,17373657,America,129892,11171
2020-09-25,Ecuador,EC,1254,42,17373657,America,131146,11213
2020-09-26,Ecuador,EC,1329,23,17373657,America,132475,11236
2020-09-27,Ecuador,EC,1506,37,17373657,America,133981,11273
2020-09-28,Ecuador,EC,766,6,17373657,America,134747,11279
2020-09-29,Ecuador,EC,218,1,17373657,America,134965,11280
2020-09-30,Ecuador,EC,784,32,17373657,America,135749,11312
2020-10-01,Ecuador,EC,1298,43,17373657,America,137047,11355
2020-10-02,Ecuador,EC,1537,78,17373657,America,138584,11433
2020-10-03,Ecuador,EC,950,62,17373657,America,139534,11495
2020-10-04,Ecuador,EC,817,102,17373657,America,140351,11597
2020-10-05,Ecuador,EC,683,50,17373657,America,141034,11647
2020-10-06,Ecuador,EC,305,34,17373657,America,141339,11681
2020-10-07,Ecuador,EC,717,21,17373657,America,142056,11702
2020-10-08,Ecuador,EC,1475,41,17373657,America,143531,11743
2020-10-09,Ecuador,EC,1514,398,17373657,America,145045,12141
2020-10-10,Ecuador,EC,803,34,17373657,America,145848,12175
2020-10-11,Ecuador,EC,980,13,17373657,America,146828,12188
2020-10-12,Ecuador,EC,205,3,17373657,America,147033,12191
2020-10-13,Ecuador,EC,282,27,17373657,America,147315,12218
2020-10-14,Ecuador,EC,856,17,17373657,America,148171,12235
2020-10-15,Ecuador,EC,912,29,17373657,America,149083,12264
2020-10-16,Ecuador,EC,1277,42,17373657,America,150360,12306
2020-10-17,Ecuador,EC,1299,51,17373657,America,151659,12357
2020-10-18,Ecuador,EC,763,18,17373657,America,152422,12375
2020-10-19,Ecuador,EC,867,12,17373657,America,153289,12387
2020-10-20,Ecuador,EC,134,8,17373657,America,153423,12395
2020-10-21,Ecuador,EC,692,9,17373657,America,154115,12404
2020-10-22,Ecuador,EC,1510,49,17373657,America,155625,12453
2020-10-23,Ecuador,EC,826,47,17373657,America,156451,12500
2020-10-24,Ecuador,EC,1819,28,17373657,America,158270,12528
2020-10-25,Ecuador,EC,1344,14,17373657,America,159614,12542
2020-10-26,Ecuador,EC,2021,11,17373657,America,161635,12553
2020-10-27,Ecuador,EC,543,20,17373657,America,162178,12573
2020-10-28,Ecuador,EC,1014,15,17373657,America,163192,12588
2020-10-29,Ecuador,EC,1716,20,17373657,America,164908,12608
2020-10-30,Ecuador,EC,1394,14,17373657,America,166302,12622
2020-10-31,Ecuador,EC,845,10,17373657,America,167147,12632
2020-11-01,Ecuador,EC,1045,38,17373657,America,168192,12670
2020-11-02,Ecuador,EC,1002,14,17373657,America,169194,12684
2020-11-03,Ecuador,EC,368,8,17373657,America,169562,12692
2020-11-04,Ecuador,EC,548,6,17373657,America,170110,12698
2020-11-05,Ecuador,EC,1323,6,17373657,America,171433,12704
2020-11-06,Ecuador,EC,350,26,17373657,America,171783,12730
2020-11-07,Ecuador,EC,725,31,17373657,America,172508,12761
2020-11-08,Ecuador,EC,978,54,17373657,America,173486,12815
2020-11-09,Ecuador,EC,1421,15,17373657,America,174907,12830
2020-11-10,Ecuador,EC,362,9,17373657,America,175269,12839
2020-11-11,Ecuador,EC,442,10,17373657,America,175711,12849
2020-11-12,Ecuador,EC,919,71,17373657,America,176630,12920
2020-11-13,Ecuador,EC,883,26,17373657,America,177513,12946
2020-11-14,Ecuador,EC,1161,31,17373657,America,178674,12977
2020-11-15,Ecuador,EC,953,20,17373657,America,179627,12997
2020-11-16,Ecuador,EC,668,11,17373657,America,180295,13008
2020-11-17,Ecuador,EC,381,8,17373657,America,180676,13016
2020-11-18,Ecuador,EC,428,9,17373657,America,181104,13025
2020-11-19,Ecuador,EC,1146,27,17373657,America,182250,13052
2020-11-20,Ecuador,EC,996,21,17373657,America,183246,13073
2020-11-21,Ecuador,EC,594,22,17373657,America,183840,13095
2020-11-22,Ecuador,EC,1036,44,17373657,America,184876,13139
2020-11-23,Ecuador,EC,767,62,17373657,America,185643,13201
2020-11-24,Ecuador,EC,301,24,17373657,America,185944,13225
2020-11-25,Ecuador,EC,492,39,17373657,America,186436,13264
2020-11-26,Ecuador,EC,794,24,17373657,America,187230,13288
2020-11-27,Ecuador,EC,908,28,17373657,America,188138,13316
2020-11-28,Ecuador,EC,1396,42,17373657,America,189534,13358
2020-11-29,Ecuador,EC,1375,13,17373657,America,190909,13371
2020-11-30,Ecuador,EC,1208,52,17373657,America,192117,13423
2020-12-01,Ecuador,EC,568,38,17373657,America,192685,13461
2020-12-02,Ecuador,EC,988,40,17373657,America,193673,13501
2020-12-03,Ecuador,EC,1203,61,17373657,America,194876,13562
2020-12-04,Ecuador,EC,1008,50,17373657,America,195884,13612
2020-12-05,Ecuador,EC,598,84,17373657,America,196482,13696
2020-12-06,Ecuador,EC,909,60,17373657,America,197391,13756
2020-12-07,Ecuador,EC,607,22,17373657,America,197998,13778
2020-12-08,Ecuador,EC,246,2,17373657,America,198244,13780
2020-12-09,Ecuador,EC,508,14,17373657,America,198752,13794
2020-12-10,Ecuador,EC,476,20,17373657,America,199228,13814
2020-12-11,Ecuador,EC,1151,36,17373657,America,200379,13850
2020-12-12,Ecuador,EC,386,8,17373657,America,200765,13858
2020-12-13,Ecuador,EC,759,16,17373657,America,201524,13874
2020-12-14,Ecuador,EC,586,1,17373657,America,202110,13875
2019-12-31,Estonia,EE,0,0,1324820,Europe,0,0
2020-01-01,Estonia,EE,0,0,1324820,Europe,0,0
2020-01-02,Estonia,EE,0,0,1324820,Europe,0,0
2020-01-03,Estonia,EE,0,0,1324820,Europe,0,0
2020-01-04,Estonia,EE,0,0,1324820,Europe,0,0
2020-01-05,Estonia,EE,0,0,1324820,Europe,0,0
2020-01-06,Estonia,EE,0,0,1324820,Europe,0,0
2020-01-07,Estonia,EE,0,0,1324820,Europe,0,0
2020-01-08,Estonia,EE,0,0,1324820,Europe,0,0
2020-01-09,Estonia,EE,0,0,1324820,Europe,0,0
2020-01-10,Estonia,EE,0,0,1324820,Europe,0,0
2020-01-11,Estonia,EE,0,0,1324820,Europe,0,0
2020-01-12,Estonia,EE,0,0,1324820,Europe,0,0
2020-01-13,Estonia,EE,0,0,1324820,Europe,0,0
2020-01-14,Estonia,EE,0,0,1324820,Europe,0,0
2020-01-15,Estonia,EE,0,0,1324820,Europe,0,0
2020-01-16,Estonia,EE,0,0,1324820,Europe,0,0
2020-01-17,Estonia,EE,0,0,1324820,Europe,0,0
2020-01-18,Estonia,EE,0,0,1324820,Europe,0,0
2020-01-19,Estonia,EE,0,0,1324820,Europe,0,0
2020-01-20,Estonia,EE,0,0,1324820,Europe,0,0
2020-01-21,Estonia,EE,0,0,1324820,Europe,0,0
2020-01-22,Estonia,EE,0,0,1324820,Europe,0,0
2020-01-23,Estonia,EE,0,0,1324820,Europe,0,0
2020-01-24,Estonia,EE,0,0,1324820,Europe,0,0
2020-01-25,Estonia,EE,0,0,1324820,Europe,0,0
2020-01-26,Estonia,EE,0,0,1324820,Europe,0,0
2020-01-27,Estonia,EE,0,0,1324820,Europe,0,0
2020-01-28,Estonia,EE,0,0,1324820,Europe,0,0
2020-01-29,Estonia,EE,0,0,1324820,Europe,0,0
2020-01-30,Estonia,EE,0,0,1324820,Europe,0,0
2020-01-31,Estonia,EE,0,0,1324820,Europe,0,0
2020-02-01,Estonia,EE,0,0,1324820,Europe,0,0
2020-02-02,Estonia,EE,0,0,1324820,Europe,0,0
2020-02-03,Estonia,EE,0,0,1324820,Europe,0,0
2020-02-04,Estonia,EE,0,0,1324820,Europe,0,0
2020-02-05,Estonia,EE,0,0,1324820,Europe,0,0
2020-02-06,Estonia,EE,0,0,1324820,Europe,0,0
2020-02-07,Estonia,EE,0,0,1324820,Europe,0,0
2020-02-08,Estonia,EE,0,0,1324820,Europe,0,0
2020-02-09,Estonia,EE,0,0,1324820,Europe,0,0
2020-02-10,Estonia,EE,0,0,1324820,Europe,0,0
2020-02-11,Estonia,EE,0,0,1324820,Europe,0,0
2020-02-12,Estonia,EE,0,0,1324820,Europe,0,0
2020-02-13,Estonia,EE,0,0,1324820,Europe,0,0
2020-02-14,Estonia,EE,0,0,1324820,Europe,0,0
2020-02-15,Estonia,EE,0,0,1324820,Europe,0,0
2020-02-16,Estonia,EE,0,0,1324820,Europe,0,0
2020-02-17,Estonia,EE,0,0,1324820,Europe,0,0
2020-02-18,Estonia,EE,0,0,1324820,Europe,0,0
2020-02-19,Estonia,EE,0,0,1324820,Europe,0,0
2020-02-20,Estonia,EE,0,0,1324820,Europe,0,0
2020-02-21,Estonia,EE,0,0,1324820,Europe,0,0
2020-02-22,Estonia,EE,0,0,1324820,Europe,0,0
2020-02-23,Estonia,EE,0,0,1324820,Europe,0,0
2020-02-24,Estonia,EE,0,0,1324820,Europe,0,0
2020-02-25,Estonia,EE,0,0,1324820,Europe,0,0
2020-02-26,Estonia,EE,0,0,1324820,Europe,0,0
2020-02-27,Estonia,EE,0,0,1324820,Europe,0,0
2020-02-28,Estonia,EE,1,0,1324820,Europe,1,0
2020-02-29,Estonia,EE,0,0,1324820,Europe,1,0
2020-03-01,Estonia,EE,0,0,1324820,Europe,1,0
2020-03-02,Estonia,EE,0,0,1324820,Europe,1,0
2020-03-04,Estonia,EE,1,0,1324820,Europe,2,0
2020-03-06,Estonia,EE,3,0,1324820,Europe,5,0
2020-03-07,Estonia,EE,5,0,1324820,Europe,10,0
2020-03-11,Estonia,EE,3,0,1324820,Europe,13,0
2020-03-12,Estonia,EE,3,0,1324820,Europe,16,0
2020-03-13,Estonia,EE,11,0,1324820,Europe,27,0
2020-03-14,Estonia,EE,52,0,1324820,Europe,79,0
2020-03-15,Estonia,EE,36,0,1324820,Europe,115,0
2020-03-16,Estonia,EE,56,0,1324820,Europe,171,0
2020-03-17,Estonia,EE,34,0,1324820,Europe,205,0
2020-03-18,Estonia,EE,20,0,1324820,Europe,225,0
2020-03-19,Estonia,EE,33,0,1324820,Europe,258,0
2020-03-20,Estonia,EE,9,0,1324820,Europe,267,0
2020-03-21,Estonia,EE,16,0,1324820,Europe,283,0
2020-03-22,Estonia,EE,23,0,1324820,Europe,306,0
2020-03-23,Estonia,EE,20,0,1324820,Europe,326,0
2020-03-24,Estonia,EE,26,0,1324820,Europe,352,0
2020-03-25,Estonia,EE,17,0,1324820,Europe,369,0
2020-03-26,Estonia,EE,35,1,1324820,Europe,404,1
2020-03-27,Estonia,EE,134,0,1324820,Europe,538,1
2020-03-28,Estonia,EE,37,0,1324820,Europe,575,1
2020-03-29,Estonia,EE,65,0,1324820,Europe,640,1
2020-03-30,Estonia,EE,39,2,1324820,Europe,679,3
2020-03-31,Estonia,EE,36,0,1324820,Europe,715,3
2020-04-01,Estonia,EE,30,1,1324820,Europe,745,4
2020-04-02,Estonia,EE,34,1,1324820,Europe,779,5
2020-04-03,Estonia,EE,79,6,1324820,Europe,858,11
2020-04-04,Estonia,EE,103,1,1324820,Europe,961,12
2020-04-05,Estonia,EE,57,1,1324820,Europe,1018,13
2020-04-06,Estonia,EE,79,2,1324820,Europe,1097,15
2020-04-07,Estonia,EE,11,4,1324820,Europe,1108,19
2020-04-08,Estonia,EE,41,2,1324820,Europe,1149,21
2020-04-09,Estonia,EE,36,3,1324820,Europe,1185,24
2020-04-10,Estonia,EE,22,0,1324820,Europe,1207,24
2020-04-11,Estonia,EE,51,0,1324820,Europe,1258,24
2020-04-12,Estonia,EE,46,0,1324820,Europe,1304,24
2020-04-13,Estonia,EE,5,1,1324820,Europe,1309,25
2020-04-14,Estonia,EE,23,3,1324820,Europe,1332,28
2020-04-15,Estonia,EE,41,3,1324820,Europe,1373,31
2020-04-16,Estonia,EE,29,4,1324820,Europe,1402,35
2020-04-17,Estonia,EE,32,1,1324820,Europe,1434,36
2020-04-18,Estonia,EE,25,2,1324820,Europe,1459,38
2020-04-19,Estonia,EE,53,0,1324820,Europe,1512,38
2020-04-20,Estonia,EE,16,2,1324820,Europe,1528,40
2020-04-21,Estonia,EE,7,0,1324820,Europe,1535,40
2020-04-22,Estonia,EE,17,3,1324820,Europe,1552,43
2020-04-23,Estonia,EE,7,1,1324820,Europe,1559,44
2020-04-24,Estonia,EE,33,1,1324820,Europe,1592,45
2020-04-25,Estonia,EE,13,1,1324820,Europe,1605,46
2020-04-26,Estonia,EE,30,0,1324820,Europe,1635,46
2020-04-27,Estonia,EE,8,3,1324820,Europe,1643,49
2020-04-28,Estonia,EE,4,1,1324820,Europe,1647,50
2020-04-29,Estonia,EE,13,0,1324820,Europe,1660,50
2020-04-30,Estonia,EE,6,0,1324820,Europe,1666,50
2020-05-01,Estonia,EE,23,2,1324820,Europe,1689,52
2020-05-02,Estonia,EE,5,0,1324820,Europe,1694,52
2020-05-03,Estonia,EE,5,1,1324820,Europe,1699,53
2020-05-04,Estonia,EE,1,2,1324820,Europe,1700,55
2020-05-05,Estonia,EE,3,0,1324820,Europe,1703,55
2020-05-06,Estonia,EE,8,0,1324820,Europe,1711,55
2020-05-07,Estonia,EE,2,0,1324820,Europe,1713,55
2020-05-08,Estonia,EE,7,1,1324820,Europe,1720,56
2020-05-09,Estonia,EE,5,0,1324820,Europe,1725,56
2020-05-10,Estonia,EE,8,4,1324820,Europe,1733,60
2020-05-11,Estonia,EE,6,0,1324820,Europe,1739,60
2020-05-12,Estonia,EE,2,1,1324820,Europe,1741,61
2020-05-13,Estonia,EE,5,0,1324820,Europe,1746,61
2020-05-14,Estonia,EE,5,0,1324820,Europe,1751,61
2020-05-15,Estonia,EE,7,1,1324820,Europe,1758,62
2020-05-16,Estonia,EE,8,1,1324820,Europe,1766,63
2020-05-17,Estonia,EE,4,0,1324820,Europe,1770,63
2020-05-18,Estonia,EE,4,0,1324820,Europe,1774,63
2020-05-19,Estonia,EE,10,0,1324820,Europe,1784,63
2020-05-20,Estonia,EE,7,0,1324820,Europe,1791,63
2020-05-21,Estonia,EE,3,0,1324820,Europe,1794,63
2020-05-22,Estonia,EE,6,0,1324820,Europe,1800,63
2020-05-23,Estonia,EE,7,0,1324820,Europe,1807,63
2020-05-24,Estonia,EE,14,0,1324820,Europe,1821,63
2020-05-25,Estonia,EE,2,0,1324820,Europe,1823,63
2020-05-26,Estonia,EE,1,0,1324820,Europe,1824,63
2020-05-27,Estonia,EE,10,0,1324820,Europe,1834,63
2020-05-28,Estonia,EE,6,0,1324820,Europe,1840,63
2020-05-29,Estonia,EE,11,0,1324820,Europe,1851,63
2020-05-30,Estonia,EE,8,0,1324820,Europe,1859,63
2020-05-31,Estonia,EE,6,0,1324820,Europe,1865,63
2020-06-01,Estonia,EE,4,0,1324820,Europe,1869,63
2020-06-02,Estonia,EE,1,0,1324820,Europe,1870,63
2020-06-03,Estonia,EE,0,0,1324820,Europe,1870,63
2020-06-04,Estonia,EE,10,0,1324820,Europe,1880,63
2020-06-05,Estonia,EE,10,0,1324820,Europe,1890,63
2020-06-06,Estonia,EE,20,0,1324820,Europe,1910,63
2020-06-07,Estonia,EE,21,0,1324820,Europe,1931,63
2020-06-08,Estonia,EE,8,0,1324820,Europe,1939,63
2020-06-09,Estonia,EE,1,0,1324820,Europe,1940,63
2020-06-10,Estonia,EE,7,0,1324820,Europe,1947,63
2020-06-11,Estonia,EE,11,0,1324820,Europe,1958,63
2020-06-12,Estonia,EE,7,0,1324820,Europe,1965,63
2020-06-13,Estonia,EE,5,0,1324820,Europe,1970,63
2020-06-14,Estonia,EE,3,0,1324820,Europe,1973,63
2020-06-15,Estonia,EE,0,0,1324820,Europe,1973,63
2020-06-16,Estonia,EE,1,0,1324820,Europe,1974,63
2020-06-17,Estonia,EE,1,0,1324820,Europe,1975,63
2020-06-18,Estonia,EE,2,0,1324820,Europe,1977,63
2020-06-19,Estonia,EE,0,0,1324820,Europe,1977,63
2020-06-20,Estonia,EE,2,0,1324820,Europe,1979,63
2020-06-21,Estonia,EE,2,0,1324820,Europe,1981,63
2020-06-22,Estonia,EE,0,0,1324820,Europe,1981,63
2020-06-23,Estonia,EE,0,0,1324820,Europe,1981,63
2020-06-24,Estonia,EE,1,0,1324820,Europe,1982,63
2020-06-25,Estonia,EE,1,0,1324820,Europe,1983,63
2020-06-26,Estonia,EE,1,0,1324820,Europe,1984,63
2020-06-27,Estonia,EE,2,0,1324820,Europe,1986,63
2020-06-28,Estonia,EE,0,0,1324820,Europe,1986,63
2020-06-29,Estonia,EE,1,0,1324820,Europe,1987,63
2020-06-30,Estonia,EE,0,0,1324820,Europe,1987,63
2020-07-01,Estonia,EE,2,0,1324820,Europe,1989,63
2020-07-02,Estonia,EE,0,0,1324820,Europe,1989,63
2020-07-03,Estonia,EE,1,0,1324820,Europe,1990,63
2020-07-04,Estonia,EE,1,0,1324820,Europe,1991,63
2020-07-05,Estonia,EE,2,0,1324820,Europe,1993,63
2020-07-06,Estonia,EE,0,0,1324820,Europe,1993,63
2020-07-07,Estonia,EE,1,0,1324820,Europe,1994,63
2020-07-08,Estonia,EE,1,0,1324820,Europe,1995,63
2020-07-09,Estonia,EE,8,0,1324820,Europe,2003,63
2020-07-10,Estonia,EE,8,0,1324820,Europe,2011,63
2020-07-11,Estonia,EE,2,0,1324820,Europe,2013,63
2020-07-12,Estonia,EE,1,0,1324820,Europe,2014,63
2020-07-13,Estonia,EE,0,0,1324820,Europe,2014,63
2020-07-14,Estonia,EE,0,0,1324820,Europe,2014,63
2020-07-15,Estonia,EE,1,0,1324820,Europe,2015,63
2020-07-16,Estonia,EE,1,0,1324820,Europe,2016,63
2020-07-17,Estonia,EE,0,0,1324820,Europe,2016,63
2020-07-18,Estonia,EE,4,0,1324820,Europe,2020,63
2020-07-19,Estonia,EE,1,0,1324820,Europe,2021,63
2020-07-20,Estonia,EE,0,0,1324820,Europe,2021,63
2020-07-21,Estonia,EE,0,0,1324820,Europe,2021,63
2020-07-22,Estonia,EE,1,0,1324820,Europe,2022,63
2020-07-23,Estonia,EE,3,0,1324820,Europe,2025,63
2020-07-24,Estonia,EE,2,0,1324820,Europe,2027,63
2020-07-25,Estonia,EE,1,0,1324820,Europe,2028,63
2020-07-26,Estonia,EE,5,0,1324820,Europe,2033,63
2020-07-27,Estonia,EE,1,0,1324820,Europe,2034,63
2020-07-28,Estonia,EE,4,0,1324820,Europe,2038,63
2020-07-29,Estonia,EE,0,0,1324820,Europe,2038,63
2020-07-30,Estonia,EE,4,0,1324820,Europe,2042,63
2020-07-31,Estonia,EE,9,0,1324820,Europe,2051,63
2020-08-01,Estonia,EE,13,0,1324820,Europe,2064,63
2020-08-02,Estonia,EE,8,0,1324820,Europe,2072,63
2020-08-03,Estonia,EE,7,0,1324820,Europe,2079,63
2020-08-04,Estonia,EE,1,0,1324820,Europe,2080,63
2020-08-05,Estonia,EE,11,0,1324820,Europe,2091,63
2020-08-06,Estonia,EE,22,0,1324820,Europe,2113,63
2020-08-07,Estonia,EE,11,0,1324820,Europe,2124,63
2020-08-08,Estonia,EE,9,0,1324820,Europe,2133,63
2020-08-09,Estonia,EE,14,0,1324820,Europe,2147,63
2020-08-10,Estonia,EE,5,0,1324820,Europe,2152,63
2020-08-11,Estonia,EE,6,0,1324820,Europe,2158,63
2020-08-12,Estonia,EE,9,0,1324820,Europe,2167,63
2020-08-13,Estonia,EE,7,0,1324820,Europe,2174,63
2020-08-14,Estonia,EE,0,0,1324820,Europe,2174,63
2020-08-15,Estonia,EE,3,0,1324820,Europe,2177,63
2020-08-16,Estonia,EE,7,0,1324820,Europe,2184,63
2020-08-17,Estonia,EE,6,0,1324820,Europe,2190,63
2020-08-18,Estonia,EE,2,0,1324820,Europe,2192,63
2020-08-19,Estonia,EE,8,0,1324820,Europe,2200,63
2020-08-20,Estonia,EE,7,0,1324820,Europe,2207,63
2020-08-21,Estonia,EE,20,0,1324820,Europe,2227,63
2020-08-22,Estonia,EE,17,0,1324820,Europe,2244,63
2020-08-23,Estonia,EE,21,0,1324820,Europe,2265,63
2020-08-24,Estonia,EE,7,0,1324820,Europe,2272,63
2020-08-25,Estonia,EE,3,1,1324820,Europe,2275,64
2020-08-26,Estonia,EE,19,0,1324820,Europe,2294,64
2020-08-27,Estonia,EE,17,0,1324820,Europe,2311,64
2020-08-28,Estonia,EE,14,0,1324820,Europe,2325,64
2020-08-29,Estonia,EE,18,0,1324820,Europe,2343,64
2020-08-30,Estonia,EE,20,0,1324820,Europe,2363,64
2020-08-31,Estonia,EE,10,0,1324820,Europe,2373,64
2020-09-01,Estonia,EE,2,0,1324820,Europe,2375,64
2020-09-02,Estonia,EE,20,0,1324820,Europe,2395,64
2020-09-03,Estonia,EE,20,0,1324820,Europe,2415,64
2020-09-04,Estonia,EE,26,0,1324820,Europe,2441,64
2020-09-05,Estonia,EE,15,0,1324820,Europe,2456,64
2020-09-06,Estonia,EE,34,0,1324820,Europe,2490,64
2020-09-07,Estonia,EE,25,0,1324820,Europe,2515,64
2020-09-08,Estonia,EE,16,0,1324820,Europe,2531,64
2020-09-09,Estonia,EE,32,0,1324820,Europe,2563,64
2020-09-10,Estonia,EE,22,0,1324820,Europe,2585,64
2020-09-11,Estonia,EE,15,0,1324820,Europe,2600,64
2020-09-12,Estonia,EE,32,0,1324820,Europe,2632,64
2020-09-13,Estonia,EE,23,0,1324820,Europe,2655,64
2020-09-14,Estonia,EE,21,0,1324820,Europe,2676,64
2020-09-15,Estonia,EE,22,0,1324820,Europe,2698,64
2020-09-16,Estonia,EE,24,0,1324820,Europe,2722,64
2020-09-17,Estonia,EE,34,0,1324820,Europe,2756,64
2020-09-18,Estonia,EE,22,0,1324820,Europe,2778,64
2020-09-19,Estonia,EE,36,0,1324820,Europe,2814,64
2020-09-20,Estonia,EE,61,0,1324820,Europe,2875,64
2020-09-21,Estonia,EE,49,0,1324820,Europe,2924,64
2020-09-22,Estonia,EE,17,0,1324820,Europe,2941,64
2020-09-23,Estonia,EE,35,0,1324820,Europe,2976,64
2020-09-24,Estonia,EE,57,0,1324820,Europe,3033,64
2020-09-25,Estonia,EE,43,0,1324820,Europe,3076,64
2020-09-26,Estonia,EE,42,0,1324820,Europe,3118,64
2020-09-27,Estonia,EE,47,0,1324820,Europe,3165,64
2020-09-28,Estonia,EE,35,0,1324820,Europe,3200,64
2020-09-29,Estonia,EE,67,0,1324820,Europe,3267,64
2020-09-30,Estonia,EE,48,0,1324820,Europe,3315,64
2020-10-01,Estonia,EE,56,0,1324820,Europe,3371,64
2020-10-02,Estonia,EE,79,1,1324820,Europe,3450,65
2020-10-03,Estonia,EE,57,1,1324820,Europe,3507,66
2020-10-04,Estonia,EE,70,1,1324820,Europe,3577,67
2020-10-05,Estonia,EE,30,0,1324820,Europe,3607,67
2020-10-06,Estonia,EE,10,0,1324820,Europe,3617,67
2020-10-07,Estonia,EE,42,0,1324820,Europe,3659,67
2020-10-08,Estonia,EE,56,0,1324820,Europe,3715,67
2020-10-09,Estonia,EE,45,0,1324820,Europe,3760,67
2020-10-10,Estonia,EE,49,1,1324820,Europe,3809,68
2020-10-11,Estonia,EE,37,0,1324820,Europe,3846,68
2020-10-12,Estonia,EE,19,0,1324820,Europe,3865,68
2020-10-13,Estonia,EE,18,0,1324820,Europe,3883,68
2020-10-14,Estonia,EE,25,0,1324820,Europe,3908,68
2020-10-15,Estonia,EE,39,0,1324820,Europe,3947,68
2020-10-16,Estonia,EE,33,0,1324820,Europe,3980,68
2020-10-17,Estonia,EE,37,0,1324820,Europe,4017,68
2020-10-18,Estonia,EE,35,0,1324820,Europe,4052,68
2020-10-19,Estonia,EE,26,0,1324820,Europe,4078,68
2020-10-20,Estonia,EE,7,0,1324820,Europe,4085,68
2020-10-21,Estonia,EE,42,3,1324820,Europe,4127,71
2020-10-22,Estonia,EE,44,0,1324820,Europe,4171,71
2020-10-23,Estonia,EE,76,0,1324820,Europe,4247,71
2020-10-24,Estonia,EE,53,2,1324820,Europe,4300,73
2020-10-25,Estonia,EE,51,0,1324820,Europe,4351,73
2020-10-26,Estonia,EE,60,0,1324820,Europe,4411,73
2020-10-27,Estonia,EE,17,0,1324820,Europe,4428,73
2020-10-28,Estonia,EE,37,0,1324820,Europe,4465,73
2020-10-29,Estonia,EE,125,0,1324820,Europe,4590,73
2020-10-30,Estonia,EE,81,0,1324820,Europe,4671,73
2020-10-31,Estonia,EE,100,0,1324820,Europe,4771,73
2020-11-01,Estonia,EE,134,0,1324820,Europe,4905,73
2020-11-02,Estonia,EE,80,0,1324820,Europe,4985,73
2020-11-03,Estonia,EE,61,0,1324820,Europe,5046,73
2020-11-04,Estonia,EE,79,0,1324820,Europe,5125,73
2020-11-05,Estonia,EE,208,0,1324820,Europe,5333,73
2020-11-06,Estonia,EE,131,0,1324820,Europe,5464,73
2020-11-07,Estonia,EE,241,0,1324820,Europe,5705,73
2020-11-08,Estonia,EE,228,0,1324820,Europe,5933,73
2020-11-09,Estonia,EE,192,2,1324820,Europe,6125,75
2020-11-10,Estonia,EE,125,1,1324820,Europe,6250,76
2020-11-11,Estonia,EE,126,0,1324820,Europe,6376,76
2020-11-12,Estonia,EE,132,0,1324820,Europe,6508,76
2020-11-13,Estonia,EE,373,0,1324820,Europe,6881,76
2020-11-14,Estonia,EE,267,4,1324820,Europe,7148,80
2020-11-15,Estonia,EE,0,0,1324820,Europe,7148,80
2020-11-16,Estonia,EE,489,1,1324820,Europe,7637,81
2020-11-17,Estonia,EE,211,0,1324820,Europe,7848,81
2020-11-18,Estonia,EE,185,3,1324820,Europe,8033,84
2020-11-19,Estonia,EE,271,1,1324820,Europe,8304,85
2020-11-20,Estonia,EE,411,1,1324820,Europe,8715,86
2020-11-21,Estonia,EE,361,1,1324820,Europe,9076,87
2020-11-22,Estonia,EE,299,0,1324820,Europe,9375,87
2020-11-23,Estonia,EE,349,1,1324820,Europe,9724,88
2020-11-24,Estonia,EE,232,4,1324820,Europe,9956,92
2020-11-25,Estonia,EE,203,2,1324820,Europe,10159,94
2020-11-26,Estonia,EE,382,3,1324820,Europe,10541,97
2020-11-27,Estonia,EE,414,2,1324820,Europe,10955,99
2020-11-28,Estonia,EE,368,5,1324820,Europe,11323,104
2020-11-29,Estonia,EE,375,5,1324820,Europe,11698,109
2020-11-30,Estonia,EE,354,3,1324820,Europe,12052,112
2020-12-01,Estonia,EE,256,6,1324820,Europe,12308,118
2020-12-02,Estonia,EE,189,3,1324820,Europe,12497,121
2020-12-03,Estonia,EE,522,1,1324820,Europe,13019,122
2020-12-04,Estonia,EE,450,1,1324820,Europe,13469,123
2020-12-05,Estonia,EE,470,2,1324820,Europe,13939,125
2020-12-06,Estonia,EE,561,1,1324820,Europe,14500,126
2020-12-07,Estonia,EE,478,5,1324820,Europe,14978,131
2020-12-08,Estonia,EE,248,3,1324820,Europe,15226,134
2020-12-09,Estonia,EE,284,3,1324820,Europe,15510,137
2020-12-10,Estonia,EE,544,2,1324820,Europe,16054,139
2020-12-11,Estonia,EE,544,2,1324820,Europe,16598,141
2020-12-12,Estonia,EE,358,1,1324820,Europe,16956,142
2020-12-13,Estonia,EE,757,6,1324820,Europe,17713,148
2020-12-14,Estonia,EE,342,1,1324820,Europe,18055,149
2019-12-31,Egypt,EG,0,0,100388076,Africa,0,0
2020-01-01,Egypt,EG,0,0,100388076,Africa,0,0
2020-01-02,Egypt,EG,0,0,100388076,Africa,0,0
2020-01-03,Egypt,EG,0,0,100388076,Africa,0,0
2020-01-04,Egypt,EG,0,0,100388076,Africa,0,0
2020-01-05,Egypt,EG,0,0,100388076,Africa,0,0
2020-01-06,Egypt,EG,0,0,100388076,Africa,0,0
2020-01-07,Egypt,EG,0,0,100388076,Africa,0,0
2020-01-08,Egypt,EG,0,0,100388076,Africa,0,0
2020-01-09,Egypt,EG,0,0,100388076,Africa,0,0
2020-01-10,Egypt,EG,0,0,100388076,Africa,0,0
2020-01-11,Egypt,EG,0,0,100388076,Africa,0,0
2020-01-12,Egypt,EG,0,0,100388076,Africa,0,0
2020-01-13,Egypt,EG,0,0,100388076,Africa,0,0
2020-01-14,Egypt,EG,0,0,100388076,Africa,0,0
2020-01-15,Egypt,EG,0,0,100388076,Africa,0,0
2020-01-16,Egypt,EG,0,0,100388076,Africa,0,0
2020-01-17,Egypt,EG,0,0,100388076,Africa,0,0
2020-01-18,Egypt,EG,0,0,100388076,Africa,0,0
2020-01-19,Egypt,EG,0,0,100388076,Africa,0,0
2020-01-20,Egypt,EG,0,0,100388076,Africa,0,0
2020-01-21,Egypt,EG,0,0,100388076,Africa,0,0
2020-01-22,Egypt,EG,0,0,100388076,Africa,0,0
2020-01-23,Egypt,EG,0,0,100388076,Africa,0,0
2020-01-24,Egypt,EG,0,0,100388076,Africa,0,0
2020-01-25,Egypt,EG,0,0,100388076,Africa,0,0
2020-01-26,Egypt,EG,0,0,100388076,Africa,0,0
2020-01-27,Egypt,EG,0,0,100388076,Africa,0,0
2020-01-28,Egypt,EG,0,0,100388076,Africa,0,0
2020-01-29,Egypt,EG,0,0,100388076,Africa,0,0
2020-01-30,Egypt,EG,0,0,100388076,Africa,0,0
2020-01-31,Egypt,EG,0,0,100388076,Africa,0,0
2020-02-01,Egypt,EG,0,0,100388076,Africa,0,0
2020-02-02,Egypt,EG,0,0,100388076,Africa,0,0
2020-02-03,Egypt,EG,0,0,100388076,Africa,0,0
2020-02-04,Egypt,EG,0,0,100388076,Africa,0,0
2020-02-05,Egypt,EG,0,0,100388076,Africa,0,0
2020-02-06,Egypt,EG,0,0,100388076,Africa,0,0
2020-02-07,Egypt,EG,0,0,100388076,Africa,0,0
2020-02-08,Egypt,EG,0,0,100388076,Africa,0,0
2020-02-09,Egypt,EG,0,0,100388076,Africa,0,0
2020-02-10,Egypt,EG,0,0,100388076,Africa,0,0
2020-02-11,Egypt,EG,0,0,100388076,Africa,0,0
2020-02-12,Egypt,EG,0,0,100388076,Africa,0,0
2020-02-13,Egypt,EG,0,0,100388076,Africa,0,0
2020-02-14,Egypt,EG,0,0,100388076,Africa,0,0
2020-02-15,Egypt,EG,1,0,100388076,Africa,1,0
2020-02-16,Egypt,EG,0,0,100388076,Africa,1,0
2020-02-17,Egypt,EG,0,0,100388076,Africa,1,0
2020-02-18,Egypt,EG,0,0,100388076,Africa,1,0
2020-02-19,Egypt,EG,0,0,100388076,Africa,1,0
2020-02-20,Egypt,EG,0,0,100388076,Africa,1,0
2020-02-21,Egypt,EG,0,0,100388076,Africa,1,0
2020-02-22,Egypt,EG,0,0,100388076,Africa,1,0
2020-02-23,Egypt,EG,0,0,100388076,Africa,1,0
2020-02-24,Egypt,EG,0,0,100388076,Africa,1,0
2020-02-25,Egypt,EG,0,0,100388076,Africa,1,0
2020-02-26,Egypt,EG,0,0,100388076,Africa,1,0
2020-02-27,Egypt,EG,0,0,100388076,Africa,1,0
2020-02-28,Egypt,EG,0,0,100388076,Africa,1,0
2020-02-29,Egypt,EG,0,0,100388076,Africa,1,0
2020-03-01,Egypt,EG,0,0,100388076,Africa,1,0
2020-03-02,Egypt,EG,1,0,100388076,Africa,2,0
2020-03-06,Egypt,EG,1,0,100388076,Africa,3,0
2020-03-07,Egypt,EG,12,0,100388076,Africa,15,0
2020-03-09,Egypt,EG,34,1,100388076,Africa,49,1
2020-03-10,Egypt,EG,6,0,100388076,Africa,55,1
2020-03-11,Egypt,EG,4,0,100388076,Africa,59,1
2020-03-12,Egypt,EG,1,0,100388076,Africa,60,1
2020-03-13,Egypt,EG,20,1,100388076,Africa,80,2
2020-03-14,Egypt,EG,13,0,100388076,Africa,93,2
2020-03-15,Egypt,EG,0,0,100388076,Africa,93,2
2020-03-16,Egypt,EG,17,0,100388076,Africa,110,2
2020-03-17,Egypt,EG,16,0,100388076,Africa,126,2
2020-03-18,Egypt,EG,40,2,100388076,Africa,166,4
2020-03-19,Egypt,EG,30,2,100388076,Africa,196,6
2020-03-20,Egypt,EG,14,0,100388076,Africa,210,6
2020-03-21,Egypt,EG,46,1,100388076,Africa,256,7
2020-03-22,Egypt,EG,29,1,100388076,Africa,285,8
2020-03-23,Egypt,EG,9,2,100388076,Africa,294,10
2020-03-24,Egypt,EG,33,4,100388076,Africa,327,14
2020-03-25,Egypt,EG,39,5,100388076,Africa,366,19
2020-03-26,Egypt,EG,76,2,100388076,Africa,442,21
2020-03-27,Egypt,EG,14,0,100388076,Africa,456,21
2020-03-28,Egypt,EG,39,3,100388076,Africa,495,24
2020-03-29,Egypt,EG,41,6,100388076,Africa,536,30
2020-03-30,Egypt,EG,40,6,100388076,Africa,576,36
2020-03-31,Egypt,EG,33,4,100388076,Africa,609,40
2020-04-01,Egypt,EG,47,1,100388076,Africa,656,41
2020-04-02,Egypt,EG,54,5,100388076,Africa,710,46
2020-04-03,Egypt,EG,69,6,100388076,Africa,779,52
2020-04-04,Egypt,EG,0,0,100388076,Africa,779,52
2020-04-05,Egypt,EG,206,14,100388076,Africa,985,66
2020-04-06,Egypt,EG,85,5,100388076,Africa,1070,71
2020-04-07,Egypt,EG,3,7,100388076,Africa,1073,78
2020-04-08,Egypt,EG,249,7,100388076,Africa,1322,85
2020-04-09,Egypt,EG,238,18,100388076,Africa,1560,103
2020-04-10,Egypt,EG,139,15,100388076,Africa,1699,118
2020-04-11,Egypt,EG,95,17,100388076,Africa,1794,135
2020-04-12,Egypt,EG,145,11,100388076,Africa,1939,146
2020-04-13,Egypt,EG,126,13,100388076,Africa,2065,159
2020-04-14,Egypt,EG,125,5,100388076,Africa,2190,164
2020-04-15,Egypt,EG,160,14,100388076,Africa,2350,178
2020-04-16,Egypt,EG,155,5,100388076,Africa,2505,183
2020-04-17,Egypt,EG,168,13,100388076,Africa,2673,196
2020-04-18,Egypt,EG,171,9,100388076,Africa,2844,205
2020-04-19,Egypt,EG,188,19,100388076,Africa,3032,224
2020-04-20,Egypt,EG,112,15,100388076,Africa,3144,239
2020-04-21,Egypt,EG,189,11,100388076,Africa,3333,250
2020-04-22,Egypt,EG,157,14,100388076,Africa,3490,264
2020-04-23,Egypt,EG,0,0,100388076,Africa,3490,264
2020-04-24,Egypt,EG,169,12,100388076,Africa,3659,276
2020-04-25,Egypt,EG,433,18,100388076,Africa,4092,294
2020-04-26,Egypt,EG,227,13,100388076,Africa,4319,307
2020-04-27,Egypt,EG,0,0,100388076,Africa,4319,307
2020-04-28,Egypt,EG,463,30,100388076,Africa,4782,337
2020-04-29,Egypt,EG,260,22,100388076,Africa,5042,359
2020-04-30,Egypt,EG,226,21,100388076,Africa,5268,380
2020-05-01,Egypt,EG,269,12,100388076,Africa,5537,392
2020-05-02,Egypt,EG,358,14,100388076,Africa,5895,406
2020-05-03,Egypt,EG,298,9,100388076,Africa,6193,415
2020-05-04,Egypt,EG,272,14,100388076,Africa,6465,429
2020-05-05,Egypt,EG,348,7,100388076,Africa,6813,436
2020-05-06,Egypt,EG,388,16,100388076,Africa,7201,452
2020-05-07,Egypt,EG,387,17,100388076,Africa,7588,469
2020-05-08,Egypt,EG,393,13,100388076,Africa,7981,482
2020-05-09,Egypt,EG,495,21,100388076,Africa,8476,503
2020-05-10,Egypt,EG,488,11,100388076,Africa,8964,514
2020-05-11,Egypt,EG,436,11,100388076,Africa,9400,525
2020-05-12,Egypt,EG,346,8,100388076,Africa,9746,533
2020-05-13,Egypt,EG,347,11,100388076,Africa,10093,544
2020-05-14,Egypt,EG,338,12,100388076,Africa,10431,556
2020-05-15,Egypt,EG,398,15,100388076,Africa,10829,571
2020-05-16,Egypt,EG,399,21,100388076,Africa,11228,592
2020-05-17,Egypt,EG,491,20,100388076,Africa,11719,612
2020-05-18,Egypt,EG,510,18,100388076,Africa,12229,630
2020-05-19,Egypt,EG,535,15,100388076,Africa,12764,645
2020-05-20,Egypt,EG,720,14,100388076,Africa,13484,659
2020-05-21,Egypt,EG,745,21,100388076,Africa,14229,680
2020-05-22,Egypt,EG,774,16,100388076,Africa,15003,696
2020-05-23,Egypt,EG,783,11,100388076,Africa,15786,707
2020-05-24,Egypt,EG,827,28,100388076,Africa,16613,735
2020-05-25,Egypt,EG,652,29,100388076,Africa,17265,764
2020-05-26,Egypt,EG,702,19,100388076,Africa,17967,783
2020-05-27,Egypt,EG,789,14,100388076,Africa,18756,797
2020-05-28,Egypt,EG,910,19,100388076,Africa,19666,816
2020-05-29,Egypt,EG,1127,29,100388076,Africa,20793,845
2020-05-30,Egypt,EG,1289,34,100388076,Africa,22082,879
2020-05-31,Egypt,EG,1367,34,100388076,Africa,23449,913
2020-06-01,Egypt,EG,1536,46,100388076,Africa,24985,959
2020-06-02,Egypt,EG,1399,46,100388076,Africa,26384,1005
2020-06-03,Egypt,EG,1152,47,100388076,Africa,27536,1052
2020-06-04,Egypt,EG,1079,36,100388076,Africa,28615,1088
2020-06-05,Egypt,EG,1152,38,100388076,Africa,29767,1126
2020-06-06,Egypt,EG,1348,40,100388076,Africa,31115,1166
2020-06-07,Egypt,EG,1497,32,100388076,Africa,32612,1198
2020-06-08,Egypt,EG,1467,39,100388076,Africa,34079,1237
2020-06-09,Egypt,EG,1365,34,100388076,Africa,35444,1271
2020-06-10,Egypt,EG,1385,35,100388076,Africa,36829,1306
2020-06-11,Egypt,EG,1455,36,100388076,Africa,38284,1342
2020-06-12,Egypt,EG,1442,35,100388076,Africa,39726,1377
2020-06-13,Egypt,EG,1578,45,100388076,Africa,41304,1422
2020-06-14,Egypt,EG,1676,62,100388076,Africa,42980,1484
2020-06-15,Egypt,EG,1618,91,100388076,Africa,44598,1575
2020-06-16,Egypt,EG,1691,97,100388076,Africa,46289,1672
2020-06-17,Egypt,EG,1567,94,100388076,Africa,47856,1766
2020-06-18,Egypt,EG,1363,84,100388076,Africa,49219,1850
2020-06-19,Egypt,EG,1218,88,100388076,Africa,50437,1938
2020-06-20,Egypt,EG,1774,79,100388076,Africa,52211,2017
2020-06-21,Egypt,EG,1547,89,100388076,Africa,53758,2106
2020-06-22,Egypt,EG,1475,87,100388076,Africa,55233,2193
2020-06-23,Egypt,EG,1576,85,100388076,Africa,56809,2278
2020-06-24,Egypt,EG,1332,87,100388076,Africa,58141,2365
2020-06-25,Egypt,EG,1420,85,100388076,Africa,59561,2450
2020-06-26,Egypt,EG,1569,83,100388076,Africa,61130,2533
2020-06-27,Egypt,EG,1625,87,100388076,Africa,62755,2620
2020-06-28,Egypt,EG,1168,88,100388076,Africa,63923,2708
2020-06-29,Egypt,EG,1265,81,100388076,Africa,65188,2789
2020-06-30,Egypt,EG,1566,83,100388076,Africa,66754,2872
2020-07-01,Egypt,EG,1557,81,100388076,Africa,68311,2953
2020-07-02,Egypt,EG,1503,81,100388076,Africa,69814,3034
2020-07-03,Egypt,EG,1485,86,100388076,Africa,71299,3120
2020-07-04,Egypt,EG,1412,81,100388076,Africa,72711,3201
2020-07-05,Egypt,EG,1324,79,100388076,Africa,74035,3280
2020-07-06,Egypt,EG,1218,63,100388076,Africa,75253,3343
2020-07-07,Egypt,EG,969,79,100388076,Africa,76222,3422
2020-07-08,Egypt,EG,1057,67,100388076,Africa,77279,3489
2020-07-09,Egypt,EG,1025,75,100388076,Africa,78304,3564
2020-07-10,Egypt,EG,950,53,100388076,Africa,79254,3617
2020-07-11,Egypt,EG,981,85,100388076,Africa,80235,3702
2020-07-12,Egypt,EG,923,67,100388076,Africa,81158,3769
2020-07-13,Egypt,EG,912,89,100388076,Africa,82070,3858
2020-07-14,Egypt,EG,931,77,100388076,Africa,83001,3935
2020-07-15,Egypt,EG,929,73,100388076,Africa,83930,4008
2020-07-16,Egypt,EG,913,59,100388076,Africa,84843,4067
2020-07-17,Egypt,EG,928,53,100388076,Africa,85771,4120
2020-07-18,Egypt,EG,703,68,100388076,Africa,86474,4188
2020-07-19,Egypt,EG,698,63,100388076,Africa,87172,4251
2020-07-20,Egypt,EG,603,51,100388076,Africa,87775,4302
2020-07-21,Egypt,EG,627,50,100388076,Africa,88402,4352
2020-07-22,Egypt,EG,676,47,100388076,Africa,89078,4399
2020-07-23,Egypt,EG,667,41,100388076,Africa,89745,4440
2020-07-24,Egypt,EG,668,40,100388076,Africa,90413,4480
2020-07-25,Egypt,EG,659,38,100388076,Africa,91072,4518
2020-07-26,Egypt,EG,511,40,100388076,Africa,91583,4558
2020-07-27,Egypt,EG,479,48,100388076,Africa,92062,4606
2020-07-28,Egypt,EG,420,46,100388076,Africa,92482,4652
2020-07-29,Egypt,EG,465,39,100388076,Africa,92947,4691
2020-07-30,Egypt,EG,409,37,100388076,Africa,93356,4728
2020-07-31,Egypt,EG,401,46,100388076,Africa,93757,4774
2020-08-01,Egypt,EG,321,31,100388076,Africa,94078,4805
2020-08-02,Egypt,EG,238,29,100388076,Africa,94316,4834
2020-08-03,Egypt,EG,167,31,100388076,Africa,94483,4865
2020-08-04,Egypt,EG,157,23,100388076,Africa,94640,4888
2020-08-05,Egypt,EG,112,24,100388076,Africa,94752,4912
2020-08-06,Egypt,EG,123,18,100388076,Africa,94875,4930
2020-08-07,Egypt,EG,131,21,100388076,Africa,95006,4951
2020-08-08,Egypt,EG,141,20,100388076,Africa,95147,4971
2020-08-09,Egypt,EG,167,21,100388076,Africa,95314,4992
2020-08-10,Egypt,EG,178,17,100388076,Africa,95492,5009
2020-08-11,Egypt,EG,174,26,100388076,Africa,95666,5035
2020-08-12,Egypt,EG,168,24,100388076,Africa,95834,5059
2020-08-13,Egypt,EG,129,26,100388076,Africa,95963,5085
2020-08-14,Egypt,EG,145,22,100388076,Africa,96108,5107
2020-08-15,Egypt,EG,112,17,100388076,Africa,96220,5124
2020-08-16,Egypt,EG,116,17,100388076,Africa,96336,5141
2020-08-17,Egypt,EG,139,19,100388076,Africa,96475,5160
2020-08-18,Egypt,EG,115,13,100388076,Africa,96590,5173
2020-08-19,Egypt,EG,0,0,100388076,Africa,96590,5173
2020-08-20,Egypt,EG,324,24,100388076,Africa,96914,5197
2020-08-21,Egypt,EG,111,15,100388076,Africa,97025,5212
2020-08-22,Egypt,EG,123,19,100388076,Africa,97148,5231
2020-08-23,Egypt,EG,89,12,100388076,Africa,97237,5243
2020-08-24,Egypt,EG,0,0,100388076,Africa,97237,5243
2020-08-25,Egypt,EG,241,37,100388076,Africa,97478,5280
2020-08-26,Egypt,EG,141,18,100388076,Africa,97619,5298
2020-08-27,Egypt,EG,206,19,100388076,Africa,97825,5317
2020-08-28,Egypt,EG,237,25,100388076,Africa,98062,5342
2020-08-29,Egypt,EG,223,20,100388076,Africa,98285,5362
2020-08-30,Egypt,EG,212,14,100388076,Africa,98497,5376
2020-08-31,Egypt,EG,230,23,100388076,Africa,98727,5399
2020-09-01,Egypt,EG,212,22,100388076,Africa,98939,5421
2020-09-02,Egypt,EG,176,19,100388076,Africa,99115,5440
2020-09-03,Egypt,EG,165,21,100388076,Africa,99280,5461
2020-09-04,Egypt,EG,145,18,100388076,Africa,99425,5479
2020-09-05,Egypt,EG,157,16,100388076,Africa,99582,5495
2020-09-06,Egypt,EG,130,16,100388076,Africa,99712,5511
2020-09-07,Egypt,EG,151,19,100388076,Africa,99863,5530
2020-09-08,Egypt,EG,178,11,100388076,Africa,100041,5541
2020-09-09,Egypt,EG,187,19,100388076,Africa,100228,5560
2020-09-10,Egypt,EG,175,17,100388076,Africa,100403,5577
2020-09-11,Egypt,EG,154,13,100388076,Africa,100557,5590
2020-09-12,Egypt,EG,151,17,100388076,Africa,100708,5607
2020-09-13,Egypt,EG,148,20,100388076,Africa,100856,5627
2020-09-14,Egypt,EG,153,21,100388076,Africa,101009,5648
2020-09-15,Egypt,EG,168,13,100388076,Africa,101177,5661
2020-09-16,Egypt,EG,163,18,100388076,Africa,101340,5679
2020-09-17,Egypt,EG,160,17,100388076,Africa,101500,5696
2020-09-18,Egypt,EG,141,19,100388076,Africa,101641,5715
2020-09-19,Egypt,EG,131,18,100388076,Africa,101772,5733
2020-09-20,Egypt,EG,128,17,100388076,Africa,101900,5750
2020-09-21,Egypt,EG,115,20,100388076,Africa,102015,5770
2020-09-22,Egypt,EG,126,17,100388076,Africa,102141,5787
2020-09-23,Egypt,EG,113,19,100388076,Africa,102254,5806
2020-09-24,Egypt,EG,121,16,100388076,Africa,102375,5822
2020-09-25,Egypt,EG,138,13,100388076,Africa,102513,5835
2020-09-26,Egypt,EG,112,18,100388076,Africa,102625,5853
2020-09-27,Egypt,EG,111,16,100388076,Africa,102736,5869
2020-09-28,Egypt,EG,104,14,100388076,Africa,102840,5883
2020-09-29,Egypt,EG,115,18,100388076,Africa,102955,5901
2020-09-30,Egypt,EG,124,13,100388076,Africa,103079,5914
2020-10-01,Egypt,EG,119,16,100388076,Africa,103198,5930
2020-10-02,Egypt,EG,119,16,100388076,Africa,103317,5946
2020-10-03,Egypt,EG,149,10,100388076,Africa,103466,5956
2020-10-04,Egypt,EG,109,14,100388076,Africa,103575,5970
2020-10-05,Egypt,EG,108,11,100388076,Africa,103683,5981
2020-10-06,Egypt,EG,98,9,100388076,Africa,103781,5990
2020-10-07,Egypt,EG,121,11,100388076,Africa,103902,6001
2020-10-08,Egypt,EG,133,9,100388076,Africa,104035,6010
2020-10-09,Egypt,EG,121,7,100388076,Africa,104156,6017
2020-10-10,Egypt,EG,106,12,100388076,Africa,104262,6029
2020-10-11,Egypt,EG,125,11,100388076,Africa,104387,6040
2020-10-12,Egypt,EG,0,0,100388076,Africa,104387,6040
2020-10-13,Egypt,EG,261,22,100388076,Africa,104648,6062
2020-10-14,Egypt,EG,139,9,100388076,Africa,104787,6071
2020-10-15,Egypt,EG,128,6,100388076,Africa,104915,6077
2020-10-16,Egypt,EG,118,11,100388076,Africa,105033,6088
2020-10-17,Egypt,EG,126,11,100388076,Africa,105159,6099
2020-10-18,Egypt,EG,138,10,100388076,Africa,105297,6109
2020-10-19,Egypt,EG,127,11,100388076,Africa,105424,6120
2020-10-20,Egypt,EG,123,10,100388076,Africa,105547,6130
2020-10-21,Egypt,EG,158,12,100388076,Africa,105705,6142
2020-10-22,Egypt,EG,178,13,100388076,Africa,105883,6155
2020-10-23,Egypt,EG,177,11,100388076,Africa,106060,6166
2020-10-24,Egypt,EG,170,10,100388076,Africa,106230,6176
2020-10-25,Egypt,EG,167,11,100388076,Africa,106397,6187
2020-10-26,Egypt,EG,143,12,100388076,Africa,106540,6199
2020-10-27,Egypt,EG,167,12,100388076,Africa,106707,6211
2020-10-28,Egypt,EG,170,11,100388076,Africa,106877,6222
2020-10-29,Egypt,EG,153,12,100388076,Africa,107030,6234
2020-10-30,Egypt,EG,179,13,100388076,Africa,107209,6247
2020-10-31,Egypt,EG,167,11,100388076,Africa,107376,6258
2020-11-01,Egypt,EG,179,8,100388076,Africa,107555,6266
2020-11-02,Egypt,EG,181,12,100388076,Africa,107736,6278
2020-11-03,Egypt,EG,189,13,100388076,Africa,107925,6291
2020-11-04,Egypt,EG,197,14,100388076,Africa,108122,6305
2020-11-05,Egypt,EG,207,13,100388076,Africa,108329,6318
2020-11-06,Egypt,EG,201,11,100388076,Africa,108530,6329
2020-11-07,Egypt,EG,224,14,100388076,Africa,108754,6343
2020-11-08,Egypt,EG,208,12,100388076,Africa,108962,6355
2020-11-09,Egypt,EG,239,13,100388076,Africa,109201,6368
2020-11-10,Egypt,EG,221,12,100388076,Africa,109422,6380
2020-11-11,Egypt,EG,232,14,100388076,Africa,109654,6394
2020-11-12,Egypt,EG,227,11,100388076,Africa,109881,6405
2020-11-13,Egypt,EG,214,12,100388076,Africa,110095,6417
2020-11-14,Egypt,EG,224,12,100388076,Africa,110319,6429
2020-11-15,Egypt,EG,228,13,100388076,Africa,110547,6442
2020-11-16,Egypt,EG,220,11,100388076,Africa,110767,6453
2020-11-17,Egypt,EG,242,12,100388076,Africa,111009,6465
2020-11-18,Egypt,EG,275,16,100388076,Africa,111284,6481
2020-11-19,Egypt,EG,329,14,100388076,Africa,111613,6495
2020-11-20,Egypt,EG,342,13,100388076,Africa,111955,6508
2020-11-21,Egypt,EG,363,13,100388076,Africa,112318,6521
2020-11-22,Egypt,EG,358,14,100388076,Africa,112676,6535
2020-11-23,Egypt,EG,351,13,100388076,Africa,113027,6548
2020-11-24,Egypt,EG,354,12,100388076,Africa,113381,6560
2020-11-25,Egypt,EG,361,13,100388076,Africa,113742,6573
2020-11-26,Egypt,EG,365,12,100388076,Africa,114107,6585
2020-11-27,Egypt,EG,368,11,100388076,Africa,114475,6596
2020-11-28,Egypt,EG,357,12,100388076,Africa,114832,6608
2020-11-29,Egypt,EG,351,13,100388076,Africa,115183,6621
2020-11-30,Egypt,EG,358,15,100388076,Africa,115541,6636
2020-12-01,Egypt,EG,370,14,100388076,Africa,115911,6650
2020-12-02,Egypt,EG,392,16,100388076,Africa,116303,6666
2020-12-03,Egypt,EG,421,28,100388076,Africa,116724,6694
2020-12-04,Egypt,EG,432,19,100388076,Africa,117156,6713
2020-12-05,Egypt,EG,427,19,100388076,Africa,117583,6732
2020-12-06,Egypt,EG,431,18,100388076,Africa,118014,6750
2020-12-07,Egypt,EG,418,21,100388076,Africa,118432,6771
2020-12-08,Egypt,EG,415,19,100388076,Africa,118847,6790
2020-12-09,Egypt,EG,434,23,100388076,Africa,119281,6813
2020-12-10,Egypt,EG,421,19,100388076,Africa,119702,6832
2020-12-11,Egypt,EG,445,22,100388076,Africa,120147,6854
2020-12-12,Egypt,EG,464,23,100388076,Africa,120611,6877
2020-12-13,Egypt,EG,478,21,100388076,Africa,121089,6898
2020-12-14,Egypt,EG,486,22,100388076,Africa,121575,6920
2020-04-26,Western_Sahara,EH,6,0,582458,Africa,6,0
2020-04-27,Western_Sahara,EH,0,0,582458,Africa,6,0
2020-04-28,Western_Sahara,EH,0,0,582458,Africa,6,0
2020-04-29,Western_Sahara,EH,0,0,582458,Africa,6,0
2020-04-30,Western_Sahara,EH,0,0,582458,Africa,6,0
2020-05-01,Western_Sahara,EH,0,0,582458,Africa,6,0
2020-05-02,Western_Sahara,EH,0,0,582458,Africa,6,0
2020-05-03,Western_Sahara,EH,0,0,582458,Africa,6,0
2020-05-04,Western_Sahara,EH,0,0,582458,Africa,6,0
2020-05-05,Western_Sahara,EH,0,0,582458,Africa,6,0
2020-05-06,Western_Sahara,EH,0,0,582458,Africa,6,0
2020-05-07,Western_Sahara,EH,0,0,582458,Africa,6,0
2020-05-08,Western_Sahara,EH,0,0,582458,Africa,6,0
2020-05-09,Western_Sahara,EH,0,0,582458,Africa,6,0
2020-05-10,Western_Sahara,EH,0,0,582458,Africa,6,0
2020-05-11,Western_Sahara,EH,0,0,582458,Africa,6,0
2020-05-12,Western_Sahara,EH,0,0,582458,Africa,6,0
2020-05-13,Western_Sahara,EH,0,0,582458,Africa,6,0
2020-05-14,Western_Sahara,EH,0,0,582458,Africa,6,0
2020-05-15,Western_Sahara,EH,0,0,582458,Africa,6,0
2020-05-16,Western_Sahara,EH,0,0,582458,Africa,6,0
2020-05-17,Western_Sahara,EH,0,0,582458,Africa,6,0
2020-05-18,Western_Sahara,EH,0,0,582458,Africa,6,0
2020-05-19,Western_Sahara,EH,0,0,582458,Africa,6,0
2020-05-20,Western_Sahara,EH,0,0,582458,Africa,6,0
2020-05-21,Western_Sahara,EH,0,0,582458,Africa,6,0
2020-05-22,Western_Sahara,EH,0,0,582458,Africa,6,0
2020-05-23,Western_Sahara,EH,0,0,582458,Africa,6,0
2020-05-24,Western_Sahara,EH,0,0,582458,Africa,6,0
2020-05-25,Western_Sahara,EH,0,0,582458,Africa,6,0
2020-05-26,Western_Sahara,EH,0,0,582458,Africa,6,0
2020-05-27,Western_Sahara,EH,0,0,582458,Africa,6,0
2020-05-28,Western_Sahara,EH,0,0,582458,Africa,6,0
2020-05-29,Western_Sahara,EH,0,0,582458,Africa,6,0
2020-05-30,Western_Sahara,EH,17,1,582458,Africa,23,1
2020-05-31,Western_Sahara,EH,0,0,582458,Africa,23,1
2020-06-01,Western_Sahara,EH,0,0,582458,Africa,23,1
2020-06-02,Western_Sahara,EH,0,0,582458,Africa,23,1
2020-06-03,Western_Sahara,EH,0,0,582458,Africa,23,1
2020-06-04,Western_Sahara,EH,0,0,582458,Africa,23,1
2020-06-05,Western_Sahara,EH,0,0,582458,Africa,23,1
2020-06-06,Western_Sahara,EH,0,0,582458,Africa,23,1
2020-06-07,Western_Sahara,EH,0,0,582458,Africa,23,1
2020-06-08,Western_Sahara,EH,0,0,582458,Africa,23,1
2020-06-09,Western_Sahara,EH,0,0,582458,Africa,23,1
2020-06-10,Western_Sahara,EH,0,0,582458,Africa,23,1
2020-06-11,Western_Sahara,EH,0,0,582458,Africa,23,1
2020-06-12,Western_Sahara,EH,0,0,582458,Africa,23,1
2020-06-13,Western_Sahara,EH,0,0,582458,Africa,23,1
2020-06-14,Western_Sahara,EH,0,0,582458,Africa,23,1
2020-06-15,Western_Sahara,EH,0,0,582458,Africa,23,1
2020-06-16,Western_Sahara,EH,0,0,582458,Africa,23,1
2020-06-17,Western_Sahara,EH,0,0,582458,Africa,23,1
2020-06-18,Western_Sahara,EH,0,0,582458,Africa,23,1
2020-06-19,Western_Sahara,EH,0,0,582458,Africa,23,1
2020-06-20,Western_Sahara,EH,2,0,582458,Africa,25,1
2020-06-21,Western_Sahara,EH,0,0,582458,Africa,25,1
2020-06-22,Western_Sahara,EH,0,0,582458,Africa,25,1
2020-06-23,Western_Sahara,EH,0,0,582458,Africa,25,1
2020-06-24,Western_Sahara,EH,0,0,582458,Africa,25,1
2020-06-25,Western_Sahara,EH,0,0,582458,Africa,25,1
2020-06-26,Western_Sahara,EH,0,0,582458,Africa,25,1
2020-06-27,Western_Sahara,EH,0,0,582458,Africa,25,1
2020-06-28,Western_Sahara,EH,183,0,582458,Africa,208,1
2020-06-29,Western_Sahara,EH,0,0,582458,Africa,208,1
2020-06-30,Western_Sahara,EH,0,0,582458,Africa,208,1
2020-07-01,Western_Sahara,EH,172,0,582458,Africa,380,1
2020-07-02,Western_Sahara,EH,81,0,582458,Africa,461,1
2020-07-03,Western_Sahara,EH,0,0,582458,Africa,461,1
2020-07-04,Western_Sahara,EH,58,0,582458,Africa,519,1
2020-07-05,Western_Sahara,EH,0,0,582458,Africa,519,1
2020-07-06,Western_Sahara,EH,0,0,582458,Africa,519,1
2020-07-07,Western_Sahara,EH,0,0,582458,Africa,519,1
2020-07-08,Western_Sahara,EH,0,0,582458,Africa,519,1
2020-07-09,Western_Sahara,EH,0,0,582458,Africa,519,1
2020-07-10,Western_Sahara,EH,0,0,582458,Africa,519,1
2020-07-11,Western_Sahara,EH,0,0,582458,Africa,519,1
2020-07-12,Western_Sahara,EH,0,0,582458,Africa,519,1
2020-07-13,Western_Sahara,EH,0,0,582458,Africa,519,1
2020-07-14,Western_Sahara,EH,242,0,582458,Africa,761,1
2020-07-15,Western_Sahara,EH,5,0,582458,Africa,766,1
2020-07-16,Western_Sahara,EH,0,0,582458,Africa,766,1
2020-07-17,Western_Sahara,EH,0,0,582458,Africa,766,1
2020-07-18,Western_Sahara,EH,0,0,582458,Africa,766,1
2020-07-19,Western_Sahara,EH,0,0,582458,Africa,766,1
2020-07-20,Western_Sahara,EH,0,0,582458,Africa,766,1
2020-07-21,Western_Sahara,EH,0,0,582458,Africa,766,1
2020-07-22,Western_Sahara,EH,0,0,582458,Africa,766,1
2020-07-23,Western_Sahara,EH,0,0,582458,Africa,766,1
2020-07-24,Western_Sahara,EH,0,0,582458,Africa,766,1
2020-07-25,Western_Sahara,EH,0,0,582458,Africa,766,1
2020-07-26,Western_Sahara,EH,0,0,582458,Africa,766,1
2020-07-27,Western_Sahara,EH,0,0,582458,Africa,766,1
2020-07-28,Western_Sahara,EH,0,0,582458,Africa,766,1
2020-07-29,Western_Sahara,EH,0,0,582458,Africa,766,1
2020-07-30,Western_Sahara,EH,0,0,582458,Africa,766,1
2020-07-31,Western_Sahara,EH,0,0,582458,Africa,766,1
2020-08-01,Western_Sahara,EH,0,0,582458,Africa,766,1
2020-08-02,Western_Sahara,EH,0,0,582458,Africa,766,1
2020-08-03,Western_Sahara,EH,0,0,582458,Africa,766,1
2020-08-04,Western_Sahara,EH,0,0,582458,Africa,766,1
2020-08-05,Western_Sahara,EH,0,0,582458,Africa,766,1
2020-08-06,Western_Sahara,EH,0,0,582458,Africa,766,1
2020-08-07,Western_Sahara,EH,0,0,582458,Africa,766,1
2020-08-08,Western_Sahara,EH,0,0,582458,Africa,766,1
2020-08-09,Western_Sahara,EH,0,0,582458,Africa,766,1
2020-08-10,Western_Sahara,EH,0,0,582458,Africa,766,1
2020-08-11,Western_Sahara,EH,0,0,582458,Africa,766,1
2020-08-12,Western_Sahara,EH,0,0,582458,Africa,766,1
2020-08-13,Western_Sahara,EH,0,0,582458,Africa,766,1
2020-08-14,Western_Sahara,EH,0,0,582458,Africa,766,1
2020-08-15,Western_Sahara,EH,0,0,582458,Africa,766,1
2020-08-16,Western_Sahara,EH,0,0,582458,Africa,766,1
2020-08-17,Western_Sahara,EH,0,0,582458,Africa,766,1
2020-08-18,Western_Sahara,EH,0,0,582458,Africa,766,1
2020-08-19,Western_Sahara,EH,0,0,582458,Africa,766,1
2020-08-20,Western_Sahara,EH,0,0,582458,Africa,766,1
2020-08-21,Western_Sahara,EH,0,0,582458,Africa,766,1
2020-08-22,Western_Sahara,EH,0,0,582458,Africa,766,1
2020-08-23,Western_Sahara,EH,0,0,582458,Africa,766,1
2020-08-24,Western_Sahara,EH,0,0,582458,Africa,766,1
2020-08-25,Western_Sahara,EH,0,0,582458,Africa,766,1
2020-08-26,Western_Sahara,EH,0,0,582458,Africa,766,1
2020-08-27,Western_Sahara,EH,0,0,582458,Africa,766,1
2020-08-28,Western_Sahara,EH,0,0,582458,Africa,766,1
2020-08-29,Western_Sahara,EH,0,0,582458,Africa,766,1
2020-08-30,Western_Sahara,EH,0,0,582458,Africa,766,1
2020-08-31,Western_Sahara,EH,0,0,582458,Africa,766,1
2020-09-01,Western_Sahara,EH,0,0,582458,Africa,766,1
2020-09-02,Western_Sahara,EH,0,0,582458,Africa,766,1
2020-09-03,Western_Sahara,EH,0,0,582458,Africa,766,1
2020-09-04,Western_Sahara,EH,0,0,582458,Africa,766,1
2020-09-05,Western_Sahara,EH,0,0,582458,Africa,766,1
2020-09-06,Western_Sahara,EH,0,0,582458,Africa,766,1
2020-09-07,Western_Sahara,EH,0,0,582458,Africa,766,1
2020-09-08,Western_Sahara,EH,0,0,582458,Africa,766,1
2020-09-09,Western_Sahara,EH,0,0,582458,Africa,766,1
2020-09-10,Western_Sahara,EH,0,0,582458,Africa,766,1
2020-09-11,Western_Sahara,EH,0,0,582458,Africa,766,1
2020-09-12,Western_Sahara,EH,0,0,582458,Africa,766,1
2020-09-13,Western_Sahara,EH,0,0,582458,Africa,766,1
2020-09-14,Western_Sahara,EH,0,0,582458,Africa,766,1
2020-09-15,Western_Sahara,EH,0,0,582458,Africa,766,1
2020-09-16,Western_Sahara,EH,0,0,582458,Africa,766,1
2020-09-17,Western_Sahara,EH,0,0,582458,Africa,766,1
2020-09-18,Western_Sahara,EH,0,0,582458,Africa,766,1
2020-09-19,Western_Sahara,EH,0,0,582458,Africa,766,1
2020-09-20,Western_Sahara,EH,0,0,582458,Africa,766,1
2020-09-21,Western_Sahara,EH,0,0,582458,Africa,766,1
2020-09-22,Western_Sahara,EH,0,0,582458,Africa,766,1
2020-09-23,Western_Sahara,EH,0,0,582458,Africa,766,1
2020-09-24,Western_Sahara,EH,0,0,582458,Africa,766,1
2020-09-25,Western_Sahara,EH,0,0,582458,Africa,766,1
2020-09-26,Western_Sahara,EH,0,0,582458,Africa,766,1
2020-09-27,Western_Sahara,EH,0,0,582458,Africa,766,1
2020-09-28,Western_Sahara,EH,0,0,582458,Africa,766,1
2020-09-29,Western_Sahara,EH,0,0,582458,Africa,766,1
2020-09-30,Western_Sahara,EH,0,0,582458,Africa,766,1
2020-10-01,Western_Sahara,EH,0,0,582458,Africa,766,1
2020-10-02,Western_Sahara,EH,0,0,582458,Africa,766,1
2020-10-03,Western_Sahara,EH,0,0,582458,Africa,766,1
2020-10-04,Western_Sahara,EH,0,0,582458,Africa,766,1
2020-10-05,Western_Sahara,EH,0,0,582458,Africa,766,1
2020-10-06,Western_Sahara,EH,0,0,582458,Africa,766,1
2020-10-07,Western_Sahara,EH,0,0,582458,Africa,766,1
2020-10-08,Western_Sahara,EH,0,0,582458,Africa,766,1
2020-10-09,Western_Sahara,EH,0,0,582458,Africa,766,1
2020-10-10,Western_Sahara,EH,0,0,582458,Africa,766,1
2020-10-11,Western_Sahara,EH,0,0,582458,Africa,766,1
2020-10-12,Western_Sahara,EH,0,0,582458,Africa,766,1
2020-10-13,Western_Sahara,EH,0,0,582458,Africa,766,1
2020-10-14,Western_Sahara,EH,0,0,582458,Africa,766,1
2020-10-15,Western_Sahara,EH,0,0,582458,Africa,766,1
2020-10-16,Western_Sahara,EH,0,0,582458,Africa,766,1
2020-10-17,Western_Sahara,EH,0,0,582458,Africa,766,1
2020-10-18,Western_Sahara,EH,0,0,582458,Africa,766,1
2020-10-19,Western_Sahara,EH,0,0,582458,Africa,766,1
2020-10-20,Western_Sahara,EH,0,0,582458,Africa,766,1
2020-10-21,Western_Sahara,EH,0,0,582458,Africa,766,1
2020-10-22,Western_Sahara,EH,0,0,582458,Africa,766,1
2020-10-23,Western_Sahara,EH,0,0,582458,Africa,766,1
2020-10-24,Western_Sahara,EH,0,0,582458,Africa,766,1
2020-10-25,Western_Sahara,EH,0,0,582458,Africa,766,1
2020-10-26,Western_Sahara,EH,0,0,582458,Africa,766,1
2020-10-27,Western_Sahara,EH,0,0,582458,Africa,766,1
2020-10-28,Western_Sahara,EH,0,0,582458,Africa,766,1
2020-10-29,Western_Sahara,EH,0,0,582458,Africa,766,1
2020-10-30,Western_Sahara,EH,0,0,582458,Africa,766,1
2020-10-31,Western_Sahara,EH,0,0,582458,Africa,766,1
2020-11-01,Western_Sahara,EH,0,0,582458,Africa,766,1
2020-11-02,Western_Sahara,EH,0,0,582458,Africa,766,1
2020-11-03,Western_Sahara,EH,0,0,582458,Africa,766,1
2020-11-04,Western_Sahara,EH,0,0,582458,Africa,766,1
2020-11-05,Western_Sahara,EH,0,0,582458,Africa,766,1
2020-11-06,Western_Sahara,EH,0,0,582458,Africa,766,1
2020-11-07,Western_Sahara,EH,0,0,582458,Africa,766,1
2020-11-08,Western_Sahara,EH,0,0,582458,Africa,766,1
2020-11-09,Western_Sahara,EH,0,0,582458,Africa,766,1
2020-11-10,Western_Sahara,EH,0,0,582458,Africa,766,1
2020-11-11,Western_Sahara,EH,0,0,582458,Africa,766,1
2020-11-12,Western_Sahara,EH,0,0,582458,Africa,766,1
2020-11-13,Western_Sahara,EH,0,0,582458,Africa,766,1
2020-11-14,Western_Sahara,EH,0,0,582458,Africa,766,1
2020-11-15,Western_Sahara,EH,0,0,582458,Africa,766,1
2020-11-16,Western_Sahara,EH,0,0,582458,Africa,766,1
2020-11-17,Western_Sahara,EH,0,0,582458,Africa,766,1
2020-11-18,Western_Sahara,EH,0,0,582458,Africa,766,1
2020-11-19,Western_Sahara,EH,0,0,582458,Africa,766,1
2020-11-20,Western_Sahara,EH,0,0,582458,Africa,766,1
2020-11-21,Western_Sahara,EH,0,0,582458,Africa,766,1
2020-11-22,Western_Sahara,EH,0,0,582458,Africa,766,1
2020-11-23,Western_Sahara,EH,0,0,582458,Africa,766,1
2020-11-24,Western_Sahara,EH,0,0,582458,Africa,766,1
2020-11-25,Western_Sahara,EH,0,0,582458,Africa,766,1
2020-11-26,Western_Sahara,EH,0,0,582458,Africa,766,1
2020-11-27,Western_Sahara,EH,0,0,582458,Africa,766,1
2020-11-28,Western_Sahara,EH,0,0,582458,Africa,766,1
2020-11-29,Western_Sahara,EH,0,0,582458,Africa,766,1
2020-11-30,Western_Sahara,EH,0,0,582458,Africa,766,1
2020-12-01,Western_Sahara,EH,0,0,582458,Africa,766,1
2020-12-02,Western_Sahara,EH,0,0,582458,Africa,766,1
2020-12-03,Western_Sahara,EH,0,0,582458,Africa,766,1
2020-12-04,Western_Sahara,EH,0,0,582458,Africa,766,1
2020-12-05,Western_Sahara,EH,0,0,582458,Africa,766,1
2020-12-06,Western_Sahara,EH,0,0,582458,Africa,766,1
2020-12-07,Western_Sahara,EH,0,0,582458,Africa,766,1
2020-12-08,Western_Sahara,EH,0,0,582458,Africa,766,1
2020-12-09,Western_Sahara,EH,0,0,582458,Africa,766,1
2020-12-10,Western_Sahara,EH,0,0,582458,Africa,766,1
2020-12-11,Western_Sahara,EH,0,0,582458,Africa,766,1
2020-12-12,Western_Sahara,EH,0,0,582458,Africa,766,1
2020-12-13,Western_Sahara,EH,0,0,582458,Africa,766,1
2020-12-14,Western_Sahara,EH,0,0,582458,Africa,766,1
2019-12-31,Greece,EL,0,0,10724599,Europe,0,0
2020-01-01,Greece,EL,0,0,10724599,Europe,0,0
2020-01-02,Greece,EL,0,0,10724599,Europe,0,0
2020-01-03,Greece,EL,0,0,10724599,Europe,0,0
2020-01-04,Greece,EL,0,0,10724599,Europe,0,0
2020-01-05,Greece,EL,0,0,10724599,Europe,0,0
2020-01-06,Greece,EL,0,0,10724599,Europe,0,0
2020-01-07,Greece,EL,0,0,10724599,Europe,0,0
2020-01-08,Greece,EL,0,0,10724599,Europe,0,0
2020-01-09,Greece,EL,0,0,10724599,Europe,0,0
2020-01-10,Greece,EL,0,0,10724599,Europe,0,0
2020-01-11,Greece,EL,0,0,10724599,Europe,0,0
2020-01-12,Greece,EL,0,0,10724599,Europe,0,0
2020-01-13,Greece,EL,0,0,10724599,Europe,0,0
2020-01-14,Greece,EL,0,0,10724599,Europe,0,0
2020-01-15,Greece,EL,0,0,10724599,Europe,0,0
2020-01-16,Greece,EL,0,0,10724599,Europe,0,0
2020-01-17,Greece,EL,0,0,10724599,Europe,0,0
2020-01-18,Greece,EL,0,0,10724599,Europe,0,0
2020-01-19,Greece,EL,0,0,10724599,Europe,0,0
2020-01-20,Greece,EL,0,0,10724599,Europe,0,0
2020-01-21,Greece,EL,0,0,10724599,Europe,0,0
2020-01-22,Greece,EL,0,0,10724599,Europe,0,0
2020-01-23,Greece,EL,0,0,10724599,Europe,0,0
2020-01-24,Greece,EL,0,0,10724599,Europe,0,0
2020-01-25,Greece,EL,0,0,10724599,Europe,0,0
2020-01-26,Greece,EL,0,0,10724599,Europe,0,0
2020-01-27,Greece,EL,0,0,10724599,Europe,0,0
2020-01-28,Greece,EL,0,0,10724599,Europe,0,0
2020-01-29,Greece,EL,0,0,10724599,Europe,0,0
2020-01-30,Greece,EL,0,0,10724599,Europe,0,0
2020-01-31,Greece,EL,0,0,10724599,Europe,0,0
2020-02-01,Greece,EL,0,0,10724599,Europe,0,0
2020-02-02,Greece,EL,0,0,10724599,Europe,0,0
2020-02-03,Greece,EL,0,0,10724599,Europe,0,0
2020-02-04,Greece,EL,0,0,10724599,Europe,0,0
2020-02-05,Greece,EL,0,0,10724599,Europe,0,0
2020-02-06,Greece,EL,0,0,10724599,Europe,0,0
2020-02-07,Greece,EL,0,0,10724599,Europe,0,0
2020-02-08,Greece,EL,0,0,10724599,Europe,0,0
2020-02-09,Greece,EL,0,0,10724599,Europe,0,0
2020-02-10,Greece,EL,0,0,10724599,Europe,0,0
2020-02-11,Greece,EL,0,0,10724599,Europe,0,0
2020-02-12,Greece,EL,0,0,10724599,Europe,0,0
2020-02-13,Greece,EL,0,0,10724599,Europe,0,0
2020-02-14,Greece,EL,0,0,10724599,Europe,0,0
2020-02-15,Greece,EL,0,0,10724599,Europe,0,0
2020-02-16,Greece,EL,0,0,10724599,Europe,0,0
2020-02-17,Greece,EL,0,0,10724599,Europe,0,0
2020-02-18,Greece,EL,0,0,10724599,Europe,0,0
2020-02-19,Greece,EL,0,0,10724599,Europe,0,0
2020-02-20,Greece,EL,0,0,10724599,Europe,0,0
2020-02-21,Greece,EL,0,0,10724599,Europe,0,0
2020-02-22,Greece,EL,0,0,10724599,Europe,0,0
2020-02-23,Greece,EL,0,0,10724599,Europe,0,0
2020-02-24,Greece,EL,0,0,10724599,Europe,0,0
2020-02-25,Greece,EL,0,0,10724599,Europe,0,0
2020-02-26,Greece,EL,0,0,10724599,Europe,0,0
2020-02-27,Greece,EL,1,0,10724599,Europe,1,0
2020-02-28,Greece,EL,2,0,10724599,Europe,3,0
2020-02-29,Greece,EL,1,0,10724599,Europe,4,0
2020-03-01,Greece,EL,3,0,10724599,Europe,7,0
2020-03-02,Greece,EL,0,0,10724599,Europe,7,0
2020-03-05,Greece,EL,3,0,10724599,Europe,10,0
2020-03-06,Greece,EL,22,0,10724599,Europe,32,0
2020-03-07,Greece,EL,13,0,10724599,Europe,45,0
2020-03-08,Greece,EL,21,0,10724599,Europe,66,0
2020-03-09,Greece,EL,7,0,10724599,Europe,73,0
2020-03-10,Greece,EL,11,0,10724599,Europe,84,0
2020-03-11,Greece,EL,6,0,10724599,Europe,90,0
2020-03-12,Greece,EL,9,1,10724599,Europe,99,1
2020-03-13,Greece,EL,34,0,10724599,Europe,133,1
2020-03-14,Greece,EL,57,0,10724599,Europe,190,1
2020-03-15,Greece,EL,38,2,10724599,Europe,228,3
2020-03-16,Greece,EL,103,1,10724599,Europe,331,4
2020-03-17,Greece,EL,21,0,10724599,Europe,352,4
2020-03-18,Greece,EL,35,1,10724599,Europe,387,5
2020-03-19,Greece,EL,31,0,10724599,Europe,418,5
2020-03-20,Greece,EL,46,0,10724599,Europe,464,5
2020-03-21,Greece,EL,31,3,10724599,Europe,495,8
2020-03-22,Greece,EL,35,5,10724599,Europe,530,13
2020-03-23,Greece,EL,94,2,10724599,Europe,624,15
2020-03-24,Greece,EL,71,2,10724599,Europe,695,17
2020-03-25,Greece,EL,48,3,10724599,Europe,743,20
2020-03-26,Greece,EL,78,2,10724599,Europe,821,22
2020-03-27,Greece,EL,71,4,10724599,Europe,892,26
2020-03-28,Greece,EL,74,2,10724599,Europe,966,28
2020-03-29,Greece,EL,95,4,10724599,Europe,1061,32
2020-03-30,Greece,EL,95,6,10724599,Europe,1156,38
2020-03-31,Greece,EL,56,5,10724599,Europe,1212,43
2020-04-01,Greece,EL,102,6,10724599,Europe,1314,49
2020-04-02,Greece,EL,61,1,10724599,Europe,1375,50
2020-04-03,Greece,EL,139,3,10724599,Europe,1514,53
2020-04-04,Greece,EL,99,6,10724599,Europe,1613,59
2020-04-05,Greece,EL,60,9,10724599,Europe,1673,68
2020-04-06,Greece,EL,62,5,10724599,Europe,1735,73
2020-04-07,Greece,EL,20,6,10724599,Europe,1755,79
2020-04-08,Greece,EL,77,2,10724599,Europe,1832,81
2020-04-09,Greece,EL,52,2,10724599,Europe,1884,83
2020-04-10,Greece,EL,71,3,10724599,Europe,1955,86
2020-04-11,Greece,EL,56,4,10724599,Europe,2011,90
2020-04-12,Greece,EL,70,3,10724599,Europe,2081,93
2020-04-13,Greece,EL,33,5,10724599,Europe,2114,98
2020-04-14,Greece,EL,31,1,10724599,Europe,2145,99
2020-04-15,Greece,EL,25,2,10724599,Europe,2170,101
2020-04-16,Greece,EL,22,1,10724599,Europe,2192,102
2020-04-17,Greece,EL,15,3,10724599,Europe,2207,105
2020-04-18,Greece,EL,0,0,10724599,Europe,2207,105
2020-04-19,Greece,EL,0,0,10724599,Europe,2207,105
2020-04-20,Greece,EL,28,5,10724599,Europe,2235,110
2020-04-21,Greece,EL,10,6,10724599,Europe,2245,116
2020-04-22,Greece,EL,156,5,10724599,Europe,2401,121
2020-04-23,Greece,EL,7,0,10724599,Europe,2408,121
2020-04-24,Greece,EL,55,4,10724599,Europe,2463,125
2020-04-25,Greece,EL,27,5,10724599,Europe,2490,130
2020-04-26,Greece,EL,16,0,10724599,Europe,2506,130
2020-04-27,Greece,EL,0,0,10724599,Europe,2506,130
2020-04-28,Greece,EL,28,6,10724599,Europe,2534,136
2020-04-29,Greece,EL,0,0,10724599,Europe,2534,136
2020-04-30,Greece,EL,42,3,10724599,Europe,2576,139
2020-05-01,Greece,EL,15,1,10724599,Europe,2591,140
2020-05-02,Greece,EL,0,0,10724599,Europe,2591,140
2020-05-03,Greece,EL,29,3,10724599,Europe,2620,143
2020-05-04,Greece,EL,6,1,10724599,Europe,2626,144
2020-05-05,Greece,EL,6,2,10724599,Europe,2632,146
2020-05-06,Greece,EL,10,0,10724599,Europe,2642,146
2020-05-07,Greece,EL,21,1,10724599,Europe,2663,147
2020-05-08,Greece,EL,15,1,10724599,Europe,2678,148
2020-05-09,Greece,EL,13,2,10724599,Europe,2691,150
2020-05-10,Greece,EL,19,1,10724599,Europe,2710,151
2020-05-11,Greece,EL,6,0,10724599,Europe,2716,151
2020-05-12,Greece,EL,10,0,10724599,Europe,2726,151
2020-05-13,Greece,EL,18,1,10724599,Europe,2744,152
2020-05-14,Greece,EL,16,3,10724599,Europe,2760,155
2020-05-15,Greece,EL,10,1,10724599,Europe,2770,156
2020-05-16,Greece,EL,40,4,10724599,Europe,2810,160
2020-05-17,Greece,EL,9,2,10724599,Europe,2819,162
2020-05-18,Greece,EL,15,1,10724599,Europe,2834,163
2020-05-19,Greece,EL,2,2,10724599,Europe,2836,165
2020-05-20,Greece,EL,4,0,10724599,Europe,2840,165
2020-05-21,Greece,EL,10,1,10724599,Europe,2850,166
2020-05-22,Greece,EL,3,2,10724599,Europe,2853,168
2020-05-23,Greece,EL,20,1,10724599,Europe,2873,169
2020-05-24,Greece,EL,3,2,10724599,Europe,2876,171
2020-05-25,Greece,EL,2,0,10724599,Europe,2878,171
2020-05-26,Greece,EL,4,1,10724599,Europe,2882,172
2020-05-27,Greece,EL,10,1,10724599,Europe,2892,173
2020-05-28,Greece,EL,11,0,10724599,Europe,2903,173
2020-05-29,Greece,EL,3,2,10724599,Europe,2906,175
2020-05-30,Greece,EL,3,0,10724599,Europe,2909,175
2020-05-31,Greece,EL,6,0,10724599,Europe,2915,175
2020-06-01,Greece,EL,2,0,10724599,Europe,2917,175
2020-06-02,Greece,EL,1,4,10724599,Europe,2918,179
2020-06-03,Greece,EL,19,0,10724599,Europe,2937,179
2020-06-04,Greece,EL,0,0,10724599,Europe,2937,179
2020-06-05,Greece,EL,15,1,10724599,Europe,2952,180
2020-06-06,Greece,EL,15,0,10724599,Europe,2967,180
2020-06-07,Greece,EL,13,0,10724599,Europe,2980,180
2020-06-08,Greece,EL,17,0,10724599,Europe,2997,180
2020-06-09,Greece,EL,52,2,10724599,Europe,3049,182
2020-06-10,Greece,EL,9,1,10724599,Europe,3058,183
2020-06-11,Greece,EL,10,0,10724599,Europe,3068,183
2020-06-12,Greece,EL,20,0,10724599,Europe,3088,183
2020-06-13,Greece,EL,20,0,10724599,Europe,3108,183
2020-06-14,Greece,EL,4,0,10724599,Europe,3112,183
2020-06-15,Greece,EL,9,0,10724599,Europe,3121,183
2020-06-16,Greece,EL,13,1,10724599,Europe,3134,184
2020-06-17,Greece,EL,14,1,10724599,Europe,3148,185
2020-06-18,Greece,EL,55,2,10724599,Europe,3203,187
2020-06-19,Greece,EL,24,1,10724599,Europe,3227,188
2020-06-20,Greece,EL,10,1,10724599,Europe,3237,189
2020-06-21,Greece,EL,19,1,10724599,Europe,3256,190
2020-06-22,Greece,EL,10,0,10724599,Europe,3266,190
2020-06-23,Greece,EL,21,0,10724599,Europe,3287,190
2020-06-24,Greece,EL,15,0,10724599,Europe,3302,190
2020-06-25,Greece,EL,8,0,10724599,Europe,3310,190
2020-06-26,Greece,EL,11,1,10724599,Europe,3321,191
2020-06-27,Greece,EL,22,0,10724599,Europe,3343,191
2020-06-28,Greece,EL,23,0,10724599,Europe,3366,191
2020-06-29,Greece,EL,10,0,10724599,Europe,3376,191
2020-06-30,Greece,EL,14,0,10724599,Europe,3390,191
2020-07-01,Greece,EL,19,1,10724599,Europe,3409,192
2020-07-02,Greece,EL,23,0,10724599,Europe,3432,192
2020-07-03,Greece,EL,26,0,10724599,Europe,3458,192
2020-07-04,Greece,EL,28,0,10724599,Europe,3486,192
2020-07-05,Greece,EL,25,0,10724599,Europe,3511,192
2020-07-06,Greece,EL,8,0,10724599,Europe,3519,192
2020-07-07,Greece,EL,43,0,10724599,Europe,3562,192
2020-07-08,Greece,EL,27,1,10724599,Europe,3589,193
2020-07-09,Greece,EL,33,0,10724599,Europe,3622,193
2020-07-10,Greece,EL,50,0,10724599,Europe,3672,193
2020-07-11,Greece,EL,60,0,10724599,Europe,3732,193
2020-07-12,Greece,EL,40,0,10724599,Europe,3772,193
2020-07-13,Greece,EL,31,0,10724599,Europe,3803,193
2020-07-14,Greece,EL,23,0,10724599,Europe,3826,193
2020-07-15,Greece,EL,57,0,10724599,Europe,3883,193
2020-07-16,Greece,EL,27,0,10724599,Europe,3910,193
2020-07-17,Greece,EL,29,0,10724599,Europe,3939,193
2020-07-18,Greece,EL,25,1,10724599,Europe,3964,194
2020-07-19,Greece,EL,19,0,10724599,Europe,3983,194
2020-07-20,Greece,EL,24,0,10724599,Europe,4007,194
2020-07-21,Greece,EL,5,1,10724599,Europe,4012,195
2020-07-22,Greece,EL,36,2,10724599,Europe,4048,197
2020-07-23,Greece,EL,29,3,10724599,Europe,4077,200
2020-07-24,Greece,EL,33,1,10724599,Europe,4110,201
2020-07-25,Greece,EL,25,0,10724599,Europe,4135,201
2020-07-26,Greece,EL,31,0,10724599,Europe,4166,201
2020-07-27,Greece,EL,27,1,10724599,Europe,4193,202
2020-07-28,Greece,EL,34,0,10724599,Europe,4227,202
2020-07-29,Greece,EL,52,1,10724599,Europe,4279,203
2020-07-30,Greece,EL,57,0,10724599,Europe,4336,203
2020-07-31,Greece,EL,65,0,10724599,Europe,4401,203
2020-08-01,Greece,EL,76,3,10724599,Europe,4477,206
2020-08-02,Greece,EL,110,0,10724599,Europe,4587,206
2020-08-03,Greece,EL,75,2,10724599,Europe,4662,208
2020-08-04,Greece,EL,75,1,10724599,Europe,4737,209
2020-08-05,Greece,EL,118,0,10724599,Europe,4855,209
2020-08-06,Greece,EL,118,1,10724599,Europe,4973,210
2020-08-07,Greece,EL,150,0,10724599,Europe,5123,210
2020-08-08,Greece,EL,147,0,10724599,Europe,5270,210
2020-08-09,Greece,EL,151,1,10724599,Europe,5421,211
2020-08-10,Greece,EL,202,1,10724599,Europe,5623,212
2020-08-11,Greece,EL,126,1,10724599,Europe,5749,213
2020-08-12,Greece,EL,193,1,10724599,Europe,5942,214
2020-08-13,Greece,EL,235,2,10724599,Europe,6177,216
2020-08-14,Greece,EL,204,5,10724599,Europe,6381,221
2020-08-15,Greece,EL,251,2,10724599,Europe,6632,223
2020-08-16,Greece,EL,226,3,10724599,Europe,6858,226
2020-08-17,Greece,EL,217,2,10724599,Europe,7075,228
2020-08-18,Greece,EL,147,2,10724599,Europe,7222,230
2020-08-19,Greece,EL,250,2,10724599,Europe,7472,232
2020-08-20,Greece,EL,212,3,10724599,Europe,7684,235
2020-08-21,Greece,EL,250,0,10724599,Europe,7934,235
2020-08-22,Greece,EL,204,3,10724599,Europe,8138,238
2020-08-23,Greece,EL,243,2,10724599,Europe,8381,240
2020-08-24,Greece,EL,283,2,10724599,Europe,8664,242
2020-08-25,Greece,EL,155,0,10724599,Europe,8819,242
2020-08-26,Greece,EL,168,1,10724599,Europe,8987,243
2020-08-27,Greece,EL,293,5,10724599,Europe,9280,248
2020-08-28,Greece,EL,251,6,10724599,Europe,9531,254
2020-08-29,Greece,EL,269,5,10724599,Europe,9800,259
2020-08-30,Greece,EL,177,1,10724599,Europe,9977,260
2020-08-31,Greece,EL,157,2,10724599,Europe,10134,262
2020-09-01,Greece,EL,183,4,10724599,Europe,10317,266
2020-09-02,Greece,EL,207,5,10724599,Europe,10524,271
2020-09-03,Greece,EL,233,2,10724599,Europe,10757,273
2020-09-04,Greece,EL,241,5,10724599,Europe,10998,278
2020-09-05,Greece,EL,202,1,10724599,Europe,11200,279
2020-09-06,Greece,EL,186,1,10724599,Europe,11386,280
2020-09-07,Greece,EL,138,4,10724599,Europe,11524,284
2020-09-08,Greece,EL,139,5,10724599,Europe,11663,289
2020-09-09,Greece,EL,169,1,10724599,Europe,11832,290
2020-09-10,Greece,EL,248,3,10724599,Europe,12080,293
2020-09-11,Greece,EL,372,4,10724599,Europe,12452,297
2020-09-12,Greece,EL,282,3,10724599,Europe,12734,300
2020-09-13,Greece,EL,302,2,10724599,Europe,13036,302
2020-09-14,Greece,EL,204,3,10724599,Europe,13240,305
2020-09-15,Greece,EL,180,5,10724599,Europe,13420,310
2020-09-16,Greece,EL,310,3,10724599,Europe,13730,313
2020-09-17,Greece,EL,311,3,10724599,Europe,14041,316
2020-09-18,Greece,EL,359,9,10724599,Europe,14400,325
2020-09-19,Greece,EL,338,2,10724599,Europe,14738,327
2020-09-20,Greece,EL,240,4,10724599,Europe,14978,331
2020-09-21,Greece,EL,164,7,10724599,Europe,15142,338
2020-09-22,Greece,EL,453,6,10724599,Europe,15595,344
2020-09-23,Greece,EL,333,8,10724599,Europe,15928,352
2020-09-24,Greece,EL,358,5,10724599,Europe,16286,357
2020-09-25,Greece,EL,341,9,10724599,Europe,16627,366
2020-09-26,Greece,EL,286,3,10724599,Europe,16913,369
2020-09-27,Greece,EL,315,7,10724599,Europe,17228,376
2020-09-28,Greece,EL,216,3,10724599,Europe,17444,379
2020-09-29,Greece,EL,263,4,10724599,Europe,17707,383
2020-09-30,Greece,EL,416,5,10724599,Europe,18123,388
2020-10-01,Greece,EL,352,3,10724599,Europe,18475,391
2020-10-02,Greece,EL,411,2,10724599,Europe,18886,393
2020-10-03,Greece,EL,460,5,10724599,Europe,19346,398
2020-10-04,Greece,EL,267,7,10724599,Europe,19613,405
2020-10-05,Greece,EL,229,4,10724599,Europe,19842,409
2020-10-06,Greece,EL,300,8,10724599,Europe,20142,417
2020-10-07,Greece,EL,399,3,10724599,Europe,20541,420
2020-10-08,Greece,EL,406,4,10724599,Europe,20947,424
2020-10-09,Greece,EL,434,6,10724599,Europe,21381,430
2020-10-10,Greece,EL,391,1,10724599,Europe,21772,431
2020-10-11,Greece,EL,306,5,10724599,Europe,22078,436
2020-10-12,Greece,EL,280,13,10724599,Europe,22358,449
2020-10-13,Greece,EL,294,7,10724599,Europe,22652,456
2020-10-14,Greece,EL,408,6,10724599,Europe,23060,462
2020-10-15,Greece,EL,435,7,10724599,Europe,23495,469
2020-10-16,Greece,EL,452,13,10724599,Europe,23947,482
2020-10-17,Greece,EL,503,8,10724599,Europe,24450,490
2020-10-18,Greece,EL,482,10,10724599,Europe,24932,500
2020-10-19,Greece,EL,438,9,10724599,Europe,25370,509
2020-10-20,Greece,EL,432,11,10724599,Europe,25802,520
2020-10-21,Greece,EL,667,8,10724599,Europe,26469,528
2020-10-22,Greece,EL,865,6,10724599,Europe,27334,534
2020-10-23,Greece,EL,882,15,10724599,Europe,28216,549
2020-10-24,Greece,EL,841,10,10724599,Europe,29057,559
2020-10-25,Greece,EL,935,5,10724599,Europe,29992,564
2020-10-26,Greece,EL,790,10,10724599,Europe,30782,574
2020-10-27,Greece,EL,714,7,10724599,Europe,31496,581
2020-10-28,Greece,EL,1256,12,10724599,Europe,32752,593
2020-10-29,Greece,EL,1547,10,10724599,Europe,34299,603
2020-10-30,Greece,EL,1211,12,10724599,Europe,35510,615
2020-10-31,Greece,EL,1686,5,10724599,Europe,37196,620
2020-11-01,Greece,EL,2055,6,10724599,Europe,39251,626
2020-11-02,Greece,EL,1678,9,10724599,Europe,40929,635
2020-11-03,Greece,EL,1151,7,10724599,Europe,42080,642
2020-11-04,Greece,EL,2166,13,10724599,Europe,44246,655
2020-11-05,Greece,EL,2646,18,10724599,Europe,46892,673
2020-11-06,Greece,EL,2915,29,10724599,Europe,49807,702
2020-11-07,Greece,EL,2447,13,10724599,Europe,52254,715
2020-11-08,Greece,EL,2555,34,10724599,Europe,54809,749
2020-11-09,Greece,EL,1889,35,10724599,Europe,56698,784
2020-11-10,Greece,EL,1489,41,10724599,Europe,58187,825
2020-11-11,Greece,EL,2383,41,10724599,Europe,60570,866
2020-11-12,Greece,EL,2751,43,10724599,Europe,63321,909
2020-11-13,Greece,EL,3316,50,10724599,Europe,66637,959
2020-11-14,Greece,EL,3038,38,10724599,Europe,69675,997
2020-11-15,Greece,EL,2835,38,10724599,Europe,72510,1035
2020-11-16,Greece,EL,1695,71,10724599,Europe,74205,1106
2020-11-17,Greece,EL,2198,59,10724599,Europe,76403,1165
2020-11-18,Greece,EL,2422,63,10724599,Europe,78825,1228
2020-11-19,Greece,EL,3209,60,10724599,Europe,82034,1288
2020-11-20,Greece,EL,3227,59,10724599,Europe,85261,1347
2020-11-21,Greece,EL,2551,72,10724599,Europe,87812,1419
2020-11-22,Greece,EL,2309,108,10724599,Europe,90121,1527
2020-11-23,Greece,EL,1498,103,10724599,Europe,91619,1630
2020-11-24,Greece,EL,1387,84,10724599,Europe,93006,1714
2020-11-25,Greece,EL,2131,101,10724599,Europe,95137,1815
2020-11-26,Greece,EL,2151,87,10724599,Europe,97288,1902
2020-11-27,Greece,EL,2018,99,10724599,Europe,99306,2001
2020-11-28,Greece,EL,1981,101,10724599,Europe,101287,2102
2020-11-29,Greece,EL,1747,121,10724599,Europe,103034,2223
2020-11-30,Greece,EL,1193,98,10724599,Europe,104227,2321
2020-12-01,Greece,EL,1044,85,10724599,Europe,105271,2406
2020-12-02,Greece,EL,2199,111,10724599,Europe,107470,2517
2020-12-03,Greece,EL,2185,89,10724599,Europe,109655,2606
2020-12-04,Greece,EL,1882,100,10724599,Europe,111537,2706
2020-12-05,Greece,EL,1648,98,10724599,Europe,113185,2804
2020-12-06,Greece,EL,1383,98,10724599,Europe,114568,2902
2020-12-07,Greece,EL,903,101,10724599,Europe,115471,3003
2020-12-08,Greece,EL,1250,89,10724599,Europe,116721,3092
2020-12-09,Greece,EL,1324,102,10724599,Europe,118045,3194
2020-12-10,Greece,EL,1675,95,10724599,Europe,119720,3289
2020-12-11,Greece,EL,1533,81,10724599,Europe,121253,3370
2020-12-12,Greece,EL,1395,102,10724599,Europe,122648,3472
2020-12-13,Greece,EL,1194,68,10724599,Europe,123842,3540
2020-12-14,Greece,EL,692,85,10724599,Europe,124534,3625
2020-03-22,Eritrea,ER,1,0,3497117,Africa,1,0
2020-03-23,Eritrea,ER,0,0,3497117,Africa,1,0
2020-03-24,Eritrea,ER,0,0,3497117,Africa,1,0
2020-03-25,Eritrea,ER,0,0,3497117,Africa,1,0
2020-03-26,Eritrea,ER,3,0,3497117,Africa,4,0
2020-03-27,Eritrea,ER,2,0,3497117,Africa,6,0
2020-03-28,Eritrea,ER,0,0,3497117,Africa,6,0
2020-03-29,Eritrea,ER,0,0,3497117,Africa,6,0
2020-03-30,Eritrea,ER,6,0,3497117,Africa,12,0
2020-03-31,Eritrea,ER,0,0,3497117,Africa,12,0
2020-04-01,Eritrea,ER,3,0,3497117,Africa,15,0
2020-04-02,Eritrea,ER,3,0,3497117,Africa,18,0
2020-04-03,Eritrea,ER,4,0,3497117,Africa,22,0
2020-04-04,Eritrea,ER,0,0,3497117,Africa,22,0
2020-04-05,Eritrea,ER,7,0,3497117,Africa,29,0
2020-04-06,Eritrea,ER,0,0,3497117,Africa,29,0
2020-04-07,Eritrea,ER,2,0,3497117,Africa,31,0
2020-04-08,Eritrea,ER,0,0,3497117,Africa,31,0
2020-04-09,Eritrea,ER,2,0,3497117,Africa,33,0
2020-04-10,Eritrea,ER,0,0,3497117,Africa,33,0
2020-04-11,Eritrea,ER,1,0,3497117,Africa,34,0
2020-04-12,Eritrea,ER,0,0,3497117,Africa,34,0
2020-04-13,Eritrea,ER,0,0,3497117,Africa,34,0
2020-04-14,Eritrea,ER,0,0,3497117,Africa,34,0
2020-04-15,Eritrea,ER,1,0,3497117,Africa,35,0
2020-04-16,Eritrea,ER,0,0,3497117,Africa,35,0
2020-04-17,Eritrea,ER,0,0,3497117,Africa,35,0
2020-04-18,Eritrea,ER,0,0,3497117,Africa,35,0
2020-04-19,Eritrea,ER,0,0,3497117,Africa,35,0
2020-04-20,Eritrea,ER,4,0,3497117,Africa,39,0
2020-04-21,Eritrea,ER,0,0,3497117,Africa,39,0
2020-04-22,Eritrea,ER,0,0,3497117,Africa,39,0
2020-04-23,Eritrea,ER,0,0,3497117,Africa,39,0
2020-04-24,Eritrea,ER,0,0,3497117,Africa,39,0
2020-04-25,Eritrea,ER,0,0,3497117,Africa,39,0
2020-04-26,Eritrea,ER,0,0,3497117,Africa,39,0
2020-04-27,Eritrea,ER,0,0,3497117,Africa,39,0
2020-04-28,Eritrea,ER,0,0,3497117,Africa,39,0
2020-04-29,Eritrea,ER,0,0,3497117,Africa,39,0
2020-04-30,Eritrea,ER,0,0,3497117,Africa,39,0
2020-05-01,Eritrea,ER,0,0,3497117,Africa,39,0
2020-05-02,Eritrea,ER,0,0,3497117,Africa,39,0
2020-05-03,Eritrea,ER,0,0,3497117,Africa,39,0
2020-05-04,Eritrea,ER,0,0,3497117,Africa,39,0
2020-05-05,Eritrea,ER,0,0,3497117,Africa,39,0
2020-05-06,Eritrea,ER,0,0,3497117,Africa,39,0
2020-05-07,Eritrea,ER,0,0,3497117,Africa,39,0
2020-05-08,Eritrea,ER,0,0,3497117,Africa,39,0
2020-05-09,Eritrea,ER,0,0,3497117,Africa,39,0
2020-05-10,Eritrea,ER,0,0,3497117,Africa,39,0
2020-05-11,Eritrea,ER,0,0,3497117,Africa,39,0
2020-05-12,Eritrea,ER,0,0,3497117,Africa,39,0
2020-05-13,Eritrea,ER,0,0,3497117,Africa,39,0
2020-05-14,Eritrea,ER,0,0,3497117,Africa,39,0
2020-05-15,Eritrea,ER,0,0,3497117,Africa,39,0
2020-05-16,Eritrea,ER,0,0,3497117,Africa,39,0
2020-05-17,Eritrea,ER,0,0,3497117,Africa,39,0
2020-05-18,Eritrea,ER,0,0,3497117,Africa,39,0
2020-05-19,Eritrea,ER,0,0,3497117,Africa,39,0
2020-05-20,Eritrea,ER,0,0,3497117,Africa,39,0
2020-05-21,Eritrea,ER,0,0,3497117,Africa,39,0
2020-05-22,Eritrea,ER,0,0,3497117,Africa,39,0
2020-05-23,Eritrea,ER,0,0,3497117,Africa,39,0
2020-05-24,Eritrea,ER,0,0,3497117,Africa,39,0
2020-05-25,Eritrea,ER,0,0,3497117,Africa,39,0
2020-05-26,Eritrea,ER,0,0,3497117,Africa,39,0
2020-05-27,Eritrea,ER,0,0,3497117,Africa,39,0
2020-05-28,Eritrea,ER,0,0,3497117,Africa,39,0
2020-05-29,Eritrea,ER,0,0,3497117,Africa,39,0
2020-05-30,Eritrea,ER,0,0,3497117,Africa,39,0
2020-05-31,Eritrea,ER,0,0,3497117,Africa,39,0
2020-06-01,Eritrea,ER,0,0,3497117,Africa,39,0
2020-06-02,Eritrea,ER,0,0,3497117,Africa,39,0
2020-06-03,Eritrea,ER,0,0,3497117,Africa,39,0
2020-06-04,Eritrea,ER,1,0,3497117,Africa,40,0
2020-06-05,Eritrea,ER,1,0,3497117,Africa,41,0
2020-06-06,Eritrea,ER,0,0,3497117,Africa,41,0
2020-06-07,Eritrea,ER,0,0,3497117,Africa,41,0
2020-06-08,Eritrea,ER,0,0,3497117,Africa,41,0
2020-06-09,Eritrea,ER,0,0,3497117,Africa,41,0
2020-06-10,Eritrea,ER,0,0,3497117,Africa,41,0
2020-06-11,Eritrea,ER,0,0,3497117,Africa,41,0
2020-06-12,Eritrea,ER,0,0,3497117,Africa,41,0
2020-06-13,Eritrea,ER,0,0,3497117,Africa,41,0
2020-06-14,Eritrea,ER,24,0,3497117,Africa,65,0
2020-06-15,Eritrea,ER,31,0,3497117,Africa,96,0
2020-06-16,Eritrea,ER,13,0,3497117,Africa,109,0
2020-06-17,Eritrea,ER,12,0,3497117,Africa,121,0
2020-06-18,Eritrea,ER,10,0,3497117,Africa,131,0
2020-06-19,Eritrea,ER,11,0,3497117,Africa,142,0
2020-06-20,Eritrea,ER,0,0,3497117,Africa,142,0
2020-06-21,Eritrea,ER,1,0,3497117,Africa,143,0
2020-06-22,Eritrea,ER,0,0,3497117,Africa,143,0
2020-06-23,Eritrea,ER,0,0,3497117,Africa,143,0
2020-06-24,Eritrea,ER,0,0,3497117,Africa,143,0
2020-06-25,Eritrea,ER,0,0,3497117,Africa,143,0
2020-06-26,Eritrea,ER,1,0,3497117,Africa,144,0
2020-06-27,Eritrea,ER,23,0,3497117,Africa,167,0
2020-06-28,Eritrea,ER,24,0,3497117,Africa,191,0
2020-06-29,Eritrea,ER,0,0,3497117,Africa,191,0
2020-06-30,Eritrea,ER,0,0,3497117,Africa,191,0
2020-07-01,Eritrea,ER,12,0,3497117,Africa,203,0
2020-07-02,Eritrea,ER,0,0,3497117,Africa,203,0
2020-07-03,Eritrea,ER,12,0,3497117,Africa,215,0
2020-07-04,Eritrea,ER,0,0,3497117,Africa,215,0
2020-07-05,Eritrea,ER,0,0,3497117,Africa,215,0
2020-07-06,Eritrea,ER,0,0,3497117,Africa,215,0
2020-07-07,Eritrea,ER,0,0,3497117,Africa,215,0
2020-07-08,Eritrea,ER,0,0,3497117,Africa,215,0
2020-07-09,Eritrea,ER,0,0,3497117,Africa,215,0
2020-07-10,Eritrea,ER,17,0,3497117,Africa,232,0
2020-07-11,Eritrea,ER,0,0,3497117,Africa,232,0
2020-07-12,Eritrea,ER,0,0,3497117,Africa,232,0
2020-07-13,Eritrea,ER,0,0,3497117,Africa,232,0
2020-07-14,Eritrea,ER,0,0,3497117,Africa,232,0
2020-07-15,Eritrea,ER,0,0,3497117,Africa,232,0
2020-07-16,Eritrea,ER,0,0,3497117,Africa,232,0
2020-07-17,Eritrea,ER,19,0,3497117,Africa,251,0
2020-07-18,Eritrea,ER,0,0,3497117,Africa,251,0
2020-07-19,Eritrea,ER,0,0,3497117,Africa,251,0
2020-07-20,Eritrea,ER,0,0,3497117,Africa,251,0
2020-07-21,Eritrea,ER,0,0,3497117,Africa,251,0
2020-07-22,Eritrea,ER,0,0,3497117,Africa,251,0
2020-07-23,Eritrea,ER,0,0,3497117,Africa,251,0
2020-07-24,Eritrea,ER,10,0,3497117,Africa,261,0
2020-07-25,Eritrea,ER,0,0,3497117,Africa,261,0
2020-07-26,Eritrea,ER,2,0,3497117,Africa,263,0
2020-07-27,Eritrea,ER,0,0,3497117,Africa,263,0
2020-07-28,Eritrea,ER,2,0,3497117,Africa,265,0
2020-07-29,Eritrea,ER,0,0,3497117,Africa,265,0
2020-07-30,Eritrea,ER,0,0,3497117,Africa,265,0
2020-07-31,Eritrea,ER,14,0,3497117,Africa,279,0
2020-08-01,Eritrea,ER,0,0,3497117,Africa,279,0
2020-08-02,Eritrea,ER,0,0,3497117,Africa,279,0
2020-08-03,Eritrea,ER,0,0,3497117,Africa,279,0
2020-08-04,Eritrea,ER,3,0,3497117,Africa,282,0
2020-08-05,Eritrea,ER,0,0,3497117,Africa,282,0
2020-08-06,Eritrea,ER,0,0,3497117,Africa,282,0
2020-08-07,Eritrea,ER,0,0,3497117,Africa,282,0
2020-08-08,Eritrea,ER,3,0,3497117,Africa,285,0
2020-08-09,Eritrea,ER,0,0,3497117,Africa,285,0
2020-08-10,Eritrea,ER,0,0,3497117,Africa,285,0
2020-08-11,Eritrea,ER,0,0,3497117,Africa,285,0
2020-08-12,Eritrea,ER,0,0,3497117,Africa,285,0
2020-08-13,Eritrea,ER,0,0,3497117,Africa,285,0
2020-08-14,Eritrea,ER,0,0,3497117,Africa,285,0
2020-08-15,Eritrea,ER,0,0,3497117,Africa,285,0
2020-08-16,Eritrea,ER,0,0,3497117,Africa,285,0
2020-08-17,Eritrea,ER,0,0,3497117,Africa,285,0
2020-08-18,Eritrea,ER,0,0,3497117,Africa,285,0
2020-08-19,Eritrea,ER,19,0,3497117,Africa,304,0
2020-08-20,Eritrea,ER,0,0,3497117,Africa,304,0
2020-08-21,Eritrea,ER,0,0,3497117,Africa,304,0
2020-08-22,Eritrea,ER,2,0,3497117,Africa,306,0
2020-08-23,Eritrea,ER,0,0,3497117,Africa,306,0
2020-08-24,Eritrea,ER,0,0,3497117,Africa,306,0
2020-08-25,Eritrea,ER,0,0,3497117,Africa,306,0
2020-08-26,Eritrea,ER,9,0,3497117,Africa,315,0
2020-08-27,Eritrea,ER,0,0,3497117,Africa,315,0
2020-08-28,Eritrea,ER,2,0,3497117,Africa,317,0
2020-08-29,Eritrea,ER,0,0,3497117,Africa,317,0
2020-08-30,Eritrea,ER,1,0,3497117,Africa,318,0
2020-08-31,Eritrea,ER,0,0,3497117,Africa,318,0
2020-09-01,Eritrea,ER,0,0,3497117,Africa,318,0
2020-09-02,Eritrea,ER,1,0,3497117,Africa,319,0
2020-09-03,Eritrea,ER,0,0,3497117,Africa,319,0
2020-09-04,Eritrea,ER,11,0,3497117,Africa,330,0
2020-09-05,Eritrea,ER,0,0,3497117,Africa,330,0
2020-09-06,Eritrea,ER,0,0,3497117,Africa,330,0
2020-09-07,Eritrea,ER,0,0,3497117,Africa,330,0
2020-09-08,Eritrea,ER,0,0,3497117,Africa,330,0
2020-09-09,Eritrea,ER,11,0,3497117,Africa,341,0
2020-09-10,Eritrea,ER,0,0,3497117,Africa,341,0
2020-09-11,Eritrea,ER,20,0,3497117,Africa,361,0
2020-09-12,Eritrea,ER,0,0,3497117,Africa,361,0
2020-09-13,Eritrea,ER,0,0,3497117,Africa,361,0
2020-09-14,Eritrea,ER,0,0,3497117,Africa,361,0
2020-09-15,Eritrea,ER,0,0,3497117,Africa,361,0
2020-09-16,Eritrea,ER,0,0,3497117,Africa,361,0
2020-09-17,Eritrea,ER,3,0,3497117,Africa,364,0
2020-09-18,Eritrea,ER,0,0,3497117,Africa,364,0
2020-09-19,Eritrea,ER,0,0,3497117,Africa,364,0
2020-09-20,Eritrea,ER,0,0,3497117,Africa,364,0
2020-09-21,Eritrea,ER,0,0,3497117,Africa,364,0
2020-09-22,Eritrea,ER,0,0,3497117,Africa,364,0
2020-09-23,Eritrea,ER,0,0,3497117,Africa,364,0
2020-09-24,Eritrea,ER,0,0,3497117,Africa,364,0
2020-09-25,Eritrea,ER,0,0,3497117,Africa,364,0
2020-09-26,Eritrea,ER,5,0,3497117,Africa,369,0
2020-09-27,Eritrea,ER,6,0,3497117,Africa,375,0
2020-09-28,Eritrea,ER,0,0,3497117,Africa,375,0
2020-09-29,Eritrea,ER,0,0,3497117,Africa,375,0
2020-09-30,Eritrea,ER,0,0,3497117,Africa,375,0
2020-10-01,Eritrea,ER,0,0,3497117,Africa,375,0
2020-10-02,Eritrea,ER,0,0,3497117,Africa,375,0
2020-10-03,Eritrea,ER,6,0,3497117,Africa,381,0
2020-10-04,Eritrea,ER,17,0,3497117,Africa,398,0
2020-10-05,Eritrea,ER,0,0,3497117,Africa,398,0
2020-10-06,Eritrea,ER,0,0,3497117,Africa,398,0
2020-10-07,Eritrea,ER,0,0,3497117,Africa,398,0
2020-10-08,Eritrea,ER,0,0,3497117,Africa,398,0
2020-10-09,Eritrea,ER,7,0,3497117,Africa,405,0
2020-10-10,Eritrea,ER,0,0,3497117,Africa,405,0
2020-10-11,Eritrea,ER,9,0,3497117,Africa,414,0
2020-10-12,Eritrea,ER,0,0,3497117,Africa,414,0
2020-10-13,Eritrea,ER,0,0,3497117,Africa,414,0
2020-10-14,Eritrea,ER,0,0,3497117,Africa,414,0
2020-10-15,Eritrea,ER,0,0,3497117,Africa,414,0
2020-10-16,Eritrea,ER,0,0,3497117,Africa,414,0
2020-10-17,Eritrea,ER,8,0,3497117,Africa,422,0
2020-10-18,Eritrea,ER,0,0,3497117,Africa,422,0
2020-10-19,Eritrea,ER,3,0,3497117,Africa,425,0
2020-10-20,Eritrea,ER,27,0,3497117,Africa,452,0
2020-10-21,Eritrea,ER,0,0,3497117,Africa,452,0
2020-10-22,Eritrea,ER,0,0,3497117,Africa,452,0
2020-10-23,Eritrea,ER,5,0,3497117,Africa,457,0
2020-10-24,Eritrea,ER,4,0,3497117,Africa,461,0
2020-10-25,Eritrea,ER,0,0,3497117,Africa,461,0
2020-10-26,Eritrea,ER,0,0,3497117,Africa,461,0
2020-10-27,Eritrea,ER,0,0,3497117,Africa,461,0
2020-10-28,Eritrea,ER,0,0,3497117,Africa,461,0
2020-10-29,Eritrea,ER,0,0,3497117,Africa,461,0
2020-10-30,Eritrea,ER,0,0,3497117,Africa,461,0
2020-10-31,Eritrea,ER,0,0,3497117,Africa,461,0
2020-11-01,Eritrea,ER,2,0,3497117,Africa,463,0
2020-11-02,Eritrea,ER,0,0,3497117,Africa,463,0
2020-11-03,Eritrea,ER,0,0,3497117,Africa,463,0
2020-11-04,Eritrea,ER,17,0,3497117,Africa,480,0
2020-11-05,Eritrea,ER,0,0,3497117,Africa,480,0
2020-11-06,Eritrea,ER,4,0,3497117,Africa,484,0
2020-11-07,Eritrea,ER,0,0,3497117,Africa,484,0
2020-11-08,Eritrea,ER,7,0,3497117,Africa,491,0
2020-11-09,Eritrea,ER,0,0,3497117,Africa,491,0
2020-11-10,Eritrea,ER,0,0,3497117,Africa,491,0
2020-11-11,Eritrea,ER,0,0,3497117,Africa,491,0
2020-11-12,Eritrea,ER,0,0,3497117,Africa,491,0
2020-11-13,Eritrea,ER,0,0,3497117,Africa,491,0
2020-11-14,Eritrea,ER,2,0,3497117,Africa,493,0
2020-11-15,Eritrea,ER,0,0,3497117,Africa,493,0
2020-11-16,Eritrea,ER,0,0,3497117,Africa,493,0
2020-11-17,Eritrea,ER,0,0,3497117,Africa,493,0
2020-11-18,Eritrea,ER,0,0,3497117,Africa,493,0
2020-11-19,Eritrea,ER,25,0,3497117,Africa,518,0
2020-11-20,Eritrea,ER,9,0,3497117,Africa,527,0
2020-11-21,Eritrea,ER,0,0,3497117,Africa,527,0
2020-11-22,Eritrea,ER,24,0,3497117,Africa,551,0
2020-11-23,Eritrea,ER,0,0,3497117,Africa,551,0
2020-11-24,Eritrea,ER,7,0,3497117,Africa,558,0
2020-11-25,Eritrea,ER,0,0,3497117,Africa,558,0
2020-11-26,Eritrea,ER,0,0,3497117,Africa,558,0
2020-11-27,Eritrea,ER,8,0,3497117,Africa,566,0
2020-11-28,Eritrea,ER,0,0,3497117,Africa,566,0
2020-11-29,Eritrea,ER,11,0,3497117,Africa,577,0
2020-11-30,Eritrea,ER,0,0,3497117,Africa,577,0
2020-12-01,Eritrea,ER,0,0,3497117,Africa,577,0
2020-12-02,Eritrea,ER,0,0,3497117,Africa,577,0
2020-12-03,Eritrea,ER,0,0,3497117,Africa,577,0
2020-12-04,Eritrea,ER,17,0,3497117,Africa,594,0
2020-12-05,Eritrea,ER,38,0,3497117,Africa,632,0
2020-12-06,Eritrea,ER,0,0,3497117,Africa,632,0
2020-12-07,Eritrea,ER,0,0,3497117,Africa,632,0
2020-12-08,Eritrea,ER,17,0,3497117,Africa,649,0
2020-12-09,Eritrea,ER,0,0,3497117,Africa,649,0
2020-12-10,Eritrea,ER,0,0,3497117,Africa,649,0
2020-12-11,Eritrea,ER,7,0,3497117,Africa,656,0
2020-12-12,Eritrea,ER,0,0,3497117,Africa,656,0
2020-12-13,Eritrea,ER,55,0,3497117,Africa,711,0
2020-12-14,Eritrea,ER,0,0,3497117,Africa,711,0
2019-12-31,Spain,ES,0,0,46937060,Europe,0,0
2020-01-01,Spain,ES,0,0,46937060,Europe,0,0
2020-01-02,Spain,ES,0,0,46937060,Europe,0,0
2020-01-03,Spain,ES,0,0,46937060,Europe,0,0
2020-01-04,Spain,ES,0,0,46937060,Europe,0,0
2020-01-05,Spain,ES,0,0,46937060,Europe,0,0
2020-01-06,Spain,ES,0,0,46937060,Europe,0,0
2020-01-07,Spain,ES,0,0,46937060,Europe,0,0
2020-01-08,Spain,ES,0,0,46937060,Europe,0,0
2020-01-09,Spain,ES,0,0,46937060,Europe,0,0
2020-01-10,Spain,ES,0,0,46937060,Europe,0,0
2020-01-11,Spain,ES,0,0,46937060,Europe,0,0
2020-01-12,Spain,ES,0,0,46937060,Europe,0,0
2020-01-13,Spain,ES,0,0,46937060,Europe,0,0
2020-01-14,Spain,ES,0,0,46937060,Europe,0,0
2020-01-15,Spain,ES,0,0,46937060,Europe,0,0
2020-01-16,Spain,ES,0,0,46937060,Europe,0,0
2020-01-17,Spain,ES,0,0,46937060,Europe,0,0
2020-01-18,Spain,ES,0,0,46937060,Europe,0,0
2020-01-19,Spain,ES,0,0,46937060,Europe,0,0
2020-01-20,Spain,ES,0,0,46937060,Europe,0,0
2020-01-21,Spain,ES,0,0,46937060,Europe,0,0
2020-01-22,Spain,ES,0,0,46937060,Europe,0,0
2020-01-23,Spain,ES,0,0,46937060,Europe,0,0
2020-01-24,Spain,ES,0,0,46937060,Europe,0,0
2020-01-25,Spain,ES,0,0,46937060,Europe,0,0
2020-01-26,Spain,ES,0,0,46937060,Europe,0,0
2020-01-27,Spain,ES,0,0,46937060,Europe,0,0
2020-01-28,Spain,ES,0,0,46937060,Europe,0,0
2020-01-29,Spain,ES,0,0,46937060,Europe,0,0
2020-01-30,Spain,ES,0,0,46937060,Europe,0,0
2020-01-31,Spain,ES,0,0,46937060,Europe,0,0
2020-02-01,Spain,ES,1,0,46937060,Europe,1,0
2020-02-02,Spain,ES,0,0,46937060,Europe,1,0
2020-02-03,Spain,ES,0,0,46937060,Europe,1,0
2020-02-04,Spain,ES,0,0,46937060,Europe,1,0
2020-02-05,Spain,ES,0,0,46937060,Europe,1,0
2020-02-06,Spain,ES,0,0,46937060,Europe,1,0
2020-02-07,Spain,ES,0,0,46937060,Europe,1,0
2020-02-08,Spain,ES,0,0,46937060,Europe,1,0
2020-02-09,Spain,ES,0,0,46937060,Europe,1,0
2020-02-10,Spain,ES,1,0,46937060,Europe,2,0
2020-02-11,Spain,ES,0,0,46937060,Europe,2,0
2020-02-12,Spain,ES,0,0,46937060,Europe,2,0
2020-02-13,Spain,ES,0,0,46937060,Europe,2,0
2020-02-14,Spain,ES,0,0,46937060,Europe,2,0
2020-02-15,Spain,ES,0,0,46937060,Europe,2,0
2020-02-16,Spain,ES,0,0,46937060,Europe,2,0
2020-02-17,Spain,ES,0,0,46937060,Europe,2,0
2020-02-18,Spain,ES,0,0,46937060,Europe,2,0
2020-02-19,Spain,ES,0,0,46937060,Europe,2,0
2020-02-20,Spain,ES,0,0,46937060,Europe,2,0
2020-02-21,Spain,ES,0,0,46937060,Europe,2,0
2020-02-22,Spain,ES,0,0,46937060,Europe,2,0
2020-02-23,Spain,ES,0,0,46937060,Europe,2,0
2020-02-24,Spain,ES,0,0,46937060,Europe,2,0
2020-02-25,Spain,ES,1,0,46937060,Europe,3,0
2020-02-26,Spain,ES,6,0,46937060,Europe,9,0
2020-02-27,Spain,ES,8,0,46937060,Europe,17,0
2020-02-28,Spain,ES,18,0,46937060,Europe,35,0
2020-02-29,Spain,ES,19,0,46937060,Europe,54,0
2020-03-01,Spain,ES,28,0,46937060,Europe,82,0
2020-03-02,Spain,ES,54,0,46937060,Europe,136,0
2020-03-03,Spain,ES,56,0,46937060,Europe,192,0
2020-03-04,Spain,ES,75,0,46937060,Europe,267,0
2020-03-05,Spain,ES,81,1,46937060,Europe,348,1
2020-03-06,Spain,ES,183,2,46937060,Europe,531,3
2020-03-07,Spain,ES,233,2,46937060,Europe,764,5
2020-03-08,Spain,ES,330,0,46937060,Europe,1094,5
2020-03-09,Spain,ES,433,0,46937060,Europe,1527,5
2020-03-10,Spain,ES,772,23,46937060,Europe,2299,28
2020-03-11,Spain,ES,975,7,46937060,Europe,3274,35
2020-03-12,Spain,ES,1153,12,46937060,Europe,4427,47
2020-03-13,Spain,ES,1531,37,46937060,Europe,5958,84
2020-03-14,Spain,ES,1683,37,46937060,Europe,7641,121
2020-03-15,Spain,ES,2144,15,46937060,Europe,9785,136
2020-03-16,Spain,ES,1706,152,46937060,Europe,11491,288
2020-03-17,Spain,ES,2503,21,46937060,Europe,13994,309
2020-03-18,Spain,ES,3694,182,46937060,Europe,17688,491
2020-03-19,Spain,ES,4047,107,46937060,Europe,21735,598
2020-03-20,Spain,ES,4569,169,46937060,Europe,26304,767
2020-03-21,Spain,ES,5446,235,46937060,Europe,31750,1002
2020-03-22,Spain,ES,4866,324,46937060,Europe,36616,1326
2020-03-23,Spain,ES,4646,394,46937060,Europe,41262,1720
2020-03-24,Spain,ES,7691,462,46937060,Europe,48953,2182
2020-03-25,Spain,ES,8553,514,46937060,Europe,57506,2696
2020-03-26,Spain,ES,8954,738,46937060,Europe,66460,3434
2020-03-27,Spain,ES,9181,655,46937060,Europe,75641,4089
2020-03-28,Spain,ES,8244,769,46937060,Europe,83885,4858
2020-03-29,Spain,ES,6424,832,46937060,Europe,90309,5690
2020-03-30,Spain,ES,5813,838,46937060,Europe,96122,6528
2020-03-31,Spain,ES,8145,812,46937060,Europe,104267,7340
2020-04-01,Spain,ES,7413,849,46937060,Europe,111680,8189
2020-04-02,Spain,ES,7583,864,46937060,Europe,119263,9053
2020-04-03,Spain,ES,7272,950,46937060,Europe,126535,10003
2020-04-04,Spain,ES,6663,932,46937060,Europe,133198,10935
2020-04-05,Spain,ES,5533,809,46937060,Europe,138731,11744
2020-04-06,Spain,ES,3667,674,46937060,Europe,142398,12418
2020-04-07,Spain,ES,5209,637,46937060,Europe,147607,13055
2020-04-08,Spain,ES,5583,743,46937060,Europe,153190,13798
2020-04-09,Spain,ES,5745,757,46937060,Europe,158935,14555
2020-04-10,Spain,ES,4537,683,46937060,Europe,163472,15238
2020-04-11,Spain,ES,4550,605,46937060,Europe,168022,15843
2020-04-12,Spain,ES,3899,510,46937060,Europe,171921,16353
2020-04-13,Spain,ES,3030,619,46937060,Europe,174951,16972
2020-04-14,Spain,ES,3116,517,46937060,Europe,178067,17489
2020-04-15,Spain,ES,4424,787,46937060,Europe,182491,18276
2020-04-16,Spain,ES,3820,617,46937060,Europe,186311,18893
2020-04-17,Spain,ES,3818,585,46937060,Europe,190129,19478
2020-04-18,Spain,ES,3836,565,46937060,Europe,193965,20043
2020-04-19,Spain,ES,-713,410,46937060,Europe,193252,20453
2020-04-20,Spain,ES,2218,399,46937060,Europe,195470,20852
2020-04-21,Spain,ES,2951,430,46937060,Europe,198421,21282
2020-04-22,Spain,ES,2312,435,46937060,Europe,200733,21717
2020-04-23,Spain,ES,2916,440,46937060,Europe,203649,22157
2020-04-24,Spain,ES,2114,367,46937060,Europe,205763,22524
2020-04-25,Spain,ES,2506,378,46937060,Europe,208269,22902
2020-04-26,Spain,ES,1641,288,46937060,Europe,209910,23190
2020-04-27,Spain,ES,1660,0,46937060,Europe,211570,23190
2020-04-28,Spain,ES,1525,632,46937060,Europe,213095,23822
2020-04-29,Spain,ES,847,453,46937060,Europe,213942,24275
2020-04-30,Spain,ES,1241,268,46937060,Europe,215183,24543
2020-05-01,Spain,ES,1387,281,46937060,Europe,216570,24824
2020-05-02,Spain,ES,1234,276,46937060,Europe,217804,25100
2020-05-03,Spain,ES,935,164,46937060,Europe,218739,25264
2020-05-04,Spain,ES,466,164,46937060,Europe,219205,25428
2020-05-05,Spain,ES,1039,185,46937060,Europe,220244,25613
2020-05-06,Spain,ES,880,244,46937060,Europe,221124,25857
2020-05-07,Spain,ES,921,213,46937060,Europe,222045,26070
2020-05-08,Spain,ES,1173,181,46937060,Europe,223218,26251
2020-05-09,Spain,ES,743,227,46937060,Europe,223961,26478
2020-05-10,Spain,ES,3416,143,46937060,Europe,227377,26621
2020-05-11,Spain,ES,393,123,46937060,Europe,227770,26744
2020-05-12,Spain,ES,482,176,46937060,Europe,228252,26920
2020-05-13,Spain,ES,439,184,46937060,Europe,228691,27104
2020-05-14,Spain,ES,849,217,46937060,Europe,229540,27321
2020-05-15,Spain,ES,643,138,46937060,Europe,230183,27459
2020-05-16,Spain,ES,515,104,46937060,Europe,230698,27563
2020-05-17,Spain,ES,652,87,46937060,Europe,231350,27650
2020-05-18,Spain,ES,256,59,46937060,Europe,231606,27709
2020-05-19,Spain,ES,431,69,46937060,Europe,232037,27778
2020-05-20,Spain,ES,518,110,46937060,Europe,232555,27888
2020-05-21,Spain,ES,482,52,46937060,Europe,233037,27940
2020-05-22,Spain,ES,1787,688,46937060,Europe,234824,28628
2020-05-23,Spain,ES,466,50,46937060,Europe,235290,28678
2020-05-24,Spain,ES,482,74,46937060,Europe,235772,28752
2020-05-25,Spain,ES,-372,-1918,46937060,Europe,235400,26834
2020-05-26,Spain,ES,859,283,46937060,Europe,236259,27117
2020-05-27,Spain,ES,510,1,46937060,Europe,236769,27118
2020-05-28,Spain,ES,1137,1,46937060,Europe,237906,27119
2020-05-29,Spain,ES,658,2,46937060,Europe,238564,27121
2020-05-30,Spain,ES,664,4,46937060,Europe,239228,27125
2020-05-31,Spain,ES,201,2,46937060,Europe,239429,27127
2020-06-01,Spain,ES,209,0,46937060,Europe,239638,27127
2020-06-02,Spain,ES,294,0,46937060,Europe,239932,27127
2020-06-03,Spain,ES,394,1,46937060,Europe,240326,27128
2020-06-04,Spain,ES,334,5,46937060,Europe,240660,27133
2020-06-05,Spain,ES,318,1,46937060,Europe,240978,27134
2020-06-06,Spain,ES,332,1,46937060,Europe,241310,27135
2020-06-07,Spain,ES,240,1,46937060,Europe,241550,27136
2020-06-08,Spain,ES,167,0,46937060,Europe,241717,27136
2020-06-09,Spain,ES,249,0,46937060,Europe,241966,27136
2020-06-10,Spain,ES,314,0,46937060,Europe,242280,27136
2020-06-11,Spain,ES,427,0,46937060,Europe,242707,27136
2020-06-12,Spain,ES,502,0,46937060,Europe,243209,27136
2020-06-13,Spain,ES,396,0,46937060,Europe,243605,27136
2020-06-14,Spain,ES,323,0,46937060,Europe,243928,27136
2020-06-15,Spain,ES,181,0,46937060,Europe,244109,27136
2020-06-16,Spain,ES,219,0,46937060,Europe,244328,27136
2020-06-17,Spain,ES,355,0,46937060,Europe,244683,27136
2020-06-18,Spain,ES,585,0,46937060,Europe,245268,27136
2020-06-19,Spain,ES,307,1179,46937060,Europe,245575,28315
2020-06-20,Spain,ES,363,7,46937060,Europe,245938,28322
2020-06-21,Spain,ES,334,1,46937060,Europe,246272,28323
2020-06-22,Spain,ES,232,1,46937060,Europe,246504,28324
2020-06-23,Spain,ES,248,1,46937060,Europe,246752,28325
2020-06-24,Spain,ES,334,2,46937060,Europe,247086,28327
2020-06-25,Spain,ES,400,3,46937060,Europe,247486,28330
2020-06-26,Spain,ES,419,8,46937060,Europe,247905,28338
2020-06-27,Spain,ES,564,3,46937060,Europe,248469,28341
2020-06-28,Spain,ES,301,2,46937060,Europe,248770,28343
2020-06-29,Spain,ES,200,3,46937060,Europe,248970,28346
2020-06-30,Spain,ES,301,9,46937060,Europe,249271,28355
2020-07-01,Spain,ES,388,8,46937060,Europe,249659,28363
2020-07-02,Spain,ES,444,5,46937060,Europe,250103,28368
2020-07-03,Spain,ES,442,17,46937060,Europe,250545,28385
2020-07-04,Spain,ES,0,0,46937060,Europe,250545,28385
2020-07-05,Spain,ES,0,0,46937060,Europe,250545,28385
2020-07-06,Spain,ES,1244,3,46937060,Europe,251789,28388
2020-07-07,Spain,ES,341,4,46937060,Europe,252130,28392
2020-07-08,Spain,ES,383,4,46937060,Europe,252513,28396
2020-07-09,Spain,ES,543,5,46937060,Europe,253056,28401
2020-07-10,Spain,ES,852,2,46937060,Europe,253908,28403
2020-07-11,Spain,ES,0,0,46937060,Europe,253908,28403
2020-07-12,Spain,ES,0,0,46937060,Europe,253908,28403
2020-07-13,Spain,ES,2045,3,46937060,Europe,255953,28406
2020-07-14,Spain,ES,666,3,46937060,Europe,256619,28409
2020-07-15,Spain,ES,875,4,46937060,Europe,257494,28413
2020-07-16,Spain,ES,1361,3,46937060,Europe,258855,28416
2020-07-17,Spain,ES,1400,4,46937060,Europe,260255,28420
2020-07-18,Spain,ES,0,0,46937060,Europe,260255,28420
2020-07-19,Spain,ES,0,0,46937060,Europe,260255,28420
2020-07-20,Spain,ES,4581,2,46937060,Europe,264836,28422
2020-07-21,Spain,ES,1358,2,46937060,Europe,266194,28424
2020-07-22,Spain,ES,1357,2,46937060,Europe,267551,28426
2020-07-23,Spain,ES,2615,3,46937060,Europe,270166,28429
2020-07-24,Spain,ES,2255,3,46937060,Europe,272421,28432
2020-07-25,Spain,ES,0,0,46937060,Europe,272421,28432
2020-07-26,Spain,ES,0,0,46937060,Europe,272421,28432
2020-07-27,Spain,ES,6361,2,46937060,Europe,278782,28434
2020-07-28,Spain,ES,1828,2,46937060,Europe,280610,28436
2020-07-29,Spain,ES,2031,5,46937060,Europe,282641,28441
2020-07-30,Spain,ES,2789,2,46937060,Europe,285430,28443
2020-07-31,Spain,ES,3092,2,46937060,Europe,288522,28445
2020-08-01,Spain,ES,0,0,46937060,Europe,288522,28445
2020-08-02,Spain,ES,0,0,46937060,Europe,288522,28445
2020-08-03,Spain,ES,8532,27,46937060,Europe,297054,28472
2020-08-04,Spain,ES,5760,26,46937060,Europe,302814,28498
2020-08-05,Spain,ES,2953,1,46937060,Europe,305767,28499
2020-08-06,Spain,ES,4088,1,46937060,Europe,309855,28500
2020-08-07,Spain,ES,4507,3,46937060,Europe,314362,28503
2020-08-08,Spain,ES,0,0,46937060,Europe,314362,28503
2020-08-09,Spain,ES,0,0,46937060,Europe,314362,28503
2020-08-10,Spain,ES,8618,73,46937060,Europe,322980,28576
2020-08-11,Spain,ES,3632,5,46937060,Europe,326612,28581
2020-08-12,Spain,ES,3172,-2,46937060,Europe,329784,28579
2020-08-13,Spain,ES,7550,26,46937060,Europe,337334,28605
2020-08-14,Spain,ES,5479,12,46937060,Europe,342813,28617
2020-08-15,Spain,ES,0,0,46937060,Europe,342813,28617
2020-08-16,Spain,ES,0,0,46937060,Europe,342813,28617
2020-08-17,Spain,ES,16269,29,46937060,Europe,359082,28646
2020-08-18,Spain,ES,5114,24,46937060,Europe,364196,28670
2020-08-19,Spain,ES,6671,127,46937060,Europe,370867,28797
2020-08-20,Spain,ES,7039,16,46937060,Europe,377906,28813
2020-08-21,Spain,ES,8148,25,46937060,Europe,386054,28838
2020-08-22,Spain,ES,0,0,46937060,Europe,386054,28838
2020-08-23,Spain,ES,0,0,46937060,Europe,386054,28838
2020-08-24,Spain,ES,19382,34,46937060,Europe,405436,28872
2020-08-25,Spain,ES,7117,52,46937060,Europe,412553,28924
2020-08-26,Spain,ES,7296,47,46937060,Europe,419849,28971
2020-08-27,Spain,ES,9658,25,46937060,Europe,429507,28996
2020-08-28,Spain,ES,9779,15,46937060,Europe,439286,29011
2020-08-29,Spain,ES,0,0,46937060,Europe,439286,29011
2020-08-30,Spain,ES,0,0,46937060,Europe,439286,29011
2020-08-31,Spain,ES,23572,83,46937060,Europe,462858,29094
2020-09-01,Spain,ES,8115,58,46937060,Europe,470973,29152
2020-09-02,Spain,ES,8581,42,46937060,Europe,479554,29194
2020-09-03,Spain,ES,8959,40,46937060,Europe,488513,29234
2020-09-04,Spain,ES,10476,184,46937060,Europe,498989,29418
2020-09-05,Spain,ES,0,0,46937060,Europe,498989,29418
2020-09-06,Spain,ES,0,0,46937060,Europe,498989,29418
2020-09-07,Spain,ES,26560,98,46937060,Europe,525549,29516
2020-09-08,Spain,ES,8964,78,46937060,Europe,534513,29594
2020-09-09,Spain,ES,8866,34,46937060,Europe,543379,29628
2020-09-10,Spain,ES,10764,71,46937060,Europe,554143,29699
2020-09-11,Spain,ES,12183,48,46937060,Europe,566326,29747
2020-09-12,Spain,ES,0,0,46937060,Europe,566326,29747
2020-09-13,Spain,ES,0,0,46937060,Europe,566326,29747
2020-09-14,Spain,ES,27404,101,46937060,Europe,593730,29848
2020-09-15,Spain,ES,9437,156,46937060,Europe,603167,30004
2020-09-16,Spain,ES,11193,239,46937060,Europe,614360,30243
2020-09-17,Spain,ES,11291,162,46937060,Europe,625651,30405
2020-09-18,Spain,ES,14389,90,46937060,Europe,640040,30495
2020-09-19,Spain,ES,0,0,46937060,Europe,640040,30495
2020-09-20,Spain,ES,0,0,46937060,Europe,640040,30495
2020-09-21,Spain,ES,31428,168,46937060,Europe,671468,30663
2020-09-22,Spain,ES,10799,241,46937060,Europe,682267,30904
2020-09-23,Spain,ES,11289,130,46937060,Europe,693556,31034
2020-09-24,Spain,ES,10653,84,46937060,Europe,704209,31118
2020-09-25,Spain,ES,12272,114,46937060,Europe,716481,31232
2020-09-26,Spain,ES,0,0,46937060,Europe,716481,31232
2020-09-27,Spain,ES,0,0,46937060,Europe,716481,31232
2020-09-28,Spain,ES,31785,179,46937060,Europe,748266,31411
2020-09-29,Spain,ES,9906,203,46937060,Europe,758172,31614
2020-09-30,Spain,ES,11016,177,46937060,Europe,769188,31791
2020-10-01,Spain,ES,9419,182,46937060,Europe,778607,31973
2020-10-02,Spain,ES,11325,113,46937060,Europe,789932,32086
2020-10-03,Spain,ES,0,0,46937060,Europe,789932,32086
2020-10-04,Spain,ES,0,0,46937060,Europe,789932,32086
2020-10-05,Spain,ES,23480,139,46937060,Europe,813412,32225
2020-10-06,Spain,ES,11998,261,46937060,Europe,825410,32486
2020-10-07,Spain,ES,10491,76,46937060,Europe,835901,32562
2020-10-08,Spain,ES,12423,126,46937060,Europe,848324,32688
2020-10-09,Spain,ES,12788,241,46937060,Europe,861112,32929
2020-10-10,Spain,ES,0,0,46937060,Europe,861112,32929
2020-10-11,Spain,ES,0,0,46937060,Europe,861112,32929
2020-10-12,Spain,ES,27856,195,46937060,Europe,888968,33124
2020-10-13,Spain,ES,7118,80,46937060,Europe,896086,33204
2020-10-14,Spain,ES,11970,209,46937060,Europe,908056,33413
2020-10-15,Spain,ES,13318,140,46937060,Europe,921374,33553
2020-10-16,Spain,ES,15186,222,46937060,Europe,936560,33775
2020-10-17,Spain,ES,0,0,46937060,Europe,936560,33775
2020-10-18,Spain,ES,0,0,46937060,Europe,936560,33775
2020-10-19,Spain,ES,37889,217,46937060,Europe,974449,33992
2020-10-20,Spain,ES,13873,218,46937060,Europe,988322,34210
2020-10-21,Spain,ES,16973,156,46937060,Europe,1005295,34366
2020-10-22,Spain,ES,20986,155,46937060,Europe,1026281,34521
2020-10-23,Spain,ES,19851,231,46937060,Europe,1046132,34752
2020-10-24,Spain,ES,0,0,46937060,Europe,1046132,34752
2020-10-25,Spain,ES,0,0,46937060,Europe,1046132,34752
2020-10-26,Spain,ES,52188,279,46937060,Europe,1098320,35031
2020-10-27,Spain,ES,18418,267,46937060,Europe,1116738,35298
2020-10-28,Spain,ES,19765,168,46937060,Europe,1136503,35466
2020-10-29,Spain,ES,23580,173,46937060,Europe,1160083,35639
2020-10-30,Spain,ES,25595,239,46937060,Europe,1185678,35878
2020-10-31,Spain,ES,0,0,46937060,Europe,1185678,35878
2020-11-01,Spain,ES,0,0,46937060,Europe,1185678,35878
2020-11-02,Spain,ES,55019,379,46937060,Europe,1240697,36257
2020-11-03,Spain,ES,18669,238,46937060,Europe,1259366,36495
2020-11-04,Spain,ES,25042,1623,46937060,Europe,1284408,38118
2020-11-05,Spain,ES,21908,368,46937060,Europe,1306316,38486
2020-11-06,Spain,ES,22516,347,46937060,Europe,1328832,38833
2020-11-07,Spain,ES,0,0,46937060,Europe,1328832,38833
2020-11-08,Spain,ES,0,0,46937060,Europe,1328832,38833
2020-11-09,Spain,ES,52386,512,46937060,Europe,1381218,39345
2020-11-10,Spain,ES,17395,411,46937060,Europe,1398613,39756
2020-11-11,Spain,ES,19096,349,46937060,Europe,1417709,40105
2020-11-12,Spain,ES,19511,356,46937060,Europe,1437220,40461
2020-11-13,Spain,ES,21371,308,46937060,Europe,1458591,40769
2020-11-14,Spain,ES,0,0,46937060,Europe,1458591,40769
2020-11-15,Spain,ES,0,0,46937060,Europe,1458591,40769
2020-11-16,Spain,ES,38273,484,46937060,Europe,1496864,41253
2020-11-17,Spain,ES,13159,435,46937060,Europe,1510023,41688
2020-11-18,Spain,ES,15318,351,46937060,Europe,1525341,42039
2020-11-19,Spain,ES,16233,252,46937060,Europe,1541574,42291
2020-11-20,Spain,ES,15156,328,46937060,Europe,1556730,42619
2020-11-21,Spain,ES,0,0,46937060,Europe,1556730,42619
2020-11-22,Spain,ES,0,0,46937060,Europe,1556730,42619
2020-11-23,Spain,ES,25886,512,46937060,Europe,1582616,43131
2020-11-24,Spain,ES,12228,537,46937060,Europe,1594844,43668
2020-11-25,Spain,ES,10222,369,46937060,Europe,1605066,44037
2020-11-26,Spain,ES,12289,337,46937060,Europe,1617355,44374
2020-11-27,Spain,ES,10853,294,46937060,Europe,1628208,44668
2020-11-28,Spain,ES,0,0,46937060,Europe,1628208,44668
2020-11-29,Spain,ES,0,0,46937060,Europe,1628208,44668
2020-11-30,Spain,ES,19979,401,46937060,Europe,1648187,45069
2020-12-01,Spain,ES,8257,442,46937060,Europe,1656444,45511
2020-12-02,Spain,ES,9331,273,46937060,Europe,1665775,45784
2020-12-03,Spain,ES,10127,254,46937060,Europe,1675902,46038
2020-12-04,Spain,ES,8745,214,46937060,Europe,1684647,46252
2020-12-05,Spain,ES,0,0,46937060,Europe,1684647,46252
2020-12-06,Spain,ES,0,0,46937060,Europe,1684647,46252
2020-12-07,Spain,ES,17681,394,46937060,Europe,1702328,46646
2020-12-08,Spain,ES,0,0,46937060,Europe,1702328,46646
2020-12-09,Spain,ES,9773,373,46937060,Europe,1712101,47019
2020-12-10,Spain,ES,7955,325,46937060,Europe,1720056,47344
2020-12-11,Spain,ES,10519,280,46937060,Europe,1730575,47624
2020-12-12,Spain,ES,0,0,46937060,Europe,1730575,47624
2020-12-13,Spain,ES,0,0,46937060,Europe,1730575,47624
2020-03-14,Ethiopia,ET,1,0,112078727,Africa,1,0
2020-03-15,Ethiopia,ET,0,0,112078727,Africa,1,0
2020-03-16,Ethiopia,ET,3,0,112078727,Africa,4,0
2020-03-17,Ethiopia,ET,1,0,112078727,Africa,5,0
2020-03-18,Ethiopia,ET,0,0,112078727,Africa,5,0
2020-03-19,Ethiopia,ET,1,0,112078727,Africa,6,0
2020-03-20,Ethiopia,ET,1,0,112078727,Africa,7,0
2020-03-21,Ethiopia,ET,2,0,112078727,Africa,9,0
2020-03-22,Ethiopia,ET,0,0,112078727,Africa,9,0
2020-03-23,Ethiopia,ET,2,0,112078727,Africa,11,0
2020-03-24,Ethiopia,ET,0,0,112078727,Africa,11,0
2020-03-25,Ethiopia,ET,0,0,112078727,Africa,11,0
2020-03-26,Ethiopia,ET,1,0,112078727,Africa,12,0
2020-03-27,Ethiopia,ET,0,0,112078727,Africa,12,0
2020-03-28,Ethiopia,ET,4,0,112078727,Africa,16,0
2020-03-29,Ethiopia,ET,0,0,112078727,Africa,16,0
2020-03-30,Ethiopia,ET,0,0,112078727,Africa,16,0
2020-03-31,Ethiopia,ET,7,0,112078727,Africa,23,0
2020-04-01,Ethiopia,ET,2,0,112078727,Africa,25,0
2020-04-02,Ethiopia,ET,4,0,112078727,Africa,29,0
2020-04-03,Ethiopia,ET,0,0,112078727,Africa,29,0
2020-04-04,Ethiopia,ET,6,0,112078727,Africa,35,0
2020-04-05,Ethiopia,ET,3,0,112078727,Africa,38,0
2020-04-06,Ethiopia,ET,5,2,112078727,Africa,43,2
2020-04-07,Ethiopia,ET,1,0,112078727,Africa,44,2
2020-04-08,Ethiopia,ET,8,0,112078727,Africa,52,2
2020-04-09,Ethiopia,ET,3,0,112078727,Africa,55,2
2020-04-10,Ethiopia,ET,1,0,112078727,Africa,56,2
2020-04-11,Ethiopia,ET,9,0,112078727,Africa,65,2
2020-04-12,Ethiopia,ET,4,1,112078727,Africa,69,3
2020-04-13,Ethiopia,ET,2,0,112078727,Africa,71,3
2020-04-14,Ethiopia,ET,3,0,112078727,Africa,74,3
2020-04-15,Ethiopia,ET,8,0,112078727,Africa,82,3
2020-04-16,Ethiopia,ET,3,0,112078727,Africa,85,3
2020-04-17,Ethiopia,ET,7,0,112078727,Africa,92,3
2020-04-18,Ethiopia,ET,4,0,112078727,Africa,96,3
2020-04-19,Ethiopia,ET,9,0,112078727,Africa,105,3
2020-04-20,Ethiopia,ET,3,0,112078727,Africa,108,3
2020-04-21,Ethiopia,ET,3,0,112078727,Africa,111,3
2020-04-22,Ethiopia,ET,3,0,112078727,Africa,114,3
2020-04-23,Ethiopia,ET,2,0,112078727,Africa,116,3
2020-04-24,Ethiopia,ET,0,0,112078727,Africa,116,3
2020-04-25,Ethiopia,ET,1,0,112078727,Africa,117,3
2020-04-26,Ethiopia,ET,5,0,112078727,Africa,122,3
2020-04-27,Ethiopia,ET,1,0,112078727,Africa,123,3
2020-04-28,Ethiopia,ET,1,0,112078727,Africa,124,3
2020-04-29,Ethiopia,ET,2,0,112078727,Africa,126,3
2020-04-30,Ethiopia,ET,4,0,112078727,Africa,130,3
2020-05-01,Ethiopia,ET,1,0,112078727,Africa,131,3
2020-05-02,Ethiopia,ET,2,0,112078727,Africa,133,3
2020-05-03,Ethiopia,ET,0,0,112078727,Africa,133,3
2020-05-04,Ethiopia,ET,2,0,112078727,Africa,135,3
2020-05-05,Ethiopia,ET,5,0,112078727,Africa,140,3
2020-05-06,Ethiopia,ET,5,1,112078727,Africa,145,4
2020-05-07,Ethiopia,ET,17,0,112078727,Africa,162,4
2020-05-08,Ethiopia,ET,29,0,112078727,Africa,191,4
2020-05-09,Ethiopia,ET,3,0,112078727,Africa,194,4
2020-05-10,Ethiopia,ET,16,1,112078727,Africa,210,5
2020-05-11,Ethiopia,ET,29,0,112078727,Africa,239,5
2020-05-12,Ethiopia,ET,11,0,112078727,Africa,250,5
2020-05-13,Ethiopia,ET,11,0,112078727,Africa,261,5
2020-05-14,Ethiopia,ET,2,0,112078727,Africa,263,5
2020-05-15,Ethiopia,ET,9,0,112078727,Africa,272,5
2020-05-16,Ethiopia,ET,15,0,112078727,Africa,287,5
2020-05-17,Ethiopia,ET,19,0,112078727,Africa,306,5
2020-05-18,Ethiopia,ET,11,0,112078727,Africa,317,5
2020-05-19,Ethiopia,ET,35,0,112078727,Africa,352,5
2020-05-20,Ethiopia,ET,13,0,112078727,Africa,365,5
2020-05-21,Ethiopia,ET,24,0,112078727,Africa,389,5
2020-05-22,Ethiopia,ET,10,0,112078727,Africa,399,5
2020-05-23,Ethiopia,ET,34,0,112078727,Africa,433,5
2020-05-24,Ethiopia,ET,61,0,112078727,Africa,494,5
2020-05-25,Ethiopia,ET,88,0,112078727,Africa,582,5
2020-05-26,Ethiopia,ET,73,0,112078727,Africa,655,5
2020-05-27,Ethiopia,ET,46,1,112078727,Africa,701,6
2020-05-28,Ethiopia,ET,30,0,112078727,Africa,731,6
2020-05-29,Ethiopia,ET,100,1,112078727,Africa,831,7
2020-05-30,Ethiopia,ET,137,1,112078727,Africa,968,8
2020-05-31,Ethiopia,ET,95,0,112078727,Africa,1063,8
2020-06-01,Ethiopia,ET,109,3,112078727,Africa,1172,11
2020-06-02,Ethiopia,ET,85,1,112078727,Africa,1257,12
2020-06-03,Ethiopia,ET,87,2,112078727,Africa,1344,14
2020-06-04,Ethiopia,ET,142,3,112078727,Africa,1486,17
2020-06-05,Ethiopia,ET,150,1,112078727,Africa,1636,18
2020-06-06,Ethiopia,ET,169,1,112078727,Africa,1805,19
2020-06-07,Ethiopia,ET,129,1,112078727,Africa,1934,20
2020-06-08,Ethiopia,ET,86,7,112078727,Africa,2020,27
2020-06-09,Ethiopia,ET,136,0,112078727,Africa,2156,27
2020-06-10,Ethiopia,ET,180,5,112078727,Africa,2336,32
2020-06-11,Ethiopia,ET,170,3,112078727,Africa,2506,35
2020-06-12,Ethiopia,ET,164,5,112078727,Africa,2670,40
2020-06-13,Ethiopia,ET,245,7,112078727,Africa,2915,47
2020-06-14,Ethiopia,ET,251,8,112078727,Africa,3166,55
2020-06-15,Ethiopia,ET,179,2,112078727,Africa,3345,57
2020-06-16,Ethiopia,ET,176,3,112078727,Africa,3521,60
2020-06-17,Ethiopia,ET,109,1,112078727,Africa,3630,61
2020-06-18,Ethiopia,ET,129,2,112078727,Africa,3759,63
2020-06-19,Ethiopia,ET,195,2,112078727,Africa,3954,65
2020-06-20,Ethiopia,ET,116,7,112078727,Africa,4070,72
2020-06-21,Ethiopia,ET,399,0,112078727,Africa,4469,72
2020-06-22,Ethiopia,ET,63,2,112078727,Africa,4532,74
2020-06-23,Ethiopia,ET,131,1,112078727,Africa,4663,75
2020-06-24,Ethiopia,ET,185,0,112078727,Africa,4848,75
2020-06-25,Ethiopia,ET,186,3,112078727,Africa,5034,78
2020-06-26,Ethiopia,ET,141,3,112078727,Africa,5175,81
2020-06-27,Ethiopia,ET,250,8,112078727,Africa,5425,89
2020-06-28,Ethiopia,ET,145,5,112078727,Africa,5570,94
2020-06-29,Ethiopia,ET,119,4,112078727,Africa,5689,98
2020-06-30,Ethiopia,ET,157,5,112078727,Africa,5846,103
2020-07-01,Ethiopia,ET,0,0,112078727,Africa,5846,103
2020-07-02,Ethiopia,ET,0,0,112078727,Africa,5846,103
2020-07-03,Ethiopia,ET,0,0,112078727,Africa,5846,103
2020-07-04,Ethiopia,ET,0,0,112078727,Africa,5846,103
2020-07-05,Ethiopia,ET,0,0,112078727,Africa,5846,103
2020-07-06,Ethiopia,ET,0,0,112078727,Africa,5846,103
2020-07-07,Ethiopia,ET,540,13,112078727,Africa,6386,116
2020-07-08,Ethiopia,ET,280,3,112078727,Africa,6666,119
2020-07-09,Ethiopia,ET,108,1,112078727,Africa,6774,120
2020-07-10,Ethiopia,ET,199,0,112078727,Africa,6973,120
2020-07-11,Ethiopia,ET,147,4,112078727,Africa,7120,124
2020-07-12,Ethiopia,ET,282,0,112078727,Africa,7402,124
2020-07-13,Ethiopia,ET,158,3,112078727,Africa,7560,127
2020-07-14,Ethiopia,ET,206,1,112078727,Africa,7766,128
2020-07-15,Ethiopia,ET,203,11,112078727,Africa,7969,139
2020-07-16,Ethiopia,ET,212,7,112078727,Africa,8181,146
2020-07-17,Ethiopia,ET,294,2,112078727,Africa,8475,148
2020-07-18,Ethiopia,ET,328,2,112078727,Africa,8803,150
2020-07-19,Ethiopia,ET,344,13,112078727,Africa,9147,163
2020-07-20,Ethiopia,ET,356,4,112078727,Africa,9503,167
2020-07-21,Ethiopia,ET,704,3,112078727,Africa,10207,170
2020-07-22,Ethiopia,ET,304,3,112078727,Africa,10511,173
2020-07-23,Ethiopia,ET,561,7,112078727,Africa,11072,180
2020-07-24,Ethiopia,ET,452,8,112078727,Africa,11524,188
2020-07-25,Ethiopia,ET,409,9,112078727,Africa,11933,197
2020-07-26,Ethiopia,ET,760,3,112078727,Africa,12693,200
2020-07-27,Ethiopia,ET,1275,23,112078727,Africa,13968,223
2020-07-28,Ethiopia,ET,579,5,112078727,Africa,14547,228
2020-07-29,Ethiopia,ET,653,11,112078727,Africa,15200,239
2020-07-30,Ethiopia,ET,610,14,112078727,Africa,15810,253
2020-07-31,Ethiopia,ET,805,10,112078727,Africa,16615,263
2020-08-01,Ethiopia,ET,915,11,112078727,Africa,17530,274
2020-08-02,Ethiopia,ET,469,10,112078727,Africa,17999,284
2020-08-03,Ethiopia,ET,0,0,112078727,Africa,17999,284
2020-08-04,Ethiopia,ET,1290,52,112078727,Africa,19289,336
2020-08-05,Ethiopia,ET,588,7,112078727,Africa,19877,343
2020-08-06,Ethiopia,ET,459,13,112078727,Africa,20336,356
2020-08-07,Ethiopia,ET,564,9,112078727,Africa,20900,365
2020-08-08,Ethiopia,ET,552,15,112078727,Africa,21452,380
2020-08-09,Ethiopia,ET,801,10,112078727,Africa,22253,390
2020-08-10,Ethiopia,ET,565,17,112078727,Africa,22818,407
2020-08-11,Ethiopia,ET,773,13,112078727,Africa,23591,420
2020-08-12,Ethiopia,ET,584,20,112078727,Africa,24175,440
2020-08-13,Ethiopia,ET,943,23,112078727,Africa,25118,463
2020-08-14,Ethiopia,ET,1086,16,112078727,Africa,26204,479
2020-08-15,Ethiopia,ET,1038,13,112078727,Africa,27242,492
2020-08-16,Ethiopia,ET,1652,17,112078727,Africa,28894,509
2020-08-17,Ethiopia,ET,982,19,112078727,Africa,29876,528
2020-08-18,Ethiopia,ET,1460,16,112078727,Africa,31336,544
2020-08-19,Ethiopia,ET,1386,28,112078727,Africa,32722,572
2020-08-20,Ethiopia,ET,1336,28,112078727,Africa,34058,600
2020-08-21,Ethiopia,ET,1778,20,112078727,Africa,35836,620
2020-08-22,Ethiopia,ET,1829,17,112078727,Africa,37665,637
2020-08-23,Ethiopia,ET,1368,25,112078727,Africa,39033,662
2020-08-24,Ethiopia,ET,1638,16,112078727,Africa,40671,678
2020-08-25,Ethiopia,ET,1472,14,112078727,Africa,42143,692
2020-08-26,Ethiopia,ET,1545,17,112078727,Africa,43688,709
2020-08-27,Ethiopia,ET,1533,16,112078727,Africa,45221,725
2020-08-28,Ethiopia,ET,1186,20,112078727,Africa,46407,745
2020-08-29,Ethiopia,ET,1733,13,112078727,Africa,48140,758
2020-08-30,Ethiopia,ET,1514,12,112078727,Africa,49654,770
2020-08-31,Ethiopia,ET,1468,23,112078727,Africa,51122,793
2020-09-01,Ethiopia,ET,1009,16,112078727,Africa,52131,809
2020-09-02,Ethiopia,ET,1173,19,112078727,Africa,53304,828
2020-09-03,Ethiopia,ET,1105,18,112078727,Africa,54409,846
2020-09-04,Ethiopia,ET,804,10,112078727,Africa,55213,856
2020-09-05,Ethiopia,ET,1303,24,112078727,Africa,56516,880
2020-09-06,Ethiopia,ET,950,17,112078727,Africa,57466,897
2020-09-07,Ethiopia,ET,1206,21,112078727,Africa,58672,918
2020-09-08,Ethiopia,ET,976,15,112078727,Africa,59648,933
2020-09-09,Ethiopia,ET,1136,16,112078727,Africa,60784,949
2020-09-10,Ethiopia,ET,916,17,112078727,Africa,61700,966
2020-09-11,Ethiopia,ET,878,8,112078727,Africa,62578,974
2020-09-12,Ethiopia,ET,789,12,112078727,Africa,63367,986
2020-09-13,Ethiopia,ET,521,10,112078727,Africa,63888,996
2020-09-14,Ethiopia,ET,413,17,112078727,Africa,64301,1013
2020-09-15,Ethiopia,ET,485,9,112078727,Africa,64786,1022
2020-09-16,Ethiopia,ET,700,13,112078727,Africa,65486,1035
2020-09-17,Ethiopia,ET,738,10,112078727,Africa,66224,1045
2020-09-18,Ethiopia,ET,689,15,112078727,Africa,66913,1060
2020-09-19,Ethiopia,ET,602,12,112078727,Africa,67515,1072
2020-09-20,Ethiopia,ET,616,17,112078727,Africa,68131,1089
2020-09-21,Ethiopia,ET,689,7,112078727,Africa,68820,1096
2020-09-22,Ethiopia,ET,889,12,112078727,Africa,69709,1108
2020-09-23,Ethiopia,ET,713,19,112078727,Africa,70422,1127
2020-09-24,Ethiopia,ET,661,14,112078727,Africa,71083,1141
2020-09-25,Ethiopia,ET,604,7,112078727,Africa,71687,1148
2020-09-26,Ethiopia,ET,486,7,112078727,Africa,72173,1155
2020-09-27,Ethiopia,ET,527,10,112078727,Africa,72700,1165
2020-09-28,Ethiopia,ET,632,5,112078727,Africa,73332,1170
2020-09-29,Ethiopia,ET,612,7,112078727,Africa,73944,1177
2020-09-30,Ethiopia,ET,640,14,112078727,Africa,74584,1191
2020-10-01,Ethiopia,ET,784,7,112078727,Africa,75368,1198
2020-10-02,Ethiopia,ET,730,7,112078727,Africa,76098,1205
2020-10-03,Ethiopia,ET,890,3,112078727,Africa,76988,1208
2020-10-04,Ethiopia,ET,872,6,112078727,Africa,77860,1214
2020-10-05,Ethiopia,ET,959,8,112078727,Africa,78819,1222
2020-10-06,Ethiopia,ET,618,8,112078727,Africa,79437,1230
2020-10-07,Ethiopia,ET,566,8,112078727,Africa,80003,1238
2020-10-08,Ethiopia,ET,892,17,112078727,Africa,80895,1255
2020-10-09,Ethiopia,ET,902,7,112078727,Africa,81797,1262
2020-10-10,Ethiopia,ET,865,9,112078727,Africa,82662,1271
2020-10-11,Ethiopia,ET,767,6,112078727,Africa,83429,1277
2020-10-12,Ethiopia,ET,866,10,112078727,Africa,84295,1287
2020-10-13,Ethiopia,ET,841,14,112078727,Africa,85136,1301
2020-10-14,Ethiopia,ET,582,4,112078727,Africa,85718,1305
2020-10-15,Ethiopia,ET,712,7,112078727,Africa,86430,1312
2020-10-16,Ethiopia,ET,739,13,112078727,Africa,87169,1325
2020-10-17,Ethiopia,ET,665,12,112078727,Africa,87834,1337
2020-10-18,Ethiopia,ET,600,9,112078727,Africa,88434,1346
2020-10-19,Ethiopia,ET,703,6,112078727,Africa,89137,1352
2020-10-20,Ethiopia,ET,723,13,112078727,Africa,89860,1365
2020-10-21,Ethiopia,ET,630,6,112078727,Africa,90490,1371
2020-10-22,Ethiopia,ET,628,13,112078727,Africa,91118,1384
2020-10-23,Ethiopia,ET,575,12,112078727,Africa,91693,1396
2020-10-24,Ethiopia,ET,536,4,112078727,Africa,92229,1400
2020-10-25,Ethiopia,ET,629,19,112078727,Africa,92858,1419
2020-10-26,Ethiopia,ET,485,7,112078727,Africa,93343,1426
2020-10-27,Ethiopia,ET,364,11,112078727,Africa,93707,1437
2020-10-28,Ethiopia,ET,511,8,112078727,Africa,94218,1445
2020-10-29,Ethiopia,ET,602,6,112078727,Africa,94820,1451
2020-10-30,Ethiopia,ET,481,6,112078727,Africa,95301,1457
2020-10-31,Ethiopia,ET,488,7,112078727,Africa,95789,1464
2020-11-01,Ethiopia,ET,380,5,112078727,Africa,96169,1469
2020-11-02,Ethiopia,ET,414,9,112078727,Africa,96583,1478
2020-11-03,Ethiopia,ET,359,11,112078727,Africa,96942,1489
2020-11-04,Ethiopia,ET,560,5,112078727,Africa,97502,1494
2020-11-05,Ethiopia,ET,379,9,112078727,Africa,97881,1503
2020-11-06,Ethiopia,ET,510,5,112078727,Africa,98391,1508
2020-11-07,Ethiopia,ET,355,4,112078727,Africa,98746,1512
2020-11-08,Ethiopia,ET,455,6,112078727,Africa,99201,1518
2020-11-09,Ethiopia,ET,474,5,112078727,Africa,99675,1523
2020-11-10,Ethiopia,ET,307,7,112078727,Africa,99982,1530
2020-11-11,Ethiopia,ET,345,7,112078727,Africa,100327,1537
2020-11-12,Ethiopia,ET,400,8,112078727,Africa,100727,1545
2020-11-13,Ethiopia,ET,521,9,112078727,Africa,101248,1554
2020-11-14,Ethiopia,ET,509,4,112078727,Africa,101757,1558
2020-11-15,Ethiopia,ET,564,7,112078727,Africa,102321,1565
2020-11-16,Ethiopia,ET,399,4,112078727,Africa,102720,1569
2020-11-17,Ethiopia,ET,336,12,112078727,Africa,103056,1581
2020-11-18,Ethiopia,ET,339,7,112078727,Africa,103395,1588
2020-11-19,Ethiopia,ET,533,13,112078727,Africa,103928,1601
2020-11-20,Ethiopia,ET,499,6,112078727,Africa,104427,1607
2020-11-21,Ethiopia,ET,452,13,112078727,Africa,104879,1620
2020-11-22,Ethiopia,ET,473,16,112078727,Africa,105352,1636
2020-11-23,Ethiopia,ET,433,11,112078727,Africa,105785,1647
2020-11-24,Ethiopia,ET,418,4,112078727,Africa,106203,1651
2020-11-25,Ethiopia,ET,388,10,112078727,Africa,106591,1661
2020-11-26,Ethiopia,ET,518,3,112078727,Africa,107109,1664
2020-11-27,Ethiopia,ET,560,8,112078727,Africa,107669,1672
2020-11-28,Ethiopia,ET,769,14,112078727,Africa,108438,1686
2020-11-29,Ethiopia,ET,492,9,112078727,Africa,108930,1695
2020-11-30,Ethiopia,ET,604,5,112078727,Africa,109534,1700
2020-12-01,Ethiopia,ET,540,6,112078727,Africa,110074,1706
2020-12-02,Ethiopia,ET,480,3,112078727,Africa,110554,1709
2020-12-03,Ethiopia,ET,430,6,112078727,Africa,110984,1715
2020-12-04,Ethiopia,ET,595,9,112078727,Africa,111579,1724
2020-12-05,Ethiopia,ET,512,10,112078727,Africa,112091,1734
2020-12-06,Ethiopia,ET,649,11,112078727,Africa,112740,1745
2020-12-07,Ethiopia,ET,555,2,112078727,Africa,113295,1747
2020-12-08,Ethiopia,ET,440,8,112078727,Africa,113735,1755
2020-12-09,Ethiopia,ET,531,11,112078727,Africa,114266,1766
2020-12-10,Ethiopia,ET,568,3,112078727,Africa,114834,1769
2020-12-11,Ethiopia,ET,526,10,112078727,Africa,115360,1779
2020-12-12,Ethiopia,ET,422,12,112078727,Africa,115782,1791
2020-12-13,Ethiopia,ET,515,12,112078727,Africa,116297,1803
2020-12-14,Ethiopia,ET,472,3,112078727,Africa,116769,1806
2019-12-31,Finland,FI,0,0,5517919,Europe,0,0
2020-01-01,Finland,FI,0,0,5517919,Europe,0,0
2020-01-02,Finland,FI,0,0,5517919,Europe,0,0
2020-01-03,Finland,FI,0,0,5517919,Europe,0,0
2020-01-04,Finland,FI,0,0,5517919,Europe,0,0
2020-01-05,Finland,FI,0,0,5517919,Europe,0,0
2020-01-06,Finland,FI,0,0,5517919,Europe,0,0
2020-01-07,Finland,FI,0,0,5517919,Europe,0,0
2020-01-08,Finland,FI,0,0,5517919,Europe,0,0
2020-01-09,Finland,FI,0,0,5517919,Europe,0,0
2020-01-10,Finland,FI,0,0,5517919,Europe,0,0
2020-01-11,Finland,FI,0,0,5517919,Europe,0,0
2020-01-12,Finland,FI,0,0,5517919,Europe,0,0
2020-01-13,Finland,FI,0,0,5517919,Europe,0,0
2020-01-14,Finland,FI,0,0,5517919,Europe,0,0
2020-01-15,Finland,FI,0,0,5517919,Europe,0,0
2020-01-16,Finland,FI,0,0,5517919,Europe,0,0
2020-01-17,Finland,FI,0,0,5517919,Europe,0,0
2020-01-18,Finland,FI,0,0,5517919,Europe,0,0
2020-01-19,Finland,FI,0,0,5517919,Europe,0,0
2020-01-20,Finland,FI,0,0,5517919,Europe,0,0
2020-01-21,Finland,FI,0,0,5517919,Europe,0,0
2020-01-22,Finland,FI,0,0,5517919,Europe,0,0
2020-01-23,Finland,FI,0,0,5517919,Europe,0,0
2020-01-24,Finland,FI,0,0,5517919,Europe,0,0
2020-01-25,Finland,FI,0,0,5517919,Europe,0,0
2020-01-26,Finland,FI,0,0,5517919,Europe,0,0
2020-01-27,Finland,FI,0,0,5517919,Europe,0,0
2020-01-28,Finland,FI,0,0,5517919,Europe,0,0
2020-01-29,Finland,FI,0,0,5517919,Europe,0,0
2020-01-30,Finland,FI,1,0,5517919,Europe,1,0
2020-01-31,Finland,FI,0,0,5517919,Europe,1,0
2020-02-01,Finland,FI,0,0,5517919,Europe,1,0
2020-02-02,Finland,FI,0,0,5517919,Europe,1,0
2020-02-03,Finland,FI,0,0,5517919,Europe,1,0
2020-02-04,Finland,FI,0,0,5517919,Europe,1,0
2020-02-05,Finland,FI,0,0,5517919,Europe,1,0
2020-02-06,Finland,FI,0,0,5517919,Europe,1,0
2020-02-07,Finland,FI,0,0,5517919,Europe,1,0
2020-02-08,Finland,FI,0,0,5517919,Europe,1,0
2020-02-09,Finland,FI,0,0,5517919,Europe,1,0
2020-02-10,Finland,FI,0,0,5517919,Europe,1,0
2020-02-11,Finland,FI,0,0,5517919,Europe,1,0
2020-02-12,Finland,FI,0,0,5517919,Europe,1,0
2020-02-13,Finland,FI,0,0,5517919,Europe,1,0
2020-02-14,Finland,FI,0,0,5517919,Europe,1,0
2020-02-15,Finland,FI,0,0,5517919,Europe,1,0
2020-02-16,Finland,FI,0,0,5517919,Europe,1,0
2020-02-17,Finland,FI,0,0,5517919,Europe,1,0
2020-02-18,Finland,FI,0,0,5517919,Europe,1,0
2020-02-19,Finland,FI,0,0,5517919,Europe,1,0
2020-02-20,Finland,FI,0,0,5517919,Europe,1,0
2020-02-21,Finland,FI,0,0,5517919,Europe,1,0
2020-02-22,Finland,FI,0,0,5517919,Europe,1,0
2020-02-23,Finland,FI,0,0,5517919,Europe,1,0
2020-02-24,Finland,FI,0,0,5517919,Europe,1,0
2020-02-25,Finland,FI,0,0,5517919,Europe,1,0
2020-02-26,Finland,FI,0,0,5517919,Europe,1,0
2020-02-27,Finland,FI,1,0,5517919,Europe,2,0
2020-02-28,Finland,FI,0,0,5517919,Europe,2,0
2020-02-29,Finland,FI,1,0,5517919,Europe,3,0
2020-03-01,Finland,FI,0,0,5517919,Europe,3,0
2020-03-02,Finland,FI,3,0,5517919,Europe,6,0
2020-03-04,Finland,FI,1,0,5517919,Europe,7,0
2020-03-06,Finland,FI,5,0,5517919,Europe,12,0
2020-03-07,Finland,FI,7,0,5517919,Europe,19,0
2020-03-09,Finland,FI,11,0,5517919,Europe,30,0
2020-03-10,Finland,FI,10,0,5517919,Europe,40,0
2020-03-12,Finland,FI,19,0,5517919,Europe,59,0
2020-03-13,Finland,FI,96,0,5517919,Europe,155,0
2020-03-14,Finland,FI,28,0,5517919,Europe,183,0
2020-03-15,Finland,FI,27,0,5517919,Europe,210,0
2020-03-16,Finland,FI,57,0,5517919,Europe,267,0
2020-03-17,Finland,FI,5,0,5517919,Europe,272,0
2020-03-18,Finland,FI,47,0,5517919,Europe,319,0
2020-03-19,Finland,FI,50,0,5517919,Europe,369,0
2020-03-20,Finland,FI,31,0,5517919,Europe,400,0
2020-03-21,Finland,FI,50,0,5517919,Europe,450,0
2020-03-22,Finland,FI,71,1,5517919,Europe,521,1
2020-03-23,Finland,FI,105,0,5517919,Europe,626,1
2020-03-24,Finland,FI,74,0,5517919,Europe,700,1
2020-03-25,Finland,FI,92,0,5517919,Europe,792,1
2020-03-26,Finland,FI,88,2,5517919,Europe,880,3
2020-03-27,Finland,FI,78,1,5517919,Europe,958,4
2020-03-28,Finland,FI,67,3,5517919,Europe,1025,7
2020-03-29,Finland,FI,193,2,5517919,Europe,1218,9
2020-03-30,Finland,FI,0,2,5517919,Europe,1218,11
2020-03-31,Finland,FI,95,2,5517919,Europe,1313,13
2020-04-01,Finland,FI,71,4,5517919,Europe,1384,17
2020-04-02,Finland,FI,62,0,5517919,Europe,1446,17
2020-04-03,Finland,FI,72,2,5517919,Europe,1518,19
2020-04-04,Finland,FI,97,1,5517919,Europe,1615,20
2020-04-05,Finland,FI,267,5,5517919,Europe,1882,25
2020-04-06,Finland,FI,45,2,5517919,Europe,1927,27
2020-04-07,Finland,FI,249,0,5517919,Europe,2176,27
2020-04-08,Finland,FI,132,7,5517919,Europe,2308,34
2020-04-09,Finland,FI,179,6,5517919,Europe,2487,40
2020-04-10,Finland,FI,118,2,5517919,Europe,2605,42
2020-04-11,Finland,FI,164,6,5517919,Europe,2769,48
2020-04-12,Finland,FI,136,1,5517919,Europe,2905,49
2020-04-13,Finland,FI,69,7,5517919,Europe,2974,56
2020-04-14,Finland,FI,90,3,5517919,Europe,3064,59
2020-04-15,Finland,FI,97,5,5517919,Europe,3161,64
2020-04-16,Finland,FI,76,8,5517919,Europe,3237,72
2020-04-17,Finland,FI,132,3,5517919,Europe,3369,75
2020-04-18,Finland,FI,120,7,5517919,Europe,3489,82
2020-04-19,Finland,FI,192,8,5517919,Europe,3681,90
2020-04-20,Finland,FI,102,4,5517919,Europe,3783,94
2020-04-21,Finland,FI,85,4,5517919,Europe,3868,98
2020-04-22,Finland,FI,146,43,5517919,Europe,4014,141
2020-04-23,Finland,FI,115,8,5517919,Europe,4129,149
2020-04-24,Finland,FI,155,23,5517919,Europe,4284,172
2020-04-25,Finland,FI,111,5,5517919,Europe,4395,177
2020-04-26,Finland,FI,80,9,5517919,Europe,4475,186
2020-04-27,Finland,FI,101,4,5517919,Europe,4576,190
2020-04-28,Finland,FI,119,3,5517919,Europe,4695,193
2020-04-29,Finland,FI,45,6,5517919,Europe,4740,199
2020-04-30,Finland,FI,166,7,5517919,Europe,4906,206
2020-05-01,Finland,FI,89,5,5517919,Europe,4995,211
2020-05-02,Finland,FI,56,7,5517919,Europe,5051,218
2020-05-03,Finland,FI,128,2,5517919,Europe,5179,220
2020-05-04,Finland,FI,75,10,5517919,Europe,5254,230
2020-05-05,Finland,FI,73,10,5517919,Europe,5327,240
2020-05-06,Finland,FI,85,6,5517919,Europe,5412,246
2020-05-07,Finland,FI,161,6,5517919,Europe,5573,252
2020-05-08,Finland,FI,100,3,5517919,Europe,5673,255
2020-05-09,Finland,FI,65,5,5517919,Europe,5738,260
2020-05-10,Finland,FI,142,5,5517919,Europe,5880,265
2020-05-11,Finland,FI,82,2,5517919,Europe,5962,267
2020-05-12,Finland,FI,22,4,5517919,Europe,5984,271
2020-05-13,Finland,FI,19,4,5517919,Europe,6003,275
2020-05-14,Finland,FI,51,9,5517919,Europe,6054,284
2020-05-15,Finland,FI,91,3,5517919,Europe,6145,287
2020-05-16,Finland,FI,83,6,5517919,Europe,6228,293
2020-05-17,Finland,FI,58,4,5517919,Europe,6286,297
2020-05-18,Finland,FI,61,1,5517919,Europe,6347,298
2020-05-19,Finland,FI,33,2,5517919,Europe,6380,300
2020-05-20,Finland,FI,19,1,5517919,Europe,6399,301
2020-05-21,Finland,FI,44,3,5517919,Europe,6443,304
2020-05-22,Finland,FI,50,2,5517919,Europe,6493,306
2020-05-23,Finland,FI,44,0,5517919,Europe,6537,306
2020-05-24,Finland,FI,31,0,5517919,Europe,6568,306
2020-05-25,Finland,FI,11,1,5517919,Europe,6579,307
2020-05-26,Finland,FI,20,1,5517919,Europe,6599,308
2020-05-27,Finland,FI,29,4,5517919,Europe,6628,312
2020-05-28,Finland,FI,64,1,5517919,Europe,6692,313
2020-05-29,Finland,FI,51,0,5517919,Europe,6743,313
2020-05-30,Finland,FI,33,1,5517919,Europe,6776,314
2020-05-31,Finland,FI,50,2,5517919,Europe,6826,316
2020-06-01,Finland,FI,33,4,5517919,Europe,6859,320
2020-06-02,Finland,FI,26,0,5517919,Europe,6885,320
2020-06-03,Finland,FI,2,0,5517919,Europe,6887,320
2020-06-04,Finland,FI,24,1,5517919,Europe,6911,321
2020-06-05,Finland,FI,0,1,5517919,Europe,6911,322
2020-06-06,Finland,FI,30,0,5517919,Europe,6941,322
2020-06-07,Finland,FI,23,0,5517919,Europe,6964,322
2020-06-08,Finland,FI,17,1,5517919,Europe,6981,323
2020-06-09,Finland,FI,20,0,5517919,Europe,7001,323
2020-06-10,Finland,FI,24,1,5517919,Europe,7025,324
2020-06-11,Finland,FI,15,0,5517919,Europe,7040,324
2020-06-12,Finland,FI,24,1,5517919,Europe,7064,325
2020-06-13,Finland,FI,9,0,5517919,Europe,7073,325
2020-06-14,Finland,FI,14,0,5517919,Europe,7087,325
2020-06-15,Finland,FI,17,1,5517919,Europe,7104,326
2020-06-16,Finland,FI,4,0,5517919,Europe,7108,326
2020-06-17,Finland,FI,4,0,5517919,Europe,7112,326
2020-06-18,Finland,FI,5,0,5517919,Europe,7117,326
2020-06-19,Finland,FI,0,0,5517919,Europe,7117,326
2020-06-20,Finland,FI,16,0,5517919,Europe,7133,326
2020-06-21,Finland,FI,9,0,5517919,Europe,7142,326
2020-06-22,Finland,FI,1,0,5517919,Europe,7143,326
2020-06-23,Finland,FI,1,1,5517919,Europe,7144,327
2020-06-24,Finland,FI,11,0,5517919,Europe,7155,327
2020-06-25,Finland,FI,12,0,5517919,Europe,7167,327
2020-06-26,Finland,FI,5,0,5517919,Europe,7172,327
2020-06-27,Finland,FI,19,1,5517919,Europe,7191,328
2020-06-28,Finland,FI,0,0,5517919,Europe,7191,328
2020-06-29,Finland,FI,0,0,5517919,Europe,7191,328
2020-06-30,Finland,FI,18,0,5517919,Europe,7209,328
2020-07-01,Finland,FI,5,0,5517919,Europe,7214,328
2020-07-02,Finland,FI,22,0,5517919,Europe,7236,328
2020-07-03,Finland,FI,5,0,5517919,Europe,7241,328
2020-07-04,Finland,FI,28,0,5517919,Europe,7269,328
2020-07-05,Finland,FI,1,0,5517919,Europe,7270,328
2020-07-06,Finland,FI,2,0,5517919,Europe,7272,328
2020-07-07,Finland,FI,3,0,5517919,Europe,7275,328
2020-07-08,Finland,FI,1,0,5517919,Europe,7276,328
2020-07-09,Finland,FI,7,0,5517919,Europe,7283,328
2020-07-10,Finland,FI,4,0,5517919,Europe,7287,328
2020-07-11,Finland,FI,3,0,5517919,Europe,7290,328
2020-07-12,Finland,FI,0,0,5517919,Europe,7290,328
2020-07-13,Finland,FI,2,0,5517919,Europe,7292,328
2020-07-14,Finland,FI,1,0,5517919,Europe,7293,328
2020-07-15,Finland,FI,0,0,5517919,Europe,7293,328
2020-07-16,Finland,FI,0,0,5517919,Europe,7293,328
2020-07-17,Finland,FI,0,0,5517919,Europe,7293,328
2020-07-18,Finland,FI,8,0,5517919,Europe,7301,328
2020-07-19,Finland,FI,17,0,5517919,Europe,7318,328
2020-07-20,Finland,FI,20,0,5517919,Europe,7338,328
2020-07-21,Finland,FI,2,0,5517919,Europe,7340,328
2020-07-22,Finland,FI,11,0,5517919,Europe,7351,328
2020-07-23,Finland,FI,11,0,5517919,Europe,7362,328
2020-07-24,Finland,FI,10,0,5517919,Europe,7372,328
2020-07-25,Finland,FI,8,1,5517919,Europe,7380,329
2020-07-26,Finland,FI,8,0,5517919,Europe,7388,329
2020-07-27,Finland,FI,5,0,5517919,Europe,7393,329
2020-07-28,Finland,FI,5,0,5517919,Europe,7398,329
2020-07-29,Finland,FI,6,0,5517919,Europe,7404,329
2020-07-30,Finland,FI,10,0,5517919,Europe,7414,329
2020-07-31,Finland,FI,9,0,5517919,Europe,7423,329
2020-08-01,Finland,FI,9,0,5517919,Europe,7432,329
2020-08-02,Finland,FI,11,0,5517919,Europe,7443,329
2020-08-03,Finland,FI,10,0,5517919,Europe,7453,329
2020-08-04,Finland,FI,13,0,5517919,Europe,7466,329
2020-08-05,Finland,FI,17,2,5517919,Europe,7483,331
2020-08-06,Finland,FI,29,0,5517919,Europe,7512,331
2020-08-07,Finland,FI,20,0,5517919,Europe,7532,331
2020-08-08,Finland,FI,22,0,5517919,Europe,7554,331
2020-08-09,Finland,FI,14,0,5517919,Europe,7568,331
2020-08-10,Finland,FI,16,0,5517919,Europe,7584,331
2020-08-11,Finland,FI,17,2,5517919,Europe,7601,333
2020-08-12,Finland,FI,22,0,5517919,Europe,7623,333
2020-08-13,Finland,FI,19,0,5517919,Europe,7642,333
2020-08-14,Finland,FI,41,0,5517919,Europe,7683,333
2020-08-15,Finland,FI,17,0,5517919,Europe,7700,333
2020-08-16,Finland,FI,20,0,5517919,Europe,7720,333
2020-08-17,Finland,FI,11,0,5517919,Europe,7731,333
2020-08-18,Finland,FI,21,1,5517919,Europe,7752,334
2020-08-19,Finland,FI,24,0,5517919,Europe,7776,334
2020-08-20,Finland,FI,29,0,5517919,Europe,7805,334
2020-08-21,Finland,FI,37,0,5517919,Europe,7842,334
2020-08-22,Finland,FI,29,0,5517919,Europe,7871,334
2020-08-23,Finland,FI,35,0,5517919,Europe,7906,334
2020-08-24,Finland,FI,14,0,5517919,Europe,7920,334
2020-08-25,Finland,FI,18,1,5517919,Europe,7938,335
2020-08-26,Finland,FI,43,0,5517919,Europe,7981,335
2020-08-27,Finland,FI,21,0,5517919,Europe,8002,335
2020-08-28,Finland,FI,17,0,5517919,Europe,8019,335
2020-08-29,Finland,FI,23,0,5517919,Europe,8042,335
2020-08-30,Finland,FI,7,0,5517919,Europe,8049,335
2020-08-31,Finland,FI,28,0,5517919,Europe,8077,335
2020-09-01,Finland,FI,9,0,5517919,Europe,8086,335
2020-09-02,Finland,FI,56,0,5517919,Europe,8142,335
2020-09-03,Finland,FI,19,0,5517919,Europe,8161,335
2020-09-04,Finland,FI,39,0,5517919,Europe,8200,335
2020-09-05,Finland,FI,25,0,5517919,Europe,8225,335
2020-09-06,Finland,FI,36,1,5517919,Europe,8261,336
2020-09-07,Finland,FI,30,0,5517919,Europe,8291,336
2020-09-08,Finland,FI,36,0,5517919,Europe,8327,336
2020-09-09,Finland,FI,10,0,5517919,Europe,8337,336
2020-09-10,Finland,FI,93,1,5517919,Europe,8430,337
2020-09-11,Finland,FI,39,0,5517919,Europe,8469,337
2020-09-12,Finland,FI,43,0,5517919,Europe,8512,337
2020-09-13,Finland,FI,45,0,5517919,Europe,8557,337
2020-09-14,Finland,FI,23,0,5517919,Europe,8580,337
2020-09-15,Finland,FI,47,2,5517919,Europe,8627,339
2020-09-16,Finland,FI,98,0,5517919,Europe,8725,339
2020-09-17,Finland,FI,25,0,5517919,Europe,8750,339
2020-09-18,Finland,FI,49,0,5517919,Europe,8799,339
2020-09-19,Finland,FI,59,0,5517919,Europe,8858,339
2020-09-20,Finland,FI,64,0,5517919,Europe,8922,339
2020-09-21,Finland,FI,58,0,5517919,Europe,8980,339
2020-09-22,Finland,FI,66,2,5517919,Europe,9046,341
2020-09-23,Finland,FI,149,0,5517919,Europe,9195,341
2020-09-24,Finland,FI,93,2,5517919,Europe,9288,343
2020-09-25,Finland,FI,91,0,5517919,Europe,9379,343
2020-09-26,Finland,FI,105,0,5517919,Europe,9484,343
2020-09-27,Finland,FI,93,0,5517919,Europe,9577,343
2020-09-28,Finland,FI,105,0,5517919,Europe,9682,343
2020-09-29,Finland,FI,52,0,5517919,Europe,9734,343
2020-09-30,Finland,FI,158,0,5517919,Europe,9892,343
2020-10-01,Finland,FI,100,1,5517919,Europe,9992,344
2020-10-02,Finland,FI,111,0,5517919,Europe,10103,344
2020-10-03,Finland,FI,101,1,5517919,Europe,10204,345
2020-10-04,Finland,FI,40,0,5517919,Europe,10244,345
2020-10-05,Finland,FI,294,0,5517919,Europe,10538,345
2020-10-06,Finland,FI,164,1,5517919,Europe,10702,346
2020-10-07,Finland,FI,227,0,5517919,Europe,10929,346
2020-10-08,Finland,FI,120,0,5517919,Europe,11049,346
2020-10-09,Finland,FI,296,0,5517919,Europe,11345,346
2020-10-10,Finland,FI,235,0,5517919,Europe,11580,346
2020-10-11,Finland,FI,269,0,5517919,Europe,11849,346
2020-10-12,Finland,FI,149,0,5517919,Europe,11998,346
2020-10-13,Finland,FI,214,0,5517919,Europe,12212,346
2020-10-14,Finland,FI,287,0,5517919,Europe,12499,346
2020-10-15,Finland,FI,204,4,5517919,Europe,12703,350
2020-10-16,Finland,FI,291,0,5517919,Europe,12994,350
2020-10-17,Finland,FI,139,1,5517919,Europe,13133,351
2020-10-18,Finland,FI,160,0,5517919,Europe,13293,351
2020-10-19,Finland,FI,131,0,5517919,Europe,13424,351
2020-10-20,Finland,FI,131,0,5517919,Europe,13555,351
2020-10-21,Finland,FI,294,0,5517919,Europe,13849,351
2020-10-22,Finland,FI,222,2,5517919,Europe,14071,353
2020-10-23,Finland,FI,184,0,5517919,Europe,14255,353
2020-10-24,Finland,FI,219,0,5517919,Europe,14474,353
2020-10-25,Finland,FI,178,0,5517919,Europe,14652,353
2020-10-26,Finland,FI,196,0,5517919,Europe,14848,353
2020-10-27,Finland,FI,122,1,5517919,Europe,14970,354
2020-10-28,Finland,FI,193,0,5517919,Europe,15163,354
2020-10-29,Finland,FI,215,0,5517919,Europe,15378,354
2020-10-30,Finland,FI,188,0,5517919,Europe,15566,354
2020-10-31,Finland,FI,344,4,5517919,Europe,15910,358
2020-11-01,Finland,FI,203,0,5517919,Europe,16113,358
2020-11-02,Finland,FI,178,0,5517919,Europe,16291,358
2020-11-03,Finland,FI,109,1,5517919,Europe,16400,359
2020-11-04,Finland,FI,237,0,5517919,Europe,16637,359
2020-11-05,Finland,FI,293,2,5517919,Europe,16930,361
2020-11-06,Finland,FI,189,0,5517919,Europe,17119,361
2020-11-07,Finland,FI,266,1,5517919,Europe,17385,362
2020-11-08,Finland,FI,0,0,5517919,Europe,17385,362
2020-11-09,Finland,FI,412,0,5517919,Europe,17797,362
2020-11-10,Finland,FI,90,1,5517919,Europe,17887,363
2020-11-11,Finland,FI,220,0,5517919,Europe,18107,363
2020-11-12,Finland,FI,238,2,5517919,Europe,18345,365
2020-11-13,Finland,FI,197,0,5517919,Europe,18542,365
2020-11-14,Finland,FI,316,4,5517919,Europe,18858,369
2020-11-15,Finland,FI,244,0,5517919,Europe,19102,369
2020-11-16,Finland,FI,213,0,5517919,Europe,19315,369
2020-11-17,Finland,FI,104,2,5517919,Europe,19419,371
2020-11-18,Finland,FI,228,0,5517919,Europe,19647,371
2020-11-19,Finland,FI,288,3,5517919,Europe,19935,374
2020-11-20,Finland,FI,351,0,5517919,Europe,20286,374
2020-11-21,Finland,FI,461,1,5517919,Europe,20747,375
2020-11-22,Finland,FI,469,0,5517919,Europe,21216,375
2020-11-23,Finland,FI,423,0,5517919,Europe,21639,375
2020-11-24,Finland,FI,297,9,5517919,Europe,21936,384
2020-11-25,Finland,FI,353,0,5517919,Europe,22289,384
2020-11-26,Finland,FI,363,4,5517919,Europe,22652,388
2020-11-27,Finland,FI,496,0,5517919,Europe,23148,388
2020-11-28,Finland,FI,618,5,5517919,Europe,23766,393
2020-11-29,Finland,FI,541,0,5517919,Europe,24307,393
2020-11-30,Finland,FI,322,0,5517919,Europe,24629,393
2020-12-01,Finland,FI,283,6,5517919,Europe,24912,399
2020-12-02,Finland,FI,550,0,5517919,Europe,25462,399
2020-12-03,Finland,FI,420,9,5517919,Europe,25882,408
2020-12-04,Finland,FI,560,0,5517919,Europe,26442,408
2020-12-05,Finland,FI,316,7,5517919,Europe,26758,415
2020-12-06,Finland,FI,460,0,5517919,Europe,27218,415
2020-12-07,Finland,FI,413,0,5517919,Europe,27631,415
2020-12-08,Finland,FI,250,9,5517919,Europe,27881,424
2020-12-09,Finland,FI,361,1,5517919,Europe,28242,425
2020-12-10,Finland,FI,490,8,5517919,Europe,28732,433
2020-12-11,Finland,FI,840,9,5517919,Europe,29572,442
2020-12-12,Finland,FI,501,11,5517919,Europe,30073,453
2020-12-13,Finland,FI,377,0,5517919,Europe,30450,453
2020-12-14,Finland,FI,360,0,5517919,Europe,30810,453
2020-03-20,Fiji,FJ,1,0,889955,Oceania,1,0
2020-03-21,Fiji,FJ,0,0,889955,Oceania,1,0
2020-03-22,Fiji,FJ,1,0,889955,Oceania,2,0
2020-03-23,Fiji,FJ,1,0,889955,Oceania,3,0
2020-03-24,Fiji,FJ,1,0,889955,Oceania,4,0
2020-03-25,Fiji,FJ,1,0,889955,Oceania,5,0
2020-03-26,Fiji,FJ,0,0,889955,Oceania,5,0
2020-03-27,Fiji,FJ,0,0,889955,Oceania,5,0
2020-03-28,Fiji,FJ,0,0,889955,Oceania,5,0
2020-03-29,Fiji,FJ,0,0,889955,Oceania,5,0
2020-03-30,Fiji,FJ,0,0,889955,Oceania,5,0
2020-03-31,Fiji,FJ,0,0,889955,Oceania,5,0
2020-04-01,Fiji,FJ,0,0,889955,Oceania,5,0
2020-04-02,Fiji,FJ,2,0,889955,Oceania,7,0
2020-04-03,Fiji,FJ,0,0,889955,Oceania,7,0
2020-04-04,Fiji,FJ,5,0,889955,Oceania,12,0
2020-04-05,Fiji,FJ,0,0,889955,Oceania,12,0
2020-04-06,Fiji,FJ,2,0,889955,Oceania,14,0
2020-04-07,Fiji,FJ,0,0,889955,Oceania,14,0
2020-04-08,Fiji,FJ,1,0,889955,Oceania,15,0
2020-04-09,Fiji,FJ,0,0,889955,Oceania,15,0
2020-04-10,Fiji,FJ,0,0,889955,Oceania,15,0
2020-04-11,Fiji,FJ,1,0,889955,Oceania,16,0
2020-04-12,Fiji,FJ,0,0,889955,Oceania,16,0
2020-04-13,Fiji,FJ,0,0,889955,Oceania,16,0
2020-04-14,Fiji,FJ,0,0,889955,Oceania,16,0
2020-04-15,Fiji,FJ,0,0,889955,Oceania,16,0
2020-04-16,Fiji,FJ,0,0,889955,Oceania,16,0
2020-04-17,Fiji,FJ,1,0,889955,Oceania,17,0
2020-04-18,Fiji,FJ,0,0,889955,Oceania,17,0
2020-04-19,Fiji,FJ,0,0,889955,Oceania,17,0
2020-04-20,Fiji,FJ,0,0,889955,Oceania,17,0
2020-04-21,Fiji,FJ,1,0,889955,Oceania,18,0
2020-04-22,Fiji,FJ,0,0,889955,Oceania,18,0
2020-04-23,Fiji,FJ,0,0,889955,Oceania,18,0
2020-04-24,Fiji,FJ,0,0,889955,Oceania,18,0
2020-04-25,Fiji,FJ,0,0,889955,Oceania,18,0
2020-04-26,Fiji,FJ,0,0,889955,Oceania,18,0
2020-04-27,Fiji,FJ,0,0,889955,Oceania,18,0
2020-04-28,Fiji,FJ,0,0,889955,Oceania,18,0
2020-04-29,Fiji,FJ,0,0,889955,Oceania,18,0
2020-04-30,Fiji,FJ,0,0,889955,Oceania,18,0
2020-05-01,Fiji,FJ,0,0,889955,Oceania,18,0
2020-05-02,Fiji,FJ,0,0,889955,Oceania,18,0
2020-05-03,Fiji,FJ,0,0,889955,Oceania,18,0
2020-05-04,Fiji,FJ,0,0,889955,Oceania,18,0
2020-05-05,Fiji,FJ,0,0,889955,Oceania,18,0
2020-05-06,Fiji,FJ,0,0,889955,Oceania,18,0
2020-05-07,Fiji,FJ,0,0,889955,Oceania,18,0
2020-05-08,Fiji,FJ,0,0,889955,Oceania,18,0
2020-05-09,Fiji,FJ,0,0,889955,Oceania,18,0
2020-05-10,Fiji,FJ,0,0,889955,Oceania,18,0
2020-05-11,Fiji,FJ,0,0,889955,Oceania,18,0
2020-05-12,Fiji,FJ,0,0,889955,Oceania,18,0
2020-05-13,Fiji,FJ,0,0,889955,Oceania,18,0
2020-05-14,Fiji,FJ,0,0,889955,Oceania,18,0
2020-05-15,Fiji,FJ,0,0,889955,Oceania,18,0
2020-05-16,Fiji,FJ,0,0,889955,Oceania,18,0
2020-05-17,Fiji,FJ,0,0,889955,Oceania,18,0
2020-05-18,Fiji,FJ,0,0,889955,Oceania,18,0
2020-05-19,Fiji,FJ,0,0,889955,Oceania,18,0
2020-05-20,Fiji,FJ,0,0,889955,Oceania,18,0
2020-05-21,Fiji,FJ,0,0,889955,Oceania,18,0
2020-05-22,Fiji,FJ,0,0,889955,Oceania,18,0
2020-05-23,Fiji,FJ,0,0,889955,Oceania,18,0
2020-05-24,Fiji,FJ,0,0,889955,Oceania,18,0
2020-05-25,Fiji,FJ,0,0,889955,Oceania,18,0
2020-05-26,Fiji,FJ,0,0,889955,Oceania,18,0
2020-05-27,Fiji,FJ,0,0,889955,Oceania,18,0
2020-05-28,Fiji,FJ,0,0,889955,Oceania,18,0
2020-05-29,Fiji,FJ,0,0,889955,Oceania,18,0
2020-05-30,Fiji,FJ,0,0,889955,Oceania,18,0
2020-05-31,Fiji,FJ,0,0,889955,Oceania,18,0
2020-06-01,Fiji,FJ,0,0,889955,Oceania,18,0
2020-06-02,Fiji,FJ,0,0,889955,Oceania,18,0
2020-06-03,Fiji,FJ,0,0,889955,Oceania,18,0
2020-06-04,Fiji,FJ,0,0,889955,Oceania,18,0
2020-06-05,Fiji,FJ,0,0,889955,Oceania,18,0
2020-06-06,Fiji,FJ,0,0,889955,Oceania,18,0
2020-06-07,Fiji,FJ,0,0,889955,Oceania,18,0
2020-06-08,Fiji,FJ,0,0,889955,Oceania,18,0
2020-06-09,Fiji,FJ,0,0,889955,Oceania,18,0
2020-06-10,Fiji,FJ,0,0,889955,Oceania,18,0
2020-06-11,Fiji,FJ,0,0,889955,Oceania,18,0
2020-06-12,Fiji,FJ,0,0,889955,Oceania,18,0
2020-06-13,Fiji,FJ,0,0,889955,Oceania,18,0
2020-06-14,Fiji,FJ,0,0,889955,Oceania,18,0
2020-06-15,Fiji,FJ,0,0,889955,Oceania,18,0
2020-06-16,Fiji,FJ,0,0,889955,Oceania,18,0
2020-06-17,Fiji,FJ,0,0,889955,Oceania,18,0
2020-06-18,Fiji,FJ,0,0,889955,Oceania,18,0
2020-06-19,Fiji,FJ,0,0,889955,Oceania,18,0
2020-06-20,Fiji,FJ,0,0,889955,Oceania,18,0
2020-06-21,Fiji,FJ,0,0,889955,Oceania,18,0
2020-06-22,Fiji,FJ,0,0,889955,Oceania,18,0
2020-06-23,Fiji,FJ,0,0,889955,Oceania,18,0
2020-06-24,Fiji,FJ,0,0,889955,Oceania,18,0
2020-06-25,Fiji,FJ,0,0,889955,Oceania,18,0
2020-06-26,Fiji,FJ,0,0,889955,Oceania,18,0
2020-06-27,Fiji,FJ,0,0,889955,Oceania,18,0
2020-06-28,Fiji,FJ,0,0,889955,Oceania,18,0
2020-06-29,Fiji,FJ,0,0,889955,Oceania,18,0
2020-06-30,Fiji,FJ,0,0,889955,Oceania,18,0
2020-07-01,Fiji,FJ,0,0,889955,Oceania,18,0
2020-07-02,Fiji,FJ,0,0,889955,Oceania,18,0
2020-07-03,Fiji,FJ,0,0,889955,Oceania,18,0
2020-07-04,Fiji,FJ,0,0,889955,Oceania,18,0
2020-07-05,Fiji,FJ,0,0,889955,Oceania,18,0
2020-07-06,Fiji,FJ,0,0,889955,Oceania,18,0
2020-07-07,Fiji,FJ,1,0,889955,Oceania,19,0
2020-07-08,Fiji,FJ,0,0,889955,Oceania,19,0
2020-07-09,Fiji,FJ,2,0,889955,Oceania,21,0
2020-07-10,Fiji,FJ,0,0,889955,Oceania,21,0
2020-07-11,Fiji,FJ,0,0,889955,Oceania,21,0
2020-07-12,Fiji,FJ,0,0,889955,Oceania,21,0
2020-07-13,Fiji,FJ,5,0,889955,Oceania,26,0
2020-07-14,Fiji,FJ,0,0,889955,Oceania,26,0
2020-07-15,Fiji,FJ,0,0,889955,Oceania,26,0
2020-07-16,Fiji,FJ,0,0,889955,Oceania,26,0
2020-07-17,Fiji,FJ,0,0,889955,Oceania,26,0
2020-07-18,Fiji,FJ,0,0,889955,Oceania,26,0
2020-07-19,Fiji,FJ,0,0,889955,Oceania,26,0
2020-07-20,Fiji,FJ,0,0,889955,Oceania,26,0
2020-07-21,Fiji,FJ,0,0,889955,Oceania,26,0
2020-07-22,Fiji,FJ,1,0,889955,Oceania,27,0
2020-07-23,Fiji,FJ,0,0,889955,Oceania,27,0
2020-07-24,Fiji,FJ,0,0,889955,Oceania,27,0
2020-07-25,Fiji,FJ,0,0,889955,Oceania,27,0
2020-07-26,Fiji,FJ,0,0,889955,Oceania,27,0
2020-07-27,Fiji,FJ,0,0,889955,Oceania,27,0
2020-07-28,Fiji,FJ,0,0,889955,Oceania,27,0
2020-07-29,Fiji,FJ,0,0,889955,Oceania,27,0
2020-07-30,Fiji,FJ,0,0,889955,Oceania,27,0
2020-07-31,Fiji,FJ,0,0,889955,Oceania,27,0
2020-08-01,Fiji,FJ,0,1,889955,Oceania,27,1
2020-08-02,Fiji,FJ,0,0,889955,Oceania,27,1
2020-08-03,Fiji,FJ,0,0,889955,Oceania,27,1
2020-08-04,Fiji,FJ,0,0,889955,Oceania,27,1
2020-08-05,Fiji,FJ,0,0,889955,Oceania,27,1
2020-08-06,Fiji,FJ,0,0,889955,Oceania,27,1
2020-08-07,Fiji,FJ,0,0,889955,Oceania,27,1
2020-08-08,Fiji,FJ,0,0,889955,Oceania,27,1
2020-08-09,Fiji,FJ,0,0,889955,Oceania,27,1
2020-08-10,Fiji,FJ,0,0,889955,Oceania,27,1
2020-08-11,Fiji,FJ,0,0,889955,Oceania,27,1
2020-08-12,Fiji,FJ,0,0,889955,Oceania,27,1
2020-08-13,Fiji,FJ,0,0,889955,Oceania,27,1
2020-08-14,Fiji,FJ,0,0,889955,Oceania,27,1
2020-08-15,Fiji,FJ,0,0,889955,Oceania,27,1
2020-08-16,Fiji,FJ,0,0,889955,Oceania,27,1
2020-08-17,Fiji,FJ,1,0,889955,Oceania,28,1
2020-08-18,Fiji,FJ,0,0,889955,Oceania,28,1
2020-08-19,Fiji,FJ,0,0,889955,Oceania,28,1
2020-08-20,Fiji,FJ,0,0,889955,Oceania,28,1
2020-08-21,Fiji,FJ,0,0,889955,Oceania,28,1
2020-08-22,Fiji,FJ,0,0,889955,Oceania,28,1
2020-08-23,Fiji,FJ,0,0,889955,Oceania,28,1
2020-08-24,Fiji,FJ,0,0,889955,Oceania,28,1
2020-08-25,Fiji,FJ,0,0,889955,Oceania,28,1
2020-08-26,Fiji,FJ,0,0,889955,Oceania,28,1
2020-08-27,Fiji,FJ,0,0,889955,Oceania,28,1
2020-08-28,Fiji,FJ,0,0,889955,Oceania,28,1
2020-08-29,Fiji,FJ,0,1,889955,Oceania,28,2
2020-08-30,Fiji,FJ,0,0,889955,Oceania,28,2
2020-08-31,Fiji,FJ,0,0,889955,Oceania,28,2
2020-09-01,Fiji,FJ,0,0,889955,Oceania,28,2
2020-09-02,Fiji,FJ,1,0,889955,Oceania,29,2
2020-09-03,Fiji,FJ,0,0,889955,Oceania,29,2
2020-09-04,Fiji,FJ,2,0,889955,Oceania,31,2
2020-09-05,Fiji,FJ,0,0,889955,Oceania,31,2
2020-09-06,Fiji,FJ,0,0,889955,Oceania,31,2
2020-09-07,Fiji,FJ,0,0,889955,Oceania,31,2
2020-09-08,Fiji,FJ,0,0,889955,Oceania,31,2
2020-09-09,Fiji,FJ,0,0,889955,Oceania,31,2
2020-09-10,Fiji,FJ,1,0,889955,Oceania,32,2
2020-09-11,Fiji,FJ,0,0,889955,Oceania,32,2
2020-09-12,Fiji,FJ,0,0,889955,Oceania,32,2
2020-09-13,Fiji,FJ,0,0,889955,Oceania,32,2
2020-09-14,Fiji,FJ,0,0,889955,Oceania,32,2
2020-09-15,Fiji,FJ,0,0,889955,Oceania,32,2
2020-09-16,Fiji,FJ,0,0,889955,Oceania,32,2
2020-09-17,Fiji,FJ,0,0,889955,Oceania,32,2
2020-09-18,Fiji,FJ,0,0,889955,Oceania,32,2
2020-09-19,Fiji,FJ,0,0,889955,Oceania,32,2
2020-09-20,Fiji,FJ,0,0,889955,Oceania,32,2
2020-09-21,Fiji,FJ,0,0,889955,Oceania,32,2
2020-09-22,Fiji,FJ,0,0,889955,Oceania,32,2
2020-09-23,Fiji,FJ,0,0,889955,Oceania,32,2
2020-09-24,Fiji,FJ,0,0,889955,Oceania,32,2
2020-09-25,Fiji,FJ,0,0,889955,Oceania,32,2
2020-09-26,Fiji,FJ,0,0,889955,Oceania,32,2
2020-09-27,Fiji,FJ,0,0,889955,Oceania,32,2
2020-09-28,Fiji,FJ,0,0,889955,Oceania,32,2
2020-09-29,Fiji,FJ,0,0,889955,Oceania,32,2
2020-09-30,Fiji,FJ,0,0,889955,Oceania,32,2
2020-10-01,Fiji,FJ,0,0,889955,Oceania,32,2
2020-10-02,Fiji,FJ,0,0,889955,Oceania,32,2
2020-10-03,Fiji,FJ,0,0,889955,Oceania,32,2
2020-10-04,Fiji,FJ,0,0,889955,Oceania,32,2
2020-10-05,Fiji,FJ,0,0,889955,Oceania,32,2
2020-10-06,Fiji,FJ,0,0,889955,Oceania,32,2
2020-10-07,Fiji,FJ,0,0,889955,Oceania,32,2
2020-10-08,Fiji,FJ,0,0,889955,Oceania,32,2
2020-10-09,Fiji,FJ,0,0,889955,Oceania,32,2
2020-10-10,Fiji,FJ,0,0,889955,Oceania,32,2
2020-10-11,Fiji,FJ,0,0,889955,Oceania,32,2
2020-10-12,Fiji,FJ,0,0,889955,Oceania,32,2
2020-10-13,Fiji,FJ,0,0,889955,Oceania,32,2
2020-10-14,Fiji,FJ,0,0,889955,Oceania,32,2
2020-10-15,Fiji,FJ,0,0,889955,Oceania,32,2
2020-10-16,Fiji,FJ,0,0,889955,Oceania,32,2
2020-10-17,Fiji,FJ,0,0,889955,Oceania,32,2
2020-10-18,Fiji,FJ,0,0,889955,Oceania,32,2
2020-10-19,Fiji,FJ,0,0,889955,Oceania,32,2
2020-10-20,Fiji,FJ,0,0,889955,Oceania,32,2
2020-10-21,Fiji,FJ,1,0,889955,Oceania,33,2
2020-10-22,Fiji,FJ,0,0,889955,Oceania,33,2
2020-10-23,Fiji,FJ,0,0,889955,Oceania,33,2
2020-10-24,Fiji,FJ,0,0,889955,Oceania,33,2
2020-10-25,Fiji,FJ,0,0,889955,Oceania,33,2
2020-10-26,Fiji,FJ,0,0,889955,Oceania,33,2
2020-10-27,Fiji,FJ,0,0,889955,Oceania,33,2
2020-10-28,Fiji,FJ,0,0,889955,Oceania,33,2
2020-10-29,Fiji,FJ,0,0,889955,Oceania,33,2
2020-10-30,Fiji,FJ,1,0,889955,Oceania,34,2
2020-10-31,Fiji,FJ,0,0,889955,Oceania,34,2
2020-11-01,Fiji,FJ,0,0,889955,Oceania,34,2
2020-11-02,Fiji,FJ,0,0,889955,Oceania,34,2
2020-11-03,Fiji,FJ,0,0,889955,Oceania,34,2
2020-11-04,Fiji,FJ,0,0,889955,Oceania,34,2
2020-11-05,Fiji,FJ,0,0,889955,Oceania,34,2
2020-11-06,Fiji,FJ,0,0,889955,Oceania,34,2
2020-11-07,Fiji,FJ,0,0,889955,Oceania,34,2
2020-11-08,Fiji,FJ,0,0,889955,Oceania,34,2
2020-11-09,Fiji,FJ,0,0,889955,Oceania,34,2
2020-11-10,Fiji,FJ,0,0,889955,Oceania,34,2
2020-11-11,Fiji,FJ,1,0,889955,Oceania,35,2
2020-11-12,Fiji,FJ,0,0,889955,Oceania,35,2
2020-11-13,Fiji,FJ,0,0,889955,Oceania,35,2
2020-11-14,Fiji,FJ,0,0,889955,Oceania,35,2
2020-11-15,Fiji,FJ,0,0,889955,Oceania,35,2
2020-11-16,Fiji,FJ,0,0,889955,Oceania,35,2
2020-11-17,Fiji,FJ,0,0,889955,Oceania,35,2
2020-11-18,Fiji,FJ,0,0,889955,Oceania,35,2
2020-11-19,Fiji,FJ,0,0,889955,Oceania,35,2
2020-11-20,Fiji,FJ,0,0,889955,Oceania,35,2
2020-11-21,Fiji,FJ,0,0,889955,Oceania,35,2
2020-11-22,Fiji,FJ,0,0,889955,Oceania,35,2
2020-11-23,Fiji,FJ,0,0,889955,Oceania,35,2
2020-11-24,Fiji,FJ,0,0,889955,Oceania,35,2
2020-11-25,Fiji,FJ,3,0,889955,Oceania,38,2
2020-11-26,Fiji,FJ,0,0,889955,Oceania,38,2
2020-11-27,Fiji,FJ,0,0,889955,Oceania,38,2
2020-11-28,Fiji,FJ,0,0,889955,Oceania,38,2
2020-11-29,Fiji,FJ,0,0,889955,Oceania,38,2
2020-11-30,Fiji,FJ,4,0,889955,Oceania,42,2
2020-12-01,Fiji,FJ,0,0,889955,Oceania,42,2
2020-12-02,Fiji,FJ,0,0,889955,Oceania,42,2
2020-12-03,Fiji,FJ,0,0,889955,Oceania,42,2
2020-12-04,Fiji,FJ,2,0,889955,Oceania,44,2
2020-12-05,Fiji,FJ,0,0,889955,Oceania,44,2
2020-12-06,Fiji,FJ,0,0,889955,Oceania,44,2
2020-12-07,Fiji,FJ,0,0,889955,Oceania,44,2
2020-12-08,Fiji,FJ,0,0,889955,Oceania,44,2
2020-12-09,Fiji,FJ,0,0,889955,Oceania,44,2
2020-12-10,Fiji,FJ,0,0,889955,Oceania,44,2
2020-12-11,Fiji,FJ,0,0,889955,Oceania,44,2
2020-12-12,Fiji,FJ,0,0,889955,Oceania,44,2
2020-12-13,Fiji,FJ,0,0,889955,Oceania,44,2
2020-12-14,Fiji,FJ,2,0,889955,Oceania,46,2
2020-04-04,Falkland_Islands_(Malvinas),FK,1,0,3372,America,1,0
2020-04-05,Falkland_Islands_(Malvinas),FK,0,0,3372,America,1,0
2020-04-06,Falkland_Islands_(Malvinas),FK,1,0,3372,America,2,0
2020-04-07,Falkland_Islands_(Malvinas),FK,0,0,3372,America,2,0
2020-04-08,Falkland_Islands_(Malvinas),FK,3,0,3372,America,5,0
2020-04-09,Falkland_Islands_(Malvinas),FK,0,0,3372,America,5,0
2020-04-10,Falkland_Islands_(Malvinas),FK,0,0,3372,America,5,0
2020-04-11,Falkland_Islands_(Malvinas),FK,0,0,3372,America,5,0
2020-04-12,Falkland_Islands_(Malvinas),FK,0,0,3372,America,5,0
2020-04-13,Falkland_Islands_(Malvinas),FK,0,0,3372,America,5,0
2020-04-14,Falkland_Islands_(Malvinas),FK,0,0,3372,America,5,0
2020-04-15,Falkland_Islands_(Malvinas),FK,6,0,3372,America,11,0
2020-04-16,Falkland_Islands_(Malvinas),FK,0,0,3372,America,11,0
2020-04-17,Falkland_Islands_(Malvinas),FK,0,0,3372,America,11,0
2020-04-18,Falkland_Islands_(Malvinas),FK,0,0,3372,America,11,0
2020-04-19,Falkland_Islands_(Malvinas),FK,0,0,3372,America,11,0
2020-04-20,Falkland_Islands_(Malvinas),FK,0,0,3372,America,11,0
2020-04-21,Falkland_Islands_(Malvinas),FK,0,0,3372,America,11,0
2020-04-22,Falkland_Islands_(Malvinas),FK,1,0,3372,America,12,0
2020-04-23,Falkland_Islands_(Malvinas),FK,0,0,3372,America,12,0
2020-04-24,Falkland_Islands_(Malvinas),FK,0,0,3372,America,12,0
2020-04-25,Falkland_Islands_(Malvinas),FK,0,0,3372,America,12,0
2020-04-26,Falkland_Islands_(Malvinas),FK,1,0,3372,America,13,0
2020-04-27,Falkland_Islands_(Malvinas),FK,0,0,3372,America,13,0
2020-04-28,Falkland_Islands_(Malvinas),FK,0,0,3372,America,13,0
2020-04-29,Falkland_Islands_(Malvinas),FK,0,0,3372,America,13,0
2020-04-30,Falkland_Islands_(Malvinas),FK,0,0,3372,America,13,0
2020-05-01,Falkland_Islands_(Malvinas),FK,0,0,3372,America,13,0
2020-05-02,Falkland_Islands_(Malvinas),FK,0,0,3372,America,13,0
2020-05-03,Falkland_Islands_(Malvinas),FK,0,0,3372,America,13,0
2020-05-04,Falkland_Islands_(Malvinas),FK,0,0,3372,America,13,0
2020-05-05,Falkland_Islands_(Malvinas),FK,0,0,3372,America,13,0
2020-05-06,Falkland_Islands_(Malvinas),FK,0,0,3372,America,13,0
2020-05-07,Falkland_Islands_(Malvinas),FK,0,0,3372,America,13,0
2020-05-08,Falkland_Islands_(Malvinas),FK,0,0,3372,America,13,0
2020-05-09,Falkland_Islands_(Malvinas),FK,0,0,3372,America,13,0
2020-05-10,Falkland_Islands_(Malvinas),FK,0,0,3372,America,13,0
2020-05-11,Falkland_Islands_(Malvinas),FK,0,0,3372,America,13,0
2020-05-12,Falkland_Islands_(Malvinas),FK,0,0,3372,America,13,0
2020-05-13,Falkland_Islands_(Malvinas),FK,0,0,3372,America,13,0
2020-05-14,Falkland_Islands_(Malvinas),FK,0,0,3372,America,13,0
2020-05-15,Falkland_Islands_(Malvinas),FK,0,0,3372,America,13,0
2020-05-16,Falkland_Islands_(Malvinas),FK,0,0,3372,America,13,0
2020-05-17,Falkland_Islands_(Malvinas),FK,0,0,3372,America,13,0
2020-05-18,Falkland_Islands_(Malvinas),FK,0,0,3372,America,13,0
2020-05-19,Falkland_Islands_(Malvinas),FK,0,0,3372,America,13,0
2020-05-20,Falkland_Islands_(Malvinas),FK,0,0,3372,America,13,0
2020-05-21,Falkland_Islands_(Malvinas),FK,0,0,3372,America,13,0
2020-05-22,Falkland_Islands_(Malvinas),FK,0,0,3372,America,13,0
2020-05-23,Falkland_Islands_(Malvinas),FK,0,0,3372,America,13,0
2020-05-24,Falkland_Islands_(Malvinas),FK,0,0,3372,America,13,0
2020-05-25,Falkland_Islands_(Malvinas),FK,0,0,3372,America,13,0
2020-05-26,Falkland_Islands_(Malvinas),FK,0,0,3372,America,13,0
2020-05-27,Falkland_Islands_(Malvinas),FK,0,0,3372,America,13,0
2020-05-28,Falkland_Islands_(Malvinas),FK,0,0,3372,America,13,0
2020-05-29,Falkland_Islands_(Malvinas),FK,0,0,3372,America,13,0
2020-05-30,Falkland_Islands_(Malvinas),FK,0,0,3372,America,13,0
2020-05-31,Falkland_Islands_(Malvinas),FK,0,0,3372,America,13,0
2020-06-01,Falkland_Islands_(Malvinas),FK,0,0,3372,America,13,0
2020-06-02,Falkland_Islands_(Malvinas),FK,0,0,3372,America,13,0
2020-06-03,Falkland_Islands_(Malvinas),FK,0,0,3372,America,13,0
2020-06-04,Falkland_Islands_(Malvinas),FK,0,0,3372,America,13,0
2020-06-05,Falkland_Islands_(Malvinas),FK,0,0,3372,America,13,0
2020-06-06,Falkland_Islands_(Malvinas),FK,0,0,3372,America,13,0
2020-06-07,Falkland_Islands_(Malvinas),FK,0,0,3372,America,13,0
2020-06-08,Falkland_Islands_(Malvinas),FK,0,0,3372,America,13,0
2020-06-09,Falkland_Islands_(Malvinas),FK,0,0,3372,America,13,0
2020-06-10,Falkland_Islands_(Malvinas),FK,0,0,3372,America,13,0
2020-06-11,Falkland_Islands_(Malvinas),FK,0,0,3372,America,13,0
2020-06-12,Falkland_Islands_(Malvinas),FK,0,0,3372,America,13,0
2020-06-13,Falkland_Islands_(Malvinas),FK,0,0,3372,America,13,0
2020-06-14,Falkland_Islands_(Malvinas),FK,0,0,3372,America,13,0
2020-06-15,Falkland_Islands_(Malvinas),FK,0,0,3372,America,13,0
2020-06-16,Falkland_Islands_(Malvinas),FK,0,0,3372,America,13,0
2020-06-17,Falkland_Islands_(Malvinas),FK,0,0,3372,America,13,0
2020-06-18,Falkland_Islands_(Malvinas),FK,0,0,3372,America,13,0
2020-06-19,Falkland_Islands_(Malvinas),FK,0,0,3372,America,13,0
2020-06-20,Falkland_Islands_(Malvinas),FK,0,0,3372,America,13,0
2020-06-21,Falkland_Islands_(Malvinas),FK,0,0,3372,America,13,0
2020-06-22,Falkland_Islands_(Malvinas),FK,0,0,3372,America,13,0
2020-06-23,Falkland_Islands_(Malvinas),FK,0,0,3372,America,13,0
2020-06-24,Falkland_Islands_(Malvinas),FK,0,0,3372,America,13,0
2020-06-25,Falkland_Islands_(Malvinas),FK,0,0,3372,America,13,0
2020-06-26,Falkland_Islands_(Malvinas),FK,0,0,3372,America,13,0
2020-06-27,Falkland_Islands_(Malvinas),FK,0,0,3372,America,13,0
2020-06-28,Falkland_Islands_(Malvinas),FK,0,0,3372,America,13,0
2020-06-29,Falkland_Islands_(Malvinas),FK,0,0,3372,America,13,0
2020-06-30,Falkland_Islands_(Malvinas),FK,0,0,3372,America,13,0
2020-07-01,Falkland_Islands_(Malvinas),FK,0,0,3372,America,13,0
2020-07-02,Falkland_Islands_(Malvinas),FK,0,0,3372,America,13,0
2020-07-03,Falkland_Islands_(Malvinas),FK,0,0,3372,America,13,0
2020-07-04,Falkland_Islands_(Malvinas),FK,0,0,3372,America,13,0
2020-07-05,Falkland_Islands_(Malvinas),FK,0,0,3372,America,13,0
2020-07-06,Falkland_Islands_(Malvinas),FK,0,0,3372,America,13,0
2020-07-07,Falkland_Islands_(Malvinas),FK,0,0,3372,America,13,0
2020-07-08,Falkland_Islands_(Malvinas),FK,0,0,3372,America,13,0
2020-07-09,Falkland_Islands_(Malvinas),FK,0,0,3372,America,13,0
2020-07-10,Falkland_Islands_(Malvinas),FK,0,0,3372,America,13,0
2020-07-11,Falkland_Islands_(Malvinas),FK,0,0,3372,America,13,0
2020-07-12,Falkland_Islands_(Malvinas),FK,0,0,3372,America,13,0
2020-07-13,Falkland_Islands_(Malvinas),FK,0,0,3372,America,13,0
2020-07-14,Falkland_Islands_(Malvinas),FK,0,0,3372,America,13,0
2020-07-15,Falkland_Islands_(Malvinas),FK,0,0,3372,America,13,0
2020-07-16,Falkland_Islands_(Malvinas),FK,0,0,3372,America,13,0
2020-07-17,Falkland_Islands_(Malvinas),FK,0,0,3372,America,13,0
2020-07-18,Falkland_Islands_(Malvinas),FK,0,0,3372,America,13,0
2020-07-19,Falkland_Islands_(Malvinas),FK,0,0,3372,America,13,0
2020-07-20,Falkland_Islands_(Malvinas),FK,0,0,3372,America,13,0
2020-07-21,Falkland_Islands_(Malvinas),FK,0,0,3372,America,13,0
2020-07-22,Falkland_Islands_(Malvinas),FK,0,0,3372,America,13,0
2020-07-23,Falkland_Islands_(Malvinas),FK,0,0,3372,America,13,0
2020-07-24,Falkland_Islands_(Malvinas),FK,0,0,3372,America,13,0
2020-07-25,Falkland_Islands_(Malvinas),FK,0,0,3372,America,13,0
2020-07-26,Falkland_Islands_(Malvinas),FK,0,0,3372,America,13,0
2020-07-27,Falkland_Islands_(Malvinas),FK,0,0,3372,America,13,0
2020-07-28,Falkland_Islands_(Malvinas),FK,0,0,3372,America,13,0
2020-07-29,Falkland_Islands_(Malvinas),FK,0,0,3372,America,13,0
2020-07-30,Falkland_Islands_(Malvinas),FK,0,0,3372,America,13,0
2020-07-31,Falkland_Islands_(Malvinas),FK,0,0,3372,America,13,0
2020-08-01,Falkland_Islands_(Malvinas),FK,0,0,3372,America,13,0
2020-08-02,Falkland_Islands_(Malvinas),FK,0,0,3372,America,13,0
2020-08-03,Falkland_Islands_(Malvinas),FK,0,0,3372,America,13,0
2020-08-04,Falkland_Islands_(Malvinas),FK,0,0,3372,America,13,0
2020-08-05,Falkland_Islands_(Malvinas),FK,0,0,3372,America,13,0
2020-08-06,Falkland_Islands_(Malvinas),FK,0,0,3372,America,13,0
2020-08-07,Falkland_Islands_(Malvinas),FK,0,0,3372,America,13,0
2020-08-08,Falkland_Islands_(Malvinas),FK,0,0,3372,America,13,0
2020-08-09,Falkland_Islands_(Malvinas),FK,0,0,3372,America,13,0
2020-08-10,Falkland_Islands_(Malvinas),FK,0,0,3372,America,13,0
2020-08-11,Falkland_Islands_(Malvinas),FK,0,0,3372,America,13,0
2020-08-12,Falkland_Islands_(Malvinas),FK,0,0,3372,America,13,0
2020-08-13,Falkland_Islands_(Malvinas),FK,0,0,3372,America,13,0
2020-08-14,Falkland_Islands_(Malvinas),FK,0,0,3372,America,13,0
2020-08-15,Falkland_Islands_(Malvinas),FK,0,0,3372,America,13,0
2020-08-16,Falkland_Islands_(Malvinas),FK,0,0,3372,America,13,0
2020-08-17,Falkland_Islands_(Malvinas),FK,0,0,3372,America,13,0
2020-08-18,Falkland_Islands_(Malvinas),FK,0,0,3372,America,13,0
2020-08-19,Falkland_Islands_(Malvinas),FK,0,0,3372,America,13,0
2020-08-20,Falkland_Islands_(Malvinas),FK,0,0,3372,America,13,0
2020-08-21,Falkland_Islands_(Malvinas),FK,0,0,3372,America,13,0
2020-08-22,Falkland_Islands_(Malvinas),FK,0,0,3372,America,13,0
2020-08-23,Falkland_Islands_(Malvinas),FK,0,0,3372,America,13,0
2020-08-24,Falkland_Islands_(Malvinas),FK,0,0,3372,America,13,0
2020-08-25,Falkland_Islands_(Malvinas),FK,0,0,3372,America,13,0
2020-08-26,Falkland_Islands_(Malvinas),FK,0,0,3372,America,13,0
2020-08-27,Falkland_Islands_(Malvinas),FK,0,0,3372,America,13,0
2020-08-28,Falkland_Islands_(Malvinas),FK,0,0,3372,America,13,0
2020-08-29,Falkland_Islands_(Malvinas),FK,0,0,3372,America,13,0
2020-08-30,Falkland_Islands_(Malvinas),FK,0,0,3372,America,13,0
2020-08-31,Falkland_Islands_(Malvinas),FK,0,0,3372,America,13,0
2020-09-01,Falkland_Islands_(Malvinas),FK,0,0,3372,America,13,0
2020-09-02,Falkland_Islands_(Malvinas),FK,0,0,3372,America,13,0
2020-09-03,Falkland_Islands_(Malvinas),FK,0,0,3372,America,13,0
2020-09-04,Falkland_Islands_(Malvinas),FK,0,0,3372,America,13,0
2020-09-05,Falkland_Islands_(Malvinas),FK,0,0,3372,America,13,0
2020-09-06,Falkland_Islands_(Malvinas),FK,0,0,3372,America,13,0
2020-09-07,Falkland_Islands_(Malvinas),FK,0,0,3372,America,13,0
2020-09-08,Falkland_Islands_(Malvinas),FK,0,0,3372,America,13,0
2020-09-09,Falkland_Islands_(Malvinas),FK,0,0,3372,America,13,0
2020-09-10,Falkland_Islands_(Malvinas),FK,0,0,3372,America,13,0
2020-09-11,Falkland_Islands_(Malvinas),FK,0,0,3372,America,13,0
2020-09-12,Falkland_Islands_(Malvinas),FK,0,0,3372,America,13,0
2020-09-13,Falkland_Islands_(Malvinas),FK,0,0,3372,America,13,0
2020-09-14,Falkland_Islands_(Malvinas),FK,0,0,3372,America,13,0
2020-09-15,Falkland_Islands_(Malvinas),FK,0,0,3372,America,13,0
2020-09-16,Falkland_Islands_(Malvinas),FK,0,0,3372,America,13,0
2020-09-17,Falkland_Islands_(Malvinas),FK,0,0,3372,America,13,0
2020-09-18,Falkland_Islands_(Malvinas),FK,0,0,3372,America,13,0
2020-09-19,Falkland_Islands_(Malvinas),FK,0,0,3372,America,13,0
2020-09-20,Falkland_Islands_(Malvinas),FK,0,0,3372,America,13,0
2020-09-21,Falkland_Islands_(Malvinas),FK,0,0,3372,America,13,0
2020-09-22,Falkland_Islands_(Malvinas),FK,0,0,3372,America,13,0
2020-09-23,Falkland_Islands_(Malvinas),FK,0,0,3372,America,13,0
2020-09-24,Falkland_Islands_(Malvinas),FK,0,0,3372,America,13,0
2020-09-25,Falkland_Islands_(Malvinas),FK,0,0,3372,America,13,0
2020-09-26,Falkland_Islands_(Malvinas),FK,0,0,3372,America,13,0
2020-09-27,Falkland_Islands_(Malvinas),FK,0,0,3372,America,13,0
2020-09-28,Falkland_Islands_(Malvinas),FK,0,0,3372,America,13,0
2020-09-29,Falkland_Islands_(Malvinas),FK,0,0,3372,America,13,0
2020-09-30,Falkland_Islands_(Malvinas),FK,0,0,3372,America,13,0
2020-10-01,Falkland_Islands_(Malvinas),FK,0,0,3372,America,13,0
2020-10-02,Falkland_Islands_(Malvinas),FK,0,0,3372,America,13,0
2020-10-03,Falkland_Islands_(Malvinas),FK,0,0,3372,America,13,0
2020-10-04,Falkland_Islands_(Malvinas),FK,0,0,3372,America,13,0
2020-10-05,Falkland_Islands_(Malvinas),FK,0,0,3372,America,13,0
2020-10-06,Falkland_Islands_(Malvinas),FK,0,0,3372,America,13,0
2020-10-07,Falkland_Islands_(Malvinas),FK,0,0,3372,America,13,0
2020-10-08,Falkland_Islands_(Malvinas),FK,0,0,3372,America,13,0
2020-10-09,Falkland_Islands_(Malvinas),FK,0,0,3372,America,13,0
2020-10-10,Falkland_Islands_(Malvinas),FK,0,0,3372,America,13,0
2020-10-11,Falkland_Islands_(Malvinas),FK,0,0,3372,America,13,0
2020-10-12,Falkland_Islands_(Malvinas),FK,0,0,3372,America,13,0
2020-10-13,Falkland_Islands_(Malvinas),FK,0,0,3372,America,13,0
2020-10-14,Falkland_Islands_(Malvinas),FK,0,0,3372,America,13,0
2020-10-15,Falkland_Islands_(Malvinas),FK,0,0,3372,America,13,0
2020-10-16,Falkland_Islands_(Malvinas),FK,0,0,3372,America,13,0
2020-10-17,Falkland_Islands_(Malvinas),FK,0,0,3372,America,13,0
2020-10-18,Falkland_Islands_(Malvinas),FK,0,0,3372,America,13,0
2020-10-19,Falkland_Islands_(Malvinas),FK,0,0,3372,America,13,0
2020-10-20,Falkland_Islands_(Malvinas),FK,0,0,3372,America,13,0
2020-10-21,Falkland_Islands_(Malvinas),FK,0,0,3372,America,13,0
2020-10-22,Falkland_Islands_(Malvinas),FK,0,0,3372,America,13,0
2020-10-23,Falkland_Islands_(Malvinas),FK,0,0,3372,America,13,0
2020-10-24,Falkland_Islands_(Malvinas),FK,0,0,3372,America,13,0
2020-10-25,Falkland_Islands_(Malvinas),FK,0,0,3372,America,13,0
2020-10-26,Falkland_Islands_(Malvinas),FK,0,0,3372,America,13,0
2020-10-27,Falkland_Islands_(Malvinas),FK,0,0,3372,America,13,0
2020-10-28,Falkland_Islands_(Malvinas),FK,0,0,3372,America,13,0
2020-10-29,Falkland_Islands_(Malvinas),FK,0,0,3372,America,13,0
2020-10-30,Falkland_Islands_(Malvinas),FK,0,0,3372,America,13,0
2020-10-31,Falkland_Islands_(Malvinas),FK,0,0,3372,America,13,0
2020-11-01,Falkland_Islands_(Malvinas),FK,0,0,3372,America,13,0
2020-11-02,Falkland_Islands_(Malvinas),FK,0,0,3372,America,13,0
2020-11-03,Falkland_Islands_(Malvinas),FK,0,0,3372,America,13,0
2020-11-04,Falkland_Islands_(Malvinas),FK,0,0,3372,America,13,0
2020-11-05,Falkland_Islands_(Malvinas),FK,0,0,3372,America,13,0
2020-11-06,Falkland_Islands_(Malvinas),FK,0,0,3372,America,13,0
2020-11-07,Falkland_Islands_(Malvinas),FK,0,0,3372,America,13,0
2020-11-08,Falkland_Islands_(Malvinas),FK,0,0,3372,America,13,0
2020-11-09,Falkland_Islands_(Malvinas),FK,0,0,3372,America,13,0
2020-11-10,Falkland_Islands_(Malvinas),FK,0,0,3372,America,13,0
2020-11-11,Falkland_Islands_(Malvinas),FK,1,0,3372,America,14,0
2020-11-12,Falkland_Islands_(Malvinas),FK,0,0,3372,America,14,0
2020-11-13,Falkland_Islands_(Malvinas),FK,1,0,3372,America,15,0
2020-11-14,Falkland_Islands_(Malvinas),FK,0,0,3372,America,15,0
2020-11-15,Falkland_Islands_(Malvinas),FK,0,0,3372,America,15,0
2020-11-16,Falkland_Islands_(Malvinas),FK,0,0,3372,America,15,0
2020-11-17,Falkland_Islands_(Malvinas),FK,0,0,3372,America,15,0
2020-11-18,Falkland_Islands_(Malvinas),FK,1,0,3372,America,16,0
2020-11-19,Falkland_Islands_(Malvinas),FK,0,0,3372,America,16,0
2020-11-20,Falkland_Islands_(Malvinas),FK,0,0,3372,America,16,0
2020-11-21,Falkland_Islands_(Malvinas),FK,0,0,3372,America,16,0
2020-11-22,Falkland_Islands_(Malvinas),FK,0,0,3372,America,16,0
2020-11-23,Falkland_Islands_(Malvinas),FK,0,0,3372,America,16,0
2020-11-24,Falkland_Islands_(Malvinas),FK,0,0,3372,America,16,0
2020-11-25,Falkland_Islands_(Malvinas),FK,0,0,3372,America,16,0
2020-11-26,Falkland_Islands_(Malvinas),FK,0,0,3372,America,16,0
2020-11-27,Falkland_Islands_(Malvinas),FK,0,0,3372,America,16,0
2020-11-28,Falkland_Islands_(Malvinas),FK,1,0,3372,America,17,0
2020-11-29,Falkland_Islands_(Malvinas),FK,0,0,3372,America,17,0
2020-11-30,Falkland_Islands_(Malvinas),FK,0,0,3372,America,17,0
2020-12-01,Falkland_Islands_(Malvinas),FK,0,0,3372,America,17,0
2020-12-02,Falkland_Islands_(Malvinas),FK,0,0,3372,America,17,0
2020-12-03,Falkland_Islands_(Malvinas),FK,0,0,3372,America,17,0
2020-12-04,Falkland_Islands_(Malvinas),FK,0,0,3372,America,17,0
2020-12-05,Falkland_Islands_(Malvinas),FK,0,0,3372,America,17,0
2020-12-06,Falkland_Islands_(Malvinas),FK,0,0,3372,America,17,0
2020-12-07,Falkland_Islands_(Malvinas),FK,0,0,3372,America,17,0
2020-12-08,Falkland_Islands_(Malvinas),FK,0,0,3372,America,17,0
2020-12-09,Falkland_Islands_(Malvinas),FK,0,0,3372,America,17,0
2020-12-10,Falkland_Islands_(Malvinas),FK,0,0,3372,America,17,0
2020-12-11,Falkland_Islands_(Malvinas),FK,2,0,3372,America,19,0
2020-12-12,Falkland_Islands_(Malvinas),FK,0,0,3372,America,19,0
2020-12-13,Falkland_Islands_(Malvinas),FK,0,0,3372,America,19,0
2020-12-14,Falkland_Islands_(Malvinas),FK,0,0,3372,America,19,0
2020-03-06,Faroe_Islands,FO,1,0,48677,Europe,1,0
2020-03-07,Faroe_Islands,FO,1,0,48677,Europe,2,0
2020-03-08,Faroe_Islands,FO,1,0,48677,Europe,3,0
2020-03-09,Faroe_Islands,FO,0,0,48677,Europe,3,0
2020-03-10,Faroe_Islands,FO,0,0,48677,Europe,3,0
2020-03-11,Faroe_Islands,FO,0,0,48677,Europe,3,0
2020-03-12,Faroe_Islands,FO,0,0,48677,Europe,3,0
2020-03-13,Faroe_Islands,FO,0,0,48677,Europe,3,0
2020-03-14,Faroe_Islands,FO,0,0,48677,Europe,3,0
2020-03-15,Faroe_Islands,FO,0,0,48677,Europe,3,0
2020-03-16,Faroe_Islands,FO,6,0,48677,Europe,9,0
2020-03-17,Faroe_Islands,FO,2,0,48677,Europe,11,0
2020-03-18,Faroe_Islands,FO,7,0,48677,Europe,18,0
2020-03-19,Faroe_Islands,FO,29,0,48677,Europe,47,0
2020-03-20,Faroe_Islands,FO,25,0,48677,Europe,72,0
2020-03-21,Faroe_Islands,FO,8,0,48677,Europe,80,0
2020-03-22,Faroe_Islands,FO,12,0,48677,Europe,92,0
2020-03-23,Faroe_Islands,FO,23,0,48677,Europe,115,0
2020-03-24,Faroe_Islands,FO,3,0,48677,Europe,118,0
2020-03-25,Faroe_Islands,FO,4,0,48677,Europe,122,0
2020-03-26,Faroe_Islands,FO,10,0,48677,Europe,132,0
2020-03-27,Faroe_Islands,FO,8,0,48677,Europe,140,0
2020-03-28,Faroe_Islands,FO,4,0,48677,Europe,144,0
2020-03-29,Faroe_Islands,FO,11,0,48677,Europe,155,0
2020-03-30,Faroe_Islands,FO,4,0,48677,Europe,159,0
2020-03-31,Faroe_Islands,FO,9,0,48677,Europe,168,0
2020-04-01,Faroe_Islands,FO,1,0,48677,Europe,169,0
2020-04-02,Faroe_Islands,FO,4,0,48677,Europe,173,0
2020-04-03,Faroe_Islands,FO,4,0,48677,Europe,177,0
2020-04-04,Faroe_Islands,FO,2,0,48677,Europe,179,0
2020-04-05,Faroe_Islands,FO,2,0,48677,Europe,181,0
2020-04-06,Faroe_Islands,FO,0,0,48677,Europe,181,0
2020-04-07,Faroe_Islands,FO,2,0,48677,Europe,183,0
2020-04-08,Faroe_Islands,FO,1,0,48677,Europe,184,0
2020-04-09,Faroe_Islands,FO,0,0,48677,Europe,184,0
2020-04-10,Faroe_Islands,FO,0,0,48677,Europe,184,0
2020-04-11,Faroe_Islands,FO,0,0,48677,Europe,184,0
2020-04-12,Faroe_Islands,FO,0,0,48677,Europe,184,0
2020-04-13,Faroe_Islands,FO,0,0,48677,Europe,184,0
2020-04-14,Faroe_Islands,FO,0,0,48677,Europe,184,0
2020-04-15,Faroe_Islands,FO,0,0,48677,Europe,184,0
2020-04-16,Faroe_Islands,FO,0,0,48677,Europe,184,0
2020-04-17,Faroe_Islands,FO,0,0,48677,Europe,184,0
2020-04-18,Faroe_Islands,FO,0,0,48677,Europe,184,0
2020-04-19,Faroe_Islands,FO,0,0,48677,Europe,184,0
2020-04-20,Faroe_Islands,FO,1,0,48677,Europe,185,0
2020-04-21,Faroe_Islands,FO,0,0,48677,Europe,185,0
2020-04-22,Faroe_Islands,FO,0,0,48677,Europe,185,0
2020-04-23,Faroe_Islands,FO,0,0,48677,Europe,185,0
2020-04-24,Faroe_Islands,FO,2,0,48677,Europe,187,0
2020-04-25,Faroe_Islands,FO,0,0,48677,Europe,187,0
2020-04-26,Faroe_Islands,FO,0,0,48677,Europe,187,0
2020-04-27,Faroe_Islands,FO,0,0,48677,Europe,187,0
2020-04-28,Faroe_Islands,FO,0,0,48677,Europe,187,0
2020-04-29,Faroe_Islands,FO,0,0,48677,Europe,187,0
2020-04-30,Faroe_Islands,FO,0,0,48677,Europe,187,0
2020-05-01,Faroe_Islands,FO,0,0,48677,Europe,187,0
2020-05-02,Faroe_Islands,FO,0,0,48677,Europe,187,0
2020-05-03,Faroe_Islands,FO,0,0,48677,Europe,187,0
2020-05-04,Faroe_Islands,FO,0,0,48677,Europe,187,0
2020-05-05,Faroe_Islands,FO,0,0,48677,Europe,187,0
2020-05-06,Faroe_Islands,FO,0,0,48677,Europe,187,0
2020-05-07,Faroe_Islands,FO,0,0,48677,Europe,187,0
2020-05-08,Faroe_Islands,FO,0,0,48677,Europe,187,0
2020-05-09,Faroe_Islands,FO,0,0,48677,Europe,187,0
2020-05-10,Faroe_Islands,FO,0,0,48677,Europe,187,0
2020-05-11,Faroe_Islands,FO,0,0,48677,Europe,187,0
2020-05-12,Faroe_Islands,FO,0,0,48677,Europe,187,0
2020-05-13,Faroe_Islands,FO,0,0,48677,Europe,187,0
2020-05-14,Faroe_Islands,FO,0,0,48677,Europe,187,0
2020-05-15,Faroe_Islands,FO,0,0,48677,Europe,187,0
2020-05-16,Faroe_Islands,FO,0,0,48677,Europe,187,0
2020-05-17,Faroe_Islands,FO,0,0,48677,Europe,187,0
2020-05-18,Faroe_Islands,FO,0,0,48677,Europe,187,0
2020-05-19,Faroe_Islands,FO,0,0,48677,Europe,187,0
2020-05-20,Faroe_Islands,FO,0,0,48677,Europe,187,0
2020-05-21,Faroe_Islands,FO,0,0,48677,Europe,187,0
2020-05-22,Faroe_Islands,FO,0,0,48677,Europe,187,0
2020-05-23,Faroe_Islands,FO,0,0,48677,Europe,187,0
2020-05-24,Faroe_Islands,FO,0,0,48677,Europe,187,0
2020-05-25,Faroe_Islands,FO,0,0,48677,Europe,187,0
2020-05-26,Faroe_Islands,FO,0,0,48677,Europe,187,0
2020-05-27,Faroe_Islands,FO,0,0,48677,Europe,187,0
2020-05-28,Faroe_Islands,FO,0,0,48677,Europe,187,0
2020-05-29,Faroe_Islands,FO,0,0,48677,Europe,187,0
2020-05-30,Faroe_Islands,FO,0,0,48677,Europe,187,0
2020-05-31,Faroe_Islands,FO,0,0,48677,Europe,187,0
2020-06-01,Faroe_Islands,FO,0,0,48677,Europe,187,0
2020-06-02,Faroe_Islands,FO,0,0,48677,Europe,187,0
2020-06-03,Faroe_Islands,FO,0,0,48677,Europe,187,0
2020-06-04,Faroe_Islands,FO,0,0,48677,Europe,187,0
2020-06-05,Faroe_Islands,FO,0,0,48677,Europe,187,0
2020-06-06,Faroe_Islands,FO,0,0,48677,Europe,187,0
2020-06-07,Faroe_Islands,FO,0,0,48677,Europe,187,0
2020-06-08,Faroe_Islands,FO,0,0,48677,Europe,187,0
2020-06-09,Faroe_Islands,FO,0,0,48677,Europe,187,0
2020-06-10,Faroe_Islands,FO,0,0,48677,Europe,187,0
2020-06-11,Faroe_Islands,FO,0,0,48677,Europe,187,0
2020-06-12,Faroe_Islands,FO,0,0,48677,Europe,187,0
2020-06-13,Faroe_Islands,FO,0,0,48677,Europe,187,0
2020-06-14,Faroe_Islands,FO,0,0,48677,Europe,187,0
2020-06-15,Faroe_Islands,FO,0,0,48677,Europe,187,0
2020-06-16,Faroe_Islands,FO,0,0,48677,Europe,187,0
2020-06-17,Faroe_Islands,FO,0,0,48677,Europe,187,0
2020-06-18,Faroe_Islands,FO,0,0,48677,Europe,187,0
2020-06-19,Faroe_Islands,FO,0,0,48677,Europe,187,0
2020-06-20,Faroe_Islands,FO,0,0,48677,Europe,187,0
2020-06-21,Faroe_Islands,FO,0,0,48677,Europe,187,0
2020-06-22,Faroe_Islands,FO,0,0,48677,Europe,187,0
2020-06-23,Faroe_Islands,FO,0,0,48677,Europe,187,0
2020-06-24,Faroe_Islands,FO,0,0,48677,Europe,187,0
2020-06-25,Faroe_Islands,FO,0,0,48677,Europe,187,0
2020-06-26,Faroe_Islands,FO,0,0,48677,Europe,187,0
2020-06-27,Faroe_Islands,FO,0,0,48677,Europe,187,0
2020-06-28,Faroe_Islands,FO,0,0,48677,Europe,187,0
2020-06-29,Faroe_Islands,FO,0,0,48677,Europe,187,0
2020-06-30,Faroe_Islands,FO,0,0,48677,Europe,187,0
2020-07-01,Faroe_Islands,FO,0,0,48677,Europe,187,0
2020-07-02,Faroe_Islands,FO,0,0,48677,Europe,187,0
2020-07-03,Faroe_Islands,FO,0,0,48677,Europe,187,0
2020-07-04,Faroe_Islands,FO,0,0,48677,Europe,187,0
2020-07-05,Faroe_Islands,FO,0,0,48677,Europe,187,0
2020-07-06,Faroe_Islands,FO,0,0,48677,Europe,187,0
2020-07-07,Faroe_Islands,FO,0,0,48677,Europe,187,0
2020-07-08,Faroe_Islands,FO,1,0,48677,Europe,188,0
2020-07-09,Faroe_Islands,FO,0,0,48677,Europe,188,0
2020-07-10,Faroe_Islands,FO,0,0,48677,Europe,188,0
2020-07-11,Faroe_Islands,FO,0,0,48677,Europe,188,0
2020-07-12,Faroe_Islands,FO,0,0,48677,Europe,188,0
2020-07-13,Faroe_Islands,FO,0,0,48677,Europe,188,0
2020-07-14,Faroe_Islands,FO,0,0,48677,Europe,188,0
2020-07-15,Faroe_Islands,FO,0,0,48677,Europe,188,0
2020-07-16,Faroe_Islands,FO,0,0,48677,Europe,188,0
2020-07-17,Faroe_Islands,FO,0,0,48677,Europe,188,0
2020-07-18,Faroe_Islands,FO,0,0,48677,Europe,188,0
2020-07-19,Faroe_Islands,FO,0,0,48677,Europe,188,0
2020-07-20,Faroe_Islands,FO,3,0,48677,Europe,191,0
2020-07-21,Faroe_Islands,FO,0,0,48677,Europe,191,0
2020-07-22,Faroe_Islands,FO,0,0,48677,Europe,191,0
2020-07-23,Faroe_Islands,FO,0,0,48677,Europe,191,0
2020-07-24,Faroe_Islands,FO,0,0,48677,Europe,191,0
2020-07-25,Faroe_Islands,FO,0,0,48677,Europe,191,0
2020-07-26,Faroe_Islands,FO,0,0,48677,Europe,191,0
2020-07-27,Faroe_Islands,FO,0,0,48677,Europe,191,0
2020-07-28,Faroe_Islands,FO,23,0,48677,Europe,214,0
2020-07-29,Faroe_Islands,FO,6,0,48677,Europe,220,0
2020-07-30,Faroe_Islands,FO,0,0,48677,Europe,220,0
2020-07-31,Faroe_Islands,FO,0,0,48677,Europe,220,0
2020-08-01,Faroe_Islands,FO,5,0,48677,Europe,225,0
2020-08-02,Faroe_Islands,FO,0,0,48677,Europe,225,0
2020-08-03,Faroe_Islands,FO,0,0,48677,Europe,225,0
2020-08-04,Faroe_Islands,FO,0,0,48677,Europe,225,0
2020-08-05,Faroe_Islands,FO,2,0,48677,Europe,227,0
2020-08-06,Faroe_Islands,FO,14,0,48677,Europe,241,0
2020-08-07,Faroe_Islands,FO,0,0,48677,Europe,241,0
2020-08-08,Faroe_Islands,FO,50,0,48677,Europe,291,0
2020-08-09,Faroe_Islands,FO,0,0,48677,Europe,291,0
2020-08-10,Faroe_Islands,FO,0,0,48677,Europe,291,0
2020-08-11,Faroe_Islands,FO,22,0,48677,Europe,313,0
2020-08-12,Faroe_Islands,FO,11,0,48677,Europe,324,0
2020-08-13,Faroe_Islands,FO,15,0,48677,Europe,339,0
2020-08-14,Faroe_Islands,FO,23,0,48677,Europe,362,0
2020-08-15,Faroe_Islands,FO,0,0,48677,Europe,362,0
2020-08-16,Faroe_Islands,FO,8,0,48677,Europe,370,0
2020-08-17,Faroe_Islands,FO,2,0,48677,Europe,372,0
2020-08-18,Faroe_Islands,FO,1,0,48677,Europe,373,0
2020-08-19,Faroe_Islands,FO,0,0,48677,Europe,373,0
2020-08-20,Faroe_Islands,FO,9,0,48677,Europe,382,0
2020-08-21,Faroe_Islands,FO,1,0,48677,Europe,383,0
2020-08-22,Faroe_Islands,FO,1,0,48677,Europe,384,0
2020-08-23,Faroe_Islands,FO,0,0,48677,Europe,384,0
2020-08-24,Faroe_Islands,FO,0,0,48677,Europe,384,0
2020-08-25,Faroe_Islands,FO,26,0,48677,Europe,410,0
2020-08-26,Faroe_Islands,FO,1,0,48677,Europe,411,0
2020-08-27,Faroe_Islands,FO,0,0,48677,Europe,411,0
2020-08-28,Faroe_Islands,FO,0,0,48677,Europe,411,0
2020-08-29,Faroe_Islands,FO,0,0,48677,Europe,411,0
2020-08-30,Faroe_Islands,FO,0,0,48677,Europe,411,0
2020-08-31,Faroe_Islands,FO,0,0,48677,Europe,411,0
2020-09-01,Faroe_Islands,FO,0,0,48677,Europe,411,0
2020-09-02,Faroe_Islands,FO,0,0,48677,Europe,411,0
2020-09-03,Faroe_Islands,FO,0,0,48677,Europe,411,0
2020-09-04,Faroe_Islands,FO,1,0,48677,Europe,412,0
2020-09-05,Faroe_Islands,FO,1,0,48677,Europe,413,0
2020-09-06,Faroe_Islands,FO,0,0,48677,Europe,413,0
2020-09-07,Faroe_Islands,FO,0,0,48677,Europe,413,0
2020-09-08,Faroe_Islands,FO,0,0,48677,Europe,413,0
2020-09-09,Faroe_Islands,FO,1,0,48677,Europe,414,0
2020-09-10,Faroe_Islands,FO,1,0,48677,Europe,415,0
2020-09-11,Faroe_Islands,FO,0,0,48677,Europe,415,0
2020-09-12,Faroe_Islands,FO,1,0,48677,Europe,416,0
2020-09-13,Faroe_Islands,FO,2,0,48677,Europe,418,0
2020-09-14,Faroe_Islands,FO,5,0,48677,Europe,423,0
2020-09-15,Faroe_Islands,FO,0,0,48677,Europe,423,0
2020-09-16,Faroe_Islands,FO,5,0,48677,Europe,428,0
2020-09-17,Faroe_Islands,FO,0,0,48677,Europe,428,0
2020-09-18,Faroe_Islands,FO,1,0,48677,Europe,429,0
2020-09-19,Faroe_Islands,FO,1,0,48677,Europe,430,0
2020-09-20,Faroe_Islands,FO,1,0,48677,Europe,431,0
2020-09-21,Faroe_Islands,FO,3,0,48677,Europe,434,0
2020-09-22,Faroe_Islands,FO,3,0,48677,Europe,437,0
2020-09-23,Faroe_Islands,FO,11,0,48677,Europe,448,0
2020-09-24,Faroe_Islands,FO,3,0,48677,Europe,451,0
2020-09-25,Faroe_Islands,FO,4,0,48677,Europe,455,0
2020-09-26,Faroe_Islands,FO,3,0,48677,Europe,458,0
2020-09-27,Faroe_Islands,FO,2,0,48677,Europe,460,0
2020-09-28,Faroe_Islands,FO,0,0,48677,Europe,460,0
2020-09-29,Faroe_Islands,FO,0,0,48677,Europe,460,0
2020-09-30,Faroe_Islands,FO,3,0,48677,Europe,463,0
2020-10-01,Faroe_Islands,FO,4,0,48677,Europe,467,0
2020-10-02,Faroe_Islands,FO,5,0,48677,Europe,472,0
2020-10-03,Faroe_Islands,FO,0,0,48677,Europe,472,0
2020-10-04,Faroe_Islands,FO,1,0,48677,Europe,473,0
2020-10-05,Faroe_Islands,FO,1,0,48677,Europe,474,0
2020-10-06,Faroe_Islands,FO,1,0,48677,Europe,475,0
2020-10-07,Faroe_Islands,FO,0,0,48677,Europe,475,0
2020-10-08,Faroe_Islands,FO,1,0,48677,Europe,476,0
2020-10-09,Faroe_Islands,FO,1,0,48677,Europe,477,0
2020-10-10,Faroe_Islands,FO,0,0,48677,Europe,477,0
2020-10-11,Faroe_Islands,FO,0,0,48677,Europe,477,0
2020-10-12,Faroe_Islands,FO,0,0,48677,Europe,477,0
2020-10-13,Faroe_Islands,FO,0,0,48677,Europe,477,0
2020-10-14,Faroe_Islands,FO,0,0,48677,Europe,477,0
2020-10-15,Faroe_Islands,FO,1,0,48677,Europe,478,0
2020-10-16,Faroe_Islands,FO,2,0,48677,Europe,480,0
2020-10-17,Faroe_Islands,FO,2,0,48677,Europe,482,0
2020-10-18,Faroe_Islands,FO,1,0,48677,Europe,483,0
2020-10-19,Faroe_Islands,FO,2,0,48677,Europe,485,0
2020-10-20,Faroe_Islands,FO,0,0,48677,Europe,485,0
2020-10-21,Faroe_Islands,FO,3,0,48677,Europe,488,0
2020-10-22,Faroe_Islands,FO,0,0,48677,Europe,488,0
2020-10-23,Faroe_Islands,FO,2,0,48677,Europe,490,0
2020-10-24,Faroe_Islands,FO,0,0,48677,Europe,490,0
2020-10-25,Faroe_Islands,FO,0,0,48677,Europe,490,0
2020-10-26,Faroe_Islands,FO,0,0,48677,Europe,490,0
2020-10-27,Faroe_Islands,FO,0,0,48677,Europe,490,0
2020-10-28,Faroe_Islands,FO,4,0,48677,Europe,494,0
2020-10-29,Faroe_Islands,FO,0,0,48677,Europe,494,0
2020-10-30,Faroe_Islands,FO,0,0,48677,Europe,494,0
2020-10-31,Faroe_Islands,FO,0,0,48677,Europe,494,0
2020-11-01,Faroe_Islands,FO,1,0,48677,Europe,495,0
2020-11-02,Faroe_Islands,FO,0,0,48677,Europe,495,0
2020-11-03,Faroe_Islands,FO,0,0,48677,Europe,495,0
2020-11-04,Faroe_Islands,FO,0,0,48677,Europe,495,0
2020-11-05,Faroe_Islands,FO,0,0,48677,Europe,495,0
2020-11-06,Faroe_Islands,FO,0,0,48677,Europe,495,0
2020-11-07,Faroe_Islands,FO,0,0,48677,Europe,495,0
2020-11-08,Faroe_Islands,FO,0,0,48677,Europe,495,0
2020-11-09,Faroe_Islands,FO,2,0,48677,Europe,497,0
2020-11-10,Faroe_Islands,FO,0,0,48677,Europe,497,0
2020-11-11,Faroe_Islands,FO,0,0,48677,Europe,497,0
2020-11-12,Faroe_Islands,FO,0,0,48677,Europe,497,0
2020-11-13,Faroe_Islands,FO,0,0,48677,Europe,497,0
2020-11-14,Faroe_Islands,FO,0,0,48677,Europe,497,0
2020-11-15,Faroe_Islands,FO,0,0,48677,Europe,497,0
2020-11-16,Faroe_Islands,FO,1,0,48677,Europe,498,0
2020-11-17,Faroe_Islands,FO,0,0,48677,Europe,498,0
2020-11-18,Faroe_Islands,FO,0,0,48677,Europe,498,0
2020-11-19,Faroe_Islands,FO,0,0,48677,Europe,498,0
2020-11-20,Faroe_Islands,FO,0,0,48677,Europe,498,0
2020-11-21,Faroe_Islands,FO,0,0,48677,Europe,498,0
2020-11-22,Faroe_Islands,FO,1,0,48677,Europe,499,0
2020-11-23,Faroe_Islands,FO,1,0,48677,Europe,500,0
2020-11-24,Faroe_Islands,FO,0,0,48677,Europe,500,0
2020-11-25,Faroe_Islands,FO,0,0,48677,Europe,500,0
2020-11-26,Faroe_Islands,FO,0,0,48677,Europe,500,0
2020-11-27,Faroe_Islands,FO,0,0,48677,Europe,500,0
2020-11-28,Faroe_Islands,FO,0,0,48677,Europe,500,0
2020-11-29,Faroe_Islands,FO,2,0,48677,Europe,502,0
2020-11-30,Faroe_Islands,FO,0,0,48677,Europe,502,0
2020-12-01,Faroe_Islands,FO,1,0,48677,Europe,503,0
2020-12-02,Faroe_Islands,FO,0,0,48677,Europe,503,0
2020-12-03,Faroe_Islands,FO,0,0,48677,Europe,503,0
2020-12-04,Faroe_Islands,FO,2,0,48677,Europe,505,0
2020-12-05,Faroe_Islands,FO,0,0,48677,Europe,505,0
2020-12-06,Faroe_Islands,FO,1,0,48677,Europe,506,0
2020-12-07,Faroe_Islands,FO,4,0,48677,Europe,510,0
2020-12-08,Faroe_Islands,FO,0,0,48677,Europe,510,0
2020-12-09,Faroe_Islands,FO,4,0,48677,Europe,514,0
2020-12-10,Faroe_Islands,FO,5,0,48677,Europe,519,0
2020-12-11,Faroe_Islands,FO,0,0,48677,Europe,519,0
2020-12-12,Faroe_Islands,FO,1,0,48677,Europe,520,0
2020-12-13,Faroe_Islands,FO,5,0,48677,Europe,525,0
2020-12-14,Faroe_Islands,FO,3,0,48677,Europe,528,0
2019-12-31,France,FR,0,0,67012883,Europe,0,0
2020-01-01,France,FR,0,0,67012883,Europe,0,0
2020-01-02,France,FR,0,0,67012883,Europe,0,0
2020-01-03,France,FR,0,0,67012883,Europe,0,0
2020-01-04,France,FR,0,0,67012883,Europe,0,0
2020-01-05,France,FR,0,0,67012883,Europe,0,0
2020-01-06,France,FR,0,0,67012883,Europe,0,0
2020-01-07,France,FR,0,0,67012883,Europe,0,0
2020-01-08,France,FR,0,0,67012883,Europe,0,0
2020-01-09,France,FR,0,0,67012883,Europe,0,0
2020-01-10,France,FR,0,0,67012883,Europe,0,0
2020-01-11,France,FR,0,0,67012883,Europe,0,0
2020-01-12,France,FR,0,0,67012883,Europe,0,0
2020-01-13,France,FR,0,0,67012883,Europe,0,0
2020-01-14,France,FR,0,0,67012883,Europe,0,0
2020-01-15,France,FR,0,0,67012883,Europe,0,0
2020-01-16,France,FR,0,0,67012883,Europe,0,0
2020-01-17,France,FR,0,0,67012883,Europe,0,0
2020-01-18,France,FR,0,0,67012883,Europe,0,0
2020-01-19,France,FR,0,0,67012883,Europe,0,0
2020-01-20,France,FR,0,0,67012883,Europe,0,0
2020-01-21,France,FR,0,0,67012883,Europe,0,0
2020-01-22,France,FR,0,0,67012883,Europe,0,0
2020-01-23,France,FR,0,0,67012883,Europe,0,0
2020-01-24,France,FR,0,0,67012883,Europe,0,0
2020-01-25,France,FR,3,0,67012883,Europe,3,0
2020-01-26,France,FR,0,0,67012883,Europe,3,0
2020-01-27,France,FR,0,0,67012883,Europe,3,0
2020-01-28,France,FR,0,0,67012883,Europe,3,0
2020-01-29,France,FR,1,0,67012883,Europe,4,0
2020-01-30,France,FR,1,0,67012883,Europe,5,0
2020-01-31,France,FR,1,0,67012883,Europe,6,0
2020-02-01,France,FR,0,0,67012883,Europe,6,0
2020-02-02,France,FR,0,0,67012883,Europe,6,0
2020-02-03,France,FR,0,0,67012883,Europe,6,0
2020-02-04,France,FR,0,0,67012883,Europe,6,0
2020-02-05,France,FR,0,0,67012883,Europe,6,0
2020-02-06,France,FR,0,0,67012883,Europe,6,0
2020-02-07,France,FR,0,0,67012883,Europe,6,0
2020-02-08,France,FR,5,0,67012883,Europe,11,0
2020-02-09,France,FR,0,0,67012883,Europe,11,0
2020-02-10,France,FR,0,0,67012883,Europe,11,0
2020-02-11,France,FR,0,0,67012883,Europe,11,0
2020-02-12,France,FR,0,0,67012883,Europe,11,0
2020-02-13,France,FR,0,0,67012883,Europe,11,0
2020-02-14,France,FR,0,0,67012883,Europe,11,0
2020-02-15,France,FR,0,1,67012883,Europe,11,1
2020-02-16,France,FR,0,0,67012883,Europe,11,1
2020-02-17,France,FR,1,0,67012883,Europe,12,1
2020-02-18,France,FR,0,0,67012883,Europe,12,1
2020-02-19,France,FR,0,0,67012883,Europe,12,1
2020-02-20,France,FR,0,0,67012883,Europe,12,1
2020-02-21,France,FR,0,0,67012883,Europe,12,1
2020-02-22,France,FR,0,0,67012883,Europe,12,1
2020-02-23,France,FR,0,0,67012883,Europe,12,1
2020-02-24,France,FR,0,0,67012883,Europe,12,1
2020-02-25,France,FR,0,0,67012883,Europe,12,1
2020-02-26,France,FR,2,0,67012883,Europe,14,1
2020-02-27,France,FR,3,1,67012883,Europe,17,2
2020-02-28,France,FR,21,0,67012883,Europe,38,2
2020-02-29,France,FR,19,0,67012883,Europe,57,2
2020-03-01,France,FR,43,0,67012883,Europe,100,2
2020-03-02,France,FR,30,0,67012883,Europe,130,2
2020-03-03,France,FR,48,1,67012883,Europe,178,3
2020-03-04,France,FR,34,1,67012883,Europe,212,4
2020-03-05,France,FR,73,0,67012883,Europe,285,4
2020-03-06,France,FR,138,3,67012883,Europe,423,7
2020-03-07,France,FR,190,2,67012883,Europe,613,9
2020-03-08,France,FR,103,1,67012883,Europe,716,10
2020-03-09,France,FR,410,9,67012883,Europe,1126,19
2020-03-10,France,FR,286,11,67012883,Europe,1412,30
2020-03-11,France,FR,372,3,67012883,Europe,1784,33
2020-03-12,France,FR,497,15,67012883,Europe,2281,48
2020-03-13,France,FR,595,13,67012883,Europe,2876,61
2020-03-14,France,FR,785,18,67012883,Europe,3661,79
2020-03-15,France,FR,838,12,67012883,Europe,4499,91
2020-03-16,France,FR,924,36,67012883,Europe,5423,127
2020-03-17,France,FR,1210,21,67012883,Europe,6633,148
2020-03-18,France,FR,1097,27,67012883,Europe,7730,175
2020-03-19,France,FR,1404,69,67012883,Europe,9134,244
2020-03-20,France,FR,1861,128,67012883,Europe,10995,372
2020-03-21,France,FR,1617,78,67012883,Europe,12612,450
2020-03-22,France,FR,1847,112,67012883,Europe,14459,562
2020-03-23,France,FR,1559,112,67012883,Europe,16018,674
2020-03-24,France,FR,3838,186,67012883,Europe,19856,860
2020-03-25,France,FR,2446,240,67012883,Europe,22302,1100
2020-03-26,France,FR,2931,231,67012883,Europe,25233,1331
2020-03-27,France,FR,3922,365,67012883,Europe,29155,1696
2020-03-28,France,FR,3809,299,67012883,Europe,32964,1995
2020-03-29,France,FR,4611,319,67012883,Europe,37575,2314
2020-03-30,France,FR,2599,292,67012883,Europe,40174,2606
2020-03-31,France,FR,4376,418,67012883,Europe,44550,3024
2020-04-01,France,FR,7578,499,67012883,Europe,52128,3523
2020-04-02,France,FR,4861,509,67012883,Europe,56989,4032
2020-04-03,France,FR,2116,471,67012883,Europe,59105,4503
2020-04-04,France,FR,5233,2004,67012883,Europe,64338,6507
2020-04-05,France,FR,4267,1053,67012883,Europe,68605,7560
2020-04-06,France,FR,1873,518,67012883,Europe,70478,8078
2020-04-07,France,FR,3912,833,67012883,Europe,74390,8911
2020-04-08,France,FR,3777,1417,67012883,Europe,78167,10328
2020-04-09,France,FR,3881,541,67012883,Europe,82048,10869
2020-04-10,France,FR,4286,1341,67012883,Europe,86334,12210
2020-04-11,France,FR,4342,987,67012883,Europe,90676,13197
2020-04-12,France,FR,3114,635,67012883,Europe,93790,13832
2020-04-13,France,FR,1613,561,67012883,Europe,95403,14393
2020-04-14,France,FR,2673,574,67012883,Europe,98076,14967
2020-04-15,France,FR,5497,762,67012883,Europe,103573,15729
2020-04-16,France,FR,2633,1438,67012883,Europe,106206,17167
2020-04-17,France,FR,2641,753,67012883,Europe,108847,17920
2020-04-18,France,FR,405,761,67012883,Europe,109252,18681
2020-04-19,France,FR,2569,642,67012883,Europe,111821,19323
2020-04-20,France,FR,785,395,67012883,Europe,112606,19718
2020-04-21,France,FR,2051,547,67012883,Europe,114657,20265
2020-04-22,France,FR,2667,531,67012883,Europe,117324,20796
2020-04-23,France,FR,1827,544,67012883,Europe,119151,21340
2020-04-24,France,FR,1653,516,67012883,Europe,120804,21856
2020-04-25,France,FR,1773,389,67012883,Europe,122577,22245
2020-04-26,France,FR,1537,369,67012883,Europe,124114,22614
2020-04-27,France,FR,461,242,67012883,Europe,124575,22856
2020-04-28,France,FR,1195,437,67012883,Europe,125770,23293
2020-04-29,France,FR,1065,367,67012883,Europe,126835,23660
2020-04-30,France,FR,1607,427,67012883,Europe,128442,24087
2020-05-01,France,FR,1139,289,67012883,Europe,129581,24376
2020-05-02,France,FR,604,218,67012883,Europe,130185,24594
2020-05-03,France,FR,794,166,67012883,Europe,130979,24760
2020-05-04,France,FR,308,135,67012883,Europe,131287,24895
2020-05-05,France,FR,576,306,67012883,Europe,131863,25201
2020-05-06,France,FR,1104,330,67012883,Europe,132967,25531
2020-05-07,France,FR,4183,278,67012883,Europe,137150,25809
2020-05-08,France,FR,629,178,67012883,Europe,137779,25987
2020-05-09,France,FR,642,243,67012883,Europe,138421,26230
2020-05-10,France,FR,433,80,67012883,Europe,138854,26310
2020-05-11,France,FR,209,70,67012883,Europe,139063,26380
2020-05-12,France,FR,456,263,67012883,Europe,139519,26643
2020-05-13,France,FR,708,348,67012883,Europe,140227,26991
2020-05-14,France,FR,507,83,67012883,Europe,140734,27074
2020-05-15,France,FR,622,351,67012883,Europe,141356,27425
2020-05-16,France,FR,563,130,67012883,Europe,141919,27555
2020-05-17,France,FR,372,88,67012883,Europe,142291,27643
2020-05-18,France,FR,120,68,67012883,Europe,142411,27711
2020-05-19,France,FR,492,186,67012883,Europe,142903,27897
2020-05-20,France,FR,524,125,67012883,Europe,143427,28022
2020-05-21,France,FR,418,110,67012883,Europe,143845,28132
2020-05-22,France,FR,318,83,67012883,Europe,144163,28215
2020-05-23,France,FR,403,74,67012883,Europe,144566,28289
2020-05-24,France,FR,240,43,67012883,Europe,144806,28332
2020-05-25,France,FR,115,35,67012883,Europe,144921,28367
2020-05-26,France,FR,358,65,67012883,Europe,145279,28432
2020-05-27,France,FR,276,98,67012883,Europe,145555,28530
2020-05-28,France,FR,191,66,67012883,Europe,145746,28596
2020-05-29,France,FR,3325,66,67012883,Europe,149071,28662
2020-05-30,France,FR,597,52,67012883,Europe,149668,28714
2020-05-31,France,FR,1828,57,67012883,Europe,151496,28771
2020-06-01,France,FR,257,31,67012883,Europe,151753,28802
2020-06-02,France,FR,338,31,67012883,Europe,152091,28833
2020-06-03,France,FR,-766,107,67012883,Europe,151325,28940
2020-06-04,France,FR,352,81,67012883,Europe,151677,29021
2020-06-05,France,FR,767,44,67012883,Europe,152444,29065
2020-06-06,France,FR,611,46,67012883,Europe,153055,29111
2020-06-07,France,FR,579,31,67012883,Europe,153634,29142
2020-06-08,France,FR,343,13,67012883,Europe,153977,29155
2020-06-09,France,FR,211,54,67012883,Europe,154188,29209
2020-06-10,France,FR,403,87,67012883,Europe,154591,29296
2020-06-11,France,FR,545,23,67012883,Europe,155136,29319
2020-06-12,France,FR,425,27,67012883,Europe,155561,29346
2020-06-13,France,FR,726,28,67012883,Europe,156287,29374
2020-06-14,France,FR,526,24,67012883,Europe,156813,29398
2020-06-15,France,FR,407,9,67012883,Europe,157220,29407
2020-06-16,France,FR,152,29,67012883,Europe,157372,29436
2020-06-17,France,FR,344,111,67012883,Europe,157716,29547
2020-06-18,France,FR,458,28,67012883,Europe,158174,29575
2020-06-19,France,FR,467,28,67012883,Europe,158641,29603
2020-06-20,France,FR,811,14,67012883,Europe,159452,29617
2020-06-21,France,FR,641,16,67012883,Europe,160093,29633
2020-06-22,France,FR,284,7,67012883,Europe,160377,29640
2020-06-23,France,FR,373,23,67012883,Europe,160750,29663
2020-06-24,France,FR,517,57,67012883,Europe,161267,29720
2020-06-25,France,FR,81,11,67012883,Europe,161348,29731
2020-06-26,France,FR,0,21,67012883,Europe,161348,29752
2020-06-27,France,FR,1588,26,67012883,Europe,162936,29778
2020-06-28,France,FR,0,0,67012883,Europe,162936,29778
2020-06-29,France,FR,0,0,67012883,Europe,162936,29778
2020-06-30,France,FR,1324,35,67012883,Europe,164260,29813
2020-07-01,France,FR,541,30,67012883,Europe,164801,29843
2020-07-02,France,FR,918,18,67012883,Europe,165719,29861
2020-07-03,France,FR,659,14,67012883,Europe,166378,29875
2020-07-04,France,FR,582,18,67012883,Europe,166960,29893
2020-07-05,France,FR,0,0,67012883,Europe,166960,29893
2020-07-06,France,FR,0,0,67012883,Europe,166960,29893
2020-07-07,France,FR,1375,27,67012883,Europe,168335,29920
2020-07-08,France,FR,475,13,67012883,Europe,168810,29933
2020-07-09,France,FR,663,32,67012883,Europe,169473,29965
2020-07-10,France,FR,621,14,67012883,Europe,170094,29979
2020-07-11,France,FR,658,25,67012883,Europe,170752,30004
2020-07-12,France,FR,0,0,67012883,Europe,170752,30004
2020-07-13,France,FR,0,0,67012883,Europe,170752,30004
2020-07-14,France,FR,1625,25,67012883,Europe,172377,30029
2020-07-15,France,FR,0,0,67012883,Europe,172377,30029
2020-07-16,France,FR,927,91,67012883,Europe,173304,30120
2020-07-17,France,FR,534,18,67012883,Europe,173838,30138
2020-07-18,France,FR,836,14,67012883,Europe,174674,30152
2020-07-19,France,FR,0,0,67012883,Europe,174674,30152
2020-07-20,France,FR,0,0,67012883,Europe,174674,30152
2020-07-21,France,FR,2080,13,67012883,Europe,176754,30165
2020-07-22,France,FR,584,0,67012883,Europe,177338,30165
2020-07-23,France,FR,998,7,67012883,Europe,178336,30172
2020-07-24,France,FR,1062,10,67012883,Europe,179398,30182
2020-07-25,France,FR,1130,10,67012883,Europe,180528,30192
2020-07-26,France,FR,0,0,67012883,Europe,180528,30192
2020-07-27,France,FR,0,0,67012883,Europe,180528,30192
2020-07-28,France,FR,2551,17,67012883,Europe,183079,30209
2020-07-29,France,FR,725,14,67012883,Europe,183804,30223
2020-07-30,France,FR,1392,15,67012883,Europe,185196,30238
2020-07-31,France,FR,1377,16,67012883,Europe,186573,30254
2020-08-01,France,FR,1346,11,67012883,Europe,187919,30265
2020-08-02,France,FR,0,0,67012883,Europe,187919,30265
2020-08-03,France,FR,0,0,67012883,Europe,187919,30265
2020-08-04,France,FR,3376,29,67012883,Europe,191295,30294
2020-08-05,France,FR,1039,2,67012883,Europe,192334,30296
2020-08-06,France,FR,1695,9,67012883,Europe,194029,30305
2020-08-07,France,FR,1604,7,67012883,Europe,195633,30312
2020-08-08,France,FR,2288,12,67012883,Europe,197921,30324
2020-08-09,France,FR,0,0,67012883,Europe,197921,30324
2020-08-10,France,FR,0,0,67012883,Europe,197921,30324
2020-08-11,France,FR,4854,16,67012883,Europe,202775,30340
2020-08-12,France,FR,1397,14,67012883,Europe,204172,30354
2020-08-13,France,FR,2524,17,67012883,Europe,206696,30371
2020-08-14,France,FR,2669,17,67012883,Europe,209365,30388
2020-08-15,France,FR,2846,18,67012883,Europe,212211,30406
2020-08-16,France,FR,3310,3,67012883,Europe,215521,30409
2020-08-17,France,FR,3015,1,67012883,Europe,218536,30410
2020-08-18,France,FR,493,19,67012883,Europe,219029,30429
2020-08-19,France,FR,2238,22,67012883,Europe,221267,30451
2020-08-20,France,FR,3776,17,67012883,Europe,225043,30468
2020-08-21,France,FR,4771,12,67012883,Europe,229814,30480
2020-08-22,France,FR,4586,23,67012883,Europe,234400,30503
2020-08-23,France,FR,3602,9,67012883,Europe,238002,30512
2020-08-24,France,FR,4897,1,67012883,Europe,242899,30513
2020-08-25,France,FR,1955,15,67012883,Europe,244854,30528
2020-08-26,France,FR,3304,16,67012883,Europe,248158,30544
2020-08-27,France,FR,5429,0,67012883,Europe,253587,30544
2020-08-28,France,FR,6111,32,67012883,Europe,259698,30576
2020-08-29,France,FR,7379,20,67012883,Europe,267077,30596
2020-08-30,France,FR,5453,6,67012883,Europe,272530,30602
2020-08-31,France,FR,5413,4,67012883,Europe,277943,30606
2020-09-01,France,FR,3082,29,67012883,Europe,281025,30635
2020-09-02,France,FR,4982,26,67012883,Europe,286007,30661
2020-09-03,France,FR,7017,25,67012883,Europe,293024,30686
2020-09-04,France,FR,7157,0,67012883,Europe,300181,30686
2020-09-05,France,FR,8975,0,67012883,Europe,309156,30686
2020-09-06,France,FR,8550,12,67012883,Europe,317706,30698
2020-09-07,France,FR,7071,3,67012883,Europe,324777,30701
2020-09-08,France,FR,4203,25,67012883,Europe,328980,30726
2020-09-09,France,FR,6544,38,67012883,Europe,335524,30764
2020-09-10,France,FR,8577,30,67012883,Europe,344101,30794
2020-09-11,France,FR,9843,19,67012883,Europe,353944,30813
2020-09-12,France,FR,9406,80,67012883,Europe,363350,30893
2020-09-13,France,FR,10561,17,67012883,Europe,373911,30910
2020-09-14,France,FR,7183,6,67012883,Europe,381094,30916
2020-09-15,France,FR,6158,34,67012883,Europe,387252,30950
2020-09-16,France,FR,7852,49,67012883,Europe,395104,30999
2020-09-17,France,FR,9784,46,67012883,Europe,404888,31045
2020-09-18,France,FR,10593,50,67012883,Europe,415481,31095
2020-09-19,France,FR,13215,154,67012883,Europe,428696,31249
2020-09-20,France,FR,13498,25,67012883,Europe,442194,31274
2020-09-21,France,FR,11569,11,67012883,Europe,453763,31285
2020-09-22,France,FR,4298,53,67012883,Europe,458061,31338
2020-09-23,France,FR,10008,78,67012883,Europe,468069,31416
2020-09-24,France,FR,13072,43,67012883,Europe,481141,31459
2020-09-25,France,FR,16096,52,67012883,Europe,497237,31511
2020-09-26,France,FR,15797,150,67012883,Europe,513034,31661
2020-09-27,France,FR,14412,39,67012883,Europe,527446,31700
2020-09-28,France,FR,11123,27,67012883,Europe,538569,31727
2020-09-29,France,FR,4070,81,67012883,Europe,542639,31808
2020-09-30,France,FR,8051,85,67012883,Europe,550690,31893
2020-10-01,France,FR,12845,63,67012883,Europe,563535,31956
2020-10-02,France,FR,13970,63,67012883,Europe,577505,32019
2020-10-03,France,FR,12148,136,67012883,Europe,589653,32155
2020-10-04,France,FR,16972,43,67012883,Europe,606625,32198
2020-10-05,France,FR,12545,32,67012883,Europe,619170,32230
2020-10-06,France,FR,5104,69,67012883,Europe,624274,32299
2020-10-07,France,FR,10489,66,67012883,Europe,634763,32365
2020-10-08,France,FR,18746,80,67012883,Europe,653509,32445
2020-10-09,France,FR,18129,76,67012883,Europe,671638,32521
2020-10-10,France,FR,20339,109,67012883,Europe,691977,32630
2020-10-11,France,FR,26896,54,67012883,Europe,718873,32684
2020-10-12,France,FR,16101,46,67012883,Europe,734974,32730
2020-10-13,France,FR,8505,95,67012883,Europe,743479,32825
2020-10-14,France,FR,12993,108,67012883,Europe,756472,32933
2020-10-15,France,FR,22591,104,67012883,Europe,779063,33037
2020-10-16,France,FR,30621,88,67012883,Europe,809684,33125
2020-10-17,France,FR,25086,178,67012883,Europe,834770,33303
2020-10-18,France,FR,32427,89,67012883,Europe,867197,33392
2020-10-19,France,FR,29837,85,67012883,Europe,897034,33477
2020-10-20,France,FR,13243,146,67012883,Europe,910277,33623
2020-10-21,France,FR,20468,262,67012883,Europe,930745,33885
2020-10-22,France,FR,26676,163,67012883,Europe,957421,34048
2020-10-23,France,FR,41622,162,67012883,Europe,999043,34210
2020-10-24,France,FR,42032,298,67012883,Europe,1041075,34508
2020-10-25,France,FR,45422,137,67012883,Europe,1086497,34645
2020-10-26,France,FR,52010,116,67012883,Europe,1138507,34761
2020-10-27,France,FR,26771,257,67012883,Europe,1165278,35018
2020-10-28,France,FR,33417,523,67012883,Europe,1198695,35541
2020-10-29,France,FR,36437,244,67012883,Europe,1235132,35785
2020-10-30,France,FR,47637,235,67012883,Europe,1282769,36020
2020-10-31,France,FR,49215,545,67012883,Europe,1331984,36565
2020-11-01,France,FR,32641,223,67012883,Europe,1364625,36788
2020-11-02,France,FR,49290,231,67012883,Europe,1413915,37019
2020-11-03,France,FR,52518,416,67012883,Europe,1466433,37435
2020-11-04,France,FR,36330,854,67012883,Europe,1502763,38289
2020-11-05,France,FR,40558,385,67012883,Europe,1543321,38674
2020-11-06,France,FR,58046,363,67012883,Europe,1601367,39037
2020-11-07,France,FR,60486,828,67012883,Europe,1661853,39865
2020-11-08,France,FR,86852,304,67012883,Europe,1748705,40169
2020-11-09,France,FR,38619,270,67012883,Europe,1787324,40439
2020-11-10,France,FR,20155,548,67012883,Europe,1807479,40987
2020-11-11,France,FR,22180,1220,67012883,Europe,1829659,42207
2020-11-12,France,FR,35879,328,67012883,Europe,1865538,42535
2020-11-13,France,FR,33172,425,67012883,Europe,1898710,42960
2020-11-14,France,FR,23794,932,67012883,Europe,1922504,43892
2020-11-15,France,FR,32095,354,67012883,Europe,1954599,44246
2020-11-16,France,FR,27228,302,67012883,Europe,1981827,44548
2020-11-17,France,FR,9406,506,67012883,Europe,1991233,45054
2020-11-18,France,FR,45522,1219,67012883,Europe,2036755,46273
2020-11-19,France,FR,28383,425,67012883,Europe,2065138,46698
2020-11-20,France,FR,21150,429,67012883,Europe,2086288,47127
2020-11-21,France,FR,22882,1138,67012883,Europe,2109170,48265
2020-11-22,France,FR,17881,253,67012883,Europe,2127051,48518
2020-11-23,France,FR,13157,214,67012883,Europe,2140208,48732
2020-11-24,France,FR,4452,500,67012883,Europe,2144660,49232
2020-11-25,France,FR,9155,1005,67012883,Europe,2153815,50237
2020-11-26,France,FR,16282,381,67012883,Europe,2170097,50618
2020-11-27,France,FR,13563,339,67012883,Europe,2183660,50957
2020-11-28,France,FR,12539,957,67012883,Europe,2196199,51914
2020-11-29,France,FR,12500,213,67012883,Europe,2208699,52127
2020-11-30,France,FR,9784,198,67012883,Europe,2218483,52325
2020-12-01,France,FR,4005,406,67012883,Europe,2222488,52731
2020-12-02,France,FR,8083,775,67012883,Europe,2230571,53506
2020-12-03,France,FR,14064,310,67012883,Europe,2244635,53816
2020-12-04,France,FR,12696,324,67012883,Europe,2257331,54140
2020-12-05,France,FR,11221,627,67012883,Europe,2268552,54767
2020-12-06,France,FR,12923,214,67012883,Europe,2281475,54981
2020-12-07,France,FR,11022,174,67012883,Europe,2292497,55155
2020-12-08,France,FR,3411,366,67012883,Europe,2295908,55521
2020-12-09,France,FR,13713,831,67012883,Europe,2309621,56352
2020-12-10,France,FR,14595,296,67012883,Europe,2324216,56648
2020-12-11,France,FR,13750,292,67012883,Europe,2337966,56940
2020-12-12,France,FR,13406,627,67012883,Europe,2351372,57567
2020-12-13,France,FR,13947,194,67012883,Europe,2365319,57761
2020-12-14,France,FR,11533,150,67012883,Europe,2376852,57911
2020-03-13,Gabon,GA,1,0,2172578,Africa,1,0
2020-03-15,Gabon,GA,0,0,2172578,Africa,1,0
2020-03-16,Gabon,GA,0,0,2172578,Africa,1,0
2020-03-17,Gabon,GA,0,0,2172578,Africa,1,0
2020-03-18,Gabon,GA,0,0,2172578,Africa,1,0
2020-03-19,Gabon,GA,2,0,2172578,Africa,3,0
2020-03-20,Gabon,GA,0,0,2172578,Africa,3,0
2020-03-21,Gabon,GA,0,1,2172578,Africa,3,1
2020-03-22,Gabon,GA,0,0,2172578,Africa,3,1
2020-03-23,Gabon,GA,3,0,2172578,Africa,6,1
2020-03-24,Gabon,GA,0,0,2172578,Africa,6,1
2020-03-25,Gabon,GA,0,0,2172578,Africa,6,1
2020-03-26,Gabon,GA,0,0,2172578,Africa,6,1
2020-03-27,Gabon,GA,1,0,2172578,Africa,7,1
2020-03-28,Gabon,GA,0,0,2172578,Africa,7,1
2020-03-29,Gabon,GA,0,0,2172578,Africa,7,1
2020-03-30,Gabon,GA,0,0,2172578,Africa,7,1
2020-03-31,Gabon,GA,0,0,2172578,Africa,7,1
2020-04-01,Gabon,GA,9,0,2172578,Africa,16,1
2020-04-02,Gabon,GA,2,0,2172578,Africa,18,1
2020-04-03,Gabon,GA,0,0,2172578,Africa,18,1
2020-04-04,Gabon,GA,3,0,2172578,Africa,21,1
2020-04-05,Gabon,GA,0,0,2172578,Africa,21,1
2020-04-06,Gabon,GA,0,0,2172578,Africa,21,1
2020-04-07,Gabon,GA,0,0,2172578,Africa,21,1
2020-04-08,Gabon,GA,9,0,2172578,Africa,30,1
2020-04-09,Gabon,GA,3,0,2172578,Africa,33,1
2020-04-10,Gabon,GA,11,0,2172578,Africa,44,1
2020-04-11,Gabon,GA,2,0,2172578,Africa,46,1
2020-04-12,Gabon,GA,3,0,2172578,Africa,49,1
2020-04-13,Gabon,GA,8,0,2172578,Africa,57,1
2020-04-14,Gabon,GA,0,0,2172578,Africa,57,1
2020-04-15,Gabon,GA,18,0,2172578,Africa,75,1
2020-04-16,Gabon,GA,12,0,2172578,Africa,87,1
2020-04-17,Gabon,GA,8,0,2172578,Africa,95,1
2020-04-18,Gabon,GA,13,0,2172578,Africa,108,1
2020-04-19,Gabon,GA,1,0,2172578,Africa,109,1
2020-04-20,Gabon,GA,0,0,2172578,Africa,109,1
2020-04-21,Gabon,GA,11,0,2172578,Africa,120,1
2020-04-22,Gabon,GA,36,0,2172578,Africa,156,1
2020-04-23,Gabon,GA,10,0,2172578,Africa,166,1
2020-04-24,Gabon,GA,1,1,2172578,Africa,167,2
2020-04-25,Gabon,GA,5,1,2172578,Africa,172,3
2020-04-26,Gabon,GA,4,0,2172578,Africa,176,3
2020-04-27,Gabon,GA,0,0,2172578,Africa,176,3
2020-04-28,Gabon,GA,35,0,2172578,Africa,211,3
2020-04-29,Gabon,GA,27,0,2172578,Africa,238,3
2020-04-30,Gabon,GA,38,0,2172578,Africa,276,3
2020-05-01,Gabon,GA,0,0,2172578,Africa,276,3
2020-05-02,Gabon,GA,32,1,2172578,Africa,308,4
2020-05-03,Gabon,GA,27,1,2172578,Africa,335,5
2020-05-04,Gabon,GA,0,0,2172578,Africa,335,5
2020-05-05,Gabon,GA,32,1,2172578,Africa,367,6
2020-05-06,Gabon,GA,30,0,2172578,Africa,397,6
2020-05-07,Gabon,GA,42,2,2172578,Africa,439,8
2020-05-08,Gabon,GA,65,0,2172578,Africa,504,8
2020-05-09,Gabon,GA,116,0,2172578,Africa,620,8
2020-05-10,Gabon,GA,41,0,2172578,Africa,661,8
2020-05-11,Gabon,GA,0,0,2172578,Africa,661,8
2020-05-12,Gabon,GA,141,1,2172578,Africa,802,9
2020-05-13,Gabon,GA,61,0,2172578,Africa,863,9
2020-05-14,Gabon,GA,141,0,2172578,Africa,1004,9
2020-05-15,Gabon,GA,100,1,2172578,Africa,1104,10
2020-05-16,Gabon,GA,105,0,2172578,Africa,1209,10
2020-05-17,Gabon,GA,111,1,2172578,Africa,1320,11
2020-05-18,Gabon,GA,0,0,2172578,Africa,1320,11
2020-05-19,Gabon,GA,112,0,2172578,Africa,1432,11
2020-05-20,Gabon,GA,70,1,2172578,Africa,1502,12
2020-05-21,Gabon,GA,65,0,2172578,Africa,1567,12
2020-05-22,Gabon,GA,0,0,2172578,Africa,1567,12
2020-05-23,Gabon,GA,161,0,2172578,Africa,1728,12
2020-05-24,Gabon,GA,206,0,2172578,Africa,1934,12
2020-05-25,Gabon,GA,0,0,2172578,Africa,1934,12
2020-05-26,Gabon,GA,201,2,2172578,Africa,2135,14
2020-05-27,Gabon,GA,103,0,2172578,Africa,2238,14
2020-05-28,Gabon,GA,81,0,2172578,Africa,2319,14
2020-05-29,Gabon,GA,112,0,2172578,Africa,2431,14
2020-05-30,Gabon,GA,182,1,2172578,Africa,2613,15
2020-05-31,Gabon,GA,42,2,2172578,Africa,2655,17
2020-06-01,Gabon,GA,0,0,2172578,Africa,2655,17
2020-06-02,Gabon,GA,0,0,2172578,Africa,2655,17
2020-06-03,Gabon,GA,148,3,2172578,Africa,2803,20
2020-06-04,Gabon,GA,99,0,2172578,Africa,2902,20
2020-06-05,Gabon,GA,53,1,2172578,Africa,2955,21
2020-06-06,Gabon,GA,146,0,2172578,Africa,3101,21
2020-06-07,Gabon,GA,0,0,2172578,Africa,3101,21
2020-06-08,Gabon,GA,0,0,2172578,Africa,3101,21
2020-06-09,Gabon,GA,146,0,2172578,Africa,3247,21
2020-06-10,Gabon,GA,47,0,2172578,Africa,3294,21
2020-06-11,Gabon,GA,81,1,2172578,Africa,3375,22
2020-06-12,Gabon,GA,88,1,2172578,Africa,3463,23
2020-06-13,Gabon,GA,0,0,2172578,Africa,3463,23
2020-06-14,Gabon,GA,0,0,2172578,Africa,3463,23
2020-06-15,Gabon,GA,0,0,2172578,Africa,3463,23
2020-06-16,Gabon,GA,570,4,2172578,Africa,4033,27
2020-06-17,Gabon,GA,81,2,2172578,Africa,4114,29
2020-06-18,Gabon,GA,115,1,2172578,Africa,4229,30
2020-06-19,Gabon,GA,111,2,2172578,Africa,4340,32
2020-06-20,Gabon,GA,88,2,2172578,Africa,4428,34
2020-06-21,Gabon,GA,0,0,2172578,Africa,4428,34
2020-06-22,Gabon,GA,0,0,2172578,Africa,4428,34
2020-06-23,Gabon,GA,311,5,2172578,Africa,4739,39
2020-06-24,Gabon,GA,134,0,2172578,Africa,4873,39
2020-06-25,Gabon,GA,83,0,2172578,Africa,4956,39
2020-06-26,Gabon,GA,131,1,2172578,Africa,5087,40
2020-06-27,Gabon,GA,122,0,2172578,Africa,5209,40
2020-06-28,Gabon,GA,0,0,2172578,Africa,5209,40
2020-06-29,Gabon,GA,0,0,2172578,Africa,5209,40
2020-06-30,Gabon,GA,185,2,2172578,Africa,5394,42
2020-07-01,Gabon,GA,0,0,2172578,Africa,5394,42
2020-07-02,Gabon,GA,119,0,2172578,Africa,5513,42
2020-07-03,Gabon,GA,0,0,2172578,Africa,5513,42
2020-07-04,Gabon,GA,107,2,2172578,Africa,5620,44
2020-07-05,Gabon,GA,0,0,2172578,Africa,5620,44
2020-07-06,Gabon,GA,0,0,2172578,Africa,5620,44
2020-07-07,Gabon,GA,123,2,2172578,Africa,5743,46
2020-07-08,Gabon,GA,0,0,2172578,Africa,5743,46
2020-07-09,Gabon,GA,128,0,2172578,Africa,5871,46
2020-07-10,Gabon,GA,0,0,2172578,Africa,5871,46
2020-07-11,Gabon,GA,71,0,2172578,Africa,5942,46
2020-07-12,Gabon,GA,0,0,2172578,Africa,5942,46
2020-07-13,Gabon,GA,0,0,2172578,Africa,5942,46
2020-07-14,Gabon,GA,84,0,2172578,Africa,6026,46
2020-07-15,Gabon,GA,0,0,2172578,Africa,6026,46
2020-07-16,Gabon,GA,95,0,2172578,Africa,6121,46
2020-07-17,Gabon,GA,0,0,2172578,Africa,6121,46
2020-07-18,Gabon,GA,194,0,2172578,Africa,6315,46
2020-07-19,Gabon,GA,0,0,2172578,Africa,6315,46
2020-07-20,Gabon,GA,0,0,2172578,Africa,6315,46
2020-07-21,Gabon,GA,118,0,2172578,Africa,6433,46
2020-07-22,Gabon,GA,0,0,2172578,Africa,6433,46
2020-07-23,Gabon,GA,155,1,2172578,Africa,6588,47
2020-07-24,Gabon,GA,0,0,2172578,Africa,6588,47
2020-07-25,Gabon,GA,396,2,2172578,Africa,6984,49
2020-07-26,Gabon,GA,0,0,2172578,Africa,6984,49
2020-07-27,Gabon,GA,0,0,2172578,Africa,6984,49
2020-07-28,Gabon,GA,205,0,2172578,Africa,7189,49
2020-07-29,Gabon,GA,0,0,2172578,Africa,7189,49
2020-07-30,Gabon,GA,163,0,2172578,Africa,7352,49
2020-07-31,Gabon,GA,0,0,2172578,Africa,7352,49
2020-08-01,Gabon,GA,0,0,2172578,Africa,7352,49
2020-08-02,Gabon,GA,179,1,2172578,Africa,7531,50
2020-08-03,Gabon,GA,0,0,2172578,Africa,7531,50
2020-08-04,Gabon,GA,115,1,2172578,Africa,7646,51
2020-08-05,Gabon,GA,0,0,2172578,Africa,7646,51
2020-08-06,Gabon,GA,141,0,2172578,Africa,7787,51
2020-08-07,Gabon,GA,0,0,2172578,Africa,7787,51
2020-08-08,Gabon,GA,136,0,2172578,Africa,7923,51
2020-08-09,Gabon,GA,0,0,2172578,Africa,7923,51
2020-08-10,Gabon,GA,0,0,2172578,Africa,7923,51
2020-08-11,Gabon,GA,83,0,2172578,Africa,8006,51
2020-08-12,Gabon,GA,0,0,2172578,Africa,8006,51
2020-08-13,Gabon,GA,71,0,2172578,Africa,8077,51
2020-08-14,Gabon,GA,0,0,2172578,Africa,8077,51
2020-08-15,Gabon,GA,148,0,2172578,Africa,8225,51
2020-08-16,Gabon,GA,0,0,2172578,Africa,8225,51
2020-08-17,Gabon,GA,0,0,2172578,Africa,8225,51
2020-08-18,Gabon,GA,45,2,2172578,Africa,8270,53
2020-08-19,Gabon,GA,0,0,2172578,Africa,8270,53
2020-08-20,Gabon,GA,49,0,2172578,Africa,8319,53
2020-08-21,Gabon,GA,0,0,2172578,Africa,8319,53
2020-08-22,Gabon,GA,69,0,2172578,Africa,8388,53
2020-08-23,Gabon,GA,0,0,2172578,Africa,8388,53
2020-08-24,Gabon,GA,0,0,2172578,Africa,8388,53
2020-08-25,Gabon,GA,21,0,2172578,Africa,8409,53
2020-08-26,Gabon,GA,0,0,2172578,Africa,8409,53
2020-08-27,Gabon,GA,59,0,2172578,Africa,8468,53
2020-08-28,Gabon,GA,0,0,2172578,Africa,8468,53
2020-08-29,Gabon,GA,37,0,2172578,Africa,8505,53
2020-08-30,Gabon,GA,0,0,2172578,Africa,8505,53
2020-08-31,Gabon,GA,0,0,2172578,Africa,8505,53
2020-09-01,Gabon,GA,28,0,2172578,Africa,8533,53
2020-09-02,Gabon,GA,0,0,2172578,Africa,8533,53
2020-09-03,Gabon,GA,5,0,2172578,Africa,8538,53
2020-09-04,Gabon,GA,0,0,2172578,Africa,8538,53
2020-09-05,Gabon,GA,63,0,2172578,Africa,8601,53
2020-09-06,Gabon,GA,0,0,2172578,Africa,8601,53
2020-09-07,Gabon,GA,0,0,2172578,Africa,8601,53
2020-09-08,Gabon,GA,7,0,2172578,Africa,8608,53
2020-09-09,Gabon,GA,0,0,2172578,Africa,8608,53
2020-09-10,Gabon,GA,13,0,2172578,Africa,8621,53
2020-09-11,Gabon,GA,0,0,2172578,Africa,8621,53
2020-09-12,Gabon,GA,22,0,2172578,Africa,8643,53
2020-09-13,Gabon,GA,0,0,2172578,Africa,8643,53
2020-09-14,Gabon,GA,0,0,2172578,Africa,8643,53
2020-09-15,Gabon,GA,11,0,2172578,Africa,8654,53
2020-09-16,Gabon,GA,0,0,2172578,Africa,8654,53
2020-09-17,Gabon,GA,24,0,2172578,Africa,8678,53
2020-09-18,Gabon,GA,0,0,2172578,Africa,8678,53
2020-09-19,Gabon,GA,18,0,2172578,Africa,8696,53
2020-09-20,Gabon,GA,0,0,2172578,Africa,8696,53
2020-09-21,Gabon,GA,0,0,2172578,Africa,8696,53
2020-09-22,Gabon,GA,8,1,2172578,Africa,8704,54
2020-09-23,Gabon,GA,0,0,2172578,Africa,8704,54
2020-09-24,Gabon,GA,12,0,2172578,Africa,8716,54
2020-09-25,Gabon,GA,0,0,2172578,Africa,8716,54
2020-09-26,Gabon,GA,12,0,2172578,Africa,8728,54
2020-09-27,Gabon,GA,0,0,2172578,Africa,8728,54
2020-09-28,Gabon,GA,0,0,2172578,Africa,8728,54
2020-09-29,Gabon,GA,24,0,2172578,Africa,8752,54
2020-09-30,Gabon,GA,0,0,2172578,Africa,8752,54
2020-10-01,Gabon,GA,14,0,2172578,Africa,8766,54
2020-10-02,Gabon,GA,0,0,2172578,Africa,8766,54
2020-10-03,Gabon,GA,31,0,2172578,Africa,8797,54
2020-10-04,Gabon,GA,0,0,2172578,Africa,8797,54
2020-10-05,Gabon,GA,0,0,2172578,Africa,8797,54
2020-10-06,Gabon,GA,11,0,2172578,Africa,8808,54
2020-10-07,Gabon,GA,0,0,2172578,Africa,8808,54
2020-10-08,Gabon,GA,7,0,2172578,Africa,8815,54
2020-10-09,Gabon,GA,0,0,2172578,Africa,8815,54
2020-10-10,Gabon,GA,20,0,2172578,Africa,8835,54
2020-10-11,Gabon,GA,0,0,2172578,Africa,8835,54
2020-10-12,Gabon,GA,0,0,2172578,Africa,8835,54
2020-10-13,Gabon,GA,25,0,2172578,Africa,8860,54
2020-10-14,Gabon,GA,0,0,2172578,Africa,8860,54
2020-10-15,Gabon,GA,9,0,2172578,Africa,8869,54
2020-10-16,Gabon,GA,0,0,2172578,Africa,8869,54
2020-10-17,Gabon,GA,12,0,2172578,Africa,8881,54
2020-10-18,Gabon,GA,0,0,2172578,Africa,8881,54
2020-10-19,Gabon,GA,0,0,2172578,Africa,8881,54
2020-10-20,Gabon,GA,3,0,2172578,Africa,8884,54
2020-10-21,Gabon,GA,0,0,2172578,Africa,8884,54
2020-10-22,Gabon,GA,17,0,2172578,Africa,8901,54
2020-10-23,Gabon,GA,0,0,2172578,Africa,8901,54
2020-10-24,Gabon,GA,18,0,2172578,Africa,8919,54
2020-10-25,Gabon,GA,0,0,2172578,Africa,8919,54
2020-10-26,Gabon,GA,0,0,2172578,Africa,8919,54
2020-10-27,Gabon,GA,18,0,2172578,Africa,8937,54
2020-10-28,Gabon,GA,0,0,2172578,Africa,8937,54
2020-10-29,Gabon,GA,20,1,2172578,Africa,8957,55
2020-10-30,Gabon,GA,0,0,2172578,Africa,8957,55
2020-10-31,Gabon,GA,11,0,2172578,Africa,8968,55
2020-11-01,Gabon,GA,0,0,2172578,Africa,8968,55
2020-11-02,Gabon,GA,0,0,2172578,Africa,8968,55
2020-11-03,Gabon,GA,16,0,2172578,Africa,8984,55
2020-11-04,Gabon,GA,0,0,2172578,Africa,8984,55
2020-11-05,Gabon,GA,21,0,2172578,Africa,9005,55
2020-11-06,Gabon,GA,0,0,2172578,Africa,9005,55
2020-11-07,Gabon,GA,17,0,2172578,Africa,9022,55
2020-11-08,Gabon,GA,0,0,2172578,Africa,9022,55
2020-11-09,Gabon,GA,0,0,2172578,Africa,9022,55
2020-11-10,Gabon,GA,7,2,2172578,Africa,9029,57
2020-11-11,Gabon,GA,0,0,2172578,Africa,9029,57
2020-11-12,Gabon,GA,19,0,2172578,Africa,9048,57
2020-11-13,Gabon,GA,0,0,2172578,Africa,9048,57
2020-11-14,Gabon,GA,14,1,2172578,Africa,9062,58
2020-11-15,Gabon,GA,0,0,2172578,Africa,9062,58
2020-11-16,Gabon,GA,0,0,2172578,Africa,9062,58
2020-11-17,Gabon,GA,22,0,2172578,Africa,9084,58
2020-11-18,Gabon,GA,0,0,2172578,Africa,9084,58
2020-11-19,Gabon,GA,0,0,2172578,Africa,9084,58
2020-11-20,Gabon,GA,32,1,2172578,Africa,9116,59
2020-11-21,Gabon,GA,15,0,2172578,Africa,9131,59
2020-11-22,Gabon,GA,0,0,2172578,Africa,9131,59
2020-11-23,Gabon,GA,0,0,2172578,Africa,9131,59
2020-11-24,Gabon,GA,19,0,2172578,Africa,9150,59
2020-11-25,Gabon,GA,0,0,2172578,Africa,9150,59
2020-11-26,Gabon,GA,23,0,2172578,Africa,9173,59
2020-11-27,Gabon,GA,0,0,2172578,Africa,9173,59
2020-11-28,Gabon,GA,18,0,2172578,Africa,9191,59
2020-11-29,Gabon,GA,0,0,2172578,Africa,9191,59
2020-11-30,Gabon,GA,0,0,2172578,Africa,9191,59
2020-12-01,Gabon,GA,23,1,2172578,Africa,9214,60
2020-12-02,Gabon,GA,0,0,2172578,Africa,9214,60
2020-12-03,Gabon,GA,25,0,2172578,Africa,9239,60
2020-12-04,Gabon,GA,0,0,2172578,Africa,9239,60
2020-12-05,Gabon,GA,15,0,2172578,Africa,9254,60
2020-12-06,Gabon,GA,0,0,2172578,Africa,9254,60
2020-12-07,Gabon,GA,0,0,2172578,Africa,9254,60
2020-12-08,Gabon,GA,24,0,2172578,Africa,9278,60
2020-12-09,Gabon,GA,0,0,2172578,Africa,9278,60
2020-12-10,Gabon,GA,22,2,2172578,Africa,9300,62
2020-12-11,Gabon,GA,0,0,2172578,Africa,9300,62
2020-12-12,Gabon,GA,30,1,2172578,Africa,9330,63
2020-12-13,Gabon,GA,0,0,2172578,Africa,9330,63
2020-12-14,Gabon,GA,0,0,2172578,Africa,9330,63
2020-03-23,Grenada,GD,1,0,112002,America,1,0
2020-03-24,Grenada,GD,0,0,112002,America,1,0
2020-03-25,Grenada,GD,0,0,112002,America,1,0
2020-03-26,Grenada,GD,0,0,112002,America,1,0
2020-03-27,Grenada,GD,6,0,112002,America,7,0
2020-03-28,Grenada,GD,0,0,112002,America,7,0
2020-03-29,Grenada,GD,2,0,112002,America,9,0
2020-03-30,Grenada,GD,0,0,112002,America,9,0
2020-03-31,Grenada,GD,0,0,112002,America,9,0
2020-04-01,Grenada,GD,0,0,112002,America,9,0
2020-04-02,Grenada,GD,1,0,112002,America,10,0
2020-04-03,Grenada,GD,0,0,112002,America,10,0
2020-04-04,Grenada,GD,2,0,112002,America,12,0
2020-04-05,Grenada,GD,0,0,112002,America,12,0
2020-04-06,Grenada,GD,0,0,112002,America,12,0
2020-04-07,Grenada,GD,0,0,112002,America,12,0
2020-04-08,Grenada,GD,0,0,112002,America,12,0
2020-04-09,Grenada,GD,0,0,112002,America,12,0
2020-04-10,Grenada,GD,0,0,112002,America,12,0
2020-04-11,Grenada,GD,2,0,112002,America,14,0
2020-04-12,Grenada,GD,0,0,112002,America,14,0
2020-04-13,Grenada,GD,0,0,112002,America,14,0
2020-04-14,Grenada,GD,0,0,112002,America,14,0
2020-04-15,Grenada,GD,0,0,112002,America,14,0
2020-04-16,Grenada,GD,0,0,112002,America,14,0
2020-04-17,Grenada,GD,0,0,112002,America,14,0
2020-04-18,Grenada,GD,0,0,112002,America,14,0
2020-04-19,Grenada,GD,0,0,112002,America,14,0
2020-04-20,Grenada,GD,0,0,112002,America,14,0
2020-04-21,Grenada,GD,0,0,112002,America,14,0
2020-04-22,Grenada,GD,0,0,112002,America,14,0
2020-04-23,Grenada,GD,1,0,112002,America,15,0
2020-04-24,Grenada,GD,0,0,112002,America,15,0
2020-04-25,Grenada,GD,0,0,112002,America,15,0
2020-04-26,Grenada,GD,3,0,112002,America,18,0
2020-04-27,Grenada,GD,0,0,112002,America,18,0
2020-04-28,Grenada,GD,0,0,112002,America,18,0
2020-04-29,Grenada,GD,0,0,112002,America,18,0
2020-04-30,Grenada,GD,2,0,112002,America,20,0
2020-05-01,Grenada,GD,0,0,112002,America,20,0
2020-05-02,Grenada,GD,0,0,112002,America,20,0
2020-05-03,Grenada,GD,1,0,112002,America,21,0
2020-05-04,Grenada,GD,0,0,112002,America,21,0
2020-05-05,Grenada,GD,0,0,112002,America,21,0
2020-05-06,Grenada,GD,0,0,112002,America,21,0
2020-05-07,Grenada,GD,0,0,112002,America,21,0
2020-05-08,Grenada,GD,0,0,112002,America,21,0
2020-05-09,Grenada,GD,0,0,112002,America,21,0
2020-05-10,Grenada,GD,0,0,112002,America,21,0
2020-05-11,Grenada,GD,0,0,112002,America,21,0
2020-05-12,Grenada,GD,0,0,112002,America,21,0
2020-05-13,Grenada,GD,0,0,112002,America,21,0
2020-05-14,Grenada,GD,0,0,112002,America,21,0
2020-05-15,Grenada,GD,0,0,112002,America,21,0
2020-05-16,Grenada,GD,1,0,112002,America,22,0
2020-05-17,Grenada,GD,0,0,112002,America,22,0
2020-05-18,Grenada,GD,0,0,112002,America,22,0
2020-05-19,Grenada,GD,0,0,112002,America,22,0
2020-05-20,Grenada,GD,0,0,112002,America,22,0
2020-05-21,Grenada,GD,0,0,112002,America,22,0
2020-05-22,Grenada,GD,0,0,112002,America,22,0
2020-05-23,Grenada,GD,0,0,112002,America,22,0
2020-05-24,Grenada,GD,0,0,112002,America,22,0
2020-05-25,Grenada,GD,0,0,112002,America,22,0
2020-05-26,Grenada,GD,1,0,112002,America,23,0
2020-05-27,Grenada,GD,0,0,112002,America,23,0
2020-05-28,Grenada,GD,0,0,112002,America,23,0
2020-05-29,Grenada,GD,0,0,112002,America,23,0
2020-05-30,Grenada,GD,0,0,112002,America,23,0
2020-05-31,Grenada,GD,0,0,112002,America,23,0
2020-06-01,Grenada,GD,0,0,112002,America,23,0
2020-06-02,Grenada,GD,0,0,112002,America,23,0
2020-06-03,Grenada,GD,0,0,112002,America,23,0
2020-06-04,Grenada,GD,0,0,112002,America,23,0
2020-06-05,Grenada,GD,0,0,112002,America,23,0
2020-06-06,Grenada,GD,0,0,112002,America,23,0
2020-06-07,Grenada,GD,0,0,112002,America,23,0
2020-06-08,Grenada,GD,0,0,112002,America,23,0
2020-06-09,Grenada,GD,0,0,112002,America,23,0
2020-06-10,Grenada,GD,0,0,112002,America,23,0
2020-06-11,Grenada,GD,0,0,112002,America,23,0
2020-06-12,Grenada,GD,0,0,112002,America,23,0
2020-06-13,Grenada,GD,0,0,112002,America,23,0
2020-06-14,Grenada,GD,0,0,112002,America,23,0
2020-06-15,Grenada,GD,0,0,112002,America,23,0
2020-06-16,Grenada,GD,0,0,112002,America,23,0
2020-06-17,Grenada,GD,0,0,112002,America,23,0
2020-06-18,Grenada,GD,0,0,112002,America,23,0
2020-06-19,Grenada,GD,0,0,112002,America,23,0
2020-06-20,Grenada,GD,0,0,112002,America,23,0
2020-06-21,Grenada,GD,0,0,112002,America,23,0
2020-06-22,Grenada,GD,0,0,112002,America,23,0
2020-06-23,Grenada,GD,0,0,112002,America,23,0
2020-06-24,Grenada,GD,0,0,112002,America,23,0
2020-06-25,Grenada,GD,0,0,112002,America,23,0
2020-06-26,Grenada,GD,0,0,112002,America,23,0
2020-06-27,Grenada,GD,0,0,112002,America,23,0
2020-06-28,Grenada,GD,0,0,112002,America,23,0
2020-06-29,Grenada,GD,0,0,112002,America,23,0
2020-06-30,Grenada,GD,0,0,112002,America,23,0
2020-07-01,Grenada,GD,0,0,112002,America,23,0
2020-07-02,Grenada,GD,0,0,112002,America,23,0
2020-07-03,Grenada,GD,0,0,112002,America,23,0
2020-07-04,Grenada,GD,0,0,112002,America,23,0
2020-07-05,Grenada,GD,0,0,112002,America,23,0
2020-07-06,Grenada,GD,0,0,112002,America,23,0
2020-07-07,Grenada,GD,0,0,112002,America,23,0
2020-07-08,Grenada,GD,0,0,112002,America,23,0
2020-07-09,Grenada,GD,0,0,112002,America,23,0
2020-07-10,Grenada,GD,0,0,112002,America,23,0
2020-07-11,Grenada,GD,0,0,112002,America,23,0
2020-07-12,Grenada,GD,0,0,112002,America,23,0
2020-07-13,Grenada,GD,0,0,112002,America,23,0
2020-07-14,Grenada,GD,0,0,112002,America,23,0
2020-07-15,Grenada,GD,0,0,112002,America,23,0
2020-07-16,Grenada,GD,0,0,112002,America,23,0
2020-07-17,Grenada,GD,0,0,112002,America,23,0
2020-07-18,Grenada,GD,0,0,112002,America,23,0
2020-07-19,Grenada,GD,0,0,112002,America,23,0
2020-07-20,Grenada,GD,0,0,112002,America,23,0
2020-07-21,Grenada,GD,0,0,112002,America,23,0
2020-07-22,Grenada,GD,0,0,112002,America,23,0
2020-07-23,Grenada,GD,0,0,112002,America,23,0
2020-07-24,Grenada,GD,0,0,112002,America,23,0
2020-07-25,Grenada,GD,0,0,112002,America,23,0
2020-07-26,Grenada,GD,0,0,112002,America,23,0
2020-07-27,Grenada,GD,0,0,112002,America,23,0
2020-07-28,Grenada,GD,0,0,112002,America,23,0
2020-07-29,Grenada,GD,0,0,112002,America,23,0
2020-07-30,Grenada,GD,1,0,112002,America,24,0
2020-07-31,Grenada,GD,0,0,112002,America,24,0
2020-08-01,Grenada,GD,0,0,112002,America,24,0
2020-08-02,Grenada,GD,0,0,112002,America,24,0
2020-08-03,Grenada,GD,0,0,112002,America,24,0
2020-08-04,Grenada,GD,0,0,112002,America,24,0
2020-08-05,Grenada,GD,0,0,112002,America,24,0
2020-08-06,Grenada,GD,0,0,112002,America,24,0
2020-08-07,Grenada,GD,0,0,112002,America,24,0
2020-08-08,Grenada,GD,0,0,112002,America,24,0
2020-08-09,Grenada,GD,0,0,112002,America,24,0
2020-08-10,Grenada,GD,0,0,112002,America,24,0
2020-08-11,Grenada,GD,0,0,112002,America,24,0
2020-08-12,Grenada,GD,0,0,112002,America,24,0
2020-08-13,Grenada,GD,0,0,112002,America,24,0
2020-08-14,Grenada,GD,0,0,112002,America,24,0
2020-08-15,Grenada,GD,0,0,112002,America,24,0
2020-08-16,Grenada,GD,0,0,112002,America,24,0
2020-08-17,Grenada,GD,0,0,112002,America,24,0
2020-08-18,Grenada,GD,0,0,112002,America,24,0
2020-08-19,Grenada,GD,0,0,112002,America,24,0
2020-08-20,Grenada,GD,0,0,112002,America,24,0
2020-08-21,Grenada,GD,0,0,112002,America,24,0
2020-08-22,Grenada,GD,0,0,112002,America,24,0
2020-08-23,Grenada,GD,0,0,112002,America,24,0
2020-08-24,Grenada,GD,0,0,112002,America,24,0
2020-08-25,Grenada,GD,0,0,112002,America,24,0
2020-08-26,Grenada,GD,0,0,112002,America,24,0
2020-08-27,Grenada,GD,0,0,112002,America,24,0
2020-08-28,Grenada,GD,0,0,112002,America,24,0
2020-08-29,Grenada,GD,0,0,112002,America,24,0
2020-08-30,Grenada,GD,0,0,112002,America,24,0
2020-08-31,Grenada,GD,0,0,112002,America,24,0
2020-09-01,Grenada,GD,0,0,112002,America,24,0
2020-09-02,Grenada,GD,0,0,112002,America,24,0
2020-09-03,Grenada,GD,0,0,112002,America,24,0
2020-09-04,Grenada,GD,0,0,112002,America,24,0
2020-09-05,Grenada,GD,0,0,112002,America,24,0
2020-09-06,Grenada,GD,0,0,112002,America,24,0
2020-09-07,Grenada,GD,0,0,112002,America,24,0
2020-09-08,Grenada,GD,0,0,112002,America,24,0
2020-09-09,Grenada,GD,0,0,112002,America,24,0
2020-09-10,Grenada,GD,0,0,112002,America,24,0
2020-09-11,Grenada,GD,0,0,112002,America,24,0
2020-09-12,Grenada,GD,0,0,112002,America,24,0
2020-09-13,Grenada,GD,0,0,112002,America,24,0
2020-09-14,Grenada,GD,0,0,112002,America,24,0
2020-09-15,Grenada,GD,0,0,112002,America,24,0
2020-09-16,Grenada,GD,0,0,112002,America,24,0
2020-09-17,Grenada,GD,0,0,112002,America,24,0
2020-09-18,Grenada,GD,0,0,112002,America,24,0
2020-09-19,Grenada,GD,0,0,112002,America,24,0
2020-09-20,Grenada,GD,0,0,112002,America,24,0
2020-09-21,Grenada,GD,0,0,112002,America,24,0
2020-09-22,Grenada,GD,0,0,112002,America,24,0
2020-09-23,Grenada,GD,0,0,112002,America,24,0
2020-09-24,Grenada,GD,0,0,112002,America,24,0
2020-09-25,Grenada,GD,0,0,112002,America,24,0
2020-09-26,Grenada,GD,0,0,112002,America,24,0
2020-09-27,Grenada,GD,0,0,112002,America,24,0
2020-09-28,Grenada,GD,0,0,112002,America,24,0
2020-09-29,Grenada,GD,0,0,112002,America,24,0
2020-09-30,Grenada,GD,0,0,112002,America,24,0
2020-10-01,Grenada,GD,0,0,112002,America,24,0
2020-10-02,Grenada,GD,0,0,112002,America,24,0
2020-10-03,Grenada,GD,0,0,112002,America,24,0
2020-10-04,Grenada,GD,0,0,112002,America,24,0
2020-10-05,Grenada,GD,0,0,112002,America,24,0
2020-10-06,Grenada,GD,0,0,112002,America,24,0
2020-10-07,Grenada,GD,0,0,112002,America,24,0
2020-10-08,Grenada,GD,0,0,112002,America,24,0
2020-10-09,Grenada,GD,0,0,112002,America,24,0
2020-10-10,Grenada,GD,0,0,112002,America,24,0
2020-10-11,Grenada,GD,0,0,112002,America,24,0
2020-10-12,Grenada,GD,0,0,112002,America,24,0
2020-10-13,Grenada,GD,1,0,112002,America,25,0
2020-10-14,Grenada,GD,0,0,112002,America,25,0
2020-10-15,Grenada,GD,0,0,112002,America,25,0
2020-10-16,Grenada,GD,0,0,112002,America,25,0
2020-10-17,Grenada,GD,0,0,112002,America,25,0
2020-10-18,Grenada,GD,2,0,112002,America,27,0
2020-10-19,Grenada,GD,0,0,112002,America,27,0
2020-10-20,Grenada,GD,0,0,112002,America,27,0
2020-10-21,Grenada,GD,0,0,112002,America,27,0
2020-10-22,Grenada,GD,0,0,112002,America,27,0
2020-10-23,Grenada,GD,0,0,112002,America,27,0
2020-10-24,Grenada,GD,0,0,112002,America,27,0
2020-10-25,Grenada,GD,1,0,112002,America,28,0
2020-10-26,Grenada,GD,0,0,112002,America,28,0
2020-10-27,Grenada,GD,0,0,112002,America,28,0
2020-10-28,Grenada,GD,0,0,112002,America,28,0
2020-10-29,Grenada,GD,0,0,112002,America,28,0
2020-10-30,Grenada,GD,0,0,112002,America,28,0
2020-10-31,Grenada,GD,0,0,112002,America,28,0
2020-11-01,Grenada,GD,0,0,112002,America,28,0
2020-11-02,Grenada,GD,0,0,112002,America,28,0
2020-11-03,Grenada,GD,1,0,112002,America,29,0
2020-11-04,Grenada,GD,0,0,112002,America,29,0
2020-11-05,Grenada,GD,1,0,112002,America,30,0
2020-11-06,Grenada,GD,0,0,112002,America,30,0
2020-11-07,Grenada,GD,0,0,112002,America,30,0
2020-11-08,Grenada,GD,0,0,112002,America,30,0
2020-11-09,Grenada,GD,2,0,112002,America,32,0
2020-11-10,Grenada,GD,0,0,112002,America,32,0
2020-11-11,Grenada,GD,0,0,112002,America,32,0
2020-11-12,Grenada,GD,0,0,112002,America,32,0
2020-11-13,Grenada,GD,0,0,112002,America,32,0
2020-11-14,Grenada,GD,0,0,112002,America,32,0
2020-11-15,Grenada,GD,0,0,112002,America,32,0
2020-11-16,Grenada,GD,0,0,112002,America,32,0
2020-11-17,Grenada,GD,0,0,112002,America,32,0
2020-11-18,Grenada,GD,1,0,112002,America,33,0
2020-11-19,Grenada,GD,3,0,112002,America,36,0
2020-11-20,Grenada,GD,0,0,112002,America,36,0
2020-11-21,Grenada,GD,5,0,112002,America,41,0
2020-11-22,Grenada,GD,0,0,112002,America,41,0
2020-11-23,Grenada,GD,0,0,112002,America,41,0
2020-11-24,Grenada,GD,0,0,112002,America,41,0
2020-11-25,Grenada,GD,0,0,112002,America,41,0
2020-11-26,Grenada,GD,0,0,112002,America,41,0
2020-11-27,Grenada,GD,0,0,112002,America,41,0
2020-11-28,Grenada,GD,0,0,112002,America,41,0
2020-11-29,Grenada,GD,0,0,112002,America,41,0
2020-11-30,Grenada,GD,0,0,112002,America,41,0
2020-12-01,Grenada,GD,0,0,112002,America,41,0
2020-12-02,Grenada,GD,0,0,112002,America,41,0
2020-12-03,Grenada,GD,0,0,112002,America,41,0
2020-12-04,Grenada,GD,0,0,112002,America,41,0
2020-12-05,Grenada,GD,0,0,112002,America,41,0
2020-12-06,Grenada,GD,0,0,112002,America,41,0
2020-12-07,Grenada,GD,0,0,112002,America,41,0
2020-12-08,Grenada,GD,0,0,112002,America,41,0
2020-12-09,Grenada,GD,2,0,112002,America,43,0
2020-12-10,Grenada,GD,0,0,112002,America,43,0
2020-12-11,Grenada,GD,0,0,112002,America,43,0
2020-12-12,Grenada,GD,0,0,112002,America,43,0
2020-12-13,Grenada,GD,0,0,112002,America,43,0
2020-12-14,Grenada,GD,26,0,112002,America,69,0
2019-12-31,Georgia,GE,0,0,3996762,Europe,0,0
2020-01-01,Georgia,GE,0,0,3996762,Europe,0,0
2020-01-02,Georgia,GE,0,0,3996762,Europe,0,0
2020-01-03,Georgia,GE,0,0,3996762,Europe,0,0
2020-01-04,Georgia,GE,0,0,3996762,Europe,0,0
2020-01-05,Georgia,GE,0,0,3996762,Europe,0,0
2020-01-06,Georgia,GE,0,0,3996762,Europe,0,0
2020-01-07,Georgia,GE,0,0,3996762,Europe,0,0
2020-01-08,Georgia,GE,0,0,3996762,Europe,0,0
2020-01-09,Georgia,GE,0,0,3996762,Europe,0,0
2020-01-10,Georgia,GE,0,0,3996762,Europe,0,0
2020-01-11,Georgia,GE,0,0,3996762,Europe,0,0
2020-01-12,Georgia,GE,0,0,3996762,Europe,0,0
2020-01-13,Georgia,GE,0,0,3996762,Europe,0,0
2020-01-14,Georgia,GE,0,0,3996762,Europe,0,0
2020-01-15,Georgia,GE,0,0,3996762,Europe,0,0
2020-01-16,Georgia,GE,0,0,3996762,Europe,0,0
2020-01-17,Georgia,GE,0,0,3996762,Europe,0,0
2020-01-18,Georgia,GE,0,0,3996762,Europe,0,0
2020-01-19,Georgia,GE,0,0,3996762,Europe,0,0
2020-01-20,Georgia,GE,0,0,3996762,Europe,0,0
2020-01-21,Georgia,GE,0,0,3996762,Europe,0,0
2020-01-22,Georgia,GE,0,0,3996762,Europe,0,0
2020-01-23,Georgia,GE,0,0,3996762,Europe,0,0
2020-01-24,Georgia,GE,0,0,3996762,Europe,0,0
2020-01-25,Georgia,GE,0,0,3996762,Europe,0,0
2020-01-26,Georgia,GE,0,0,3996762,Europe,0,0
2020-01-27,Georgia,GE,0,0,3996762,Europe,0,0
2020-01-28,Georgia,GE,0,0,3996762,Europe,0,0
2020-01-29,Georgia,GE,0,0,3996762,Europe,0,0
2020-01-30,Georgia,GE,0,0,3996762,Europe,0,0
2020-01-31,Georgia,GE,0,0,3996762,Europe,0,0
2020-02-01,Georgia,GE,0,0,3996762,Europe,0,0
2020-02-02,Georgia,GE,0,0,3996762,Europe,0,0
2020-02-03,Georgia,GE,0,0,3996762,Europe,0,0
2020-02-04,Georgia,GE,0,0,3996762,Europe,0,0
2020-02-05,Georgia,GE,0,0,3996762,Europe,0,0
2020-02-06,Georgia,GE,0,0,3996762,Europe,0,0
2020-02-07,Georgia,GE,0,0,3996762,Europe,0,0
2020-02-08,Georgia,GE,0,0,3996762,Europe,0,0
2020-02-09,Georgia,GE,0,0,3996762,Europe,0,0
2020-02-10,Georgia,GE,0,0,3996762,Europe,0,0
2020-02-11,Georgia,GE,0,0,3996762,Europe,0,0
2020-02-12,Georgia,GE,0,0,3996762,Europe,0,0
2020-02-13,Georgia,GE,0,0,3996762,Europe,0,0
2020-02-14,Georgia,GE,0,0,3996762,Europe,0,0
2020-02-15,Georgia,GE,0,0,3996762,Europe,0,0
2020-02-16,Georgia,GE,0,0,3996762,Europe,0,0
2020-02-17,Georgia,GE,0,0,3996762,Europe,0,0
2020-02-18,Georgia,GE,0,0,3996762,Europe,0,0
2020-02-19,Georgia,GE,0,0,3996762,Europe,0,0
2020-02-20,Georgia,GE,0,0,3996762,Europe,0,0
2020-02-21,Georgia,GE,0,0,3996762,Europe,0,0
2020-02-22,Georgia,GE,0,0,3996762,Europe,0,0
2020-02-23,Georgia,GE,0,0,3996762,Europe,0,0
2020-02-24,Georgia,GE,0,0,3996762,Europe,0,0
2020-02-25,Georgia,GE,0,0,3996762,Europe,0,0
2020-02-26,Georgia,GE,0,0,3996762,Europe,0,0
2020-02-27,Georgia,GE,1,0,3996762,Europe,1,0
2020-02-28,Georgia,GE,0,0,3996762,Europe,1,0
2020-02-29,Georgia,GE,1,0,3996762,Europe,2,0
2020-03-01,Georgia,GE,1,0,3996762,Europe,3,0
2020-03-02,Georgia,GE,0,0,3996762,Europe,3,0
2020-03-05,Georgia,GE,0,0,3996762,Europe,3,0
2020-03-06,Georgia,GE,6,0,3996762,Europe,9,0
2020-03-08,Georgia,GE,3,0,3996762,Europe,12,0
2020-03-09,Georgia,GE,1,0,3996762,Europe,13,0
2020-03-10,Georgia,GE,2,0,3996762,Europe,15,0
2020-03-11,Georgia,GE,8,0,3996762,Europe,23,0
2020-03-12,Georgia,GE,1,0,3996762,Europe,24,0
2020-03-13,Georgia,GE,1,0,3996762,Europe,25,0
2020-03-14,Georgia,GE,5,0,3996762,Europe,30,0
2020-03-15,Georgia,GE,0,0,3996762,Europe,30,0
2020-03-16,Georgia,GE,0,0,3996762,Europe,30,0
2020-03-17,Georgia,GE,3,0,3996762,Europe,33,0
2020-03-18,Georgia,GE,1,0,3996762,Europe,34,0
2020-03-19,Georgia,GE,0,0,3996762,Europe,34,0
2020-03-20,Georgia,GE,6,0,3996762,Europe,40,0
2020-03-21,Georgia,GE,3,0,3996762,Europe,43,0
2020-03-22,Georgia,GE,6,0,3996762,Europe,49,0
2020-03-23,Georgia,GE,5,0,3996762,Europe,54,0
2020-03-24,Georgia,GE,7,0,3996762,Europe,61,0
2020-03-25,Georgia,GE,9,0,3996762,Europe,70,0
2020-03-26,Georgia,GE,3,0,3996762,Europe,73,0
2020-03-27,Georgia,GE,6,0,3996762,Europe,79,0
2020-03-28,Georgia,GE,2,0,3996762,Europe,81,0
2020-03-29,Georgia,GE,4,0,3996762,Europe,85,0
2020-03-30,Georgia,GE,5,0,3996762,Europe,90,0
2020-03-31,Georgia,GE,8,0,3996762,Europe,98,0
2020-04-01,Georgia,GE,12,0,3996762,Europe,110,0
2020-04-02,Georgia,GE,5,0,3996762,Europe,115,0
2020-04-03,Georgia,GE,6,0,3996762,Europe,121,0
2020-04-04,Georgia,GE,27,0,3996762,Europe,148,0
2020-04-05,Georgia,GE,9,0,3996762,Europe,157,0
2020-04-06,Georgia,GE,17,2,3996762,Europe,174,2
2020-04-07,Georgia,GE,14,0,3996762,Europe,188,2
2020-04-08,Georgia,GE,8,1,3996762,Europe,196,3
2020-04-09,Georgia,GE,15,0,3996762,Europe,211,3
2020-04-10,Georgia,GE,7,0,3996762,Europe,218,3
2020-04-11,Georgia,GE,16,0,3996762,Europe,234,3
2020-04-12,Georgia,GE,8,0,3996762,Europe,242,3
2020-04-13,Georgia,GE,15,0,3996762,Europe,257,3
2020-04-14,Georgia,GE,15,0,3996762,Europe,272,3
2020-04-15,Georgia,GE,28,0,3996762,Europe,300,3
2020-04-16,Georgia,GE,6,0,3996762,Europe,306,3
2020-04-17,Georgia,GE,42,0,3996762,Europe,348,3
2020-04-18,Georgia,GE,22,0,3996762,Europe,370,3
2020-04-19,Georgia,GE,18,1,3996762,Europe,388,4
2020-04-20,Georgia,GE,6,0,3996762,Europe,394,4
2020-04-21,Georgia,GE,8,0,3996762,Europe,402,4
2020-04-22,Georgia,GE,6,0,3996762,Europe,408,4
2020-04-23,Georgia,GE,8,1,3996762,Europe,416,5
2020-04-24,Georgia,GE,9,0,3996762,Europe,425,5
2020-04-25,Georgia,GE,19,0,3996762,Europe,444,5
2020-04-26,Georgia,GE,12,0,3996762,Europe,456,5
2020-04-27,Georgia,GE,30,1,3996762,Europe,486,6
2020-04-28,Georgia,GE,11,0,3996762,Europe,497,6
2020-04-29,Georgia,GE,14,0,3996762,Europe,511,6
2020-04-30,Georgia,GE,6,0,3996762,Europe,517,6
2020-05-01,Georgia,GE,22,0,3996762,Europe,539,6
2020-05-02,Georgia,GE,43,2,3996762,Europe,582,8
2020-05-03,Georgia,GE,0,0,3996762,Europe,582,8
2020-05-04,Georgia,GE,7,1,3996762,Europe,589,9
2020-05-05,Georgia,GE,4,0,3996762,Europe,593,9
2020-05-06,Georgia,GE,11,0,3996762,Europe,604,9
2020-05-07,Georgia,GE,6,0,3996762,Europe,610,9
2020-05-08,Georgia,GE,5,0,3996762,Europe,615,9
2020-05-09,Georgia,GE,8,1,3996762,Europe,623,10
2020-05-10,Georgia,GE,3,0,3996762,Europe,626,10
2020-05-11,Georgia,GE,9,0,3996762,Europe,635,10
2020-05-12,Georgia,GE,3,1,3996762,Europe,638,11
2020-05-13,Georgia,GE,4,0,3996762,Europe,642,11
2020-05-14,Georgia,GE,5,0,3996762,Europe,647,11
2020-05-15,Georgia,GE,20,1,3996762,Europe,667,12
2020-05-16,Georgia,GE,4,0,3996762,Europe,671,12
2020-05-17,Georgia,GE,24,0,3996762,Europe,695,12
2020-05-18,Georgia,GE,6,0,3996762,Europe,701,12
2020-05-19,Georgia,GE,1,0,3996762,Europe,702,12
2020-05-20,Georgia,GE,5,0,3996762,Europe,707,12
2020-05-21,Georgia,GE,6,0,3996762,Europe,713,12
2020-05-22,Georgia,GE,8,0,3996762,Europe,721,12
2020-05-23,Georgia,GE,2,0,3996762,Europe,723,12
2020-05-24,Georgia,GE,5,0,3996762,Europe,728,12
2020-05-25,Georgia,GE,2,0,3996762,Europe,730,12
2020-05-26,Georgia,GE,1,0,3996762,Europe,731,12
2020-05-27,Georgia,GE,1,0,3996762,Europe,732,12
2020-05-28,Georgia,GE,3,0,3996762,Europe,735,12
2020-05-29,Georgia,GE,3,0,3996762,Europe,738,12
2020-05-30,Georgia,GE,8,0,3996762,Europe,746,12
2020-05-31,Georgia,GE,11,0,3996762,Europe,757,12
2020-06-01,Georgia,GE,26,0,3996762,Europe,783,12
2020-06-02,Georgia,GE,13,0,3996762,Europe,796,12
2020-06-03,Georgia,GE,4,1,3996762,Europe,800,13
2020-06-04,Georgia,GE,0,0,3996762,Europe,800,13
2020-06-05,Georgia,GE,1,0,3996762,Europe,801,13
2020-06-06,Georgia,GE,4,0,3996762,Europe,805,13
2020-06-07,Georgia,GE,3,0,3996762,Europe,808,13
2020-06-08,Georgia,GE,0,0,3996762,Europe,808,13
2020-06-09,Georgia,GE,4,0,3996762,Europe,812,13
2020-06-10,Georgia,GE,6,0,3996762,Europe,818,13
2020-06-11,Georgia,GE,9,0,3996762,Europe,827,13
2020-06-12,Georgia,GE,4,0,3996762,Europe,831,13
2020-06-13,Georgia,GE,12,0,3996762,Europe,843,13
2020-06-14,Georgia,GE,8,1,3996762,Europe,851,14
2020-06-15,Georgia,GE,28,0,3996762,Europe,879,14
2020-06-16,Georgia,GE,0,0,3996762,Europe,879,14
2020-06-17,Georgia,GE,9,0,3996762,Europe,888,14
2020-06-18,Georgia,GE,5,0,3996762,Europe,893,14
2020-06-19,Georgia,GE,2,0,3996762,Europe,895,14
2020-06-20,Georgia,GE,1,0,3996762,Europe,896,14
2020-06-21,Georgia,GE,2,0,3996762,Europe,898,14
2020-06-22,Georgia,GE,10,0,3996762,Europe,908,14
2020-06-23,Georgia,GE,3,0,3996762,Europe,911,14
2020-06-24,Georgia,GE,3,0,3996762,Europe,914,14
2020-06-25,Georgia,GE,3,0,3996762,Europe,917,14
2020-06-26,Georgia,GE,2,0,3996762,Europe,919,14
2020-06-27,Georgia,GE,2,0,3996762,Europe,921,14
2020-06-28,Georgia,GE,3,1,3996762,Europe,924,15
2020-06-29,Georgia,GE,2,0,3996762,Europe,926,15
2020-06-30,Georgia,GE,2,0,3996762,Europe,928,15
2020-07-01,Georgia,GE,0,0,3996762,Europe,928,15
2020-07-02,Georgia,GE,3,0,3996762,Europe,931,15
2020-07-03,Georgia,GE,8,0,3996762,Europe,939,15
2020-07-04,Georgia,GE,7,0,3996762,Europe,946,15
2020-07-05,Georgia,GE,2,0,3996762,Europe,948,15
2020-07-06,Georgia,GE,5,0,3996762,Europe,953,15
2020-07-07,Georgia,GE,5,0,3996762,Europe,958,15
2020-07-08,Georgia,GE,5,0,3996762,Europe,963,15
2020-07-09,Georgia,GE,5,0,3996762,Europe,968,15
2020-07-10,Georgia,GE,5,0,3996762,Europe,973,15
2020-07-11,Georgia,GE,8,0,3996762,Europe,981,15
2020-07-12,Georgia,GE,5,0,3996762,Europe,986,15
2020-07-13,Georgia,GE,9,0,3996762,Europe,995,15
2020-07-14,Georgia,GE,4,0,3996762,Europe,999,15
2020-07-15,Georgia,GE,4,0,3996762,Europe,1003,15
2020-07-16,Georgia,GE,3,0,3996762,Europe,1006,15
2020-07-17,Georgia,GE,0,0,3996762,Europe,1006,15
2020-07-18,Georgia,GE,12,0,3996762,Europe,1018,15
2020-07-19,Georgia,GE,10,0,3996762,Europe,1028,15
2020-07-20,Georgia,GE,0,0,3996762,Europe,1028,15
2020-07-21,Georgia,GE,11,1,3996762,Europe,1039,16
2020-07-22,Georgia,GE,10,0,3996762,Europe,1049,16
2020-07-23,Georgia,GE,24,0,3996762,Europe,1073,16
2020-07-24,Georgia,GE,31,0,3996762,Europe,1104,16
2020-07-25,Georgia,GE,13,0,3996762,Europe,1117,16
2020-07-26,Georgia,GE,14,0,3996762,Europe,1131,16
2020-07-27,Georgia,GE,6,0,3996762,Europe,1137,16
2020-07-28,Georgia,GE,8,0,3996762,Europe,1145,16
2020-07-29,Georgia,GE,10,0,3996762,Europe,1155,16
2020-07-30,Georgia,GE,0,1,3996762,Europe,1155,17
2020-07-31,Georgia,GE,5,0,3996762,Europe,1160,17
2020-08-01,Georgia,GE,8,0,3996762,Europe,1168,17
2020-08-02,Georgia,GE,3,0,3996762,Europe,1171,17
2020-08-03,Georgia,GE,6,0,3996762,Europe,1177,17
2020-08-04,Georgia,GE,5,0,3996762,Europe,1182,17
2020-08-05,Georgia,GE,15,0,3996762,Europe,1197,17
2020-08-06,Georgia,GE,9,0,3996762,Europe,1206,17
2020-08-07,Georgia,GE,0,0,3996762,Europe,1206,17
2020-08-08,Georgia,GE,7,0,3996762,Europe,1213,17
2020-08-09,Georgia,GE,12,0,3996762,Europe,1225,17
2020-08-10,Georgia,GE,25,0,3996762,Europe,1250,17
2020-08-11,Georgia,GE,14,0,3996762,Europe,1264,17
2020-08-12,Georgia,GE,14,0,3996762,Europe,1278,17
2020-08-13,Georgia,GE,5,0,3996762,Europe,1283,17
2020-08-14,Georgia,GE,23,0,3996762,Europe,1306,17
2020-08-15,Georgia,GE,0,0,3996762,Europe,1306,17
2020-08-16,Georgia,GE,15,0,3996762,Europe,1321,17
2020-08-17,Georgia,GE,20,0,3996762,Europe,1341,17
2020-08-18,Georgia,GE,10,0,3996762,Europe,1351,17
2020-08-19,Georgia,GE,10,0,3996762,Europe,1361,17
2020-08-20,Georgia,GE,0,0,3996762,Europe,1361,17
2020-08-21,Georgia,GE,9,0,3996762,Europe,1370,17
2020-08-22,Georgia,GE,15,0,3996762,Europe,1385,17
2020-08-23,Georgia,GE,9,0,3996762,Europe,1394,17
2020-08-24,Georgia,GE,17,0,3996762,Europe,1411,17
2020-08-25,Georgia,GE,10,1,3996762,Europe,1421,18
2020-08-26,Georgia,GE,15,1,3996762,Europe,1436,19
2020-08-27,Georgia,GE,11,0,3996762,Europe,1447,19
2020-08-28,Georgia,GE,8,0,3996762,Europe,1455,19
2020-08-29,Georgia,GE,7,0,3996762,Europe,1462,19
2020-08-30,Georgia,GE,0,0,3996762,Europe,1462,19
2020-08-31,Georgia,GE,25,0,3996762,Europe,1487,19
2020-09-01,Georgia,GE,0,0,3996762,Europe,1487,19
2020-09-02,Georgia,GE,23,0,3996762,Europe,1510,19
2020-09-03,Georgia,GE,38,0,3996762,Europe,1548,19
2020-09-04,Georgia,GE,20,0,3996762,Europe,1568,19
2020-09-05,Georgia,GE,28,0,3996762,Europe,1596,19
2020-09-06,Georgia,GE,25,0,3996762,Europe,1621,19
2020-09-07,Georgia,GE,19,0,3996762,Europe,1640,19
2020-09-08,Georgia,GE,44,0,3996762,Europe,1684,19
2020-09-09,Georgia,GE,89,0,3996762,Europe,1773,19
2020-09-10,Georgia,GE,57,0,3996762,Europe,1830,19
2020-09-11,Georgia,GE,87,0,3996762,Europe,1917,19
2020-09-12,Georgia,GE,158,0,3996762,Europe,2075,19
2020-09-13,Georgia,GE,0,0,3996762,Europe,2075,19
2020-09-14,Georgia,GE,317,0,3996762,Europe,2392,19
2020-09-15,Georgia,GE,0,0,3996762,Europe,2392,19
2020-09-16,Georgia,GE,366,0,3996762,Europe,2758,19
2020-09-17,Georgia,GE,179,0,3996762,Europe,2937,19
2020-09-18,Georgia,GE,182,0,3996762,Europe,3119,19
2020-09-19,Georgia,GE,187,0,3996762,Europe,3306,19
2020-09-20,Georgia,GE,196,0,3996762,Europe,3502,19
2020-09-21,Georgia,GE,193,1,3996762,Europe,3695,20
2020-09-22,Georgia,GE,218,2,3996762,Europe,3913,22
2020-09-23,Georgia,GE,227,2,3996762,Europe,4140,24
2020-09-24,Georgia,GE,259,1,3996762,Europe,4399,25
2020-09-25,Georgia,GE,0,0,3996762,Europe,4399,25
2020-09-26,Georgia,GE,265,2,3996762,Europe,4664,27
2020-09-27,Georgia,GE,590,1,3996762,Europe,5254,28
2020-09-28,Georgia,GE,298,0,3996762,Europe,5552,28
2020-09-29,Georgia,GE,314,5,3996762,Europe,5866,33
2020-09-30,Georgia,GE,0,0,3996762,Europe,5866,33
2020-10-01,Georgia,GE,774,6,3996762,Europe,6640,39
2020-10-02,Georgia,GE,453,4,3996762,Europe,7093,43
2020-10-03,Georgia,GE,471,5,3996762,Europe,7564,48
2020-10-04,Georgia,GE,554,2,3996762,Europe,8118,50
2020-10-05,Georgia,GE,0,0,3996762,Europe,8118,50
2020-10-06,Georgia,GE,578,4,3996762,Europe,8696,54
2020-10-07,Georgia,GE,549,4,3996762,Europe,9245,58
2020-10-08,Georgia,GE,508,5,3996762,Europe,9753,63
2020-10-09,Georgia,GE,472,3,3996762,Europe,10225,66
2020-10-10,Georgia,GE,527,6,3996762,Europe,10752,72
2020-10-11,Georgia,GE,519,6,3996762,Europe,11271,78
2020-10-12,Georgia,GE,523,7,3996762,Europe,11794,85
2020-10-13,Georgia,GE,478,8,3996762,Europe,12272,93
2020-10-14,Georgia,GE,569,9,3996762,Europe,12841,102
2020-10-15,Georgia,GE,680,7,3996762,Europe,13521,109
2020-10-16,Georgia,GE,919,4,3996762,Europe,14440,113
2020-10-17,Georgia,GE,887,11,3996762,Europe,15327,124
2020-10-18,Georgia,GE,958,4,3996762,Europe,16285,128
2020-10-19,Georgia,GE,1192,8,3996762,Europe,17477,136
2020-10-20,Georgia,GE,1186,7,3996762,Europe,18663,143
2020-10-21,Georgia,GE,1194,15,3996762,Europe,19857,158
2020-10-22,Georgia,GE,1351,14,3996762,Europe,21208,172
2020-10-23,Georgia,GE,1595,6,3996762,Europe,22803,178
2020-10-24,Georgia,GE,1759,5,3996762,Europe,24562,183
2020-10-25,Georgia,GE,3869,18,3996762,Europe,28431,201
2020-10-26,Georgia,GE,1872,14,3996762,Europe,30303,215
2020-10-27,Georgia,GE,1824,23,3996762,Europe,32127,238
2020-10-28,Georgia,GE,1731,15,3996762,Europe,33858,253
2020-10-29,Georgia,GE,1709,20,3996762,Europe,35567,273
2020-10-30,Georgia,GE,1696,12,3996762,Europe,37263,285
2020-10-31,Georgia,GE,1673,22,3996762,Europe,38936,307
2020-11-01,Georgia,GE,1791,28,3996762,Europe,40727,335
2020-11-02,Georgia,GE,1852,7,3996762,Europe,42579,342
2020-11-03,Georgia,GE,1943,20,3996762,Europe,44522,362
2020-11-04,Georgia,GE,2295,19,3996762,Europe,46817,381
2020-11-05,Georgia,GE,2401,20,3996762,Europe,49218,401
2020-11-06,Georgia,GE,2775,22,3996762,Europe,51993,423
2020-11-07,Georgia,GE,2859,18,3996762,Europe,54852,441
2020-11-08,Georgia,GE,2901,34,3996762,Europe,57753,475
2020-11-09,Georgia,GE,2927,24,3996762,Europe,60680,499
2020-11-10,Georgia,GE,2970,22,3996762,Europe,63650,521
2020-11-11,Georgia,GE,2911,45,3996762,Europe,66561,566
2020-11-12,Georgia,GE,3120,33,3996762,Europe,69681,599
2020-11-13,Georgia,GE,3473,37,3996762,Europe,73154,636
2020-11-14,Georgia,GE,3504,33,3996762,Europe,76658,669
2020-11-15,Georgia,GE,3020,34,3996762,Europe,79678,703
2020-11-16,Georgia,GE,3157,30,3996762,Europe,82835,733
2020-11-17,Georgia,GE,2757,45,3996762,Europe,85592,778
2020-11-18,Georgia,GE,360,0,3996762,Europe,85952,778
2020-11-19,Georgia,GE,3443,37,3996762,Europe,89395,815
2020-11-20,Georgia,GE,3697,38,3996762,Europe,93092,853
2020-11-21,Georgia,GE,7592,74,3996762,Europe,100684,927
2020-11-22,Georgia,GE,4048,49,3996762,Europe,104732,976
2020-11-23,Georgia,GE,3958,36,3996762,Europe,108690,1012
2020-11-24,Georgia,GE,3128,39,3996762,Europe,111818,1051
2020-11-25,Georgia,GE,3071,34,3996762,Europe,114889,1085
2020-11-26,Georgia,GE,3801,39,3996762,Europe,118690,1124
2020-11-27,Georgia,GE,4780,37,3996762,Europe,123470,1161
2020-11-28,Georgia,GE,4472,34,3996762,Europe,127942,1195
2020-11-29,Georgia,GE,4426,35,3996762,Europe,132368,1230
2020-11-30,Georgia,GE,3216,37,3996762,Europe,135584,1267
2020-12-01,Georgia,GE,3759,36,3996762,Europe,139343,1303
2020-12-02,Georgia,GE,4033,39,3996762,Europe,143376,1342
2020-12-03,Georgia,GE,4260,45,3996762,Europe,147636,1387
2020-12-04,Georgia,GE,5068,38,3996762,Europe,152704,1425
2020-12-05,Georgia,GE,5450,37,3996762,Europe,158154,1462
2020-12-06,Georgia,GE,4321,42,3996762,Europe,162475,1504
2020-12-07,Georgia,GE,2501,36,3996762,Europe,164976,1540
2020-12-08,Georgia,GE,4673,36,3996762,Europe,169649,1576
2020-12-09,Georgia,GE,4734,38,3996762,Europe,174383,1614
2020-12-10,Georgia,GE,4570,43,3996762,Europe,178953,1657
2020-12-11,Georgia,GE,4146,37,3996762,Europe,183099,1694
2020-12-12,Georgia,GE,3907,50,3996762,Europe,187006,1744
2020-12-13,Georgia,GE,2720,46,3996762,Europe,189726,1790
2020-12-14,Georgia,GE,1337,49,3996762,Europe,191063,1839
2020-03-20,Guernsey,GG,1,0,64468,Europe,1,0
2020-03-21,Guernsey,GG,0,0,64468,Europe,1,0
2020-03-22,Guernsey,GG,0,0,64468,Europe,1,0
2020-03-23,Guernsey,GG,16,0,64468,Europe,17,0
2020-03-24,Guernsey,GG,3,0,64468,Europe,20,0
2020-03-25,Guernsey,GG,3,0,64468,Europe,23,0
2020-03-26,Guernsey,GG,7,0,64468,Europe,30,0
2020-03-27,Guernsey,GG,4,0,64468,Europe,34,0
2020-03-28,Guernsey,GG,2,0,64468,Europe,36,0
2020-03-29,Guernsey,GG,3,0,64468,Europe,39,0
2020-03-30,Guernsey,GG,6,0,64468,Europe,45,0
2020-03-31,Guernsey,GG,0,0,64468,Europe,45,0
2020-04-01,Guernsey,GG,15,0,64468,Europe,60,0
2020-04-02,Guernsey,GG,18,0,64468,Europe,78,0
2020-04-03,Guernsey,GG,13,0,64468,Europe,91,0
2020-04-04,Guernsey,GG,23,2,64468,Europe,114,2
2020-04-05,Guernsey,GG,22,0,64468,Europe,136,2
2020-04-06,Guernsey,GG,18,1,64468,Europe,154,3
2020-04-07,Guernsey,GG,11,1,64468,Europe,165,4
2020-04-08,Guernsey,GG,1,0,64468,Europe,166,4
2020-04-09,Guernsey,GG,15,1,64468,Europe,181,5
2020-04-10,Guernsey,GG,10,0,64468,Europe,191,5
2020-04-11,Guernsey,GG,9,1,64468,Europe,200,6
2020-04-12,Guernsey,GG,9,0,64468,Europe,209,6
2020-04-13,Guernsey,GG,9,0,64468,Europe,218,6
2020-04-14,Guernsey,GG,1,0,64468,Europe,219,6
2020-04-15,Guernsey,GG,4,1,64468,Europe,223,7
2020-04-16,Guernsey,GG,0,0,64468,Europe,223,7
2020-04-17,Guernsey,GG,11,2,64468,Europe,234,9
2020-04-18,Guernsey,GG,0,0,64468,Europe,234,9
2020-04-19,Guernsey,GG,5,0,64468,Europe,239,9
2020-04-20,Guernsey,GG,0,0,64468,Europe,239,9
2020-04-21,Guernsey,GG,0,1,64468,Europe,239,10
2020-04-22,Guernsey,GG,0,0,64468,Europe,239,10
2020-04-23,Guernsey,GG,4,0,64468,Europe,243,10
2020-04-24,Guernsey,GG,2,0,64468,Europe,245,10
2020-04-25,Guernsey,GG,0,1,64468,Europe,245,11
2020-04-26,Guernsey,GG,0,1,64468,Europe,245,12
2020-04-27,Guernsey,GG,2,1,64468,Europe,247,13
2020-04-28,Guernsey,GG,0,0,64468,Europe,247,13
2020-04-29,Guernsey,GG,0,0,64468,Europe,247,13
2020-04-30,Guernsey,GG,4,0,64468,Europe,251,13
2020-05-01,Guernsey,GG,0,0,64468,Europe,251,13
2020-05-02,Guernsey,GG,1,0,64468,Europe,252,13
2020-05-03,Guernsey,GG,0,0,64468,Europe,252,13
2020-05-04,Guernsey,GG,0,0,64468,Europe,252,13
2020-05-05,Guernsey,GG,0,0,64468,Europe,252,13
2020-05-06,Guernsey,GG,0,0,64468,Europe,252,13
2020-05-07,Guernsey,GG,0,0,64468,Europe,252,13
2020-05-08,Guernsey,GG,0,0,64468,Europe,252,13
2020-05-09,Guernsey,GG,0,0,64468,Europe,252,13
2020-05-10,Guernsey,GG,0,0,64468,Europe,252,13
2020-05-11,Guernsey,GG,0,0,64468,Europe,252,13
2020-05-12,Guernsey,GG,0,0,64468,Europe,252,13
2020-05-13,Guernsey,GG,0,0,64468,Europe,252,13
2020-05-14,Guernsey,GG,0,0,64468,Europe,252,13
2020-05-15,Guernsey,GG,0,0,64468,Europe,252,13
2020-05-16,Guernsey,GG,0,0,64468,Europe,252,13
2020-05-17,Guernsey,GG,0,0,64468,Europe,252,13
2020-05-18,Guernsey,GG,0,0,64468,Europe,252,13
2020-05-19,Guernsey,GG,0,0,64468,Europe,252,13
2020-05-20,Guernsey,GG,0,0,64468,Europe,252,13
2020-05-21,Guernsey,GG,0,0,64468,Europe,252,13
2020-05-22,Guernsey,GG,0,0,64468,Europe,252,13
2020-05-23,Guernsey,GG,0,0,64468,Europe,252,13
2020-05-24,Guernsey,GG,0,0,64468,Europe,252,13
2020-05-25,Guernsey,GG,0,0,64468,Europe,252,13
2020-05-26,Guernsey,GG,0,0,64468,Europe,252,13
2020-05-27,Guernsey,GG,0,0,64468,Europe,252,13
2020-05-28,Guernsey,GG,0,0,64468,Europe,252,13
2020-05-29,Guernsey,GG,0,0,64468,Europe,252,13
2020-05-30,Guernsey,GG,0,0,64468,Europe,252,13
2020-05-31,Guernsey,GG,0,0,64468,Europe,252,13
2020-06-01,Guernsey,GG,0,0,64468,Europe,252,13
2020-06-02,Guernsey,GG,0,0,64468,Europe,252,13
2020-06-03,Guernsey,GG,0,0,64468,Europe,252,13
2020-06-04,Guernsey,GG,0,0,64468,Europe,252,13
2020-06-05,Guernsey,GG,0,0,64468,Europe,252,13
2020-06-06,Guernsey,GG,0,0,64468,Europe,252,13
2020-06-07,Guernsey,GG,0,0,64468,Europe,252,13
2020-06-08,Guernsey,GG,0,0,64468,Europe,252,13
2020-06-09,Guernsey,GG,0,0,64468,Europe,252,13
2020-06-10,Guernsey,GG,0,0,64468,Europe,252,13
2020-06-11,Guernsey,GG,0,0,64468,Europe,252,13
2020-06-12,Guernsey,GG,0,0,64468,Europe,252,13
2020-06-13,Guernsey,GG,0,0,64468,Europe,252,13
2020-06-14,Guernsey,GG,0,0,64468,Europe,252,13
2020-06-15,Guernsey,GG,0,0,64468,Europe,252,13
2020-06-16,Guernsey,GG,0,0,64468,Europe,252,13
2020-06-17,Guernsey,GG,0,0,64468,Europe,252,13
2020-06-18,Guernsey,GG,0,0,64468,Europe,252,13
2020-06-19,Guernsey,GG,0,0,64468,Europe,252,13
2020-06-20,Guernsey,GG,0,0,64468,Europe,252,13
2020-06-21,Guernsey,GG,0,0,64468,Europe,252,13
2020-06-22,Guernsey,GG,0,0,64468,Europe,252,13
2020-06-23,Guernsey,GG,0,0,64468,Europe,252,13
2020-06-24,Guernsey,GG,0,0,64468,Europe,252,13
2020-06-25,Guernsey,GG,0,0,64468,Europe,252,13
2020-06-26,Guernsey,GG,0,0,64468,Europe,252,13
2020-06-27,Guernsey,GG,0,0,64468,Europe,252,13
2020-06-28,Guernsey,GG,0,0,64468,Europe,252,13
2020-06-29,Guernsey,GG,0,0,64468,Europe,252,13
2020-06-30,Guernsey,GG,0,0,64468,Europe,252,13
2020-07-01,Guernsey,GG,0,0,64468,Europe,252,13
2020-07-02,Guernsey,GG,0,0,64468,Europe,252,13
2020-07-03,Guernsey,GG,0,0,64468,Europe,252,13
2020-07-04,Guernsey,GG,0,0,64468,Europe,252,13
2020-07-05,Guernsey,GG,0,0,64468,Europe,252,13
2020-07-06,Guernsey,GG,0,0,64468,Europe,252,13
2020-07-07,Guernsey,GG,0,0,64468,Europe,252,13
2020-07-08,Guernsey,GG,0,0,64468,Europe,252,13
2020-07-09,Guernsey,GG,0,0,64468,Europe,252,13
2020-07-10,Guernsey,GG,0,0,64468,Europe,252,13
2020-07-11,Guernsey,GG,0,0,64468,Europe,252,13
2020-07-12,Guernsey,GG,0,0,64468,Europe,252,13
2020-07-13,Guernsey,GG,0,0,64468,Europe,252,13
2020-07-14,Guernsey,GG,0,0,64468,Europe,252,13
2020-07-15,Guernsey,GG,0,0,64468,Europe,252,13
2020-07-16,Guernsey,GG,0,0,64468,Europe,252,13
2020-07-17,Guernsey,GG,0,0,64468,Europe,252,13
2020-07-18,Guernsey,GG,0,0,64468,Europe,252,13
2020-07-19,Guernsey,GG,0,0,64468,Europe,252,13
2020-07-20,Guernsey,GG,0,0,64468,Europe,252,13
2020-07-21,Guernsey,GG,0,0,64468,Europe,252,13
2020-07-22,Guernsey,GG,0,0,64468,Europe,252,13
2020-07-23,Guernsey,GG,0,0,64468,Europe,252,13
2020-07-24,Guernsey,GG,0,0,64468,Europe,252,13
2020-07-25,Guernsey,GG,0,0,64468,Europe,252,13
2020-07-26,Guernsey,GG,0,0,64468,Europe,252,13
2020-07-27,Guernsey,GG,0,0,64468,Europe,252,13
2020-07-28,Guernsey,GG,0,0,64468,Europe,252,13
2020-07-29,Guernsey,GG,0,0,64468,Europe,252,13
2020-07-30,Guernsey,GG,0,0,64468,Europe,252,13
2020-07-31,Guernsey,GG,0,0,64468,Europe,252,13
2020-08-01,Guernsey,GG,0,0,64468,Europe,252,13
2020-08-02,Guernsey,GG,0,0,64468,Europe,252,13
2020-08-03,Guernsey,GG,0,0,64468,Europe,252,13
2020-08-04,Guernsey,GG,0,0,64468,Europe,252,13
2020-08-05,Guernsey,GG,0,0,64468,Europe,252,13
2020-08-06,Guernsey,GG,0,0,64468,Europe,252,13
2020-08-07,Guernsey,GG,0,0,64468,Europe,252,13
2020-08-08,Guernsey,GG,0,0,64468,Europe,252,13
2020-08-09,Guernsey,GG,0,0,64468,Europe,252,13
2020-08-10,Guernsey,GG,0,0,64468,Europe,252,13
2020-08-11,Guernsey,GG,0,0,64468,Europe,252,13
2020-08-12,Guernsey,GG,0,0,64468,Europe,252,13
2020-08-13,Guernsey,GG,0,0,64468,Europe,252,13
2020-08-14,Guernsey,GG,0,0,64468,Europe,252,13
2020-08-15,Guernsey,GG,0,0,64468,Europe,252,13
2020-08-16,Guernsey,GG,0,0,64468,Europe,252,13
2020-08-17,Guernsey,GG,0,0,64468,Europe,252,13
2020-08-18,Guernsey,GG,0,0,64468,Europe,252,13
2020-08-19,Guernsey,GG,0,0,64468,Europe,252,13
2020-08-20,Guernsey,GG,0,0,64468,Europe,252,13
2020-08-21,Guernsey,GG,0,0,64468,Europe,252,13
2020-08-22,Guernsey,GG,0,0,64468,Europe,252,13
2020-08-23,Guernsey,GG,0,0,64468,Europe,252,13
2020-08-24,Guernsey,GG,0,0,64468,Europe,252,13
2020-08-25,Guernsey,GG,0,0,64468,Europe,252,13
2020-08-26,Guernsey,GG,0,0,64468,Europe,252,13
2020-08-27,Guernsey,GG,0,0,64468,Europe,252,13
2020-08-28,Guernsey,GG,0,0,64468,Europe,252,13
2020-08-29,Guernsey,GG,0,0,64468,Europe,252,13
2020-08-30,Guernsey,GG,0,0,64468,Europe,252,13
2020-08-31,Guernsey,GG,0,0,64468,Europe,252,13
2020-09-01,Guernsey,GG,0,0,64468,Europe,252,13
2020-09-02,Guernsey,GG,0,0,64468,Europe,252,13
2020-09-03,Guernsey,GG,0,0,64468,Europe,252,13
2020-09-04,Guernsey,GG,0,0,64468,Europe,252,13
2020-09-05,Guernsey,GG,0,0,64468,Europe,252,13
2020-09-06,Guernsey,GG,0,0,64468,Europe,252,13
2020-09-07,Guernsey,GG,0,0,64468,Europe,252,13
2020-09-08,Guernsey,GG,1,0,64468,Europe,253,13
2020-09-09,Guernsey,GG,0,0,64468,Europe,253,13
2020-09-10,Guernsey,GG,0,0,64468,Europe,253,13
2020-09-11,Guernsey,GG,0,0,64468,Europe,253,13
2020-09-12,Guernsey,GG,0,0,64468,Europe,253,13
2020-09-13,Guernsey,GG,0,0,64468,Europe,253,13
2020-09-14,Guernsey,GG,0,0,64468,Europe,253,13
2020-09-15,Guernsey,GG,0,0,64468,Europe,253,13
2020-09-16,Guernsey,GG,0,0,64468,Europe,253,13
2020-09-17,Guernsey,GG,0,0,64468,Europe,253,13
2020-09-18,Guernsey,GG,0,0,64468,Europe,253,13
2020-09-19,Guernsey,GG,1,0,64468,Europe,254,13
2020-09-20,Guernsey,GG,0,0,64468,Europe,254,13
2020-09-21,Guernsey,GG,1,0,64468,Europe,255,13
2020-09-22,Guernsey,GG,1,0,64468,Europe,256,13
2020-09-23,Guernsey,GG,0,0,64468,Europe,256,13
2020-09-24,Guernsey,GG,0,0,64468,Europe,256,13
2020-09-25,Guernsey,GG,0,0,64468,Europe,256,13
2020-09-26,Guernsey,GG,0,0,64468,Europe,256,13
2020-09-27,Guernsey,GG,0,0,64468,Europe,256,13
2020-09-28,Guernsey,GG,0,0,64468,Europe,256,13
2020-09-29,Guernsey,GG,0,0,64468,Europe,256,13
2020-09-30,Guernsey,GG,0,0,64468,Europe,256,13
2020-10-01,Guernsey,GG,0,0,64468,Europe,256,13
2020-10-02,Guernsey,GG,0,0,64468,Europe,256,13
2020-10-03,Guernsey,GG,0,0,64468,Europe,256,13
2020-10-04,Guernsey,GG,1,0,64468,Europe,257,13
2020-10-05,Guernsey,GG,0,0,64468,Europe,257,13
2020-10-06,Guernsey,GG,0,0,64468,Europe,257,13
2020-10-07,Guernsey,GG,0,0,64468,Europe,257,13
2020-10-08,Guernsey,GG,0,0,64468,Europe,257,13
2020-10-09,Guernsey,GG,1,0,64468,Europe,258,13
2020-10-10,Guernsey,GG,0,0,64468,Europe,258,13
2020-10-11,Guernsey,GG,0,0,64468,Europe,258,13
2020-10-12,Guernsey,GG,0,0,64468,Europe,258,13
2020-10-13,Guernsey,GG,0,0,64468,Europe,258,13
2020-10-14,Guernsey,GG,0,0,64468,Europe,258,13
2020-10-15,Guernsey,GG,0,0,64468,Europe,258,13
2020-10-16,Guernsey,GG,0,0,64468,Europe,258,13
2020-10-17,Guernsey,GG,0,0,64468,Europe,258,13
2020-10-18,Guernsey,GG,0,0,64468,Europe,258,13
2020-10-19,Guernsey,GG,0,0,64468,Europe,258,13
2020-10-20,Guernsey,GG,0,0,64468,Europe,258,13
2020-10-21,Guernsey,GG,1,0,64468,Europe,259,13
2020-10-22,Guernsey,GG,1,0,64468,Europe,260,13
2020-10-23,Guernsey,GG,2,0,64468,Europe,262,13
2020-10-24,Guernsey,GG,3,0,64468,Europe,265,13
2020-10-25,Guernsey,GG,0,0,64468,Europe,265,13
2020-10-26,Guernsey,GG,0,0,64468,Europe,265,13
2020-10-27,Guernsey,GG,1,0,64468,Europe,266,13
2020-10-28,Guernsey,GG,0,0,64468,Europe,266,13
2020-10-29,Guernsey,GG,1,0,64468,Europe,267,13
2020-10-30,Guernsey,GG,0,0,64468,Europe,267,13
2020-10-31,Guernsey,GG,0,0,64468,Europe,267,13
2020-11-01,Guernsey,GG,1,0,64468,Europe,268,13
2020-11-02,Guernsey,GG,2,0,64468,Europe,270,13
2020-11-03,Guernsey,GG,1,0,64468,Europe,271,13
2020-11-04,Guernsey,GG,1,0,64468,Europe,272,13
2020-11-05,Guernsey,GG,1,0,64468,Europe,273,13
2020-11-06,Guernsey,GG,1,0,64468,Europe,274,13
2020-11-07,Guernsey,GG,4,0,64468,Europe,278,13
2020-11-08,Guernsey,GG,1,0,64468,Europe,279,13
2020-11-09,Guernsey,GG,0,0,64468,Europe,279,13
2020-11-10,Guernsey,GG,0,0,64468,Europe,279,13
2020-11-11,Guernsey,GG,3,0,64468,Europe,282,13
2020-11-12,Guernsey,GG,0,0,64468,Europe,282,13
2020-11-13,Guernsey,GG,0,0,64468,Europe,282,13
2020-11-14,Guernsey,GG,0,0,64468,Europe,282,13
2020-11-15,Guernsey,GG,0,0,64468,Europe,282,13
2020-11-16,Guernsey,GG,0,0,64468,Europe,282,13
2020-11-17,Guernsey,GG,0,0,64468,Europe,282,13
2020-11-18,Guernsey,GG,0,0,64468,Europe,282,13
2020-11-19,Guernsey,GG,0,0,64468,Europe,282,13
2020-11-20,Guernsey,GG,0,0,64468,Europe,282,13
2020-11-21,Guernsey,GG,1,0,64468,Europe,283,13
2020-11-22,Guernsey,GG,0,0,64468,Europe,283,13
2020-11-23,Guernsey,GG,0,0,64468,Europe,283,13
2020-11-24,Guernsey,GG,0,0,64468,Europe,283,13
2020-11-25,Guernsey,GG,0,0,64468,Europe,283,13
2020-11-26,Guernsey,GG,2,0,64468,Europe,285,13
2020-11-27,Guernsey,GG,1,0,64468,Europe,286,13
2020-11-28,Guernsey,GG,0,0,64468,Europe,286,13
2020-11-29,Guernsey,GG,0,0,64468,Europe,286,13
2020-11-30,Guernsey,GG,0,0,64468,Europe,286,13
2020-12-01,Guernsey,GG,1,0,64468,Europe,287,13
2020-12-02,Guernsey,GG,0,0,64468,Europe,287,13
2020-12-03,Guernsey,GG,0,0,64468,Europe,287,13
2020-12-04,Guernsey,GG,1,0,64468,Europe,288,13
2020-12-05,Guernsey,GG,0,0,64468,Europe,288,13
2020-12-06,Guernsey,GG,0,0,64468,Europe,288,13
2020-12-07,Guernsey,GG,0,0,64468,Europe,288,13
2020-12-08,Guernsey,GG,0,0,64468,Europe,288,13
2020-12-09,Guernsey,GG,0,0,64468,Europe,288,13
2020-12-10,Guernsey,GG,1,0,64468,Europe,289,13
2020-12-11,Guernsey,GG,0,0,64468,Europe,289,13
2020-12-12,Guernsey,GG,0,0,64468,Europe,289,13
2020-12-13,Guernsey,GG,0,0,64468,Europe,289,13
2020-12-14,Guernsey,GG,0,0,64468,Europe,289,13
2020-03-13,Ghana,GH,2,0,30417858,Africa,2,0
2020-03-15,Ghana,GH,0,0,30417858,Africa,2,0
2020-03-16,Ghana,GH,0,0,30417858,Africa,2,0
2020-03-17,Ghana,GH,4,0,30417858,Africa,6,0
2020-03-18,Ghana,GH,0,0,30417858,Africa,6,0
2020-03-19,Ghana,GH,1,0,30417858,Africa,7,0
2020-03-20,Ghana,GH,4,0,30417858,Africa,11,0
2020-03-21,Ghana,GH,5,0,30417858,Africa,16,0
2020-03-22,Ghana,GH,5,1,30417858,Africa,21,1
2020-03-23,Ghana,GH,3,0,30417858,Africa,24,1
2020-03-24,Ghana,GH,3,1,30417858,Africa,27,2
2020-03-25,Ghana,GH,26,0,30417858,Africa,53,2
2020-03-26,Ghana,GH,15,1,30417858,Africa,68,3
2020-03-27,Ghana,GH,64,0,30417858,Africa,132,3
2020-03-28,Ghana,GH,5,0,30417858,Africa,137,3
2020-03-29,Ghana,GH,4,2,30417858,Africa,141,5
2020-03-30,Ghana,GH,11,0,30417858,Africa,152,5
2020-03-31,Ghana,GH,0,0,30417858,Africa,152,5
2020-04-01,Ghana,GH,0,0,30417858,Africa,152,5
2020-04-02,Ghana,GH,43,0,30417858,Africa,195,5
2020-04-03,Ghana,GH,9,0,30417858,Africa,204,5
2020-04-04,Ghana,GH,1,0,30417858,Africa,205,5
2020-04-05,Ghana,GH,9,0,30417858,Africa,214,5
2020-04-06,Ghana,GH,0,0,30417858,Africa,214,5
2020-04-07,Ghana,GH,73,0,30417858,Africa,287,5
2020-04-08,Ghana,GH,0,0,30417858,Africa,287,5
2020-04-09,Ghana,GH,26,1,30417858,Africa,313,6
2020-04-10,Ghana,GH,65,0,30417858,Africa,378,6
2020-04-11,Ghana,GH,0,0,30417858,Africa,378,6
2020-04-12,Ghana,GH,30,2,30417858,Africa,408,8
2020-04-13,Ghana,GH,158,0,30417858,Africa,566,8
2020-04-14,Ghana,GH,0,0,30417858,Africa,566,8
2020-04-15,Ghana,GH,70,0,30417858,Africa,636,8
2020-04-16,Ghana,GH,5,0,30417858,Africa,641,8
2020-04-17,Ghana,GH,0,0,30417858,Africa,641,8
2020-04-18,Ghana,GH,0,0,30417858,Africa,641,8
2020-04-19,Ghana,GH,193,1,30417858,Africa,834,9
2020-04-20,Ghana,GH,208,0,30417858,Africa,1042,9
2020-04-21,Ghana,GH,0,0,30417858,Africa,1042,9
2020-04-22,Ghana,GH,0,0,30417858,Africa,1042,9
2020-04-23,Ghana,GH,112,0,30417858,Africa,1154,9
2020-04-24,Ghana,GH,0,0,30417858,Africa,1154,9
2020-04-25,Ghana,GH,125,1,30417858,Africa,1279,10
2020-04-26,Ghana,GH,0,0,30417858,Africa,1279,10
2020-04-27,Ghana,GH,271,1,30417858,Africa,1550,11
2020-04-28,Ghana,GH,0,0,30417858,Africa,1550,11
2020-04-29,Ghana,GH,121,5,30417858,Africa,1671,16
2020-04-30,Ghana,GH,0,0,30417858,Africa,1671,16
2020-05-01,Ghana,GH,403,1,30417858,Africa,2074,17
2020-05-02,Ghana,GH,0,0,30417858,Africa,2074,17
2020-05-03,Ghana,GH,95,1,30417858,Africa,2169,18
2020-05-04,Ghana,GH,0,0,30417858,Africa,2169,18
2020-05-05,Ghana,GH,550,0,30417858,Africa,2719,18
2020-05-06,Ghana,GH,0,0,30417858,Africa,2719,18
2020-05-07,Ghana,GH,372,0,30417858,Africa,3091,18
2020-05-08,Ghana,GH,0,0,30417858,Africa,3091,18
2020-05-09,Ghana,GH,921,0,30417858,Africa,4012,18
2020-05-10,Ghana,GH,251,4,30417858,Africa,4263,22
2020-05-11,Ghana,GH,0,0,30417858,Africa,4263,22
2020-05-12,Ghana,GH,437,0,30417858,Africa,4700,22
2020-05-13,Ghana,GH,427,0,30417858,Africa,5127,22
2020-05-14,Ghana,GH,281,2,30417858,Africa,5408,24
2020-05-15,Ghana,GH,122,0,30417858,Africa,5530,24
2020-05-16,Ghana,GH,108,4,30417858,Africa,5638,28
2020-05-17,Ghana,GH,97,1,30417858,Africa,5735,29
2020-05-18,Ghana,GH,0,0,30417858,Africa,5735,29
2020-05-19,Ghana,GH,0,0,30417858,Africa,5735,29
2020-05-20,Ghana,GH,361,2,30417858,Africa,6096,31
2020-05-21,Ghana,GH,173,0,30417858,Africa,6269,31
2020-05-22,Ghana,GH,217,0,30417858,Africa,6486,31
2020-05-23,Ghana,GH,131,0,30417858,Africa,6617,31
2020-05-24,Ghana,GH,0,0,30417858,Africa,6617,31
2020-05-25,Ghana,GH,66,1,30417858,Africa,6683,32
2020-05-26,Ghana,GH,125,0,30417858,Africa,6808,32
2020-05-27,Ghana,GH,309,2,30417858,Africa,7117,34
2020-05-28,Ghana,GH,186,0,30417858,Africa,7303,34
2020-05-29,Ghana,GH,0,0,30417858,Africa,7303,34
2020-05-30,Ghana,GH,313,0,30417858,Africa,7616,34
2020-05-31,Ghana,GH,152,1,30417858,Africa,7768,35
2020-06-01,Ghana,GH,302,1,30417858,Africa,8070,36
2020-06-02,Ghana,GH,0,0,30417858,Africa,8070,36
2020-06-03,Ghana,GH,227,2,30417858,Africa,8297,38
2020-06-04,Ghana,GH,251,0,30417858,Africa,8548,38
2020-06-05,Ghana,GH,337,0,30417858,Africa,8885,38
2020-06-06,Ghana,GH,283,4,30417858,Africa,9168,42
2020-06-07,Ghana,GH,294,2,30417858,Africa,9462,44
2020-06-08,Ghana,GH,176,0,30417858,Africa,9638,44
2020-06-09,Ghana,GH,272,4,30417858,Africa,9910,48
2020-06-10,Ghana,GH,291,0,30417858,Africa,10201,48
2020-06-11,Ghana,GH,157,0,30417858,Africa,10358,48
2020-06-12,Ghana,GH,0,0,30417858,Africa,10358,48
2020-06-13,Ghana,GH,760,0,30417858,Africa,11118,48
2020-06-14,Ghana,GH,304,3,30417858,Africa,11422,51
2020-06-15,Ghana,GH,542,3,30417858,Africa,11964,54
2020-06-16,Ghana,GH,0,0,30417858,Africa,11964,54
2020-06-17,Ghana,GH,229,4,30417858,Africa,12193,58
2020-06-18,Ghana,GH,397,8,30417858,Africa,12590,66
2020-06-19,Ghana,GH,339,0,30417858,Africa,12929,66
2020-06-20,Ghana,GH,274,4,30417858,Africa,13203,70
2020-06-21,Ghana,GH,508,15,30417858,Africa,13711,85
2020-06-22,Ghana,GH,443,0,30417858,Africa,14154,85
2020-06-23,Ghana,GH,0,0,30417858,Africa,14154,85
2020-06-24,Ghana,GH,414,10,30417858,Africa,14568,95
2020-06-25,Ghana,GH,445,0,30417858,Africa,15013,95
2020-06-26,Ghana,GH,460,0,30417858,Africa,15473,95
2020-06-27,Ghana,GH,361,8,30417858,Africa,15834,103
2020-06-28,Ghana,GH,597,0,30417858,Africa,16431,103
2020-06-29,Ghana,GH,920,9,30417858,Africa,17351,112
2020-06-30,Ghana,GH,0,0,30417858,Africa,17351,112
2020-07-01,Ghana,GH,390,0,30417858,Africa,17741,112
2020-07-02,Ghana,GH,393,5,30417858,Africa,18134,117
2020-07-03,Ghana,GH,0,0,30417858,Africa,18134,117
2020-07-04,Ghana,GH,1254,0,30417858,Africa,19388,117
2020-07-05,Ghana,GH,0,0,30417858,Africa,19388,117
2020-07-06,Ghana,GH,697,5,30417858,Africa,20085,122
2020-07-07,Ghana,GH,992,7,30417858,Africa,21077,129
2020-07-08,Ghana,GH,891,0,30417858,Africa,21968,129
2020-07-09,Ghana,GH,854,0,30417858,Africa,22822,129
2020-07-10,Ghana,GH,641,0,30417858,Africa,23463,129
2020-07-11,Ghana,GH,371,6,30417858,Africa,23834,135
2020-07-12,Ghana,GH,414,0,30417858,Africa,24248,135
2020-07-13,Ghana,GH,270,4,30417858,Africa,24518,139
2020-07-14,Ghana,GH,470,0,30417858,Africa,24988,139
2020-07-15,Ghana,GH,0,0,30417858,Africa,24988,139
2020-07-16,Ghana,GH,442,0,30417858,Africa,25430,139
2020-07-17,Ghana,GH,695,0,30417858,Africa,26125,139
2020-07-18,Ghana,GH,447,5,30417858,Africa,26572,144
2020-07-19,Ghana,GH,488,1,30417858,Africa,27060,145
2020-07-20,Ghana,GH,607,3,30417858,Africa,27667,148
2020-07-21,Ghana,GH,763,5,30417858,Africa,28430,153
2020-07-22,Ghana,GH,559,0,30417858,Africa,28989,153
2020-07-23,Ghana,GH,683,0,30417858,Africa,29672,153
2020-07-24,Ghana,GH,694,0,30417858,Africa,30366,153
2020-07-25,Ghana,GH,691,8,30417858,Africa,31057,161
2020-07-26,Ghana,GH,794,0,30417858,Africa,31851,161
2020-07-27,Ghana,GH,1118,7,30417858,Africa,32969,168
2020-07-28,Ghana,GH,655,0,30417858,Africa,33624,168
2020-07-29,Ghana,GH,782,0,30417858,Africa,34406,168
2020-07-30,Ghana,GH,736,7,30417858,Africa,35142,175
2020-07-31,Ghana,GH,0,0,30417858,Africa,35142,175
2020-08-01,Ghana,GH,359,7,30417858,Africa,35501,182
2020-08-02,Ghana,GH,1513,0,30417858,Africa,37014,182
2020-08-03,Ghana,GH,0,0,30417858,Africa,37014,182
2020-08-04,Ghana,GH,798,9,30417858,Africa,37812,191
2020-08-05,Ghana,GH,0,0,30417858,Africa,37812,191
2020-08-06,Ghana,GH,1263,8,30417858,Africa,39075,199
2020-08-07,Ghana,GH,1022,7,30417858,Africa,40097,206
2020-08-08,Ghana,GH,0,0,30417858,Africa,40097,206
2020-08-09,Ghana,GH,436,0,30417858,Africa,40533,206
2020-08-10,Ghana,GH,470,9,30417858,Africa,41003,215
2020-08-11,Ghana,GH,209,0,30417858,Africa,41212,215
2020-08-12,Ghana,GH,192,0,30417858,Africa,41404,215
2020-08-13,Ghana,GH,321,8,30417858,Africa,41725,223
2020-08-14,Ghana,GH,122,0,30417858,Africa,41847,223
2020-08-15,Ghana,GH,216,8,30417858,Africa,42063,231
2020-08-16,Ghana,GH,147,0,30417858,Africa,42210,231
2020-08-17,Ghana,GH,322,0,30417858,Africa,42532,231
2020-08-18,Ghana,GH,121,8,30417858,Africa,42653,239
2020-08-19,Ghana,GH,340,9,30417858,Africa,42993,248
2020-08-20,Ghana,GH,101,8,30417858,Africa,43094,256
2020-08-21,Ghana,GH,166,5,30417858,Africa,43260,261
2020-08-22,Ghana,GH,65,0,30417858,Africa,43325,261
2020-08-23,Ghana,GH,180,0,30417858,Africa,43505,261
2020-08-24,Ghana,GH,0,0,30417858,Africa,43505,261
2020-08-25,Ghana,GH,117,2,30417858,Africa,43622,263
2020-08-26,Ghana,GH,95,7,30417858,Africa,43717,270
2020-08-27,Ghana,GH,124,0,30417858,Africa,43841,270
2020-08-28,Ghana,GH,0,0,30417858,Africa,43841,270
2020-08-29,Ghana,GH,108,0,30417858,Africa,43949,270
2020-08-30,Ghana,GH,169,0,30417858,Africa,44118,270
2020-08-31,Ghana,GH,87,6,30417858,Africa,44205,276
2020-09-01,Ghana,GH,93,0,30417858,Africa,44298,276
2020-09-02,Ghana,GH,162,0,30417858,Africa,44460,276
2020-09-03,Ghana,GH,198,0,30417858,Africa,44658,276
2020-09-04,Ghana,GH,55,4,30417858,Africa,44713,280
2020-09-05,Ghana,GH,64,3,30417858,Africa,44777,283
2020-09-06,Ghana,GH,0,0,30417858,Africa,44777,283
2020-09-07,Ghana,GH,0,0,30417858,Africa,44777,283
2020-09-08,Ghana,GH,235,0,30417858,Africa,45012,283
2020-09-09,Ghana,GH,0,0,30417858,Africa,45012,283
2020-09-10,Ghana,GH,301,0,30417858,Africa,45313,283
2020-09-11,Ghana,GH,0,0,30417858,Africa,45313,283
2020-09-12,Ghana,GH,75,2,30417858,Africa,45388,285
2020-09-13,Ghana,GH,46,1,30417858,Africa,45434,286
2020-09-14,Ghana,GH,0,0,30417858,Africa,45434,286
2020-09-15,Ghana,GH,167,8,30417858,Africa,45601,294
2020-09-16,Ghana,GH,54,0,30417858,Africa,45655,294
2020-09-17,Ghana,GH,0,0,30417858,Africa,45655,294
2020-09-18,Ghana,GH,59,0,30417858,Africa,45714,294
2020-09-19,Ghana,GH,143,1,30417858,Africa,45857,295
2020-09-20,Ghana,GH,20,2,30417858,Africa,45877,297
2020-09-21,Ghana,GH,127,0,30417858,Africa,46004,297
2020-09-22,Ghana,GH,58,0,30417858,Africa,46062,297
2020-09-23,Ghana,GH,54,0,30417858,Africa,46116,297
2020-09-24,Ghana,GH,37,2,30417858,Africa,46153,299
2020-09-25,Ghana,GH,69,0,30417858,Africa,46222,299
2020-09-26,Ghana,GH,0,0,30417858,Africa,46222,299
2020-09-27,Ghana,GH,0,0,30417858,Africa,46222,299
2020-09-28,Ghana,GH,165,0,30417858,Africa,46387,299
2020-09-29,Ghana,GH,95,2,30417858,Africa,46482,301
2020-09-30,Ghana,GH,0,0,30417858,Africa,46482,301
2020-10-01,Ghana,GH,174,0,30417858,Africa,46656,301
2020-10-02,Ghana,GH,0,0,30417858,Africa,46656,301
2020-10-03,Ghana,GH,38,0,30417858,Africa,46694,301
2020-10-04,Ghana,GH,109,2,30417858,Africa,46803,303
2020-10-05,Ghana,GH,26,0,30417858,Africa,46829,303
2020-10-06,Ghana,GH,0,0,30417858,Africa,46829,303
2020-10-07,Ghana,GH,0,0,30417858,Africa,46829,303
2020-10-08,Ghana,GH,0,0,30417858,Africa,46829,303
2020-10-09,Ghana,GH,118,3,30417858,Africa,46947,306
2020-10-10,Ghana,GH,40,0,30417858,Africa,46987,306
2020-10-11,Ghana,GH,18,0,30417858,Africa,47005,306
2020-10-12,Ghana,GH,0,0,30417858,Africa,47005,306
2020-10-13,Ghana,GH,25,2,30417858,Africa,47030,308
2020-10-14,Ghana,GH,96,2,30417858,Africa,47126,310
2020-10-15,Ghana,GH,0,0,30417858,Africa,47126,310
2020-10-16,Ghana,GH,47,0,30417858,Africa,47173,310
2020-10-17,Ghana,GH,0,0,30417858,Africa,47173,310
2020-10-18,Ghana,GH,59,0,30417858,Africa,47232,310
2020-10-19,Ghana,GH,78,0,30417858,Africa,47310,310
2020-10-20,Ghana,GH,62,0,30417858,Africa,47372,310
2020-10-21,Ghana,GH,89,2,30417858,Africa,47461,312
2020-10-22,Ghana,GH,0,0,30417858,Africa,47461,312
2020-10-23,Ghana,GH,77,0,30417858,Africa,47538,312
2020-10-24,Ghana,GH,63,2,30417858,Africa,47601,314
2020-10-25,Ghana,GH,89,2,30417858,Africa,47690,316
2020-10-26,Ghana,GH,0,0,30417858,Africa,47690,316
2020-10-27,Ghana,GH,85,0,30417858,Africa,47775,316
2020-10-28,Ghana,GH,0,0,30417858,Africa,47775,316
2020-10-29,Ghana,GH,0,0,30417858,Africa,47775,316
2020-10-30,Ghana,GH,280,4,30417858,Africa,48055,320
2020-10-31,Ghana,GH,0,0,30417858,Africa,48055,320
2020-11-01,Ghana,GH,69,0,30417858,Africa,48124,320
2020-11-02,Ghana,GH,0,0,30417858,Africa,48124,320
2020-11-03,Ghana,GH,76,0,30417858,Africa,48200,320
2020-11-04,Ghana,GH,0,0,30417858,Africa,48200,320
2020-11-05,Ghana,GH,443,0,30417858,Africa,48643,320
2020-11-06,Ghana,GH,145,0,30417858,Africa,48788,320
2020-11-07,Ghana,GH,0,0,30417858,Africa,48788,320
2020-11-08,Ghana,GH,116,0,30417858,Africa,48904,320
2020-11-09,Ghana,GH,298,0,30417858,Africa,49202,320
2020-11-10,Ghana,GH,0,0,30417858,Africa,49202,320
2020-11-11,Ghana,GH,100,0,30417858,Africa,49302,320
2020-11-12,Ghana,GH,0,0,30417858,Africa,49302,320
2020-11-13,Ghana,GH,716,0,30417858,Africa,50018,320
2020-11-14,Ghana,GH,0,0,30417858,Africa,50018,320
2020-11-15,Ghana,GH,0,0,30417858,Africa,50018,320
2020-11-16,Ghana,GH,105,2,30417858,Africa,50123,322
2020-11-17,Ghana,GH,253,1,30417858,Africa,50376,323
2020-11-18,Ghana,GH,81,0,30417858,Africa,50457,323
2020-11-19,Ghana,GH,0,0,30417858,Africa,50457,323
2020-11-20,Ghana,GH,174,0,30417858,Africa,50631,323
2020-11-21,Ghana,GH,0,0,30417858,Africa,50631,323
2020-11-22,Ghana,GH,243,0,30417858,Africa,50874,323
2020-11-23,Ghana,GH,0,0,30417858,Africa,50874,323
2020-11-24,Ghana,GH,67,0,30417858,Africa,50941,323
2020-11-25,Ghana,GH,243,0,30417858,Africa,51184,323
2020-11-26,Ghana,GH,41,0,30417858,Africa,51225,323
2020-11-27,Ghana,GH,0,0,30417858,Africa,51225,323
2020-11-28,Ghana,GH,0,0,30417858,Africa,51225,323
2020-11-29,Ghana,GH,154,0,30417858,Africa,51379,323
2020-11-30,Ghana,GH,190,0,30417858,Africa,51569,323
2020-12-01,Ghana,GH,98,0,30417858,Africa,51667,323
2020-12-02,Ghana,GH,0,0,30417858,Africa,51667,323
2020-12-03,Ghana,GH,0,0,30417858,Africa,51667,323
2020-12-04,Ghana,GH,0,0,30417858,Africa,51667,323
2020-12-05,Ghana,GH,429,2,30417858,Africa,52096,325
2020-12-06,Ghana,GH,102,0,30417858,Africa,52198,325
2020-12-07,Ghana,GH,76,0,30417858,Africa,52274,325
2020-12-08,Ghana,GH,0,0,30417858,Africa,52274,325
2020-12-09,Ghana,GH,226,1,30417858,Africa,52500,326
2020-12-10,Ghana,GH,122,0,30417858,Africa,52622,326
2020-12-11,Ghana,GH,116,0,30417858,Africa,52738,326
2020-12-12,Ghana,GH,0,0,30417858,Africa,52738,326
2020-12-13,Ghana,GH,195,1,30417858,Africa,52933,327
2020-12-14,Ghana,GH,81,0,30417858,Africa,53014,327
2020-03-20,Gibraltar,GI,10,0,33706,Europe,10,0
2020-03-21,Gibraltar,GI,0,0,33706,Europe,10,0
2020-03-22,Gibraltar,GI,0,0,33706,Europe,10,0
2020-03-23,Gibraltar,GI,5,0,33706,Europe,15,0
2020-03-24,Gibraltar,GI,0,0,33706,Europe,15,0
2020-03-25,Gibraltar,GI,0,0,33706,Europe,15,0
2020-03-26,Gibraltar,GI,11,0,33706,Europe,26,0
2020-03-27,Gibraltar,GI,9,0,33706,Europe,35,0
2020-03-28,Gibraltar,GI,20,0,33706,Europe,55,0
2020-03-29,Gibraltar,GI,1,0,33706,Europe,56,0
2020-03-30,Gibraltar,GI,9,0,33706,Europe,65,0
2020-03-31,Gibraltar,GI,4,0,33706,Europe,69,0
2020-04-01,Gibraltar,GI,0,0,33706,Europe,69,0
2020-04-02,Gibraltar,GI,0,0,33706,Europe,69,0
2020-04-03,Gibraltar,GI,19,0,33706,Europe,88,0
2020-04-04,Gibraltar,GI,7,0,33706,Europe,95,0
2020-04-05,Gibraltar,GI,3,0,33706,Europe,98,0
2020-04-06,Gibraltar,GI,5,0,33706,Europe,103,0
2020-04-07,Gibraltar,GI,6,0,33706,Europe,109,0
2020-04-08,Gibraltar,GI,4,0,33706,Europe,113,0
2020-04-09,Gibraltar,GI,7,0,33706,Europe,120,0
2020-04-10,Gibraltar,GI,3,0,33706,Europe,123,0
2020-04-11,Gibraltar,GI,4,0,33706,Europe,127,0
2020-04-12,Gibraltar,GI,2,0,33706,Europe,129,0
2020-04-13,Gibraltar,GI,0,0,33706,Europe,129,0
2020-04-14,Gibraltar,GI,0,0,33706,Europe,129,0
2020-04-15,Gibraltar,GI,0,0,33706,Europe,129,0
2020-04-16,Gibraltar,GI,2,0,33706,Europe,131,0
2020-04-17,Gibraltar,GI,2,0,33706,Europe,133,0
2020-04-18,Gibraltar,GI,0,0,33706,Europe,133,0
2020-04-19,Gibraltar,GI,0,0,33706,Europe,133,0
2020-04-20,Gibraltar,GI,0,0,33706,Europe,133,0
2020-04-21,Gibraltar,GI,0,0,33706,Europe,133,0
2020-04-22,Gibraltar,GI,0,0,33706,Europe,133,0
2020-04-23,Gibraltar,GI,0,0,33706,Europe,133,0
2020-04-24,Gibraltar,GI,0,0,33706,Europe,133,0
2020-04-25,Gibraltar,GI,0,0,33706,Europe,133,0
2020-04-26,Gibraltar,GI,3,0,33706,Europe,136,0
2020-04-27,Gibraltar,GI,5,0,33706,Europe,141,0
2020-04-28,Gibraltar,GI,0,0,33706,Europe,141,0
2020-04-29,Gibraltar,GI,0,0,33706,Europe,141,0
2020-04-30,Gibraltar,GI,0,0,33706,Europe,141,0
2020-05-01,Gibraltar,GI,3,0,33706,Europe,144,0
2020-05-02,Gibraltar,GI,0,0,33706,Europe,144,0
2020-05-03,Gibraltar,GI,0,0,33706,Europe,144,0
2020-05-04,Gibraltar,GI,0,0,33706,Europe,144,0
2020-05-05,Gibraltar,GI,0,0,33706,Europe,144,0
2020-05-06,Gibraltar,GI,0,0,33706,Europe,144,0
2020-05-07,Gibraltar,GI,0,0,33706,Europe,144,0
2020-05-08,Gibraltar,GI,0,0,33706,Europe,144,0
2020-05-09,Gibraltar,GI,2,0,33706,Europe,146,0
2020-05-10,Gibraltar,GI,0,0,33706,Europe,146,0
2020-05-11,Gibraltar,GI,0,0,33706,Europe,146,0
2020-05-12,Gibraltar,GI,1,0,33706,Europe,147,0
2020-05-13,Gibraltar,GI,0,0,33706,Europe,147,0
2020-05-14,Gibraltar,GI,0,0,33706,Europe,147,0
2020-05-15,Gibraltar,GI,0,0,33706,Europe,147,0
2020-05-16,Gibraltar,GI,0,0,33706,Europe,147,0
2020-05-17,Gibraltar,GI,0,0,33706,Europe,147,0
2020-05-18,Gibraltar,GI,0,0,33706,Europe,147,0
2020-05-19,Gibraltar,GI,0,0,33706,Europe,147,0
2020-05-20,Gibraltar,GI,0,0,33706,Europe,147,0
2020-05-21,Gibraltar,GI,2,0,33706,Europe,149,0
2020-05-22,Gibraltar,GI,2,0,33706,Europe,151,0
2020-05-23,Gibraltar,GI,0,0,33706,Europe,151,0
2020-05-24,Gibraltar,GI,0,0,33706,Europe,151,0
2020-05-25,Gibraltar,GI,0,0,33706,Europe,151,0
2020-05-26,Gibraltar,GI,4,0,33706,Europe,155,0
2020-05-27,Gibraltar,GI,0,0,33706,Europe,155,0
2020-05-28,Gibraltar,GI,2,0,33706,Europe,157,0
2020-05-29,Gibraltar,GI,0,0,33706,Europe,157,0
2020-05-30,Gibraltar,GI,4,0,33706,Europe,161,0
2020-05-31,Gibraltar,GI,0,0,33706,Europe,161,0
2020-06-01,Gibraltar,GI,8,0,33706,Europe,169,0
2020-06-02,Gibraltar,GI,1,0,33706,Europe,170,0
2020-06-03,Gibraltar,GI,2,0,33706,Europe,172,0
2020-06-04,Gibraltar,GI,1,0,33706,Europe,173,0
2020-06-05,Gibraltar,GI,0,0,33706,Europe,173,0
2020-06-06,Gibraltar,GI,1,0,33706,Europe,174,0
2020-06-07,Gibraltar,GI,0,0,33706,Europe,174,0
2020-06-08,Gibraltar,GI,1,0,33706,Europe,175,0
2020-06-09,Gibraltar,GI,1,0,33706,Europe,176,0
2020-06-10,Gibraltar,GI,0,0,33706,Europe,176,0
2020-06-11,Gibraltar,GI,0,0,33706,Europe,176,0
2020-06-12,Gibraltar,GI,0,0,33706,Europe,176,0
2020-06-13,Gibraltar,GI,0,0,33706,Europe,176,0
2020-06-14,Gibraltar,GI,0,0,33706,Europe,176,0
2020-06-15,Gibraltar,GI,0,0,33706,Europe,176,0
2020-06-16,Gibraltar,GI,0,0,33706,Europe,176,0
2020-06-17,Gibraltar,GI,0,0,33706,Europe,176,0
2020-06-18,Gibraltar,GI,0,0,33706,Europe,176,0
2020-06-19,Gibraltar,GI,0,0,33706,Europe,176,0
2020-06-20,Gibraltar,GI,0,0,33706,Europe,176,0
2020-06-21,Gibraltar,GI,0,0,33706,Europe,176,0
2020-06-22,Gibraltar,GI,0,0,33706,Europe,176,0
2020-06-23,Gibraltar,GI,0,0,33706,Europe,176,0
2020-06-24,Gibraltar,GI,0,0,33706,Europe,176,0
2020-06-25,Gibraltar,GI,0,0,33706,Europe,176,0
2020-06-26,Gibraltar,GI,0,0,33706,Europe,176,0
2020-06-27,Gibraltar,GI,0,0,33706,Europe,176,0
2020-06-28,Gibraltar,GI,0,0,33706,Europe,176,0
2020-06-29,Gibraltar,GI,1,0,33706,Europe,177,0
2020-06-30,Gibraltar,GI,0,0,33706,Europe,177,0
2020-07-01,Gibraltar,GI,0,0,33706,Europe,177,0
2020-07-02,Gibraltar,GI,1,0,33706,Europe,178,0
2020-07-03,Gibraltar,GI,0,0,33706,Europe,178,0
2020-07-04,Gibraltar,GI,0,0,33706,Europe,178,0
2020-07-05,Gibraltar,GI,0,0,33706,Europe,178,0
2020-07-06,Gibraltar,GI,0,0,33706,Europe,178,0
2020-07-07,Gibraltar,GI,1,0,33706,Europe,179,0
2020-07-08,Gibraltar,GI,0,0,33706,Europe,179,0
2020-07-09,Gibraltar,GI,0,0,33706,Europe,179,0
2020-07-10,Gibraltar,GI,1,0,33706,Europe,180,0
2020-07-11,Gibraltar,GI,0,0,33706,Europe,180,0
2020-07-12,Gibraltar,GI,0,0,33706,Europe,180,0
2020-07-13,Gibraltar,GI,0,0,33706,Europe,180,0
2020-07-14,Gibraltar,GI,0,0,33706,Europe,180,0
2020-07-15,Gibraltar,GI,0,0,33706,Europe,180,0
2020-07-16,Gibraltar,GI,0,0,33706,Europe,180,0
2020-07-17,Gibraltar,GI,0,0,33706,Europe,180,0
2020-07-18,Gibraltar,GI,0,0,33706,Europe,180,0
2020-07-19,Gibraltar,GI,0,0,33706,Europe,180,0
2020-07-20,Gibraltar,GI,0,0,33706,Europe,180,0
2020-07-21,Gibraltar,GI,0,0,33706,Europe,180,0
2020-07-22,Gibraltar,GI,0,0,33706,Europe,180,0
2020-07-23,Gibraltar,GI,2,0,33706,Europe,182,0
2020-07-24,Gibraltar,GI,2,0,33706,Europe,184,0
2020-07-25,Gibraltar,GI,0,0,33706,Europe,184,0
2020-07-26,Gibraltar,GI,1,0,33706,Europe,185,0
2020-07-27,Gibraltar,GI,0,0,33706,Europe,185,0
2020-07-28,Gibraltar,GI,0,0,33706,Europe,185,0
2020-07-29,Gibraltar,GI,1,0,33706,Europe,186,0
2020-07-30,Gibraltar,GI,0,0,33706,Europe,186,0
2020-07-31,Gibraltar,GI,1,0,33706,Europe,187,0
2020-08-01,Gibraltar,GI,0,0,33706,Europe,187,0
2020-08-02,Gibraltar,GI,1,0,33706,Europe,188,0
2020-08-03,Gibraltar,GI,0,0,33706,Europe,188,0
2020-08-04,Gibraltar,GI,0,0,33706,Europe,188,0
2020-08-05,Gibraltar,GI,1,0,33706,Europe,189,0
2020-08-06,Gibraltar,GI,0,0,33706,Europe,189,0
2020-08-07,Gibraltar,GI,1,0,33706,Europe,190,0
2020-08-08,Gibraltar,GI,0,0,33706,Europe,190,0
2020-08-09,Gibraltar,GI,7,0,33706,Europe,197,0
2020-08-10,Gibraltar,GI,0,0,33706,Europe,197,0
2020-08-11,Gibraltar,GI,0,0,33706,Europe,197,0
2020-08-12,Gibraltar,GI,4,0,33706,Europe,201,0
2020-08-13,Gibraltar,GI,2,0,33706,Europe,203,0
2020-08-14,Gibraltar,GI,2,0,33706,Europe,205,0
2020-08-15,Gibraltar,GI,1,0,33706,Europe,206,0
2020-08-16,Gibraltar,GI,3,0,33706,Europe,209,0
2020-08-17,Gibraltar,GI,6,0,33706,Europe,215,0
2020-08-18,Gibraltar,GI,2,0,33706,Europe,217,0
2020-08-19,Gibraltar,GI,5,0,33706,Europe,222,0
2020-08-20,Gibraltar,GI,1,0,33706,Europe,223,0
2020-08-21,Gibraltar,GI,6,0,33706,Europe,229,0
2020-08-22,Gibraltar,GI,0,0,33706,Europe,229,0
2020-08-23,Gibraltar,GI,0,0,33706,Europe,229,0
2020-08-24,Gibraltar,GI,0,0,33706,Europe,229,0
2020-08-25,Gibraltar,GI,19,0,33706,Europe,248,0
2020-08-26,Gibraltar,GI,8,0,33706,Europe,256,0
2020-08-27,Gibraltar,GI,14,0,33706,Europe,270,0
2020-08-28,Gibraltar,GI,2,0,33706,Europe,272,0
2020-08-29,Gibraltar,GI,2,0,33706,Europe,274,0
2020-08-30,Gibraltar,GI,1,0,33706,Europe,275,0
2020-08-31,Gibraltar,GI,10,0,33706,Europe,285,0
2020-09-01,Gibraltar,GI,0,0,33706,Europe,285,0
2020-09-02,Gibraltar,GI,5,0,33706,Europe,290,0
2020-09-03,Gibraltar,GI,5,0,33706,Europe,295,0
2020-09-04,Gibraltar,GI,0,0,33706,Europe,295,0
2020-09-05,Gibraltar,GI,10,0,33706,Europe,305,0
2020-09-06,Gibraltar,GI,7,0,33706,Europe,312,0
2020-09-07,Gibraltar,GI,3,0,33706,Europe,315,0
2020-09-08,Gibraltar,GI,0,0,33706,Europe,315,0
2020-09-09,Gibraltar,GI,5,0,33706,Europe,320,0
2020-09-10,Gibraltar,GI,2,0,33706,Europe,322,0
2020-09-11,Gibraltar,GI,1,0,33706,Europe,323,0
2020-09-12,Gibraltar,GI,0,0,33706,Europe,323,0
2020-09-13,Gibraltar,GI,4,0,33706,Europe,327,0
2020-09-14,Gibraltar,GI,3,0,33706,Europe,330,0
2020-09-15,Gibraltar,GI,0,0,33706,Europe,330,0
2020-09-16,Gibraltar,GI,4,0,33706,Europe,334,0
2020-09-17,Gibraltar,GI,0,0,33706,Europe,334,0
2020-09-18,Gibraltar,GI,9,0,33706,Europe,343,0
2020-09-19,Gibraltar,GI,0,0,33706,Europe,343,0
2020-09-20,Gibraltar,GI,3,0,33706,Europe,346,0
2020-09-21,Gibraltar,GI,4,0,33706,Europe,350,0
2020-09-22,Gibraltar,GI,0,0,33706,Europe,350,0
2020-09-23,Gibraltar,GI,5,0,33706,Europe,355,0
2020-09-24,Gibraltar,GI,2,0,33706,Europe,357,0
2020-09-25,Gibraltar,GI,4,0,33706,Europe,361,0
2020-09-26,Gibraltar,GI,3,0,33706,Europe,364,0
2020-09-27,Gibraltar,GI,8,0,33706,Europe,372,0
2020-09-28,Gibraltar,GI,7,0,33706,Europe,379,0
2020-09-29,Gibraltar,GI,3,0,33706,Europe,382,0
2020-09-30,Gibraltar,GI,9,0,33706,Europe,391,0
2020-10-01,Gibraltar,GI,5,0,33706,Europe,396,0
2020-10-02,Gibraltar,GI,14,0,33706,Europe,410,0
2020-10-03,Gibraltar,GI,6,0,33706,Europe,416,0
2020-10-04,Gibraltar,GI,12,0,33706,Europe,428,0
2020-10-05,Gibraltar,GI,4,0,33706,Europe,432,0
2020-10-06,Gibraltar,GI,0,0,33706,Europe,432,0
2020-10-07,Gibraltar,GI,5,0,33706,Europe,437,0
2020-10-08,Gibraltar,GI,8,0,33706,Europe,445,0
2020-10-09,Gibraltar,GI,7,0,33706,Europe,452,0
2020-10-10,Gibraltar,GI,16,0,33706,Europe,468,0
2020-10-11,Gibraltar,GI,8,0,33706,Europe,476,0
2020-10-12,Gibraltar,GI,9,0,33706,Europe,485,0
2020-10-13,Gibraltar,GI,1,0,33706,Europe,486,0
2020-10-14,Gibraltar,GI,13,0,33706,Europe,499,0
2020-10-15,Gibraltar,GI,17,0,33706,Europe,516,0
2020-10-16,Gibraltar,GI,15,0,33706,Europe,531,0
2020-10-17,Gibraltar,GI,13,0,33706,Europe,544,0
2020-10-18,Gibraltar,GI,14,0,33706,Europe,558,0
2020-10-19,Gibraltar,GI,13,0,33706,Europe,571,0
2020-10-20,Gibraltar,GI,6,0,33706,Europe,577,0
2020-10-21,Gibraltar,GI,31,0,33706,Europe,608,0
2020-10-22,Gibraltar,GI,13,0,33706,Europe,621,0
2020-10-23,Gibraltar,GI,9,0,33706,Europe,630,0
2020-10-24,Gibraltar,GI,11,0,33706,Europe,641,0
2020-10-25,Gibraltar,GI,19,0,33706,Europe,660,0
2020-10-26,Gibraltar,GI,7,0,33706,Europe,667,0
2020-10-27,Gibraltar,GI,3,0,33706,Europe,670,0
2020-10-28,Gibraltar,GI,9,0,33706,Europe,679,0
2020-10-29,Gibraltar,GI,3,0,33706,Europe,682,0
2020-10-30,Gibraltar,GI,6,0,33706,Europe,688,0
2020-10-31,Gibraltar,GI,5,0,33706,Europe,693,0
2020-11-01,Gibraltar,GI,4,0,33706,Europe,697,0
2020-11-02,Gibraltar,GI,6,0,33706,Europe,703,0
2020-11-03,Gibraltar,GI,4,0,33706,Europe,707,0
2020-11-04,Gibraltar,GI,23,0,33706,Europe,730,0
2020-11-05,Gibraltar,GI,13,0,33706,Europe,743,0
2020-11-06,Gibraltar,GI,11,0,33706,Europe,754,0
2020-11-07,Gibraltar,GI,16,0,33706,Europe,770,0
2020-11-08,Gibraltar,GI,15,0,33706,Europe,785,0
2020-11-09,Gibraltar,GI,8,0,33706,Europe,793,0
2020-11-10,Gibraltar,GI,12,0,33706,Europe,805,0
2020-11-11,Gibraltar,GI,9,0,33706,Europe,814,0
2020-11-12,Gibraltar,GI,28,1,33706,Europe,842,1
2020-11-13,Gibraltar,GI,22,0,33706,Europe,864,1
2020-11-14,Gibraltar,GI,12,0,33706,Europe,876,1
2020-11-15,Gibraltar,GI,11,0,33706,Europe,887,1
2020-11-16,Gibraltar,GI,15,0,33706,Europe,902,1
2020-11-17,Gibraltar,GI,5,0,33706,Europe,907,1
2020-11-18,Gibraltar,GI,8,0,33706,Europe,915,1
2020-11-19,Gibraltar,GI,11,1,33706,Europe,926,2
2020-11-20,Gibraltar,GI,5,0,33706,Europe,931,2
2020-11-21,Gibraltar,GI,12,1,33706,Europe,943,3
2020-11-22,Gibraltar,GI,10,0,33706,Europe,953,3
2020-11-23,Gibraltar,GI,5,1,33706,Europe,958,4
2020-11-24,Gibraltar,GI,9,1,33706,Europe,967,5
2020-11-25,Gibraltar,GI,14,0,33706,Europe,981,5
2020-11-26,Gibraltar,GI,10,0,33706,Europe,991,5
2020-11-27,Gibraltar,GI,0,0,33706,Europe,991,5
2020-11-28,Gibraltar,GI,8,0,33706,Europe,999,5
2020-11-29,Gibraltar,GI,10,0,33706,Europe,1009,5
2020-11-30,Gibraltar,GI,5,0,33706,Europe,1014,5
2020-12-01,Gibraltar,GI,6,0,33706,Europe,1020,5
2020-12-02,Gibraltar,GI,10,0,33706,Europe,1030,5
2020-12-03,Gibraltar,GI,5,0,33706,Europe,1035,5
2020-12-04,Gibraltar,GI,3,0,33706,Europe,1038,5
2020-12-05,Gibraltar,GI,4,0,33706,Europe,1042,5
2020-12-06,Gibraltar,GI,6,0,33706,Europe,1048,5
2020-12-07,Gibraltar,GI,5,0,33706,Europe,1053,5
2020-12-08,Gibraltar,GI,2,0,33706,Europe,1055,5
2020-12-09,Gibraltar,GI,3,0,33706,Europe,1058,5
2020-12-10,Gibraltar,GI,7,0,33706,Europe,1065,5
2020-12-11,Gibraltar,GI,4,0,33706,Europe,1069,5
2020-12-12,Gibraltar,GI,1,0,33706,Europe,1070,5
2020-12-13,Gibraltar,GI,2,0,33706,Europe,1072,5
2020-12-14,Gibraltar,GI,3,0,33706,Europe,1075,5
2020-03-20,Greenland,GL,2,0,56660,America,2,0
2020-03-21,Greenland,GL,0,0,56660,America,2,0
2020-03-22,Greenland,GL,0,0,56660,America,2,0
2020-03-23,Greenland,GL,0,0,56660,America,2,0
2020-03-24,Greenland,GL,2,0,56660,America,4,0
2020-03-25,Greenland,GL,0,0,56660,America,4,0
2020-03-26,Greenland,GL,1,0,56660,America,5,0
2020-03-27,Greenland,GL,1,0,56660,America,6,0
2020-03-28,Greenland,GL,3,0,56660,America,9,0
2020-03-29,Greenland,GL,1,0,56660,America,10,0
2020-03-30,Greenland,GL,0,0,56660,America,10,0
2020-03-31,Greenland,GL,0,0,56660,America,10,0
2020-04-01,Greenland,GL,0,0,56660,America,10,0
2020-04-02,Greenland,GL,0,0,56660,America,10,0
2020-04-03,Greenland,GL,0,0,56660,America,10,0
2020-04-04,Greenland,GL,0,0,56660,America,10,0
2020-04-05,Greenland,GL,0,0,56660,America,10,0
2020-04-06,Greenland,GL,1,0,56660,America,11,0
2020-04-07,Greenland,GL,0,0,56660,America,11,0
2020-04-08,Greenland,GL,0,0,56660,America,11,0
2020-04-09,Greenland,GL,0,0,56660,America,11,0
2020-04-10,Greenland,GL,0,0,56660,America,11,0
2020-04-11,Greenland,GL,0,0,56660,America,11,0
2020-04-12,Greenland,GL,0,0,56660,America,11,0
2020-04-13,Greenland,GL,0,0,56660,America,11,0
2020-04-14,Greenland,GL,0,0,56660,America,11,0
2020-04-15,Greenland,GL,0,0,56660,America,11,0
2020-04-16,Greenland,GL,0,0,56660,America,11,0
2020-04-17,Greenland,GL,0,0,56660,America,11,0
2020-04-18,Greenland,GL,0,0,56660,America,11,0
2020-04-19,Greenland,GL,0,0,56660,America,11,0
2020-04-20,Greenland,GL,0,0,56660,America,11,0
2020-04-21,Greenland,GL,0,0,56660,America,11,0
2020-04-22,Greenland,GL,0,0,56660,America,11,0
2020-04-23,Greenland,GL,0,0,56660,America,11,0
2020-04-24,Greenland,GL,0,0,56660,America,11,0
2020-04-25,Greenland,GL,0,0,56660,America,11,0
2020-04-26,Greenland,GL,0,0,56660,America,11,0
2020-04-27,Greenland,GL,0,0,56660,America,11,0
2020-04-28,Greenland,GL,0,0,56660,America,11,0
2020-04-29,Greenland,GL,0,0,56660,America,11,0
2020-04-30,Greenland,GL,0,0,56660,America,11,0
2020-05-01,Greenland,GL,0,0,56660,America,11,0
2020-05-02,Greenland,GL,0,0,56660,America,11,0
2020-05-03,Greenland,GL,0,0,56660,America,11,0
2020-05-04,Greenland,GL,0,0,56660,America,11,0
2020-05-05,Greenland,GL,0,0,56660,America,11,0
2020-05-06,Greenland,GL,0,0,56660,America,11,0
2020-05-07,Greenland,GL,0,0,56660,America,11,0
2020-05-08,Greenland,GL,0,0,56660,America,11,0
2020-05-09,Greenland,GL,0,0,56660,America,11,0
2020-05-10,Greenland,GL,0,0,56660,America,11,0
2020-05-11,Greenland,GL,0,0,56660,America,11,0
2020-05-12,Greenland,GL,0,0,56660,America,11,0
2020-05-13,Greenland,GL,0,0,56660,America,11,0
2020-05-14,Greenland,GL,0,0,56660,America,11,0
2020-05-15,Greenland,GL,0,0,56660,America,11,0
2020-05-16,Greenland,GL,0,0,56660,America,11,0
2020-05-17,Greenland,GL,0,0,56660,America,11,0
2020-05-18,Greenland,GL,0,0,56660,America,11,0
2020-05-19,Greenland,GL,0,0,56660,America,11,0
2020-05-20,Greenland,GL,0,0,56660,America,11,0
2020-05-21,Greenland,GL,0,0,56660,America,11,0
2020-05-22,Greenland,GL,0,0,56660,America,11,0
2020-05-23,Greenland,GL,0,0,56660,America,11,0
2020-05-24,Greenland,GL,0,0,56660,America,11,0
2020-05-25,Greenland,GL,0,0,56660,America,11,0
2020-05-26,Greenland,GL,1,0,56660,America,12,0
2020-05-27,Greenland,GL,0,0,56660,America,12,0
2020-05-28,Greenland,GL,0,0,56660,America,12,0
2020-05-29,Greenland,GL,1,0,56660,America,13,0
2020-05-30,Greenland,GL,0,0,56660,America,13,0
2020-05-31,Greenland,GL,0,0,56660,America,13,0
2020-06-01,Greenland,GL,0,0,56660,America,13,0
2020-06-02,Greenland,GL,0,0,56660,America,13,0
2020-06-03,Greenland,GL,0,0,56660,America,13,0
2020-06-04,Greenland,GL,0,0,56660,America,13,0
2020-06-05,Greenland,GL,0,0,56660,America,13,0
2020-06-06,Greenland,GL,0,0,56660,America,13,0
2020-06-07,Greenland,GL,0,0,56660,America,13,0
2020-06-08,Greenland,GL,0,0,56660,America,13,0
2020-06-09,Greenland,GL,0,0,56660,America,13,0
2020-06-10,Greenland,GL,0,0,56660,America,13,0
2020-06-11,Greenland,GL,0,0,56660,America,13,0
2020-06-12,Greenland,GL,0,0,56660,America,13,0
2020-06-13,Greenland,GL,0,0,56660,America,13,0
2020-06-14,Greenland,GL,0,0,56660,America,13,0
2020-06-15,Greenland,GL,0,0,56660,America,13,0
2020-06-16,Greenland,GL,0,0,56660,America,13,0
2020-06-17,Greenland,GL,0,0,56660,America,13,0
2020-06-18,Greenland,GL,0,0,56660,America,13,0
2020-06-19,Greenland,GL,0,0,56660,America,13,0
2020-06-20,Greenland,GL,0,0,56660,America,13,0
2020-06-21,Greenland,GL,0,0,56660,America,13,0
2020-06-22,Greenland,GL,0,0,56660,America,13,0
2020-06-23,Greenland,GL,0,0,56660,America,13,0
2020-06-24,Greenland,GL,0,0,56660,America,13,0
2020-06-25,Greenland,GL,0,0,56660,America,13,0
2020-06-26,Greenland,GL,0,0,56660,America,13,0
2020-06-27,Greenland,GL,0,0,56660,America,13,0
2020-06-28,Greenland,GL,0,0,56660,America,13,0
2020-06-29,Greenland,GL,0,0,56660,America,13,0
2020-06-30,Greenland,GL,0,0,56660,America,13,0
2020-07-01,Greenland,GL,0,0,56660,America,13,0
2020-07-02,Greenland,GL,0,0,56660,America,13,0
2020-07-03,Greenland,GL,0,0,56660,America,13,0
2020-07-04,Greenland,GL,0,0,56660,America,13,0
2020-07-05,Greenland,GL,0,0,56660,America,13,0
2020-07-06,Greenland,GL,0,0,56660,America,13,0
2020-07-07,Greenland,GL,0,0,56660,America,13,0
2020-07-08,Greenland,GL,0,0,56660,America,13,0
2020-07-09,Greenland,GL,0,0,56660,America,13,0
2020-07-10,Greenland,GL,0,0,56660,America,13,0
2020-07-11,Greenland,GL,0,0,56660,America,13,0
2020-07-12,Greenland,GL,0,0,56660,America,13,0
2020-07-13,Greenland,GL,0,0,56660,America,13,0
2020-07-14,Greenland,GL,0,0,56660,America,13,0
2020-07-15,Greenland,GL,0,0,56660,America,13,0
2020-07-16,Greenland,GL,0,0,56660,America,13,0
2020-07-17,Greenland,GL,0,0,56660,America,13,0
2020-07-18,Greenland,GL,0,0,56660,America,13,0
2020-07-19,Greenland,GL,0,0,56660,America,13,0
2020-07-20,Greenland,GL,0,0,56660,America,13,0
2020-07-21,Greenland,GL,0,0,56660,America,13,0
2020-07-22,Greenland,GL,0,0,56660,America,13,0
2020-07-23,Greenland,GL,0,0,56660,America,13,0
2020-07-24,Greenland,GL,0,0,56660,America,13,0
2020-07-25,Greenland,GL,0,0,56660,America,13,0
2020-07-26,Greenland,GL,0,0,56660,America,13,0
2020-07-27,Greenland,GL,0,0,56660,America,13,0
2020-07-28,Greenland,GL,0,0,56660,America,13,0
2020-07-29,Greenland,GL,1,0,56660,America,14,0
2020-07-30,Greenland,GL,0,0,56660,America,14,0
2020-07-31,Greenland,GL,0,0,56660,America,14,0
2020-08-01,Greenland,GL,0,0,56660,America,14,0
2020-08-02,Greenland,GL,0,0,56660,America,14,0
2020-08-03,Greenland,GL,0,0,56660,America,14,0
2020-08-04,Greenland,GL,0,0,56660,America,14,0
2020-08-05,Greenland,GL,0,0,56660,America,14,0
2020-08-06,Greenland,GL,0,0,56660,America,14,0
2020-08-07,Greenland,GL,0,0,56660,America,14,0
2020-08-08,Greenland,GL,0,0,56660,America,14,0
2020-08-09,Greenland,GL,0,0,56660,America,14,0
2020-08-10,Greenland,GL,0,0,56660,America,14,0
2020-08-11,Greenland,GL,0,0,56660,America,14,0
2020-08-12,Greenland,GL,0,0,56660,America,14,0
2020-08-13,Greenland,GL,0,0,56660,America,14,0
2020-08-14,Greenland,GL,0,0,56660,America,14,0
2020-08-15,Greenland,GL,0,0,56660,America,14,0
2020-08-16,Greenland,GL,0,0,56660,America,14,0
2020-08-17,Greenland,GL,0,0,56660,America,14,0
2020-08-18,Greenland,GL,0,0,56660,America,14,0
2020-08-19,Greenland,GL,0,0,56660,America,14,0
2020-08-20,Greenland,GL,0,0,56660,America,14,0
2020-08-21,Greenland,GL,0,0,56660,America,14,0
2020-08-22,Greenland,GL,0,0,56660,America,14,0
2020-08-23,Greenland,GL,0,0,56660,America,14,0
2020-08-24,Greenland,GL,0,0,56660,America,14,0
2020-08-25,Greenland,GL,0,0,56660,America,14,0
2020-08-26,Greenland,GL,0,0,56660,America,14,0
2020-08-27,Greenland,GL,0,0,56660,America,14,0
2020-08-28,Greenland,GL,0,0,56660,America,14,0
2020-08-29,Greenland,GL,0,0,56660,America,14,0
2020-08-30,Greenland,GL,0,0,56660,America,14,0
2020-08-31,Greenland,GL,0,0,56660,America,14,0
2020-09-01,Greenland,GL,0,0,56660,America,14,0
2020-09-02,Greenland,GL,0,0,56660,America,14,0
2020-09-03,Greenland,GL,0,0,56660,America,14,0
2020-09-04,Greenland,GL,0,0,56660,America,14,0
2020-09-05,Greenland,GL,0,0,56660,America,14,0
2020-09-06,Greenland,GL,0,0,56660,America,14,0
2020-09-07,Greenland,GL,0,0,56660,America,14,0
2020-09-08,Greenland,GL,0,0,56660,America,14,0
2020-09-09,Greenland,GL,0,0,56660,America,14,0
2020-09-10,Greenland,GL,0,0,56660,America,14,0
2020-09-11,Greenland,GL,0,0,56660,America,14,0
2020-09-12,Greenland,GL,0,0,56660,America,14,0
2020-09-13,Greenland,GL,0,0,56660,America,14,0
2020-09-14,Greenland,GL,0,0,56660,America,14,0
2020-09-15,Greenland,GL,0,0,56660,America,14,0
2020-09-16,Greenland,GL,0,0,56660,America,14,0
2020-09-17,Greenland,GL,0,0,56660,America,14,0
2020-09-18,Greenland,GL,0,0,56660,America,14,0
2020-09-19,Greenland,GL,0,0,56660,America,14,0
2020-09-20,Greenland,GL,0,0,56660,America,14,0
2020-09-21,Greenland,GL,0,0,56660,America,14,0
2020-09-22,Greenland,GL,0,0,56660,America,14,0
2020-09-23,Greenland,GL,0,0,56660,America,14,0
2020-09-24,Greenland,GL,0,0,56660,America,14,0
2020-09-25,Greenland,GL,0,0,56660,America,14,0
2020-09-26,Greenland,GL,0,0,56660,America,14,0
2020-09-27,Greenland,GL,0,0,56660,America,14,0
2020-09-28,Greenland,GL,0,0,56660,America,14,0
2020-09-29,Greenland,GL,0,0,56660,America,14,0
2020-09-30,Greenland,GL,0,0,56660,America,14,0
2020-10-01,Greenland,GL,0,0,56660,America,14,0
2020-10-02,Greenland,GL,0,0,56660,America,14,0
2020-10-03,Greenland,GL,0,0,56660,America,14,0
2020-10-04,Greenland,GL,0,0,56660,America,14,0
2020-10-05,Greenland,GL,0,0,56660,America,14,0
2020-10-06,Greenland,GL,0,0,56660,America,14,0
2020-10-07,Greenland,GL,0,0,56660,America,14,0
2020-10-08,Greenland,GL,0,0,56660,America,14,0
2020-10-09,Greenland,GL,1,0,56660,America,15,0
2020-10-10,Greenland,GL,1,0,56660,America,16,0
2020-10-11,Greenland,GL,0,0,56660,America,16,0
2020-10-12,Greenland,GL,0,0,56660,America,16,0
2020-10-13,Greenland,GL,0,0,56660,America,16,0
2020-10-14,Greenland,GL,0,0,56660,America,16,0
2020-10-15,Greenland,GL,0,0,56660,America,16,0
2020-10-16,Greenland,GL,0,0,56660,America,16,0
2020-10-17,Greenland,GL,0,0,56660,America,16,0
2020-10-18,Greenland,GL,0,0,56660,America,16,0
2020-10-19,Greenland,GL,0,0,56660,America,16,0
2020-10-20,Greenland,GL,0,0,56660,America,16,0
2020-10-21,Greenland,GL,0,0,56660,America,16,0
2020-10-22,Greenland,GL,0,0,56660,America,16,0
2020-10-23,Greenland,GL,1,0,56660,America,17,0
2020-10-24,Greenland,GL,0,0,56660,America,17,0
2020-10-25,Greenland,GL,0,0,56660,America,17,0
2020-10-26,Greenland,GL,0,0,56660,America,17,0
2020-10-27,Greenland,GL,0,0,56660,America,17,0
2020-10-28,Greenland,GL,0,0,56660,America,17,0
2020-10-29,Greenland,GL,0,0,56660,America,17,0
2020-10-30,Greenland,GL,0,0,56660,America,17,0
2020-10-31,Greenland,GL,0,0,56660,America,17,0
2020-11-01,Greenland,GL,0,0,56660,America,17,0
2020-11-02,Greenland,GL,0,0,56660,America,17,0
2020-11-03,Greenland,GL,0,0,56660,America,17,0
2020-11-04,Greenland,GL,0,0,56660,America,17,0
2020-11-05,Greenland,GL,0,0,56660,America,17,0
2020-11-06,Greenland,GL,0,0,56660,America,17,0
2020-11-07,Greenland,GL,0,0,56660,America,17,0
2020-11-08,Greenland,GL,0,0,56660,America,17,0
2020-11-09,Greenland,GL,0,0,56660,America,17,0
2020-11-10,Greenland,GL,0,0,56660,America,17,0
2020-11-11,Greenland,GL,0,0,56660,America,17,0
2020-11-12,Greenland,GL,0,0,56660,America,17,0
2020-11-13,Greenland,GL,0,0,56660,America,17,0
2020-11-14,Greenland,GL,0,0,56660,America,17,0
2020-11-15,Greenland,GL,0,0,56660,America,17,0
2020-11-16,Greenland,GL,0,0,56660,America,17,0
2020-11-17,Greenland,GL,1,0,56660,America,18,0
2020-11-18,Greenland,GL,0,0,56660,America,18,0
2020-11-19,Greenland,GL,0,0,56660,America,18,0
2020-11-20,Greenland,GL,0,0,56660,America,18,0
2020-11-21,Greenland,GL,0,0,56660,America,18,0
2020-11-22,Greenland,GL,0,0,56660,America,18,0
2020-11-23,Greenland,GL,0,0,56660,America,18,0
2020-11-24,Greenland,GL,0,0,56660,America,18,0
2020-11-25,Greenland,GL,0,0,56660,America,18,0
2020-11-26,Greenland,GL,0,0,56660,America,18,0
2020-11-27,Greenland,GL,0,0,56660,America,18,0
2020-11-28,Greenland,GL,0,0,56660,America,18,0
2020-11-29,Greenland,GL,0,0,56660,America,18,0
2020-11-30,Greenland,GL,0,0,56660,America,18,0
2020-12-01,Greenland,GL,0,0,56660,America,18,0
2020-12-02,Greenland,GL,0,0,56660,America,18,0
2020-12-03,Greenland,GL,0,0,56660,America,18,0
2020-12-04,Greenland,GL,0,0,56660,America,18,0
2020-12-05,Greenland,GL,0,0,56660,America,18,0
2020-12-06,Greenland,GL,0,0,56660,America,18,0
2020-12-07,Greenland,GL,0,0,56660,America,18,0
2020-12-08,Greenland,GL,0,0,56660,America,18,0
2020-12-09,Greenland,GL,1,0,56660,America,19,0
2020-12-10,Greenland,GL,0,0,56660,America,19,0
2020-12-11,Greenland,GL,0,0,56660,America,19,0
2020-12-12,Greenland,GL,0,0,56660,America,19,0
2020-12-13,Greenland,GL,0,0,56660,America,19,0
2020-12-14,Greenland,GL,0,0,56660,America,19,0
2020-03-18,Gambia,GM,1,0,2347696,Africa,1,0
2020-03-19,Gambia,GM,0,0,2347696,Africa,1,0
2020-03-20,Gambia,GM,0,0,2347696,Africa,1,0
2020-03-21,Gambia,GM,0,0,2347696,Africa,1,0
2020-03-22,Gambia,GM,0,0,2347696,Africa,1,0
2020-03-23,Gambia,GM,0,0,2347696,Africa,1,0
2020-03-24,Gambia,GM,1,1,2347696,Africa,2,1
2020-03-25,Gambia,GM,1,0,2347696,Africa,3,1
2020-03-26,Gambia,GM,0,0,2347696,Africa,3,1
2020-03-27,Gambia,GM,0,0,2347696,Africa,3,1
2020-03-28,Gambia,GM,0,0,2347696,Africa,3,1
2020-03-29,Gambia,GM,0,0,2347696,Africa,3,1
2020-03-30,Gambia,GM,0,0,2347696,Africa,3,1
2020-03-31,Gambia,GM,1,0,2347696,Africa,4,1
2020-04-01,Gambia,GM,0,0,2347696,Africa,4,1
2020-04-02,Gambia,GM,0,0,2347696,Africa,4,1
2020-04-03,Gambia,GM,0,0,2347696,Africa,4,1
2020-04-04,Gambia,GM,0,0,2347696,Africa,4,1
2020-04-05,Gambia,GM,0,0,2347696,Africa,4,1
2020-04-06,Gambia,GM,0,0,2347696,Africa,4,1
2020-04-07,Gambia,GM,0,0,2347696,Africa,4,1
2020-04-08,Gambia,GM,0,0,2347696,Africa,4,1
2020-04-09,Gambia,GM,0,0,2347696,Africa,4,1
2020-04-10,Gambia,GM,0,0,2347696,Africa,4,1
2020-04-11,Gambia,GM,0,0,2347696,Africa,4,1
2020-04-12,Gambia,GM,5,0,2347696,Africa,9,1
2020-04-13,Gambia,GM,0,0,2347696,Africa,9,1
2020-04-14,Gambia,GM,0,0,2347696,Africa,9,1
2020-04-15,Gambia,GM,0,0,2347696,Africa,9,1
2020-04-16,Gambia,GM,0,0,2347696,Africa,9,1
2020-04-17,Gambia,GM,0,0,2347696,Africa,9,1
2020-04-18,Gambia,GM,0,0,2347696,Africa,9,1
2020-04-19,Gambia,GM,0,0,2347696,Africa,9,1
2020-04-20,Gambia,GM,1,0,2347696,Africa,10,1
2020-04-21,Gambia,GM,0,0,2347696,Africa,10,1
2020-04-22,Gambia,GM,0,0,2347696,Africa,10,1
2020-04-23,Gambia,GM,0,0,2347696,Africa,10,1
2020-04-24,Gambia,GM,0,0,2347696,Africa,10,1
2020-04-25,Gambia,GM,0,0,2347696,Africa,10,1
2020-04-26,Gambia,GM,0,0,2347696,Africa,10,1
2020-04-27,Gambia,GM,0,0,2347696,Africa,10,1
2020-04-28,Gambia,GM,0,0,2347696,Africa,10,1
2020-04-29,Gambia,GM,0,0,2347696,Africa,10,1
2020-04-30,Gambia,GM,1,0,2347696,Africa,11,1
2020-05-01,Gambia,GM,1,0,2347696,Africa,12,1
2020-05-02,Gambia,GM,0,0,2347696,Africa,12,1
2020-05-03,Gambia,GM,5,0,2347696,Africa,17,1
2020-05-04,Gambia,GM,0,0,2347696,Africa,17,1
2020-05-05,Gambia,GM,0,0,2347696,Africa,17,1
2020-05-06,Gambia,GM,0,0,2347696,Africa,17,1
2020-05-07,Gambia,GM,0,0,2347696,Africa,17,1
2020-05-08,Gambia,GM,1,0,2347696,Africa,18,1
2020-05-09,Gambia,GM,2,0,2347696,Africa,20,1
2020-05-10,Gambia,GM,0,0,2347696,Africa,20,1
2020-05-11,Gambia,GM,0,0,2347696,Africa,20,1
2020-05-12,Gambia,GM,2,0,2347696,Africa,22,1
2020-05-13,Gambia,GM,1,0,2347696,Africa,23,1
2020-05-14,Gambia,GM,0,0,2347696,Africa,23,1
2020-05-15,Gambia,GM,0,0,2347696,Africa,23,1
2020-05-16,Gambia,GM,0,0,2347696,Africa,23,1
2020-05-17,Gambia,GM,0,0,2347696,Africa,23,1
2020-05-18,Gambia,GM,0,0,2347696,Africa,23,1
2020-05-19,Gambia,GM,1,0,2347696,Africa,24,1
2020-05-20,Gambia,GM,0,0,2347696,Africa,24,1
2020-05-21,Gambia,GM,0,0,2347696,Africa,24,1
2020-05-22,Gambia,GM,0,0,2347696,Africa,24,1
2020-05-23,Gambia,GM,1,0,2347696,Africa,25,1
2020-05-24,Gambia,GM,0,0,2347696,Africa,25,1
2020-05-25,Gambia,GM,0,0,2347696,Africa,25,1
2020-05-26,Gambia,GM,0,0,2347696,Africa,25,1
2020-05-27,Gambia,GM,0,0,2347696,Africa,25,1
2020-05-28,Gambia,GM,0,0,2347696,Africa,25,1
2020-05-29,Gambia,GM,0,0,2347696,Africa,25,1
2020-05-30,Gambia,GM,0,0,2347696,Africa,25,1
2020-05-31,Gambia,GM,0,0,2347696,Africa,25,1
2020-06-01,Gambia,GM,0,0,2347696,Africa,25,1
2020-06-02,Gambia,GM,0,0,2347696,Africa,25,1
2020-06-03,Gambia,GM,1,0,2347696,Africa,26,1
2020-06-04,Gambia,GM,0,0,2347696,Africa,26,1
2020-06-05,Gambia,GM,0,0,2347696,Africa,26,1
2020-06-06,Gambia,GM,0,0,2347696,Africa,26,1
2020-06-07,Gambia,GM,0,0,2347696,Africa,26,1
2020-06-08,Gambia,GM,0,0,2347696,Africa,26,1
2020-06-09,Gambia,GM,2,0,2347696,Africa,28,1
2020-06-10,Gambia,GM,0,0,2347696,Africa,28,1
2020-06-11,Gambia,GM,0,0,2347696,Africa,28,1
2020-06-12,Gambia,GM,0,0,2347696,Africa,28,1
2020-06-13,Gambia,GM,0,0,2347696,Africa,28,1
2020-06-14,Gambia,GM,0,0,2347696,Africa,28,1
2020-06-15,Gambia,GM,0,0,2347696,Africa,28,1
2020-06-16,Gambia,GM,2,0,2347696,Africa,30,1
2020-06-17,Gambia,GM,4,0,2347696,Africa,34,1
2020-06-18,Gambia,GM,0,0,2347696,Africa,34,1
2020-06-19,Gambia,GM,2,0,2347696,Africa,36,1
2020-06-20,Gambia,GM,0,0,2347696,Africa,36,1
2020-06-21,Gambia,GM,1,1,2347696,Africa,37,2
2020-06-22,Gambia,GM,0,0,2347696,Africa,37,2
2020-06-23,Gambia,GM,4,0,2347696,Africa,41,2
2020-06-24,Gambia,GM,1,0,2347696,Africa,42,2
2020-06-25,Gambia,GM,0,0,2347696,Africa,42,2
2020-06-26,Gambia,GM,1,0,2347696,Africa,43,2
2020-06-27,Gambia,GM,1,0,2347696,Africa,44,2
2020-06-28,Gambia,GM,1,0,2347696,Africa,45,2
2020-06-29,Gambia,GM,0,0,2347696,Africa,45,2
2020-06-30,Gambia,GM,2,0,2347696,Africa,47,2
2020-07-01,Gambia,GM,0,0,2347696,Africa,47,2
2020-07-02,Gambia,GM,2,0,2347696,Africa,49,2
2020-07-03,Gambia,GM,6,0,2347696,Africa,55,2
2020-07-04,Gambia,GM,0,0,2347696,Africa,55,2
2020-07-05,Gambia,GM,2,0,2347696,Africa,57,2
2020-07-06,Gambia,GM,0,0,2347696,Africa,57,2
2020-07-07,Gambia,GM,4,1,2347696,Africa,61,3
2020-07-08,Gambia,GM,0,0,2347696,Africa,61,3
2020-07-09,Gambia,GM,2,0,2347696,Africa,63,3
2020-07-10,Gambia,GM,1,0,2347696,Africa,64,3
2020-07-11,Gambia,GM,0,0,2347696,Africa,64,3
2020-07-12,Gambia,GM,0,0,2347696,Africa,64,3
2020-07-13,Gambia,GM,0,0,2347696,Africa,64,3
2020-07-14,Gambia,GM,0,0,2347696,Africa,64,3
2020-07-15,Gambia,GM,0,0,2347696,Africa,64,3
2020-07-16,Gambia,GM,0,0,2347696,Africa,64,3
2020-07-17,Gambia,GM,14,0,2347696,Africa,78,3
2020-07-18,Gambia,GM,0,0,2347696,Africa,78,3
2020-07-19,Gambia,GM,15,1,2347696,Africa,93,4
2020-07-20,Gambia,GM,0,0,2347696,Africa,93,4
2020-07-21,Gambia,GM,19,0,2347696,Africa,112,4
2020-07-22,Gambia,GM,0,0,2347696,Africa,112,4
2020-07-23,Gambia,GM,34,1,2347696,Africa,146,5
2020-07-24,Gambia,GM,24,0,2347696,Africa,170,5
2020-07-25,Gambia,GM,46,1,2347696,Africa,216,6
2020-07-26,Gambia,GM,61,0,2347696,Africa,277,6
2020-07-27,Gambia,GM,0,0,2347696,Africa,277,6
2020-07-28,Gambia,GM,49,2,2347696,Africa,326,8
2020-07-29,Gambia,GM,0,0,2347696,Africa,326,8
2020-07-30,Gambia,GM,0,0,2347696,Africa,326,8
2020-07-31,Gambia,GM,77,0,2347696,Africa,403,8
2020-08-01,Gambia,GM,95,1,2347696,Africa,498,9
2020-08-02,Gambia,GM,0,0,2347696,Africa,498,9
2020-08-03,Gambia,GM,0,0,2347696,Africa,498,9
2020-08-04,Gambia,GM,0,0,2347696,Africa,498,9
2020-08-05,Gambia,GM,173,5,2347696,Africa,671,14
2020-08-06,Gambia,GM,128,2,2347696,Africa,799,16
2020-08-07,Gambia,GM,136,0,2347696,Africa,935,16
2020-08-08,Gambia,GM,155,3,2347696,Africa,1090,19
2020-08-09,Gambia,GM,0,0,2347696,Africa,1090,19
2020-08-10,Gambia,GM,145,4,2347696,Africa,1235,23
2020-08-11,Gambia,GM,0,0,2347696,Africa,1235,23
2020-08-12,Gambia,GM,111,9,2347696,Africa,1346,32
2020-08-13,Gambia,GM,131,1,2347696,Africa,1477,33
2020-08-14,Gambia,GM,79,10,2347696,Africa,1556,43
2020-08-15,Gambia,GM,67,7,2347696,Africa,1623,50
2020-08-16,Gambia,GM,66,4,2347696,Africa,1689,54
2020-08-17,Gambia,GM,183,9,2347696,Africa,1872,63
2020-08-18,Gambia,GM,0,0,2347696,Africa,1872,63
2020-08-19,Gambia,GM,0,0,2347696,Africa,1872,63
2020-08-20,Gambia,GM,416,14,2347696,Africa,2288,77
2020-08-21,Gambia,GM,113,4,2347696,Africa,2401,81
2020-08-22,Gambia,GM,36,3,2347696,Africa,2437,84
2020-08-23,Gambia,GM,0,0,2347696,Africa,2437,84
2020-08-24,Gambia,GM,0,0,2347696,Africa,2437,84
2020-08-25,Gambia,GM,148,3,2347696,Africa,2585,87
2020-08-26,Gambia,GM,101,3,2347696,Africa,2686,90
2020-08-27,Gambia,GM,22,3,2347696,Africa,2708,93
2020-08-28,Gambia,GM,35,0,2347696,Africa,2743,93
2020-08-29,Gambia,GM,54,3,2347696,Africa,2797,96
2020-08-30,Gambia,GM,98,0,2347696,Africa,2895,96
2020-08-31,Gambia,GM,68,0,2347696,Africa,2963,96
2020-09-01,Gambia,GM,0,0,2347696,Africa,2963,96
2020-09-02,Gambia,GM,66,0,2347696,Africa,3029,96
2020-09-03,Gambia,GM,38,1,2347696,Africa,3067,97
2020-09-04,Gambia,GM,34,2,2347696,Africa,3101,99
2020-09-05,Gambia,GM,19,0,2347696,Africa,3120,99
2020-09-06,Gambia,GM,30,0,2347696,Africa,3150,99
2020-09-07,Gambia,GM,47,0,2347696,Africa,3197,99
2020-09-08,Gambia,GM,0,0,2347696,Africa,3197,99
2020-09-09,Gambia,GM,78,0,2347696,Africa,3275,99
2020-09-10,Gambia,GM,18,0,2347696,Africa,3293,99
2020-09-11,Gambia,GM,37,1,2347696,Africa,3330,100
2020-09-12,Gambia,GM,32,0,2347696,Africa,3362,100
2020-09-13,Gambia,GM,14,2,2347696,Africa,3376,102
2020-09-14,Gambia,GM,29,1,2347696,Africa,3405,103
2020-09-15,Gambia,GM,0,0,2347696,Africa,3405,103
2020-09-16,Gambia,GM,23,2,2347696,Africa,3428,105
2020-09-17,Gambia,GM,12,2,2347696,Africa,3440,107
2020-09-18,Gambia,GM,33,0,2347696,Africa,3473,107
2020-09-19,Gambia,GM,12,1,2347696,Africa,3485,108
2020-09-20,Gambia,GM,19,0,2347696,Africa,3504,108
2020-09-21,Gambia,GM,22,0,2347696,Africa,3526,108
2020-09-22,Gambia,GM,14,2,2347696,Africa,3540,110
2020-09-23,Gambia,GM,0,0,2347696,Africa,3540,110
2020-09-24,Gambia,GM,2,0,2347696,Africa,3542,110
2020-09-25,Gambia,GM,10,0,2347696,Africa,3552,110
2020-09-26,Gambia,GM,3,0,2347696,Africa,3555,110
2020-09-27,Gambia,GM,0,0,2347696,Africa,3555,110
2020-09-28,Gambia,GM,14,1,2347696,Africa,3569,111
2020-09-29,Gambia,GM,0,0,2347696,Africa,3569,111
2020-09-30,Gambia,GM,10,1,2347696,Africa,3579,112
2020-10-01,Gambia,GM,0,0,2347696,Africa,3579,112
2020-10-02,Gambia,GM,5,1,2347696,Africa,3584,113
2020-10-03,Gambia,GM,1,2,2347696,Africa,3585,115
2020-10-04,Gambia,GM,5,0,2347696,Africa,3590,115
2020-10-05,Gambia,GM,4,0,2347696,Africa,3594,115
2020-10-06,Gambia,GM,0,0,2347696,Africa,3594,115
2020-10-07,Gambia,GM,19,2,2347696,Africa,3613,117
2020-10-08,Gambia,GM,0,0,2347696,Africa,3613,117
2020-10-09,Gambia,GM,4,0,2347696,Africa,3617,117
2020-10-10,Gambia,GM,4,0,2347696,Africa,3621,117
2020-10-11,Gambia,GM,7,0,2347696,Africa,3628,117
2020-10-12,Gambia,GM,4,0,2347696,Africa,3632,117
2020-10-13,Gambia,GM,4,1,2347696,Africa,3636,118
2020-10-14,Gambia,GM,0,0,2347696,Africa,3636,118
2020-10-15,Gambia,GM,8,0,2347696,Africa,3644,118
2020-10-16,Gambia,GM,0,0,2347696,Africa,3644,118
2020-10-17,Gambia,GM,5,0,2347696,Africa,3649,118
2020-10-18,Gambia,GM,0,0,2347696,Africa,3649,118
2020-10-19,Gambia,GM,0,0,2347696,Africa,3649,118
2020-10-20,Gambia,GM,6,0,2347696,Africa,3655,118
2020-10-21,Gambia,GM,0,0,2347696,Africa,3655,118
2020-10-22,Gambia,GM,2,0,2347696,Africa,3657,118
2020-10-23,Gambia,GM,2,1,2347696,Africa,3659,119
2020-10-24,Gambia,GM,0,0,2347696,Africa,3659,119
2020-10-25,Gambia,GM,0,0,2347696,Africa,3659,119
2020-10-26,Gambia,GM,1,0,2347696,Africa,3660,119
2020-10-27,Gambia,GM,5,0,2347696,Africa,3665,119
2020-10-28,Gambia,GM,0,0,2347696,Africa,3665,119
2020-10-29,Gambia,GM,1,0,2347696,Africa,3666,119
2020-10-30,Gambia,GM,0,0,2347696,Africa,3666,119
2020-10-31,Gambia,GM,4,0,2347696,Africa,3670,119
2020-11-01,Gambia,GM,2,0,2347696,Africa,3672,119
2020-11-02,Gambia,GM,0,0,2347696,Africa,3672,119
2020-11-03,Gambia,GM,0,0,2347696,Africa,3672,119
2020-11-04,Gambia,GM,7,1,2347696,Africa,3679,120
2020-11-05,Gambia,GM,1,0,2347696,Africa,3680,120
2020-11-06,Gambia,GM,0,0,2347696,Africa,3680,120
2020-11-07,Gambia,GM,1,0,2347696,Africa,3681,120
2020-11-08,Gambia,GM,3,1,2347696,Africa,3684,121
2020-11-09,Gambia,GM,0,0,2347696,Africa,3684,121
2020-11-10,Gambia,GM,0,0,2347696,Africa,3684,121
2020-11-11,Gambia,GM,0,0,2347696,Africa,3684,121
2020-11-12,Gambia,GM,13,1,2347696,Africa,3697,122
2020-11-13,Gambia,GM,0,0,2347696,Africa,3697,122
2020-11-14,Gambia,GM,1,0,2347696,Africa,3698,122
2020-11-15,Gambia,GM,0,0,2347696,Africa,3698,122
2020-11-16,Gambia,GM,4,0,2347696,Africa,3702,122
2020-11-17,Gambia,GM,3,0,2347696,Africa,3705,122
2020-11-18,Gambia,GM,0,0,2347696,Africa,3705,122
2020-11-19,Gambia,GM,0,0,2347696,Africa,3705,122
2020-11-20,Gambia,GM,0,0,2347696,Africa,3705,122
2020-11-21,Gambia,GM,0,0,2347696,Africa,3705,122
2020-11-22,Gambia,GM,21,1,2347696,Africa,3726,123
2020-11-23,Gambia,GM,0,0,2347696,Africa,3726,123
2020-11-24,Gambia,GM,0,0,2347696,Africa,3726,123
2020-11-25,Gambia,GM,0,0,2347696,Africa,3726,123
2020-11-26,Gambia,GM,1,0,2347696,Africa,3727,123
2020-11-27,Gambia,GM,1,0,2347696,Africa,3728,123
2020-11-28,Gambia,GM,3,0,2347696,Africa,3731,123
2020-11-29,Gambia,GM,3,0,2347696,Africa,3734,123
2020-11-30,Gambia,GM,0,0,2347696,Africa,3734,123
2020-12-01,Gambia,GM,8,0,2347696,Africa,3742,123
2020-12-02,Gambia,GM,1,0,2347696,Africa,3743,123
2020-12-03,Gambia,GM,22,0,2347696,Africa,3765,123
2020-12-04,Gambia,GM,2,0,2347696,Africa,3767,123
2020-12-05,Gambia,GM,0,0,2347696,Africa,3767,123
2020-12-06,Gambia,GM,3,0,2347696,Africa,3770,123
2020-12-07,Gambia,GM,0,0,2347696,Africa,3770,123
2020-12-08,Gambia,GM,0,0,2347696,Africa,3770,123
2020-12-09,Gambia,GM,2,0,2347696,Africa,3772,123
2020-12-10,Gambia,GM,4,0,2347696,Africa,3776,123
2020-12-11,Gambia,GM,3,0,2347696,Africa,3779,123
2020-12-12,Gambia,GM,0,0,2347696,Africa,3779,123
2020-12-13,Gambia,GM,1,0,2347696,Africa,3780,123
2020-12-14,Gambia,GM,2,0,2347696,Africa,3782,123
2020-03-14,Guinea,GN,1,0,12771246,Africa,1,0
2020-03-15,Guinea,GN,0,0,12771246,Africa,1,0
2020-03-17,Guinea,GN,0,0,12771246,Africa,1,0
2020-03-18,Guinea,GN,0,0,12771246,Africa,1,0
2020-03-19,Guinea,GN,0,0,12771246,Africa,1,0
2020-03-20,Guinea,GN,0,0,12771246,Africa,1,0
2020-03-21,Guinea,GN,1,0,12771246,Africa,2,0
2020-03-22,Guinea,GN,0,0,12771246,Africa,2,0
2020-03-23,Guinea,GN,0,0,12771246,Africa,2,0
2020-03-24,Guinea,GN,0,0,12771246,Africa,2,0
2020-03-25,Guinea,GN,2,0,12771246,Africa,4,0
2020-03-26,Guinea,GN,0,0,12771246,Africa,4,0
2020-03-27,Guinea,GN,1,0,12771246,Africa,5,0
2020-03-28,Guinea,GN,0,0,12771246,Africa,5,0
2020-03-29,Guinea,GN,3,0,12771246,Africa,8,0
2020-03-30,Guinea,GN,0,0,12771246,Africa,8,0
2020-03-31,Guinea,GN,8,0,12771246,Africa,16,0
2020-04-01,Guinea,GN,0,0,12771246,Africa,16,0
2020-04-02,Guinea,GN,14,0,12771246,Africa,30,0
2020-04-03,Guinea,GN,22,0,12771246,Africa,52,0
2020-04-04,Guinea,GN,0,0,12771246,Africa,52,0
2020-04-05,Guinea,GN,59,0,12771246,Africa,111,0
2020-04-06,Guinea,GN,10,0,12771246,Africa,121,0
2020-04-07,Guinea,GN,7,0,12771246,Africa,128,0
2020-04-08,Guinea,GN,16,0,12771246,Africa,144,0
2020-04-09,Guinea,GN,20,0,12771246,Africa,164,0
2020-04-10,Guinea,GN,30,0,12771246,Africa,194,0
2020-04-11,Guinea,GN,18,0,12771246,Africa,212,0
2020-04-12,Guinea,GN,38,0,12771246,Africa,250,0
2020-04-13,Guinea,GN,0,0,12771246,Africa,250,0
2020-04-14,Guinea,GN,69,0,12771246,Africa,319,0
2020-04-15,Guinea,GN,44,0,12771246,Africa,363,0
2020-04-16,Guinea,GN,41,1,12771246,Africa,404,1
2020-04-17,Guinea,GN,34,0,12771246,Africa,438,1
2020-04-18,Guinea,GN,39,2,12771246,Africa,477,3
2020-04-19,Guinea,GN,0,0,12771246,Africa,477,3
2020-04-20,Guinea,GN,102,2,12771246,Africa,579,5
2020-04-21,Guinea,GN,43,0,12771246,Africa,622,5
2020-04-22,Guinea,GN,66,1,12771246,Africa,688,6
2020-04-23,Guinea,GN,73,0,12771246,Africa,761,6
2020-04-24,Guinea,GN,101,0,12771246,Africa,862,6
2020-04-25,Guinea,GN,92,0,12771246,Africa,954,6
2020-04-26,Guinea,GN,42,1,12771246,Africa,996,7
2020-04-27,Guinea,GN,98,0,12771246,Africa,1094,7
2020-04-28,Guinea,GN,69,0,12771246,Africa,1163,7
2020-04-29,Guinea,GN,77,0,12771246,Africa,1240,7
2020-04-30,Guinea,GN,111,0,12771246,Africa,1351,7
2020-05-01,Guinea,GN,144,0,12771246,Africa,1495,7
2020-05-02,Guinea,GN,42,0,12771246,Africa,1537,7
2020-05-03,Guinea,GN,49,0,12771246,Africa,1586,7
2020-05-04,Guinea,GN,0,0,12771246,Africa,1586,7
2020-05-05,Guinea,GN,124,2,12771246,Africa,1710,9
2020-05-06,Guinea,GN,101,1,12771246,Africa,1811,10
2020-05-07,Guinea,GN,45,1,12771246,Africa,1856,11
2020-05-08,Guinea,GN,71,0,12771246,Africa,1927,11
2020-05-09,Guinea,GN,82,0,12771246,Africa,2009,11
2020-05-10,Guinea,GN,33,0,12771246,Africa,2042,11
2020-05-11,Guinea,GN,104,0,12771246,Africa,2146,11
2020-05-12,Guinea,GN,67,0,12771246,Africa,2213,11
2020-05-13,Guinea,GN,0,0,12771246,Africa,2213,11
2020-05-14,Guinea,GN,161,3,12771246,Africa,2374,14
2020-05-15,Guinea,GN,99,0,12771246,Africa,2473,14
2020-05-16,Guinea,GN,58,1,12771246,Africa,2531,15
2020-05-17,Guinea,GN,127,1,12771246,Africa,2658,16
2020-05-18,Guinea,GN,0,0,12771246,Africa,2658,16
2020-05-19,Guinea,GN,138,0,12771246,Africa,2796,16
2020-05-20,Guinea,GN,67,2,12771246,Africa,2863,18
2020-05-21,Guinea,GN,0,0,12771246,Africa,2863,18
2020-05-22,Guinea,GN,204,1,12771246,Africa,3067,19
2020-05-23,Guinea,GN,0,0,12771246,Africa,3067,19
2020-05-24,Guinea,GN,109,1,12771246,Africa,3176,20
2020-05-25,Guinea,GN,99,0,12771246,Africa,3275,20
2020-05-26,Guinea,GN,0,0,12771246,Africa,3275,20
2020-05-27,Guinea,GN,83,0,12771246,Africa,3358,20
2020-05-28,Guinea,GN,88,1,12771246,Africa,3446,21
2020-05-29,Guinea,GN,107,1,12771246,Africa,3553,22
2020-05-30,Guinea,GN,103,0,12771246,Africa,3656,22
2020-05-31,Guinea,GN,50,1,12771246,Africa,3706,23
2020-06-01,Guinea,GN,65,0,12771246,Africa,3771,23
2020-06-02,Guinea,GN,73,0,12771246,Africa,3844,23
2020-06-03,Guinea,GN,0,0,12771246,Africa,3844,23
2020-06-04,Guinea,GN,42,0,12771246,Africa,3886,23
2020-06-05,Guinea,GN,105,0,12771246,Africa,3991,23
2020-06-06,Guinea,GN,69,0,12771246,Africa,4060,23
2020-06-07,Guinea,GN,57,0,12771246,Africa,4117,23
2020-06-08,Guinea,GN,48,0,12771246,Africa,4165,23
2020-06-09,Guinea,GN,51,0,12771246,Africa,4216,23
2020-06-10,Guinea,GN,42,0,12771246,Africa,4258,23
2020-06-11,Guinea,GN,0,0,12771246,Africa,4258,23
2020-06-12,Guinea,GN,114,0,12771246,Africa,4372,23
2020-06-13,Guinea,GN,54,1,12771246,Africa,4426,24
2020-06-14,Guinea,GN,58,1,12771246,Africa,4484,25
2020-06-15,Guinea,GN,48,0,12771246,Africa,4532,25
2020-06-16,Guinea,GN,40,1,12771246,Africa,4572,26
2020-06-17,Guinea,GN,67,0,12771246,Africa,4639,26
2020-06-18,Guinea,GN,29,0,12771246,Africa,4668,26
2020-06-19,Guinea,GN,173,0,12771246,Africa,4841,26
2020-06-20,Guinea,GN,63,1,12771246,Africa,4904,27
2020-06-21,Guinea,GN,56,0,12771246,Africa,4960,27
2020-06-22,Guinea,GN,28,0,12771246,Africa,4988,27
2020-06-23,Guinea,GN,0,0,12771246,Africa,4988,27
2020-06-24,Guinea,GN,116,2,12771246,Africa,5104,29
2020-06-25,Guinea,GN,70,0,12771246,Africa,5174,29
2020-06-26,Guinea,GN,37,0,12771246,Africa,5211,29
2020-06-27,Guinea,GN,49,0,12771246,Africa,5260,29
2020-06-28,Guinea,GN,31,1,12771246,Africa,5291,30
2020-06-29,Guinea,GN,51,1,12771246,Africa,5342,31
2020-06-30,Guinea,GN,9,0,12771246,Africa,5351,31
2020-07-01,Guinea,GN,40,2,12771246,Africa,5391,33
2020-07-02,Guinea,GN,13,0,12771246,Africa,5404,33
2020-07-03,Guinea,GN,46,0,12771246,Africa,5450,33
2020-07-04,Guinea,GN,71,0,12771246,Africa,5521,33
2020-07-05,Guinea,GN,49,1,12771246,Africa,5570,34
2020-07-06,Guinea,GN,40,0,12771246,Africa,5610,34
2020-07-07,Guinea,GN,26,0,12771246,Africa,5636,34
2020-07-08,Guinea,GN,61,0,12771246,Africa,5697,34
2020-07-09,Guinea,GN,0,0,12771246,Africa,5697,34
2020-07-10,Guinea,GN,184,2,12771246,Africa,5881,36
2020-07-11,Guinea,GN,88,1,12771246,Africa,5969,37
2020-07-12,Guinea,GN,75,0,12771246,Africa,6044,37
2020-07-13,Guinea,GN,97,0,12771246,Africa,6141,37
2020-07-14,Guinea,GN,0,0,12771246,Africa,6141,37
2020-07-15,Guinea,GN,0,0,12771246,Africa,6141,37
2020-07-16,Guinea,GN,135,1,12771246,Africa,6276,38
2020-07-17,Guinea,GN,0,0,12771246,Africa,6276,38
2020-07-18,Guinea,GN,154,1,12771246,Africa,6430,39
2020-07-19,Guinea,GN,61,0,12771246,Africa,6491,39
2020-07-20,Guinea,GN,53,0,12771246,Africa,6544,39
2020-07-21,Guinea,GN,46,1,12771246,Africa,6590,40
2020-07-22,Guinea,GN,62,1,12771246,Africa,6652,41
2020-07-23,Guinea,GN,95,0,12771246,Africa,6747,41
2020-07-24,Guinea,GN,59,1,12771246,Africa,6806,42
2020-07-25,Guinea,GN,61,0,12771246,Africa,6867,42
2020-07-26,Guinea,GN,60,0,12771246,Africa,6927,42
2020-07-27,Guinea,GN,81,1,12771246,Africa,7008,43
2020-07-28,Guinea,GN,47,2,12771246,Africa,7055,45
2020-07-29,Guinea,GN,71,1,12771246,Africa,7126,46
2020-07-30,Guinea,GN,57,0,12771246,Africa,7183,46
2020-07-31,Guinea,GN,59,0,12771246,Africa,7242,46
2020-08-01,Guinea,GN,66,0,12771246,Africa,7308,46
2020-08-02,Guinea,GN,9,0,12771246,Africa,7317,46
2020-08-03,Guinea,GN,47,0,12771246,Africa,7364,46
2020-08-04,Guinea,GN,0,0,12771246,Africa,7364,46
2020-08-05,Guinea,GN,125,2,12771246,Africa,7489,48
2020-08-06,Guinea,GN,86,1,12771246,Africa,7575,49
2020-08-07,Guinea,GN,89,0,12771246,Africa,7664,49
2020-08-08,Guinea,GN,113,1,12771246,Africa,7777,50
2020-08-09,Guinea,GN,98,0,12771246,Africa,7875,50
2020-08-10,Guinea,GN,55,0,12771246,Africa,7930,50
2020-08-11,Guinea,GN,0,0,12771246,Africa,7930,50
2020-08-12,Guinea,GN,88,0,12771246,Africa,8018,50
2020-08-13,Guinea,GN,98,0,12771246,Africa,8116,50
2020-08-14,Guinea,GN,82,0,12771246,Africa,8198,50
2020-08-15,Guinea,GN,62,0,12771246,Africa,8260,50
2020-08-16,Guinea,GN,83,0,12771246,Africa,8343,50
2020-08-17,Guinea,GN,139,1,12771246,Africa,8482,51
2020-08-18,Guinea,GN,138,0,12771246,Africa,8620,51
2020-08-19,Guinea,GN,95,1,12771246,Africa,8715,52
2020-08-20,Guinea,GN,77,1,12771246,Africa,8792,53
2020-08-21,Guinea,GN,84,0,12771246,Africa,8876,53
2020-08-22,Guinea,GN,56,0,12771246,Africa,8932,53
2020-08-23,Guinea,GN,0,0,12771246,Africa,8932,53
2020-08-24,Guinea,GN,35,0,12771246,Africa,8967,53
2020-08-25,Guinea,GN,46,1,12771246,Africa,9013,54
2020-08-26,Guinea,GN,115,3,12771246,Africa,9128,57
2020-08-27,Guinea,GN,39,0,12771246,Africa,9167,57
2020-08-28,Guinea,GN,46,1,12771246,Africa,9213,58
2020-08-29,Guinea,GN,38,1,12771246,Africa,9251,59
2020-08-30,Guinea,GN,0,0,12771246,Africa,9251,59
2020-08-31,Guinea,GN,120,0,12771246,Africa,9371,59
2020-09-01,Guinea,GN,38,0,12771246,Africa,9409,59
2020-09-02,Guinea,GN,70,0,12771246,Africa,9479,59
2020-09-03,Guinea,GN,0,0,12771246,Africa,9479,59
2020-09-04,Guinea,GN,47,1,12771246,Africa,9526,60
2020-09-05,Guinea,GN,53,1,12771246,Africa,9579,61
2020-09-06,Guinea,GN,70,0,12771246,Africa,9649,61
2020-09-07,Guinea,GN,73,0,12771246,Africa,9722,61
2020-09-08,Guinea,GN,76,0,12771246,Africa,9798,61
2020-09-09,Guinea,GN,50,2,12771246,Africa,9848,63
2020-09-10,Guinea,GN,37,0,12771246,Africa,9885,63
2020-09-11,Guinea,GN,61,0,12771246,Africa,9946,63
2020-09-12,Guinea,GN,33,0,12771246,Africa,9979,63
2020-09-13,Guinea,GN,41,0,12771246,Africa,10020,63
2020-09-14,Guinea,GN,0,0,12771246,Africa,10020,63
2020-09-15,Guinea,GN,41,0,12771246,Africa,10061,63
2020-09-16,Guinea,GN,50,0,12771246,Africa,10111,63
2020-09-17,Guinea,GN,43,0,12771246,Africa,10154,63
2020-09-18,Guinea,GN,0,0,12771246,Africa,10154,63
2020-09-19,Guinea,GN,77,0,12771246,Africa,10231,63
2020-09-20,Guinea,GN,55,0,12771246,Africa,10286,63
2020-09-21,Guinea,GN,39,1,12771246,Africa,10325,64
2020-09-22,Guinea,GN,19,1,12771246,Africa,10344,65
2020-09-23,Guinea,GN,43,0,12771246,Africa,10387,65
2020-09-24,Guinea,GN,47,0,12771246,Africa,10434,65
2020-09-25,Guinea,GN,44,0,12771246,Africa,10478,65
2020-09-26,Guinea,GN,0,0,12771246,Africa,10478,65
2020-09-27,Guinea,GN,70,1,12771246,Africa,10548,66
2020-09-28,Guinea,GN,32,0,12771246,Africa,10580,66
2020-09-29,Guinea,GN,18,0,12771246,Africa,10598,66
2020-09-30,Guinea,GN,36,0,12771246,Africa,10634,66
2020-10-01,Guinea,GN,18,0,12771246,Africa,10652,66
2020-10-02,Guinea,GN,0,0,12771246,Africa,10652,66
2020-10-03,Guinea,GN,83,0,12771246,Africa,10735,66
2020-10-04,Guinea,GN,0,0,12771246,Africa,10735,66
2020-10-05,Guinea,GN,19,0,12771246,Africa,10754,66
2020-10-06,Guinea,GN,46,1,12771246,Africa,10800,67
2020-10-07,Guinea,GN,63,1,12771246,Africa,10863,68
2020-10-08,Guinea,GN,0,0,12771246,Africa,10863,68
2020-10-09,Guinea,GN,38,0,12771246,Africa,10901,68
2020-10-10,Guinea,GN,53,0,12771246,Africa,10954,68
2020-10-11,Guinea,GN,42,1,12771246,Africa,10996,69
2020-10-12,Guinea,GN,26,0,12771246,Africa,11022,69
2020-10-13,Guinea,GN,40,1,12771246,Africa,11062,70
2020-10-14,Guinea,GN,72,0,12771246,Africa,11134,70
2020-10-15,Guinea,GN,54,0,12771246,Africa,11188,70
2020-10-16,Guinea,GN,67,0,12771246,Africa,11255,70
2020-10-17,Guinea,GN,107,0,12771246,Africa,11362,70
2020-10-18,Guinea,GN,116,0,12771246,Africa,11478,70
2020-10-19,Guinea,GN,40,0,12771246,Africa,11518,70
2020-10-20,Guinea,GN,0,0,12771246,Africa,11518,70
2020-10-21,Guinea,GN,20,0,12771246,Africa,11538,70
2020-10-22,Guinea,GN,97,1,12771246,Africa,11635,71
2020-10-23,Guinea,GN,0,0,12771246,Africa,11635,71
2020-10-24,Guinea,GN,0,0,12771246,Africa,11635,71
2020-10-25,Guinea,GN,34,0,12771246,Africa,11669,71
2020-10-26,Guinea,GN,0,0,12771246,Africa,11669,71
2020-10-27,Guinea,GN,0,0,12771246,Africa,11669,71
2020-10-28,Guinea,GN,150,0,12771246,Africa,11819,71
2020-10-29,Guinea,GN,0,0,12771246,Africa,11819,71
2020-10-30,Guinea,GN,201,0,12771246,Africa,12020,71
2020-10-31,Guinea,GN,52,1,12771246,Africa,12072,72
2020-11-01,Guinea,GN,0,0,12771246,Africa,12072,72
2020-11-02,Guinea,GN,123,1,12771246,Africa,12195,73
2020-11-03,Guinea,GN,18,0,12771246,Africa,12213,73
2020-11-04,Guinea,GN,0,0,12771246,Africa,12213,73
2020-11-05,Guinea,GN,118,0,12771246,Africa,12331,73
2020-11-06,Guinea,GN,32,0,12771246,Africa,12363,73
2020-11-07,Guinea,GN,0,0,12771246,Africa,12363,73
2020-11-08,Guinea,GN,37,0,12771246,Africa,12400,73
2020-11-09,Guinea,GN,26,1,12771246,Africa,12426,74
2020-11-10,Guinea,GN,33,0,12771246,Africa,12459,74
2020-11-11,Guinea,GN,25,0,12771246,Africa,12484,74
2020-11-12,Guinea,GN,32,0,12771246,Africa,12516,74
2020-11-13,Guinea,GN,21,0,12771246,Africa,12537,74
2020-11-14,Guinea,GN,0,0,12771246,Africa,12537,74
2020-11-15,Guinea,GN,48,0,12771246,Africa,12585,74
2020-11-16,Guinea,GN,26,1,12771246,Africa,12611,75
2020-11-17,Guinea,GN,13,0,12771246,Africa,12624,75
2020-11-18,Guinea,GN,30,0,12771246,Africa,12654,75
2020-11-19,Guinea,GN,59,0,12771246,Africa,12713,75
2020-11-20,Guinea,GN,0,0,12771246,Africa,12713,75
2020-11-21,Guinea,GN,85,0,12771246,Africa,12798,75
2020-11-22,Guinea,GN,0,0,12771246,Africa,12798,75
2020-11-23,Guinea,GN,28,0,12771246,Africa,12826,75
2020-11-24,Guinea,GN,37,0,12771246,Africa,12863,75
2020-11-25,Guinea,GN,66,1,12771246,Africa,12929,76
2020-11-26,Guinea,GN,20,0,12771246,Africa,12949,76
2020-11-27,Guinea,GN,0,0,12771246,Africa,12949,76
2020-11-28,Guinea,GN,90,0,12771246,Africa,13039,76
2020-11-29,Guinea,GN,0,0,12771246,Africa,13039,76
2020-11-30,Guinea,GN,0,0,12771246,Africa,13039,76
2020-12-01,Guinea,GN,80,0,12771246,Africa,13119,76
2020-12-02,Guinea,GN,0,0,12771246,Africa,13119,76
2020-12-03,Guinea,GN,24,0,12771246,Africa,13143,76
2020-12-04,Guinea,GN,43,0,12771246,Africa,13186,76
2020-12-05,Guinea,GN,0,0,12771246,Africa,13186,76
2020-12-06,Guinea,GN,47,0,12771246,Africa,13233,76
2020-12-07,Guinea,GN,0,0,12771246,Africa,13233,76
2020-12-08,Guinea,GN,31,3,12771246,Africa,13264,79
2020-12-09,Guinea,GN,0,0,12771246,Africa,13264,79
2020-12-10,Guinea,GN,61,0,12771246,Africa,13325,79
2020-12-11,Guinea,GN,43,0,12771246,Africa,13368,79
2020-12-12,Guinea,GN,30,0,12771246,Africa,13398,79
2020-12-13,Guinea,GN,22,0,12771246,Africa,13420,79
2020-12-14,Guinea,GN,0,0,12771246,Africa,13420,79
2020-03-15,Equatorial_Guinea,GQ,1,0,1355982,Africa,1,0
2020-03-16,Equatorial_Guinea,GQ,0,0,1355982,Africa,1,0
2020-03-17,Equatorial_Guinea,GQ,0,0,1355982,Africa,1,0
2020-03-18,Equatorial_Guinea,GQ,0,0,1355982,Africa,1,0
2020-03-19,Equatorial_Guinea,GQ,2,0,1355982,Africa,3,0
2020-03-20,Equatorial_Guinea,GQ,1,0,1355982,Africa,4,0
2020-03-21,Equatorial_Guinea,GQ,0,0,1355982,Africa,4,0
2020-03-22,Equatorial_Guinea,GQ,2,0,1355982,Africa,6,0
2020-03-23,Equatorial_Guinea,GQ,0,0,1355982,Africa,6,0
2020-03-24,Equatorial_Guinea,GQ,3,0,1355982,Africa,9,0
2020-03-25,Equatorial_Guinea,GQ,0,0,1355982,Africa,9,0
2020-03-26,Equatorial_Guinea,GQ,2,0,1355982,Africa,11,0
2020-03-27,Equatorial_Guinea,GQ,1,0,1355982,Africa,12,0
2020-03-28,Equatorial_Guinea,GQ,1,0,1355982,Africa,13,0
2020-03-29,Equatorial_Guinea,GQ,0,0,1355982,Africa,13,0
2020-03-30,Equatorial_Guinea,GQ,1,0,1355982,Africa,14,0
2020-03-31,Equatorial_Guinea,GQ,0,0,1355982,Africa,14,0
2020-04-01,Equatorial_Guinea,GQ,1,0,1355982,Africa,15,0
2020-04-02,Equatorial_Guinea,GQ,0,0,1355982,Africa,15,0
2020-04-03,Equatorial_Guinea,GQ,0,0,1355982,Africa,15,0
2020-04-04,Equatorial_Guinea,GQ,1,0,1355982,Africa,16,0
2020-04-05,Equatorial_Guinea,GQ,0,0,1355982,Africa,16,0
2020-04-06,Equatorial_Guinea,GQ,0,0,1355982,Africa,16,0
2020-04-07,Equatorial_Guinea,GQ,0,0,1355982,Africa,16,0
2020-04-08,Equatorial_Guinea,GQ,0,0,1355982,Africa,16,0
2020-04-09,Equatorial_Guinea,GQ,2,0,1355982,Africa,18,0
2020-04-10,Equatorial_Guinea,GQ,0,0,1355982,Africa,18,0
2020-04-11,Equatorial_Guinea,GQ,0,0,1355982,Africa,18,0
2020-04-12,Equatorial_Guinea,GQ,0,0,1355982,Africa,18,0
2020-04-13,Equatorial_Guinea,GQ,3,0,1355982,Africa,21,0
2020-04-14,Equatorial_Guinea,GQ,0,0,1355982,Africa,21,0
2020-04-15,Equatorial_Guinea,GQ,20,0,1355982,Africa,41,0
2020-04-16,Equatorial_Guinea,GQ,10,0,1355982,Africa,51,0
2020-04-17,Equatorial_Guinea,GQ,0,0,1355982,Africa,51,0
2020-04-18,Equatorial_Guinea,GQ,28,0,1355982,Africa,79,0
2020-04-19,Equatorial_Guinea,GQ,0,0,1355982,Africa,79,0
2020-04-20,Equatorial_Guinea,GQ,0,0,1355982,Africa,79,0
2020-04-21,Equatorial_Guinea,GQ,0,0,1355982,Africa,79,0
2020-04-22,Equatorial_Guinea,GQ,0,0,1355982,Africa,79,0
2020-04-23,Equatorial_Guinea,GQ,4,0,1355982,Africa,83,0
2020-04-24,Equatorial_Guinea,GQ,1,1,1355982,Africa,84,1
2020-04-25,Equatorial_Guinea,GQ,128,0,1355982,Africa,212,1
2020-04-26,Equatorial_Guinea,GQ,2,0,1355982,Africa,214,1
2020-04-27,Equatorial_Guinea,GQ,44,0,1355982,Africa,258,1
2020-04-28,Equatorial_Guinea,GQ,0,0,1355982,Africa,258,1
2020-04-29,Equatorial_Guinea,GQ,57,0,1355982,Africa,315,1
2020-04-30,Equatorial_Guinea,GQ,0,0,1355982,Africa,315,1
2020-05-01,Equatorial_Guinea,GQ,0,0,1355982,Africa,315,1
2020-05-02,Equatorial_Guinea,GQ,0,0,1355982,Africa,315,1
2020-05-03,Equatorial_Guinea,GQ,0,0,1355982,Africa,315,1
2020-05-04,Equatorial_Guinea,GQ,0,0,1355982,Africa,315,1
2020-05-05,Equatorial_Guinea,GQ,0,1,1355982,Africa,315,2
2020-05-06,Equatorial_Guinea,GQ,124,2,1355982,Africa,439,4
2020-05-07,Equatorial_Guinea,GQ,0,0,1355982,Africa,439,4
2020-05-08,Equatorial_Guinea,GQ,0,0,1355982,Africa,439,4
2020-05-09,Equatorial_Guinea,GQ,0,0,1355982,Africa,439,4
2020-05-10,Equatorial_Guinea,GQ,0,0,1355982,Africa,439,4
2020-05-11,Equatorial_Guinea,GQ,0,0,1355982,Africa,439,4
2020-05-12,Equatorial_Guinea,GQ,0,0,1355982,Africa,439,4
2020-05-13,Equatorial_Guinea,GQ,0,0,1355982,Africa,439,4
2020-05-14,Equatorial_Guinea,GQ,83,2,1355982,Africa,522,6
2020-05-15,Equatorial_Guinea,GQ,72,1,1355982,Africa,594,7
2020-05-16,Equatorial_Guinea,GQ,0,0,1355982,Africa,594,7
2020-05-17,Equatorial_Guinea,GQ,0,0,1355982,Africa,594,7
2020-05-18,Equatorial_Guinea,GQ,0,0,1355982,Africa,594,7
2020-05-19,Equatorial_Guinea,GQ,125,0,1355982,Africa,719,7
2020-05-20,Equatorial_Guinea,GQ,171,0,1355982,Africa,890,7
2020-05-21,Equatorial_Guinea,GQ,0,0,1355982,Africa,890,7
2020-05-22,Equatorial_Guinea,GQ,13,3,1355982,Africa,903,10
2020-05-23,Equatorial_Guinea,GQ,0,0,1355982,Africa,903,10
2020-05-24,Equatorial_Guinea,GQ,140,2,1355982,Africa,1043,12
2020-05-25,Equatorial_Guinea,GQ,0,0,1355982,Africa,1043,12
2020-05-26,Equatorial_Guinea,GQ,0,0,1355982,Africa,1043,12
2020-05-27,Equatorial_Guinea,GQ,0,0,1355982,Africa,1043,12
2020-05-28,Equatorial_Guinea,GQ,0,0,1355982,Africa,1043,12
2020-05-29,Equatorial_Guinea,GQ,0,0,1355982,Africa,1043,12
2020-05-30,Equatorial_Guinea,GQ,0,0,1355982,Africa,1043,12
2020-05-31,Equatorial_Guinea,GQ,263,0,1355982,Africa,1306,12
2020-06-01,Equatorial_Guinea,GQ,0,0,1355982,Africa,1306,12
2020-06-02,Equatorial_Guinea,GQ,0,0,1355982,Africa,1306,12
2020-06-03,Equatorial_Guinea,GQ,0,0,1355982,Africa,1306,12
2020-06-04,Equatorial_Guinea,GQ,0,0,1355982,Africa,1306,12
2020-06-05,Equatorial_Guinea,GQ,0,0,1355982,Africa,1306,12
2020-06-06,Equatorial_Guinea,GQ,0,0,1355982,Africa,1306,12
2020-06-07,Equatorial_Guinea,GQ,0,0,1355982,Africa,1306,12
2020-06-08,Equatorial_Guinea,GQ,0,0,1355982,Africa,1306,12
2020-06-09,Equatorial_Guinea,GQ,0,0,1355982,Africa,1306,12
2020-06-10,Equatorial_Guinea,GQ,0,0,1355982,Africa,1306,12
2020-06-11,Equatorial_Guinea,GQ,0,0,1355982,Africa,1306,12
2020-06-12,Equatorial_Guinea,GQ,0,0,1355982,Africa,1306,12
2020-06-13,Equatorial_Guinea,GQ,0,0,1355982,Africa,1306,12
2020-06-14,Equatorial_Guinea,GQ,0,0,1355982,Africa,1306,12
2020-06-15,Equatorial_Guinea,GQ,0,0,1355982,Africa,1306,12
2020-06-16,Equatorial_Guinea,GQ,0,0,1355982,Africa,1306,12
2020-06-17,Equatorial_Guinea,GQ,0,0,1355982,Africa,1306,12
2020-06-18,Equatorial_Guinea,GQ,0,0,1355982,Africa,1306,12
2020-06-19,Equatorial_Guinea,GQ,0,0,1355982,Africa,1306,12
2020-06-20,Equatorial_Guinea,GQ,358,20,1355982,Africa,1664,32
2020-06-21,Equatorial_Guinea,GQ,0,0,1355982,Africa,1664,32
2020-06-22,Equatorial_Guinea,GQ,0,0,1355982,Africa,1664,32
2020-06-23,Equatorial_Guinea,GQ,337,0,1355982,Africa,2001,32
2020-06-24,Equatorial_Guinea,GQ,0,0,1355982,Africa,2001,32
2020-06-25,Equatorial_Guinea,GQ,0,0,1355982,Africa,2001,32
2020-06-26,Equatorial_Guinea,GQ,0,0,1355982,Africa,2001,32
2020-06-27,Equatorial_Guinea,GQ,0,0,1355982,Africa,2001,32
2020-06-28,Equatorial_Guinea,GQ,0,0,1355982,Africa,2001,32
2020-06-29,Equatorial_Guinea,GQ,0,0,1355982,Africa,2001,32
2020-06-30,Equatorial_Guinea,GQ,0,0,1355982,Africa,2001,32
2020-07-01,Equatorial_Guinea,GQ,0,0,1355982,Africa,2001,32
2020-07-02,Equatorial_Guinea,GQ,0,0,1355982,Africa,2001,32
2020-07-03,Equatorial_Guinea,GQ,1070,19,1355982,Africa,3071,51
2020-07-04,Equatorial_Guinea,GQ,0,0,1355982,Africa,3071,51
2020-07-05,Equatorial_Guinea,GQ,0,0,1355982,Africa,3071,51
2020-07-06,Equatorial_Guinea,GQ,0,0,1355982,Africa,3071,51
2020-07-07,Equatorial_Guinea,GQ,0,0,1355982,Africa,3071,51
2020-07-08,Equatorial_Guinea,GQ,0,0,1355982,Africa,3071,51
2020-07-09,Equatorial_Guinea,GQ,0,0,1355982,Africa,3071,51
2020-07-10,Equatorial_Guinea,GQ,0,0,1355982,Africa,3071,51
2020-07-11,Equatorial_Guinea,GQ,0,0,1355982,Africa,3071,51
2020-07-12,Equatorial_Guinea,GQ,0,0,1355982,Africa,3071,51
2020-07-13,Equatorial_Guinea,GQ,0,0,1355982,Africa,3071,51
2020-07-14,Equatorial_Guinea,GQ,0,0,1355982,Africa,3071,51
2020-07-15,Equatorial_Guinea,GQ,0,0,1355982,Africa,3071,51
2020-07-16,Equatorial_Guinea,GQ,0,0,1355982,Africa,3071,51
2020-07-17,Equatorial_Guinea,GQ,0,0,1355982,Africa,3071,51
2020-07-18,Equatorial_Guinea,GQ,0,0,1355982,Africa,3071,51
2020-07-19,Equatorial_Guinea,GQ,0,0,1355982,Africa,3071,51
2020-07-20,Equatorial_Guinea,GQ,0,0,1355982,Africa,3071,51
2020-07-21,Equatorial_Guinea,GQ,0,0,1355982,Africa,3071,51
2020-07-22,Equatorial_Guinea,GQ,0,0,1355982,Africa,3071,51
2020-07-23,Equatorial_Guinea,GQ,0,0,1355982,Africa,3071,51
2020-07-24,Equatorial_Guinea,GQ,0,0,1355982,Africa,3071,51
2020-07-25,Equatorial_Guinea,GQ,0,0,1355982,Africa,3071,51
2020-07-26,Equatorial_Guinea,GQ,0,0,1355982,Africa,3071,51
2020-07-27,Equatorial_Guinea,GQ,0,0,1355982,Africa,3071,51
2020-07-28,Equatorial_Guinea,GQ,0,0,1355982,Africa,3071,51
2020-07-29,Equatorial_Guinea,GQ,0,0,1355982,Africa,3071,51
2020-07-30,Equatorial_Guinea,GQ,0,0,1355982,Africa,3071,51
2020-07-31,Equatorial_Guinea,GQ,0,0,1355982,Africa,3071,51
2020-08-01,Equatorial_Guinea,GQ,0,0,1355982,Africa,3071,51
2020-08-02,Equatorial_Guinea,GQ,1750,32,1355982,Africa,4821,83
2020-08-03,Equatorial_Guinea,GQ,0,0,1355982,Africa,4821,83
2020-08-04,Equatorial_Guinea,GQ,0,0,1355982,Africa,4821,83
2020-08-05,Equatorial_Guinea,GQ,0,0,1355982,Africa,4821,83
2020-08-06,Equatorial_Guinea,GQ,0,0,1355982,Africa,4821,83
2020-08-07,Equatorial_Guinea,GQ,0,0,1355982,Africa,4821,83
2020-08-08,Equatorial_Guinea,GQ,0,0,1355982,Africa,4821,83
2020-08-09,Equatorial_Guinea,GQ,0,0,1355982,Africa,4821,83
2020-08-10,Equatorial_Guinea,GQ,0,0,1355982,Africa,4821,83
2020-08-11,Equatorial_Guinea,GQ,0,0,1355982,Africa,4821,83
2020-08-12,Equatorial_Guinea,GQ,0,0,1355982,Africa,4821,83
2020-08-13,Equatorial_Guinea,GQ,0,0,1355982,Africa,4821,83
2020-08-14,Equatorial_Guinea,GQ,0,0,1355982,Africa,4821,83
2020-08-15,Equatorial_Guinea,GQ,0,0,1355982,Africa,4821,83
2020-08-16,Equatorial_Guinea,GQ,0,0,1355982,Africa,4821,83
2020-08-17,Equatorial_Guinea,GQ,0,0,1355982,Africa,4821,83
2020-08-18,Equatorial_Guinea,GQ,0,0,1355982,Africa,4821,83
2020-08-19,Equatorial_Guinea,GQ,71,0,1355982,Africa,4892,83
2020-08-20,Equatorial_Guinea,GQ,0,0,1355982,Africa,4892,83
2020-08-21,Equatorial_Guinea,GQ,0,0,1355982,Africa,4892,83
2020-08-22,Equatorial_Guinea,GQ,0,0,1355982,Africa,4892,83
2020-08-23,Equatorial_Guinea,GQ,34,0,1355982,Africa,4926,83
2020-08-24,Equatorial_Guinea,GQ,0,0,1355982,Africa,4926,83
2020-08-25,Equatorial_Guinea,GQ,0,0,1355982,Africa,4926,83
2020-08-26,Equatorial_Guinea,GQ,0,0,1355982,Africa,4926,83
2020-08-27,Equatorial_Guinea,GQ,0,0,1355982,Africa,4926,83
2020-08-28,Equatorial_Guinea,GQ,2,0,1355982,Africa,4928,83
2020-08-29,Equatorial_Guinea,GQ,0,0,1355982,Africa,4928,83
2020-08-30,Equatorial_Guinea,GQ,13,0,1355982,Africa,4941,83
2020-08-31,Equatorial_Guinea,GQ,0,0,1355982,Africa,4941,83
2020-09-01,Equatorial_Guinea,GQ,0,0,1355982,Africa,4941,83
2020-09-02,Equatorial_Guinea,GQ,24,0,1355982,Africa,4965,83
2020-09-03,Equatorial_Guinea,GQ,0,0,1355982,Africa,4965,83
2020-09-04,Equatorial_Guinea,GQ,0,0,1355982,Africa,4965,83
2020-09-05,Equatorial_Guinea,GQ,7,0,1355982,Africa,4972,83
2020-09-06,Equatorial_Guinea,GQ,0,0,1355982,Africa,4972,83
2020-09-07,Equatorial_Guinea,GQ,0,0,1355982,Africa,4972,83
2020-09-08,Equatorial_Guinea,GQ,0,0,1355982,Africa,4972,83
2020-09-09,Equatorial_Guinea,GQ,13,0,1355982,Africa,4985,83
2020-09-10,Equatorial_Guinea,GQ,0,0,1355982,Africa,4985,83
2020-09-11,Equatorial_Guinea,GQ,5,0,1355982,Africa,4990,83
2020-09-12,Equatorial_Guinea,GQ,0,0,1355982,Africa,4990,83
2020-09-13,Equatorial_Guinea,GQ,6,0,1355982,Africa,4996,83
2020-09-14,Equatorial_Guinea,GQ,0,0,1355982,Africa,4996,83
2020-09-15,Equatorial_Guinea,GQ,4,0,1355982,Africa,5000,83
2020-09-16,Equatorial_Guinea,GQ,0,0,1355982,Africa,5000,83
2020-09-17,Equatorial_Guinea,GQ,0,0,1355982,Africa,5000,83
2020-09-18,Equatorial_Guinea,GQ,0,0,1355982,Africa,5000,83
2020-09-19,Equatorial_Guinea,GQ,2,0,1355982,Africa,5002,83
2020-09-20,Equatorial_Guinea,GQ,0,0,1355982,Africa,5002,83
2020-09-21,Equatorial_Guinea,GQ,0,0,1355982,Africa,5002,83
2020-09-22,Equatorial_Guinea,GQ,16,0,1355982,Africa,5018,83
2020-09-23,Equatorial_Guinea,GQ,0,0,1355982,Africa,5018,83
2020-09-24,Equatorial_Guinea,GQ,0,0,1355982,Africa,5018,83
2020-09-25,Equatorial_Guinea,GQ,0,0,1355982,Africa,5018,83
2020-09-26,Equatorial_Guinea,GQ,0,0,1355982,Africa,5018,83
2020-09-27,Equatorial_Guinea,GQ,10,0,1355982,Africa,5028,83
2020-09-28,Equatorial_Guinea,GQ,0,0,1355982,Africa,5028,83
2020-09-29,Equatorial_Guinea,GQ,0,0,1355982,Africa,5028,83
2020-09-30,Equatorial_Guinea,GQ,2,0,1355982,Africa,5030,83
2020-10-01,Equatorial_Guinea,GQ,0,0,1355982,Africa,5030,83
2020-10-02,Equatorial_Guinea,GQ,15,0,1355982,Africa,5045,83
2020-10-03,Equatorial_Guinea,GQ,0,0,1355982,Africa,5045,83
2020-10-04,Equatorial_Guinea,GQ,0,0,1355982,Africa,5045,83
2020-10-05,Equatorial_Guinea,GQ,0,0,1355982,Africa,5045,83
2020-10-06,Equatorial_Guinea,GQ,7,0,1355982,Africa,5052,83
2020-10-07,Equatorial_Guinea,GQ,0,0,1355982,Africa,5052,83
2020-10-08,Equatorial_Guinea,GQ,10,0,1355982,Africa,5062,83
2020-10-09,Equatorial_Guinea,GQ,0,0,1355982,Africa,5062,83
2020-10-10,Equatorial_Guinea,GQ,1,0,1355982,Africa,5063,83
2020-10-11,Equatorial_Guinea,GQ,0,0,1355982,Africa,5063,83
2020-10-12,Equatorial_Guinea,GQ,0,0,1355982,Africa,5063,83
2020-10-13,Equatorial_Guinea,GQ,3,0,1355982,Africa,5066,83
2020-10-14,Equatorial_Guinea,GQ,0,0,1355982,Africa,5066,83
2020-10-15,Equatorial_Guinea,GQ,2,0,1355982,Africa,5068,83
2020-10-16,Equatorial_Guinea,GQ,0,0,1355982,Africa,5068,83
2020-10-17,Equatorial_Guinea,GQ,2,0,1355982,Africa,5070,83
2020-10-18,Equatorial_Guinea,GQ,0,0,1355982,Africa,5070,83
2020-10-19,Equatorial_Guinea,GQ,0,0,1355982,Africa,5070,83
2020-10-20,Equatorial_Guinea,GQ,0,0,1355982,Africa,5070,83
2020-10-21,Equatorial_Guinea,GQ,4,0,1355982,Africa,5074,83
2020-10-22,Equatorial_Guinea,GQ,0,0,1355982,Africa,5074,83
2020-10-23,Equatorial_Guinea,GQ,0,0,1355982,Africa,5074,83
2020-10-24,Equatorial_Guinea,GQ,5,0,1355982,Africa,5079,83
2020-10-25,Equatorial_Guinea,GQ,0,0,1355982,Africa,5079,83
2020-10-26,Equatorial_Guinea,GQ,0,0,1355982,Africa,5079,83
2020-10-27,Equatorial_Guinea,GQ,4,0,1355982,Africa,5083,83
2020-10-28,Equatorial_Guinea,GQ,0,0,1355982,Africa,5083,83
2020-10-29,Equatorial_Guinea,GQ,0,0,1355982,Africa,5083,83
2020-10-30,Equatorial_Guinea,GQ,0,0,1355982,Africa,5083,83
2020-10-31,Equatorial_Guinea,GQ,5,0,1355982,Africa,5088,83
2020-11-01,Equatorial_Guinea,GQ,0,0,1355982,Africa,5088,83
2020-11-02,Equatorial_Guinea,GQ,1,0,1355982,Africa,5089,83
2020-11-03,Equatorial_Guinea,GQ,0,0,1355982,Africa,5089,83
2020-11-04,Equatorial_Guinea,GQ,0,0,1355982,Africa,5089,83
2020-11-05,Equatorial_Guinea,GQ,0,0,1355982,Africa,5089,83
2020-11-06,Equatorial_Guinea,GQ,3,2,1355982,Africa,5092,85
2020-11-07,Equatorial_Guinea,GQ,0,0,1355982,Africa,5092,85
2020-11-08,Equatorial_Guinea,GQ,0,0,1355982,Africa,5092,85
2020-11-09,Equatorial_Guinea,GQ,0,0,1355982,Africa,5092,85
2020-11-10,Equatorial_Guinea,GQ,0,0,1355982,Africa,5092,85
2020-11-11,Equatorial_Guinea,GQ,10,0,1355982,Africa,5102,85
2020-11-12,Equatorial_Guinea,GQ,2,0,1355982,Africa,5104,85
2020-11-13,Equatorial_Guinea,GQ,0,0,1355982,Africa,5104,85
2020-11-14,Equatorial_Guinea,GQ,0,0,1355982,Africa,5104,85
2020-11-15,Equatorial_Guinea,GQ,0,0,1355982,Africa,5104,85
2020-11-16,Equatorial_Guinea,GQ,0,0,1355982,Africa,5104,85
2020-11-17,Equatorial_Guinea,GQ,17,0,1355982,Africa,5121,85
2020-11-18,Equatorial_Guinea,GQ,0,0,1355982,Africa,5121,85
2020-11-19,Equatorial_Guinea,GQ,0,0,1355982,Africa,5121,85
2020-11-20,Equatorial_Guinea,GQ,0,0,1355982,Africa,5121,85
2020-11-21,Equatorial_Guinea,GQ,0,0,1355982,Africa,5121,85
2020-11-22,Equatorial_Guinea,GQ,9,0,1355982,Africa,5130,85
2020-11-23,Equatorial_Guinea,GQ,0,0,1355982,Africa,5130,85
2020-11-24,Equatorial_Guinea,GQ,7,0,1355982,Africa,5137,85
2020-11-25,Equatorial_Guinea,GQ,0,0,1355982,Africa,5137,85
2020-11-26,Equatorial_Guinea,GQ,9,0,1355982,Africa,5146,85
2020-11-27,Equatorial_Guinea,GQ,0,0,1355982,Africa,5146,85
2020-11-28,Equatorial_Guinea,GQ,7,0,1355982,Africa,5153,85
2020-11-29,Equatorial_Guinea,GQ,0,0,1355982,Africa,5153,85
2020-11-30,Equatorial_Guinea,GQ,0,0,1355982,Africa,5153,85
2020-12-01,Equatorial_Guinea,GQ,0,0,1355982,Africa,5153,85
2020-12-02,Equatorial_Guinea,GQ,3,0,1355982,Africa,5156,85
2020-12-03,Equatorial_Guinea,GQ,3,0,1355982,Africa,5159,85
2020-12-04,Equatorial_Guinea,GQ,0,0,1355982,Africa,5159,85
2020-12-05,Equatorial_Guinea,GQ,0,0,1355982,Africa,5159,85
2020-12-06,Equatorial_Guinea,GQ,0,0,1355982,Africa,5159,85
2020-12-07,Equatorial_Guinea,GQ,7,0,1355982,Africa,5166,85
2020-12-08,Equatorial_Guinea,GQ,0,0,1355982,Africa,5166,85
2020-12-09,Equatorial_Guinea,GQ,0,0,1355982,Africa,5166,85
2020-12-10,Equatorial_Guinea,GQ,17,0,1355982,Africa,5183,85
2020-12-11,Equatorial_Guinea,GQ,0,0,1355982,Africa,5183,85
2020-12-12,Equatorial_Guinea,GQ,2,0,1355982,Africa,5185,85
2020-12-13,Equatorial_Guinea,GQ,0,0,1355982,Africa,5185,85
2020-12-14,Equatorial_Guinea,GQ,0,0,1355982,Africa,5185,85
2020-03-15,Guatemala,GT,1,0,17581476,America,1,0
2020-03-16,Guatemala,GT,0,1,17581476,America,1,1
2020-03-17,Guatemala,GT,5,0,17581476,America,6,1
2020-03-18,Guatemala,GT,0,0,17581476,America,6,1
2020-03-19,Guatemala,GT,2,0,17581476,America,8,1
2020-03-20,Guatemala,GT,1,0,17581476,America,9,1
2020-03-21,Guatemala,GT,4,0,17581476,America,13,1
2020-03-22,Guatemala,GT,4,0,17581476,America,17,1
2020-03-23,Guatemala,GT,2,0,17581476,America,19,1
2020-03-24,Guatemala,GT,1,0,17581476,America,20,1
2020-03-25,Guatemala,GT,1,0,17581476,America,21,1
2020-03-26,Guatemala,GT,3,0,17581476,America,24,1
2020-03-27,Guatemala,GT,1,0,17581476,America,25,1
2020-03-28,Guatemala,GT,7,0,17581476,America,32,1
2020-03-29,Guatemala,GT,2,0,17581476,America,34,1
2020-03-30,Guatemala,GT,2,0,17581476,America,36,1
2020-03-31,Guatemala,GT,0,0,17581476,America,36,1
2020-04-01,Guatemala,GT,2,0,17581476,America,38,1
2020-04-02,Guatemala,GT,8,0,17581476,America,46,1
2020-04-03,Guatemala,GT,1,0,17581476,America,47,1
2020-04-04,Guatemala,GT,3,0,17581476,America,50,1
2020-04-05,Guatemala,GT,11,1,17581476,America,61,2
2020-04-06,Guatemala,GT,9,1,17581476,America,70,3
2020-04-07,Guatemala,GT,4,0,17581476,America,74,3
2020-04-08,Guatemala,GT,6,0,17581476,America,80,3
2020-04-09,Guatemala,GT,7,0,17581476,America,87,3
2020-04-10,Guatemala,GT,39,0,17581476,America,126,3
2020-04-11,Guatemala,GT,11,0,17581476,America,137,3
2020-04-12,Guatemala,GT,16,0,17581476,America,153,3
2020-04-13,Guatemala,GT,3,2,17581476,America,156,5
2020-04-14,Guatemala,GT,11,0,17581476,America,167,5
2020-04-15,Guatemala,GT,13,0,17581476,America,180,5
2020-04-16,Guatemala,GT,16,0,17581476,America,196,5
2020-04-17,Guatemala,GT,18,2,17581476,America,214,7
2020-04-18,Guatemala,GT,21,0,17581476,America,235,7
2020-04-19,Guatemala,GT,22,0,17581476,America,257,7
2020-04-20,Guatemala,GT,32,0,17581476,America,289,7
2020-04-21,Guatemala,GT,5,0,17581476,America,294,7
2020-04-22,Guatemala,GT,22,1,17581476,America,316,8
2020-04-23,Guatemala,GT,26,2,17581476,America,342,10
2020-04-24,Guatemala,GT,42,1,17581476,America,384,11
2020-04-25,Guatemala,GT,46,0,17581476,America,430,11
2020-04-26,Guatemala,GT,43,2,17581476,America,473,13
2020-04-27,Guatemala,GT,27,2,17581476,America,500,15
2020-04-28,Guatemala,GT,30,0,17581476,America,530,15
2020-04-29,Guatemala,GT,27,1,17581476,America,557,16
2020-04-30,Guatemala,GT,28,0,17581476,America,585,16
2020-05-01,Guatemala,GT,14,0,17581476,America,599,16
2020-05-02,Guatemala,GT,45,0,17581476,America,644,16
2020-05-03,Guatemala,GT,44,1,17581476,America,688,17
2020-05-04,Guatemala,GT,15,0,17581476,America,703,17
2020-05-05,Guatemala,GT,27,2,17581476,America,730,19
2020-05-06,Guatemala,GT,33,0,17581476,America,763,19
2020-05-07,Guatemala,GT,35,2,17581476,America,798,21
2020-05-08,Guatemala,GT,34,2,17581476,America,832,23
2020-05-09,Guatemala,GT,68,1,17581476,America,900,24
2020-05-10,Guatemala,GT,67,0,17581476,America,967,24
2020-05-11,Guatemala,GT,85,2,17581476,America,1052,26
2020-05-12,Guatemala,GT,62,0,17581476,America,1114,26
2020-05-13,Guatemala,GT,85,1,17581476,America,1199,27
2020-05-14,Guatemala,GT,143,2,17581476,America,1342,29
2020-05-15,Guatemala,GT,176,0,17581476,America,1518,29
2020-05-16,Guatemala,GT,125,1,17581476,America,1643,30
2020-05-17,Guatemala,GT,120,3,17581476,America,1763,33
2020-05-18,Guatemala,GT,149,2,17581476,America,1912,35
2020-05-19,Guatemala,GT,89,3,17581476,America,2001,38
2020-05-20,Guatemala,GT,132,5,17581476,America,2133,43
2020-05-21,Guatemala,GT,132,2,17581476,America,2265,45
2020-05-22,Guatemala,GT,247,3,17581476,America,2512,48
2020-05-23,Guatemala,GT,231,3,17581476,America,2743,51
2020-05-24,Guatemala,GT,311,4,17581476,America,3054,55
2020-05-25,Guatemala,GT,370,3,17581476,America,3424,58
2020-05-26,Guatemala,GT,336,1,17581476,America,3760,59
2020-05-27,Guatemala,GT,194,4,17581476,America,3954,63
2020-05-28,Guatemala,GT,191,5,17581476,America,4145,68
2020-05-29,Guatemala,GT,203,12,17581476,America,4348,80
2020-05-30,Guatemala,GT,259,10,17581476,America,4607,90
2020-05-31,Guatemala,GT,132,12,17581476,America,4739,102
2020-06-01,Guatemala,GT,348,6,17581476,America,5087,108
2020-06-02,Guatemala,GT,249,8,17581476,America,5336,116
2020-06-03,Guatemala,GT,250,7,17581476,America,5586,123
2020-06-04,Guatemala,GT,174,20,17581476,America,5760,143
2020-06-05,Guatemala,GT,394,15,17581476,America,6154,158
2020-06-06,Guatemala,GT,331,58,17581476,America,6485,216
2020-06-07,Guatemala,GT,307,14,17581476,America,6792,230
2020-06-08,Guatemala,GT,263,22,17581476,America,7055,252
2020-06-09,Guatemala,GT,447,15,17581476,America,7502,267
2020-06-10,Guatemala,GT,364,22,17581476,America,7866,289
2020-06-11,Guatemala,GT,355,27,17581476,America,8221,316
2020-06-12,Guatemala,GT,340,18,17581476,America,8561,334
2020-06-13,Guatemala,GT,421,17,17581476,America,8982,351
2020-06-14,Guatemala,GT,509,16,17581476,America,9491,367
2020-06-15,Guatemala,GT,354,17,17581476,America,9845,384
2020-06-16,Guatemala,GT,427,15,17581476,America,10272,399
2020-06-17,Guatemala,GT,434,19,17581476,America,10706,418
2020-06-18,Guatemala,GT,545,14,17581476,America,11251,432
2020-06-19,Guatemala,GT,617,17,17581476,America,11868,449
2020-06-20,Guatemala,GT,641,34,17581476,America,12509,483
2020-06-21,Guatemala,GT,246,31,17581476,America,12755,514
2020-06-22,Guatemala,GT,390,17,17581476,America,13145,531
2020-06-23,Guatemala,GT,624,16,17581476,America,13769,547
2020-06-24,Guatemala,GT,771,35,17581476,America,14540,582
2020-06-25,Guatemala,GT,279,19,17581476,America,14819,601
2020-06-26,Guatemala,GT,800,22,17581476,America,15619,623
2020-06-27,Guatemala,GT,209,49,17581476,America,15828,672
2020-06-28,Guatemala,GT,569,34,17581476,America,16397,706
2020-06-29,Guatemala,GT,533,21,17581476,America,16930,727
2020-06-30,Guatemala,GT,479,19,17581476,America,17409,746
2020-07-01,Guatemala,GT,687,27,17581476,America,18096,773
2020-07-02,Guatemala,GT,915,44,17581476,America,19011,817
2020-07-03,Guatemala,GT,1061,26,17581476,America,20072,843
2020-07-04,Guatemala,GT,1221,37,17581476,America,21293,880
2020-07-05,Guatemala,GT,1208,40,17581476,America,22501,920
2020-07-06,Guatemala,GT,747,27,17581476,America,23248,947
2020-07-07,Guatemala,GT,724,34,17581476,America,23972,981
2020-07-08,Guatemala,GT,815,23,17581476,America,24787,1004
2020-07-09,Guatemala,GT,624,49,17581476,America,25411,1053
2020-07-10,Guatemala,GT,1247,39,17581476,America,26658,1092
2020-07-11,Guatemala,GT,961,47,17581476,America,27619,1139
2020-07-12,Guatemala,GT,979,33,17581476,America,28598,1172
2020-07-13,Guatemala,GT,757,47,17581476,America,29355,1219
2020-07-14,Guatemala,GT,387,25,17581476,America,29742,1244
2020-07-15,Guatemala,GT,1130,58,17581476,America,30872,1302
2020-07-16,Guatemala,GT,1202,48,17581476,America,32074,1350
2020-07-17,Guatemala,GT,865,54,17581476,America,32939,1404
2020-07-18,Guatemala,GT,870,39,17581476,America,33809,1443
2020-07-19,Guatemala,GT,4233,6,17581476,America,38042,1449
2020-07-20,Guatemala,GT,635,36,17581476,America,38677,1485
2020-07-21,Guatemala,GT,362,17,17581476,America,39039,1502
2020-07-22,Guatemala,GT,1190,29,17581476,America,40229,1531
2020-07-23,Guatemala,GT,906,42,17581476,America,41135,1573
2020-07-24,Guatemala,GT,1057,59,17581476,America,42192,1632
2020-07-25,Guatemala,GT,1091,37,17581476,America,43283,1669
2020-07-26,Guatemala,GT,1209,0,17581476,America,44492,1669
2020-07-27,Guatemala,GT,561,65,17581476,America,45053,1734
2020-07-28,Guatemala,GT,0,0,17581476,America,45053,1734
2020-07-29,Guatemala,GT,6,27,17581476,America,45059,1761
2020-07-30,Guatemala,GT,2546,74,17581476,America,47605,1835
2020-07-31,Guatemala,GT,1221,32,17581476,America,48826,1867
2020-08-01,Guatemala,GT,963,57,17581476,America,49789,1924
2020-08-02,Guatemala,GT,1190,35,17581476,America,50979,1959
2020-08-03,Guatemala,GT,327,36,17581476,America,51306,1995
2020-08-04,Guatemala,GT,236,18,17581476,America,51542,2013
2020-08-05,Guatemala,GT,823,24,17581476,America,52365,2037
2020-08-06,Guatemala,GT,1144,35,17581476,America,53509,2072
2020-08-07,Guatemala,GT,830,47,17581476,America,54339,2119
2020-08-08,Guatemala,GT,931,49,17581476,America,55270,2168
2020-08-09,Guatemala,GT,919,29,17581476,America,56189,2197
2020-08-10,Guatemala,GT,416,14,17581476,America,56605,2211
2020-08-11,Guatemala,GT,382,11,17581476,America,56987,2222
2020-08-12,Guatemala,GT,979,11,17581476,America,57966,2233
2020-08-13,Guatemala,GT,1123,34,17581476,America,59089,2267
2020-08-14,Guatemala,GT,1195,29,17581476,America,60284,2296
2020-08-15,Guatemala,GT,1144,45,17581476,America,61428,2341
2020-08-16,Guatemala,GT,885,14,17581476,America,62313,2355
2020-08-17,Guatemala,GT,249,24,17581476,America,62562,2379
2020-08-18,Guatemala,GT,382,10,17581476,America,62944,2389
2020-08-19,Guatemala,GT,903,30,17581476,America,63847,2419
2020-08-20,Guatemala,GT,1034,48,17581476,America,64881,2467
2020-08-21,Guatemala,GT,1102,39,17581476,America,65983,2506
2020-08-22,Guatemala,GT,958,26,17581476,America,66941,2532
2020-08-23,Guatemala,GT,915,48,17581476,America,67856,2580
2020-08-24,Guatemala,GT,332,14,17581476,America,68188,2594
2020-08-25,Guatemala,GT,345,17,17581476,America,68533,2611
2020-08-26,Guatemala,GT,1118,19,17581476,America,69651,2630
2020-08-27,Guatemala,GT,1063,32,17581476,America,70714,2662
2020-08-28,Guatemala,GT,1142,23,17581476,America,71856,2685
2020-08-29,Guatemala,GT,1065,24,17581476,America,72921,2709
2020-08-30,Guatemala,GT,758,19,17581476,America,73679,2728
2020-08-31,Guatemala,GT,233,12,17581476,America,73912,2740
2020-09-01,Guatemala,GT,162,20,17581476,America,74074,2760
2020-09-02,Guatemala,GT,819,18,17581476,America,74893,2778
2020-09-03,Guatemala,GT,771,12,17581476,America,75664,2790
2020-09-04,Guatemala,GT,694,14,17581476,America,76358,2804
2020-09-05,Guatemala,GT,682,21,17581476,America,77040,2825
2020-09-06,Guatemala,GT,441,20,17581476,America,77481,2845
2020-09-07,Guatemala,GT,202,7,17581476,America,77683,2852
2020-09-08,Guatemala,GT,145,10,17581476,America,77828,2862
2020-09-09,Guatemala,GT,893,28,17581476,America,78721,2890
2020-09-10,Guatemala,GT,901,7,17581476,America,79622,2897
2020-09-11,Guatemala,GT,684,21,17581476,America,80306,2918
2020-09-12,Guatemala,GT,703,11,17581476,America,81009,2929
2020-09-13,Guatemala,GT,649,20,17581476,America,81658,2949
2020-09-14,Guatemala,GT,251,8,17581476,America,81909,2957
2020-09-15,Guatemala,GT,263,15,17581476,America,82172,2972
2020-09-16,Guatemala,GT,512,12,17581476,America,82684,2984
2020-09-17,Guatemala,GT,240,25,17581476,America,82924,3009
2020-09-18,Guatemala,GT,740,27,17581476,America,83664,3036
2020-09-19,Guatemala,GT,680,40,17581476,America,84344,3076
2020-09-20,Guatemala,GT,808,29,17581476,America,85152,3105
2020-09-21,Guatemala,GT,292,14,17581476,America,85444,3119
2020-09-22,Guatemala,GT,237,5,17581476,America,85681,3124
2020-09-23,Guatemala,GT,942,13,17581476,America,86623,3137
2020-09-24,Guatemala,GT,819,17,17581476,America,87442,3154
2020-09-25,Guatemala,GT,491,16,17581476,America,87933,3170
2020-09-26,Guatemala,GT,945,16,17581476,America,88878,3186
2020-09-27,Guatemala,GT,824,27,17581476,America,89702,3213
2020-09-28,Guatemala,GT,390,16,17581476,America,90092,3229
2020-09-29,Guatemala,GT,171,5,17581476,America,90263,3234
2020-09-30,Guatemala,GT,705,4,17581476,America,90968,3238
2020-10-01,Guatemala,GT,778,8,17581476,America,91746,3246
2020-10-02,Guatemala,GT,663,15,17581476,America,92409,3261
2020-10-03,Guatemala,GT,681,6,17581476,America,93090,3267
2020-10-04,Guatemala,GT,658,18,17581476,America,93748,3285
2020-10-05,Guatemala,GT,215,8,17581476,America,93963,3293
2020-10-06,Guatemala,GT,219,9,17581476,America,94182,3302
2020-10-07,Guatemala,GT,688,8,17581476,America,94870,3310
2020-10-08,Guatemala,GT,834,25,17581476,America,95704,3335
2020-10-09,Guatemala,GT,776,12,17581476,America,96480,3347
2020-10-10,Guatemala,GT,455,9,17581476,America,96935,3356
2020-10-11,Guatemala,GT,609,9,17581476,America,97544,3365
2020-10-12,Guatemala,GT,171,19,17581476,America,97715,3384
2020-10-13,Guatemala,GT,111,3,17581476,America,97826,3387
2020-10-14,Guatemala,GT,554,23,17581476,America,98380,3410
2020-10-15,Guatemala,GT,714,20,17581476,America,99094,3430
2020-10-16,Guatemala,GT,671,23,17581476,America,99765,3453
2020-10-17,Guatemala,GT,666,25,17581476,America,100431,3478
2020-10-18,Guatemala,GT,597,37,17581476,America,101028,3515
2020-10-19,Guatemala,GT,332,15,17581476,America,101360,3530
2020-10-20,Guatemala,GT,239,11,17581476,America,101599,3541
2020-10-21,Guatemala,GT,620,5,17581476,America,102219,3546
2020-10-22,Guatemala,GT,196,21,17581476,America,102415,3567
2020-10-23,Guatemala,GT,757,13,17581476,America,103172,3580
2020-10-24,Guatemala,GT,730,14,17581476,America,103902,3594
2020-10-25,Guatemala,GT,730,15,17581476,America,104632,3609
2020-10-26,Guatemala,GT,155,35,17581476,America,104787,3644
2020-10-27,Guatemala,GT,107,7,17581476,America,104894,3651
2020-10-28,Guatemala,GT,677,14,17581476,America,105571,3665
2020-10-29,Guatemala,GT,749,17,17581476,America,106320,3682
2020-10-30,Guatemala,GT,470,22,17581476,America,106790,3704
2020-10-31,Guatemala,GT,549,10,17581476,America,107339,3714
2020-11-01,Guatemala,GT,600,15,17581476,America,107939,3729
2020-11-02,Guatemala,GT,165,9,17581476,America,108104,3738
2020-11-03,Guatemala,GT,0,0,17581476,America,108104,3738
2020-11-04,Guatemala,GT,379,10,17581476,America,108483,3748
2020-11-05,Guatemala,GT,664,4,17581476,America,109147,3752
2020-11-06,Guatemala,GT,702,14,17581476,America,109849,3766
2020-11-07,Guatemala,GT,653,28,17581476,America,110502,3794
2020-11-08,Guatemala,GT,548,17,17581476,America,111050,3811
2020-11-09,Guatemala,GT,212,10,17581476,America,111262,3821
2020-11-10,Guatemala,GT,98,2,17581476,America,111360,3823
2020-11-11,Guatemala,GT,769,9,17581476,America,112129,3832
2020-11-12,Guatemala,GT,682,13,17581476,America,112811,3845
2020-11-13,Guatemala,GT,732,13,17581476,America,113543,3858
2020-11-14,Guatemala,GT,580,22,17581476,America,114123,3880
2020-11-15,Guatemala,GT,596,40,17581476,America,114719,3920
2020-11-16,Guatemala,GT,166,12,17581476,America,114885,3932
2020-11-17,Guatemala,GT,147,6,17581476,America,115032,3938
2020-11-18,Guatemala,GT,698,9,17581476,America,115730,3947
2020-11-19,Guatemala,GT,651,61,17581476,America,116381,4008
2020-11-20,Guatemala,GT,685,42,17581476,America,117066,4050
2020-11-21,Guatemala,GT,691,17,17581476,America,117757,4067
2020-11-22,Guatemala,GT,660,7,17581476,America,118417,4074
2020-11-23,Guatemala,GT,212,2,17581476,America,118629,4076
2020-11-24,Guatemala,GT,93,16,17581476,America,118722,4092
2020-11-25,Guatemala,GT,627,7,17581476,America,119349,4099
2020-11-26,Guatemala,GT,640,8,17581476,America,119989,4107
2020-11-27,Guatemala,GT,696,26,17581476,America,120685,4133
2020-11-28,Guatemala,GT,447,8,17581476,America,121132,4141
2020-11-29,Guatemala,GT,666,20,17581476,America,121798,4161
2020-11-30,Guatemala,GT,173,5,17581476,America,121971,4166
2020-12-01,Guatemala,GT,91,5,17581476,America,122062,4171
2020-12-02,Guatemala,GT,712,7,17581476,America,122774,4178
2020-12-03,Guatemala,GT,686,13,17581476,America,123460,4191
2020-12-04,Guatemala,GT,593,18,17581476,America,124053,4209
2020-12-05,Guatemala,GT,752,15,17581476,America,124805,4224
2020-12-06,Guatemala,GT,547,15,17581476,America,125352,4239
2020-12-07,Guatemala,GT,198,11,17581476,America,125550,4250
2020-12-08,Guatemala,GT,124,24,17581476,America,125674,4274
2020-12-09,Guatemala,GT,799,12,17581476,America,126473,4286
2020-12-10,Guatemala,GT,654,25,17581476,America,127127,4311
2020-12-11,Guatemala,GT,659,34,17581476,America,127786,4345
2020-12-12,Guatemala,GT,755,31,17581476,America,128541,4376
2020-12-13,Guatemala,GT,558,29,17581476,America,129099,4405
2020-12-14,Guatemala,GT,183,18,17581476,America,129282,4423
2020-03-19,Guam,GU,3,0,167295,Oceania,3,0
2020-03-20,Guam,GU,9,0,167295,Oceania,12,0
2020-03-21,Guam,GU,2,0,167295,Oceania,14,0
2020-03-22,Guam,GU,1,1,167295,Oceania,15,1
2020-03-23,Guam,GU,12,0,167295,Oceania,27,1
2020-03-24,Guam,GU,2,0,167295,Oceania,29,1
2020-03-25,Guam,GU,3,0,167295,Oceania,32,1
2020-03-26,Guam,GU,5,0,167295,Oceania,37,1
2020-03-27,Guam,GU,12,0,167295,Oceania,49,1
2020-03-28,Guam,GU,2,0,167295,Oceania,51,1
2020-03-29,Guam,GU,4,0,167295,Oceania,55,1
2020-03-30,Guam,GU,1,0,167295,Oceania,56,1
2020-03-31,Guam,GU,4,0,167295,Oceania,60,1
2020-04-01,Guam,GU,9,2,167295,Oceania,69,3
2020-04-02,Guam,GU,8,0,167295,Oceania,77,3
2020-04-03,Guam,GU,5,0,167295,Oceania,82,3
2020-04-04,Guam,GU,5,1,167295,Oceania,87,4
2020-04-05,Guam,GU,6,0,167295,Oceania,93,4
2020-04-06,Guam,GU,17,0,167295,Oceania,110,4
2020-04-07,Guam,GU,2,0,167295,Oceania,112,4
2020-04-08,Guam,GU,9,0,167295,Oceania,121,4
2020-04-09,Guam,GU,4,0,167295,Oceania,125,4
2020-04-10,Guam,GU,3,0,167295,Oceania,128,4
2020-04-11,Guam,GU,2,0,167295,Oceania,130,4
2020-04-12,Guam,GU,3,1,167295,Oceania,133,5
2020-04-13,Guam,GU,0,0,167295,Oceania,133,5
2020-04-14,Guam,GU,1,0,167295,Oceania,134,5
2020-04-15,Guam,GU,1,0,167295,Oceania,135,5
2020-04-16,Guam,GU,0,0,167295,Oceania,135,5
2020-04-17,Guam,GU,0,0,167295,Oceania,135,5
2020-04-18,Guam,GU,1,0,167295,Oceania,136,5
2020-04-19,Guam,GU,0,0,167295,Oceania,136,5
2020-04-20,Guam,GU,0,0,167295,Oceania,136,5
2020-04-21,Guam,GU,0,0,167295,Oceania,136,5
2020-04-22,Guam,GU,0,0,167295,Oceania,136,5
2020-04-23,Guam,GU,1,0,167295,Oceania,137,5
2020-04-24,Guam,GU,3,0,167295,Oceania,140,5
2020-04-25,Guam,GU,1,0,167295,Oceania,141,5
2020-04-26,Guam,GU,0,0,167295,Oceania,141,5
2020-04-27,Guam,GU,1,0,167295,Oceania,142,5
2020-04-28,Guam,GU,2,0,167295,Oceania,144,5
2020-04-29,Guam,GU,1,0,167295,Oceania,145,5
2020-04-30,Guam,GU,0,0,167295,Oceania,145,5
2020-05-01,Guam,GU,1,0,167295,Oceania,146,5
2020-05-02,Guam,GU,0,0,167295,Oceania,146,5
2020-05-03,Guam,GU,2,0,167295,Oceania,148,5
2020-05-04,Guam,GU,1,0,167295,Oceania,149,5
2020-05-05,Guam,GU,0,0,167295,Oceania,149,5
2020-05-06,Guam,GU,0,0,167295,Oceania,149,5
2020-05-07,Guam,GU,2,0,167295,Oceania,151,5
2020-05-08,Guam,GU,0,0,167295,Oceania,151,5
2020-05-09,Guam,GU,0,0,167295,Oceania,151,5
2020-05-10,Guam,GU,0,0,167295,Oceania,151,5
2020-05-11,Guam,GU,0,0,167295,Oceania,151,5
2020-05-12,Guam,GU,1,0,167295,Oceania,152,5
2020-05-13,Guam,GU,0,0,167295,Oceania,152,5
2020-05-14,Guam,GU,0,0,167295,Oceania,152,5
2020-05-15,Guam,GU,2,0,167295,Oceania,154,5
2020-05-16,Guam,GU,0,0,167295,Oceania,154,5
2020-05-17,Guam,GU,0,0,167295,Oceania,154,5
2020-05-18,Guam,GU,0,0,167295,Oceania,154,5
2020-05-19,Guam,GU,0,0,167295,Oceania,154,5
2020-05-20,Guam,GU,0,0,167295,Oceania,154,5
2020-05-21,Guam,GU,11,0,167295,Oceania,165,5
2020-05-22,Guam,GU,0,0,167295,Oceania,165,5
2020-05-23,Guam,GU,0,0,167295,Oceania,165,5
2020-05-24,Guam,GU,1,0,167295,Oceania,166,5
2020-05-25,Guam,GU,0,0,167295,Oceania,166,5
2020-05-26,Guam,GU,0,0,167295,Oceania,166,5
2020-05-27,Guam,GU,3,0,167295,Oceania,169,5
2020-05-28,Guam,GU,2,0,167295,Oceania,171,5
2020-05-29,Guam,GU,1,0,167295,Oceania,172,5
2020-05-30,Guam,GU,0,0,167295,Oceania,172,5
2020-05-31,Guam,GU,1,0,167295,Oceania,173,5
2020-06-01,Guam,GU,2,0,167295,Oceania,175,5
2020-06-02,Guam,GU,0,0,167295,Oceania,175,5
2020-06-03,Guam,GU,2,0,167295,Oceania,177,5
2020-06-04,Guam,GU,2,0,167295,Oceania,179,5
2020-06-05,Guam,GU,0,0,167295,Oceania,179,5
2020-06-06,Guam,GU,0,0,167295,Oceania,179,5
2020-06-07,Guam,GU,0,0,167295,Oceania,179,5
2020-06-08,Guam,GU,0,0,167295,Oceania,179,5
2020-06-09,Guam,GU,1,0,167295,Oceania,180,5
2020-06-10,Guam,GU,0,0,167295,Oceania,180,5
2020-06-11,Guam,GU,2,0,167295,Oceania,182,5
2020-06-12,Guam,GU,0,0,167295,Oceania,182,5
2020-06-13,Guam,GU,3,0,167295,Oceania,185,5
2020-06-14,Guam,GU,0,0,167295,Oceania,185,5
2020-06-15,Guam,GU,0,0,167295,Oceania,185,5
2020-06-16,Guam,GU,1,0,167295,Oceania,186,5
2020-06-17,Guam,GU,2,0,167295,Oceania,188,5
2020-06-18,Guam,GU,4,0,167295,Oceania,192,5
2020-06-19,Guam,GU,8,0,167295,Oceania,200,5
2020-06-20,Guam,GU,0,0,167295,Oceania,200,5
2020-06-21,Guam,GU,22,0,167295,Oceania,222,5
2020-06-22,Guam,GU,0,0,167295,Oceania,222,5
2020-06-23,Guam,GU,3,0,167295,Oceania,225,5
2020-06-24,Guam,GU,1,0,167295,Oceania,226,5
2020-06-25,Guam,GU,5,0,167295,Oceania,231,5
2020-06-26,Guam,GU,16,0,167295,Oceania,247,5
2020-06-27,Guam,GU,1,0,167295,Oceania,248,5
2020-06-28,Guam,GU,0,0,167295,Oceania,248,5
2020-06-29,Guam,GU,5,0,167295,Oceania,253,5
2020-06-30,Guam,GU,4,0,167295,Oceania,257,5
2020-07-01,Guam,GU,10,0,167295,Oceania,267,5
2020-07-02,Guam,GU,13,0,167295,Oceania,280,5
2020-07-03,Guam,GU,6,0,167295,Oceania,286,5
2020-07-04,Guam,GU,2,0,167295,Oceania,288,5
2020-07-05,Guam,GU,0,0,167295,Oceania,288,5
2020-07-06,Guam,GU,13,0,167295,Oceania,301,5
2020-07-07,Guam,GU,2,0,167295,Oceania,303,5
2020-07-08,Guam,GU,0,0,167295,Oceania,303,5
2020-07-09,Guam,GU,6,0,167295,Oceania,309,5
2020-07-10,Guam,GU,1,0,167295,Oceania,310,5
2020-07-11,Guam,GU,2,0,167295,Oceania,312,5
2020-07-12,Guam,GU,0,0,167295,Oceania,312,5
2020-07-13,Guam,GU,0,0,167295,Oceania,312,5
2020-07-14,Guam,GU,0,0,167295,Oceania,312,5
2020-07-15,Guam,GU,1,0,167295,Oceania,313,5
2020-07-16,Guam,GU,1,0,167295,Oceania,314,5
2020-07-17,Guam,GU,0,0,167295,Oceania,314,5
2020-07-18,Guam,GU,1,0,167295,Oceania,315,5
2020-07-19,Guam,GU,0,0,167295,Oceania,315,5
2020-07-20,Guam,GU,4,0,167295,Oceania,319,5
2020-07-21,Guam,GU,8,0,167295,Oceania,327,5
2020-07-22,Guam,GU,3,0,167295,Oceania,330,5
2020-07-23,Guam,GU,2,0,167295,Oceania,332,5
2020-07-24,Guam,GU,5,0,167295,Oceania,337,5
2020-07-25,Guam,GU,0,0,167295,Oceania,337,5
2020-07-26,Guam,GU,0,0,167295,Oceania,337,5
2020-07-27,Guam,GU,9,0,167295,Oceania,346,5
2020-07-28,Guam,GU,3,0,167295,Oceania,349,5
2020-07-29,Guam,GU,2,0,167295,Oceania,351,5
2020-07-30,Guam,GU,3,0,167295,Oceania,354,5
2020-07-31,Guam,GU,2,0,167295,Oceania,356,5
2020-08-01,Guam,GU,3,0,167295,Oceania,359,5
2020-08-02,Guam,GU,0,0,167295,Oceania,359,5
2020-08-03,Guam,GU,9,0,167295,Oceania,368,5
2020-08-04,Guam,GU,7,0,167295,Oceania,375,5
2020-08-05,Guam,GU,14,0,167295,Oceania,389,5
2020-08-06,Guam,GU,8,0,167295,Oceania,397,5
2020-08-07,Guam,GU,14,0,167295,Oceania,411,5
2020-08-08,Guam,GU,1,0,167295,Oceania,412,5
2020-08-09,Guam,GU,0,0,167295,Oceania,412,5
2020-08-10,Guam,GU,6,0,167295,Oceania,418,5
2020-08-11,Guam,GU,16,0,167295,Oceania,434,5
2020-08-12,Guam,GU,15,0,167295,Oceania,449,5
2020-08-13,Guam,GU,0,0,167295,Oceania,449,5
2020-08-14,Guam,GU,28,0,167295,Oceania,477,5
2020-08-15,Guam,GU,25,0,167295,Oceania,502,5
2020-08-16,Guam,GU,14,0,167295,Oceania,516,5
2020-08-17,Guam,GU,42,0,167295,Oceania,558,5
2020-08-18,Guam,GU,19,0,167295,Oceania,577,5
2020-08-19,Guam,GU,22,0,167295,Oceania,599,5
2020-08-20,Guam,GU,0,0,167295,Oceania,599,5
2020-08-21,Guam,GU,105,1,167295,Oceania,704,6
2020-08-22,Guam,GU,63,1,167295,Oceania,767,7
2020-08-23,Guam,GU,53,0,167295,Oceania,820,7
2020-08-24,Guam,GU,0,0,167295,Oceania,820,7
2020-08-25,Guam,GU,87,0,167295,Oceania,907,7
2020-08-26,Guam,GU,77,2,167295,Oceania,984,9
2020-08-27,Guam,GU,136,0,167295,Oceania,1120,9
2020-08-28,Guam,GU,112,1,167295,Oceania,1232,10
2020-08-29,Guam,GU,55,0,167295,Oceania,1287,10
2020-08-30,Guam,GU,60,0,167295,Oceania,1347,10
2020-08-31,Guam,GU,0,0,167295,Oceania,1347,10
2020-09-01,Guam,GU,48,0,167295,Oceania,1395,10
2020-09-02,Guam,GU,52,3,167295,Oceania,1447,13
2020-09-03,Guam,GU,0,0,167295,Oceania,1447,13
2020-09-04,Guam,GU,113,0,167295,Oceania,1560,13
2020-09-05,Guam,GU,59,1,167295,Oceania,1619,14
2020-09-06,Guam,GU,0,0,167295,Oceania,1619,14
2020-09-07,Guam,GU,0,0,167295,Oceania,1619,14
2020-09-08,Guam,GU,52,1,167295,Oceania,1671,15
2020-09-09,Guam,GU,42,4,167295,Oceania,1713,19
2020-09-10,Guam,GU,45,1,167295,Oceania,1758,20
2020-09-11,Guam,GU,88,2,167295,Oceania,1846,22
2020-09-12,Guam,GU,17,1,167295,Oceania,1863,23
2020-09-13,Guam,GU,28,2,167295,Oceania,1891,25
2020-09-14,Guam,GU,0,0,167295,Oceania,1891,25
2020-09-15,Guam,GU,36,2,167295,Oceania,1927,27
2020-09-16,Guam,GU,0,0,167295,Oceania,1927,27
2020-09-17,Guam,GU,39,2,167295,Oceania,1966,29
2020-09-18,Guam,GU,79,2,167295,Oceania,2045,31
2020-09-19,Guam,GU,0,3,167295,Oceania,2045,34
2020-09-20,Guam,GU,72,0,167295,Oceania,2117,34
2020-09-21,Guam,GU,0,0,167295,Oceania,2117,34
2020-09-22,Guam,GU,30,3,167295,Oceania,2147,37
2020-09-23,Guam,GU,43,0,167295,Oceania,2190,37
2020-09-24,Guam,GU,45,1,167295,Oceania,2235,38
2020-09-25,Guam,GU,0,0,167295,Oceania,2235,38
2020-09-26,Guam,GU,51,4,167295,Oceania,2286,42
2020-09-27,Guam,GU,68,0,167295,Oceania,2354,42
2020-09-28,Guam,GU,0,0,167295,Oceania,2354,42
2020-09-29,Guam,GU,36,4,167295,Oceania,2390,46
2020-09-30,Guam,GU,53,1,167295,Oceania,2443,47
2020-10-01,Guam,GU,0,0,167295,Oceania,2443,47
2020-10-02,Guam,GU,107,2,167295,Oceania,2550,49
2020-10-03,Guam,GU,0,0,167295,Oceania,2550,49
2020-10-04,Guam,GU,149,2,167295,Oceania,2699,51
2020-10-05,Guam,GU,0,1,167295,Oceania,2699,52
2020-10-06,Guam,GU,54,3,167295,Oceania,2753,55
2020-10-07,Guam,GU,65,0,167295,Oceania,2818,55
2020-10-08,Guam,GU,0,3,167295,Oceania,2818,58
2020-10-09,Guam,GU,116,0,167295,Oceania,2934,58
2020-10-10,Guam,GU,55,0,167295,Oceania,2989,58
2020-10-11,Guam,GU,89,2,167295,Oceania,3078,60
2020-10-12,Guam,GU,0,0,167295,Oceania,3078,60
2020-10-13,Guam,GU,92,0,167295,Oceania,3170,60
2020-10-14,Guam,GU,96,1,167295,Oceania,3266,61
2020-10-15,Guam,GU,75,0,167295,Oceania,3341,61
2020-10-16,Guam,GU,86,2,167295,Oceania,3427,63
2020-10-17,Guam,GU,190,0,167295,Oceania,3617,63
2020-10-18,Guam,GU,0,3,167295,Oceania,3617,66
2020-10-19,Guam,GU,58,0,167295,Oceania,3675,66
2020-10-20,Guam,GU,81,0,167295,Oceania,3756,66
2020-10-21,Guam,GU,130,1,167295,Oceania,3886,67
2020-10-22,Guam,GU,82,2,167295,Oceania,3968,69
2020-10-23,Guam,GU,88,0,167295,Oceania,4056,69
2020-10-24,Guam,GU,85,0,167295,Oceania,4141,69
2020-10-25,Guam,GU,75,2,167295,Oceania,4216,71
2020-10-26,Guam,GU,0,1,167295,Oceania,4216,72
2020-10-27,Guam,GU,120,3,167295,Oceania,4336,75
2020-10-28,Guam,GU,96,1,167295,Oceania,4432,76
2020-10-29,Guam,GU,34,1,167295,Oceania,4466,77
2020-10-30,Guam,GU,0,1,167295,Oceania,4466,78
2020-10-31,Guam,GU,215,1,167295,Oceania,4681,79
2020-11-01,Guam,GU,9,0,167295,Oceania,4690,79
2020-11-02,Guam,GU,3,0,167295,Oceania,4693,79
2020-11-03,Guam,GU,0,0,167295,Oceania,4693,79
2020-11-04,Guam,GU,119,2,167295,Oceania,4812,81
2020-11-05,Guam,GU,91,2,167295,Oceania,4903,83
2020-11-06,Guam,GU,101,2,167295,Oceania,5004,85
2020-11-07,Guam,GU,109,4,167295,Oceania,5113,89
2020-11-08,Guam,GU,0,0,167295,Oceania,5113,89
2020-11-09,Guam,GU,120,0,167295,Oceania,5233,89
2020-11-10,Guam,GU,0,2,167295,Oceania,5233,91
2020-11-11,Guam,GU,421,0,167295,Oceania,5654,91
2020-11-12,Guam,GU,101,0,167295,Oceania,5755,91
2020-11-13,Guam,GU,95,1,167295,Oceania,5850,92
2020-11-14,Guam,GU,74,1,167295,Oceania,5924,93
2020-11-15,Guam,GU,41,0,167295,Oceania,5965,93
2020-11-16,Guam,GU,156,5,167295,Oceania,6121,98
2020-11-17,Guam,GU,0,0,167295,Oceania,6121,98
2020-11-18,Guam,GU,113,2,167295,Oceania,6234,100
2020-11-19,Guam,GU,112,0,167295,Oceania,6346,100
2020-11-20,Guam,GU,70,1,167295,Oceania,6416,101
2020-11-21,Guam,GU,36,2,167295,Oceania,6452,103
2020-11-22,Guam,GU,97,3,167295,Oceania,6549,106
2020-11-23,Guam,GU,0,0,167295,Oceania,6549,106
2020-11-24,Guam,GU,53,0,167295,Oceania,6602,106
2020-11-25,Guam,GU,103,3,167295,Oceania,6705,109
2020-11-26,Guam,GU,0,0,167295,Oceania,6705,109
2020-11-27,Guam,GU,43,2,167295,Oceania,6748,111
2020-11-28,Guam,GU,34,1,167295,Oceania,6782,112
2020-11-29,Guam,GU,0,0,167295,Oceania,6782,112
2020-11-30,Guam,GU,36,0,167295,Oceania,6818,112
2020-12-01,Guam,GU,34,0,167295,Oceania,6852,112
2020-12-02,Guam,GU,37,0,167295,Oceania,6889,112
2020-12-03,Guam,GU,31,0,167295,Oceania,6920,112
2020-12-04,Guam,GU,22,0,167295,Oceania,6942,112
2020-12-05,Guam,GU,17,1,167295,Oceania,6959,113
2020-12-06,Guam,GU,45,0,167295,Oceania,7004,113
2020-12-07,Guam,GU,0,0,167295,Oceania,7004,113
2020-12-08,Guam,GU,15,0,167295,Oceania,7019,113
2020-12-09,Guam,GU,7,0,167295,Oceania,7026,113
2020-12-10,Guam,GU,13,0,167295,Oceania,7039,113
2020-12-11,Guam,GU,13,2,167295,Oceania,7052,115
2020-12-12,Guam,GU,38,2,167295,Oceania,7090,117
2020-12-13,Guam,GU,0,0,167295,Oceania,7090,117
2020-12-14,Guam,GU,16,1,167295,Oceania,7106,118
2020-03-27,Guinea_Bissau,GW,2,0,1920917,Africa,2,0
2020-03-28,Guinea_Bissau,GW,0,0,1920917,Africa,2,0
2020-03-29,Guinea_Bissau,GW,0,0,1920917,Africa,2,0
2020-03-30,Guinea_Bissau,GW,0,0,1920917,Africa,2,0
2020-03-31,Guinea_Bissau,GW,0,0,1920917,Africa,2,0
2020-04-01,Guinea_Bissau,GW,6,0,1920917,Africa,8,0
2020-04-02,Guinea_Bissau,GW,1,0,1920917,Africa,9,0
2020-04-03,Guinea_Bissau,GW,0,0,1920917,Africa,9,0
2020-04-04,Guinea_Bissau,GW,6,0,1920917,Africa,15,0
2020-04-05,Guinea_Bissau,GW,3,0,1920917,Africa,18,0
2020-04-06,Guinea_Bissau,GW,0,0,1920917,Africa,18,0
2020-04-07,Guinea_Bissau,GW,15,0,1920917,Africa,33,0
2020-04-08,Guinea_Bissau,GW,0,0,1920917,Africa,33,0
2020-04-09,Guinea_Bissau,GW,0,0,1920917,Africa,33,0
2020-04-10,Guinea_Bissau,GW,2,0,1920917,Africa,35,0
2020-04-11,Guinea_Bissau,GW,0,0,1920917,Africa,35,0
2020-04-12,Guinea_Bissau,GW,3,0,1920917,Africa,38,0
2020-04-13,Guinea_Bissau,GW,1,0,1920917,Africa,39,0
2020-04-14,Guinea_Bissau,GW,0,0,1920917,Africa,39,0
2020-04-15,Guinea_Bissau,GW,1,0,1920917,Africa,40,0
2020-04-16,Guinea_Bissau,GW,3,0,1920917,Africa,43,0
2020-04-17,Guinea_Bissau,GW,3,0,1920917,Africa,46,0
2020-04-18,Guinea_Bissau,GW,4,0,1920917,Africa,50,0
2020-04-19,Guinea_Bissau,GW,0,0,1920917,Africa,50,0
2020-04-20,Guinea_Bissau,GW,0,0,1920917,Africa,50,0
2020-04-21,Guinea_Bissau,GW,0,0,1920917,Africa,50,0
2020-04-22,Guinea_Bissau,GW,0,0,1920917,Africa,50,0
2020-04-23,Guinea_Bissau,GW,0,0,1920917,Africa,50,0
2020-04-24,Guinea_Bissau,GW,2,0,1920917,Africa,52,0
2020-04-25,Guinea_Bissau,GW,0,0,1920917,Africa,52,0
2020-04-26,Guinea_Bissau,GW,0,0,1920917,Africa,52,0
2020-04-27,Guinea_Bissau,GW,1,1,1920917,Africa,53,1
2020-04-28,Guinea_Bissau,GW,20,0,1920917,Africa,73,1
2020-04-29,Guinea_Bissau,GW,0,0,1920917,Africa,73,1
2020-04-30,Guinea_Bissau,GW,4,0,1920917,Africa,77,1
2020-05-01,Guinea_Bissau,GW,128,0,1920917,Africa,205,1
2020-05-02,Guinea_Bissau,GW,52,0,1920917,Africa,257,1
2020-05-03,Guinea_Bissau,GW,0,0,1920917,Africa,257,1
2020-05-04,Guinea_Bissau,GW,35,1,1920917,Africa,292,2
2020-05-05,Guinea_Bissau,GW,121,0,1920917,Africa,413,2
2020-05-06,Guinea_Bissau,GW,62,0,1920917,Africa,475,2
2020-05-07,Guinea_Bissau,GW,0,0,1920917,Africa,475,2
2020-05-08,Guinea_Bissau,GW,89,0,1920917,Africa,564,2
2020-05-09,Guinea_Bissau,GW,30,0,1920917,Africa,594,2
2020-05-10,Guinea_Bissau,GW,47,1,1920917,Africa,641,3
2020-05-11,Guinea_Bissau,GW,85,0,1920917,Africa,726,3
2020-05-12,Guinea_Bissau,GW,35,0,1920917,Africa,761,3
2020-05-13,Guinea_Bissau,GW,59,0,1920917,Africa,820,3
2020-05-14,Guinea_Bissau,GW,0,0,1920917,Africa,820,3
2020-05-15,Guinea_Bissau,GW,93,0,1920917,Africa,913,3
2020-05-16,Guinea_Bissau,GW,0,0,1920917,Africa,913,3
2020-05-17,Guinea_Bissau,GW,0,0,1920917,Africa,913,3
2020-05-18,Guinea_Bissau,GW,77,1,1920917,Africa,990,4
2020-05-19,Guinea_Bissau,GW,0,0,1920917,Africa,990,4
2020-05-20,Guinea_Bissau,GW,48,2,1920917,Africa,1038,6
2020-05-21,Guinea_Bissau,GW,0,0,1920917,Africa,1038,6
2020-05-22,Guinea_Bissau,GW,51,0,1920917,Africa,1089,6
2020-05-23,Guinea_Bissau,GW,0,0,1920917,Africa,1089,6
2020-05-24,Guinea_Bissau,GW,25,0,1920917,Africa,1114,6
2020-05-25,Guinea_Bissau,GW,59,0,1920917,Africa,1173,6
2020-05-26,Guinea_Bissau,GW,0,0,1920917,Africa,1173,6
2020-05-27,Guinea_Bissau,GW,0,0,1920917,Africa,1173,6
2020-05-28,Guinea_Bissau,GW,5,1,1920917,Africa,1178,7
2020-05-29,Guinea_Bissau,GW,0,0,1920917,Africa,1178,7
2020-05-30,Guinea_Bissau,GW,78,1,1920917,Africa,1256,8
2020-05-31,Guinea_Bissau,GW,0,0,1920917,Africa,1256,8
2020-06-01,Guinea_Bissau,GW,66,0,1920917,Africa,1322,8
2020-06-02,Guinea_Bissau,GW,17,0,1920917,Africa,1339,8
2020-06-03,Guinea_Bissau,GW,0,0,1920917,Africa,1339,8
2020-06-04,Guinea_Bissau,GW,0,0,1920917,Africa,1339,8
2020-06-05,Guinea_Bissau,GW,7,1,1920917,Africa,1346,9
2020-06-06,Guinea_Bissau,GW,22,3,1920917,Africa,1368,12
2020-06-07,Guinea_Bissau,GW,0,0,1920917,Africa,1368,12
2020-06-08,Guinea_Bissau,GW,0,0,1920917,Africa,1368,12
2020-06-09,Guinea_Bissau,GW,21,0,1920917,Africa,1389,12
2020-06-10,Guinea_Bissau,GW,0,0,1920917,Africa,1389,12
2020-06-11,Guinea_Bissau,GW,0,0,1920917,Africa,1389,12
2020-06-12,Guinea_Bissau,GW,0,0,1920917,Africa,1389,12
2020-06-13,Guinea_Bissau,GW,0,0,1920917,Africa,1389,12
2020-06-14,Guinea_Bissau,GW,71,3,1920917,Africa,1460,15
2020-06-15,Guinea_Bissau,GW,0,0,1920917,Africa,1460,15
2020-06-16,Guinea_Bissau,GW,0,0,1920917,Africa,1460,15
2020-06-17,Guinea_Bissau,GW,32,0,1920917,Africa,1492,15
2020-06-18,Guinea_Bissau,GW,0,0,1920917,Africa,1492,15
2020-06-19,Guinea_Bissau,GW,20,0,1920917,Africa,1512,15
2020-06-20,Guinea_Bissau,GW,0,0,1920917,Africa,1512,15
2020-06-21,Guinea_Bissau,GW,29,2,1920917,Africa,1541,17
2020-06-22,Guinea_Bissau,GW,0,0,1920917,Africa,1541,17
2020-06-23,Guinea_Bissau,GW,15,2,1920917,Africa,1556,19
2020-06-24,Guinea_Bissau,GW,0,0,1920917,Africa,1556,19
2020-06-25,Guinea_Bissau,GW,0,0,1920917,Africa,1556,19
2020-06-26,Guinea_Bissau,GW,0,0,1920917,Africa,1556,19
2020-06-27,Guinea_Bissau,GW,0,0,1920917,Africa,1556,19
2020-06-28,Guinea_Bissau,GW,58,2,1920917,Africa,1614,21
2020-06-29,Guinea_Bissau,GW,0,0,1920917,Africa,1614,21
2020-06-30,Guinea_Bissau,GW,0,0,1920917,Africa,1614,21
2020-07-01,Guinea_Bissau,GW,40,3,1920917,Africa,1654,24
2020-07-02,Guinea_Bissau,GW,0,0,1920917,Africa,1654,24
2020-07-03,Guinea_Bissau,GW,0,0,1920917,Africa,1654,24
2020-07-04,Guinea_Bissau,GW,56,0,1920917,Africa,1710,24
2020-07-05,Guinea_Bissau,GW,55,1,1920917,Africa,1765,25
2020-07-06,Guinea_Bissau,GW,0,0,1920917,Africa,1765,25
2020-07-07,Guinea_Bissau,GW,0,0,1920917,Africa,1765,25
2020-07-08,Guinea_Bissau,GW,25,0,1920917,Africa,1790,25
2020-07-09,Guinea_Bissau,GW,0,0,1920917,Africa,1790,25
2020-07-10,Guinea_Bissau,GW,0,0,1920917,Africa,1790,25
2020-07-11,Guinea_Bissau,GW,0,0,1920917,Africa,1790,25
2020-07-12,Guinea_Bissau,GW,52,0,1920917,Africa,1842,25
2020-07-13,Guinea_Bissau,GW,0,0,1920917,Africa,1842,25
2020-07-14,Guinea_Bissau,GW,0,0,1920917,Africa,1842,25
2020-07-15,Guinea_Bissau,GW,60,1,1920917,Africa,1902,26
2020-07-16,Guinea_Bissau,GW,0,0,1920917,Africa,1902,26
2020-07-17,Guinea_Bissau,GW,25,0,1920917,Africa,1927,26
2020-07-18,Guinea_Bissau,GW,0,0,1920917,Africa,1927,26
2020-07-19,Guinea_Bissau,GW,0,0,1920917,Africa,1927,26
2020-07-20,Guinea_Bissau,GW,0,0,1920917,Africa,1927,26
2020-07-21,Guinea_Bissau,GW,23,0,1920917,Africa,1950,26
2020-07-22,Guinea_Bissau,GW,4,0,1920917,Africa,1954,26
2020-07-23,Guinea_Bissau,GW,0,0,1920917,Africa,1954,26
2020-07-24,Guinea_Bissau,GW,0,0,1920917,Africa,1954,26
2020-07-25,Guinea_Bissau,GW,0,0,1920917,Africa,1954,26
2020-07-26,Guinea_Bissau,GW,0,0,1920917,Africa,1954,26
2020-07-27,Guinea_Bissau,GW,0,0,1920917,Africa,1954,26
2020-07-28,Guinea_Bissau,GW,0,0,1920917,Africa,1954,26
2020-07-29,Guinea_Bissau,GW,0,0,1920917,Africa,1954,26
2020-07-30,Guinea_Bissau,GW,0,0,1920917,Africa,1954,26
2020-07-31,Guinea_Bissau,GW,27,0,1920917,Africa,1981,26
2020-08-01,Guinea_Bissau,GW,0,0,1920917,Africa,1981,26
2020-08-02,Guinea_Bissau,GW,0,0,1920917,Africa,1981,26
2020-08-03,Guinea_Bissau,GW,0,0,1920917,Africa,1981,26
2020-08-04,Guinea_Bissau,GW,0,1,1920917,Africa,1981,27
2020-08-05,Guinea_Bissau,GW,51,0,1920917,Africa,2032,27
2020-08-06,Guinea_Bissau,GW,0,0,1920917,Africa,2032,27
2020-08-07,Guinea_Bissau,GW,0,0,1920917,Africa,2032,27
2020-08-08,Guinea_Bissau,GW,0,0,1920917,Africa,2032,27
2020-08-09,Guinea_Bissau,GW,20,2,1920917,Africa,2052,29
2020-08-10,Guinea_Bissau,GW,0,0,1920917,Africa,2052,29
2020-08-11,Guinea_Bissau,GW,0,0,1920917,Africa,2052,29
2020-08-12,Guinea_Bissau,GW,0,0,1920917,Africa,2052,29
2020-08-13,Guinea_Bissau,GW,0,0,1920917,Africa,2052,29
2020-08-14,Guinea_Bissau,GW,65,4,1920917,Africa,2117,33
2020-08-15,Guinea_Bissau,GW,0,0,1920917,Africa,2117,33
2020-08-16,Guinea_Bissau,GW,0,0,1920917,Africa,2117,33
2020-08-17,Guinea_Bissau,GW,0,0,1920917,Africa,2117,33
2020-08-18,Guinea_Bissau,GW,0,0,1920917,Africa,2117,33
2020-08-19,Guinea_Bissau,GW,0,0,1920917,Africa,2117,33
2020-08-20,Guinea_Bissau,GW,0,0,1920917,Africa,2117,33
2020-08-21,Guinea_Bissau,GW,0,0,1920917,Africa,2117,33
2020-08-22,Guinea_Bissau,GW,32,0,1920917,Africa,2149,33
2020-08-23,Guinea_Bissau,GW,0,0,1920917,Africa,2149,33
2020-08-24,Guinea_Bissau,GW,0,0,1920917,Africa,2149,33
2020-08-25,Guinea_Bissau,GW,0,0,1920917,Africa,2149,33
2020-08-26,Guinea_Bissau,GW,0,0,1920917,Africa,2149,33
2020-08-27,Guinea_Bissau,GW,0,0,1920917,Africa,2149,33
2020-08-28,Guinea_Bissau,GW,0,0,1920917,Africa,2149,33
2020-08-29,Guinea_Bissau,GW,0,0,1920917,Africa,2149,33
2020-08-30,Guinea_Bissau,GW,56,0,1920917,Africa,2205,33
2020-08-31,Guinea_Bissau,GW,0,1,1920917,Africa,2205,34
2020-09-01,Guinea_Bissau,GW,0,0,1920917,Africa,2205,34
2020-09-02,Guinea_Bissau,GW,0,0,1920917,Africa,2205,34
2020-09-03,Guinea_Bissau,GW,0,0,1920917,Africa,2205,34
2020-09-04,Guinea_Bissau,GW,0,0,1920917,Africa,2205,34
2020-09-05,Guinea_Bissau,GW,40,4,1920917,Africa,2245,38
2020-09-06,Guinea_Bissau,GW,0,0,1920917,Africa,2245,38
2020-09-07,Guinea_Bissau,GW,0,0,1920917,Africa,2245,38
2020-09-08,Guinea_Bissau,GW,0,0,1920917,Africa,2245,38
2020-09-09,Guinea_Bissau,GW,0,0,1920917,Africa,2245,38
2020-09-10,Guinea_Bissau,GW,0,0,1920917,Africa,2245,38
2020-09-11,Guinea_Bissau,GW,0,0,1920917,Africa,2245,38
2020-09-12,Guinea_Bissau,GW,30,1,1920917,Africa,2275,39
2020-09-13,Guinea_Bissau,GW,0,0,1920917,Africa,2275,39
2020-09-14,Guinea_Bissau,GW,0,0,1920917,Africa,2275,39
2020-09-15,Guinea_Bissau,GW,0,0,1920917,Africa,2275,39
2020-09-16,Guinea_Bissau,GW,0,0,1920917,Africa,2275,39
2020-09-17,Guinea_Bissau,GW,0,0,1920917,Africa,2275,39
2020-09-18,Guinea_Bissau,GW,0,0,1920917,Africa,2275,39
2020-09-19,Guinea_Bissau,GW,28,0,1920917,Africa,2303,39
2020-09-20,Guinea_Bissau,GW,0,0,1920917,Africa,2303,39
2020-09-21,Guinea_Bissau,GW,0,0,1920917,Africa,2303,39
2020-09-22,Guinea_Bissau,GW,0,0,1920917,Africa,2303,39
2020-09-23,Guinea_Bissau,GW,0,0,1920917,Africa,2303,39
2020-09-24,Guinea_Bissau,GW,0,0,1920917,Africa,2303,39
2020-09-25,Guinea_Bissau,GW,0,0,1920917,Africa,2303,39
2020-09-26,Guinea_Bissau,GW,21,0,1920917,Africa,2324,39
2020-09-27,Guinea_Bissau,GW,0,0,1920917,Africa,2324,39
2020-09-28,Guinea_Bissau,GW,0,0,1920917,Africa,2324,39
2020-09-29,Guinea_Bissau,GW,0,0,1920917,Africa,2324,39
2020-09-30,Guinea_Bissau,GW,0,0,1920917,Africa,2324,39
2020-10-01,Guinea_Bissau,GW,0,0,1920917,Africa,2324,39
2020-10-02,Guinea_Bissau,GW,0,0,1920917,Africa,2324,39
2020-10-03,Guinea_Bissau,GW,38,0,1920917,Africa,2362,39
2020-10-04,Guinea_Bissau,GW,0,0,1920917,Africa,2362,39
2020-10-05,Guinea_Bissau,GW,0,0,1920917,Africa,2362,39
2020-10-06,Guinea_Bissau,GW,0,0,1920917,Africa,2362,39
2020-10-07,Guinea_Bissau,GW,0,0,1920917,Africa,2362,39
2020-10-08,Guinea_Bissau,GW,0,0,1920917,Africa,2362,39
2020-10-09,Guinea_Bissau,GW,0,0,1920917,Africa,2362,39
2020-10-10,Guinea_Bissau,GW,0,0,1920917,Africa,2362,39
2020-10-11,Guinea_Bissau,GW,0,0,1920917,Africa,2362,39
2020-10-12,Guinea_Bissau,GW,23,1,1920917,Africa,2385,40
2020-10-13,Guinea_Bissau,GW,0,0,1920917,Africa,2385,40
2020-10-14,Guinea_Bissau,GW,0,0,1920917,Africa,2385,40
2020-10-15,Guinea_Bissau,GW,0,0,1920917,Africa,2385,40
2020-10-16,Guinea_Bissau,GW,0,0,1920917,Africa,2385,40
2020-10-17,Guinea_Bissau,GW,4,1,1920917,Africa,2389,41
2020-10-18,Guinea_Bissau,GW,0,0,1920917,Africa,2389,41
2020-10-19,Guinea_Bissau,GW,0,0,1920917,Africa,2389,41
2020-10-20,Guinea_Bissau,GW,0,0,1920917,Africa,2389,41
2020-10-21,Guinea_Bissau,GW,14,0,1920917,Africa,2403,41
2020-10-22,Guinea_Bissau,GW,0,0,1920917,Africa,2403,41
2020-10-23,Guinea_Bissau,GW,0,0,1920917,Africa,2403,41
2020-10-24,Guinea_Bissau,GW,0,0,1920917,Africa,2403,41
2020-10-25,Guinea_Bissau,GW,0,0,1920917,Africa,2403,41
2020-10-26,Guinea_Bissau,GW,0,0,1920917,Africa,2403,41
2020-10-27,Guinea_Bissau,GW,0,0,1920917,Africa,2403,41
2020-10-28,Guinea_Bissau,GW,0,0,1920917,Africa,2403,41
2020-10-29,Guinea_Bissau,GW,0,0,1920917,Africa,2403,41
2020-10-30,Guinea_Bissau,GW,0,0,1920917,Africa,2403,41
2020-10-31,Guinea_Bissau,GW,0,0,1920917,Africa,2403,41
2020-11-01,Guinea_Bissau,GW,10,0,1920917,Africa,2413,41
2020-11-02,Guinea_Bissau,GW,0,0,1920917,Africa,2413,41
2020-11-03,Guinea_Bissau,GW,0,0,1920917,Africa,2413,41
2020-11-04,Guinea_Bissau,GW,0,0,1920917,Africa,2413,41
2020-11-05,Guinea_Bissau,GW,0,0,1920917,Africa,2413,41
2020-11-06,Guinea_Bissau,GW,0,0,1920917,Africa,2413,41
2020-11-07,Guinea_Bissau,GW,0,0,1920917,Africa,2413,41
2020-11-08,Guinea_Bissau,GW,0,0,1920917,Africa,2413,41
2020-11-09,Guinea_Bissau,GW,0,0,1920917,Africa,2413,41
2020-11-10,Guinea_Bissau,GW,0,0,1920917,Africa,2413,41
2020-11-11,Guinea_Bissau,GW,0,0,1920917,Africa,2413,41
2020-11-12,Guinea_Bissau,GW,1,1,1920917,Africa,2414,42
2020-11-13,Guinea_Bissau,GW,0,0,1920917,Africa,2414,42
2020-11-14,Guinea_Bissau,GW,5,1,1920917,Africa,2419,43
2020-11-15,Guinea_Bissau,GW,0,0,1920917,Africa,2419,43
2020-11-16,Guinea_Bissau,GW,0,0,1920917,Africa,2419,43
2020-11-17,Guinea_Bissau,GW,0,0,1920917,Africa,2419,43
2020-11-18,Guinea_Bissau,GW,2,0,1920917,Africa,2421,43
2020-11-19,Guinea_Bissau,GW,0,0,1920917,Africa,2421,43
2020-11-20,Guinea_Bissau,GW,0,0,1920917,Africa,2421,43
2020-11-21,Guinea_Bissau,GW,0,0,1920917,Africa,2421,43
2020-11-22,Guinea_Bissau,GW,0,0,1920917,Africa,2421,43
2020-11-23,Guinea_Bissau,GW,0,0,1920917,Africa,2421,43
2020-11-24,Guinea_Bissau,GW,0,0,1920917,Africa,2421,43
2020-11-25,Guinea_Bissau,GW,1,0,1920917,Africa,2422,43
2020-11-26,Guinea_Bissau,GW,0,0,1920917,Africa,2422,43
2020-11-27,Guinea_Bissau,GW,0,0,1920917,Africa,2422,43
2020-11-28,Guinea_Bissau,GW,0,0,1920917,Africa,2422,43
2020-11-29,Guinea_Bissau,GW,0,0,1920917,Africa,2422,43
2020-11-30,Guinea_Bissau,GW,0,0,1920917,Africa,2422,43
2020-12-01,Guinea_Bissau,GW,19,1,1920917,Africa,2441,44
2020-12-02,Guinea_Bissau,GW,1,0,1920917,Africa,2442,44
2020-12-03,Guinea_Bissau,GW,0,0,1920917,Africa,2442,44
2020-12-04,Guinea_Bissau,GW,0,0,1920917,Africa,2442,44
2020-12-05,Guinea_Bissau,GW,0,0,1920917,Africa,2442,44
2020-12-06,Guinea_Bissau,GW,0,0,1920917,Africa,2442,44
2020-12-07,Guinea_Bissau,GW,0,0,1920917,Africa,2442,44
2020-12-08,Guinea_Bissau,GW,0,0,1920917,Africa,2442,44
2020-12-09,Guinea_Bissau,GW,0,0,1920917,Africa,2442,44
2020-12-10,Guinea_Bissau,GW,2,0,1920917,Africa,2444,44
2020-12-11,Guinea_Bissau,GW,0,0,1920917,Africa,2444,44
2020-12-12,Guinea_Bissau,GW,0,0,1920917,Africa,2444,44
2020-12-13,Guinea_Bissau,GW,0,0,1920917,Africa,2444,44
2020-12-14,Guinea_Bissau,GW,0,0,1920917,Africa,2444,44
2020-03-13,Guyana,GY,1,1,782775,America,1,1
2020-03-16,Guyana,GY,3,0,782775,America,4,1
2020-03-17,Guyana,GY,0,0,782775,America,4,1
2020-03-18,Guyana,GY,0,0,782775,America,4,1
2020-03-19,Guyana,GY,1,0,782775,America,5,1
2020-03-20,Guyana,GY,0,0,782775,America,5,1
2020-03-21,Guyana,GY,0,0,782775,America,5,1
2020-03-22,Guyana,GY,0,0,782775,America,5,1
2020-03-23,Guyana,GY,0,0,782775,America,5,1
2020-03-24,Guyana,GY,0,0,782775,America,5,1
2020-03-25,Guyana,GY,0,0,782775,America,5,1
2020-03-26,Guyana,GY,0,0,782775,America,5,1
2020-03-27,Guyana,GY,0,0,782775,America,5,1
2020-03-28,Guyana,GY,0,0,782775,America,5,1
2020-03-29,Guyana,GY,3,0,782775,America,8,1
2020-03-30,Guyana,GY,0,0,782775,America,8,1
2020-03-31,Guyana,GY,0,0,782775,America,8,1
2020-04-01,Guyana,GY,4,1,782775,America,12,2
2020-04-02,Guyana,GY,7,2,782775,America,19,4
2020-04-03,Guyana,GY,0,0,782775,America,19,4
2020-04-04,Guyana,GY,4,0,782775,America,23,4
2020-04-05,Guyana,GY,1,0,782775,America,24,4
2020-04-06,Guyana,GY,5,0,782775,America,29,4
2020-04-07,Guyana,GY,2,1,782775,America,31,5
2020-04-08,Guyana,GY,2,0,782775,America,33,5
2020-04-09,Guyana,GY,4,1,782775,America,37,6
2020-04-10,Guyana,GY,0,0,782775,America,37,6
2020-04-11,Guyana,GY,3,0,782775,America,40,6
2020-04-12,Guyana,GY,5,0,782775,America,45,6
2020-04-13,Guyana,GY,0,0,782775,America,45,6
2020-04-14,Guyana,GY,2,0,782775,America,47,6
2020-04-15,Guyana,GY,1,0,782775,America,48,6
2020-04-16,Guyana,GY,7,0,782775,America,55,6
2020-04-17,Guyana,GY,2,0,782775,America,57,6
2020-04-18,Guyana,GY,6,0,782775,America,63,6
2020-04-19,Guyana,GY,0,1,782775,America,63,7
2020-04-20,Guyana,GY,2,0,782775,America,65,7
2020-04-21,Guyana,GY,1,0,782775,America,66,7
2020-04-22,Guyana,GY,1,0,782775,America,67,7
2020-04-23,Guyana,GY,0,0,782775,America,67,7
2020-04-24,Guyana,GY,3,0,782775,America,70,7
2020-04-25,Guyana,GY,3,1,782775,America,73,8
2020-04-26,Guyana,GY,1,0,782775,America,74,8
2020-04-27,Guyana,GY,0,0,782775,America,74,8
2020-04-28,Guyana,GY,0,0,782775,America,74,8
2020-04-29,Guyana,GY,1,0,782775,America,75,8
2020-04-30,Guyana,GY,3,0,782775,America,78,8
2020-05-01,Guyana,GY,4,1,782775,America,82,9
2020-05-02,Guyana,GY,0,0,782775,America,82,9
2020-05-03,Guyana,GY,0,0,782775,America,82,9
2020-05-04,Guyana,GY,0,0,782775,America,82,9
2020-05-05,Guyana,GY,10,0,782775,America,92,9
2020-05-06,Guyana,GY,1,1,782775,America,93,10
2020-05-07,Guyana,GY,0,0,782775,America,93,10
2020-05-08,Guyana,GY,0,0,782775,America,93,10
2020-05-09,Guyana,GY,1,0,782775,America,94,10
2020-05-10,Guyana,GY,3,0,782775,America,97,10
2020-05-11,Guyana,GY,7,0,782775,America,104,10
2020-05-12,Guyana,GY,5,0,782775,America,109,10
2020-05-13,Guyana,GY,4,0,782775,America,113,10
2020-05-14,Guyana,GY,0,0,782775,America,113,10
2020-05-15,Guyana,GY,0,0,782775,America,113,10
2020-05-16,Guyana,GY,3,0,782775,America,116,10
2020-05-17,Guyana,GY,1,0,782775,America,117,10
2020-05-18,Guyana,GY,0,0,782775,America,117,10
2020-05-19,Guyana,GY,7,0,782775,America,124,10
2020-05-20,Guyana,GY,1,0,782775,America,125,10
2020-05-21,Guyana,GY,0,0,782775,America,125,10
2020-05-22,Guyana,GY,2,0,782775,America,127,10
2020-05-23,Guyana,GY,0,0,782775,America,127,10
2020-05-24,Guyana,GY,0,0,782775,America,127,10
2020-05-25,Guyana,GY,8,0,782775,America,135,10
2020-05-26,Guyana,GY,2,1,782775,America,137,11
2020-05-27,Guyana,GY,2,0,782775,America,139,11
2020-05-28,Guyana,GY,0,0,782775,America,139,11
2020-05-29,Guyana,GY,11,0,782775,America,150,11
2020-05-30,Guyana,GY,0,0,782775,America,150,11
2020-05-31,Guyana,GY,2,1,782775,America,152,12
2020-06-01,Guyana,GY,1,0,782775,America,153,12
2020-06-02,Guyana,GY,0,0,782775,America,153,12
2020-06-03,Guyana,GY,0,0,782775,America,153,12
2020-06-04,Guyana,GY,0,0,782775,America,153,12
2020-06-05,Guyana,GY,0,0,782775,America,153,12
2020-06-06,Guyana,GY,0,0,782775,America,153,12
2020-06-07,Guyana,GY,1,0,782775,America,154,12
2020-06-08,Guyana,GY,0,0,782775,America,154,12
2020-06-09,Guyana,GY,0,0,782775,America,154,12
2020-06-10,Guyana,GY,2,0,782775,America,156,12
2020-06-11,Guyana,GY,0,0,782775,America,156,12
2020-06-12,Guyana,GY,2,0,782775,America,158,12
2020-06-13,Guyana,GY,1,0,782775,America,159,12
2020-06-14,Guyana,GY,0,0,782775,America,159,12
2020-06-15,Guyana,GY,0,0,782775,America,159,12
2020-06-16,Guyana,GY,0,0,782775,America,159,12
2020-06-17,Guyana,GY,12,0,782775,America,171,12
2020-06-18,Guyana,GY,0,0,782775,America,171,12
2020-06-19,Guyana,GY,12,0,782775,America,183,12
2020-06-20,Guyana,GY,0,0,782775,America,183,12
2020-06-21,Guyana,GY,0,0,782775,America,183,12
2020-06-22,Guyana,GY,1,0,782775,America,184,12
2020-06-23,Guyana,GY,21,0,782775,America,205,12
2020-06-24,Guyana,GY,1,0,782775,America,206,12
2020-06-25,Guyana,GY,3,0,782775,America,209,12
2020-06-26,Guyana,GY,6,0,782775,America,215,12
2020-06-27,Guyana,GY,15,0,782775,America,230,12
2020-06-28,Guyana,GY,0,0,782775,America,230,12
2020-06-29,Guyana,GY,0,0,782775,America,230,12
2020-06-30,Guyana,GY,5,0,782775,America,235,12
2020-07-01,Guyana,GY,10,0,782775,America,245,12
2020-07-02,Guyana,GY,3,1,782775,America,248,13
2020-07-03,Guyana,GY,2,1,782775,America,250,14
2020-07-04,Guyana,GY,6,0,782775,America,256,14
2020-07-05,Guyana,GY,16,0,782775,America,272,14
2020-07-06,Guyana,GY,1,1,782775,America,273,15
2020-07-07,Guyana,GY,5,1,782775,America,278,16
2020-07-08,Guyana,GY,7,0,782775,America,285,16
2020-07-09,Guyana,GY,0,0,782775,America,285,16
2020-07-10,Guyana,GY,1,0,782775,America,286,16
2020-07-11,Guyana,GY,4,0,782775,America,290,16
2020-07-12,Guyana,GY,1,1,782775,America,291,17
2020-07-13,Guyana,GY,6,0,782775,America,297,17
2020-07-14,Guyana,GY,3,0,782775,America,300,17
2020-07-15,Guyana,GY,8,0,782775,America,308,17
2020-07-16,Guyana,GY,5,1,782775,America,313,18
2020-07-17,Guyana,GY,1,1,782775,America,314,19
2020-07-18,Guyana,GY,1,0,782775,America,315,19
2020-07-19,Guyana,GY,12,0,782775,America,327,19
2020-07-20,Guyana,GY,9,0,782775,America,336,19
2020-07-21,Guyana,GY,1,0,782775,America,337,19
2020-07-22,Guyana,GY,2,0,782775,America,339,19
2020-07-23,Guyana,GY,11,0,782775,America,350,19
2020-07-24,Guyana,GY,1,0,782775,America,351,19
2020-07-25,Guyana,GY,1,1,782775,America,352,20
2020-07-26,Guyana,GY,8,0,782775,America,360,20
2020-07-27,Guyana,GY,10,0,782775,America,370,20
2020-07-28,Guyana,GY,19,0,782775,America,389,20
2020-07-29,Guyana,GY,7,0,782775,America,396,20
2020-07-30,Guyana,GY,2,0,782775,America,398,20
2020-07-31,Guyana,GY,3,0,782775,America,401,20
2020-08-01,Guyana,GY,12,0,782775,America,413,20
2020-08-02,Guyana,GY,17,0,782775,America,430,20
2020-08-03,Guyana,GY,44,1,782775,America,474,21
2020-08-04,Guyana,GY,0,0,782775,America,474,21
2020-08-05,Guyana,GY,23,1,782775,America,497,22
2020-08-06,Guyana,GY,12,0,782775,America,509,22
2020-08-07,Guyana,GY,29,0,782775,America,538,22
2020-08-08,Guyana,GY,0,0,782775,America,538,22
2020-08-09,Guyana,GY,16,0,782775,America,554,22
2020-08-10,Guyana,GY,14,0,782775,America,568,22
2020-08-11,Guyana,GY,0,0,782775,America,568,22
2020-08-12,Guyana,GY,0,0,782775,America,568,22
2020-08-13,Guyana,GY,55,0,782775,America,623,22
2020-08-14,Guyana,GY,8,0,782775,America,631,22
2020-08-15,Guyana,GY,18,0,782775,America,649,22
2020-08-16,Guyana,GY,25,0,782775,America,674,22
2020-08-17,Guyana,GY,35,1,782775,America,709,23
2020-08-18,Guyana,GY,0,0,782775,America,709,23
2020-08-19,Guyana,GY,28,2,782775,America,737,25
2020-08-20,Guyana,GY,39,2,782775,America,776,27
2020-08-21,Guyana,GY,70,2,782775,America,846,29
2020-08-22,Guyana,GY,35,1,782775,America,881,30
2020-08-23,Guyana,GY,44,1,782775,America,925,31
2020-08-24,Guyana,GY,30,0,782775,America,955,31
2020-08-25,Guyana,GY,0,0,782775,America,955,31
2020-08-26,Guyana,GY,105,0,782775,America,1060,31
2020-08-27,Guyana,GY,33,0,782775,America,1093,31
2020-08-28,Guyana,GY,47,1,782775,America,1140,32
2020-08-29,Guyana,GY,40,3,782775,America,1180,35
2020-08-30,Guyana,GY,4,0,782775,America,1184,35
2020-08-31,Guyana,GY,50,2,782775,America,1234,37
2020-09-01,Guyana,GY,72,2,782775,America,1306,39
2020-09-02,Guyana,GY,67,2,782775,America,1373,41
2020-09-03,Guyana,GY,9,0,782775,America,1382,41
2020-09-04,Guyana,GY,19,3,782775,America,1401,44
2020-09-05,Guyana,GY,15,0,782775,America,1416,44
2020-09-06,Guyana,GY,43,2,782775,America,1459,46
2020-09-07,Guyana,GY,9,0,782775,America,1468,46
2020-09-08,Guyana,GY,92,1,782775,America,1560,47
2020-09-09,Guyana,GY,53,1,782775,America,1613,48
2020-09-10,Guyana,GY,90,0,782775,America,1703,48
2020-09-11,Guyana,GY,47,1,782775,America,1750,49
2020-09-12,Guyana,GY,13,3,782775,America,1763,52
2020-09-13,Guyana,GY,49,2,782775,America,1812,54
2020-09-14,Guyana,GY,41,2,782775,America,1853,56
2020-09-15,Guyana,GY,31,0,782775,America,1884,56
2020-09-16,Guyana,GY,74,2,782775,America,1958,58
2020-09-17,Guyana,GY,0,0,782775,America,1958,58
2020-09-18,Guyana,GY,69,2,782775,America,2027,60
2020-09-19,Guyana,GY,75,2,782775,America,2102,62
2020-09-20,Guyana,GY,66,2,782775,America,2168,64
2020-09-21,Guyana,GY,101,0,782775,America,2269,64
2020-09-22,Guyana,GY,133,1,782775,America,2402,65
2020-09-23,Guyana,GY,35,2,782775,America,2437,67
2020-09-24,Guyana,GY,98,2,782775,America,2535,69
2020-09-25,Guyana,GY,44,2,782775,America,2579,71
2020-09-26,Guyana,GY,130,2,782775,America,2709,73
2020-09-27,Guyana,GY,16,1,782775,America,2725,74
2020-09-28,Guyana,GY,47,2,782775,America,2772,76
2020-09-29,Guyana,GY,15,2,782775,America,2787,78
2020-09-30,Guyana,GY,59,0,782775,America,2846,78
2020-10-01,Guyana,GY,48,2,782775,America,2894,80
2020-10-02,Guyana,GY,35,2,782775,America,2929,82
2020-10-03,Guyana,GY,39,3,782775,America,2968,85
2020-10-04,Guyana,GY,37,0,782775,America,3005,85
2020-10-05,Guyana,GY,88,2,782775,America,3093,87
2020-10-06,Guyana,GY,95,3,782775,America,3188,90
2020-10-07,Guyana,GY,0,2,782775,America,3188,92
2020-10-08,Guyana,GY,104,3,782775,America,3292,95
2020-10-09,Guyana,GY,37,3,782775,America,3329,98
2020-10-10,Guyana,GY,29,2,782775,America,3358,100
2020-10-11,Guyana,GY,47,2,782775,America,3405,102
2020-10-12,Guyana,GY,64,1,782775,America,3469,103
2020-10-13,Guyana,GY,52,1,782775,America,3521,104
2020-10-14,Guyana,GY,44,2,782775,America,3565,106
2020-10-15,Guyana,GY,24,0,782775,America,3589,106
2020-10-16,Guyana,GY,31,1,782775,America,3620,107
2020-10-17,Guyana,GY,52,0,782775,America,3672,107
2020-10-18,Guyana,GY,38,2,782775,America,3710,109
2020-10-19,Guyana,GY,24,0,782775,America,3734,109
2020-10-20,Guyana,GY,31,2,782775,America,3765,111
2020-10-21,Guyana,GY,31,3,782775,America,3796,114
2020-10-22,Guyana,GY,54,2,782775,America,3850,116
2020-10-23,Guyana,GY,27,1,782775,America,3877,117
2020-10-24,Guyana,GY,83,0,782775,America,3960,117
2020-10-25,Guyana,GY,34,0,782775,America,3994,117
2020-10-26,Guyana,GY,29,2,782775,America,4023,119
2020-10-27,Guyana,GY,3,0,782775,America,4026,119
2020-10-28,Guyana,GY,35,0,782775,America,4061,119
2020-10-29,Guyana,GY,13,4,782775,America,4074,123
2020-10-30,Guyana,GY,24,0,782775,America,4098,123
2020-10-31,Guyana,GY,45,1,782775,America,4143,124
2020-11-01,Guyana,GY,19,0,782775,America,4162,124
2020-11-02,Guyana,GY,46,2,782775,America,4208,126
2020-11-03,Guyana,GY,30,2,782775,America,4238,128
2020-11-04,Guyana,GY,7,0,782775,America,4245,128
2020-11-05,Guyana,GY,79,2,782775,America,4324,130
2020-11-06,Guyana,GY,69,0,782775,America,4393,130
2020-11-07,Guyana,GY,64,3,782775,America,4457,133
2020-11-08,Guyana,GY,27,1,782775,America,4484,134
2020-11-09,Guyana,GY,30,0,782775,America,4514,134
2020-11-10,Guyana,GY,10,1,782775,America,4524,135
2020-11-11,Guyana,GY,6,0,782775,America,4530,135
2020-11-12,Guyana,GY,88,2,782775,America,4618,137
2020-11-13,Guyana,GY,44,1,782775,America,4662,138
2020-11-14,Guyana,GY,62,0,782775,America,4724,138
2020-11-15,Guyana,GY,70,0,782775,America,4794,138
2020-11-16,Guyana,GY,29,1,782775,America,4823,139
2020-11-17,Guyana,GY,0,0,782775,America,4823,139
2020-11-18,Guyana,GY,67,1,782775,America,4890,140
2020-11-19,Guyana,GY,24,2,782775,America,4914,142
2020-11-20,Guyana,GY,62,1,782775,America,4976,143
2020-11-21,Guyana,GY,29,0,782775,America,5005,143
2020-11-22,Guyana,GY,88,0,782775,America,5093,143
2020-11-23,Guyana,GY,40,0,782775,America,5133,143
2020-11-24,Guyana,GY,0,0,782775,America,5133,143
2020-11-25,Guyana,GY,56,4,782775,America,5189,147
2020-11-26,Guyana,GY,0,0,782775,America,5189,147
2020-11-27,Guyana,GY,87,2,782775,America,5276,149
2020-11-28,Guyana,GY,34,0,782775,America,5310,149
2020-11-29,Guyana,GY,28,0,782775,America,5338,149
2020-11-30,Guyana,GY,38,1,782775,America,5376,150
2020-12-01,Guyana,GY,30,1,782775,America,5406,151
2020-12-02,Guyana,GY,17,0,782775,America,5423,151
2020-12-03,Guyana,GY,26,0,782775,America,5449,151
2020-12-04,Guyana,GY,79,0,782775,America,5528,151
2020-12-05,Guyana,GY,73,0,782775,America,5601,151
2020-12-06,Guyana,GY,36,0,782775,America,5637,151
2020-12-07,Guyana,GY,28,2,782775,America,5665,153
2020-12-08,Guyana,GY,32,1,782775,America,5697,154
2020-12-09,Guyana,GY,3,0,782775,America,5700,154
2020-12-10,Guyana,GY,32,0,782775,America,5732,154
2020-12-11,Guyana,GY,79,0,782775,America,5811,154
2020-12-12,Guyana,GY,28,0,782775,America,5839,154
2020-12-13,Guyana,GY,40,0,782775,America,5879,154
2020-12-14,Guyana,GY,41,1,782775,America,5920,155
2020-03-12,Honduras,HN,2,0,9746115,America,2,0
2020-03-14,Honduras,HN,1,0,9746115,America,3,0
2020-03-16,Honduras,HN,3,0,9746115,America,6,0
2020-03-17,Honduras,HN,2,0,9746115,America,8,0
2020-03-18,Honduras,HN,1,0,9746115,America,9,0
2020-03-19,Honduras,HN,3,0,9746115,America,12,0
2020-03-20,Honduras,HN,12,0,9746115,America,24,0
2020-03-21,Honduras,HN,0,0,9746115,America,24,0
2020-03-22,Honduras,HN,2,0,9746115,America,26,0
2020-03-23,Honduras,HN,1,0,9746115,America,27,0
2020-03-24,Honduras,HN,3,0,9746115,America,30,0
2020-03-25,Honduras,HN,6,0,9746115,America,36,0
2020-03-26,Honduras,HN,16,0,9746115,America,52,0
2020-03-27,Honduras,HN,15,1,9746115,America,67,1
2020-03-28,Honduras,HN,28,0,9746115,America,95,1
2020-03-29,Honduras,HN,15,1,9746115,America,110,2
2020-03-30,Honduras,HN,29,1,9746115,America,139,3
2020-03-31,Honduras,HN,2,4,9746115,America,141,7
2020-04-01,Honduras,HN,31,3,9746115,America,172,10
2020-04-02,Honduras,HN,47,4,9746115,America,219,14
2020-04-03,Honduras,HN,3,1,9746115,America,222,15
2020-04-04,Honduras,HN,42,0,9746115,America,264,15
2020-04-05,Honduras,HN,4,7,9746115,America,268,22
2020-04-06,Honduras,HN,30,0,9746115,America,298,22
2020-04-07,Honduras,HN,7,0,9746115,America,305,22
2020-04-08,Honduras,HN,7,0,9746115,America,312,22
2020-04-09,Honduras,HN,31,1,9746115,America,343,23
2020-04-10,Honduras,HN,39,0,9746115,America,382,23
2020-04-11,Honduras,HN,10,1,9746115,America,392,24
2020-04-12,Honduras,HN,1,1,9746115,America,393,25
2020-04-13,Honduras,HN,4,0,9746115,America,397,25
2020-04-14,Honduras,HN,10,1,9746115,America,407,26
2020-04-15,Honduras,HN,12,5,9746115,America,419,31
2020-04-16,Honduras,HN,7,4,9746115,America,426,35
2020-04-17,Honduras,HN,16,6,9746115,America,442,41
2020-04-18,Honduras,HN,15,5,9746115,America,457,46
2020-04-19,Honduras,HN,15,0,9746115,America,472,46
2020-04-20,Honduras,HN,5,0,9746115,America,477,46
2020-04-21,Honduras,HN,17,0,9746115,America,494,46
2020-04-22,Honduras,HN,16,0,9746115,America,510,46
2020-04-23,Honduras,HN,9,1,9746115,America,519,47
2020-04-24,Honduras,HN,0,0,9746115,America,519,47
2020-04-25,Honduras,HN,72,0,9746115,America,591,47
2020-04-26,Honduras,HN,36,12,9746115,America,627,59
2020-04-27,Honduras,HN,34,2,9746115,America,661,61
2020-04-28,Honduras,HN,32,0,9746115,America,693,61
2020-04-29,Honduras,HN,45,5,9746115,America,738,66
2020-04-30,Honduras,HN,33,5,9746115,America,771,71
2020-05-01,Honduras,HN,33,4,9746115,America,804,75
2020-05-02,Honduras,HN,95,0,9746115,America,899,75
2020-05-03,Honduras,HN,111,1,9746115,America,1010,76
2020-05-04,Honduras,HN,45,6,9746115,America,1055,82
2020-05-05,Honduras,HN,123,0,9746115,America,1178,82
2020-05-06,Honduras,HN,92,11,9746115,America,1270,93
2020-05-07,Honduras,HN,191,6,9746115,America,1461,99
2020-05-08,Honduras,HN,224,6,9746115,America,1685,105
2020-05-09,Honduras,HN,86,2,9746115,America,1771,107
2020-05-10,Honduras,HN,59,1,9746115,America,1830,108
2020-05-11,Honduras,HN,142,0,9746115,America,1972,108
2020-05-12,Honduras,HN,34,8,9746115,America,2006,116
2020-05-13,Honduras,HN,74,5,9746115,America,2080,121
2020-05-14,Honduras,HN,175,2,9746115,America,2255,123
2020-05-15,Honduras,HN,63,10,9746115,America,2318,133
2020-05-16,Honduras,HN,142,1,9746115,America,2460,134
2020-05-17,Honduras,HN,105,4,9746115,America,2565,138
2020-05-18,Honduras,HN,81,4,9746115,America,2646,142
2020-05-19,Honduras,HN,152,4,9746115,America,2798,146
2020-05-20,Honduras,HN,157,1,9746115,America,2955,147
2020-05-21,Honduras,HN,145,4,9746115,America,3100,151
2020-05-22,Honduras,HN,104,5,9746115,America,3204,156
2020-05-23,Honduras,HN,273,11,9746115,America,3477,167
2020-05-24,Honduras,HN,266,7,9746115,America,3743,174
2020-05-25,Honduras,HN,207,6,9746115,America,3950,180
2020-05-26,Honduras,HN,239,2,9746115,America,4189,182
2020-05-27,Honduras,HN,212,6,9746115,America,4401,188
2020-05-28,Honduras,HN,239,6,9746115,America,4640,194
2020-05-29,Honduras,HN,112,2,9746115,America,4752,196
2020-05-30,Honduras,HN,134,3,9746115,America,4886,199
2020-05-31,Honduras,HN,208,2,9746115,America,5094,201
2020-06-01,Honduras,HN,108,11,9746115,America,5202,212
2020-06-02,Honduras,HN,160,5,9746115,America,5362,217
2020-06-03,Honduras,HN,165,8,9746115,America,5527,225
2020-06-04,Honduras,HN,163,9,9746115,America,5690,234
2020-06-05,Honduras,HN,190,9,9746115,America,5880,243
2020-06-06,Honduras,HN,91,5,9746115,America,5971,248
2020-06-07,Honduras,HN,184,2,9746115,America,6155,250
2020-06-08,Honduras,HN,172,8,9746115,America,6327,258
2020-06-09,Honduras,HN,123,4,9746115,America,6450,262
2020-06-10,Honduras,HN,485,9,9746115,America,6935,271
2020-06-11,Honduras,HN,425,19,9746115,America,7360,290
2020-06-12,Honduras,HN,309,4,9746115,America,7669,294
2020-06-13,Honduras,HN,463,12,9746115,America,8132,306
2020-06-14,Honduras,HN,323,4,9746115,America,8455,310
2020-06-15,Honduras,HN,403,2,9746115,America,8858,312
2020-06-16,Honduras,HN,320,10,9746115,America,9178,322
2020-06-17,Honduras,HN,478,8,9746115,America,9656,330
2020-06-18,Honduras,HN,643,6,9746115,America,10299,336
2020-06-19,Honduras,HN,440,7,9746115,America,10739,343
2020-06-20,Honduras,HN,519,6,9746115,America,11258,349
2020-06-21,Honduras,HN,992,9,9746115,America,12250,358
2020-06-22,Honduras,HN,519,5,9746115,America,12769,363
2020-06-23,Honduras,HN,587,32,9746115,America,13356,395
2020-06-24,Honduras,HN,587,10,9746115,America,13943,405
2020-06-25,Honduras,HN,628,12,9746115,America,14571,417
2020-06-26,Honduras,HN,795,9,9746115,America,15366,426
2020-06-27,Honduras,HN,628,45,9746115,America,15994,471
2020-06-28,Honduras,HN,1013,8,9746115,America,17007,479
2020-06-29,Honduras,HN,1075,0,9746115,America,18082,479
2020-06-30,Honduras,HN,736,6,9746115,America,18818,485
2020-07-01,Honduras,HN,740,12,9746115,America,19558,497
2020-07-02,Honduras,HN,704,45,9746115,America,20262,542
2020-07-03,Honduras,HN,858,49,9746115,America,21120,591
2020-07-04,Honduras,HN,996,14,9746115,America,22116,605
2020-07-05,Honduras,HN,805,24,9746115,America,22921,629
2020-07-06,Honduras,HN,1022,10,9746115,America,23943,639
2020-07-07,Honduras,HN,722,17,9746115,America,24665,656
2020-07-08,Honduras,HN,763,21,9746115,America,25428,677
2020-07-09,Honduras,HN,550,17,9746115,America,25978,694
2020-07-10,Honduras,HN,406,10,9746115,America,26384,704
2020-07-11,Honduras,HN,669,46,9746115,America,27053,750
2020-07-12,Honduras,HN,530,21,9746115,America,27583,771
2020-07-13,Honduras,HN,507,3,9746115,America,28090,774
2020-07-14,Honduras,HN,489,15,9746115,America,28579,789
2020-07-15,Honduras,HN,527,18,9746115,America,29106,807
2020-07-16,Honduras,HN,930,18,9746115,America,30036,825
2020-07-17,Honduras,HN,831,10,9746115,America,30867,835
2020-07-18,Honduras,HN,878,22,9746115,America,31745,857
2020-07-19,Honduras,HN,1048,34,9746115,America,32793,891
2020-07-20,Honduras,HN,1042,9,9746115,America,33835,900
2020-07-21,Honduras,HN,776,35,9746115,America,34611,935
2020-07-22,Honduras,HN,734,53,9746115,America,35345,988
2020-07-23,Honduras,HN,757,18,9746115,America,36102,1006
2020-07-24,Honduras,HN,800,5,9746115,America,36902,1011
2020-07-25,Honduras,HN,657,50,9746115,America,37559,1061
2020-07-26,Honduras,HN,879,37,9746115,America,38438,1098
2020-07-27,Honduras,HN,838,18,9746115,America,39276,1116
2020-07-28,Honduras,HN,465,50,9746115,America,39741,1166
2020-07-29,Honduras,HN,719,48,9746115,America,40460,1214
2020-07-30,Honduras,HN,484,45,9746115,America,40944,1259
2020-07-31,Honduras,HN,482,53,9746115,America,41426,1312
2020-08-01,Honduras,HN,976,25,9746115,America,42402,1337
2020-08-02,Honduras,HN,283,31,9746115,America,42685,1368
2020-08-03,Honduras,HN,512,9,9746115,America,43197,1377
2020-08-04,Honduras,HN,597,7,9746115,America,43794,1384
2020-08-05,Honduras,HN,505,16,9746115,America,44299,1400
2020-08-06,Honduras,HN,799,23,9746115,America,45098,1423
2020-08-07,Honduras,HN,657,23,9746115,America,45755,1446
2020-08-08,Honduras,HN,610,19,9746115,America,46365,1465
2020-08-09,Honduras,HN,611,11,9746115,America,46976,1476
2020-08-10,Honduras,HN,478,19,9746115,America,47454,1495
2020-08-11,Honduras,HN,418,11,9746115,America,47872,1506
2020-08-12,Honduras,HN,531,9,9746115,America,48403,1515
2020-08-13,Honduras,HN,254,18,9746115,America,48657,1533
2020-08-14,Honduras,HN,385,9,9746115,America,49042,1542
2020-08-15,Honduras,HN,425,6,9746115,America,49467,1548
2020-08-16,Honduras,HN,512,19,9746115,America,49979,1567
2020-08-17,Honduras,HN,523,8,9746115,America,50502,1575
2020-08-18,Honduras,HN,493,8,9746115,America,50995,1583
2020-08-19,Honduras,HN,675,10,9746115,America,51670,1593
2020-08-20,Honduras,HN,626,15,9746115,America,52296,1608
2020-08-21,Honduras,HN,523,11,9746115,America,52819,1619
2020-08-22,Honduras,HN,562,13,9746115,America,53381,1632
2020-08-23,Honduras,HN,602,11,9746115,America,53983,1643
2020-08-24,Honduras,HN,528,11,9746115,America,54511,1654
2020-08-25,Honduras,HN,968,29,9746115,America,55479,1683
2020-08-26,Honduras,HN,0,0,9746115,America,55479,1683
2020-08-27,Honduras,HN,1170,64,9746115,America,56649,1747
2020-08-28,Honduras,HN,1020,56,9746115,America,57669,1803
2020-08-29,Honduras,HN,1141,24,9746115,America,58810,1827
2020-08-30,Honduras,HN,835,15,9746115,America,59645,1842
2020-08-31,Honduras,HN,529,16,9746115,America,60174,1858
2020-09-01,Honduras,HN,840,15,9746115,America,61014,1873
2020-09-02,Honduras,HN,755,15,9746115,America,61769,1888
2020-09-03,Honduras,HN,757,36,9746115,America,62526,1924
2020-09-04,Honduras,HN,632,30,9746115,America,63158,1954
2020-09-05,Honduras,HN,640,30,9746115,America,63798,1984
2020-09-06,Honduras,HN,554,22,9746115,America,64352,2006
2020-09-07,Honduras,HN,412,1,9746115,America,64764,2007
2020-09-08,Honduras,HN,50,16,9746115,America,64814,2023
2020-09-09,Honduras,HN,404,11,9746115,America,65218,2034
2020-09-10,Honduras,HN,379,10,9746115,America,65597,2044
2020-09-11,Honduras,HN,205,5,9746115,America,65802,2049
2020-09-12,Honduras,HN,247,9,9746115,America,66049,2058
2020-09-13,Honduras,HN,1087,7,9746115,America,67136,2065
2020-09-14,Honduras,HN,653,14,9746115,America,67789,2079
2020-09-15,Honduras,HN,831,8,9746115,America,68620,2087
2020-09-16,Honduras,HN,0,0,9746115,America,68620,2087
2020-09-17,Honduras,HN,1040,15,9746115,America,69660,2102
2020-09-18,Honduras,HN,460,20,9746115,America,70120,2122
2020-09-19,Honduras,HN,491,24,9746115,America,70611,2146
2020-09-20,Honduras,HN,532,20,9746115,America,71143,2166
2020-09-21,Honduras,HN,473,18,9746115,America,71616,2184
2020-09-22,Honduras,HN,459,20,9746115,America,72075,2204
2020-09-23,Honduras,HN,231,2,9746115,America,72306,2206
2020-09-24,Honduras,HN,369,16,9746115,America,72675,2222
2020-09-25,Honduras,HN,518,27,9746115,America,73193,2249
2020-09-26,Honduras,HN,647,22,9746115,America,73840,2271
2020-09-27,Honduras,HN,708,17,9746115,America,74548,2288
2020-09-28,Honduras,HN,561,1,9746115,America,75109,2289
2020-09-29,Honduras,HN,428,12,9746115,America,75537,2301
2020-09-30,Honduras,HN,561,22,9746115,America,76098,2323
2020-10-01,Honduras,HN,802,30,9746115,America,76900,2353
2020-10-02,Honduras,HN,698,27,9746115,America,77598,2380
2020-10-03,Honduras,HN,671,6,9746115,America,78269,2386
2020-10-04,Honduras,HN,519,13,9746115,America,78788,2399
2020-10-05,Honduras,HN,841,23,9746115,America,79629,2422
2020-10-06,Honduras,HN,391,11,9746115,America,80020,2433
2020-10-07,Honduras,HN,642,14,9746115,America,80662,2447
2020-10-08,Honduras,HN,354,19,9746115,America,81016,2466
2020-10-09,Honduras,HN,656,11,9746115,America,81672,2477
2020-10-10,Honduras,HN,880,15,9746115,America,82552,2492
2020-10-11,Honduras,HN,594,12,9746115,America,83146,2504
2020-10-12,Honduras,HN,935,8,9746115,America,84081,2512
2020-10-13,Honduras,HN,332,9,9746115,America,84413,2521
2020-10-14,Honduras,HN,439,7,9746115,America,84852,2528
2020-10-15,Honduras,HN,606,5,9746115,America,85458,2533
2020-10-16,Honduras,HN,631,19,9746115,America,86089,2552
2020-10-17,Honduras,HN,602,4,9746115,America,86691,2556
2020-10-18,Honduras,HN,903,7,9746115,America,87594,2563
2020-10-19,Honduras,HN,831,5,9746115,America,88425,2568
2020-10-20,Honduras,HN,956,8,9746115,America,89381,2576
2020-10-21,Honduras,HN,851,6,9746115,America,90232,2582
2020-10-22,Honduras,HN,846,14,9746115,America,91078,2596
2020-10-23,Honduras,HN,431,8,9746115,America,91509,2604
2020-10-24,Honduras,HN,373,8,9746115,America,91882,2612
2020-10-25,Honduras,HN,842,5,9746115,America,92724,2617
2020-10-26,Honduras,HN,490,6,9746115,America,93214,2623
2020-10-27,Honduras,HN,752,10,9746115,America,93966,2633
2020-10-28,Honduras,HN,657,6,9746115,America,94623,2639
2020-10-29,Honduras,HN,576,13,9746115,America,95199,2652
2020-10-30,Honduras,HN,951,9,9746115,America,96150,2661
2020-10-31,Honduras,HN,738,8,9746115,America,96888,2669
2020-11-01,Honduras,HN,516,3,9746115,America,97404,2672
2020-11-02,Honduras,HN,808,3,9746115,America,98212,2675
2020-11-03,Honduras,HN,193,13,9746115,America,98405,2688
2020-11-04,Honduras,HN,283,18,9746115,America,98688,2706
2020-11-05,Honduras,HN,436,24,9746115,America,99124,2730
2020-11-06,Honduras,HN,223,6,9746115,America,99347,2736
2020-11-07,Honduras,HN,229,5,9746115,America,99576,2741
2020-11-08,Honduras,HN,465,4,9746115,America,100041,2745
2020-11-09,Honduras,HN,467,6,9746115,America,100508,2751
2020-11-10,Honduras,HN,65,14,9746115,America,100573,2765
2020-11-11,Honduras,HN,231,15,9746115,America,100804,2780
2020-11-12,Honduras,HN,365,17,9746115,America,101169,2797
2020-11-13,Honduras,HN,299,7,9746115,America,101468,2804
2020-11-14,Honduras,HN,611,16,9746115,America,102079,2820
2020-11-15,Honduras,HN,476,2,9746115,America,102555,2822
2020-11-16,Honduras,HN,547,1,9746115,America,103102,2823
2020-11-17,Honduras,HN,137,16,9746115,America,103239,2839
2020-11-18,Honduras,HN,249,0,9746115,America,103488,2839
2020-11-19,Honduras,HN,0,0,9746115,America,103488,2839
2020-11-20,Honduras,HN,0,0,9746115,America,103488,2839
2020-11-21,Honduras,HN,0,0,9746115,America,103488,2839
2020-11-22,Honduras,HN,947,18,9746115,America,104435,2857
2020-11-23,Honduras,HN,0,0,9746115,America,104435,2857
2020-11-24,Honduras,HN,480,2,9746115,America,104915,2859
2020-11-25,Honduras,HN,296,10,9746115,America,105211,2869
2020-11-26,Honduras,HN,905,19,9746115,America,106116,2888
2020-11-27,Honduras,HN,565,4,9746115,America,106681,2892
2020-11-28,Honduras,HN,453,7,9746115,America,107134,2899
2020-11-29,Honduras,HN,379,6,9746115,America,107513,2905
2020-11-30,Honduras,HN,375,4,9746115,America,107888,2909
2020-12-01,Honduras,HN,365,9,9746115,America,108253,2918
2020-12-02,Honduras,HN,388,9,9746115,America,108641,2927
2020-12-03,Honduras,HN,503,3,9746115,America,109144,2930
2020-12-04,Honduras,HN,616,8,9746115,America,109760,2938
2020-12-05,Honduras,HN,200,3,9746115,America,109960,2941
2020-12-06,Honduras,HN,763,4,9746115,America,110723,2945
2020-12-07,Honduras,HN,300,1,9746115,America,111023,2946
2020-12-08,Honduras,HN,0,0,9746115,America,111023,2946
2020-12-09,Honduras,HN,1152,6,9746115,America,112175,2952
2020-12-10,Honduras,HN,617,9,9746115,America,112792,2961
2020-12-11,Honduras,HN,415,7,9746115,America,113207,2968
2020-12-12,Honduras,HN,501,3,9746115,America,113708,2971
2020-12-13,Honduras,HN,335,3,9746115,America,114043,2974
2020-12-14,Honduras,HN,316,1,9746115,America,114359,2975
2019-12-31,Croatia,HR,0,0,4076246,Europe,0,0
2020-01-01,Croatia,HR,0,0,4076246,Europe,0,0
2020-01-02,Croatia,HR,0,0,4076246,Europe,0,0
2020-01-03,Croatia,HR,0,0,4076246,Europe,0,0
2020-01-04,Croatia,HR,0,0,4076246,Europe,0,0
2020-01-05,Croatia,HR,0,0,4076246,Europe,0,0
2020-01-06,Croatia,HR,0,0,4076246,Europe,0,0
2020-01-07,Croatia,HR,0,0,4076246,Europe,0,0
2020-01-08,Croatia,HR,0,0,4076246,Europe,0,0
2020-01-09,Croatia,HR,0,0,4076246,Europe,0,0
2020-01-10,Croatia,HR,0,0,4076246,Europe,0,0
2020-01-11,Croatia,HR,0,0,4076246,Europe,0,0
2020-01-12,Croatia,HR,0,0,4076246,Europe,0,0
2020-01-13,Croatia,HR,0,0,4076246,Europe,0,0
2020-01-14,Croatia,HR,0,0,4076246,Europe,0,0
2020-01-15,Croatia,HR,0,0,4076246,Europe,0,0
2020-01-16,Croatia,HR,0,0,4076246,Europe,0,0
2020-01-17,Croatia,HR,0,0,4076246,Europe,0,0
2020-01-18,Croatia,HR,0,0,4076246,Europe,0,0
2020-01-19,Croatia,HR,0,0,4076246,Europe,0,0
2020-01-20,Croatia,HR,0,0,4076246,Europe,0,0
2020-01-21,Croatia,HR,0,0,4076246,Europe,0,0
2020-01-22,Croatia,HR,0,0,4076246,Europe,0,0
2020-01-23,Croatia,HR,0,0,4076246,Europe,0,0
2020-01-24,Croatia,HR,0,0,4076246,Europe,0,0
2020-01-25,Croatia,HR,0,0,4076246,Europe,0,0
2020-01-26,Croatia,HR,0,0,4076246,Europe,0,0
2020-01-27,Croatia,HR,0,0,4076246,Europe,0,0
2020-01-28,Croatia,HR,0,0,4076246,Europe,0,0
2020-01-29,Croatia,HR,0,0,4076246,Europe,0,0
2020-01-30,Croatia,HR,0,0,4076246,Europe,0,0
2020-01-31,Croatia,HR,0,0,4076246,Europe,0,0
2020-02-01,Croatia,HR,0,0,4076246,Europe,0,0
2020-02-02,Croatia,HR,0,0,4076246,Europe,0,0
2020-02-03,Croatia,HR,0,0,4076246,Europe,0,0
2020-02-04,Croatia,HR,0,0,4076246,Europe,0,0
2020-02-05,Croatia,HR,0,0,4076246,Europe,0,0
2020-02-06,Croatia,HR,0,0,4076246,Europe,0,0
2020-02-07,Croatia,HR,0,0,4076246,Europe,0,0
2020-02-08,Croatia,HR,0,0,4076246,Europe,0,0
2020-02-09,Croatia,HR,0,0,4076246,Europe,0,0
2020-02-10,Croatia,HR,0,0,4076246,Europe,0,0
2020-02-11,Croatia,HR,0,0,4076246,Europe,0,0
2020-02-12,Croatia,HR,0,0,4076246,Europe,0,0
2020-02-13,Croatia,HR,0,0,4076246,Europe,0,0
2020-02-14,Croatia,HR,0,0,4076246,Europe,0,0
2020-02-15,Croatia,HR,0,0,4076246,Europe,0,0
2020-02-16,Croatia,HR,0,0,4076246,Europe,0,0
2020-02-17,Croatia,HR,0,0,4076246,Europe,0,0
2020-02-18,Croatia,HR,0,0,4076246,Europe,0,0
2020-02-19,Croatia,HR,0,0,4076246,Europe,0,0
2020-02-20,Croatia,HR,0,0,4076246,Europe,0,0
2020-02-21,Croatia,HR,0,0,4076246,Europe,0,0
2020-02-22,Croatia,HR,0,0,4076246,Europe,0,0
2020-02-23,Croatia,HR,0,0,4076246,Europe,0,0
2020-02-24,Croatia,HR,0,0,4076246,Europe,0,0
2020-02-25,Croatia,HR,0,0,4076246,Europe,0,0
2020-02-26,Croatia,HR,1,0,4076246,Europe,1,0
2020-02-27,Croatia,HR,1,0,4076246,Europe,2,0
2020-02-28,Croatia,HR,1,0,4076246,Europe,3,0
2020-02-29,Croatia,HR,2,0,4076246,Europe,5,0
2020-03-01,Croatia,HR,0,0,4076246,Europe,5,0
2020-03-02,Croatia,HR,2,0,4076246,Europe,7,0
2020-03-03,Croatia,HR,1,0,4076246,Europe,8,0
2020-03-04,Croatia,HR,1,0,4076246,Europe,9,0
2020-03-06,Croatia,HR,1,0,4076246,Europe,10,0
2020-03-07,Croatia,HR,1,0,4076246,Europe,11,0
2020-03-08,Croatia,HR,1,0,4076246,Europe,12,0
2020-03-11,Croatia,HR,1,0,4076246,Europe,13,0
2020-03-12,Croatia,HR,3,0,4076246,Europe,16,0
2020-03-13,Croatia,HR,9,0,4076246,Europe,25,0
2020-03-14,Croatia,HR,6,0,4076246,Europe,31,0
2020-03-15,Croatia,HR,6,0,4076246,Europe,37,0
2020-03-16,Croatia,HR,11,0,4076246,Europe,48,0
2020-03-17,Croatia,HR,8,0,4076246,Europe,56,0
2020-03-18,Croatia,HR,13,0,4076246,Europe,69,0
2020-03-19,Croatia,HR,12,0,4076246,Europe,81,0
2020-03-20,Croatia,HR,23,0,4076246,Europe,104,0
2020-03-21,Croatia,HR,22,0,4076246,Europe,126,0
2020-03-22,Croatia,HR,80,0,4076246,Europe,206,0
2020-03-23,Croatia,HR,29,0,4076246,Europe,235,0
2020-03-24,Croatia,HR,71,0,4076246,Europe,306,0
2020-03-25,Croatia,HR,76,1,4076246,Europe,382,1
2020-03-26,Croatia,HR,36,0,4076246,Europe,418,1
2020-03-27,Croatia,HR,77,1,4076246,Europe,495,2
2020-03-28,Croatia,HR,91,1,4076246,Europe,586,3
2020-03-29,Croatia,HR,71,2,4076246,Europe,657,5
2020-03-30,Croatia,HR,56,1,4076246,Europe,713,6
2020-03-31,Croatia,HR,77,0,4076246,Europe,790,6
2020-04-01,Croatia,HR,77,0,4076246,Europe,867,6
2020-04-02,Croatia,HR,96,0,4076246,Europe,963,6
2020-04-03,Croatia,HR,48,1,4076246,Europe,1011,7
2020-04-04,Croatia,HR,68,1,4076246,Europe,1079,8
2020-04-05,Croatia,HR,47,4,4076246,Europe,1126,12
2020-04-06,Croatia,HR,56,3,4076246,Europe,1182,15
2020-04-07,Croatia,HR,40,1,4076246,Europe,1222,16
2020-04-08,Croatia,HR,60,2,4076246,Europe,1282,18
2020-04-09,Croatia,HR,61,1,4076246,Europe,1343,19
2020-04-10,Croatia,HR,64,1,4076246,Europe,1407,20
2020-04-11,Croatia,HR,88,1,4076246,Europe,1495,21
2020-04-12,Croatia,HR,39,0,4076246,Europe,1534,21
2020-04-13,Croatia,HR,66,2,4076246,Europe,1600,23
2020-04-14,Croatia,HR,50,2,4076246,Europe,1650,25
2020-04-15,Croatia,HR,54,6,4076246,Europe,1704,31
2020-04-16,Croatia,HR,37,3,4076246,Europe,1741,34
2020-04-17,Croatia,HR,50,1,4076246,Europe,1791,35
2020-04-18,Croatia,HR,23,1,4076246,Europe,1814,36
2020-04-19,Croatia,HR,18,3,4076246,Europe,1832,39
2020-04-20,Croatia,HR,39,8,4076246,Europe,1871,47
2020-04-21,Croatia,HR,10,0,4076246,Europe,1881,47
2020-04-22,Croatia,HR,27,1,4076246,Europe,1908,48
2020-04-23,Croatia,HR,42,0,4076246,Europe,1950,48
2020-04-24,Croatia,HR,31,2,4076246,Europe,1981,50
2020-04-25,Croatia,HR,28,1,4076246,Europe,2009,51
2020-04-26,Croatia,HR,7,3,4076246,Europe,2016,54
2020-04-27,Croatia,HR,14,1,4076246,Europe,2030,55
2020-04-28,Croatia,HR,9,4,4076246,Europe,2039,59
2020-04-29,Croatia,HR,8,4,4076246,Europe,2047,63
2020-04-30,Croatia,HR,15,4,4076246,Europe,2062,67
2020-05-01,Croatia,HR,14,2,4076246,Europe,2076,69
2020-05-02,Croatia,HR,9,6,4076246,Europe,2085,75
2020-05-03,Croatia,HR,3,2,4076246,Europe,2088,77
2020-05-04,Croatia,HR,8,2,4076246,Europe,2096,79
2020-05-05,Croatia,HR,5,1,4076246,Europe,2101,80
2020-05-06,Croatia,HR,11,3,4076246,Europe,2112,83
2020-05-07,Croatia,HR,7,2,4076246,Europe,2119,85
2020-05-08,Croatia,HR,6,1,4076246,Europe,2125,86
2020-05-09,Croatia,HR,36,0,4076246,Europe,2161,86
2020-05-10,Croatia,HR,15,1,4076246,Europe,2176,87
2020-05-11,Croatia,HR,11,3,4076246,Europe,2187,90
2020-05-12,Croatia,HR,9,1,4076246,Europe,2196,91
2020-05-13,Croatia,HR,11,0,4076246,Europe,2207,91
2020-05-14,Croatia,HR,6,3,4076246,Europe,2213,94
2020-05-15,Croatia,HR,8,0,4076246,Europe,2221,94
2020-05-16,Croatia,HR,1,1,4076246,Europe,2222,95
2020-05-17,Croatia,HR,2,0,4076246,Europe,2224,95
2020-05-18,Croatia,HR,2,0,4076246,Europe,2226,95
2020-05-19,Croatia,HR,2,0,4076246,Europe,2228,95
2020-05-20,Croatia,HR,4,1,4076246,Europe,2232,96
2020-05-21,Croatia,HR,2,0,4076246,Europe,2234,96
2020-05-22,Croatia,HR,3,1,4076246,Europe,2237,97
2020-05-23,Croatia,HR,6,2,4076246,Europe,2243,99
2020-05-24,Croatia,HR,0,0,4076246,Europe,2243,99
2020-05-25,Croatia,HR,1,0,4076246,Europe,2244,99
2020-05-26,Croatia,HR,0,1,4076246,Europe,2244,100
2020-05-27,Croatia,HR,0,1,4076246,Europe,2244,101
2020-05-28,Croatia,HR,0,0,4076246,Europe,2244,101
2020-05-29,Croatia,HR,1,1,4076246,Europe,2245,102
2020-05-30,Croatia,HR,0,1,4076246,Europe,2245,103
2020-05-31,Croatia,HR,1,0,4076246,Europe,2246,103
2020-06-01,Croatia,HR,0,0,4076246,Europe,2246,103
2020-06-02,Croatia,HR,0,0,4076246,Europe,2246,103
2020-06-03,Croatia,HR,0,0,4076246,Europe,2246,103
2020-06-04,Croatia,HR,0,0,4076246,Europe,2246,103
2020-06-05,Croatia,HR,1,0,4076246,Europe,2247,103
2020-06-06,Croatia,HR,0,0,4076246,Europe,2247,103
2020-06-07,Croatia,HR,0,1,4076246,Europe,2247,104
2020-06-08,Croatia,HR,0,0,4076246,Europe,2247,104
2020-06-09,Croatia,HR,0,0,4076246,Europe,2247,104
2020-06-10,Croatia,HR,0,2,4076246,Europe,2247,106
2020-06-11,Croatia,HR,2,0,4076246,Europe,2249,106
2020-06-12,Croatia,HR,0,0,4076246,Europe,2249,106
2020-06-13,Croatia,HR,0,1,4076246,Europe,2249,107
2020-06-14,Croatia,HR,2,0,4076246,Europe,2251,107
2020-06-15,Croatia,HR,1,0,4076246,Europe,2252,107
2020-06-16,Croatia,HR,2,0,4076246,Europe,2254,107
2020-06-17,Croatia,HR,1,0,4076246,Europe,2255,107
2020-06-18,Croatia,HR,3,0,4076246,Europe,2258,107
2020-06-19,Croatia,HR,11,0,4076246,Europe,2269,107
2020-06-20,Croatia,HR,11,0,4076246,Europe,2280,107
2020-06-21,Croatia,HR,19,0,4076246,Europe,2299,107
2020-06-22,Croatia,HR,18,0,4076246,Europe,2317,107
2020-06-23,Croatia,HR,19,0,4076246,Europe,2336,107
2020-06-24,Croatia,HR,30,0,4076246,Europe,2366,107
2020-06-25,Croatia,HR,22,0,4076246,Europe,2388,107
2020-06-26,Croatia,HR,95,0,4076246,Europe,2483,107
2020-06-27,Croatia,HR,56,0,4076246,Europe,2539,107
2020-06-28,Croatia,HR,85,0,4076246,Europe,2624,107
2020-06-29,Croatia,HR,67,0,4076246,Europe,2691,107
2020-06-30,Croatia,HR,34,0,4076246,Europe,2725,107
2020-07-01,Croatia,HR,52,0,4076246,Europe,2777,107
2020-07-02,Croatia,HR,54,1,4076246,Europe,2831,108
2020-07-03,Croatia,HR,81,2,4076246,Europe,2912,110
2020-07-04,Croatia,HR,96,2,4076246,Europe,3008,112
2020-07-05,Croatia,HR,86,1,4076246,Europe,3094,113
2020-07-06,Croatia,HR,57,0,4076246,Europe,3151,113
2020-07-07,Croatia,HR,69,0,4076246,Europe,3220,113
2020-07-08,Croatia,HR,52,0,4076246,Europe,3272,113
2020-07-09,Croatia,HR,53,1,4076246,Europe,3325,114
2020-07-10,Croatia,HR,91,1,4076246,Europe,3416,115
2020-07-11,Croatia,HR,116,2,4076246,Europe,3532,117
2020-07-12,Croatia,HR,140,1,4076246,Europe,3672,118
2020-07-13,Croatia,HR,50,1,4076246,Europe,3722,119
2020-07-14,Croatia,HR,53,0,4076246,Europe,3775,119
2020-07-15,Croatia,HR,52,0,4076246,Europe,3827,119
2020-07-16,Croatia,HR,126,0,4076246,Europe,3953,119
2020-07-17,Croatia,HR,86,0,4076246,Europe,4039,119
2020-07-18,Croatia,HR,98,1,4076246,Europe,4137,120
2020-07-19,Croatia,HR,98,0,4076246,Europe,4235,120
2020-07-20,Croatia,HR,119,0,4076246,Europe,4354,120
2020-07-21,Croatia,HR,16,2,4076246,Europe,4370,122
2020-07-22,Croatia,HR,52,0,4076246,Europe,4422,122
2020-07-23,Croatia,HR,108,3,4076246,Europe,4530,125
2020-07-24,Croatia,HR,104,3,4076246,Europe,4634,128
2020-07-25,Croatia,HR,81,0,4076246,Europe,4715,128
2020-07-26,Croatia,HR,77,5,4076246,Europe,4792,133
2020-07-27,Croatia,HR,65,3,4076246,Europe,4857,136
2020-07-28,Croatia,HR,24,3,4076246,Europe,4881,139
2020-07-29,Croatia,HR,42,1,4076246,Europe,4923,140
2020-07-30,Croatia,HR,70,1,4076246,Europe,4993,141
2020-07-31,Croatia,HR,78,3,4076246,Europe,5071,144
2020-08-01,Croatia,HR,67,1,4076246,Europe,5138,145
2020-08-02,Croatia,HR,86,0,4076246,Europe,5224,145
2020-08-03,Croatia,HR,36,4,4076246,Europe,5260,149
2020-08-04,Croatia,HR,36,4,4076246,Europe,5296,153
2020-08-05,Croatia,HR,22,1,4076246,Europe,5318,154
2020-08-06,Croatia,HR,58,0,4076246,Europe,5376,154
2020-08-07,Croatia,HR,28,1,4076246,Europe,5404,155
2020-08-08,Croatia,HR,62,0,4076246,Europe,5466,155
2020-08-09,Croatia,HR,77,2,4076246,Europe,5543,157
2020-08-10,Croatia,HR,61,0,4076246,Europe,5604,157
2020-08-11,Croatia,HR,45,1,4076246,Europe,5649,158
2020-08-12,Croatia,HR,91,2,4076246,Europe,5740,160
2020-08-13,Croatia,HR,130,0,4076246,Europe,5870,160
2020-08-14,Croatia,HR,180,1,4076246,Europe,6050,161
2020-08-15,Croatia,HR,208,2,4076246,Europe,6258,163
2020-08-16,Croatia,HR,162,2,4076246,Europe,6420,165
2020-08-17,Croatia,HR,151,1,4076246,Europe,6571,166
2020-08-18,Croatia,HR,85,0,4076246,Europe,6656,166
2020-08-19,Croatia,HR,199,0,4076246,Europe,6855,166
2020-08-20,Croatia,HR,219,2,4076246,Europe,7074,168
2020-08-21,Croatia,HR,255,0,4076246,Europe,7329,168
2020-08-22,Croatia,HR,265,1,4076246,Europe,7594,169
2020-08-23,Croatia,HR,306,1,4076246,Europe,7900,170
2020-08-24,Croatia,HR,275,1,4076246,Europe,8175,171
2020-08-25,Croatia,HR,136,2,4076246,Europe,8311,173
2020-08-26,Croatia,HR,219,2,4076246,Europe,8530,175
2020-08-27,Croatia,HR,358,0,4076246,Europe,8888,175
2020-08-28,Croatia,HR,304,2,4076246,Europe,9192,177
2020-08-29,Croatia,HR,357,3,4076246,Europe,9549,180
2020-08-30,Croatia,HR,312,3,4076246,Europe,9861,183
2020-08-31,Croatia,HR,262,1,4076246,Europe,10123,184
2020-09-01,Croatia,HR,146,2,4076246,Europe,10269,186
2020-09-02,Croatia,HR,145,1,4076246,Europe,10414,187
2020-09-03,Croatia,HR,311,4,4076246,Europe,10725,191
2020-09-04,Croatia,HR,369,3,4076246,Europe,11094,194
2020-09-05,Croatia,HR,334,1,4076246,Europe,11428,195
2020-09-06,Croatia,HR,311,2,4076246,Europe,11739,197
2020-09-07,Croatia,HR,225,1,4076246,Europe,11964,198
2020-09-08,Croatia,HR,117,3,4076246,Europe,12081,201
2020-09-09,Croatia,HR,204,2,4076246,Europe,12285,203
2020-09-10,Croatia,HR,341,3,4076246,Europe,12626,206
2020-09-11,Croatia,HR,291,2,4076246,Europe,12917,208
2020-09-12,Croatia,HR,190,3,4076246,Europe,13107,211
2020-09-13,Croatia,HR,261,7,4076246,Europe,13368,218
2020-09-14,Croatia,HR,165,6,4076246,Europe,13533,224
2020-09-15,Croatia,HR,65,3,4076246,Europe,13598,227
2020-09-16,Croatia,HR,151,3,4076246,Europe,13749,230
2020-09-17,Croatia,HR,280,6,4076246,Europe,14029,236
2020-09-18,Croatia,HR,250,2,4076246,Europe,14279,238
2020-09-19,Croatia,HR,234,6,4076246,Europe,14513,244
2020-09-20,Croatia,HR,212,0,4076246,Europe,14725,244
2020-09-21,Croatia,HR,197,4,4076246,Europe,14922,248
2020-09-22,Croatia,HR,70,5,4076246,Europe,14992,253
2020-09-23,Croatia,HR,144,2,4076246,Europe,15136,255
2020-09-24,Croatia,HR,204,2,4076246,Europe,15340,257
2020-09-25,Croatia,HR,232,4,4076246,Europe,15572,261
2020-09-26,Croatia,HR,223,5,4076246,Europe,15795,266
2020-09-27,Croatia,HR,212,3,4076246,Europe,16007,269
2020-09-28,Croatia,HR,190,3,4076246,Europe,16197,272
2020-09-29,Croatia,HR,48,0,4076246,Europe,16245,272
2020-09-30,Croatia,HR,135,3,4076246,Europe,16380,275
2020-10-01,Croatia,HR,213,5,4076246,Europe,16593,280
2020-10-02,Croatia,HR,234,4,4076246,Europe,16827,284
2020-10-03,Croatia,HR,333,7,4076246,Europe,17160,291
2020-10-04,Croatia,HR,241,2,4076246,Europe,17401,293
2020-10-05,Croatia,HR,258,5,4076246,Europe,17659,298
2020-10-06,Croatia,HR,138,2,4076246,Europe,17797,300
2020-10-07,Croatia,HR,287,4,4076246,Europe,18084,304
2020-10-08,Croatia,HR,363,5,4076246,Europe,18447,309
2020-10-09,Croatia,HR,542,1,4076246,Europe,18989,310
2020-10-10,Croatia,HR,457,3,4076246,Europe,19446,313
2020-10-11,Croatia,HR,486,4,4076246,Europe,19932,317
2020-10-12,Croatia,HR,508,7,4076246,Europe,20440,324
2020-10-13,Croatia,HR,181,3,4076246,Europe,20621,327
2020-10-14,Croatia,HR,372,3,4076246,Europe,20993,330
2020-10-15,Croatia,HR,748,4,4076246,Europe,21741,334
2020-10-16,Croatia,HR,793,10,4076246,Europe,22534,344
2020-10-17,Croatia,HR,1131,1,4076246,Europe,23665,345
2020-10-18,Croatia,HR,1096,10,4076246,Europe,24761,355
2020-10-19,Croatia,HR,819,8,4076246,Europe,25580,363
2020-10-20,Croatia,HR,393,11,4076246,Europe,25973,374
2020-10-21,Croatia,HR,890,8,4076246,Europe,26863,382
2020-10-22,Croatia,HR,1424,11,4076246,Europe,28287,393
2020-10-23,Croatia,HR,1563,13,4076246,Europe,29850,406
2020-10-24,Croatia,HR,1867,7,4076246,Europe,31717,413
2020-10-25,Croatia,HR,2242,16,4076246,Europe,33959,429
2020-10-26,Croatia,HR,2421,8,4076246,Europe,36380,437
2020-10-27,Croatia,HR,828,15,4076246,Europe,37208,452
2020-10-28,Croatia,HR,1413,18,4076246,Europe,38621,470
2020-10-29,Croatia,HR,2378,23,4076246,Europe,40999,493
2020-10-30,Croatia,HR,2776,18,4076246,Europe,43775,511
2020-10-31,Croatia,HR,2772,20,4076246,Europe,46547,531
2020-11-01,Croatia,HR,2769,15,4076246,Europe,49316,546
2020-11-02,Croatia,HR,2179,16,4076246,Europe,51495,562
2020-11-03,Croatia,HR,1165,32,4076246,Europe,52660,594
2020-11-04,Croatia,HR,1427,34,4076246,Europe,54087,628
2020-11-05,Croatia,HR,2480,26,4076246,Europe,56567,654
2020-11-06,Croatia,HR,2848,29,4076246,Europe,59415,683
2020-11-07,Croatia,HR,2890,34,4076246,Europe,62305,717
2020-11-08,Croatia,HR,2399,35,4076246,Europe,64704,752
2020-11-09,Croatia,HR,2543,42,4076246,Europe,67247,794
2020-11-10,Croatia,HR,1529,38,4076246,Europe,68776,832
2020-11-11,Croatia,HR,1467,33,4076246,Europe,70243,865
2020-11-12,Croatia,HR,2597,28,4076246,Europe,72840,893
2020-11-13,Croatia,HR,3082,32,4076246,Europe,75922,925
2020-11-14,Croatia,HR,3056,43,4076246,Europe,78978,968
2020-11-15,Croatia,HR,2866,38,4076246,Europe,81844,1006
2020-11-16,Croatia,HR,2362,43,4076246,Europe,84206,1049
2020-11-17,Croatia,HR,1313,33,4076246,Europe,85519,1082
2020-11-18,Croatia,HR,1945,31,4076246,Europe,87464,1113
2020-11-19,Croatia,HR,3251,38,4076246,Europe,90715,1151
2020-11-20,Croatia,HR,3164,49,4076246,Europe,93879,1200
2020-11-21,Croatia,HR,2958,57,4076246,Europe,96837,1257
2020-11-22,Croatia,HR,3573,47,4076246,Europe,100410,1304
2020-11-23,Croatia,HR,3308,49,4076246,Europe,103718,1353
2020-11-24,Croatia,HR,1973,45,4076246,Europe,105691,1398
2020-11-25,Croatia,HR,2323,47,4076246,Europe,108014,1445
2020-11-26,Croatia,HR,3603,56,4076246,Europe,111617,1501
2020-11-27,Croatia,HR,4009,51,4076246,Europe,115626,1552
2020-11-28,Croatia,HR,4080,48,4076246,Europe,119706,1600
2020-11-29,Croatia,HR,3987,55,4076246,Europe,123693,1655
2020-11-30,Croatia,HR,2919,57,4076246,Europe,126612,1712
2020-12-01,Croatia,HR,1830,74,4076246,Europe,128442,1786
2020-12-02,Croatia,HR,2900,75,4076246,Europe,131342,1861
2020-12-03,Croatia,HR,3539,55,4076246,Europe,134881,1916
2020-12-04,Croatia,HR,4534,48,4076246,Europe,139415,1964
2020-12-05,Croatia,HR,3955,68,4076246,Europe,143370,2032
2020-12-06,Croatia,HR,4084,70,4076246,Europe,147454,2102
2020-12-07,Croatia,HR,2899,72,4076246,Europe,150353,2174
2020-12-08,Croatia,HR,1886,59,4076246,Europe,152239,2233
2020-12-09,Croatia,HR,2613,65,4076246,Europe,154852,2298
2020-12-10,Croatia,HR,4520,69,4076246,Europe,159372,2367
2020-12-11,Croatia,HR,4620,53,4076246,Europe,163992,2420
2020-12-12,Croatia,HR,4396,64,4076246,Europe,168388,2484
2020-12-13,Croatia,HR,4135,78,4076246,Europe,172523,2562
2020-12-14,Croatia,HR,3363,78,4076246,Europe,175886,2640
2020-03-20,Haiti,HT,2,0,11263079,America,2,0
2020-03-21,Haiti,HT,0,0,11263079,America,2,0
2020-03-22,Haiti,HT,0,0,11263079,America,2,0
2020-03-23,Haiti,HT,0,0,11263079,America,2,0
2020-03-24,Haiti,HT,3,0,11263079,America,5,0
2020-03-25,Haiti,HT,2,0,11263079,America,7,0
2020-03-26,Haiti,HT,1,0,11263079,America,8,0
2020-03-27,Haiti,HT,0,0,11263079,America,8,0
2020-03-28,Haiti,HT,0,0,11263079,America,8,0
2020-03-29,Haiti,HT,0,0,11263079,America,8,0
2020-03-30,Haiti,HT,7,0,11263079,America,15,0
2020-03-31,Haiti,HT,0,0,11263079,America,15,0
2020-04-01,Haiti,HT,0,0,11263079,America,15,0
2020-04-02,Haiti,HT,1,0,11263079,America,16,0
2020-04-03,Haiti,HT,2,0,11263079,America,18,0
2020-04-04,Haiti,HT,0,0,11263079,America,18,0
2020-04-05,Haiti,HT,3,0,11263079,America,21,0
2020-04-06,Haiti,HT,0,0,11263079,America,21,0
2020-04-07,Haiti,HT,3,1,11263079,America,24,1
2020-04-08,Haiti,HT,1,0,11263079,America,25,1
2020-04-09,Haiti,HT,2,0,11263079,America,27,1
2020-04-10,Haiti,HT,3,1,11263079,America,30,2
2020-04-11,Haiti,HT,1,0,11263079,America,31,2
2020-04-12,Haiti,HT,2,0,11263079,America,33,2
2020-04-13,Haiti,HT,0,1,11263079,America,33,3
2020-04-14,Haiti,HT,7,0,11263079,America,40,3
2020-04-15,Haiti,HT,0,0,11263079,America,40,3
2020-04-16,Haiti,HT,1,0,11263079,America,41,3
2020-04-17,Haiti,HT,2,0,11263079,America,43,3
2020-04-18,Haiti,HT,1,0,11263079,America,44,3
2020-04-19,Haiti,HT,0,0,11263079,America,44,3
2020-04-20,Haiti,HT,3,0,11263079,America,47,3
2020-04-21,Haiti,HT,10,0,11263079,America,57,3
2020-04-22,Haiti,HT,1,1,11263079,America,58,4
2020-04-23,Haiti,HT,4,0,11263079,America,62,4
2020-04-24,Haiti,HT,10,1,11263079,America,72,5
2020-04-25,Haiti,HT,0,0,11263079,America,72,5
2020-04-26,Haiti,HT,0,1,11263079,America,72,6
2020-04-27,Haiti,HT,0,0,11263079,America,72,6
2020-04-28,Haiti,HT,4,0,11263079,America,76,6
2020-04-29,Haiti,HT,0,0,11263079,America,76,6
2020-04-30,Haiti,HT,0,0,11263079,America,76,6
2020-05-01,Haiti,HT,5,2,11263079,America,81,8
2020-05-02,Haiti,HT,4,0,11263079,America,85,8
2020-05-03,Haiti,HT,0,0,11263079,America,85,8
2020-05-04,Haiti,HT,0,0,11263079,America,85,8
2020-05-05,Haiti,HT,15,3,11263079,America,100,11
2020-05-06,Haiti,HT,1,1,11263079,America,101,12
2020-05-07,Haiti,HT,7,0,11263079,America,108,12
2020-05-08,Haiti,HT,21,0,11263079,America,129,12
2020-05-09,Haiti,HT,17,0,11263079,America,146,12
2020-05-10,Haiti,HT,5,0,11263079,America,151,12
2020-05-11,Haiti,HT,31,3,11263079,America,182,15
2020-05-12,Haiti,HT,27,1,11263079,America,209,16
2020-05-13,Haiti,HT,10,2,11263079,America,219,18
2020-05-14,Haiti,HT,15,0,11263079,America,234,18
2020-05-15,Haiti,HT,39,2,11263079,America,273,20
2020-05-16,Haiti,HT,37,0,11263079,America,310,20
2020-05-17,Haiti,HT,48,0,11263079,America,358,20
2020-05-18,Haiti,HT,98,0,11263079,America,456,20
2020-05-19,Haiti,HT,77,1,11263079,America,533,21
2020-05-20,Haiti,HT,63,1,11263079,America,596,22
2020-05-21,Haiti,HT,0,0,11263079,America,596,22
2020-05-22,Haiti,HT,138,3,11263079,America,734,25
2020-05-23,Haiti,HT,78,0,11263079,America,812,25
2020-05-24,Haiti,HT,53,1,11263079,America,865,26
2020-05-25,Haiti,HT,93,1,11263079,America,958,27
2020-05-26,Haiti,HT,105,4,11263079,America,1063,31
2020-05-27,Haiti,HT,111,2,11263079,America,1174,33
2020-05-28,Haiti,HT,146,1,11263079,America,1320,34
2020-05-29,Haiti,HT,123,1,11263079,America,1443,35
2020-05-30,Haiti,HT,141,0,11263079,America,1584,35
2020-05-31,Haiti,HT,281,6,11263079,America,1865,41
2020-06-01,Haiti,HT,259,3,11263079,America,2124,44
2020-06-02,Haiti,HT,102,1,11263079,America,2226,45
2020-06-03,Haiti,HT,281,3,11263079,America,2507,48
2020-06-04,Haiti,HT,133,2,11263079,America,2640,50
2020-06-05,Haiti,HT,0,0,11263079,America,2640,50
2020-06-06,Haiti,HT,284,0,11263079,America,2924,50
2020-06-07,Haiti,HT,148,0,11263079,America,3072,50
2020-06-08,Haiti,HT,262,1,11263079,America,3334,51
2020-06-09,Haiti,HT,204,3,11263079,America,3538,54
2020-06-10,Haiti,HT,124,2,11263079,America,3662,56
2020-06-11,Haiti,HT,134,2,11263079,America,3796,58
2020-06-12,Haiti,HT,145,6,11263079,America,3941,64
2020-06-13,Haiti,HT,0,0,11263079,America,3941,64
2020-06-14,Haiti,HT,224,6,11263079,America,4165,70
2020-06-15,Haiti,HT,144,3,11263079,America,4309,73
2020-06-16,Haiti,HT,132,3,11263079,America,4441,76
2020-06-17,Haiti,HT,106,4,11263079,America,4547,80
2020-06-18,Haiti,HT,141,2,11263079,America,4688,82
2020-06-19,Haiti,HT,228,2,11263079,America,4916,84
2020-06-20,Haiti,HT,64,3,11263079,America,4980,87
2020-06-21,Haiti,HT,97,1,11263079,America,5077,88
2020-06-22,Haiti,HT,134,0,11263079,America,5211,88
2020-06-23,Haiti,HT,0,0,11263079,America,5211,88
2020-06-24,Haiti,HT,113,1,11263079,America,5324,89
2020-06-25,Haiti,HT,105,3,11263079,America,5429,92
2020-06-26,Haiti,HT,114,4,11263079,America,5543,96
2020-06-27,Haiti,HT,179,2,11263079,America,5722,98
2020-06-28,Haiti,HT,55,2,11263079,America,5777,100
2020-06-29,Haiti,HT,70,4,11263079,America,5847,104
2020-06-30,Haiti,HT,86,1,11263079,America,5933,105
2020-07-01,Haiti,HT,42,0,11263079,America,5975,105
2020-07-02,Haiti,HT,65,2,11263079,America,6040,107
2020-07-03,Haiti,HT,61,3,11263079,America,6101,110
2020-07-04,Haiti,HT,129,0,11263079,America,6230,110
2020-07-05,Haiti,HT,64,3,11263079,America,6294,113
2020-07-06,Haiti,HT,39,0,11263079,America,6333,113
2020-07-07,Haiti,HT,38,0,11263079,America,6371,113
2020-07-08,Haiti,HT,61,4,11263079,America,6432,117
2020-07-09,Haiti,HT,54,6,11263079,America,6486,123
2020-07-10,Haiti,HT,0,0,11263079,America,6486,123
2020-07-11,Haiti,HT,131,12,11263079,America,6617,135
2020-07-12,Haiti,HT,73,4,11263079,America,6690,139
2020-07-13,Haiti,HT,37,0,11263079,America,6727,139
2020-07-14,Haiti,HT,0,2,11263079,America,6727,141
2020-07-15,Haiti,HT,104,2,11263079,America,6831,143
2020-07-16,Haiti,HT,71,2,11263079,America,6902,145
2020-07-17,Haiti,HT,46,0,11263079,America,6948,145
2020-07-18,Haiti,HT,27,1,11263079,America,6975,146
2020-07-19,Haiti,HT,78,0,11263079,America,7053,146
2020-07-20,Haiti,HT,0,0,11263079,America,7053,146
2020-07-21,Haiti,HT,10,0,11263079,America,7063,146
2020-07-22,Haiti,HT,83,8,11263079,America,7146,154
2020-07-23,Haiti,HT,21,0,11263079,America,7167,154
2020-07-24,Haiti,HT,30,0,11263079,America,7197,154
2020-07-25,Haiti,HT,63,2,11263079,America,7260,156
2020-07-26,Haiti,HT,37,0,11263079,America,7297,156
2020-07-27,Haiti,HT,18,1,11263079,America,7315,157
2020-07-28,Haiti,HT,25,1,11263079,America,7340,158
2020-07-29,Haiti,HT,31,0,11263079,America,7371,158
2020-07-30,Haiti,HT,7,1,11263079,America,7378,159
2020-07-31,Haiti,HT,34,2,11263079,America,7412,161
2020-08-01,Haiti,HT,12,0,11263079,America,7424,161
2020-08-02,Haiti,HT,44,4,11263079,America,7468,165
2020-08-03,Haiti,HT,8,0,11263079,America,7476,165
2020-08-04,Haiti,HT,35,1,11263079,America,7511,166
2020-08-05,Haiti,HT,21,5,11263079,America,7532,171
2020-08-06,Haiti,HT,12,0,11263079,America,7544,171
2020-08-07,Haiti,HT,38,0,11263079,America,7582,171
2020-08-08,Haiti,HT,17,6,11263079,America,7599,177
2020-08-09,Haiti,HT,12,5,11263079,America,7611,182
2020-08-10,Haiti,HT,23,1,11263079,America,7634,183
2020-08-11,Haiti,HT,15,0,11263079,America,7649,183
2020-08-12,Haiti,HT,0,0,11263079,America,7649,183
2020-08-13,Haiti,HT,94,4,11263079,America,7743,187
2020-08-14,Haiti,HT,67,5,11263079,America,7810,192
2020-08-15,Haiti,HT,21,4,11263079,America,7831,196
2020-08-16,Haiti,HT,0,0,11263079,America,7831,196
2020-08-17,Haiti,HT,48,0,11263079,America,7879,196
2020-08-18,Haiti,HT,18,0,11263079,America,7897,196
2020-08-19,Haiti,HT,24,0,11263079,America,7921,196
2020-08-20,Haiti,HT,28,0,11263079,America,7949,196
2020-08-21,Haiti,HT,48,0,11263079,America,7997,196
2020-08-22,Haiti,HT,19,0,11263079,America,8016,196
2020-08-23,Haiti,HT,34,0,11263079,America,8050,196
2020-08-24,Haiti,HT,32,0,11263079,America,8082,196
2020-08-25,Haiti,HT,28,0,11263079,America,8110,196
2020-08-26,Haiti,HT,2,0,11263079,America,8112,196
2020-08-27,Haiti,HT,39,4,11263079,America,8151,200
2020-08-28,Haiti,HT,0,0,11263079,America,8151,200
2020-08-29,Haiti,HT,10,1,11263079,America,8161,201
2020-08-30,Haiti,HT,48,0,11263079,America,8209,201
2020-08-31,Haiti,HT,0,0,11263079,America,8209,201
2020-09-01,Haiti,HT,15,0,11263079,America,8224,201
2020-09-02,Haiti,HT,34,5,11263079,America,8258,206
2020-09-03,Haiti,HT,0,0,11263079,America,8258,206
2020-09-04,Haiti,HT,43,4,11263079,America,8301,210
2020-09-05,Haiti,HT,25,2,11263079,America,8326,212
2020-09-06,Haiti,HT,10,0,11263079,America,8336,212
2020-09-07,Haiti,HT,24,2,11263079,America,8360,214
2020-09-08,Haiti,HT,2,0,11263079,America,8362,214
2020-09-09,Haiti,HT,14,0,11263079,America,8376,214
2020-09-10,Haiti,HT,8,0,11263079,America,8384,214
2020-09-11,Haiti,HT,45,1,11263079,America,8429,215
2020-09-12,Haiti,HT,28,1,11263079,America,8457,216
2020-09-13,Haiti,HT,21,3,11263079,America,8478,219
2020-09-14,Haiti,HT,15,0,11263079,America,8493,219
2020-09-15,Haiti,HT,6,0,11263079,America,8499,219
2020-09-16,Haiti,HT,31,1,11263079,America,8530,220
2020-09-17,Haiti,HT,11,0,11263079,America,8541,220
2020-09-18,Haiti,HT,15,0,11263079,America,8556,220
2020-09-19,Haiti,HT,44,1,11263079,America,8600,221
2020-09-20,Haiti,HT,15,0,11263079,America,8615,221
2020-09-21,Haiti,HT,4,0,11263079,America,8619,221
2020-09-22,Haiti,HT,5,0,11263079,America,8624,221
2020-09-23,Haiti,HT,9,2,11263079,America,8633,223
2020-09-24,Haiti,HT,13,2,11263079,America,8646,225
2020-09-25,Haiti,HT,0,0,11263079,America,8646,225
2020-09-26,Haiti,HT,38,2,11263079,America,8684,227
2020-09-27,Haiti,HT,39,0,11263079,America,8723,227
2020-09-28,Haiti,HT,0,0,11263079,America,8723,227
2020-09-29,Haiti,HT,17,0,11263079,America,8740,227
2020-09-30,Haiti,HT,7,2,11263079,America,8747,229
2020-10-01,Haiti,HT,19,0,11263079,America,8766,229
2020-10-02,Haiti,HT,0,0,11263079,America,8766,229
2020-10-03,Haiti,HT,26,0,11263079,America,8792,229
2020-10-04,Haiti,HT,19,0,11263079,America,8811,229
2020-10-05,Haiti,HT,8,0,11263079,America,8819,229
2020-10-06,Haiti,HT,0,0,11263079,America,8819,229
2020-10-07,Haiti,HT,19,0,11263079,America,8838,229
2020-10-08,Haiti,HT,0,0,11263079,America,8838,229
2020-10-09,Haiti,HT,16,1,11263079,America,8854,230
2020-10-10,Haiti,HT,0,0,11263079,America,8854,230
2020-10-11,Haiti,HT,6,0,11263079,America,8860,230
2020-10-12,Haiti,HT,22,0,11263079,America,8882,230
2020-10-13,Haiti,HT,0,0,11263079,America,8882,230
2020-10-14,Haiti,HT,5,0,11263079,America,8887,230
2020-10-15,Haiti,HT,21,1,11263079,America,8908,231
2020-10-16,Haiti,HT,17,0,11263079,America,8925,231
2020-10-17,Haiti,HT,0,0,11263079,America,8925,231
2020-10-18,Haiti,HT,0,0,11263079,America,8925,231
2020-10-19,Haiti,HT,0,0,11263079,America,8925,231
2020-10-20,Haiti,HT,51,0,11263079,America,8976,231
2020-10-21,Haiti,HT,0,0,11263079,America,8976,231
2020-10-22,Haiti,HT,3,0,11263079,America,8979,231
2020-10-23,Haiti,HT,0,0,11263079,America,8979,231
2020-10-24,Haiti,HT,36,0,11263079,America,9015,231
2020-10-25,Haiti,HT,0,0,11263079,America,9015,231
2020-10-26,Haiti,HT,11,1,11263079,America,9026,232
2020-10-27,Haiti,HT,0,0,11263079,America,9026,232
2020-10-28,Haiti,HT,0,0,11263079,America,9026,232
2020-10-29,Haiti,HT,20,0,11263079,America,9046,232
2020-10-30,Haiti,HT,8,0,11263079,America,9054,232
2020-10-31,Haiti,HT,0,0,11263079,America,9054,232
2020-11-01,Haiti,HT,0,0,11263079,America,9054,232
2020-11-02,Haiti,HT,0,0,11263079,America,9054,232
2020-11-03,Haiti,HT,0,0,11263079,America,9054,232
2020-11-04,Haiti,HT,46,0,11263079,America,9100,232
2020-11-05,Haiti,HT,0,0,11263079,America,9100,232
2020-11-06,Haiti,HT,9,0,11263079,America,9109,232
2020-11-07,Haiti,HT,18,0,11263079,America,9127,232
2020-11-08,Haiti,HT,0,0,11263079,America,9127,232
2020-11-09,Haiti,HT,0,0,11263079,America,9127,232
2020-11-10,Haiti,HT,10,0,11263079,America,9137,232
2020-11-11,Haiti,HT,5,0,11263079,America,9142,232
2020-11-12,Haiti,HT,10,0,11263079,America,9152,232
2020-11-13,Haiti,HT,0,0,11263079,America,9152,232
2020-11-14,Haiti,HT,16,0,11263079,America,9168,232
2020-11-15,Haiti,HT,0,0,11263079,America,9168,232
2020-11-16,Haiti,HT,11,0,11263079,America,9179,232
2020-11-17,Haiti,HT,10,0,11263079,America,9189,232
2020-11-18,Haiti,HT,2,0,11263079,America,9191,232
2020-11-19,Haiti,HT,17,0,11263079,America,9208,232
2020-11-20,Haiti,HT,3,0,11263079,America,9211,232
2020-11-21,Haiti,HT,3,0,11263079,America,9214,232
2020-11-22,Haiti,HT,0,0,11263079,America,9214,232
2020-11-23,Haiti,HT,0,0,11263079,America,9214,232
2020-11-24,Haiti,HT,10,0,11263079,America,9224,232
2020-11-25,Haiti,HT,5,0,11263079,America,9229,232
2020-11-26,Haiti,HT,19,0,11263079,America,9248,232
2020-11-27,Haiti,HT,8,0,11263079,America,9256,232
2020-11-28,Haiti,HT,8,0,11263079,America,9264,232
2020-11-29,Haiti,HT,0,0,11263079,America,9264,232
2020-11-30,Haiti,HT,0,0,11263079,America,9264,232
2020-12-01,Haiti,HT,0,0,11263079,America,9264,232
2020-12-02,Haiti,HT,32,1,11263079,America,9296,233
2020-12-03,Haiti,HT,0,0,11263079,America,9296,233
2020-12-04,Haiti,HT,17,0,11263079,America,9313,233
2020-12-05,Haiti,HT,34,0,11263079,America,9347,233
2020-12-06,Haiti,HT,23,0,11263079,America,9370,233
2020-12-07,Haiti,HT,0,0,11263079,America,9370,233
2020-12-08,Haiti,HT,19,0,11263079,America,9389,233
2020-12-09,Haiti,HT,0,0,11263079,America,9389,233
2020-12-10,Haiti,HT,10,0,11263079,America,9399,233
2020-12-11,Haiti,HT,66,0,11263079,America,9465,233
2020-12-12,Haiti,HT,26,0,11263079,America,9491,233
2020-12-13,Haiti,HT,0,0,11263079,America,9491,233
2020-12-14,Haiti,HT,74,1,11263079,America,9565,234
2020-03-05,Hungary,HU,2,0,9772756,Europe,2,0
2020-03-07,Hungary,HU,2,0,9772756,Europe,4,0
2020-03-08,Hungary,HU,3,0,9772756,Europe,7,0
2020-03-09,Hungary,HU,1,0,9772756,Europe,8,0
2020-03-10,Hungary,HU,1,0,9772756,Europe,9,0
2020-03-11,Hungary,HU,3,0,9772756,Europe,12,0
2020-03-12,Hungary,HU,1,0,9772756,Europe,13,0
2020-03-13,Hungary,HU,3,0,9772756,Europe,16,0
2020-03-14,Hungary,HU,9,0,9772756,Europe,25,0
2020-03-15,Hungary,HU,6,0,9772756,Europe,31,0
2020-03-16,Hungary,HU,8,1,9772756,Europe,39,1
2020-03-17,Hungary,HU,11,0,9772756,Europe,50,1
2020-03-18,Hungary,HU,0,0,9772756,Europe,50,1
2020-03-19,Hungary,HU,23,0,9772756,Europe,73,1
2020-03-20,Hungary,HU,12,0,9772756,Europe,85,1
2020-03-21,Hungary,HU,18,3,9772756,Europe,103,4
2020-03-22,Hungary,HU,28,0,9772756,Europe,131,4
2020-03-23,Hungary,HU,36,3,9772756,Europe,167,7
2020-03-24,Hungary,HU,20,1,9772756,Europe,187,8
2020-03-25,Hungary,HU,39,2,9772756,Europe,226,10
2020-03-26,Hungary,HU,35,0,9772756,Europe,261,10
2020-03-27,Hungary,HU,39,0,9772756,Europe,300,10
2020-03-28,Hungary,HU,43,1,9772756,Europe,343,11
2020-03-29,Hungary,HU,65,2,9772756,Europe,408,13
2020-03-30,Hungary,HU,39,2,9772756,Europe,447,15
2020-03-31,Hungary,HU,45,1,9772756,Europe,492,16
2020-04-01,Hungary,HU,33,4,9772756,Europe,525,20
2020-04-02,Hungary,HU,60,1,9772756,Europe,585,21
2020-04-03,Hungary,HU,38,5,9772756,Europe,623,26
2020-04-04,Hungary,HU,55,6,9772756,Europe,678,32
2020-04-05,Hungary,HU,55,2,9772756,Europe,733,34
2020-04-06,Hungary,HU,11,4,9772756,Europe,744,38
2020-04-07,Hungary,HU,73,9,9772756,Europe,817,47
2020-04-08,Hungary,HU,78,11,9772756,Europe,895,58
2020-04-09,Hungary,HU,85,8,9772756,Europe,980,66
2020-04-10,Hungary,HU,210,11,9772756,Europe,1190,77
2020-04-11,Hungary,HU,120,8,9772756,Europe,1310,85
2020-04-12,Hungary,HU,100,14,9772756,Europe,1410,99
2020-04-13,Hungary,HU,48,10,9772756,Europe,1458,109
2020-04-14,Hungary,HU,54,13,9772756,Europe,1512,122
2020-04-15,Hungary,HU,67,12,9772756,Europe,1579,134
2020-04-16,Hungary,HU,73,8,9772756,Europe,1652,142
2020-04-17,Hungary,HU,111,14,9772756,Europe,1763,156
2020-04-18,Hungary,HU,71,16,9772756,Europe,1834,172
2020-04-19,Hungary,HU,82,17,9772756,Europe,1916,189
2020-04-20,Hungary,HU,68,10,9772756,Europe,1984,199
2020-04-21,Hungary,HU,114,14,9772756,Europe,2098,213
2020-04-22,Hungary,HU,70,12,9772756,Europe,2168,225
2020-04-23,Hungary,HU,116,0,9772756,Europe,2284,225
2020-04-24,Hungary,HU,99,25,9772756,Europe,2383,250
2020-04-25,Hungary,HU,60,12,9772756,Europe,2443,262
2020-04-26,Hungary,HU,57,10,9772756,Europe,2500,272
2020-04-27,Hungary,HU,83,8,9772756,Europe,2583,280
2020-04-28,Hungary,HU,66,11,9772756,Europe,2649,291
2020-04-29,Hungary,HU,78,9,9772756,Europe,2727,300
2020-04-30,Hungary,HU,48,12,9772756,Europe,2775,312
2020-05-01,Hungary,HU,88,11,9772756,Europe,2863,323
2020-05-02,Hungary,HU,79,12,9772756,Europe,2942,335
2020-05-03,Hungary,HU,56,5,9772756,Europe,2998,340
2020-05-04,Hungary,HU,37,11,9772756,Europe,3035,351
2020-05-05,Hungary,HU,30,12,9772756,Europe,3065,363
2020-05-06,Hungary,HU,46,10,9772756,Europe,3111,373
2020-05-07,Hungary,HU,39,10,9772756,Europe,3150,383
2020-05-08,Hungary,HU,28,9,9772756,Europe,3178,392
2020-05-09,Hungary,HU,35,13,9772756,Europe,3213,405
2020-05-10,Hungary,HU,50,8,9772756,Europe,3263,413
2020-05-11,Hungary,HU,21,8,9772756,Europe,3284,421
2020-05-12,Hungary,HU,29,4,9772756,Europe,3313,425
2020-05-13,Hungary,HU,28,5,9772756,Europe,3341,430
2020-05-14,Hungary,HU,39,6,9772756,Europe,3380,436
2020-05-15,Hungary,HU,37,6,9772756,Europe,3417,442
2020-05-16,Hungary,HU,56,6,9772756,Europe,3473,448
2020-05-17,Hungary,HU,36,3,9772756,Europe,3509,451
2020-05-18,Hungary,HU,26,11,9772756,Europe,3535,462
2020-05-19,Hungary,HU,21,5,9772756,Europe,3556,467
2020-05-20,Hungary,HU,42,3,9772756,Europe,3598,470
2020-05-21,Hungary,HU,43,3,9772756,Europe,3641,473
2020-05-22,Hungary,HU,37,3,9772756,Europe,3678,476
2020-05-23,Hungary,HU,35,6,9772756,Europe,3713,482
2020-05-24,Hungary,HU,28,4,9772756,Europe,3741,486
2020-05-25,Hungary,HU,15,5,9772756,Europe,3756,491
2020-05-26,Hungary,HU,15,8,9772756,Europe,3771,499
2020-05-27,Hungary,HU,22,6,9772756,Europe,3793,505
2020-05-28,Hungary,HU,23,4,9772756,Europe,3816,509
2020-05-29,Hungary,HU,25,8,9772756,Europe,3841,517
2020-05-30,Hungary,HU,0,0,9772756,Europe,3841,517
2020-05-31,Hungary,HU,26,7,9772756,Europe,3867,524
2020-06-01,Hungary,HU,9,2,9772756,Europe,3876,526
2020-06-02,Hungary,HU,45,6,9772756,Europe,3921,532
2020-06-03,Hungary,HU,10,2,9772756,Europe,3931,534
2020-06-04,Hungary,HU,0,0,9772756,Europe,3931,534
2020-06-05,Hungary,HU,23,5,9772756,Europe,3954,539
2020-06-06,Hungary,HU,16,3,9772756,Europe,3970,542
2020-06-07,Hungary,HU,0,0,9772756,Europe,3970,542
2020-06-08,Hungary,HU,0,0,9772756,Europe,3970,542
2020-06-09,Hungary,HU,44,6,9772756,Europe,4014,548
2020-06-10,Hungary,HU,3,2,9772756,Europe,4017,550
2020-06-11,Hungary,HU,10,1,9772756,Europe,4027,551
2020-06-12,Hungary,HU,12,2,9772756,Europe,4039,553
2020-06-13,Hungary,HU,14,2,9772756,Europe,4053,555
2020-06-14,Hungary,HU,11,4,9772756,Europe,4064,559
2020-06-15,Hungary,HU,12,4,9772756,Europe,4076,563
2020-06-16,Hungary,HU,1,2,9772756,Europe,4077,565
2020-06-17,Hungary,HU,1,2,9772756,Europe,4078,567
2020-06-18,Hungary,HU,1,1,9772756,Europe,4079,568
2020-06-19,Hungary,HU,2,0,9772756,Europe,4081,568
2020-06-20,Hungary,HU,5,2,9772756,Europe,4086,570
2020-06-21,Hungary,HU,8,0,9772756,Europe,4094,570
2020-06-22,Hungary,HU,8,2,9772756,Europe,4102,572
2020-06-23,Hungary,HU,5,1,9772756,Europe,4107,573
2020-06-24,Hungary,HU,0,0,9772756,Europe,4107,573
2020-06-25,Hungary,HU,7,3,9772756,Europe,4114,576
2020-06-26,Hungary,HU,9,1,9772756,Europe,4123,577
2020-06-27,Hungary,HU,4,1,9772756,Europe,4127,578
2020-06-28,Hungary,HU,11,0,9772756,Europe,4138,578
2020-06-29,Hungary,HU,4,3,9772756,Europe,4142,581
2020-06-30,Hungary,HU,3,4,9772756,Europe,4145,585
2020-07-01,Hungary,HU,10,0,9772756,Europe,4155,585
2020-07-02,Hungary,HU,2,1,9772756,Europe,4157,586
2020-07-03,Hungary,HU,9,1,9772756,Europe,4166,587
2020-07-04,Hungary,HU,6,1,9772756,Europe,4172,588
2020-07-05,Hungary,HU,11,1,9772756,Europe,4183,589
2020-07-06,Hungary,HU,0,0,9772756,Europe,4183,589
2020-07-07,Hungary,HU,6,0,9772756,Europe,4189,589
2020-07-08,Hungary,HU,16,0,9772756,Europe,4205,589
2020-07-09,Hungary,HU,5,0,9772756,Europe,4210,589
2020-07-10,Hungary,HU,10,2,9772756,Europe,4220,591
2020-07-11,Hungary,HU,3,2,9772756,Europe,4223,593
2020-07-12,Hungary,HU,6,2,9772756,Europe,4229,595
2020-07-13,Hungary,HU,5,0,9772756,Europe,4234,595
2020-07-14,Hungary,HU,13,0,9772756,Europe,4247,595
2020-07-15,Hungary,HU,16,0,9772756,Europe,4263,595
2020-07-16,Hungary,HU,0,0,9772756,Europe,4263,595
2020-07-17,Hungary,HU,16,0,9772756,Europe,4279,595
2020-07-18,Hungary,HU,14,0,9772756,Europe,4293,595
2020-07-19,Hungary,HU,22,1,9772756,Europe,4315,596
2020-07-20,Hungary,HU,18,0,9772756,Europe,4333,596
2020-07-21,Hungary,HU,14,0,9772756,Europe,4347,596
2020-07-22,Hungary,HU,19,0,9772756,Europe,4366,596
2020-07-23,Hungary,HU,14,0,9772756,Europe,4380,596
2020-07-24,Hungary,HU,18,0,9772756,Europe,4398,596
2020-07-25,Hungary,HU,26,0,9772756,Europe,4424,596
2020-07-26,Hungary,HU,11,0,9772756,Europe,4435,596
2020-07-27,Hungary,HU,13,0,9772756,Europe,4448,596
2020-07-28,Hungary,HU,8,0,9772756,Europe,4456,596
2020-07-29,Hungary,HU,9,0,9772756,Europe,4465,596
2020-07-30,Hungary,HU,19,0,9772756,Europe,4484,596
2020-07-31,Hungary,HU,21,0,9772756,Europe,4505,596
2020-08-01,Hungary,HU,0,0,9772756,Europe,4505,596
2020-08-02,Hungary,HU,21,1,9772756,Europe,4526,597
2020-08-03,Hungary,HU,9,0,9772756,Europe,4535,597
2020-08-04,Hungary,HU,9,0,9772756,Europe,4544,597
2020-08-05,Hungary,HU,9,1,9772756,Europe,4553,598
2020-08-06,Hungary,HU,11,1,9772756,Europe,4564,599
2020-08-07,Hungary,HU,33,1,9772756,Europe,4597,600
2020-08-08,Hungary,HU,24,2,9772756,Europe,4621,602
2020-08-09,Hungary,HU,32,0,9772756,Europe,4653,602
2020-08-10,Hungary,HU,43,0,9772756,Europe,4696,602
2020-08-11,Hungary,HU,35,3,9772756,Europe,4731,605
2020-08-12,Hungary,HU,15,0,9772756,Europe,4746,605
2020-08-13,Hungary,HU,22,0,9772756,Europe,4768,605
2020-08-14,Hungary,HU,45,2,9772756,Europe,4813,607
2020-08-15,Hungary,HU,40,0,9772756,Europe,4853,607
2020-08-16,Hungary,HU,24,0,9772756,Europe,4877,607
2020-08-17,Hungary,HU,39,1,9772756,Europe,4916,608
2020-08-18,Hungary,HU,54,1,9772756,Europe,4970,609
2020-08-19,Hungary,HU,0,0,9772756,Europe,4970,609
2020-08-20,Hungary,HU,32,0,9772756,Europe,5002,609
2020-08-21,Hungary,HU,44,0,9772756,Europe,5046,609
2020-08-22,Hungary,HU,52,2,9772756,Europe,5098,611
2020-08-23,Hungary,HU,35,0,9772756,Europe,5133,611
2020-08-24,Hungary,HU,22,2,9772756,Europe,5155,613
2020-08-25,Hungary,HU,36,0,9772756,Europe,5191,613
2020-08-26,Hungary,HU,24,1,9772756,Europe,5215,614
2020-08-27,Hungary,HU,73,0,9772756,Europe,5288,614
2020-08-28,Hungary,HU,91,0,9772756,Europe,5379,614
2020-08-29,Hungary,HU,132,0,9772756,Europe,5511,614
2020-08-30,Hungary,HU,158,0,9772756,Europe,5669,614
2020-08-31,Hungary,HU,292,0,9772756,Europe,5961,614
2020-09-01,Hungary,HU,178,1,9772756,Europe,6139,615
2020-09-02,Hungary,HU,118,1,9772756,Europe,6257,616
2020-09-03,Hungary,HU,365,3,9772756,Europe,6622,619
2020-09-04,Hungary,HU,301,1,9772756,Europe,6923,620
2020-09-05,Hungary,HU,459,1,9772756,Europe,7382,621
2020-09-06,Hungary,HU,510,3,9772756,Europe,7892,624
2020-09-07,Hungary,HU,495,0,9772756,Europe,8387,624
2020-09-08,Hungary,HU,576,1,9772756,Europe,8963,625
2020-09-09,Hungary,HU,341,1,9772756,Europe,9304,626
2020-09-10,Hungary,HU,411,2,9772756,Europe,9715,628
2020-09-11,Hungary,HU,476,2,9772756,Europe,10191,630
2020-09-12,Hungary,HU,718,1,9772756,Europe,10909,631
2020-09-13,Hungary,HU,916,2,9772756,Europe,11825,633
2020-09-14,Hungary,HU,484,4,9772756,Europe,12309,637
2020-09-15,Hungary,HU,844,5,9772756,Europe,13153,642
2020-09-16,Hungary,HU,1307,12,9772756,Europe,14460,654
2020-09-17,Hungary,HU,710,9,9772756,Europe,15170,663
2020-09-18,Hungary,HU,941,6,9772756,Europe,16111,669
2020-09-19,Hungary,HU,809,6,9772756,Europe,16920,675
2020-09-20,Hungary,HU,1070,8,9772756,Europe,17990,683
2020-09-21,Hungary,HU,876,3,9772756,Europe,18866,686
2020-09-22,Hungary,HU,633,8,9772756,Europe,19499,694
2020-09-23,Hungary,HU,951,8,9772756,Europe,20450,702
2020-09-24,Hungary,HU,750,7,9772756,Europe,21200,709
2020-09-25,Hungary,HU,927,9,9772756,Europe,22127,718
2020-09-26,Hungary,HU,950,12,9772756,Europe,23077,730
2020-09-27,Hungary,HU,937,6,9772756,Europe,24014,736
2020-09-28,Hungary,HU,702,13,9772756,Europe,24716,749
2020-09-29,Hungary,HU,851,8,9772756,Europe,25567,757
2020-09-30,Hungary,HU,894,8,9772756,Europe,26461,765
2020-10-01,Hungary,HU,848,16,9772756,Europe,27309,781
2020-10-02,Hungary,HU,1322,17,9772756,Europe,28631,798
2020-10-03,Hungary,HU,1086,14,9772756,Europe,29717,812
2020-10-04,Hungary,HU,858,10,9772756,Europe,30575,822
2020-10-05,Hungary,HU,905,11,9772756,Europe,31480,833
2020-10-06,Hungary,HU,818,20,9772756,Europe,32298,853
2020-10-07,Hungary,HU,816,24,9772756,Europe,33114,877
2020-10-08,Hungary,HU,932,21,9772756,Europe,34046,898
2020-10-09,Hungary,HU,1176,15,9772756,Europe,35222,913
2020-10-10,Hungary,HU,1374,20,9772756,Europe,36596,933
2020-10-11,Hungary,HU,1068,21,9772756,Europe,37664,954
2020-10-12,Hungary,HU,913,14,9772756,Europe,38577,968
2020-10-13,Hungary,HU,1285,28,9772756,Europe,39862,996
2020-10-14,Hungary,HU,920,27,9772756,Europe,40782,1023
2020-10-15,Hungary,HU,950,29,9772756,Europe,41732,1052
2020-10-16,Hungary,HU,1293,33,9772756,Europe,43025,1085
2020-10-17,Hungary,HU,1791,24,9772756,Europe,44816,1109
2020-10-18,Hungary,HU,1474,33,9772756,Europe,46290,1142
2020-10-19,Hungary,HU,1478,31,9772756,Europe,47768,1173
2020-10-20,Hungary,HU,989,38,9772756,Europe,48757,1211
2020-10-21,Hungary,HU,1423,48,9772756,Europe,50180,1259
2020-10-22,Hungary,HU,2032,46,9772756,Europe,52212,1305
2020-10-23,Hungary,HU,2066,47,9772756,Europe,54278,1352
2020-10-24,Hungary,HU,1820,38,9772756,Europe,56098,1390
2020-10-25,Hungary,HU,3149,35,9772756,Europe,59247,1425
2020-10-26,Hungary,HU,2316,47,9772756,Europe,61563,1472
2020-10-27,Hungary,HU,2079,63,9772756,Europe,63642,1535
2020-10-28,Hungary,HU,2291,43,9772756,Europe,65933,1578
2020-10-29,Hungary,HU,2194,56,9772756,Europe,68127,1634
2020-10-30,Hungary,HU,3286,65,9772756,Europe,71413,1699
2020-10-31,Hungary,HU,3908,51,9772756,Europe,75321,1750
2020-11-01,Hungary,HU,3878,69,9772756,Europe,79199,1819
2020-11-02,Hungary,HU,3581,70,9772756,Europe,82780,1889
2020-11-03,Hungary,HU,3989,84,9772756,Europe,86769,1973
2020-11-04,Hungary,HU,4219,90,9772756,Europe,90988,2063
2020-11-05,Hungary,HU,3928,84,9772756,Europe,94916,2147
2020-11-06,Hungary,HU,4709,103,9772756,Europe,99625,2250
2020-11-07,Hungary,HU,5318,107,9772756,Europe,104943,2357
2020-11-08,Hungary,HU,4673,81,9772756,Europe,109616,2438
2020-11-09,Hungary,HU,5162,55,9772756,Europe,114778,2493
2020-11-10,Hungary,HU,4140,103,9772756,Europe,118918,2596
2020-11-11,Hungary,HU,3945,101,9772756,Europe,122863,2697
2020-11-12,Hungary,HU,3927,87,9772756,Europe,126790,2784
2020-11-13,Hungary,HU,5097,99,9772756,Europe,131887,2883
2020-11-14,Hungary,HU,4836,107,9772756,Europe,136723,2990
2020-11-15,Hungary,HU,4238,107,9772756,Europe,140961,3097
2020-11-16,Hungary,HU,6495,93,9772756,Europe,147456,3190
2020-11-17,Hungary,HU,5203,91,9772756,Europe,152659,3281
2020-11-18,Hungary,HU,4290,99,9772756,Europe,156949,3380
2020-11-19,Hungary,HU,4512,92,9772756,Europe,161461,3472
2020-11-20,Hungary,HU,4440,96,9772756,Europe,165901,3568
2020-11-21,Hungary,HU,4397,121,9772756,Europe,170298,3689
2020-11-22,Hungary,HU,4320,111,9772756,Europe,174618,3800
2020-11-23,Hungary,HU,3334,91,9772756,Europe,177952,3891
2020-11-24,Hungary,HU,3929,117,9772756,Europe,181881,4008
2020-11-25,Hungary,HU,3806,106,9772756,Europe,185687,4114
2020-11-26,Hungary,HU,6360,115,9772756,Europe,192047,4229
2020-11-27,Hungary,HU,6393,135,9772756,Europe,198440,4364
2020-11-28,Hungary,HU,6268,152,9772756,Europe,204708,4516
2020-11-29,Hungary,HU,6819,156,9772756,Europe,211527,4672
2020-11-30,Hungary,HU,5595,151,9772756,Europe,217122,4823
2020-12-01,Hungary,HU,3951,154,9772756,Europe,221073,4977
2020-12-02,Hungary,HU,4136,165,9772756,Europe,225209,5142
2020-12-03,Hungary,HU,6635,182,9772756,Europe,231844,5324
2020-12-04,Hungary,HU,6212,189,9772756,Europe,238056,5513
2020-12-05,Hungary,HU,5525,193,9772756,Europe,243581,5706
2020-12-06,Hungary,HU,6697,162,9772756,Europe,250278,5868
2020-12-07,Hungary,HU,3870,116,9772756,Europe,254148,5984
2020-12-08,Hungary,HU,2219,136,9772756,Europe,256367,6120
2020-12-09,Hungary,HU,3221,160,9772756,Europe,259588,6280
2020-12-10,Hungary,HU,5415,171,9772756,Europe,265003,6451
2020-12-11,Hungary,HU,6197,171,9772756,Europe,271200,6622
2020-12-12,Hungary,HU,5047,162,9772756,Europe,276247,6784
2020-12-13,Hungary,HU,4153,181,9772756,Europe,280400,6965
2020-12-14,Hungary,HU,3470,165,9772756,Europe,283870,7130
2019-12-31,Indonesia,ID,0,0,270625567,Asia,0,0
2020-01-01,Indonesia,ID,0,0,270625567,Asia,0,0
2020-01-02,Indonesia,ID,0,0,270625567,Asia,0,0
2020-01-03,Indonesia,ID,0,0,270625567,Asia,0,0
2020-01-04,Indonesia,ID,0,0,270625567,Asia,0,0
2020-01-05,Indonesia,ID,0,0,270625567,Asia,0,0
2020-01-06,Indonesia,ID,0,0,270625567,Asia,0,0
2020-01-07,Indonesia,ID,0,0,270625567,Asia,0,0
2020-01-08,Indonesia,ID,0,0,270625567,Asia,0,0
2020-01-09,Indonesia,ID,0,0,270625567,Asia,0,0
2020-01-10,Indonesia,ID,0,0,270625567,Asia,0,0
2020-01-11,Indonesia,ID,0,0,270625567,Asia,0,0
2020-01-12,Indonesia,ID,0,0,270625567,Asia,0,0
2020-01-13,Indonesia,ID,0,0,270625567,Asia,0,0
2020-01-14,Indonesia,ID,0,0,270625567,Asia,0,0
2020-01-15,Indonesia,ID,0,0,270625567,Asia,0,0
2020-01-16,Indonesia,ID,0,0,270625567,Asia,0,0
2020-01-17,Indonesia,ID,0,0,270625567,Asia,0,0
2020-01-18,Indonesia,ID,0,0,270625567,Asia,0,0
2020-01-19,Indonesia,ID,0,0,270625567,Asia,0,0
2020-01-20,Indonesia,ID,0,0,270625567,Asia,0,0
2020-01-21,Indonesia,ID,0,0,270625567,Asia,0,0
2020-01-22,Indonesia,ID,0,0,270625567,Asia,0,0
2020-01-23,Indonesia,ID,0,0,270625567,Asia,0,0
2020-01-24,Indonesia,ID,0,0,270625567,Asia,0,0
2020-01-25,Indonesia,ID,0,0,270625567,Asia,0,0
2020-01-26,Indonesia,ID,0,0,270625567,Asia,0,0
2020-01-27,Indonesia,ID,0,0,270625567,Asia,0,0
2020-01-28,Indonesia,ID,0,0,270625567,Asia,0,0
2020-01-29,Indonesia,ID,0,0,270625567,Asia,0,0
2020-01-30,Indonesia,ID,0,0,270625567,Asia,0,0
2020-01-31,Indonesia,ID,0,0,270625567,Asia,0,0
2020-02-01,Indonesia,ID,0,0,270625567,Asia,0,0
2020-02-02,Indonesia,ID,0,0,270625567,Asia,0,0
2020-02-03,Indonesia,ID,0,0,270625567,Asia,0,0
2020-02-04,Indonesia,ID,0,0,270625567,Asia,0,0
2020-02-05,Indonesia,ID,0,0,270625567,Asia,0,0
2020-02-06,Indonesia,ID,0,0,270625567,Asia,0,0
2020-02-07,Indonesia,ID,0,0,270625567,Asia,0,0
2020-02-08,Indonesia,ID,0,0,270625567,Asia,0,0
2020-02-09,Indonesia,ID,0,0,270625567,Asia,0,0
2020-02-10,Indonesia,ID,0,0,270625567,Asia,0,0
2020-02-11,Indonesia,ID,0,0,270625567,Asia,0,0
2020-02-12,Indonesia,ID,0,0,270625567,Asia,0,0
2020-02-13,Indonesia,ID,0,0,270625567,Asia,0,0
2020-02-14,Indonesia,ID,0,0,270625567,Asia,0,0
2020-02-15,Indonesia,ID,0,0,270625567,Asia,0,0
2020-02-16,Indonesia,ID,0,0,270625567,Asia,0,0
2020-02-17,Indonesia,ID,0,0,270625567,Asia,0,0
2020-02-18,Indonesia,ID,0,0,270625567,Asia,0,0
2020-02-19,Indonesia,ID,0,0,270625567,Asia,0,0
2020-02-20,Indonesia,ID,0,0,270625567,Asia,0,0
2020-02-21,Indonesia,ID,0,0,270625567,Asia,0,0
2020-02-22,Indonesia,ID,0,0,270625567,Asia,0,0
2020-02-23,Indonesia,ID,0,0,270625567,Asia,0,0
2020-02-24,Indonesia,ID,0,0,270625567,Asia,0,0
2020-02-25,Indonesia,ID,0,0,270625567,Asia,0,0
2020-02-26,Indonesia,ID,0,0,270625567,Asia,0,0
2020-02-27,Indonesia,ID,0,0,270625567,Asia,0,0
2020-02-28,Indonesia,ID,0,0,270625567,Asia,0,0
2020-02-29,Indonesia,ID,0,0,270625567,Asia,0,0
2020-03-01,Indonesia,ID,0,0,270625567,Asia,0,0
2020-03-02,Indonesia,ID,2,0,270625567,Asia,2,0
2020-03-07,Indonesia,ID,2,0,270625567,Asia,4,0
2020-03-09,Indonesia,ID,2,0,270625567,Asia,6,0
2020-03-11,Indonesia,ID,13,0,270625567,Asia,19,0
2020-03-12,Indonesia,ID,15,1,270625567,Asia,34,1
2020-03-14,Indonesia,ID,35,3,270625567,Asia,69,4
2020-03-15,Indonesia,ID,27,0,270625567,Asia,96,4
2020-03-16,Indonesia,ID,21,1,270625567,Asia,117,5
2020-03-17,Indonesia,ID,17,0,270625567,Asia,134,5
2020-03-18,Indonesia,ID,38,0,270625567,Asia,172,5
2020-03-19,Indonesia,ID,0,0,270625567,Asia,172,5
2020-03-20,Indonesia,ID,55,14,270625567,Asia,227,19
2020-03-21,Indonesia,ID,82,6,270625567,Asia,309,25
2020-03-22,Indonesia,ID,141,13,270625567,Asia,450,38
2020-03-23,Indonesia,ID,64,10,270625567,Asia,514,48
2020-03-24,Indonesia,ID,65,1,270625567,Asia,579,49
2020-03-25,Indonesia,ID,107,6,270625567,Asia,686,55
2020-03-26,Indonesia,ID,104,3,270625567,Asia,790,58
2020-03-27,Indonesia,ID,103,20,270625567,Asia,893,78
2020-03-28,Indonesia,ID,153,9,270625567,Asia,1046,87
2020-03-29,Indonesia,ID,109,15,270625567,Asia,1155,102
2020-03-30,Indonesia,ID,130,12,270625567,Asia,1285,114
2020-03-31,Indonesia,ID,129,8,270625567,Asia,1414,122
2020-04-01,Indonesia,ID,114,14,270625567,Asia,1528,136
2020-04-02,Indonesia,ID,149,21,270625567,Asia,1677,157
2020-04-03,Indonesia,ID,113,13,270625567,Asia,1790,170
2020-04-04,Indonesia,ID,196,11,270625567,Asia,1986,181
2020-04-05,Indonesia,ID,106,10,270625567,Asia,2092,191
2020-04-06,Indonesia,ID,181,7,270625567,Asia,2273,198
2020-04-07,Indonesia,ID,218,11,270625567,Asia,2491,209
2020-04-08,Indonesia,ID,247,12,270625567,Asia,2738,221
2020-04-09,Indonesia,ID,218,19,270625567,Asia,2956,240
2020-04-10,Indonesia,ID,337,40,270625567,Asia,3293,280
2020-04-11,Indonesia,ID,219,26,270625567,Asia,3512,306
2020-04-12,Indonesia,ID,330,21,270625567,Asia,3842,327
2020-04-13,Indonesia,ID,399,46,270625567,Asia,4241,373
2020-04-14,Indonesia,ID,316,26,270625567,Asia,4557,399
2020-04-15,Indonesia,ID,282,60,270625567,Asia,4839,459
2020-04-16,Indonesia,ID,297,10,270625567,Asia,5136,469
2020-04-17,Indonesia,ID,380,27,270625567,Asia,5516,496
2020-04-18,Indonesia,ID,407,24,270625567,Asia,5923,520
2020-04-19,Indonesia,ID,325,15,270625567,Asia,6248,535
2020-04-20,Indonesia,ID,327,47,270625567,Asia,6575,582
2020-04-21,Indonesia,ID,185,8,270625567,Asia,6760,590
2020-04-22,Indonesia,ID,375,26,270625567,Asia,7135,616
2020-04-23,Indonesia,ID,283,19,270625567,Asia,7418,635
2020-04-24,Indonesia,ID,357,12,270625567,Asia,7775,647
2020-04-25,Indonesia,ID,436,42,270625567,Asia,8211,689
2020-04-26,Indonesia,ID,396,31,270625567,Asia,8607,720
2020-04-27,Indonesia,ID,275,23,270625567,Asia,8882,743
2020-04-28,Indonesia,ID,214,22,270625567,Asia,9096,765
2020-04-29,Indonesia,ID,415,8,270625567,Asia,9511,773
2020-04-30,Indonesia,ID,260,11,270625567,Asia,9771,784
2020-05-01,Indonesia,ID,347,8,270625567,Asia,10118,792
2020-05-02,Indonesia,ID,433,8,270625567,Asia,10551,800
2020-05-03,Indonesia,ID,292,31,270625567,Asia,10843,831
2020-05-04,Indonesia,ID,349,14,270625567,Asia,11192,845
2020-05-05,Indonesia,ID,395,19,270625567,Asia,11587,864
2020-05-06,Indonesia,ID,484,8,270625567,Asia,12071,872
2020-05-07,Indonesia,ID,367,23,270625567,Asia,12438,895
2020-05-08,Indonesia,ID,338,35,270625567,Asia,12776,930
2020-05-09,Indonesia,ID,336,13,270625567,Asia,13112,943
2020-05-10,Indonesia,ID,533,16,270625567,Asia,13645,959
2020-05-11,Indonesia,ID,387,14,270625567,Asia,14032,973
2020-05-12,Indonesia,ID,233,18,270625567,Asia,14265,991
2020-05-13,Indonesia,ID,484,16,270625567,Asia,14749,1007
2020-05-14,Indonesia,ID,689,21,270625567,Asia,15438,1028
2020-05-15,Indonesia,ID,568,15,270625567,Asia,16006,1043
2020-05-16,Indonesia,ID,490,33,270625567,Asia,16496,1076
2020-05-17,Indonesia,ID,529,13,270625567,Asia,17025,1089
2020-05-18,Indonesia,ID,489,59,270625567,Asia,17514,1148
2020-05-19,Indonesia,ID,496,43,270625567,Asia,18010,1191
2020-05-20,Indonesia,ID,486,30,270625567,Asia,18496,1221
2020-05-21,Indonesia,ID,693,21,270625567,Asia,19189,1242
2020-05-22,Indonesia,ID,973,36,270625567,Asia,20162,1278
2020-05-23,Indonesia,ID,634,48,270625567,Asia,20796,1326
2020-05-24,Indonesia,ID,949,25,270625567,Asia,21745,1351
2020-05-25,Indonesia,ID,526,21,270625567,Asia,22271,1372
2020-05-26,Indonesia,ID,479,19,270625567,Asia,22750,1391
2020-05-27,Indonesia,ID,415,27,270625567,Asia,23165,1418
2020-05-28,Indonesia,ID,686,55,270625567,Asia,23851,1473
2020-05-29,Indonesia,ID,687,23,270625567,Asia,24538,1496
2020-05-30,Indonesia,ID,678,24,270625567,Asia,25216,1520
2020-05-31,Indonesia,ID,557,53,270625567,Asia,25773,1573
2020-06-01,Indonesia,ID,700,40,270625567,Asia,26473,1613
2020-06-02,Indonesia,ID,467,28,270625567,Asia,26940,1641
2020-06-03,Indonesia,ID,609,22,270625567,Asia,27549,1663
2020-06-04,Indonesia,ID,684,35,270625567,Asia,28233,1698
2020-06-05,Indonesia,ID,585,23,270625567,Asia,28818,1721
2020-06-06,Indonesia,ID,703,49,270625567,Asia,29521,1770
2020-06-07,Indonesia,ID,993,31,270625567,Asia,30514,1801
2020-06-08,Indonesia,ID,672,50,270625567,Asia,31186,1851
2020-06-09,Indonesia,ID,847,32,270625567,Asia,32033,1883
2020-06-10,Indonesia,ID,1043,40,270625567,Asia,33076,1923
2020-06-11,Indonesia,ID,1240,36,270625567,Asia,34316,1959
2020-06-12,Indonesia,ID,979,41,270625567,Asia,35295,2000
2020-06-13,Indonesia,ID,1111,48,270625567,Asia,36406,2048
2020-06-14,Indonesia,ID,1014,43,270625567,Asia,37420,2091
2020-06-15,Indonesia,ID,857,43,270625567,Asia,38277,2134
2020-06-16,Indonesia,ID,1017,64,270625567,Asia,39294,2198
2020-06-17,Indonesia,ID,1106,33,270625567,Asia,40400,2231
2020-06-18,Indonesia,ID,1031,45,270625567,Asia,41431,2276
2020-06-19,Indonesia,ID,1331,63,270625567,Asia,42762,2339
2020-06-20,Indonesia,ID,1041,34,270625567,Asia,43803,2373
2020-06-21,Indonesia,ID,1226,56,270625567,Asia,45029,2429
2020-06-22,Indonesia,ID,862,36,270625567,Asia,45891,2465
2020-06-23,Indonesia,ID,954,35,270625567,Asia,46845,2500
2020-06-24,Indonesia,ID,1051,35,270625567,Asia,47896,2535
2020-06-25,Indonesia,ID,1113,38,270625567,Asia,49009,2573
2020-06-26,Indonesia,ID,1178,47,270625567,Asia,50187,2620
2020-06-27,Indonesia,ID,1240,63,270625567,Asia,51427,2683
2020-06-28,Indonesia,ID,1385,37,270625567,Asia,52812,2720
2020-06-29,Indonesia,ID,1198,34,270625567,Asia,54010,2754
2020-06-30,Indonesia,ID,1082,51,270625567,Asia,55092,2805
2020-07-01,Indonesia,ID,1293,71,270625567,Asia,56385,2876
2020-07-02,Indonesia,ID,1385,58,270625567,Asia,57770,2934
2020-07-03,Indonesia,ID,1624,53,270625567,Asia,59394,2987
2020-07-04,Indonesia,ID,1301,49,270625567,Asia,60695,3036
2020-07-05,Indonesia,ID,1447,53,270625567,Asia,62142,3089
2020-07-06,Indonesia,ID,1607,82,270625567,Asia,63749,3171
2020-07-07,Indonesia,ID,1209,70,270625567,Asia,64958,3241
2020-07-08,Indonesia,ID,1268,68,270625567,Asia,66226,3309
2020-07-09,Indonesia,ID,1853,50,270625567,Asia,68079,3359
2020-07-10,Indonesia,ID,2657,58,270625567,Asia,70736,3417
2020-07-11,Indonesia,ID,1611,52,270625567,Asia,72347,3469
2020-07-12,Indonesia,ID,1671,66,270625567,Asia,74018,3535
2020-07-13,Indonesia,ID,1681,71,270625567,Asia,75699,3606
2020-07-14,Indonesia,ID,1282,50,270625567,Asia,76981,3656
2020-07-15,Indonesia,ID,1591,54,270625567,Asia,78572,3710
2020-07-16,Indonesia,ID,1522,87,270625567,Asia,80094,3797
2020-07-17,Indonesia,ID,1574,76,270625567,Asia,81668,3873
2020-07-18,Indonesia,ID,1462,84,270625567,Asia,83130,3957
2020-07-19,Indonesia,ID,1752,59,270625567,Asia,84882,4016
2020-07-20,Indonesia,ID,1639,127,270625567,Asia,86521,4143
2020-07-21,Indonesia,ID,1693,96,270625567,Asia,88214,4239
2020-07-22,Indonesia,ID,1655,81,270625567,Asia,89869,4320
2020-07-23,Indonesia,ID,1882,139,270625567,Asia,91751,4459
2020-07-24,Indonesia,ID,1906,117,270625567,Asia,93657,4576
2020-07-25,Indonesia,ID,1761,89,270625567,Asia,95418,4665
2020-07-26,Indonesia,ID,1868,49,270625567,Asia,97286,4714
2020-07-27,Indonesia,ID,1492,67,270625567,Asia,98778,4781
2020-07-28,Indonesia,ID,1525,57,270625567,Asia,100303,4838
2020-07-29,Indonesia,ID,1748,63,270625567,Asia,102051,4901
2020-07-30,Indonesia,ID,2381,74,270625567,Asia,104432,4975
2020-07-31,Indonesia,ID,1904,83,270625567,Asia,106336,5058
2020-08-01,Indonesia,ID,2040,73,270625567,Asia,108376,5131
2020-08-02,Indonesia,ID,1560,62,270625567,Asia,109936,5193
2020-08-03,Indonesia,ID,1519,43,270625567,Asia,111455,5236
2020-08-04,Indonesia,ID,1679,66,270625567,Asia,113134,5302
2020-08-05,Indonesia,ID,1922,86,270625567,Asia,115056,5388
2020-08-06,Indonesia,ID,1815,64,270625567,Asia,116871,5452
2020-08-07,Indonesia,ID,1882,69,270625567,Asia,118753,5521
2020-08-08,Indonesia,ID,2473,72,270625567,Asia,121226,5593
2020-08-09,Indonesia,ID,2277,65,270625567,Asia,123503,5658
2020-08-10,Indonesia,ID,1893,65,270625567,Asia,125396,5723
2020-08-11,Indonesia,ID,1687,42,270625567,Asia,127083,5765
2020-08-12,Indonesia,ID,1693,59,270625567,Asia,128776,5824
2020-08-13,Indonesia,ID,1942,79,270625567,Asia,130718,5903
2020-08-14,Indonesia,ID,2098,65,270625567,Asia,132816,5968
2020-08-15,Indonesia,ID,2307,53,270625567,Asia,135123,6021
2020-08-16,Indonesia,ID,2345,50,270625567,Asia,137468,6071
2020-08-17,Indonesia,ID,2081,79,270625567,Asia,139549,6150
2020-08-18,Indonesia,ID,1821,57,270625567,Asia,141370,6207
2020-08-19,Indonesia,ID,1673,70,270625567,Asia,143043,6277
2020-08-20,Indonesia,ID,1902,69,270625567,Asia,144945,6346
2020-08-21,Indonesia,ID,2266,72,270625567,Asia,147211,6418
2020-08-22,Indonesia,ID,2197,82,270625567,Asia,149408,6500
2020-08-23,Indonesia,ID,2090,94,270625567,Asia,151498,6594
2020-08-24,Indonesia,ID,2037,86,270625567,Asia,153535,6680
2020-08-25,Indonesia,ID,1877,79,270625567,Asia,155412,6759
2020-08-26,Indonesia,ID,2447,99,270625567,Asia,157859,6858
2020-08-27,Indonesia,ID,2306,86,270625567,Asia,160165,6944
2020-08-28,Indonesia,ID,2719,120,270625567,Asia,162884,7064
2020-08-29,Indonesia,ID,3003,105,270625567,Asia,165887,7169
2020-08-30,Indonesia,ID,3308,92,270625567,Asia,169195,7261
2020-08-31,Indonesia,ID,2858,82,270625567,Asia,172053,7343
2020-09-01,Indonesia,ID,2743,74,270625567,Asia,174796,7417
2020-09-02,Indonesia,ID,2775,88,270625567,Asia,177571,7505
2020-09-03,Indonesia,ID,3075,111,270625567,Asia,180646,7616
2020-09-04,Indonesia,ID,3622,134,270625567,Asia,184268,7750
2020-09-05,Indonesia,ID,3269,82,270625567,Asia,187537,7832
2020-09-06,Indonesia,ID,3128,108,270625567,Asia,190665,7940
2020-09-07,Indonesia,ID,3444,85,270625567,Asia,194109,8025
2020-09-08,Indonesia,ID,2880,105,270625567,Asia,196989,8130
2020-09-09,Indonesia,ID,3046,100,270625567,Asia,200035,8230
2020-09-10,Indonesia,ID,3307,106,270625567,Asia,203342,8336
2020-09-11,Indonesia,ID,3861,120,270625567,Asia,207203,8456
2020-09-12,Indonesia,ID,3737,88,270625567,Asia,210940,8544
2020-09-13,Indonesia,ID,3817,106,270625567,Asia,214757,8650
2020-09-14,Indonesia,ID,3625,73,270625567,Asia,218382,8723
2020-09-15,Indonesia,ID,3141,118,270625567,Asia,221523,8841
2020-09-16,Indonesia,ID,3507,124,270625567,Asia,225030,8965
2020-09-17,Indonesia,ID,3963,135,270625567,Asia,228993,9100
2020-09-18,Indonesia,ID,3635,122,270625567,Asia,232628,9222
2020-09-19,Indonesia,ID,3891,114,270625567,Asia,236519,9336
2020-09-20,Indonesia,ID,4168,112,270625567,Asia,240687,9448
2020-09-21,Indonesia,ID,3989,105,270625567,Asia,244676,9553
2020-09-22,Indonesia,ID,4176,124,270625567,Asia,248852,9677
2020-09-23,Indonesia,ID,4071,160,270625567,Asia,252923,9837
2020-09-24,Indonesia,ID,4465,140,270625567,Asia,257388,9977
2020-09-25,Indonesia,ID,4634,128,270625567,Asia,262022,10105
2020-09-26,Indonesia,ID,4823,113,270625567,Asia,266845,10218
2020-09-27,Indonesia,ID,4494,90,270625567,Asia,271339,10308
2020-09-28,Indonesia,ID,3874,78,270625567,Asia,275213,10386
2020-09-29,Indonesia,ID,3509,87,270625567,Asia,278722,10473
2020-09-30,Indonesia,ID,4002,128,270625567,Asia,282724,10601
2020-10-01,Indonesia,ID,4284,139,270625567,Asia,287008,10740
2020-10-02,Indonesia,ID,4174,116,270625567,Asia,291182,10856
2020-10-03,Indonesia,ID,4317,116,270625567,Asia,295499,10972
2020-10-04,Indonesia,ID,4007,83,270625567,Asia,299506,11055
2020-10-05,Indonesia,ID,3992,96,270625567,Asia,303498,11151
2020-10-06,Indonesia,ID,3622,102,270625567,Asia,307120,11253
2020-10-07,Indonesia,ID,4056,121,270625567,Asia,311176,11374
2020-10-08,Indonesia,ID,4538,98,270625567,Asia,315714,11472
2020-10-09,Indonesia,ID,4850,108,270625567,Asia,320564,11580
2020-10-10,Indonesia,ID,4094,97,270625567,Asia,324658,11677
2020-10-11,Indonesia,ID,4294,88,270625567,Asia,328952,11765
2020-10-12,Indonesia,ID,4497,79,270625567,Asia,333449,11844
2020-10-13,Indonesia,ID,3267,91,270625567,Asia,336716,11935
2020-10-14,Indonesia,ID,3906,92,270625567,Asia,340622,12027
2020-10-15,Indonesia,ID,4127,129,270625567,Asia,344749,12156
2020-10-16,Indonesia,ID,4411,112,270625567,Asia,349160,12268
2020-10-17,Indonesia,ID,4301,79,270625567,Asia,353461,12347
2020-10-18,Indonesia,ID,4301,84,270625567,Asia,357762,12431
2020-10-19,Indonesia,ID,4105,80,270625567,Asia,361867,12511
2020-10-20,Indonesia,ID,3373,106,270625567,Asia,365240,12617
2020-10-21,Indonesia,ID,3602,117,270625567,Asia,368842,12734
2020-10-22,Indonesia,ID,4267,123,270625567,Asia,373109,12857
2020-10-23,Indonesia,ID,4432,102,270625567,Asia,377541,12959
2020-10-24,Indonesia,ID,4369,118,270625567,Asia,381910,13077
2020-10-25,Indonesia,ID,4070,128,270625567,Asia,385980,13205
2020-10-26,Indonesia,ID,3732,94,270625567,Asia,389712,13299
2020-10-27,Indonesia,ID,3222,112,270625567,Asia,392934,13411
2020-10-28,Indonesia,ID,3520,101,270625567,Asia,396454,13512
2020-10-29,Indonesia,ID,4029,100,270625567,Asia,400483,13612
2020-10-30,Indonesia,ID,3565,89,270625567,Asia,404048,13701
2020-10-31,Indonesia,ID,2897,81,270625567,Asia,406945,13782
2020-11-01,Indonesia,ID,3143,87,270625567,Asia,410088,13869
2020-11-02,Indonesia,ID,2696,74,270625567,Asia,412784,13943
2020-11-03,Indonesia,ID,2618,101,270625567,Asia,415402,14044
2020-11-04,Indonesia,ID,2973,102,270625567,Asia,418375,14146
2020-11-05,Indonesia,ID,3356,113,270625567,Asia,421731,14259
2020-11-06,Indonesia,ID,4065,89,270625567,Asia,425796,14348
2020-11-07,Indonesia,ID,3778,94,270625567,Asia,429574,14442
2020-11-08,Indonesia,ID,4262,98,270625567,Asia,433836,14540
2020-11-09,Indonesia,ID,3880,74,270625567,Asia,437716,14614
2020-11-10,Indonesia,ID,2853,75,270625567,Asia,440569,14689
2020-11-11,Indonesia,ID,3779,72,270625567,Asia,444348,14761
2020-11-12,Indonesia,ID,3770,75,270625567,Asia,448118,14836
2020-11-13,Indonesia,ID,4173,97,270625567,Asia,452291,14933
2020-11-14,Indonesia,ID,5444,104,270625567,Asia,457735,15037
2020-11-15,Indonesia,ID,5272,111,270625567,Asia,463007,15148
2020-11-16,Indonesia,ID,4106,63,270625567,Asia,467113,15211
2020-11-17,Indonesia,ID,3535,85,270625567,Asia,470648,15296
2020-11-18,Indonesia,ID,3807,97,270625567,Asia,474455,15393
2020-11-19,Indonesia,ID,4265,110,270625567,Asia,478720,15503
2020-11-20,Indonesia,ID,4798,97,270625567,Asia,483518,15600
2020-11-21,Indonesia,ID,4792,78,270625567,Asia,488310,15678
2020-11-22,Indonesia,ID,4998,96,270625567,Asia,493308,15774
2020-11-23,Indonesia,ID,4360,110,270625567,Asia,497668,15884
2020-11-24,Indonesia,ID,4442,118,270625567,Asia,502110,16002
2020-11-25,Indonesia,ID,4192,109,270625567,Asia,506302,16111
2020-11-26,Indonesia,ID,5534,114,270625567,Asia,511836,16225
2020-11-27,Indonesia,ID,4917,127,270625567,Asia,516753,16352
2020-11-28,Indonesia,ID,5828,169,270625567,Asia,522581,16521
2020-11-29,Indonesia,ID,5418,125,270625567,Asia,527999,16646
2020-11-30,Indonesia,ID,6267,169,270625567,Asia,534266,16815
2020-12-01,Indonesia,ID,4617,130,270625567,Asia,538883,16945
2020-12-02,Indonesia,ID,5092,136,270625567,Asia,543975,17081
2020-12-03,Indonesia,ID,5533,118,270625567,Asia,549508,17199
2020-12-04,Indonesia,ID,8369,156,270625567,Asia,557877,17355
2020-12-05,Indonesia,ID,5803,124,270625567,Asia,563680,17479
2020-12-06,Indonesia,ID,6027,110,270625567,Asia,569707,17589
2020-12-07,Indonesia,ID,6089,151,270625567,Asia,575796,17740
2020-12-08,Indonesia,ID,5754,127,270625567,Asia,581550,17867
2020-12-09,Indonesia,ID,5292,133,270625567,Asia,586842,18000
2020-12-10,Indonesia,ID,6058,171,270625567,Asia,592900,18171
2020-12-11,Indonesia,ID,6033,165,270625567,Asia,598933,18336
2020-12-12,Indonesia,ID,6310,175,270625567,Asia,605243,18511
2020-12-13,Indonesia,ID,6388,142,270625567,Asia,611631,18653
2020-12-14,Indonesia,ID,6189,166,270625567,Asia,617820,18819
2019-12-31,Ireland,IE,0,0,4904240,Europe,0,0
2020-01-01,Ireland,IE,0,0,4904240,Europe,0,0
2020-01-02,Ireland,IE,0,0,4904240,Europe,0,0
2020-01-03,Ireland,IE,0,0,4904240,Europe,0,0
2020-01-04,Ireland,IE,0,0,4904240,Europe,0,0
2020-01-05,Ireland,IE,0,0,4904240,Europe,0,0
2020-01-06,Ireland,IE,0,0,4904240,Europe,0,0
2020-01-07,Ireland,IE,0,0,4904240,Europe,0,0
2020-01-08,Ireland,IE,0,0,4904240,Europe,0,0
2020-01-09,Ireland,IE,0,0,4904240,Europe,0,0
2020-01-10,Ireland,IE,0,0,4904240,Europe,0,0
2020-01-11,Ireland,IE,0,0,4904240,Europe,0,0
2020-01-12,Ireland,IE,0,0,4904240,Europe,0,0
2020-01-13,Ireland,IE,0,0,4904240,Europe,0,0
2020-01-14,Ireland,IE,0,0,4904240,Europe,0,0
2020-01-15,Ireland,IE,0,0,4904240,Europe,0,0
2020-01-16,Ireland,IE,0,0,4904240,Europe,0,0
2020-01-17,Ireland,IE,0,0,4904240,Europe,0,0
2020-01-18,Ireland,IE,0,0,4904240,Europe,0,0
2020-01-19,Ireland,IE,0,0,4904240,Europe,0,0
2020-01-20,Ireland,IE,0,0,4904240,Europe,0,0
2020-01-21,Ireland,IE,0,0,4904240,Europe,0,0
2020-01-22,Ireland,IE,0,0,4904240,Europe,0,0
2020-01-23,Ireland,IE,0,0,4904240,Europe,0,0
2020-01-24,Ireland,IE,0,0,4904240,Europe,0,0
2020-01-25,Ireland,IE,0,0,4904240,Europe,0,0
2020-01-26,Ireland,IE,0,0,4904240,Europe,0,0
2020-01-27,Ireland,IE,0,0,4904240,Europe,0,0
2020-01-28,Ireland,IE,0,0,4904240,Europe,0,0
2020-01-29,Ireland,IE,0,0,4904240,Europe,0,0
2020-01-30,Ireland,IE,0,0,4904240,Europe,0,0
2020-01-31,Ireland,IE,0,0,4904240,Europe,0,0
2020-02-01,Ireland,IE,0,0,4904240,Europe,0,0
2020-02-02,Ireland,IE,0,0,4904240,Europe,0,0
2020-02-03,Ireland,IE,0,0,4904240,Europe,0,0
2020-02-04,Ireland,IE,0,0,4904240,Europe,0,0
2020-02-05,Ireland,IE,0,0,4904240,Europe,0,0
2020-02-06,Ireland,IE,0,0,4904240,Europe,0,0
2020-02-07,Ireland,IE,0,0,4904240,Europe,0,0
2020-02-08,Ireland,IE,0,0,4904240,Europe,0,0
2020-02-09,Ireland,IE,0,0,4904240,Europe,0,0
2020-02-10,Ireland,IE,0,0,4904240,Europe,0,0
2020-02-11,Ireland,IE,0,0,4904240,Europe,0,0
2020-02-12,Ireland,IE,0,0,4904240,Europe,0,0
2020-02-13,Ireland,IE,0,0,4904240,Europe,0,0
2020-02-14,Ireland,IE,0,0,4904240,Europe,0,0
2020-02-15,Ireland,IE,0,0,4904240,Europe,0,0
2020-02-16,Ireland,IE,0,0,4904240,Europe,0,0
2020-02-17,Ireland,IE,0,0,4904240,Europe,0,0
2020-02-18,Ireland,IE,0,0,4904240,Europe,0,0
2020-02-19,Ireland,IE,0,0,4904240,Europe,0,0
2020-02-20,Ireland,IE,0,0,4904240,Europe,0,0
2020-02-21,Ireland,IE,0,0,4904240,Europe,0,0
2020-02-22,Ireland,IE,0,0,4904240,Europe,0,0
2020-02-23,Ireland,IE,0,0,4904240,Europe,0,0
2020-02-24,Ireland,IE,0,0,4904240,Europe,0,0
2020-02-25,Ireland,IE,0,0,4904240,Europe,0,0
2020-02-26,Ireland,IE,0,0,4904240,Europe,0,0
2020-02-27,Ireland,IE,0,0,4904240,Europe,0,0
2020-02-28,Ireland,IE,0,0,4904240,Europe,0,0
2020-02-29,Ireland,IE,0,0,4904240,Europe,0,0
2020-03-01,Ireland,IE,1,0,4904240,Europe,1,0
2020-03-02,Ireland,IE,0,0,4904240,Europe,1,0
2020-03-04,Ireland,IE,1,0,4904240,Europe,2,0
2020-03-05,Ireland,IE,4,0,4904240,Europe,6,0
2020-03-06,Ireland,IE,7,0,4904240,Europe,13,0
2020-03-07,Ireland,IE,5,0,4904240,Europe,18,0
2020-03-08,Ireland,IE,1,0,4904240,Europe,19,0
2020-03-09,Ireland,IE,2,0,4904240,Europe,21,0
2020-03-11,Ireland,IE,14,0,4904240,Europe,35,0
2020-03-12,Ireland,IE,8,1,4904240,Europe,43,1
2020-03-13,Ireland,IE,27,0,4904240,Europe,70,1
2020-03-14,Ireland,IE,21,0,4904240,Europe,91,1
2020-03-15,Ireland,IE,38,1,4904240,Europe,129,2
2020-03-16,Ireland,IE,40,0,4904240,Europe,169,2
2020-03-17,Ireland,IE,54,0,4904240,Europe,223,2
2020-03-18,Ireland,IE,69,0,4904240,Europe,292,2
2020-03-19,Ireland,IE,74,0,4904240,Europe,366,2
2020-03-20,Ireland,IE,191,1,4904240,Europe,557,3
2020-03-21,Ireland,IE,126,0,4904240,Europe,683,3
2020-03-22,Ireland,IE,102,0,4904240,Europe,785,3
2020-03-23,Ireland,IE,121,1,4904240,Europe,906,4
2020-03-24,Ireland,IE,219,2,4904240,Europe,1125,6
2020-03-25,Ireland,IE,204,1,4904240,Europe,1329,7
2020-03-26,Ireland,IE,235,2,4904240,Europe,1564,9
2020-03-27,Ireland,IE,255,10,4904240,Europe,1819,19
2020-03-28,Ireland,IE,302,3,4904240,Europe,2121,22
2020-03-29,Ireland,IE,294,14,4904240,Europe,2415,36
2020-03-30,Ireland,IE,200,10,4904240,Europe,2615,46
2020-03-31,Ireland,IE,295,8,4904240,Europe,2910,54
2020-04-01,Ireland,IE,325,17,4904240,Europe,3235,71
2020-04-02,Ireland,IE,212,14,4904240,Europe,3447,85
2020-04-03,Ireland,IE,402,13,4904240,Europe,3849,98
2020-04-04,Ireland,IE,424,22,4904240,Europe,4273,120
2020-04-05,Ireland,IE,331,17,4904240,Europe,4604,137
2020-04-06,Ireland,IE,507,21,4904240,Europe,5111,158
2020-04-07,Ireland,IE,253,16,4904240,Europe,5364,174
2020-04-08,Ireland,IE,345,36,4904240,Europe,5709,210
2020-04-09,Ireland,IE,515,25,4904240,Europe,6224,235
2020-04-10,Ireland,IE,1169,28,4904240,Europe,7393,263
2020-04-11,Ireland,IE,696,24,4904240,Europe,8089,287
2020-04-12,Ireland,IE,839,33,4904240,Europe,8928,320
2020-04-13,Ireland,IE,727,14,4904240,Europe,9655,334
2020-04-14,Ireland,IE,992,31,4904240,Europe,10647,365
2020-04-15,Ireland,IE,832,41,4904240,Europe,11479,406
2020-04-16,Ireland,IE,1068,38,4904240,Europe,12547,444
2020-04-17,Ireland,IE,724,42,4904240,Europe,13271,486
2020-04-18,Ireland,IE,709,44,4904240,Europe,13980,530
2020-04-19,Ireland,IE,778,41,4904240,Europe,14758,571
2020-04-20,Ireland,IE,493,39,4904240,Europe,15251,610
2020-04-21,Ireland,IE,401,77,4904240,Europe,15652,687
2020-04-22,Ireland,IE,388,43,4904240,Europe,16040,730
2020-04-23,Ireland,IE,631,39,4904240,Europe,16671,769
2020-04-24,Ireland,IE,936,25,4904240,Europe,17607,794
2020-04-25,Ireland,IE,577,35,4904240,Europe,18184,829
2020-04-26,Ireland,IE,377,234,4904240,Europe,18561,1063
2020-04-27,Ireland,IE,701,24,4904240,Europe,19262,1087
2020-04-28,Ireland,IE,386,15,4904240,Europe,19648,1102
2020-04-29,Ireland,IE,229,57,4904240,Europe,19877,1159
2020-04-30,Ireland,IE,376,31,4904240,Europe,20253,1190
2020-05-01,Ireland,IE,359,42,4904240,Europe,20612,1232
2020-05-02,Ireland,IE,221,33,4904240,Europe,20833,1265
2020-05-03,Ireland,IE,343,0,4904240,Europe,21176,1265
2020-05-04,Ireland,IE,330,38,4904240,Europe,21506,1303
2020-05-05,Ireland,IE,216,16,4904240,Europe,21722,1319
2020-05-06,Ireland,IE,261,20,4904240,Europe,21983,1339
2020-05-07,Ireland,IE,265,36,4904240,Europe,22248,1375
2020-05-08,Ireland,IE,137,28,4904240,Europe,22385,1403
2020-05-09,Ireland,IE,156,26,4904240,Europe,22541,1429
2020-05-10,Ireland,IE,219,17,4904240,Europe,22760,1446
2020-05-11,Ireland,IE,236,12,4904240,Europe,22996,1458
2020-05-12,Ireland,IE,139,9,4904240,Europe,23135,1467
2020-05-13,Ireland,IE,107,21,4904240,Europe,23242,1488
2020-05-14,Ireland,IE,159,9,4904240,Europe,23401,1497
2020-05-15,Ireland,IE,426,9,4904240,Europe,23827,1506
2020-05-16,Ireland,IE,129,12,4904240,Europe,23956,1518
2020-05-17,Ireland,IE,92,15,4904240,Europe,24048,1533
2020-05-18,Ireland,IE,64,10,4904240,Europe,24112,1543
2020-05-19,Ireland,IE,88,4,4904240,Europe,24200,1547
2020-05-20,Ireland,IE,51,14,4904240,Europe,24251,1561
2020-05-21,Ireland,IE,64,10,4904240,Europe,24315,1571
2020-05-22,Ireland,IE,76,12,4904240,Europe,24391,1583
2020-05-23,Ireland,IE,115,9,4904240,Europe,24506,1592
2020-05-24,Ireland,IE,76,12,4904240,Europe,24582,1604
2020-05-25,Ireland,IE,57,2,4904240,Europe,24639,1606
2020-05-26,Ireland,IE,59,0,4904240,Europe,24698,1606
2020-05-27,Ireland,IE,37,9,4904240,Europe,24735,1615
2020-05-28,Ireland,IE,68,16,4904240,Europe,24803,1631
2020-05-29,Ireland,IE,38,8,4904240,Europe,24841,1639
2020-05-30,Ireland,IE,35,6,4904240,Europe,24876,1645
2020-05-31,Ireland,IE,53,5,4904240,Europe,24929,1650
2020-06-01,Ireland,IE,61,0,4904240,Europe,24990,1650
2020-06-02,Ireland,IE,72,0,4904240,Europe,25062,1650
2020-06-03,Ireland,IE,4,8,4904240,Europe,25066,1658
2020-06-04,Ireland,IE,45,1,4904240,Europe,25111,1659
2020-06-05,Ireland,IE,31,5,4904240,Europe,25142,1664
2020-06-06,Ireland,IE,21,6,4904240,Europe,25163,1670
2020-06-07,Ireland,IE,20,0,4904240,Europe,25183,1670
2020-06-08,Ireland,IE,18,9,4904240,Europe,25201,1679
2020-06-09,Ireland,IE,6,4,4904240,Europe,25207,1683
2020-06-10,Ireland,IE,8,8,4904240,Europe,25215,1691
2020-06-11,Ireland,IE,16,4,4904240,Europe,25231,1695
2020-06-12,Ireland,IE,7,8,4904240,Europe,25238,1703
2020-06-13,Ireland,IE,12,2,4904240,Europe,25250,1705
2020-06-14,Ireland,IE,45,0,4904240,Europe,25295,1705
2020-06-15,Ireland,IE,8,1,4904240,Europe,25303,1706
2020-06-16,Ireland,IE,18,0,4904240,Europe,25321,1706
2020-06-17,Ireland,IE,13,3,4904240,Europe,25334,1709
2020-06-18,Ireland,IE,7,1,4904240,Europe,25341,1710
2020-06-19,Ireland,IE,14,4,4904240,Europe,25355,1714
2020-06-20,Ireland,IE,13,0,4904240,Europe,25368,1714
2020-06-21,Ireland,IE,6,1,4904240,Europe,25374,1715
2020-06-22,Ireland,IE,5,0,4904240,Europe,25379,1715
2020-06-23,Ireland,IE,4,2,4904240,Europe,25383,1717
2020-06-24,Ireland,IE,8,3,4904240,Europe,25391,1720
2020-06-25,Ireland,IE,5,6,4904240,Europe,25396,1726
2020-06-26,Ireland,IE,9,1,4904240,Europe,25405,1727
2020-06-27,Ireland,IE,9,3,4904240,Europe,25414,1730
2020-06-28,Ireland,IE,23,4,4904240,Europe,25437,1734
2020-06-29,Ireland,IE,2,1,4904240,Europe,25439,1735
2020-06-30,Ireland,IE,23,0,4904240,Europe,25462,1735
2020-07-01,Ireland,IE,11,1,4904240,Europe,25473,1736
2020-07-02,Ireland,IE,4,2,4904240,Europe,25477,1738
2020-07-03,Ireland,IE,12,0,4904240,Europe,25489,1738
2020-07-04,Ireland,IE,9,2,4904240,Europe,25498,1740
2020-07-05,Ireland,IE,11,1,4904240,Europe,25509,1741
2020-07-06,Ireland,IE,18,0,4904240,Europe,25527,1741
2020-07-07,Ireland,IE,4,0,4904240,Europe,25531,1741
2020-07-08,Ireland,IE,7,2,4904240,Europe,25538,1743
2020-07-09,Ireland,IE,4,0,4904240,Europe,25542,1743
2020-07-10,Ireland,IE,23,0,4904240,Europe,25565,1743
2020-07-11,Ireland,IE,24,1,4904240,Europe,25589,1744
2020-07-12,Ireland,IE,22,2,4904240,Europe,25611,1746
2020-07-13,Ireland,IE,17,0,4904240,Europe,25628,1746
2020-07-14,Ireland,IE,10,0,4904240,Europe,25638,1746
2020-07-15,Ireland,IE,32,0,4904240,Europe,25670,1746
2020-07-16,Ireland,IE,13,2,4904240,Europe,25683,1748
2020-07-17,Ireland,IE,15,1,4904240,Europe,25698,1749
2020-07-18,Ireland,IE,32,3,4904240,Europe,25730,1752
2020-07-19,Ireland,IE,20,1,4904240,Europe,25750,1753
2020-07-20,Ireland,IE,10,0,4904240,Europe,25760,1753
2020-07-21,Ireland,IE,6,0,4904240,Europe,25766,1753
2020-07-22,Ireland,IE,36,0,4904240,Europe,25802,1753
2020-07-23,Ireland,IE,17,1,4904240,Europe,25819,1754
2020-07-24,Ireland,IE,7,9,4904240,Europe,25826,1763
2020-07-25,Ireland,IE,19,0,4904240,Europe,25845,1763
2020-07-26,Ireland,IE,24,0,4904240,Europe,25869,1763
2020-07-27,Ireland,IE,12,0,4904240,Europe,25881,1763
2020-07-28,Ireland,IE,11,0,4904240,Europe,25892,1763
2020-07-29,Ireland,IE,37,0,4904240,Europe,25929,1763
2020-07-30,Ireland,IE,13,0,4904240,Europe,25942,1763
2020-07-31,Ireland,IE,85,0,4904240,Europe,26027,1763
2020-08-01,Ireland,IE,38,0,4904240,Europe,26065,1763
2020-08-02,Ireland,IE,44,0,4904240,Europe,26109,1763
2020-08-03,Ireland,IE,53,0,4904240,Europe,26162,1763
2020-08-04,Ireland,IE,46,0,4904240,Europe,26208,1763
2020-08-05,Ireland,IE,45,0,4904240,Europe,26253,1763
2020-08-06,Ireland,IE,50,0,4904240,Europe,26303,1763
2020-08-07,Ireland,IE,69,5,4904240,Europe,26372,1768
2020-08-08,Ireland,IE,98,4,4904240,Europe,26470,1772
2020-08-09,Ireland,IE,174,0,4904240,Europe,26644,1772
2020-08-10,Ireland,IE,68,0,4904240,Europe,26712,1772
2020-08-11,Ireland,IE,56,0,4904240,Europe,26768,1772
2020-08-12,Ireland,IE,33,1,4904240,Europe,26801,1773
2020-08-13,Ireland,IE,37,1,4904240,Europe,26838,1774
2020-08-14,Ireland,IE,91,0,4904240,Europe,26929,1774
2020-08-15,Ireland,IE,66,0,4904240,Europe,26995,1774
2020-08-16,Ireland,IE,196,0,4904240,Europe,27191,1774
2020-08-17,Ireland,IE,66,0,4904240,Europe,27257,1774
2020-08-18,Ireland,IE,56,0,4904240,Europe,27313,1774
2020-08-19,Ireland,IE,186,1,4904240,Europe,27499,1775
2020-08-20,Ireland,IE,48,0,4904240,Europe,27547,1775
2020-08-21,Ireland,IE,129,1,4904240,Europe,27676,1776
2020-08-22,Ireland,IE,79,0,4904240,Europe,27755,1776
2020-08-23,Ireland,IE,153,1,4904240,Europe,27908,1777
2020-08-24,Ireland,IE,61,0,4904240,Europe,27969,1777
2020-08-25,Ireland,IE,147,0,4904240,Europe,28116,1777
2020-08-26,Ireland,IE,85,0,4904240,Europe,28201,1777
2020-08-27,Ireland,IE,162,0,4904240,Europe,28363,1777
2020-08-28,Ireland,IE,90,0,4904240,Europe,28453,1777
2020-08-29,Ireland,IE,126,0,4904240,Europe,28579,1777
2020-08-30,Ireland,IE,141,0,4904240,Europe,28720,1777
2020-08-31,Ireland,IE,40,0,4904240,Europe,28760,1777
2020-09-01,Ireland,IE,51,0,4904240,Europe,28811,1777
2020-09-02,Ireland,IE,214,0,4904240,Europe,29025,1777
2020-09-03,Ireland,IE,89,0,4904240,Europe,29114,1777
2020-09-04,Ireland,IE,92,0,4904240,Europe,29206,1777
2020-09-05,Ireland,IE,97,0,4904240,Europe,29303,1777
2020-09-06,Ireland,IE,231,0,4904240,Europe,29534,1777
2020-09-07,Ireland,IE,138,0,4904240,Europe,29672,1777
2020-09-08,Ireland,IE,102,0,4904240,Europe,29774,1777
2020-09-09,Ireland,IE,306,1,4904240,Europe,30080,1778
2020-09-10,Ireland,IE,84,3,4904240,Europe,30164,1781
2020-09-11,Ireland,IE,196,0,4904240,Europe,30360,1781
2020-09-12,Ireland,IE,211,0,4904240,Europe,30571,1781
2020-09-13,Ireland,IE,159,2,4904240,Europe,30730,1783
2020-09-14,Ireland,IE,255,1,4904240,Europe,30985,1784
2020-09-15,Ireland,IE,207,0,4904240,Europe,31192,1784
2020-09-16,Ireland,IE,357,3,4904240,Europe,31549,1787
2020-09-17,Ireland,IE,250,1,4904240,Europe,31799,1788
2020-09-18,Ireland,IE,224,1,4904240,Europe,32023,1789
2020-09-19,Ireland,IE,248,3,4904240,Europe,32271,1792
2020-09-20,Ireland,IE,267,0,4904240,Europe,32538,1792
2020-09-21,Ireland,IE,395,0,4904240,Europe,32933,1792
2020-09-22,Ireland,IE,188,0,4904240,Europe,33121,1792
2020-09-23,Ireland,IE,323,0,4904240,Europe,33444,1792
2020-09-24,Ireland,IE,231,2,4904240,Europe,33675,1794
2020-09-25,Ireland,IE,319,3,4904240,Europe,33994,1797
2020-09-26,Ireland,IE,321,0,4904240,Europe,34315,1797
2020-09-27,Ireland,IE,245,5,4904240,Europe,34560,1802
2020-09-28,Ireland,IE,430,0,4904240,Europe,34990,1802
2020-09-29,Ireland,IE,388,0,4904240,Europe,35378,1802
2020-09-30,Ireland,IE,362,1,4904240,Europe,35740,1803
2020-10-01,Ireland,IE,415,1,4904240,Europe,36155,1804
2020-10-02,Ireland,IE,442,2,4904240,Europe,36597,1806
2020-10-03,Ireland,IE,466,-5,4904240,Europe,37063,1801
2020-10-04,Ireland,IE,605,9,4904240,Europe,37668,1810
2020-10-05,Ireland,IE,364,0,4904240,Europe,38032,1810
2020-10-06,Ireland,IE,519,0,4904240,Europe,38551,1810
2020-10-07,Ireland,IE,424,1,4904240,Europe,38975,1811
2020-10-08,Ireland,IE,609,5,4904240,Europe,39584,1816
2020-10-09,Ireland,IE,502,1,4904240,Europe,40086,1817
2020-10-10,Ireland,IE,617,4,4904240,Europe,40703,1821
2020-10-11,Ireland,IE,1011,0,4904240,Europe,41714,1821
2020-10-12,Ireland,IE,814,5,4904240,Europe,42528,1826
2020-10-13,Ireland,IE,823,1,4904240,Europe,43351,1827
2020-10-14,Ireland,IE,808,3,4904240,Europe,44159,1830
2020-10-15,Ireland,IE,1084,5,4904240,Europe,45243,1835
2020-10-16,Ireland,IE,1186,3,4904240,Europe,46429,1838
2020-10-17,Ireland,IE,998,3,4904240,Europe,47427,1841
2020-10-18,Ireland,IE,1251,8,4904240,Europe,48678,1849
2020-10-19,Ireland,IE,1284,3,4904240,Europe,49962,1852
2020-10-20,Ireland,IE,1031,0,4904240,Europe,50993,1852
2020-10-21,Ireland,IE,1263,13,4904240,Europe,52256,1865
2020-10-22,Ireland,IE,1166,3,4904240,Europe,53422,1868
2020-10-23,Ireland,IE,1054,3,4904240,Europe,54476,1871
2020-10-24,Ireland,IE,785,7,4904240,Europe,55261,1878
2020-10-25,Ireland,IE,847,4,4904240,Europe,56108,1882
2020-10-26,Ireland,IE,1020,0,4904240,Europe,57128,1882
2020-10-27,Ireland,IE,939,3,4904240,Europe,58067,1885
2020-10-28,Ireland,IE,700,5,4904240,Europe,58767,1890
2020-10-29,Ireland,IE,667,6,4904240,Europe,59434,1896
2020-10-30,Ireland,IE,863,6,4904240,Europe,60297,1902
2020-10-31,Ireland,IE,762,6,4904240,Europe,61059,1908
2020-11-01,Ireland,IE,397,5,4904240,Europe,61456,1913
2020-11-02,Ireland,IE,546,2,4904240,Europe,62002,1915
2020-11-03,Ireland,IE,748,2,4904240,Europe,62750,1917
2020-11-04,Ireland,IE,298,5,4904240,Europe,63048,1922
2020-11-05,Ireland,IE,435,8,4904240,Europe,63483,1930
2020-11-06,Ireland,IE,563,3,4904240,Europe,64046,1933
2020-11-07,Ireland,IE,492,7,4904240,Europe,64538,1940
2020-11-08,Ireland,IE,317,5,4904240,Europe,64855,1945
2020-11-09,Ireland,IE,539,2,4904240,Europe,65394,1947
2020-11-10,Ireland,IE,265,1,4904240,Europe,65659,1948
2020-11-11,Ireland,IE,230,15,4904240,Europe,65889,1963
2020-11-12,Ireland,IE,358,2,4904240,Europe,66247,1965
2020-11-13,Ireland,IE,385,0,4904240,Europe,66632,1965
2020-11-14,Ireland,IE,467,7,4904240,Europe,67099,1972
2020-11-15,Ireland,IE,427,6,4904240,Europe,67526,1978
2020-11-16,Ireland,IE,377,1,4904240,Europe,67903,1979
2020-11-17,Ireland,IE,453,5,4904240,Europe,68356,1984
2020-11-18,Ireland,IE,330,11,4904240,Europe,68686,1995
2020-11-19,Ireland,IE,372,11,4904240,Europe,69058,2006
2020-11-20,Ireland,IE,415,4,4904240,Europe,69473,2010
2020-11-21,Ireland,IE,329,8,4904240,Europe,69802,2018
2020-11-22,Ireland,IE,341,4,4904240,Europe,70143,2022
2020-11-23,Ireland,IE,318,0,4904240,Europe,70461,2022
2020-11-24,Ireland,IE,250,0,4904240,Europe,70711,2022
2020-11-25,Ireland,IE,219,6,4904240,Europe,70930,2028
2020-11-26,Ireland,IE,257,5,4904240,Europe,71187,2033
2020-11-27,Ireland,IE,307,3,4904240,Europe,71494,2036
2020-11-28,Ireland,IE,205,7,4904240,Europe,71699,2043
2020-11-29,Ireland,IE,243,7,4904240,Europe,71942,2050
2020-11-30,Ireland,IE,299,2,4904240,Europe,72241,2052
2020-12-01,Ireland,IE,303,1,4904240,Europe,72544,2053
2020-12-02,Ireland,IE,254,16,4904240,Europe,72798,2069
2020-12-03,Ireland,IE,268,5,4904240,Europe,73066,2074
2020-12-04,Ireland,IE,162,6,4904240,Europe,73228,2080
2020-12-05,Ireland,IE,263,6,4904240,Europe,73491,2086
2020-12-06,Ireland,IE,457,11,4904240,Europe,73948,2097
2020-12-07,Ireland,IE,298,0,4904240,Europe,74246,2097
2020-12-08,Ireland,IE,222,0,4904240,Europe,74468,2097
2020-12-09,Ireland,IE,214,0,4904240,Europe,74682,2097
2020-12-10,Ireland,IE,218,5,4904240,Europe,74900,2102
2020-12-11,Ireland,IE,303,15,4904240,Europe,75203,2117
2020-12-12,Ireland,IE,304,3,4904240,Europe,75507,2120
2020-12-13,Ireland,IE,249,3,4904240,Europe,75756,2123
2020-12-14,Ireland,IE,429,1,4904240,Europe,76185,2124
2019-12-31,Israel,IL,0,0,8519373,Asia,0,0
2020-01-01,Israel,IL,0,0,8519373,Asia,0,0
2020-01-02,Israel,IL,0,0,8519373,Asia,0,0
2020-01-03,Israel,IL,0,0,8519373,Asia,0,0
2020-01-04,Israel,IL,0,0,8519373,Asia,0,0
2020-01-05,Israel,IL,0,0,8519373,Asia,0,0
2020-01-06,Israel,IL,0,0,8519373,Asia,0,0
2020-01-07,Israel,IL,0,0,8519373,Asia,0,0
2020-01-08,Israel,IL,0,0,8519373,Asia,0,0
2020-01-09,Israel,IL,0,0,8519373,Asia,0,0
2020-01-10,Israel,IL,0,0,8519373,Asia,0,0
2020-01-11,Israel,IL,0,0,8519373,Asia,0,0
2020-01-12,Israel,IL,0,0,8519373,Asia,0,0
2020-01-13,Israel,IL,0,0,8519373,Asia,0,0
2020-01-14,Israel,IL,0,0,8519373,Asia,0,0
2020-01-15,Israel,IL,0,0,8519373,Asia,0,0
2020-01-16,Israel,IL,0,0,8519373,Asia,0,0
2020-01-17,Israel,IL,0,0,8519373,Asia,0,0
2020-01-18,Israel,IL,0,0,8519373,Asia,0,0
2020-01-19,Israel,IL,0,0,8519373,Asia,0,0
2020-01-20,Israel,IL,0,0,8519373,Asia,0,0
2020-01-21,Israel,IL,0,0,8519373,Asia,0,0
2020-01-22,Israel,IL,0,0,8519373,Asia,0,0
2020-01-23,Israel,IL,0,0,8519373,Asia,0,0
2020-01-24,Israel,IL,0,0,8519373,Asia,0,0
2020-01-25,Israel,IL,0,0,8519373,Asia,0,0
2020-01-26,Israel,IL,0,0,8519373,Asia,0,0
2020-01-27,Israel,IL,0,0,8519373,Asia,0,0
2020-01-28,Israel,IL,0,0,8519373,Asia,0,0
2020-01-29,Israel,IL,0,0,8519373,Asia,0,0
2020-01-30,Israel,IL,0,0,8519373,Asia,0,0
2020-01-31,Israel,IL,0,0,8519373,Asia,0,0
2020-02-01,Israel,IL,0,0,8519373,Asia,0,0
2020-02-02,Israel,IL,0,0,8519373,Asia,0,0
2020-02-03,Israel,IL,0,0,8519373,Asia,0,0
2020-02-04,Israel,IL,0,0,8519373,Asia,0,0
2020-02-05,Israel,IL,0,0,8519373,Asia,0,0
2020-02-06,Israel,IL,0,0,8519373,Asia,0,0
2020-02-07,Israel,IL,0,0,8519373,Asia,0,0
2020-02-08,Israel,IL,0,0,8519373,Asia,0,0
2020-02-09,Israel,IL,0,0,8519373,Asia,0,0
2020-02-10,Israel,IL,0,0,8519373,Asia,0,0
2020-02-11,Israel,IL,0,0,8519373,Asia,0,0
2020-02-12,Israel,IL,0,0,8519373,Asia,0,0
2020-02-13,Israel,IL,0,0,8519373,Asia,0,0
2020-02-14,Israel,IL,0,0,8519373,Asia,0,0
2020-02-15,Israel,IL,0,0,8519373,Asia,0,0
2020-02-16,Israel,IL,0,0,8519373,Asia,0,0
2020-02-17,Israel,IL,0,0,8519373,Asia,0,0
2020-02-18,Israel,IL,0,0,8519373,Asia,0,0
2020-02-19,Israel,IL,0,0,8519373,Asia,0,0
2020-02-20,Israel,IL,0,0,8519373,Asia,0,0
2020-02-21,Israel,IL,0,0,8519373,Asia,0,0
2020-02-22,Israel,IL,1,0,8519373,Asia,1,0
2020-02-23,Israel,IL,0,0,8519373,Asia,1,0
2020-02-24,Israel,IL,1,0,8519373,Asia,2,0
2020-02-25,Israel,IL,0,0,8519373,Asia,2,0
2020-02-26,Israel,IL,0,0,8519373,Asia,2,0
2020-02-27,Israel,IL,0,0,8519373,Asia,2,0
2020-02-28,Israel,IL,1,0,8519373,Asia,3,0
2020-02-29,Israel,IL,4,0,8519373,Asia,7,0
2020-03-01,Israel,IL,0,0,8519373,Asia,7,0
2020-03-02,Israel,IL,3,0,8519373,Asia,10,0
2020-03-05,Israel,IL,5,0,8519373,Asia,15,0
2020-03-06,Israel,IL,2,0,8519373,Asia,17,0
2020-03-07,Israel,IL,2,0,8519373,Asia,19,0
2020-03-08,Israel,IL,6,0,8519373,Asia,25,0
2020-03-09,Israel,IL,14,0,8519373,Asia,39,0
2020-03-11,Israel,IL,31,0,8519373,Asia,70,0
2020-03-12,Israel,IL,12,0,8519373,Asia,82,0
2020-03-13,Israel,IL,14,0,8519373,Asia,96,0
2020-03-14,Israel,IL,20,0,8519373,Asia,116,0
2020-03-15,Israel,IL,62,0,8519373,Asia,178,0
2020-03-16,Israel,IL,72,0,8519373,Asia,250,0
2020-03-17,Israel,IL,10,0,8519373,Asia,260,0
2020-03-18,Israel,IL,167,0,8519373,Asia,427,0
2020-03-19,Israel,IL,6,0,8519373,Asia,433,0
2020-03-20,Israel,IL,244,0,8519373,Asia,677,0
2020-03-21,Israel,IL,35,1,8519373,Asia,712,1
2020-03-22,Israel,IL,171,0,8519373,Asia,883,1
2020-03-23,Israel,IL,188,0,8519373,Asia,1071,1
2020-03-24,Israel,IL,371,0,8519373,Asia,1442,1
2020-03-25,Israel,IL,488,2,8519373,Asia,1930,3
2020-03-26,Israel,IL,439,2,8519373,Asia,2369,5
2020-03-27,Israel,IL,297,3,8519373,Asia,2666,8
2020-03-28,Israel,IL,369,2,8519373,Asia,3035,10
2020-03-29,Israel,IL,584,2,8519373,Asia,3619,12
2020-03-30,Israel,IL,628,3,8519373,Asia,4247,15
2020-03-31,Israel,IL,226,2,8519373,Asia,4473,17
2020-04-01,Israel,IL,443,3,8519373,Asia,4916,20
2020-04-02,Israel,IL,675,1,8519373,Asia,5591,21
2020-04-03,Israel,IL,661,13,8519373,Asia,6252,34
2020-04-04,Israel,IL,1176,5,8519373,Asia,7428,39
2020-04-05,Israel,IL,590,7,8519373,Asia,8018,46
2020-04-06,Israel,IL,412,3,8519373,Asia,8430,49
2020-04-07,Israel,IL,474,8,8519373,Asia,8904,57
2020-04-08,Israel,IL,344,8,8519373,Asia,9248,65
2020-04-09,Israel,IL,156,6,8519373,Asia,9404,71
2020-04-10,Israel,IL,564,15,8519373,Asia,9968,86
2020-04-11,Israel,IL,440,9,8519373,Asia,10408,95
2020-04-12,Israel,IL,335,6,8519373,Asia,10743,101
2020-04-13,Israel,IL,402,2,8519373,Asia,11145,103
2020-04-14,Israel,IL,441,13,8519373,Asia,11586,116
2020-04-15,Israel,IL,460,7,8519373,Asia,12046,123
2020-04-16,Israel,IL,455,7,8519373,Asia,12501,130
2020-04-17,Israel,IL,257,12,8519373,Asia,12758,142
2020-04-18,Israel,IL,224,9,8519373,Asia,12982,151
2020-04-19,Israel,IL,283,13,8519373,Asia,13265,164
2020-04-20,Israel,IL,226,8,8519373,Asia,13491,172
2020-04-21,Israel,IL,222,5,8519373,Asia,13713,177
2020-04-22,Israel,IL,229,7,8519373,Asia,13942,184
2020-04-23,Israel,IL,650,7,8519373,Asia,14592,191
2020-04-24,Israel,IL,290,2,8519373,Asia,14882,193
2020-04-25,Israel,IL,176,1,8519373,Asia,15058,194
2020-04-26,Israel,IL,240,5,8519373,Asia,15298,199
2020-04-27,Israel,IL,100,0,8519373,Asia,15398,199
2020-04-28,Israel,IL,68,3,8519373,Asia,15466,202
2020-04-29,Israel,IL,123,6,8519373,Asia,15589,208
2020-04-30,Israel,IL,245,7,8519373,Asia,15834,215
2020-05-01,Israel,IL,112,7,8519373,Asia,15946,222
2020-05-02,Israel,IL,155,3,8519373,Asia,16101,225
2020-05-03,Israel,IL,84,4,8519373,Asia,16185,229
2020-05-04,Israel,IL,23,3,8519373,Asia,16208,232
2020-05-05,Israel,IL,38,3,8519373,Asia,16246,235
2020-05-06,Israel,IL,43,3,8519373,Asia,16289,238
2020-05-07,Israel,IL,21,1,8519373,Asia,16310,239
2020-05-08,Israel,IL,71,1,8519373,Asia,16381,240
2020-05-09,Israel,IL,55,5,8519373,Asia,16436,245
2020-05-10,Israel,IL,18,2,8519373,Asia,16454,247
2020-05-11,Israel,IL,23,5,8519373,Asia,16477,252
2020-05-12,Israel,IL,29,6,8519373,Asia,16506,258
2020-05-13,Israel,IL,23,2,8519373,Asia,16529,260
2020-05-14,Israel,IL,19,4,8519373,Asia,16548,264
2020-05-15,Israel,IL,31,1,8519373,Asia,16579,265
2020-05-16,Israel,IL,10,1,8519373,Asia,16589,266
2020-05-17,Israel,IL,19,2,8519373,Asia,16608,268
2020-05-18,Israel,IL,9,4,8519373,Asia,16617,272
2020-05-19,Israel,IL,4,0,8519373,Asia,16621,272
2020-05-20,Israel,IL,29,5,8519373,Asia,16650,277
2020-05-21,Israel,IL,20,2,8519373,Asia,16670,279
2020-05-22,Israel,IL,20,0,8519373,Asia,16690,279
2020-05-23,Israel,IL,0,0,8519373,Asia,16690,279
2020-05-24,Israel,IL,0,0,8519373,Asia,16690,279
2020-05-25,Israel,IL,30,1,8519373,Asia,16720,280
2020-05-26,Israel,IL,14,1,8519373,Asia,16734,281
2020-05-27,Israel,IL,23,0,8519373,Asia,16757,281
2020-05-28,Israel,IL,36,0,8519373,Asia,16793,281
2020-05-29,Israel,IL,79,3,8519373,Asia,16872,284
2020-05-30,Israel,IL,115,0,8519373,Asia,16987,284
2020-05-31,Israel,IL,25,0,8519373,Asia,17012,284
2020-06-01,Israel,IL,59,1,8519373,Asia,17071,285
2020-06-02,Israel,IL,148,2,8519373,Asia,17219,287
2020-06-03,Israel,IL,123,3,8519373,Asia,17342,290
2020-06-04,Israel,IL,87,1,8519373,Asia,17429,291
2020-06-05,Israel,IL,133,0,8519373,Asia,17562,291
2020-06-06,Israel,IL,144,1,8519373,Asia,17706,292
2020-06-07,Israel,IL,77,5,8519373,Asia,17783,297
2020-06-08,Israel,IL,132,1,8519373,Asia,17915,298
2020-06-09,Israel,IL,174,0,8519373,Asia,18089,298
2020-06-10,Israel,IL,179,1,8519373,Asia,18268,299
2020-06-11,Israel,IL,87,0,8519373,Asia,18355,299
2020-06-12,Israel,IL,346,1,8519373,Asia,18701,300
2020-06-13,Israel,IL,175,0,8519373,Asia,18876,300
2020-06-14,Israel,IL,132,0,8519373,Asia,19008,300
2020-06-15,Israel,IL,113,2,8519373,Asia,19121,302
2020-06-16,Israel,IL,217,0,8519373,Asia,19338,302
2020-06-17,Israel,IL,299,1,8519373,Asia,19637,303
2020-06-18,Israel,IL,257,0,8519373,Asia,19894,303
2020-06-19,Israel,IL,142,0,8519373,Asia,20036,303
2020-06-20,Israel,IL,303,1,8519373,Asia,20339,304
2020-06-21,Israel,IL,294,1,8519373,Asia,20633,305
2020-06-22,Israel,IL,145,1,8519373,Asia,20778,306
2020-06-23,Israel,IL,304,1,8519373,Asia,21082,307
2020-06-24,Israel,IL,430,1,8519373,Asia,21512,308
2020-06-25,Israel,IL,532,0,8519373,Asia,22044,308
2020-06-26,Israel,IL,356,1,8519373,Asia,22400,309
2020-06-27,Israel,IL,400,5,8519373,Asia,22800,314
2020-06-28,Israel,IL,621,3,8519373,Asia,23421,317
2020-06-29,Israel,IL,334,1,8519373,Asia,23755,318
2020-06-30,Israel,IL,686,1,8519373,Asia,24441,319
2020-07-01,Israel,IL,803,1,8519373,Asia,25244,320
2020-07-02,Israel,IL,1013,2,8519373,Asia,26257,322
2020-07-03,Israel,IL,1285,3,8519373,Asia,27542,325
2020-07-04,Israel,IL,513,1,8519373,Asia,28055,326
2020-07-05,Israel,IL,1115,4,8519373,Asia,29170,330
2020-07-06,Israel,IL,788,1,8519373,Asia,29958,331
2020-07-07,Israel,IL,1228,7,8519373,Asia,31186,338
2020-07-08,Israel,IL,1036,4,8519373,Asia,32222,342
2020-07-09,Israel,IL,1335,2,8519373,Asia,33557,344
2020-07-10,Israel,IL,1268,4,8519373,Asia,34825,348
2020-07-11,Israel,IL,1441,3,8519373,Asia,36266,351
2020-07-12,Israel,IL,1197,3,8519373,Asia,37463,354
2020-07-13,Israel,IL,1207,8,8519373,Asia,38670,362
2020-07-14,Israel,IL,1962,3,8519373,Asia,40632,365
2020-07-15,Israel,IL,1728,6,8519373,Asia,42360,371
2020-07-16,Israel,IL,2354,9,8519373,Asia,44714,380
2020-07-17,Israel,IL,1345,4,8519373,Asia,46059,384
2020-07-18,Israel,IL,1400,8,8519373,Asia,47459,392
2020-07-19,Israel,IL,1906,9,8519373,Asia,49365,401
2020-07-20,Israel,IL,924,8,8519373,Asia,50289,409
2020-07-21,Israel,IL,1387,6,8519373,Asia,51676,415
2020-07-22,Israel,IL,2366,10,8519373,Asia,54042,425
2020-07-23,Israel,IL,2043,5,8519373,Asia,56085,430
2020-07-24,Israel,IL,1897,12,8519373,Asia,57982,442
2020-07-25,Israel,IL,1493,6,8519373,Asia,59475,448
2020-07-26,Israel,IL,1203,9,8519373,Asia,60678,457
2020-07-27,Israel,IL,1278,13,8519373,Asia,61956,470
2020-07-28,Israel,IL,2502,4,8519373,Asia,64458,474
2020-07-29,Israel,IL,2097,12,8519373,Asia,66555,486
2020-07-30,Israel,IL,2001,5,8519373,Asia,68556,491
2020-07-31,Israel,IL,1823,12,8519373,Asia,70379,503
2020-08-01,Israel,IL,591,9,8519373,Asia,70970,512
2020-08-02,Israel,IL,1313,15,8519373,Asia,72283,527
2020-08-03,Israel,IL,742,9,8519373,Asia,73025,536
2020-08-04,Israel,IL,1878,10,8519373,Asia,74903,546
2020-08-05,Israel,IL,1739,15,8519373,Asia,76642,561
2020-08-06,Israel,IL,1682,4,8519373,Asia,78324,565
2020-08-07,Israel,IL,1730,11,8519373,Asia,80054,576
2020-08-08,Israel,IL,937,5,8519373,Asia,80991,581
2020-08-09,Israel,IL,1474,13,8519373,Asia,82465,594
2020-08-10,Israel,IL,537,6,8519373,Asia,83002,600
2020-08-11,Israel,IL,2220,13,8519373,Asia,85222,613
2020-08-12,Israel,IL,1737,9,8519373,Asia,86959,622
2020-08-13,Israel,IL,1595,17,8519373,Asia,88554,639
2020-08-14,Israel,IL,1268,12,8519373,Asia,89822,651
2020-08-15,Israel,IL,1258,14,8519373,Asia,91080,665
2020-08-16,Israel,IL,1263,9,8519373,Asia,92343,674
2020-08-17,Israel,IL,337,11,8519373,Asia,92680,685
2020-08-18,Israel,IL,2449,7,8519373,Asia,95129,692
2020-08-19,Israel,IL,1280,16,8519373,Asia,96409,708
2020-08-20,Israel,IL,1560,71,8519373,Asia,97969,779
2020-08-21,Israel,IL,1630,16,8519373,Asia,99599,795
2020-08-22,Israel,IL,1117,14,8519373,Asia,100716,809
2020-08-23,Israel,IL,1364,10,8519373,Asia,102080,819
2020-08-24,Israel,IL,1071,15,8519373,Asia,103151,834
2020-08-25,Israel,IL,1912,13,8519373,Asia,105063,847
2020-08-26,Israel,IL,2015,12,8519373,Asia,107078,859
2020-08-27,Israel,IL,1886,16,8519373,Asia,108964,875
2020-08-28,Israel,IL,1439,9,8519373,Asia,110403,884
2020-08-29,Israel,IL,1597,10,8519373,Asia,112000,894
2020-08-30,Israel,IL,1623,12,8519373,Asia,113623,906
2020-08-31,Israel,IL,397,13,8519373,Asia,114020,919
2020-09-01,Israel,IL,3010,20,8519373,Asia,117030,939
2020-09-02,Israel,IL,2235,18,8519373,Asia,119265,957
2020-09-03,Israel,IL,3274,12,8519373,Asia,122539,969
2020-09-04,Israel,IL,2721,16,8519373,Asia,125260,985
2020-09-05,Israel,IL,1159,8,8519373,Asia,126419,993
2020-09-06,Israel,IL,2754,14,8519373,Asia,129173,1007
2020-09-07,Israel,IL,1471,12,8519373,Asia,130644,1019
2020-09-08,Israel,IL,4399,7,8519373,Asia,135043,1026
2020-09-09,Israel,IL,3676,14,8519373,Asia,138719,1040
2020-09-10,Israel,IL,3863,14,8519373,Asia,142582,1054
2020-09-11,Israel,IL,3960,23,8519373,Asia,146542,1077
2020-09-12,Israel,IL,2022,13,8519373,Asia,148564,1090
2020-09-13,Israel,IL,4653,13,8519373,Asia,153217,1103
2020-09-14,Israel,IL,3379,16,8519373,Asia,156596,1119
2020-09-15,Israel,IL,3772,17,8519373,Asia,160368,1136
2020-09-16,Israel,IL,6426,11,8519373,Asia,166794,1147
2020-09-17,Israel,IL,4974,18,8519373,Asia,171768,1165
2020-09-18,Israel,IL,5165,4,8519373,Asia,176933,1169
2020-09-19,Israel,IL,2138,27,8519373,Asia,179071,1196
2020-09-20,Israel,IL,4531,30,8519373,Asia,183602,1226
2020-09-21,Israel,IL,4825,30,8519373,Asia,188427,1256
2020-09-22,Israel,IL,4152,17,8519373,Asia,192579,1273
2020-09-23,Israel,IL,795,12,8519373,Asia,193374,1285
2020-09-24,Israel,IL,11316,40,8519373,Asia,204690,1325
2020-09-25,Israel,IL,9768,53,8519373,Asia,214458,1378
2020-09-26,Israel,IL,815,27,8519373,Asia,215273,1405
2020-09-27,Israel,IL,11827,36,8519373,Asia,227100,1441
2020-09-28,Israel,IL,3926,25,8519373,Asia,231026,1466
2020-09-29,Israel,IL,2239,41,8519373,Asia,233265,1507
2020-09-30,Israel,IL,3661,21,8519373,Asia,236926,1528
2020-10-01,Israel,IL,11207,43,8519373,Asia,248133,1571
2020-10-02,Israel,IL,7638,51,8519373,Asia,255771,1622
2020-10-03,Israel,IL,3131,11,8519373,Asia,258902,1633
2020-10-04,Israel,IL,5955,49,8519373,Asia,264857,1682
2020-10-05,Israel,IL,3318,37,8519373,Asia,268175,1719
2020-10-06,Israel,IL,4134,38,8519373,Asia,272309,1757
2020-10-07,Israel,IL,4717,40,8519373,Asia,277026,1797
2020-10-08,Israel,IL,4455,27,8519373,Asia,281481,1824
2020-10-09,Israel,IL,4912,40,8519373,Asia,286393,1864
2020-10-10,Israel,IL,1465,22,8519373,Asia,287858,1886
2020-10-11,Israel,IL,2145,55,8519373,Asia,290003,1941
2020-10-12,Israel,IL,1825,42,8519373,Asia,291828,1983
2020-10-13,Israel,IL,3209,38,8519373,Asia,295037,2021
2020-10-14,Israel,IL,2237,34,8519373,Asia,297274,2055
2020-10-15,Israel,IL,1979,44,8519373,Asia,299253,2099
2020-10-16,Israel,IL,948,28,8519373,Asia,300201,2127
2020-10-17,Israel,IL,1695,14,8519373,Asia,301896,2141
2020-10-18,Israel,IL,936,49,8519373,Asia,302832,2190
2020-10-19,Israel,IL,1014,19,8519373,Asia,303846,2209
2020-10-20,Israel,IL,1030,54,8519373,Asia,304876,2263
2020-10-21,Israel,IL,1627,15,8519373,Asia,306503,2278
2020-10-22,Israel,IL,832,13,8519373,Asia,307335,2291
2020-10-23,Israel,IL,1237,28,8519373,Asia,308572,2319
2020-10-24,Israel,IL,268,10,8519373,Asia,308840,2329
2020-10-25,Israel,IL,573,43,8519373,Asia,309413,2372
2020-10-26,Israel,IL,735,25,8519373,Asia,310148,2397
2020-10-27,Israel,IL,703,56,8519373,Asia,310851,2453
2020-10-28,Israel,IL,1173,30,8519373,Asia,312024,2483
2020-10-29,Israel,IL,763,11,8519373,Asia,312787,2494
2020-10-30,Israel,IL,803,17,8519373,Asia,313590,2511
2020-10-31,Israel,IL,111,3,8519373,Asia,313701,2514
2020-11-01,Israel,IL,797,27,8519373,Asia,314498,2541
2020-11-02,Israel,IL,633,13,8519373,Asia,315131,2554
2020-11-03,Israel,IL,852,26,8519373,Asia,315983,2580
2020-11-04,Israel,IL,809,12,8519373,Asia,316792,2592
2020-11-05,Israel,IL,764,5,8519373,Asia,317556,2597
2020-11-06,Israel,IL,555,42,8519373,Asia,318111,2639
2020-11-07,Israel,IL,291,5,8519373,Asia,318402,2644
2020-11-08,Israel,IL,620,0,8519373,Asia,319022,2644
2020-11-09,Israel,IL,540,30,8519373,Asia,319562,2674
2020-11-10,Israel,IL,622,4,8519373,Asia,320184,2678
2020-11-11,Israel,IL,665,5,8519373,Asia,320849,2683
2020-11-12,Israel,IL,477,17,8519373,Asia,321326,2700
2020-11-13,Israel,IL,833,6,8519373,Asia,322159,2706
2020-11-14,Israel,IL,536,10,8519373,Asia,322695,2716
2020-11-15,Israel,IL,765,5,8519373,Asia,323460,2721
2020-11-16,Israel,IL,675,11,8519373,Asia,324135,2732
2020-11-17,Israel,IL,900,3,8519373,Asia,325035,2735
2020-11-18,Israel,IL,827,0,8519373,Asia,325862,2735
2020-11-19,Israel,IL,469,4,8519373,Asia,326331,2739
2020-11-20,Israel,IL,1076,3,8519373,Asia,327407,2742
2020-11-21,Israel,IL,341,2,8519373,Asia,327748,2744
2020-11-22,Israel,IL,649,13,8519373,Asia,328397,2757
2020-11-23,Israel,IL,1006,49,8519373,Asia,329403,2806
2020-11-24,Israel,IL,927,5,8519373,Asia,330330,2811
2020-11-25,Israel,IL,849,11,8519373,Asia,331179,2822
2020-11-26,Israel,IL,1138,4,8519373,Asia,332317,2826
2020-11-27,Israel,IL,1126,8,8519373,Asia,333443,2834
2020-11-28,Israel,IL,359,5,8519373,Asia,333802,2839
2020-11-29,Israel,IL,1196,15,8519373,Asia,334998,2854
2020-11-30,Israel,IL,982,10,8519373,Asia,335980,2864
2020-12-01,Israel,IL,1393,1,8519373,Asia,337373,2865
2020-12-02,Israel,IL,1218,12,8519373,Asia,338591,2877
2020-12-03,Israel,IL,1348,6,8519373,Asia,339939,2883
2020-12-04,Israel,IL,1605,8,8519373,Asia,341544,2891
2020-12-05,Israel,IL,557,5,8519373,Asia,342101,2896
2020-12-06,Israel,IL,1965,13,8519373,Asia,344066,2909
2020-12-07,Israel,IL,1135,8,8519373,Asia,345201,2917
2020-12-08,Israel,IL,2130,7,8519373,Asia,347331,2924
2020-12-09,Israel,IL,1637,8,8519373,Asia,348968,2932
2020-12-10,Israel,IL,2036,2,8519373,Asia,351004,2934
2020-12-11,Israel,IL,1856,28,8519373,Asia,352860,2962
2020-12-12,Israel,IL,409,7,8519373,Asia,353269,2969
2020-12-13,Israel,IL,2746,14,8519373,Asia,356015,2983
2020-12-14,Israel,IL,1844,16,8519373,Asia,357859,2999
2020-03-21,Isle_of_Man,IM,1,0,84589,Europe,1,0
2020-03-22,Isle_of_Man,IM,1,0,84589,Europe,2,0
2020-03-23,Isle_of_Man,IM,0,0,84589,Europe,2,0
2020-03-24,Isle_of_Man,IM,11,0,84589,Europe,13,0
2020-03-25,Isle_of_Man,IM,10,0,84589,Europe,23,0
2020-03-26,Isle_of_Man,IM,0,0,84589,Europe,23,0
2020-03-27,Isle_of_Man,IM,3,0,84589,Europe,26,0
2020-03-28,Isle_of_Man,IM,3,0,84589,Europe,29,0
2020-03-29,Isle_of_Man,IM,3,0,84589,Europe,32,0
2020-03-30,Isle_of_Man,IM,10,0,84589,Europe,42,0
2020-03-31,Isle_of_Man,IM,0,0,84589,Europe,42,0
2020-04-01,Isle_of_Man,IM,10,0,84589,Europe,52,0
2020-04-02,Isle_of_Man,IM,13,0,84589,Europe,65,0
2020-04-03,Isle_of_Man,IM,6,1,84589,Europe,71,1
2020-04-04,Isle_of_Man,IM,43,0,84589,Europe,114,1
2020-04-05,Isle_of_Man,IM,12,0,84589,Europe,126,1
2020-04-06,Isle_of_Man,IM,1,0,84589,Europe,127,1
2020-04-07,Isle_of_Man,IM,12,0,84589,Europe,139,1
2020-04-08,Isle_of_Man,IM,11,0,84589,Europe,150,1
2020-04-09,Isle_of_Man,IM,8,0,84589,Europe,158,1
2020-04-10,Isle_of_Man,IM,32,0,84589,Europe,190,1
2020-04-11,Isle_of_Man,IM,11,0,84589,Europe,201,1
2020-04-12,Isle_of_Man,IM,25,0,84589,Europe,226,1
2020-04-13,Isle_of_Man,IM,2,1,84589,Europe,228,2
2020-04-14,Isle_of_Man,IM,14,0,84589,Europe,242,2
2020-04-15,Isle_of_Man,IM,0,0,84589,Europe,242,2
2020-04-16,Isle_of_Man,IM,12,0,84589,Europe,254,2
2020-04-17,Isle_of_Man,IM,30,2,84589,Europe,284,4
2020-04-18,Isle_of_Man,IM,5,0,84589,Europe,289,4
2020-04-19,Isle_of_Man,IM,8,2,84589,Europe,297,6
2020-04-20,Isle_of_Man,IM,1,0,84589,Europe,298,6
2020-04-21,Isle_of_Man,IM,2,3,84589,Europe,300,9
2020-04-22,Isle_of_Man,IM,7,1,84589,Europe,307,10
2020-04-23,Isle_of_Man,IM,0,5,84589,Europe,307,15
2020-04-24,Isle_of_Man,IM,0,1,84589,Europe,307,16
2020-04-25,Isle_of_Man,IM,1,2,84589,Europe,308,18
2020-04-26,Isle_of_Man,IM,0,0,84589,Europe,308,18
2020-04-27,Isle_of_Man,IM,0,0,84589,Europe,308,18
2020-04-28,Isle_of_Man,IM,0,0,84589,Europe,308,18
2020-04-29,Isle_of_Man,IM,1,3,84589,Europe,309,21
2020-04-30,Isle_of_Man,IM,4,0,84589,Europe,313,21
2020-05-01,Isle_of_Man,IM,2,0,84589,Europe,315,21
2020-05-02,Isle_of_Man,IM,1,1,84589,Europe,316,22
2020-05-03,Isle_of_Man,IM,4,0,84589,Europe,320,22
2020-05-04,Isle_of_Man,IM,1,0,84589,Europe,321,22
2020-05-05,Isle_of_Man,IM,4,1,84589,Europe,325,23
2020-05-06,Isle_of_Man,IM,1,0,84589,Europe,326,23
2020-05-07,Isle_of_Man,IM,1,0,84589,Europe,327,23
2020-05-08,Isle_of_Man,IM,2,0,84589,Europe,329,23
2020-05-09,Isle_of_Man,IM,0,0,84589,Europe,329,23
2020-05-10,Isle_of_Man,IM,1,0,84589,Europe,330,23
2020-05-11,Isle_of_Man,IM,0,0,84589,Europe,330,23
2020-05-12,Isle_of_Man,IM,0,0,84589,Europe,330,23
2020-05-13,Isle_of_Man,IM,1,0,84589,Europe,331,23
2020-05-14,Isle_of_Man,IM,1,0,84589,Europe,332,23
2020-05-15,Isle_of_Man,IM,0,0,84589,Europe,332,23
2020-05-16,Isle_of_Man,IM,2,1,84589,Europe,334,24
2020-05-17,Isle_of_Man,IM,1,0,84589,Europe,335,24
2020-05-18,Isle_of_Man,IM,0,0,84589,Europe,335,24
2020-05-19,Isle_of_Man,IM,0,0,84589,Europe,335,24
2020-05-20,Isle_of_Man,IM,0,0,84589,Europe,335,24
2020-05-21,Isle_of_Man,IM,1,0,84589,Europe,336,24
2020-05-22,Isle_of_Man,IM,0,0,84589,Europe,336,24
2020-05-23,Isle_of_Man,IM,0,0,84589,Europe,336,24
2020-05-24,Isle_of_Man,IM,0,0,84589,Europe,336,24
2020-05-25,Isle_of_Man,IM,0,0,84589,Europe,336,24
2020-05-26,Isle_of_Man,IM,0,0,84589,Europe,336,24
2020-05-27,Isle_of_Man,IM,0,0,84589,Europe,336,24
2020-05-28,Isle_of_Man,IM,0,0,84589,Europe,336,24
2020-05-29,Isle_of_Man,IM,0,0,84589,Europe,336,24
2020-05-30,Isle_of_Man,IM,0,0,84589,Europe,336,24
2020-05-31,Isle_of_Man,IM,0,0,84589,Europe,336,24
2020-06-01,Isle_of_Man,IM,0,0,84589,Europe,336,24
2020-06-02,Isle_of_Man,IM,0,0,84589,Europe,336,24
2020-06-03,Isle_of_Man,IM,0,0,84589,Europe,336,24
2020-06-04,Isle_of_Man,IM,0,0,84589,Europe,336,24
2020-06-05,Isle_of_Man,IM,0,0,84589,Europe,336,24
2020-06-06,Isle_of_Man,IM,0,0,84589,Europe,336,24
2020-06-07,Isle_of_Man,IM,0,0,84589,Europe,336,24
2020-06-08,Isle_of_Man,IM,0,0,84589,Europe,336,24
2020-06-09,Isle_of_Man,IM,0,0,84589,Europe,336,24
2020-06-10,Isle_of_Man,IM,0,0,84589,Europe,336,24
2020-06-11,Isle_of_Man,IM,0,0,84589,Europe,336,24
2020-06-12,Isle_of_Man,IM,0,0,84589,Europe,336,24
2020-06-13,Isle_of_Man,IM,0,0,84589,Europe,336,24
2020-06-14,Isle_of_Man,IM,0,0,84589,Europe,336,24
2020-06-15,Isle_of_Man,IM,0,0,84589,Europe,336,24
2020-06-16,Isle_of_Man,IM,0,0,84589,Europe,336,24
2020-06-17,Isle_of_Man,IM,0,0,84589,Europe,336,24
2020-06-18,Isle_of_Man,IM,0,0,84589,Europe,336,24
2020-06-19,Isle_of_Man,IM,0,0,84589,Europe,336,24
2020-06-20,Isle_of_Man,IM,0,0,84589,Europe,336,24
2020-06-21,Isle_of_Man,IM,0,0,84589,Europe,336,24
2020-06-22,Isle_of_Man,IM,0,0,84589,Europe,336,24
2020-06-23,Isle_of_Man,IM,0,0,84589,Europe,336,24
2020-06-24,Isle_of_Man,IM,0,0,84589,Europe,336,24
2020-06-25,Isle_of_Man,IM,0,0,84589,Europe,336,24
2020-06-26,Isle_of_Man,IM,0,0,84589,Europe,336,24
2020-06-27,Isle_of_Man,IM,0,0,84589,Europe,336,24
2020-06-28,Isle_of_Man,IM,0,0,84589,Europe,336,24
2020-06-29,Isle_of_Man,IM,0,0,84589,Europe,336,24
2020-06-30,Isle_of_Man,IM,0,0,84589,Europe,336,24
2020-07-01,Isle_of_Man,IM,0,0,84589,Europe,336,24
2020-07-02,Isle_of_Man,IM,0,0,84589,Europe,336,24
2020-07-03,Isle_of_Man,IM,0,0,84589,Europe,336,24
2020-07-04,Isle_of_Man,IM,0,0,84589,Europe,336,24
2020-07-05,Isle_of_Man,IM,0,0,84589,Europe,336,24
2020-07-06,Isle_of_Man,IM,0,0,84589,Europe,336,24
2020-07-07,Isle_of_Man,IM,0,0,84589,Europe,336,24
2020-07-08,Isle_of_Man,IM,0,0,84589,Europe,336,24
2020-07-09,Isle_of_Man,IM,0,0,84589,Europe,336,24
2020-07-10,Isle_of_Man,IM,0,0,84589,Europe,336,24
2020-07-11,Isle_of_Man,IM,0,0,84589,Europe,336,24
2020-07-12,Isle_of_Man,IM,0,0,84589,Europe,336,24
2020-07-13,Isle_of_Man,IM,0,0,84589,Europe,336,24
2020-07-14,Isle_of_Man,IM,0,0,84589,Europe,336,24
2020-07-15,Isle_of_Man,IM,0,0,84589,Europe,336,24
2020-07-16,Isle_of_Man,IM,0,0,84589,Europe,336,24
2020-07-17,Isle_of_Man,IM,0,0,84589,Europe,336,24
2020-07-18,Isle_of_Man,IM,0,0,84589,Europe,336,24
2020-07-19,Isle_of_Man,IM,0,0,84589,Europe,336,24
2020-07-20,Isle_of_Man,IM,0,0,84589,Europe,336,24
2020-07-21,Isle_of_Man,IM,0,0,84589,Europe,336,24
2020-07-22,Isle_of_Man,IM,0,0,84589,Europe,336,24
2020-07-23,Isle_of_Man,IM,0,0,84589,Europe,336,24
2020-07-24,Isle_of_Man,IM,0,0,84589,Europe,336,24
2020-07-25,Isle_of_Man,IM,0,0,84589,Europe,336,24
2020-07-26,Isle_of_Man,IM,0,0,84589,Europe,336,24
2020-07-27,Isle_of_Man,IM,0,0,84589,Europe,336,24
2020-07-28,Isle_of_Man,IM,0,0,84589,Europe,336,24
2020-07-29,Isle_of_Man,IM,0,0,84589,Europe,336,24
2020-07-30,Isle_of_Man,IM,0,0,84589,Europe,336,24
2020-07-31,Isle_of_Man,IM,0,0,84589,Europe,336,24
2020-08-01,Isle_of_Man,IM,0,0,84589,Europe,336,24
2020-08-02,Isle_of_Man,IM,0,0,84589,Europe,336,24
2020-08-03,Isle_of_Man,IM,0,0,84589,Europe,336,24
2020-08-04,Isle_of_Man,IM,0,0,84589,Europe,336,24
2020-08-05,Isle_of_Man,IM,0,0,84589,Europe,336,24
2020-08-06,Isle_of_Man,IM,0,0,84589,Europe,336,24
2020-08-07,Isle_of_Man,IM,0,0,84589,Europe,336,24
2020-08-08,Isle_of_Man,IM,0,0,84589,Europe,336,24
2020-08-09,Isle_of_Man,IM,0,0,84589,Europe,336,24
2020-08-10,Isle_of_Man,IM,0,0,84589,Europe,336,24
2020-08-11,Isle_of_Man,IM,0,0,84589,Europe,336,24
2020-08-12,Isle_of_Man,IM,0,0,84589,Europe,336,24
2020-08-13,Isle_of_Man,IM,0,0,84589,Europe,336,24
2020-08-14,Isle_of_Man,IM,0,0,84589,Europe,336,24
2020-08-15,Isle_of_Man,IM,0,0,84589,Europe,336,24
2020-08-16,Isle_of_Man,IM,0,0,84589,Europe,336,24
2020-08-17,Isle_of_Man,IM,0,0,84589,Europe,336,24
2020-08-18,Isle_of_Man,IM,0,0,84589,Europe,336,24
2020-08-19,Isle_of_Man,IM,0,0,84589,Europe,336,24
2020-08-20,Isle_of_Man,IM,0,0,84589,Europe,336,24
2020-08-21,Isle_of_Man,IM,0,0,84589,Europe,336,24
2020-08-22,Isle_of_Man,IM,0,0,84589,Europe,336,24
2020-08-23,Isle_of_Man,IM,0,0,84589,Europe,336,24
2020-08-24,Isle_of_Man,IM,0,0,84589,Europe,336,24
2020-08-25,Isle_of_Man,IM,0,0,84589,Europe,336,24
2020-08-26,Isle_of_Man,IM,0,0,84589,Europe,336,24
2020-08-27,Isle_of_Man,IM,0,0,84589,Europe,336,24
2020-08-28,Isle_of_Man,IM,0,0,84589,Europe,336,24
2020-08-29,Isle_of_Man,IM,0,0,84589,Europe,336,24
2020-08-30,Isle_of_Man,IM,0,0,84589,Europe,336,24
2020-08-31,Isle_of_Man,IM,0,0,84589,Europe,336,24
2020-09-01,Isle_of_Man,IM,0,0,84589,Europe,336,24
2020-09-02,Isle_of_Man,IM,0,0,84589,Europe,336,24
2020-09-03,Isle_of_Man,IM,0,0,84589,Europe,336,24
2020-09-04,Isle_of_Man,IM,0,0,84589,Europe,336,24
2020-09-05,Isle_of_Man,IM,0,0,84589,Europe,336,24
2020-09-06,Isle_of_Man,IM,0,0,84589,Europe,336,24
2020-09-07,Isle_of_Man,IM,1,0,84589,Europe,337,24
2020-09-08,Isle_of_Man,IM,0,0,84589,Europe,337,24
2020-09-09,Isle_of_Man,IM,0,0,84589,Europe,337,24
2020-09-10,Isle_of_Man,IM,0,0,84589,Europe,337,24
2020-09-11,Isle_of_Man,IM,0,0,84589,Europe,337,24
2020-09-12,Isle_of_Man,IM,0,0,84589,Europe,337,24
2020-09-13,Isle_of_Man,IM,0,0,84589,Europe,337,24
2020-09-14,Isle_of_Man,IM,0,0,84589,Europe,337,24
2020-09-15,Isle_of_Man,IM,2,0,84589,Europe,339,24
2020-09-16,Isle_of_Man,IM,0,0,84589,Europe,339,24
2020-09-17,Isle_of_Man,IM,0,0,84589,Europe,339,24
2020-09-18,Isle_of_Man,IM,0,0,84589,Europe,339,24
2020-09-19,Isle_of_Man,IM,0,0,84589,Europe,339,24
2020-09-20,Isle_of_Man,IM,0,0,84589,Europe,339,24
2020-09-21,Isle_of_Man,IM,0,0,84589,Europe,339,24
2020-09-22,Isle_of_Man,IM,1,0,84589,Europe,340,24
2020-09-23,Isle_of_Man,IM,0,0,84589,Europe,340,24
2020-09-24,Isle_of_Man,IM,0,0,84589,Europe,340,24
2020-09-25,Isle_of_Man,IM,0,0,84589,Europe,340,24
2020-09-26,Isle_of_Man,IM,0,0,84589,Europe,340,24
2020-09-27,Isle_of_Man,IM,0,0,84589,Europe,340,24
2020-09-28,Isle_of_Man,IM,0,0,84589,Europe,340,24
2020-09-29,Isle_of_Man,IM,0,0,84589,Europe,340,24
2020-09-30,Isle_of_Man,IM,0,0,84589,Europe,340,24
2020-10-01,Isle_of_Man,IM,0,0,84589,Europe,340,24
2020-10-02,Isle_of_Man,IM,0,0,84589,Europe,340,24
2020-10-03,Isle_of_Man,IM,1,0,84589,Europe,341,24
2020-10-04,Isle_of_Man,IM,1,0,84589,Europe,342,24
2020-10-05,Isle_of_Man,IM,0,0,84589,Europe,342,24
2020-10-06,Isle_of_Man,IM,2,0,84589,Europe,344,24
2020-10-07,Isle_of_Man,IM,1,0,84589,Europe,345,24
2020-10-08,Isle_of_Man,IM,0,0,84589,Europe,345,24
2020-10-09,Isle_of_Man,IM,0,0,84589,Europe,345,24
2020-10-10,Isle_of_Man,IM,0,0,84589,Europe,345,24
2020-10-11,Isle_of_Man,IM,0,0,84589,Europe,345,24
2020-10-12,Isle_of_Man,IM,1,0,84589,Europe,346,24
2020-10-13,Isle_of_Man,IM,0,0,84589,Europe,346,24
2020-10-14,Isle_of_Man,IM,0,0,84589,Europe,346,24
2020-10-15,Isle_of_Man,IM,2,0,84589,Europe,348,24
2020-10-16,Isle_of_Man,IM,0,0,84589,Europe,348,24
2020-10-17,Isle_of_Man,IM,0,0,84589,Europe,348,24
2020-10-18,Isle_of_Man,IM,0,0,84589,Europe,348,24
2020-10-19,Isle_of_Man,IM,0,0,84589,Europe,348,24
2020-10-20,Isle_of_Man,IM,0,0,84589,Europe,348,24
2020-10-21,Isle_of_Man,IM,0,0,84589,Europe,348,24
2020-10-22,Isle_of_Man,IM,0,0,84589,Europe,348,24
2020-10-23,Isle_of_Man,IM,0,0,84589,Europe,348,24
2020-10-24,Isle_of_Man,IM,0,0,84589,Europe,348,24
2020-10-25,Isle_of_Man,IM,0,0,84589,Europe,348,24
2020-10-26,Isle_of_Man,IM,0,0,84589,Europe,348,24
2020-10-27,Isle_of_Man,IM,3,0,84589,Europe,351,24
2020-10-28,Isle_of_Man,IM,1,0,84589,Europe,352,24
2020-10-29,Isle_of_Man,IM,0,0,84589,Europe,352,24
2020-10-30,Isle_of_Man,IM,0,0,84589,Europe,352,24
2020-10-31,Isle_of_Man,IM,1,0,84589,Europe,353,24
2020-11-01,Isle_of_Man,IM,0,0,84589,Europe,353,24
2020-11-02,Isle_of_Man,IM,0,0,84589,Europe,353,24
2020-11-03,Isle_of_Man,IM,2,0,84589,Europe,355,24
2020-11-04,Isle_of_Man,IM,1,0,84589,Europe,356,24
2020-11-05,Isle_of_Man,IM,1,0,84589,Europe,357,24
2020-11-06,Isle_of_Man,IM,0,0,84589,Europe,357,24
2020-11-07,Isle_of_Man,IM,0,0,84589,Europe,357,24
2020-11-08,Isle_of_Man,IM,0,0,84589,Europe,357,24
2020-11-09,Isle_of_Man,IM,0,1,84589,Europe,357,25
2020-11-10,Isle_of_Man,IM,0,0,84589,Europe,357,25
2020-11-11,Isle_of_Man,IM,2,0,84589,Europe,359,25
2020-11-12,Isle_of_Man,IM,2,0,84589,Europe,361,25
2020-11-13,Isle_of_Man,IM,2,0,84589,Europe,363,25
2020-11-14,Isle_of_Man,IM,0,0,84589,Europe,363,25
2020-11-15,Isle_of_Man,IM,0,0,84589,Europe,363,25
2020-11-16,Isle_of_Man,IM,0,0,84589,Europe,363,25
2020-11-17,Isle_of_Man,IM,0,0,84589,Europe,363,25
2020-11-18,Isle_of_Man,IM,1,0,84589,Europe,364,25
2020-11-19,Isle_of_Man,IM,0,0,84589,Europe,364,25
2020-11-20,Isle_of_Man,IM,2,0,84589,Europe,366,25
2020-11-21,Isle_of_Man,IM,2,0,84589,Europe,368,25
2020-11-22,Isle_of_Man,IM,0,0,84589,Europe,368,25
2020-11-23,Isle_of_Man,IM,0,0,84589,Europe,368,25
2020-11-24,Isle_of_Man,IM,1,0,84589,Europe,369,25
2020-11-25,Isle_of_Man,IM,0,0,84589,Europe,369,25
2020-11-26,Isle_of_Man,IM,0,0,84589,Europe,369,25
2020-11-27,Isle_of_Man,IM,0,0,84589,Europe,369,25
2020-11-28,Isle_of_Man,IM,0,0,84589,Europe,369,25
2020-11-29,Isle_of_Man,IM,0,0,84589,Europe,369,25
2020-11-30,Isle_of_Man,IM,0,0,84589,Europe,369,25
2020-12-01,Isle_of_Man,IM,0,0,84589,Europe,369,25
2020-12-02,Isle_of_Man,IM,0,0,84589,Europe,369,25
2020-12-03,Isle_of_Man,IM,0,0,84589,Europe,369,25
2020-12-04,Isle_of_Man,IM,0,0,84589,Europe,369,25
2020-12-05,Isle_of_Man,IM,1,0,84589,Europe,370,25
2020-12-06,Isle_of_Man,IM,0,0,84589,Europe,370,25
2020-12-07,Isle_of_Man,IM,0,0,84589,Europe,370,25
2020-12-08,Isle_of_Man,IM,0,0,84589,Europe,370,25
2020-12-09,Isle_of_Man,IM,0,0,84589,Europe,370,25
2020-12-10,Isle_of_Man,IM,0,0,84589,Europe,370,25
2020-12-11,Isle_of_Man,IM,0,0,84589,Europe,370,25
2020-12-12,Isle_of_Man,IM,0,0,84589,Europe,370,25
2020-12-13,Isle_of_Man,IM,0,0,84589,Europe,370,25
2020-12-14,Isle_of_Man,IM,0,0,84589,Europe,370,25
2019-12-31,India,IN,0,0,1366417756,Asia,0,0
2020-01-01,India,IN,0,0,1366417756,Asia,0,0
2020-01-02,India,IN,0,0,1366417756,Asia,0,0
2020-01-03,India,IN,0,0,1366417756,Asia,0,0
2020-01-04,India,IN,0,0,1366417756,Asia,0,0
2020-01-05,India,IN,0,0,1366417756,Asia,0,0
2020-01-06,India,IN,0,0,1366417756,Asia,0,0
2020-01-07,India,IN,0,0,1366417756,Asia,0,0
2020-01-08,India,IN,0,0,1366417756,Asia,0,0
2020-01-09,India,IN,0,0,1366417756,Asia,0,0
2020-01-10,India,IN,0,0,1366417756,Asia,0,0
2020-01-11,India,IN,0,0,1366417756,Asia,0,0
2020-01-12,India,IN,0,0,1366417756,Asia,0,0
2020-01-13,India,IN,0,0,1366417756,Asia,0,0
2020-01-14,India,IN,0,0,1366417756,Asia,0,0
2020-01-15,India,IN,0,0,1366417756,Asia,0,0
2020-01-16,India,IN,0,0,1366417756,Asia,0,0
2020-01-17,India,IN,0,0,1366417756,Asia,0,0
2020-01-18,India,IN,0,0,1366417756,Asia,0,0
2020-01-19,India,IN,0,0,1366417756,Asia,0,0
2020-01-20,India,IN,0,0,1366417756,Asia,0,0
2020-01-21,India,IN,0,0,1366417756,Asia,0,0
2020-01-22,India,IN,0,0,1366417756,Asia,0,0
2020-01-23,India,IN,0,0,1366417756,Asia,0,0
2020-01-24,India,IN,0,0,1366417756,Asia,0,0
2020-01-25,India,IN,0,0,1366417756,Asia,0,0
2020-01-26,India,IN,0,0,1366417756,Asia,0,0
2020-01-27,India,IN,0,0,1366417756,Asia,0,0
2020-01-28,India,IN,0,0,1366417756,Asia,0,0
2020-01-29,India,IN,0,0,1366417756,Asia,0,0
2020-01-30,India,IN,1,0,1366417756,Asia,1,0
2020-01-31,India,IN,0,0,1366417756,Asia,1,0
2020-02-01,India,IN,0,0,1366417756,Asia,1,0
2020-02-02,India,IN,1,0,1366417756,Asia,2,0
2020-02-03,India,IN,0,0,1366417756,Asia,2,0
2020-02-04,India,IN,1,0,1366417756,Asia,3,0
2020-02-05,India,IN,0,0,1366417756,Asia,3,0
2020-02-06,India,IN,0,0,1366417756,Asia,3,0
2020-02-07,India,IN,0,0,1366417756,Asia,3,0
2020-02-08,India,IN,0,0,1366417756,Asia,3,0
2020-02-09,India,IN,0,0,1366417756,Asia,3,0
2020-02-10,India,IN,0,0,1366417756,Asia,3,0
2020-02-11,India,IN,0,0,1366417756,Asia,3,0
2020-02-12,India,IN,0,0,1366417756,Asia,3,0
2020-02-13,India,IN,0,0,1366417756,Asia,3,0
2020-02-14,India,IN,0,0,1366417756,Asia,3,0
2020-02-15,India,IN,0,0,1366417756,Asia,3,0
2020-02-16,India,IN,0,0,1366417756,Asia,3,0
2020-02-17,India,IN,0,0,1366417756,Asia,3,0
2020-02-18,India,IN,0,0,1366417756,Asia,3,0
2020-02-19,India,IN,0,0,1366417756,Asia,3,0
2020-02-20,India,IN,0,0,1366417756,Asia,3,0
2020-02-21,India,IN,0,0,1366417756,Asia,3,0
2020-02-22,India,IN,0,0,1366417756,Asia,3,0
2020-02-23,India,IN,0,0,1366417756,Asia,3,0
2020-02-24,India,IN,0,0,1366417756,Asia,3,0
2020-02-25,India,IN,0,0,1366417756,Asia,3,0
2020-02-26,India,IN,0,0,1366417756,Asia,3,0
2020-02-27,India,IN,0,0,1366417756,Asia,3,0
2020-02-28,India,IN,0,0,1366417756,Asia,3,0
2020-02-29,India,IN,0,0,1366417756,Asia,3,0
2020-03-01,India,IN,0,0,1366417756,Asia,3,0
2020-03-02,India,IN,0,0,1366417756,Asia,3,0
2020-03-03,India,IN,2,0,1366417756,Asia,5,0
2020-03-04,India,IN,1,0,1366417756,Asia,6,0
2020-03-05,India,IN,22,0,1366417756,Asia,28,0
2020-03-06,India,IN,1,0,1366417756,Asia,29,0
2020-03-07,India,IN,2,0,1366417756,Asia,31,0
2020-03-08,India,IN,3,0,1366417756,Asia,34,0
2020-03-10,India,IN,10,0,1366417756,Asia,44,0
2020-03-11,India,IN,6,0,1366417756,Asia,50,0
2020-03-12,India,IN,23,0,1366417756,Asia,73,0
2020-03-13,India,IN,2,1,1366417756,Asia,75,1
2020-03-14,India,IN,8,1,1366417756,Asia,83,2
2020-03-15,India,IN,7,0,1366417756,Asia,90,2
2020-03-16,India,IN,3,0,1366417756,Asia,93,2
2020-03-17,India,IN,32,1,1366417756,Asia,125,3
2020-03-18,India,IN,12,0,1366417756,Asia,137,3
2020-03-19,India,IN,28,0,1366417756,Asia,165,3
2020-03-20,India,IN,26,1,1366417756,Asia,191,4
2020-03-21,India,IN,40,0,1366417756,Asia,231,4
2020-03-22,India,IN,89,0,1366417756,Asia,320,4
2020-03-23,India,IN,119,3,1366417756,Asia,439,7
2020-03-24,India,IN,53,2,1366417756,Asia,492,9
2020-03-25,India,IN,70,0,1366417756,Asia,562,9
2020-03-26,India,IN,87,4,1366417756,Asia,649,13
2020-03-27,India,IN,75,4,1366417756,Asia,724,17
2020-03-28,India,IN,149,2,1366417756,Asia,873,19
2020-03-29,India,IN,106,6,1366417756,Asia,979,25
2020-03-30,India,IN,92,4,1366417756,Asia,1071,29
2020-03-31,India,IN,180,3,1366417756,Asia,1251,32
2020-04-01,India,IN,146,3,1366417756,Asia,1397,35
2020-04-02,India,IN,568,15,1366417756,Asia,1965,50
2020-04-03,India,IN,336,6,1366417756,Asia,2301,56
2020-04-04,India,IN,601,12,1366417756,Asia,2902,68
2020-04-05,India,IN,472,9,1366417756,Asia,3374,77
2020-04-06,India,IN,693,32,1366417756,Asia,4067,109
2020-04-07,India,IN,354,5,1366417756,Asia,4421,114
2020-04-08,India,IN,773,35,1366417756,Asia,5194,149
2020-04-09,India,IN,540,17,1366417756,Asia,5734,166
2020-04-10,India,IN,678,33,1366417756,Asia,6412,199
2020-04-11,India,IN,1035,40,1366417756,Asia,7447,239
2020-04-12,India,IN,909,34,1366417756,Asia,8356,273
2020-04-13,India,IN,796,35,1366417756,Asia,9152,308
2020-04-14,India,IN,1211,31,1366417756,Asia,10363,339
2020-04-15,India,IN,1075,38,1366417756,Asia,11438,377
2020-04-16,India,IN,942,37,1366417756,Asia,12380,414
2020-04-17,India,IN,1007,23,1366417756,Asia,13387,437
2020-04-18,India,IN,991,43,1366417756,Asia,14378,480
2020-04-19,India,IN,1334,27,1366417756,Asia,15712,507
2020-04-20,India,IN,1553,36,1366417756,Asia,17265,543
2020-04-21,India,IN,1335,47,1366417756,Asia,18600,590
2020-04-22,India,IN,1384,50,1366417756,Asia,19984,640
2020-04-23,India,IN,1409,41,1366417756,Asia,21393,681
2020-04-24,India,IN,1684,37,1366417756,Asia,23077,718
2020-04-25,India,IN,1429,57,1366417756,Asia,24506,775
2020-04-26,India,IN,1990,49,1366417756,Asia,26496,824
2020-04-27,India,IN,1396,48,1366417756,Asia,27892,872
2020-04-28,India,IN,1543,62,1366417756,Asia,29435,934
2020-04-29,India,IN,1897,73,1366417756,Asia,31332,1007
2020-04-30,India,IN,1718,67,1366417756,Asia,33050,1074
2020-05-01,India,IN,1993,73,1366417756,Asia,35043,1147
2020-05-02,India,IN,2293,71,1366417756,Asia,37336,1218
2020-05-03,India,IN,2644,83,1366417756,Asia,39980,1301
2020-05-04,India,IN,2553,72,1366417756,Asia,42533,1373
2020-05-05,India,IN,3900,195,1366417756,Asia,46433,1568
2020-05-06,India,IN,2958,126,1366417756,Asia,49391,1694
2020-05-07,India,IN,3561,89,1366417756,Asia,52952,1783
2020-05-08,India,IN,3390,103,1366417756,Asia,56342,1886
2020-05-09,India,IN,3320,95,1366417756,Asia,59662,1981
2020-05-10,India,IN,3277,128,1366417756,Asia,62939,2109
2020-05-11,India,IN,4213,97,1366417756,Asia,67152,2206
2020-05-12,India,IN,3604,87,1366417756,Asia,70756,2293
2020-05-13,India,IN,3525,122,1366417756,Asia,74281,2415
2020-05-14,India,IN,3722,134,1366417756,Asia,78003,2549
2020-05-15,India,IN,3967,100,1366417756,Asia,81970,2649
2020-05-16,India,IN,3970,103,1366417756,Asia,85940,2752
2020-05-17,India,IN,4987,120,1366417756,Asia,90927,2872
2020-05-18,India,IN,5242,157,1366417756,Asia,96169,3029
2020-05-19,India,IN,4970,134,1366417756,Asia,101139,3163
2020-05-20,India,IN,5611,140,1366417756,Asia,106750,3303
2020-05-21,India,IN,5609,132,1366417756,Asia,112359,3435
2020-05-22,India,IN,6088,148,1366417756,Asia,118447,3583
2020-05-23,India,IN,6654,137,1366417756,Asia,125101,3720
2020-05-24,India,IN,6767,147,1366417756,Asia,131868,3867
2020-05-25,India,IN,6977,154,1366417756,Asia,138845,4021
2020-05-26,India,IN,6535,146,1366417756,Asia,145380,4167
2020-05-27,India,IN,6387,170,1366417756,Asia,151767,4337
2020-05-28,India,IN,6566,194,1366417756,Asia,158333,4531
2020-05-29,India,IN,7466,175,1366417756,Asia,165799,4706
2020-05-30,India,IN,7964,265,1366417756,Asia,173763,4971
2020-05-31,India,IN,8380,193,1366417756,Asia,182143,5164
2020-06-01,India,IN,8392,230,1366417756,Asia,190535,5394
2020-06-02,India,IN,8171,204,1366417756,Asia,198706,5598
2020-06-03,India,IN,8909,217,1366417756,Asia,207615,5815
2020-06-04,India,IN,9304,260,1366417756,Asia,216919,6075
2020-06-05,India,IN,9851,273,1366417756,Asia,226770,6348
2020-06-06,India,IN,9887,294,1366417756,Asia,236657,6642
2020-06-07,India,IN,9971,287,1366417756,Asia,246628,6929
2020-06-08,India,IN,9983,206,1366417756,Asia,256611,7135
2020-06-09,India,IN,9987,331,1366417756,Asia,266598,7466
2020-06-10,India,IN,9985,279,1366417756,Asia,276583,7745
2020-06-11,India,IN,9996,357,1366417756,Asia,286579,8102
2020-06-12,India,IN,10956,396,1366417756,Asia,297535,8498
2020-06-13,India,IN,11458,386,1366417756,Asia,308993,8884
2020-06-14,India,IN,11929,311,1366417756,Asia,320922,9195
2020-06-15,India,IN,11502,325,1366417756,Asia,332424,9520
2020-06-16,India,IN,10667,380,1366417756,Asia,343091,9900
2020-06-17,India,IN,10974,2003,1366417756,Asia,354065,11903
2020-06-18,India,IN,12881,334,1366417756,Asia,366946,12237
2020-06-19,India,IN,13586,336,1366417756,Asia,380532,12573
2020-06-20,India,IN,14516,375,1366417756,Asia,395048,12948
2020-06-21,India,IN,15413,306,1366417756,Asia,410461,13254
2020-06-22,India,IN,14821,445,1366417756,Asia,425282,13699
2020-06-23,India,IN,14933,312,1366417756,Asia,440215,14011
2020-06-24,India,IN,15968,465,1366417756,Asia,456183,14476
2020-06-25,India,IN,16922,418,1366417756,Asia,473105,14894
2020-06-26,India,IN,17296,407,1366417756,Asia,490401,15301
2020-06-27,India,IN,18552,384,1366417756,Asia,508953,15685
2020-06-28,India,IN,19906,410,1366417756,Asia,528859,16095
2020-06-29,India,IN,19459,380,1366417756,Asia,548318,16475
2020-06-30,India,IN,18522,418,1366417756,Asia,566840,16893
2020-07-01,India,IN,18653,507,1366417756,Asia,585493,17400
2020-07-02,India,IN,19148,434,1366417756,Asia,604641,17834
2020-07-03,India,IN,20903,379,1366417756,Asia,625544,18213
2020-07-04,India,IN,22771,442,1366417756,Asia,648315,18655
2020-07-05,India,IN,24850,613,1366417756,Asia,673165,19268
2020-07-06,India,IN,24248,425,1366417756,Asia,697413,19693
2020-07-07,India,IN,22252,467,1366417756,Asia,719665,20160
2020-07-08,India,IN,22752,482,1366417756,Asia,742417,20642
2020-07-09,India,IN,24879,487,1366417756,Asia,767296,21129
2020-07-10,India,IN,26506,475,1366417756,Asia,793802,21604
2020-07-11,India,IN,27114,519,1366417756,Asia,820916,22123
2020-07-12,India,IN,28637,551,1366417756,Asia,849553,22674
2020-07-13,India,IN,28701,500,1366417756,Asia,878254,23174
2020-07-14,India,IN,28498,553,1366417756,Asia,906752,23727
2020-07-15,India,IN,29429,582,1366417756,Asia,936181,24309
2020-07-16,India,IN,32695,606,1366417756,Asia,968876,24915
2020-07-17,India,IN,34956,687,1366417756,Asia,1003832,25602
2020-07-18,India,IN,34884,671,1366417756,Asia,1038716,26273
2020-07-19,India,IN,38902,543,1366417756,Asia,1077618,26816
2020-07-20,India,IN,40425,681,1366417756,Asia,1118043,27497
2020-07-21,India,IN,37148,587,1366417756,Asia,1155191,28084
2020-07-22,India,IN,37724,648,1366417756,Asia,1192915,28732
2020-07-23,India,IN,45720,1129,1366417756,Asia,1238635,29861
2020-07-24,India,IN,49310,740,1366417756,Asia,1287945,30601
2020-07-25,India,IN,48916,757,1366417756,Asia,1336861,31358
2020-07-26,India,IN,48661,705,1366417756,Asia,1385522,32063
2020-07-27,India,IN,49931,708,1366417756,Asia,1435453,32771
2020-07-28,India,IN,47703,654,1366417756,Asia,1483156,33425
2020-07-29,India,IN,48513,768,1366417756,Asia,1531669,34193
2020-07-30,India,IN,52123,775,1366417756,Asia,1583792,34968
2020-07-31,India,IN,55078,779,1366417756,Asia,1638870,35747
2020-08-01,India,IN,57118,764,1366417756,Asia,1695988,36511
2020-08-02,India,IN,54735,853,1366417756,Asia,1750723,37364
2020-08-03,India,IN,52972,771,1366417756,Asia,1803695,38135
2020-08-04,India,IN,52050,803,1366417756,Asia,1855745,38938
2020-08-05,India,IN,52509,857,1366417756,Asia,1908254,39795
2020-08-06,India,IN,56282,904,1366417756,Asia,1964536,40699
2020-08-07,India,IN,62538,886,1366417756,Asia,2027074,41585
2020-08-08,India,IN,61537,933,1366417756,Asia,2088611,42518
2020-08-09,India,IN,64399,861,1366417756,Asia,2153010,43379
2020-08-10,India,IN,62064,1007,1366417756,Asia,2215074,44386
2020-08-11,India,IN,53601,871,1366417756,Asia,2268675,45257
2020-08-12,India,IN,60963,834,1366417756,Asia,2329638,46091
2020-08-13,India,IN,66999,942,1366417756,Asia,2396637,47033
2020-08-14,India,IN,64553,1007,1366417756,Asia,2461190,48040
2020-08-15,India,IN,65002,996,1366417756,Asia,2526192,49036
2020-08-16,India,IN,63490,944,1366417756,Asia,2589682,49980
2020-08-17,India,IN,57981,941,1366417756,Asia,2647663,50921
2020-08-18,India,IN,55079,876,1366417756,Asia,2702742,51797
2020-08-19,India,IN,64531,1092,1366417756,Asia,2767273,52889
2020-08-20,India,IN,69652,977,1366417756,Asia,2836925,53866
2020-08-21,India,IN,68898,983,1366417756,Asia,2905823,54849
2020-08-22,India,IN,69878,945,1366417756,Asia,2975701,55794
2020-08-23,India,IN,69239,912,1366417756,Asia,3044940,56706
2020-08-24,India,IN,61408,836,1366417756,Asia,3106348,57542
2020-08-25,India,IN,60975,848,1366417756,Asia,3167323,58390
2020-08-26,India,IN,67151,1059,1366417756,Asia,3234474,59449
2020-08-27,India,IN,75760,1023,1366417756,Asia,3310234,60472
2020-08-28,India,IN,77266,1057,1366417756,Asia,3387500,61529
2020-08-29,India,IN,76472,1021,1366417756,Asia,3463972,62550
2020-08-30,India,IN,78761,948,1366417756,Asia,3542733,63498
2020-08-31,India,IN,78512,971,1366417756,Asia,3621245,64469
2020-09-01,India,IN,69921,759,1366417756,Asia,3691166,65228
2020-09-02,India,IN,78357,1105,1366417756,Asia,3769523,66333
2020-09-03,India,IN,83883,1043,1366417756,Asia,3853406,67376
2020-09-04,India,IN,83341,1096,1366417756,Asia,3936747,68472
2020-09-05,India,IN,86432,1089,1366417756,Asia,4023179,69561
2020-09-06,India,IN,90632,1065,1366417756,Asia,4113811,70626
2020-09-07,India,IN,90802,1016,1366417756,Asia,4204613,71642
2020-09-08,India,IN,75809,1133,1366417756,Asia,4280422,72775
2020-09-09,India,IN,89706,1115,1366417756,Asia,4370128,73890
2020-09-10,India,IN,95735,1172,1366417756,Asia,4465863,75062
2020-09-11,India,IN,96551,1209,1366417756,Asia,4562414,76271
2020-09-12,India,IN,97570,1201,1366417756,Asia,4659984,77472
2020-09-13,India,IN,94372,1114,1366417756,Asia,4754356,78586
2020-09-14,India,IN,92071,1136,1366417756,Asia,4846427,79722
2020-09-15,India,IN,83809,1054,1366417756,Asia,4930236,80776
2020-09-16,India,IN,90123,1290,1366417756,Asia,5020359,82066
2020-09-17,India,IN,97894,1132,1366417756,Asia,5118253,83198
2020-09-18,India,IN,96424,1174,1366417756,Asia,5214677,84372
2020-09-19,India,IN,93337,1247,1366417756,Asia,5308014,85619
2020-09-20,India,IN,92605,1133,1366417756,Asia,5400619,86752
2020-09-21,India,IN,86961,1130,1366417756,Asia,5487580,87882
2020-09-22,India,IN,75083,1053,1366417756,Asia,5562663,88935
2020-09-23,India,IN,83347,1085,1366417756,Asia,5646010,90020
2020-09-24,India,IN,86508,1129,1366417756,Asia,5732518,91149
2020-09-25,India,IN,86052,1141,1366417756,Asia,5818570,92290
2020-09-26,India,IN,85362,1089,1366417756,Asia,5903932,93379
2020-09-27,India,IN,88600,1124,1366417756,Asia,5992532,94503
2020-09-28,India,IN,82170,1039,1366417756,Asia,6074702,95542
2020-09-29,India,IN,70589,776,1366417756,Asia,6145291,96318
2020-09-30,India,IN,80472,1179,1366417756,Asia,6225763,97497
2020-10-01,India,IN,86821,1181,1366417756,Asia,6312584,98678
2020-10-02,India,IN,81484,1095,1366417756,Asia,6394068,99773
2020-10-03,India,IN,79476,1069,1366417756,Asia,6473544,100842
2020-10-04,India,IN,75829,940,1366417756,Asia,6549373,101782
2020-10-05,India,IN,74442,903,1366417756,Asia,6623815,102685
2020-10-06,India,IN,61267,884,1366417756,Asia,6685082,103569
2020-10-07,India,IN,72049,986,1366417756,Asia,6757131,104555
2020-10-08,India,IN,78524,971,1366417756,Asia,6835655,105526
2020-10-09,India,IN,70496,964,1366417756,Asia,6906151,106490
2020-10-10,India,IN,73272,926,1366417756,Asia,6979423,107416
2020-10-11,India,IN,74383,918,1366417756,Asia,7053806,108334
2020-10-12,India,IN,66732,816,1366417756,Asia,7120538,109150
2020-10-13,India,IN,55342,706,1366417756,Asia,7175880,109856
2020-10-14,India,IN,63509,730,1366417756,Asia,7239389,110586
2020-10-15,India,IN,67708,680,1366417756,Asia,7307097,111266
2020-10-16,India,IN,63371,895,1366417756,Asia,7370468,112161
2020-10-17,India,IN,62212,837,1366417756,Asia,7432680,112998
2020-10-18,India,IN,61871,1033,1366417756,Asia,7494551,114031
2020-10-19,India,IN,55722,579,1366417756,Asia,7550273,114610
2020-10-20,India,IN,46790,587,1366417756,Asia,7597063,115197
2020-10-21,India,IN,54044,717,1366417756,Asia,7651107,115914
2020-10-22,India,IN,55839,702,1366417756,Asia,7706946,116616
2020-10-23,India,IN,54366,690,1366417756,Asia,7761312,117306
2020-10-24,India,IN,53370,650,1366417756,Asia,7814682,117956
2020-10-25,India,IN,50129,578,1366417756,Asia,7864811,118534
2020-10-26,India,IN,45148,480,1366417756,Asia,7909959,119014
2020-10-27,India,IN,36470,488,1366417756,Asia,7946429,119502
2020-10-28,India,IN,43893,508,1366417756,Asia,7990322,120010
2020-10-29,India,IN,49881,517,1366417756,Asia,8040203,120527
2020-10-30,India,IN,48648,563,1366417756,Asia,8088851,121090
2020-10-31,India,IN,48268,551,1366417756,Asia,8137119,121641
2020-11-01,India,IN,46963,470,1366417756,Asia,8184082,122111
2020-11-02,India,IN,45231,496,1366417756,Asia,8229313,122607
2020-11-03,India,IN,38310,490,1366417756,Asia,8267623,123097
2020-11-04,India,IN,46253,514,1366417756,Asia,8313876,123611
2020-11-05,India,IN,50210,704,1366417756,Asia,8364086,124315
2020-11-06,India,IN,47638,670,1366417756,Asia,8411724,124985
2020-11-07,India,IN,50356,577,1366417756,Asia,8462080,125562
2020-11-08,India,IN,45674,559,1366417756,Asia,8507754,126121
2020-11-09,India,IN,45903,490,1366417756,Asia,8553657,126611
2020-11-10,India,IN,38073,448,1366417756,Asia,8591730,127059
2020-11-11,India,IN,44281,512,1366417756,Asia,8636011,127571
2020-11-12,India,IN,47905,550,1366417756,Asia,8683916,128121
2020-11-13,India,IN,44879,547,1366417756,Asia,8728795,128668
2020-11-14,India,IN,44684,520,1366417756,Asia,8773479,129188
2020-11-15,India,IN,41100,447,1366417756,Asia,8814579,129635
2020-11-16,India,IN,30548,435,1366417756,Asia,8845127,130070
2020-11-17,India,IN,29163,449,1366417756,Asia,8874290,130519
2020-11-18,India,IN,38617,474,1366417756,Asia,8912907,130993
2020-11-19,India,IN,45576,585,1366417756,Asia,8958483,131578
2020-11-20,India,IN,45882,584,1366417756,Asia,9004365,132162
2020-11-21,India,IN,46232,564,1366417756,Asia,9050597,132726
2020-11-22,India,IN,45209,501,1366417756,Asia,9095806,133227
2020-11-23,India,IN,44059,511,1366417756,Asia,9139865,133738
2020-11-24,India,IN,37975,480,1366417756,Asia,9177840,134218
2020-11-25,India,IN,44376,481,1366417756,Asia,9222216,134699
2020-11-26,India,IN,44489,524,1366417756,Asia,9266705,135223
2020-11-27,India,IN,43082,492,1366417756,Asia,9309787,135715
2020-11-28,India,IN,41322,485,1366417756,Asia,9351109,136200
2020-11-29,India,IN,41810,496,1366417756,Asia,9392919,136696
2020-11-30,India,IN,38772,443,1366417756,Asia,9431691,137139
2020-12-01,India,IN,31118,482,1366417756,Asia,9462809,137621
2020-12-02,India,IN,36604,501,1366417756,Asia,9499413,138122
2020-12-03,India,IN,35551,526,1366417756,Asia,9534964,138648
2020-12-04,India,IN,36595,540,1366417756,Asia,9571559,139188
2020-12-05,India,IN,36652,512,1366417756,Asia,9608211,139700
2020-12-06,India,IN,36011,482,1366417756,Asia,9644222,140182
2020-12-07,India,IN,32981,391,1366417756,Asia,9677203,140573
2020-12-08,India,IN,26567,385,1366417756,Asia,9703770,140958
2020-12-09,India,IN,32080,402,1366417756,Asia,9735850,141360
2020-12-10,India,IN,31521,412,1366417756,Asia,9767371,141772
2020-12-11,India,IN,29398,414,1366417756,Asia,9796769,142186
2020-12-12,India,IN,30006,442,1366417756,Asia,9826775,142628
2020-12-13,India,IN,30254,391,1366417756,Asia,9857029,143019
2020-12-14,India,IN,27071,336,1366417756,Asia,9884100,143355
2019-12-31,Iraq,IQ,0,0,39309789,Asia,0,0
2020-01-01,Iraq,IQ,0,0,39309789,Asia,0,0
2020-01-02,Iraq,IQ,0,0,39309789,Asia,0,0
2020-01-03,Iraq,IQ,0,0,39309789,Asia,0,0
2020-01-04,Iraq,IQ,0,0,39309789,Asia,0,0
2020-01-05,Iraq,IQ,0,0,39309789,Asia,0,0
2020-01-06,Iraq,IQ,0,0,39309789,Asia,0,0
2020-01-07,Iraq,IQ,0,0,39309789,Asia,0,0
2020-01-08,Iraq,IQ,0,0,39309789,Asia,0,0
2020-01-09,Iraq,IQ,0,0,39309789,Asia,0,0
2020-01-10,Iraq,IQ,0,0,39309789,Asia,0,0
2020-01-11,Iraq,IQ,0,0,39309789,Asia,0,0
2020-01-12,Iraq,IQ,0,0,39309789,Asia,0,0
2020-01-13,Iraq,IQ,0,0,39309789,Asia,0,0
2020-01-14,Iraq,IQ,0,0,39309789,Asia,0,0
2020-01-15,Iraq,IQ,0,0,39309789,Asia,0,0
2020-01-16,Iraq,IQ,0,0,39309789,Asia,0,0
2020-01-17,Iraq,IQ,0,0,39309789,Asia,0,0
2020-01-18,Iraq,IQ,0,0,39309789,Asia,0,0
2020-01-19,Iraq,IQ,0,0,39309789,Asia,0,0
2020-01-20,Iraq,IQ,0,0,39309789,Asia,0,0
2020-01-21,Iraq,IQ,0,0,39309789,Asia,0,0
2020-01-22,Iraq,IQ,0,0,39309789,Asia,0,0
2020-01-23,Iraq,IQ,0,0,39309789,Asia,0,0
2020-01-24,Iraq,IQ,0,0,39309789,Asia,0,0
2020-01-25,Iraq,IQ,0,0,39309789,Asia,0,0
2020-01-26,Iraq,IQ,0,0,39309789,Asia,0,0
2020-01-27,Iraq,IQ,0,0,39309789,Asia,0,0
2020-01-28,Iraq,IQ,0,0,39309789,Asia,0,0
2020-01-29,Iraq,IQ,0,0,39309789,Asia,0,0
2020-01-30,Iraq,IQ,0,0,39309789,Asia,0,0
2020-01-31,Iraq,IQ,0,0,39309789,Asia,0,0
2020-02-01,Iraq,IQ,0,0,39309789,Asia,0,0
2020-02-02,Iraq,IQ,0,0,39309789,Asia,0,0
2020-02-03,Iraq,IQ,0,0,39309789,Asia,0,0
2020-02-04,Iraq,IQ,0,0,39309789,Asia,0,0
2020-02-05,Iraq,IQ,0,0,39309789,Asia,0,0
2020-02-06,Iraq,IQ,0,0,39309789,Asia,0,0
2020-02-07,Iraq,IQ,0,0,39309789,Asia,0,0
2020-02-08,Iraq,IQ,0,0,39309789,Asia,0,0
2020-02-09,Iraq,IQ,0,0,39309789,Asia,0,0
2020-02-10,Iraq,IQ,0,0,39309789,Asia,0,0
2020-02-11,Iraq,IQ,0,0,39309789,Asia,0,0
2020-02-12,Iraq,IQ,0,0,39309789,Asia,0,0
2020-02-13,Iraq,IQ,0,0,39309789,Asia,0,0
2020-02-14,Iraq,IQ,0,0,39309789,Asia,0,0
2020-02-15,Iraq,IQ,0,0,39309789,Asia,0,0
2020-02-16,Iraq,IQ,0,0,39309789,Asia,0,0
2020-02-17,Iraq,IQ,0,0,39309789,Asia,0,0
2020-02-18,Iraq,IQ,0,0,39309789,Asia,0,0
2020-02-19,Iraq,IQ,0,0,39309789,Asia,0,0
2020-02-20,Iraq,IQ,0,0,39309789,Asia,0,0
2020-02-21,Iraq,IQ,0,0,39309789,Asia,0,0
2020-02-22,Iraq,IQ,0,0,39309789,Asia,0,0
2020-02-23,Iraq,IQ,0,0,39309789,Asia,0,0
2020-02-24,Iraq,IQ,0,0,39309789,Asia,0,0
2020-02-25,Iraq,IQ,1,0,39309789,Asia,1,0
2020-02-26,Iraq,IQ,4,0,39309789,Asia,5,0
2020-02-27,Iraq,IQ,0,0,39309789,Asia,5,0
2020-02-28,Iraq,IQ,1,0,39309789,Asia,6,0
2020-02-29,Iraq,IQ,1,0,39309789,Asia,7,0
2020-03-01,Iraq,IQ,6,0,39309789,Asia,13,0
2020-03-02,Iraq,IQ,6,0,39309789,Asia,19,0
2020-03-03,Iraq,IQ,2,0,39309789,Asia,21,0
2020-03-04,Iraq,IQ,5,0,39309789,Asia,26,0
2020-03-05,Iraq,IQ,5,0,39309789,Asia,31,0
2020-03-06,Iraq,IQ,7,2,39309789,Asia,38,2
2020-03-08,Iraq,IQ,16,0,39309789,Asia,54,2
2020-03-09,Iraq,IQ,7,4,39309789,Asia,61,6
2020-03-11,Iraq,IQ,0,0,39309789,Asia,61,6
2020-03-12,Iraq,IQ,9,2,39309789,Asia,70,8
2020-03-13,Iraq,IQ,4,0,39309789,Asia,74,8
2020-03-14,Iraq,IQ,11,1,39309789,Asia,85,9
2020-03-15,Iraq,IQ,0,0,39309789,Asia,85,9
2020-03-16,Iraq,IQ,39,0,39309789,Asia,124,9
2020-03-17,Iraq,IQ,0,0,39309789,Asia,124,9
2020-03-18,Iraq,IQ,30,2,39309789,Asia,154,11
2020-03-19,Iraq,IQ,10,1,39309789,Asia,164,12
2020-03-20,Iraq,IQ,13,0,39309789,Asia,177,12
2020-03-21,Iraq,IQ,16,2,39309789,Asia,193,14
2020-03-22,Iraq,IQ,21,3,39309789,Asia,214,17
2020-03-23,Iraq,IQ,19,3,39309789,Asia,233,20
2020-03-24,Iraq,IQ,33,3,39309789,Asia,266,23
2020-03-25,Iraq,IQ,50,4,39309789,Asia,316,27
2020-03-26,Iraq,IQ,30,2,39309789,Asia,346,29
2020-03-27,Iraq,IQ,36,7,39309789,Asia,382,36
2020-03-28,Iraq,IQ,76,4,39309789,Asia,458,40
2020-03-29,Iraq,IQ,48,2,39309789,Asia,506,42
2020-03-30,Iraq,IQ,41,0,39309789,Asia,547,42
2020-03-31,Iraq,IQ,83,4,39309789,Asia,630,46
2020-04-01,Iraq,IQ,64,4,39309789,Asia,694,50
2020-04-02,Iraq,IQ,0,0,39309789,Asia,694,50
2020-04-03,Iraq,IQ,78,4,39309789,Asia,772,54
2020-04-04,Iraq,IQ,0,0,39309789,Asia,772,54
2020-04-05,Iraq,IQ,106,2,39309789,Asia,878,56
2020-04-06,Iraq,IQ,83,5,39309789,Asia,961,61
2020-04-07,Iraq,IQ,70,3,39309789,Asia,1031,64
2020-04-08,Iraq,IQ,0,0,39309789,Asia,1031,64
2020-04-09,Iraq,IQ,171,5,39309789,Asia,1202,69
2020-04-10,Iraq,IQ,30,0,39309789,Asia,1232,69
2020-04-11,Iraq,IQ,47,1,39309789,Asia,1279,70
2020-04-12,Iraq,IQ,39,2,39309789,Asia,1318,72
2020-04-13,Iraq,IQ,34,4,39309789,Asia,1352,76
2020-04-14,Iraq,IQ,26,2,39309789,Asia,1378,78
2020-04-15,Iraq,IQ,22,0,39309789,Asia,1400,78
2020-04-16,Iraq,IQ,15,1,39309789,Asia,1415,79
2020-04-17,Iraq,IQ,19,1,39309789,Asia,1434,80
2020-04-18,Iraq,IQ,48,1,39309789,Asia,1482,81
2020-04-19,Iraq,IQ,0,0,39309789,Asia,1482,81
2020-04-20,Iraq,IQ,57,1,39309789,Asia,1539,82
2020-04-21,Iraq,IQ,35,0,39309789,Asia,1574,82
2020-04-22,Iraq,IQ,28,1,39309789,Asia,1602,83
2020-04-23,Iraq,IQ,0,0,39309789,Asia,1602,83
2020-04-24,Iraq,IQ,75,0,39309789,Asia,1677,83
2020-04-25,Iraq,IQ,31,3,39309789,Asia,1708,86
2020-04-26,Iraq,IQ,55,0,39309789,Asia,1763,86
2020-04-27,Iraq,IQ,57,1,39309789,Asia,1820,87
2020-04-28,Iraq,IQ,27,1,39309789,Asia,1847,88
2020-04-29,Iraq,IQ,0,0,39309789,Asia,1847,88
2020-04-30,Iraq,IQ,156,4,39309789,Asia,2003,92
2020-05-01,Iraq,IQ,82,1,39309789,Asia,2085,93
2020-05-02,Iraq,IQ,68,1,39309789,Asia,2153,94
2020-05-03,Iraq,IQ,66,1,39309789,Asia,2219,95
2020-05-04,Iraq,IQ,77,2,39309789,Asia,2296,97
2020-05-05,Iraq,IQ,50,1,39309789,Asia,2346,98
2020-05-06,Iraq,IQ,85,4,39309789,Asia,2431,102
2020-05-07,Iraq,IQ,49,0,39309789,Asia,2480,102
2020-05-08,Iraq,IQ,63,0,39309789,Asia,2543,102
2020-05-09,Iraq,IQ,60,2,39309789,Asia,2603,104
2020-05-10,Iraq,IQ,76,3,39309789,Asia,2679,107
2020-05-11,Iraq,IQ,88,2,39309789,Asia,2767,109
2020-05-12,Iraq,IQ,51,1,39309789,Asia,2818,110
2020-05-13,Iraq,IQ,95,2,39309789,Asia,2913,112
2020-05-14,Iraq,IQ,119,3,39309789,Asia,3032,115
2020-05-15,Iraq,IQ,111,0,39309789,Asia,3143,115
2020-05-16,Iraq,IQ,50,2,39309789,Asia,3193,117
2020-05-17,Iraq,IQ,67,4,39309789,Asia,3260,121
2020-05-18,Iraq,IQ,144,2,39309789,Asia,3404,123
2020-05-19,Iraq,IQ,150,4,39309789,Asia,3554,127
2020-05-20,Iraq,IQ,57,4,39309789,Asia,3611,131
2020-05-21,Iraq,IQ,113,3,39309789,Asia,3724,134
2020-05-22,Iraq,IQ,153,6,39309789,Asia,3877,140
2020-05-23,Iraq,IQ,87,7,39309789,Asia,3964,147
2020-05-24,Iraq,IQ,308,5,39309789,Asia,4272,152
2020-05-25,Iraq,IQ,197,8,39309789,Asia,4469,160
2020-05-26,Iraq,IQ,163,3,39309789,Asia,4632,163
2020-05-27,Iraq,IQ,216,6,39309789,Asia,4848,169
2020-05-28,Iraq,IQ,287,6,39309789,Asia,5135,175
2020-05-29,Iraq,IQ,322,4,39309789,Asia,5457,179
2020-05-30,Iraq,IQ,416,6,39309789,Asia,5873,185
2020-05-31,Iraq,IQ,306,10,39309789,Asia,6179,195
2020-06-01,Iraq,IQ,260,10,39309789,Asia,6439,205
2020-06-02,Iraq,IQ,429,10,39309789,Asia,6868,215
2020-06-03,Iraq,IQ,519,20,39309789,Asia,7387,235
2020-06-04,Iraq,IQ,781,21,39309789,Asia,8168,256
2020-06-05,Iraq,IQ,672,15,39309789,Asia,8840,271
2020-06-06,Iraq,IQ,1006,14,39309789,Asia,9846,285
2020-06-07,Iraq,IQ,1252,33,39309789,Asia,11098,318
2020-06-08,Iraq,IQ,1268,28,39309789,Asia,12366,346
2020-06-09,Iraq,IQ,1115,24,39309789,Asia,13481,370
2020-06-10,Iraq,IQ,787,22,39309789,Asia,14268,392
2020-06-11,Iraq,IQ,1146,34,39309789,Asia,15414,426
2020-06-12,Iraq,IQ,1261,31,39309789,Asia,16675,457
2020-06-13,Iraq,IQ,1095,39,39309789,Asia,17770,496
2020-06-14,Iraq,IQ,1180,53,39309789,Asia,18950,549
2020-06-15,Iraq,IQ,1259,58,39309789,Asia,20209,607
2020-06-16,Iraq,IQ,1106,45,39309789,Asia,21315,652
2020-06-17,Iraq,IQ,1385,60,39309789,Asia,22700,712
2020-06-18,Iraq,IQ,1554,61,39309789,Asia,24254,773
2020-06-19,Iraq,IQ,1463,83,39309789,Asia,25717,856
2020-06-20,Iraq,IQ,1635,69,39309789,Asia,27352,925
2020-06-21,Iraq,IQ,1870,88,39309789,Asia,29222,1013
2020-06-22,Iraq,IQ,1646,87,39309789,Asia,30868,1100
2020-06-23,Iraq,IQ,1808,67,39309789,Asia,32676,1167
2020-06-24,Iraq,IQ,1826,84,39309789,Asia,34502,1251
2020-06-25,Iraq,IQ,2200,79,39309789,Asia,36702,1330
2020-06-26,Iraq,IQ,2437,107,39309789,Asia,39139,1437
2020-06-27,Iraq,IQ,2054,122,39309789,Asia,41193,1559
2020-06-28,Iraq,IQ,2069,101,39309789,Asia,43262,1660
2020-06-29,Iraq,IQ,2140,96,39309789,Asia,45402,1756
2020-06-30,Iraq,IQ,1749,83,39309789,Asia,47151,1839
2020-07-01,Iraq,IQ,1958,104,39309789,Asia,49109,1943
2020-07-02,Iraq,IQ,2415,107,39309789,Asia,51524,2050
2020-07-03,Iraq,IQ,2184,110,39309789,Asia,53708,2160
2020-07-04,Iraq,IQ,2312,102,39309789,Asia,56020,2262
2020-07-05,Iraq,IQ,2334,106,39309789,Asia,58354,2368
2020-07-06,Iraq,IQ,2125,105,39309789,Asia,60479,2473
2020-07-07,Iraq,IQ,1796,94,39309789,Asia,62275,2567
2020-07-08,Iraq,IQ,2426,118,39309789,Asia,64701,2685
2020-07-09,Iraq,IQ,2741,94,39309789,Asia,67442,2779
2020-07-10,Iraq,IQ,2170,103,39309789,Asia,69612,2882
2020-07-11,Iraq,IQ,2848,78,39309789,Asia,72460,2960
2020-07-12,Iraq,IQ,2734,95,39309789,Asia,75194,3055
2020-07-13,Iraq,IQ,2312,95,39309789,Asia,77506,3150
2020-07-14,Iraq,IQ,2229,100,39309789,Asia,79735,3250
2020-07-15,Iraq,IQ,2022,95,39309789,Asia,81757,3345
2020-07-16,Iraq,IQ,2110,87,39309789,Asia,83867,3432
2020-07-17,Iraq,IQ,2281,90,39309789,Asia,86148,3522
2020-07-18,Iraq,IQ,2023,94,39309789,Asia,88171,3616
2020-07-19,Iraq,IQ,2049,75,39309789,Asia,90220,3691
2020-07-20,Iraq,IQ,2310,90,39309789,Asia,92530,3781
2020-07-21,Iraq,IQ,2163,88,39309789,Asia,94693,3869
2020-07-22,Iraq,IQ,2466,81,39309789,Asia,97159,3950
2020-07-23,Iraq,IQ,2706,92,39309789,Asia,99865,4042
2020-07-24,Iraq,IQ,2361,80,39309789,Asia,102226,4122
2020-07-25,Iraq,IQ,2485,90,39309789,Asia,104711,4212
2020-07-26,Iraq,IQ,2862,72,39309789,Asia,107573,4284
2020-07-27,Iraq,IQ,2459,78,39309789,Asia,110032,4362
2020-07-28,Iraq,IQ,2553,96,39309789,Asia,112585,4458
2020-07-29,Iraq,IQ,2747,77,39309789,Asia,115332,4535
2020-07-30,Iraq,IQ,2968,68,39309789,Asia,118300,4603
2020-07-31,Iraq,IQ,2963,68,39309789,Asia,121263,4671
2020-08-01,Iraq,IQ,3346,70,39309789,Asia,124609,4741
2020-08-02,Iraq,IQ,2095,64,39309789,Asia,126704,4805
2020-08-03,Iraq,IQ,2447,63,39309789,Asia,129151,4868
2020-08-04,Iraq,IQ,2735,66,39309789,Asia,131886,4934
2020-08-05,Iraq,IQ,2836,83,39309789,Asia,134722,5017
2020-08-06,Iraq,IQ,2834,77,39309789,Asia,137556,5094
2020-08-07,Iraq,IQ,3047,67,39309789,Asia,140603,5161
2020-08-08,Iraq,IQ,3461,75,39309789,Asia,144064,5236
2020-08-09,Iraq,IQ,3325,74,39309789,Asia,147389,5310
2020-08-10,Iraq,IQ,2726,82,39309789,Asia,150115,5392
2020-08-11,Iraq,IQ,3484,72,39309789,Asia,153599,5464
2020-08-12,Iraq,IQ,3396,67,39309789,Asia,156995,5531
2020-08-13,Iraq,IQ,3441,57,39309789,Asia,160436,5588
2020-08-14,Iraq,IQ,3841,53,39309789,Asia,164277,5641
2020-08-15,Iraq,IQ,4013,68,39309789,Asia,168290,5709
2020-08-16,Iraq,IQ,4293,76,39309789,Asia,172583,5785
2020-08-17,Iraq,IQ,4348,75,39309789,Asia,176931,5860
2020-08-18,Iraq,IQ,3202,94,39309789,Asia,180133,5954
2020-08-19,Iraq,IQ,4576,82,39309789,Asia,184709,6036
2020-08-20,Iraq,IQ,4093,85,39309789,Asia,188802,6121
2020-08-21,Iraq,IQ,3995,87,39309789,Asia,192797,6208
2020-08-22,Iraq,IQ,4288,75,39309789,Asia,197085,6283
2020-08-23,Iraq,IQ,3965,70,39309789,Asia,201050,6353
2020-08-24,Iraq,IQ,3291,75,39309789,Asia,204341,6428
2020-08-25,Iraq,IQ,3644,91,39309789,Asia,207985,6519
2020-08-26,Iraq,IQ,3962,77,39309789,Asia,211947,6596
2020-08-27,Iraq,IQ,3837,72,39309789,Asia,215784,6668
2020-08-28,Iraq,IQ,3651,72,39309789,Asia,219435,6740
2020-08-29,Iraq,IQ,4177,74,39309789,Asia,223612,6814
2020-08-30,Iraq,IQ,3834,77,39309789,Asia,227446,6891
2020-08-31,Iraq,IQ,3731,68,39309789,Asia,231177,6959
2020-09-01,Iraq,IQ,3757,83,39309789,Asia,234934,7042
2020-09-02,Iraq,IQ,3404,81,39309789,Asia,238338,7123
2020-09-03,Iraq,IQ,3946,78,39309789,Asia,242284,7201
2020-09-04,Iraq,IQ,4755,74,39309789,Asia,247039,7275
2020-09-05,Iraq,IQ,5036,84,39309789,Asia,252075,7359
2020-09-06,Iraq,IQ,4644,63,39309789,Asia,256719,7422
2020-09-07,Iraq,IQ,3651,90,39309789,Asia,260370,7512
2020-09-08,Iraq,IQ,4314,77,39309789,Asia,264684,7589
2020-09-09,Iraq,IQ,4894,68,39309789,Asia,269578,7657
2020-09-10,Iraq,IQ,4243,75,39309789,Asia,273821,7732
2020-09-11,Iraq,IQ,4597,82,39309789,Asia,278418,7814
2020-09-12,Iraq,IQ,4254,67,39309789,Asia,282672,7881
2020-09-13,Iraq,IQ,4106,60,39309789,Asia,286778,7941
2020-09-14,Iraq,IQ,3531,73,39309789,Asia,290309,8014
2020-09-15,Iraq,IQ,4169,72,39309789,Asia,294478,8086
2020-09-16,Iraq,IQ,4224,80,39309789,Asia,298702,8166
2020-09-17,Iraq,IQ,4357,82,39309789,Asia,303059,8248
2020-09-18,Iraq,IQ,4326,84,39309789,Asia,307385,8332
2020-09-19,Iraq,IQ,4305,76,39309789,Asia,311690,8408
2020-09-20,Iraq,IQ,3907,83,39309789,Asia,315597,8491
2020-09-21,Iraq,IQ,3438,64,39309789,Asia,319035,8555
2020-09-22,Iraq,IQ,3821,70,39309789,Asia,322856,8625
2020-09-23,Iraq,IQ,4724,57,39309789,Asia,327580,8682
2020-09-24,Iraq,IQ,5055,72,39309789,Asia,332635,8754
2020-09-25,Iraq,IQ,4471,45,39309789,Asia,337106,8799
2020-09-26,Iraq,IQ,4593,68,39309789,Asia,341699,8867
2020-09-27,Iraq,IQ,4270,68,39309789,Asia,345969,8935
2020-09-28,Iraq,IQ,3481,55,39309789,Asia,349450,8990
2020-09-29,Iraq,IQ,4116,62,39309789,Asia,353566,9052
2020-09-30,Iraq,IQ,4724,70,39309789,Asia,358290,9122
2020-10-01,Iraq,IQ,4691,59,39309789,Asia,362981,9181
2020-10-02,Iraq,IQ,4493,50,39309789,Asia,367474,9231
2020-10-03,Iraq,IQ,4785,67,39309789,Asia,372259,9298
2020-10-04,Iraq,IQ,3672,49,39309789,Asia,375931,9347
2020-10-05,Iraq,IQ,3210,52,39309789,Asia,379141,9399
2020-10-06,Iraq,IQ,3808,65,39309789,Asia,382949,9464
2020-10-07,Iraq,IQ,4172,67,39309789,Asia,387121,9531
2020-10-08,Iraq,IQ,3923,73,39309789,Asia,391044,9604
2020-10-09,Iraq,IQ,3522,79,39309789,Asia,394566,9683
2020-10-10,Iraq,IQ,3214,52,39309789,Asia,397780,9735
2020-10-11,Iraq,IQ,2344,55,39309789,Asia,400124,9790
2020-10-12,Iraq,IQ,2206,62,39309789,Asia,402330,9852
2020-10-13,Iraq,IQ,3107,60,39309789,Asia,405437,9912
2020-10-14,Iraq,IQ,3921,58,39309789,Asia,409358,9970
2020-10-15,Iraq,IQ,3857,51,39309789,Asia,413215,10021
2020-10-16,Iraq,IQ,3587,65,39309789,Asia,416802,10086
2020-10-17,Iraq,IQ,3501,56,39309789,Asia,420303,10142
2020-10-18,Iraq,IQ,3221,56,39309789,Asia,423524,10198
2020-10-19,Iraq,IQ,3110,56,39309789,Asia,426634,10254
2020-10-20,Iraq,IQ,4044,63,39309789,Asia,430678,10317
2020-10-21,Iraq,IQ,3920,49,39309789,Asia,434598,10366
2020-10-22,Iraq,IQ,3667,52,39309789,Asia,438265,10418
2020-10-23,Iraq,IQ,3899,47,39309789,Asia,442164,10465
2020-10-24,Iraq,IQ,3785,48,39309789,Asia,445949,10513
2020-10-25,Iraq,IQ,3204,55,39309789,Asia,449153,10568
2020-10-26,Iraq,IQ,2554,55,39309789,Asia,451707,10623
2020-10-27,Iraq,IQ,3691,48,39309789,Asia,455398,10671
2020-10-28,Iraq,IQ,4510,53,39309789,Asia,459908,10724
2020-10-29,Iraq,IQ,4043,46,39309789,Asia,463951,10770
2020-10-30,Iraq,IQ,3804,45,39309789,Asia,467755,10815
2020-10-31,Iraq,IQ,2878,47,39309789,Asia,470633,10862
2020-11-01,Iraq,IQ,1997,48,39309789,Asia,472630,10910
2020-11-02,Iraq,IQ,2658,56,39309789,Asia,475288,10966
2020-11-03,Iraq,IQ,3413,51,39309789,Asia,478701,11017
2020-11-04,Iraq,IQ,3595,51,39309789,Asia,482296,11068
2020-11-05,Iraq,IQ,3574,60,39309789,Asia,485870,11128
2020-11-06,Iraq,IQ,3701,47,39309789,Asia,489571,11175
2020-11-07,Iraq,IQ,3568,69,39309789,Asia,493139,11244
2020-11-08,Iraq,IQ,2880,39,39309789,Asia,496019,11283
2020-11-09,Iraq,IQ,2530,44,39309789,Asia,498549,11327
2020-11-10,Iraq,IQ,3184,53,39309789,Asia,501733,11380
2020-11-11,Iraq,IQ,3577,52,39309789,Asia,505310,11432
2020-11-12,Iraq,IQ,3198,50,39309789,Asia,508508,11482
2020-11-13,Iraq,IQ,3298,50,39309789,Asia,511806,11532
2020-11-14,Iraq,IQ,2690,48,39309789,Asia,514496,11580
2020-11-15,Iraq,IQ,2419,43,39309789,Asia,516915,11623
2020-11-16,Iraq,IQ,2237,47,39309789,Asia,519152,11670
2020-11-17,Iraq,IQ,2390,42,39309789,Asia,521542,11712
2020-11-18,Iraq,IQ,2961,40,39309789,Asia,524503,11752
2020-11-19,Iraq,IQ,2349,43,39309789,Asia,526852,11795
2020-11-20,Iraq,IQ,2374,39,39309789,Asia,529226,11834
2020-11-21,Iraq,IQ,2543,49,39309789,Asia,531769,11883
2020-11-22,Iraq,IQ,1786,42,39309789,Asia,533555,11925
2020-11-23,Iraq,IQ,1766,33,39309789,Asia,535321,11958
2020-11-24,Iraq,IQ,2136,38,39309789,Asia,537457,11996
2020-11-25,Iraq,IQ,2292,35,39309789,Asia,539749,12031
2020-11-26,Iraq,IQ,2438,55,39309789,Asia,542187,12086
2020-11-27,Iraq,IQ,2483,39,39309789,Asia,544670,12125
2020-11-28,Iraq,IQ,2545,42,39309789,Asia,547215,12167
2020-11-29,Iraq,IQ,1606,33,39309789,Asia,548821,12200
2020-11-30,Iraq,IQ,1614,24,39309789,Asia,550435,12224
2020-12-01,Iraq,IQ,2114,34,39309789,Asia,552549,12258
2020-12-02,Iraq,IQ,2218,48,39309789,Asia,554767,12306
2020-12-03,Iraq,IQ,1961,34,39309789,Asia,556728,12340
2020-12-04,Iraq,IQ,2039,21,39309789,Asia,558767,12361
2020-12-05,Iraq,IQ,1855,26,39309789,Asia,560622,12387
2020-12-06,Iraq,IQ,1898,24,39309789,Asia,562520,12411
2020-12-07,Iraq,IQ,1680,21,39309789,Asia,564200,12432
2020-12-08,Iraq,IQ,1815,28,39309789,Asia,566015,12460
2020-12-09,Iraq,IQ,2123,17,39309789,Asia,568138,12477
2020-12-10,Iraq,IQ,1735,24,39309789,Asia,569873,12501
2020-12-11,Iraq,IQ,1380,25,39309789,Asia,571253,12526
2020-12-12,Iraq,IQ,1347,23,39309789,Asia,572600,12549
2020-12-13,Iraq,IQ,1022,16,39309789,Asia,573622,12565
2020-12-14,Iraq,IQ,1012,14,39309789,Asia,574634,12579
2019-12-31,Iran,IR,0,0,82913893,Asia,0,0
2020-01-01,Iran,IR,0,0,82913893,Asia,0,0
2020-01-02,Iran,IR,0,0,82913893,Asia,0,0
2020-01-03,Iran,IR,0,0,82913893,Asia,0,0
2020-01-04,Iran,IR,0,0,82913893,Asia,0,0
2020-01-05,Iran,IR,0,0,82913893,Asia,0,0
2020-01-06,Iran,IR,0,0,82913893,Asia,0,0
2020-01-07,Iran,IR,0,0,82913893,Asia,0,0
2020-01-08,Iran,IR,0,0,82913893,Asia,0,0
2020-01-09,Iran,IR,0,0,82913893,Asia,0,0
2020-01-10,Iran,IR,0,0,82913893,Asia,0,0
2020-01-11,Iran,IR,0,0,82913893,Asia,0,0
2020-01-12,Iran,IR,0,0,82913893,Asia,0,0
2020-01-13,Iran,IR,0,0,82913893,Asia,0,0
2020-01-14,Iran,IR,0,0,82913893,Asia,0,0
2020-01-15,Iran,IR,0,0,82913893,Asia,0,0
2020-01-16,Iran,IR,0,0,82913893,Asia,0,0
2020-01-17,Iran,IR,0,0,82913893,Asia,0,0
2020-01-18,Iran,IR,0,0,82913893,Asia,0,0
2020-01-19,Iran,IR,0,0,82913893,Asia,0,0
2020-01-20,Iran,IR,0,0,82913893,Asia,0,0
2020-01-21,Iran,IR,0,0,82913893,Asia,0,0
2020-01-22,Iran,IR,0,0,82913893,Asia,0,0
2020-01-23,Iran,IR,0,0,82913893,Asia,0,0
2020-01-24,Iran,IR,0,0,82913893,Asia,0,0
2020-01-25,Iran,IR,0,0,82913893,Asia,0,0
2020-01-26,Iran,IR,0,0,82913893,Asia,0,0
2020-01-27,Iran,IR,0,0,82913893,Asia,0,0
2020-01-28,Iran,IR,0,0,82913893,Asia,0,0
2020-01-29,Iran,IR,0,0,82913893,Asia,0,0
2020-01-30,Iran,IR,0,0,82913893,Asia,0,0
2020-01-31,Iran,IR,0,0,82913893,Asia,0,0
2020-02-01,Iran,IR,0,0,82913893,Asia,0,0
2020-02-02,Iran,IR,0,0,82913893,Asia,0,0
2020-02-03,Iran,IR,0,0,82913893,Asia,0,0
2020-02-04,Iran,IR,0,0,82913893,Asia,0,0
2020-02-05,Iran,IR,0,0,82913893,Asia,0,0
2020-02-06,Iran,IR,0,0,82913893,Asia,0,0
2020-02-07,Iran,IR,0,0,82913893,Asia,0,0
2020-02-08,Iran,IR,0,0,82913893,Asia,0,0
2020-02-09,Iran,IR,0,0,82913893,Asia,0,0
2020-02-10,Iran,IR,0,0,82913893,Asia,0,0
2020-02-11,Iran,IR,0,0,82913893,Asia,0,0
2020-02-12,Iran,IR,0,0,82913893,Asia,0,0
2020-02-13,Iran,IR,0,0,82913893,Asia,0,0
2020-02-14,Iran,IR,0,0,82913893,Asia,0,0
2020-02-15,Iran,IR,0,0,82913893,Asia,0,0
2020-02-16,Iran,IR,0,0,82913893,Asia,0,0
2020-02-17,Iran,IR,0,0,82913893,Asia,0,0
2020-02-18,Iran,IR,0,0,82913893,Asia,0,0
2020-02-19,Iran,IR,0,0,82913893,Asia,0,0
2020-02-20,Iran,IR,2,2,82913893,Asia,2,2
2020-02-21,Iran,IR,3,0,82913893,Asia,5,2
2020-02-22,Iran,IR,13,2,82913893,Asia,18,4
2020-02-23,Iran,IR,10,1,82913893,Asia,28,5
2020-02-24,Iran,IR,15,3,82913893,Asia,43,8
2020-02-25,Iran,IR,18,4,82913893,Asia,61,12
2020-02-26,Iran,IR,34,3,82913893,Asia,95,15
2020-02-27,Iran,IR,44,4,82913893,Asia,139,19
2020-02-28,Iran,IR,106,7,82913893,Asia,245,26
2020-02-29,Iran,IR,143,8,82913893,Asia,388,34
2020-03-01,Iran,IR,205,9,82913893,Asia,593,43
2020-03-02,Iran,IR,385,11,82913893,Asia,978,54
2020-03-03,Iran,IR,523,12,82913893,Asia,1501,66
2020-03-04,Iran,IR,835,11,82913893,Asia,2336,77
2020-03-05,Iran,IR,586,15,82913893,Asia,2922,92
2020-03-06,Iran,IR,591,15,82913893,Asia,3513,107
2020-03-07,Iran,IR,1234,17,82913893,Asia,4747,124
2020-03-08,Iran,IR,1076,21,82913893,Asia,5823,145
2020-03-09,Iran,IR,743,49,82913893,Asia,6566,194
2020-03-10,Iran,IR,595,43,82913893,Asia,7161,237
2020-03-11,Iran,IR,881,54,82913893,Asia,8042,291
2020-03-12,Iran,IR,958,63,82913893,Asia,9000,354
2020-03-13,Iran,IR,1075,75,82913893,Asia,10075,429
2020-03-14,Iran,IR,1289,85,82913893,Asia,11364,514
2020-03-15,Iran,IR,1365,97,82913893,Asia,12729,611
2020-03-16,Iran,IR,1209,113,82913893,Asia,13938,724
2020-03-17,Iran,IR,1053,129,82913893,Asia,14991,853
2020-03-18,Iran,IR,1178,135,82913893,Asia,16169,988
2020-03-19,Iran,IR,1192,147,82913893,Asia,17361,1135
2020-03-20,Iran,IR,1046,149,82913893,Asia,18407,1284
2020-03-21,Iran,IR,1237,149,82913893,Asia,19644,1433
2020-03-22,Iran,IR,966,123,82913893,Asia,20610,1556
2020-03-23,Iran,IR,1028,129,82913893,Asia,21638,1685
2020-03-24,Iran,IR,1411,127,82913893,Asia,23049,1812
2020-03-25,Iran,IR,1762,122,82913893,Asia,24811,1934
2020-03-26,Iran,IR,2206,143,82913893,Asia,27017,2077
2020-03-27,Iran,IR,2389,157,82913893,Asia,29406,2234
2020-03-28,Iran,IR,2926,144,82913893,Asia,32332,2378
2020-03-29,Iran,IR,3076,139,82913893,Asia,35408,2517
2020-03-30,Iran,IR,2901,123,82913893,Asia,38309,2640
2020-03-31,Iran,IR,3186,117,82913893,Asia,41495,2757
2020-04-01,Iran,IR,3111,141,82913893,Asia,44606,2898
2020-04-02,Iran,IR,2987,138,82913893,Asia,47593,3036
2020-04-03,Iran,IR,2875,124,82913893,Asia,50468,3160
2020-04-04,Iran,IR,0,0,82913893,Asia,50468,3160
2020-04-05,Iran,IR,5275,292,82913893,Asia,55743,3452
2020-04-06,Iran,IR,2483,151,82913893,Asia,58226,3603
2020-04-07,Iran,IR,2274,136,82913893,Asia,60500,3739
2020-04-08,Iran,IR,2089,133,82913893,Asia,62589,3872
2020-04-09,Iran,IR,1997,121,82913893,Asia,64586,3993
2020-04-10,Iran,IR,1634,117,82913893,Asia,66220,4110
2020-04-11,Iran,IR,1972,122,82913893,Asia,68192,4232
2020-04-12,Iran,IR,1837,125,82913893,Asia,70029,4357
2020-04-13,Iran,IR,1657,117,82913893,Asia,71686,4474
2020-04-14,Iran,IR,1617,111,82913893,Asia,73303,4585
2020-04-15,Iran,IR,1574,98,82913893,Asia,74877,4683
2020-04-16,Iran,IR,1512,94,82913893,Asia,76389,4777
2020-04-17,Iran,IR,1606,92,82913893,Asia,77995,4869
2020-04-18,Iran,IR,1499,89,82913893,Asia,79494,4958
2020-04-19,Iran,IR,1374,73,82913893,Asia,80868,5031
2020-04-20,Iran,IR,1343,87,82913893,Asia,82211,5118
2020-04-21,Iran,IR,1294,91,82913893,Asia,83505,5209
2020-04-22,Iran,IR,1297,88,82913893,Asia,84802,5297
2020-04-23,Iran,IR,1194,94,82913893,Asia,85996,5391
2020-04-24,Iran,IR,1030,90,82913893,Asia,87026,5481
2020-04-25,Iran,IR,1168,93,82913893,Asia,88194,5574
2020-04-26,Iran,IR,1134,76,82913893,Asia,89328,5650
2020-04-27,Iran,IR,1153,60,82913893,Asia,90481,5710
2020-04-28,Iran,IR,991,96,82913893,Asia,91472,5806
2020-04-29,Iran,IR,1112,71,82913893,Asia,92584,5877
2020-04-30,Iran,IR,1073,80,82913893,Asia,93657,5957
2020-05-01,Iran,IR,983,71,82913893,Asia,94640,6028
2020-05-02,Iran,IR,1006,63,82913893,Asia,95646,6091
2020-05-03,Iran,IR,802,65,82913893,Asia,96448,6156
2020-05-04,Iran,IR,976,47,82913893,Asia,97424,6203
2020-05-05,Iran,IR,1223,74,82913893,Asia,98647,6277
2020-05-06,Iran,IR,1323,63,82913893,Asia,99970,6340
2020-05-07,Iran,IR,1680,78,82913893,Asia,101650,6418
2020-05-08,Iran,IR,1485,68,82913893,Asia,103135,6486
2020-05-09,Iran,IR,1556,55,82913893,Asia,104691,6541
2020-05-10,Iran,IR,1529,48,82913893,Asia,106220,6589
2020-05-11,Iran,IR,1383,51,82913893,Asia,107603,6640
2020-05-12,Iran,IR,1683,45,82913893,Asia,109286,6685
2020-05-13,Iran,IR,1481,48,82913893,Asia,110767,6733
2020-05-14,Iran,IR,1958,50,82913893,Asia,112725,6783
2020-05-15,Iran,IR,1808,71,82913893,Asia,114533,6854
2020-05-16,Iran,IR,2102,48,82913893,Asia,116635,6902
2020-05-17,Iran,IR,1757,35,82913893,Asia,118392,6937
2020-05-18,Iran,IR,1806,51,82913893,Asia,120198,6988
2020-05-19,Iran,IR,2294,69,82913893,Asia,122492,7057
2020-05-20,Iran,IR,2111,62,82913893,Asia,124603,7119
2020-05-21,Iran,IR,2346,64,82913893,Asia,126949,7183
2020-05-22,Iran,IR,2392,66,82913893,Asia,129341,7249
2020-05-23,Iran,IR,2311,51,82913893,Asia,131652,7300
2020-05-24,Iran,IR,1869,59,82913893,Asia,133521,7359
2020-05-25,Iran,IR,2180,58,82913893,Asia,135701,7417
2020-05-26,Iran,IR,2023,34,82913893,Asia,137724,7451
2020-05-27,Iran,IR,1787,57,82913893,Asia,139511,7508
2020-05-28,Iran,IR,2080,56,82913893,Asia,141591,7564
2020-05-29,Iran,IR,2258,63,82913893,Asia,143849,7627
2020-05-30,Iran,IR,2819,50,82913893,Asia,146668,7677
2020-05-31,Iran,IR,2282,57,82913893,Asia,148950,7734
2020-06-01,Iran,IR,2516,63,82913893,Asia,151466,7797
2020-06-02,Iran,IR,2979,81,82913893,Asia,154445,7878
2020-06-03,Iran,IR,3117,64,82913893,Asia,157562,7942
2020-06-04,Iran,IR,3134,70,82913893,Asia,160696,8012
2020-06-05,Iran,IR,3574,59,82913893,Asia,164270,8071
2020-06-06,Iran,IR,2886,63,82913893,Asia,167156,8134
2020-06-07,Iran,IR,2269,75,82913893,Asia,169425,8209
2020-06-08,Iran,IR,2364,72,82913893,Asia,171789,8281
2020-06-09,Iran,IR,2043,70,82913893,Asia,173832,8351
2020-06-10,Iran,IR,2095,74,82913893,Asia,175927,8425
2020-06-11,Iran,IR,2011,81,82913893,Asia,177938,8506
2020-06-12,Iran,IR,2238,78,82913893,Asia,180176,8584
2020-06-13,Iran,IR,2369,75,82913893,Asia,182545,8659
2020-06-14,Iran,IR,2410,71,82913893,Asia,184955,8730
2020-06-15,Iran,IR,2472,107,82913893,Asia,187427,8837
2020-06-16,Iran,IR,2449,113,82913893,Asia,189876,8950
2020-06-17,Iran,IR,2563,115,82913893,Asia,192439,9065
2020-06-18,Iran,IR,2612,120,82913893,Asia,195051,9185
2020-06-19,Iran,IR,2596,87,82913893,Asia,197647,9272
2020-06-20,Iran,IR,2615,120,82913893,Asia,200262,9392
2020-06-21,Iran,IR,2322,115,82913893,Asia,202584,9507
2020-06-22,Iran,IR,2368,116,82913893,Asia,204952,9623
2020-06-23,Iran,IR,2573,119,82913893,Asia,207525,9742
2020-06-24,Iran,IR,2445,121,82913893,Asia,209970,9863
2020-06-25,Iran,IR,2531,133,82913893,Asia,212501,9996
2020-06-26,Iran,IR,2595,134,82913893,Asia,215096,10130
2020-06-27,Iran,IR,2628,0,82913893,Asia,217724,10130
2020-06-28,Iran,IR,2456,234,82913893,Asia,220180,10364
2020-06-29,Iran,IR,2489,144,82913893,Asia,222669,10508
2020-06-30,Iran,IR,2536,162,82913893,Asia,225205,10670
2020-07-01,Iran,IR,2457,147,82913893,Asia,227662,10817
2020-07-02,Iran,IR,2549,141,82913893,Asia,230211,10958
2020-07-03,Iran,IR,2652,148,82913893,Asia,232863,11106
2020-07-04,Iran,IR,2566,154,82913893,Asia,235429,11260
2020-07-05,Iran,IR,2449,148,82913893,Asia,237878,11408
2020-07-06,Iran,IR,2560,163,82913893,Asia,240438,11571
2020-07-07,Iran,IR,2613,160,82913893,Asia,243051,11731
2020-07-08,Iran,IR,2637,200,82913893,Asia,245688,11931
2020-07-09,Iran,IR,2691,153,82913893,Asia,248379,12084
2020-07-10,Iran,IR,2079,221,82913893,Asia,250458,12305
2020-07-11,Iran,IR,2262,142,82913893,Asia,252720,12447
2020-07-12,Iran,IR,2397,188,82913893,Asia,255117,12635
2020-07-13,Iran,IR,2186,194,82913893,Asia,257303,12829
2020-07-14,Iran,IR,2349,203,82913893,Asia,259652,13032
2020-07-15,Iran,IR,2521,179,82913893,Asia,262173,13211
2020-07-16,Iran,IR,2388,199,82913893,Asia,264561,13410
2020-07-17,Iran,IR,2500,198,82913893,Asia,267061,13608
2020-07-18,Iran,IR,2379,183,82913893,Asia,269440,13791
2020-07-19,Iran,IR,2166,188,82913893,Asia,271606,13979
2020-07-20,Iran,IR,2182,209,82913893,Asia,273788,14188
2020-07-21,Iran,IR,2414,217,82913893,Asia,276202,14405
2020-07-22,Iran,IR,2625,229,82913893,Asia,278827,14634
2020-07-23,Iran,IR,2586,219,82913893,Asia,281413,14853
2020-07-24,Iran,IR,2621,221,82913893,Asia,284034,15074
2020-07-25,Iran,IR,2489,215,82913893,Asia,286523,15289
2020-07-26,Iran,IR,2316,195,82913893,Asia,288839,15484
2020-07-27,Iran,IR,2333,216,82913893,Asia,291172,15700
2020-07-28,Iran,IR,2434,212,82913893,Asia,293606,15912
2020-07-29,Iran,IR,2667,235,82913893,Asia,296273,16147
2020-07-30,Iran,IR,2636,196,82913893,Asia,298909,16343
2020-07-31,Iran,IR,2621,226,82913893,Asia,301530,16569
2020-08-01,Iran,IR,2674,197,82913893,Asia,304204,16766
2020-08-02,Iran,IR,2548,216,82913893,Asia,306752,16982
2020-08-03,Iran,IR,2685,208,82913893,Asia,309437,17190
2020-08-04,Iran,IR,2598,215,82913893,Asia,312035,17405
2020-08-05,Iran,IR,2751,212,82913893,Asia,314786,17617
2020-08-06,Iran,IR,2697,185,82913893,Asia,317483,17802
2020-08-07,Iran,IR,2634,14,82913893,Asia,320117,17816
2020-08-08,Iran,IR,2450,316,82913893,Asia,322567,18132
2020-08-09,Iran,IR,2125,132,82913893,Asia,324692,18264
2020-08-10,Iran,IR,2020,163,82913893,Asia,326712,18427
2020-08-11,Iran,IR,2132,189,82913893,Asia,328844,18616
2020-08-12,Iran,IR,2345,184,82913893,Asia,331189,18800
2020-08-13,Iran,IR,2510,188,82913893,Asia,333699,18988
2020-08-14,Iran,IR,2625,174,82913893,Asia,336324,19162
2020-08-15,Iran,IR,2501,169,82913893,Asia,338825,19331
2020-08-16,Iran,IR,2245,161,82913893,Asia,341070,19492
2020-08-17,Iran,IR,2133,147,82913893,Asia,343203,19639
2020-08-18,Iran,IR,2247,165,82913893,Asia,345450,19804
2020-08-19,Iran,IR,2385,168,82913893,Asia,347835,19972
2020-08-20,Iran,IR,0,0,82913893,Asia,347835,19972
2020-08-21,Iran,IR,4723,292,82913893,Asia,352558,20264
2020-08-22,Iran,IR,2206,112,82913893,Asia,354764,20376
2020-08-23,Iran,IR,2028,126,82913893,Asia,356792,20502
2020-08-24,Iran,IR,2113,141,82913893,Asia,358905,20643
2020-08-25,Iran,IR,0,0,82913893,Asia,358905,20643
2020-08-26,Iran,IR,2245,133,82913893,Asia,361150,20776
2020-08-27,Iran,IR,2213,125,82913893,Asia,363363,20901
2020-08-28,Iran,IR,4433,236,82913893,Asia,367796,21137
2020-08-29,Iran,IR,2115,112,82913893,Asia,369911,21249
2020-08-30,Iran,IR,1905,110,82913893,Asia,371816,21359
2020-08-31,Iran,IR,1754,103,82913893,Asia,373570,21462
2020-09-01,Iran,IR,1642,109,82913893,Asia,375212,21571
2020-09-02,Iran,IR,1682,101,82913893,Asia,376894,21672
2020-09-03,Iran,IR,1858,125,82913893,Asia,378752,21797
2020-09-04,Iran,IR,1994,129,82913893,Asia,380746,21926
2020-09-05,Iran,IR,2026,118,82913893,Asia,382772,22044
2020-09-06,Iran,IR,1894,110,82913893,Asia,384666,22154
2020-09-07,Iran,IR,1992,139,82913893,Asia,386658,22293
2020-09-08,Iran,IR,2152,117,82913893,Asia,388810,22410
2020-09-09,Iran,IR,2302,132,82913893,Asia,391112,22542
2020-09-10,Iran,IR,2313,127,82913893,Asia,393425,22669
2020-09-11,Iran,IR,2063,129,82913893,Asia,395488,22798
2020-09-12,Iran,IR,2313,115,82913893,Asia,397801,22913
2020-09-13,Iran,IR,2139,116,82913893,Asia,399940,23029
2020-09-14,Iran,IR,2089,128,82913893,Asia,402029,23157
2020-09-15,Iran,IR,2619,156,82913893,Asia,404648,23313
2020-09-16,Iran,IR,2705,140,82913893,Asia,407353,23453
2020-09-17,Iran,IR,2981,179,82913893,Asia,410334,23632
2020-09-18,Iran,IR,2815,176,82913893,Asia,413149,23808
2020-09-19,Iran,IR,3049,144,82913893,Asia,416198,23952
2020-09-20,Iran,IR,2845,166,82913893,Asia,419043,24118
2020-09-21,Iran,IR,3097,183,82913893,Asia,422140,24301
2020-09-22,Iran,IR,3341,177,82913893,Asia,425481,24478
2020-09-23,Iran,IR,3712,178,82913893,Asia,429193,24656
2020-09-24,Iran,IR,3605,184,82913893,Asia,432798,24840
2020-09-25,Iran,IR,3521,175,82913893,Asia,436319,25015
2020-09-26,Iran,IR,3563,207,82913893,Asia,439882,25222
2020-09-27,Iran,IR,3204,172,82913893,Asia,443086,25394
2020-09-28,Iran,IR,3362,195,82913893,Asia,446448,25589
2020-09-29,Iran,IR,3512,190,82913893,Asia,449960,25779
2020-09-30,Iran,IR,3677,207,82913893,Asia,453637,25986
2020-10-01,Iran,IR,3582,183,82913893,Asia,457219,26169
2020-10-02,Iran,IR,3825,211,82913893,Asia,461044,26380
2020-10-03,Iran,IR,3552,187,82913893,Asia,464596,26567
2020-10-04,Iran,IR,3523,179,82913893,Asia,468119,26746
2020-10-05,Iran,IR,3653,211,82913893,Asia,471772,26957
2020-10-06,Iran,IR,3902,235,82913893,Asia,475674,27192
2020-10-07,Iran,IR,4151,227,82913893,Asia,479825,27419
2020-10-08,Iran,IR,4019,239,82913893,Asia,483844,27658
2020-10-09,Iran,IR,4392,230,82913893,Asia,488236,27888
2020-10-10,Iran,IR,4142,210,82913893,Asia,492378,28098
2020-10-11,Iran,IR,3875,195,82913893,Asia,496253,28293
2020-10-12,Iran,IR,3822,251,82913893,Asia,500075,28544
2020-10-13,Iran,IR,4206,272,82913893,Asia,504281,28816
2020-10-14,Iran,IR,4108,254,82913893,Asia,508389,29070
2020-10-15,Iran,IR,4830,279,82913893,Asia,513219,29349
2020-10-16,Iran,IR,4616,256,82913893,Asia,517835,29605
2020-10-17,Iran,IR,4552,265,82913893,Asia,522387,29870
2020-10-18,Iran,IR,4103,253,82913893,Asia,526490,30123
2020-10-19,Iran,IR,3890,252,82913893,Asia,530380,30375
2020-10-20,Iran,IR,4251,337,82913893,Asia,534631,30712
2020-10-21,Iran,IR,5039,322,82913893,Asia,539670,31034
2020-10-22,Iran,IR,5616,312,82913893,Asia,545286,31346
2020-10-23,Iran,IR,5471,304,82913893,Asia,550757,31650
2020-10-24,Iran,IR,6134,335,82913893,Asia,556891,31985
2020-10-25,Iran,IR,5814,335,82913893,Asia,562705,32320
2020-10-26,Iran,IR,6191,296,82913893,Asia,568896,32616
2020-10-27,Iran,IR,5960,337,82913893,Asia,574856,32953
2020-10-28,Iran,IR,6968,346,82913893,Asia,581824,33299
2020-10-29,Iran,IR,6824,415,82913893,Asia,588648,33714
2020-10-30,Iran,IR,8293,399,82913893,Asia,596941,34113
2020-10-31,Iran,IR,8011,365,82913893,Asia,604952,34478
2020-11-01,Iran,IR,7820,386,82913893,Asia,612772,34864
2020-11-02,Iran,IR,7719,434,82913893,Asia,620491,35298
2020-11-03,Iran,IR,8289,440,82913893,Asia,628780,35738
2020-11-04,Iran,IR,8932,422,82913893,Asia,637712,36160
2020-11-05,Iran,IR,8452,419,82913893,Asia,646164,36579
2020-11-06,Iran,IR,8772,406,82913893,Asia,654936,36985
2020-11-07,Iran,IR,8864,424,82913893,Asia,663800,37409
2020-11-08,Iran,IR,9450,423,82913893,Asia,673250,37832
2020-11-09,Iran,IR,9236,459,82913893,Asia,682486,38291
2020-11-10,Iran,IR,10463,458,82913893,Asia,692949,38749
2020-11-11,Iran,IR,10339,453,82913893,Asia,703288,39202
2020-11-12,Iran,IR,11780,462,82913893,Asia,715068,39664
2020-11-13,Iran,IR,11517,457,82913893,Asia,726585,40121
2020-11-14,Iran,IR,11737,461,82913893,Asia,738322,40582
2020-11-15,Iran,IR,11203,452,82913893,Asia,749525,41034
2020-11-16,Iran,IR,12543,459,82913893,Asia,762068,41493
2020-11-17,Iran,IR,13053,486,82913893,Asia,775121,41979
2020-11-18,Iran,IR,13352,482,82913893,Asia,788473,42461
2020-11-19,Iran,IR,13421,480,82913893,Asia,801894,42941
2020-11-20,Iran,IR,0,0,82913893,Asia,801894,42941
2020-11-21,Iran,IR,26483,955,82913893,Asia,828377,43896
2020-11-22,Iran,IR,12931,431,82913893,Asia,841308,44327
2020-11-23,Iran,IR,13053,475,82913893,Asia,854361,44802
2020-11-24,Iran,IR,12460,453,82913893,Asia,866821,45255
2020-11-25,Iran,IR,0,0,82913893,Asia,866821,45255
2020-11-26,Iran,IR,27564,952,82913893,Asia,894385,46207
2020-11-27,Iran,IR,13961,482,82913893,Asia,908346,46689
2020-11-28,Iran,IR,14051,406,82913893,Asia,922397,47095
2020-11-29,Iran,IR,13402,391,82913893,Asia,935799,47486
2020-11-30,Iran,IR,12950,389,82913893,Asia,948749,47875
2020-12-01,Iran,IR,13321,371,82913893,Asia,962070,48246
2020-12-02,Iran,IR,13881,382,82913893,Asia,975951,48628
2020-12-03,Iran,IR,13621,362,82913893,Asia,989572,48990
2020-12-04,Iran,IR,13922,358,82913893,Asia,1003494,49348
2020-12-05,Iran,IR,13341,347,82913893,Asia,1016835,49695
2020-12-06,Iran,IR,12151,321,82913893,Asia,1028986,50016
2020-12-07,Iran,IR,11561,294,82913893,Asia,1040547,50310
2020-12-08,Iran,IR,10827,284,82913893,Asia,1051374,50594
2020-12-09,Iran,IR,11023,323,82913893,Asia,1062397,50917
2020-12-10,Iran,IR,10223,295,82913893,Asia,1072620,51212
2020-12-11,Iran,IR,10403,284,82913893,Asia,1083023,51496
2020-12-12,Iran,IR,9594,232,82913893,Asia,1092617,51728
2020-12-13,Iran,IR,8201,221,82913893,Asia,1100818,51949
2020-12-14,Iran,IR,7451,247,82913893,Asia,1108269,52196
2019-12-31,Iceland,IS,0,0,356991,Europe,0,0
2020-01-01,Iceland,IS,0,0,356991,Europe,0,0
2020-01-02,Iceland,IS,0,0,356991,Europe,0,0
2020-01-03,Iceland,IS,0,0,356991,Europe,0,0
2020-01-04,Iceland,IS,0,0,356991,Europe,0,0
2020-01-05,Iceland,IS,0,0,356991,Europe,0,0
2020-01-06,Iceland,IS,0,0,356991,Europe,0,0
2020-01-07,Iceland,IS,0,0,356991,Europe,0,0
2020-01-08,Iceland,IS,0,0,356991,Europe,0,0
2020-01-09,Iceland,IS,0,0,356991,Europe,0,0
2020-01-10,Iceland,IS,0,0,356991,Europe,0,0
2020-01-11,Iceland,IS,0,0,356991,Europe,0,0
2020-01-12,Iceland,IS,0,0,356991,Europe,0,0
2020-01-13,Iceland,IS,0,0,356991,Europe,0,0
2020-01-14,Iceland,IS,0,0,356991,Europe,0,0
2020-01-15,Iceland,IS,0,0,356991,Europe,0,0
2020-01-16,Iceland,IS,0,0,356991,Europe,0,0
2020-01-17,Iceland,IS,0,0,356991,Europe,0,0
2020-01-18,Iceland,IS,0,0,356991,Europe,0,0
2020-01-19,Iceland,IS,0,0,356991,Europe,0,0
2020-01-20,Iceland,IS,0,0,356991,Europe,0,0
2020-01-21,Iceland,IS,0,0,356991,Europe,0,0
2020-01-22,Iceland,IS,0,0,356991,Europe,0,0
2020-01-23,Iceland,IS,0,0,356991,Europe,0,0
2020-01-24,Iceland,IS,0,0,356991,Europe,0,0
2020-01-25,Iceland,IS,0,0,356991,Europe,0,0
2020-01-26,Iceland,IS,0,0,356991,Europe,0,0
2020-01-27,Iceland,IS,0,0,356991,Europe,0,0
2020-01-28,Iceland,IS,0,0,356991,Europe,0,0
2020-01-29,Iceland,IS,0,0,356991,Europe,0,0
2020-01-30,Iceland,IS,0,0,356991,Europe,0,0
2020-01-31,Iceland,IS,0,0,356991,Europe,0,0
2020-02-01,Iceland,IS,0,0,356991,Europe,0,0
2020-02-02,Iceland,IS,0,0,356991,Europe,0,0
2020-02-03,Iceland,IS,0,0,356991,Europe,0,0
2020-02-04,Iceland,IS,0,0,356991,Europe,0,0
2020-02-05,Iceland,IS,0,0,356991,Europe,0,0
2020-02-06,Iceland,IS,0,0,356991,Europe,0,0
2020-02-07,Iceland,IS,0,0,356991,Europe,0,0
2020-02-08,Iceland,IS,0,0,356991,Europe,0,0
2020-02-09,Iceland,IS,0,0,356991,Europe,0,0
2020-02-10,Iceland,IS,0,0,356991,Europe,0,0
2020-02-11,Iceland,IS,0,0,356991,Europe,0,0
2020-02-12,Iceland,IS,0,0,356991,Europe,0,0
2020-02-13,Iceland,IS,0,0,356991,Europe,0,0
2020-02-14,Iceland,IS,0,0,356991,Europe,0,0
2020-02-15,Iceland,IS,0,0,356991,Europe,0,0
2020-02-16,Iceland,IS,0,0,356991,Europe,0,0
2020-02-17,Iceland,IS,0,0,356991,Europe,0,0
2020-02-18,Iceland,IS,0,0,356991,Europe,0,0
2020-02-19,Iceland,IS,0,0,356991,Europe,0,0
2020-02-20,Iceland,IS,0,0,356991,Europe,0,0
2020-02-21,Iceland,IS,0,0,356991,Europe,0,0
2020-02-22,Iceland,IS,0,0,356991,Europe,0,0
2020-02-23,Iceland,IS,0,0,356991,Europe,0,0
2020-02-24,Iceland,IS,0,0,356991,Europe,0,0
2020-02-25,Iceland,IS,0,0,356991,Europe,0,0
2020-02-26,Iceland,IS,0,0,356991,Europe,0,0
2020-02-27,Iceland,IS,0,0,356991,Europe,0,0
2020-02-28,Iceland,IS,0,0,356991,Europe,0,0
2020-02-29,Iceland,IS,1,0,356991,Europe,1,0
2020-03-01,Iceland,IS,0,0,356991,Europe,1,0
2020-03-02,Iceland,IS,2,0,356991,Europe,3,0
2020-03-03,Iceland,IS,3,0,356991,Europe,6,0
2020-03-04,Iceland,IS,10,0,356991,Europe,16,0
2020-03-05,Iceland,IS,10,0,356991,Europe,26,0
2020-03-06,Iceland,IS,9,0,356991,Europe,35,0
2020-03-07,Iceland,IS,8,0,356991,Europe,43,0
2020-03-08,Iceland,IS,10,0,356991,Europe,53,0
2020-03-09,Iceland,IS,2,0,356991,Europe,55,0
2020-03-10,Iceland,IS,10,0,356991,Europe,65,0
2020-03-11,Iceland,IS,5,0,356991,Europe,70,0
2020-03-12,Iceland,IS,15,0,356991,Europe,85,0
2020-03-13,Iceland,IS,32,0,356991,Europe,117,0
2020-03-14,Iceland,IS,0,0,356991,Europe,117,0
2020-03-15,Iceland,IS,21,0,356991,Europe,138,0
2020-03-16,Iceland,IS,40,0,356991,Europe,178,0
2020-03-17,Iceland,IS,21,0,356991,Europe,199,0
2020-03-18,Iceland,IS,48,0,356991,Europe,247,0
2020-03-19,Iceland,IS,3,0,356991,Europe,250,0
2020-03-20,Iceland,IS,80,1,356991,Europe,330,1
2020-03-21,Iceland,IS,79,0,356991,Europe,409,1
2020-03-22,Iceland,IS,64,0,356991,Europe,473,1
2020-03-23,Iceland,IS,95,0,356991,Europe,568,1
2020-03-24,Iceland,IS,20,1,356991,Europe,588,2
2020-03-25,Iceland,IS,60,0,356991,Europe,648,2
2020-03-26,Iceland,IS,89,0,356991,Europe,737,2
2020-03-27,Iceland,IS,65,0,356991,Europe,802,2
2020-03-28,Iceland,IS,88,0,356991,Europe,890,2
2020-03-29,Iceland,IS,73,0,356991,Europe,963,2
2020-03-30,Iceland,IS,57,0,356991,Europe,1020,2
2020-03-31,Iceland,IS,66,0,356991,Europe,1086,2
2020-04-01,Iceland,IS,49,0,356991,Europe,1135,2
2020-04-02,Iceland,IS,85,0,356991,Europe,1220,2
2020-04-03,Iceland,IS,99,2,356991,Europe,1319,4
2020-04-04,Iceland,IS,45,0,356991,Europe,1364,4
2020-04-05,Iceland,IS,53,0,356991,Europe,1417,4
2020-04-06,Iceland,IS,69,0,356991,Europe,1486,4
2020-04-07,Iceland,IS,76,2,356991,Europe,1562,6
2020-04-08,Iceland,IS,24,0,356991,Europe,1586,6
2020-04-09,Iceland,IS,30,0,356991,Europe,1616,6
2020-04-10,Iceland,IS,32,0,356991,Europe,1648,6
2020-04-11,Iceland,IS,27,1,356991,Europe,1675,7
2020-04-12,Iceland,IS,14,1,356991,Europe,1689,8
2020-04-13,Iceland,IS,12,0,356991,Europe,1701,8
2020-04-14,Iceland,IS,10,0,356991,Europe,1711,8
2020-04-15,Iceland,IS,9,0,356991,Europe,1720,8
2020-04-16,Iceland,IS,7,0,356991,Europe,1727,8
2020-04-17,Iceland,IS,12,0,356991,Europe,1739,8
2020-04-18,Iceland,IS,15,0,356991,Europe,1754,8
2020-04-19,Iceland,IS,6,1,356991,Europe,1760,9
2020-04-20,Iceland,IS,11,0,356991,Europe,1771,9
2020-04-21,Iceland,IS,2,1,356991,Europe,1773,10
2020-04-22,Iceland,IS,5,0,356991,Europe,1778,10
2020-04-23,Iceland,IS,7,0,356991,Europe,1785,10
2020-04-24,Iceland,IS,4,0,356991,Europe,1789,10
2020-04-25,Iceland,IS,0,0,356991,Europe,1789,10
2020-04-26,Iceland,IS,1,0,356991,Europe,1790,10
2020-04-27,Iceland,IS,2,0,356991,Europe,1792,10
2020-04-28,Iceland,IS,0,0,356991,Europe,1792,10
2020-04-29,Iceland,IS,3,0,356991,Europe,1795,10
2020-04-30,Iceland,IS,2,0,356991,Europe,1797,10
2020-05-01,Iceland,IS,0,0,356991,Europe,1797,10
2020-05-02,Iceland,IS,1,0,356991,Europe,1798,10
2020-05-03,Iceland,IS,0,0,356991,Europe,1798,10
2020-05-04,Iceland,IS,1,0,356991,Europe,1799,10
2020-05-05,Iceland,IS,0,0,356991,Europe,1799,10
2020-05-06,Iceland,IS,0,0,356991,Europe,1799,10
2020-05-07,Iceland,IS,0,0,356991,Europe,1799,10
2020-05-08,Iceland,IS,2,0,356991,Europe,1801,10
2020-05-09,Iceland,IS,0,0,356991,Europe,1801,10
2020-05-10,Iceland,IS,0,0,356991,Europe,1801,10
2020-05-11,Iceland,IS,0,0,356991,Europe,1801,10
2020-05-12,Iceland,IS,0,0,356991,Europe,1801,10
2020-05-13,Iceland,IS,0,0,356991,Europe,1801,10
2020-05-14,Iceland,IS,1,0,356991,Europe,1802,10
2020-05-15,Iceland,IS,0,0,356991,Europe,1802,10
2020-05-16,Iceland,IS,0,0,356991,Europe,1802,10
2020-05-17,Iceland,IS,0,0,356991,Europe,1802,10
2020-05-18,Iceland,IS,0,0,356991,Europe,1802,10
2020-05-19,Iceland,IS,0,0,356991,Europe,1802,10
2020-05-20,Iceland,IS,0,0,356991,Europe,1802,10
2020-05-21,Iceland,IS,1,0,356991,Europe,1803,10
2020-05-22,Iceland,IS,0,0,356991,Europe,1803,10
2020-05-23,Iceland,IS,0,0,356991,Europe,1803,10
2020-05-24,Iceland,IS,1,0,356991,Europe,1804,10
2020-05-25,Iceland,IS,0,0,356991,Europe,1804,10
2020-05-26,Iceland,IS,0,0,356991,Europe,1804,10
2020-05-27,Iceland,IS,0,0,356991,Europe,1804,10
2020-05-28,Iceland,IS,1,0,356991,Europe,1805,10
2020-05-29,Iceland,IS,0,0,356991,Europe,1805,10
2020-05-30,Iceland,IS,0,0,356991,Europe,1805,10
2020-05-31,Iceland,IS,1,0,356991,Europe,1806,10
2020-06-01,Iceland,IS,0,0,356991,Europe,1806,10
2020-06-02,Iceland,IS,0,0,356991,Europe,1806,10
2020-06-03,Iceland,IS,0,0,356991,Europe,1806,10
2020-06-04,Iceland,IS,0,0,356991,Europe,1806,10
2020-06-05,Iceland,IS,0,0,356991,Europe,1806,10
2020-06-06,Iceland,IS,0,0,356991,Europe,1806,10
2020-06-07,Iceland,IS,0,0,356991,Europe,1806,10
2020-06-08,Iceland,IS,1,0,356991,Europe,1807,10
2020-06-09,Iceland,IS,0,0,356991,Europe,1807,10
2020-06-10,Iceland,IS,0,0,356991,Europe,1807,10
2020-06-11,Iceland,IS,0,0,356991,Europe,1807,10
2020-06-12,Iceland,IS,0,0,356991,Europe,1807,10
2020-06-13,Iceland,IS,1,0,356991,Europe,1808,10
2020-06-14,Iceland,IS,2,0,356991,Europe,1810,10
2020-06-15,Iceland,IS,0,0,356991,Europe,1810,10
2020-06-16,Iceland,IS,1,0,356991,Europe,1811,10
2020-06-17,Iceland,IS,1,0,356991,Europe,1812,10
2020-06-18,Iceland,IS,0,0,356991,Europe,1812,10
2020-06-19,Iceland,IS,2,0,356991,Europe,1814,10
2020-06-20,Iceland,IS,1,0,356991,Europe,1815,10
2020-06-21,Iceland,IS,0,0,356991,Europe,1815,10
2020-06-22,Iceland,IS,0,0,356991,Europe,1815,10
2020-06-23,Iceland,IS,0,0,356991,Europe,1815,10
2020-06-24,Iceland,IS,0,0,356991,Europe,1815,10
2020-06-25,Iceland,IS,2,0,356991,Europe,1817,10
2020-06-26,Iceland,IS,1,0,356991,Europe,1818,10
2020-06-27,Iceland,IS,2,0,356991,Europe,1820,10
2020-06-28,Iceland,IS,0,0,356991,Europe,1820,10
2020-06-29,Iceland,IS,1,0,356991,Europe,1821,10
2020-06-30,Iceland,IS,1,0,356991,Europe,1822,10
2020-07-01,Iceland,IS,2,0,356991,Europe,1824,10
2020-07-02,Iceland,IS,1,0,356991,Europe,1825,10
2020-07-03,Iceland,IS,5,0,356991,Europe,1830,10
2020-07-04,Iceland,IS,0,0,356991,Europe,1830,10
2020-07-05,Iceland,IS,0,0,356991,Europe,1830,10
2020-07-06,Iceland,IS,0,0,356991,Europe,1830,10
2020-07-07,Iceland,IS,2,0,356991,Europe,1832,10
2020-07-08,Iceland,IS,1,0,356991,Europe,1833,10
2020-07-09,Iceland,IS,0,0,356991,Europe,1833,10
2020-07-10,Iceland,IS,0,0,356991,Europe,1833,10
2020-07-11,Iceland,IS,0,0,356991,Europe,1833,10
2020-07-12,Iceland,IS,0,0,356991,Europe,1833,10
2020-07-13,Iceland,IS,0,0,356991,Europe,1833,10
2020-07-14,Iceland,IS,0,0,356991,Europe,1833,10
2020-07-15,Iceland,IS,2,0,356991,Europe,1835,10
2020-07-16,Iceland,IS,0,0,356991,Europe,1835,10
2020-07-17,Iceland,IS,1,0,356991,Europe,1836,10
2020-07-18,Iceland,IS,0,0,356991,Europe,1836,10
2020-07-19,Iceland,IS,2,0,356991,Europe,1838,10
2020-07-20,Iceland,IS,1,0,356991,Europe,1839,10
2020-07-21,Iceland,IS,0,0,356991,Europe,1839,10
2020-07-22,Iceland,IS,0,0,356991,Europe,1839,10
2020-07-23,Iceland,IS,1,0,356991,Europe,1840,10
2020-07-24,Iceland,IS,1,0,356991,Europe,1841,10
2020-07-25,Iceland,IS,2,0,356991,Europe,1843,10
2020-07-26,Iceland,IS,0,0,356991,Europe,1843,10
2020-07-27,Iceland,IS,4,0,356991,Europe,1847,10
2020-07-28,Iceland,IS,7,0,356991,Europe,1854,10
2020-07-29,Iceland,IS,3,0,356991,Europe,1857,10
2020-07-30,Iceland,IS,4,0,356991,Europe,1861,10
2020-07-31,Iceland,IS,11,0,356991,Europe,1872,10
2020-08-01,Iceland,IS,13,0,356991,Europe,1885,10
2020-08-02,Iceland,IS,8,0,356991,Europe,1893,10
2020-08-03,Iceland,IS,14,0,356991,Europe,1907,10
2020-08-04,Iceland,IS,8,0,356991,Europe,1915,10
2020-08-05,Iceland,IS,3,0,356991,Europe,1918,10
2020-08-06,Iceland,IS,8,0,356991,Europe,1926,10
2020-08-07,Iceland,IS,6,0,356991,Europe,1932,10
2020-08-08,Iceland,IS,20,0,356991,Europe,1952,10
2020-08-09,Iceland,IS,3,0,356991,Europe,1955,10
2020-08-10,Iceland,IS,3,0,356991,Europe,1958,10
2020-08-11,Iceland,IS,4,0,356991,Europe,1962,10
2020-08-12,Iceland,IS,6,0,356991,Europe,1968,10
2020-08-13,Iceland,IS,4,0,356991,Europe,1972,10
2020-08-14,Iceland,IS,4,0,356991,Europe,1976,10
2020-08-15,Iceland,IS,7,0,356991,Europe,1983,10
2020-08-16,Iceland,IS,16,0,356991,Europe,1999,10
2020-08-17,Iceland,IS,12,0,356991,Europe,2011,10
2020-08-18,Iceland,IS,3,0,356991,Europe,2014,10
2020-08-19,Iceland,IS,13,0,356991,Europe,2027,10
2020-08-20,Iceland,IS,8,0,356991,Europe,2035,10
2020-08-21,Iceland,IS,5,0,356991,Europe,2040,10
2020-08-22,Iceland,IS,10,0,356991,Europe,2050,10
2020-08-23,Iceland,IS,8,0,356991,Europe,2058,10
2020-08-24,Iceland,IS,6,0,356991,Europe,2064,10
2020-08-25,Iceland,IS,9,0,356991,Europe,2073,10
2020-08-26,Iceland,IS,4,0,356991,Europe,2077,10
2020-08-27,Iceland,IS,5,0,356991,Europe,2082,10
2020-08-28,Iceland,IS,5,0,356991,Europe,2087,10
2020-08-29,Iceland,IS,5,0,356991,Europe,2092,10
2020-08-30,Iceland,IS,8,0,356991,Europe,2100,10
2020-08-31,Iceland,IS,5,0,356991,Europe,2105,10
2020-09-01,Iceland,IS,2,0,356991,Europe,2107,10
2020-09-02,Iceland,IS,9,0,356991,Europe,2116,10
2020-09-03,Iceland,IS,5,0,356991,Europe,2121,10
2020-09-04,Iceland,IS,7,0,356991,Europe,2128,10
2020-09-05,Iceland,IS,7,0,356991,Europe,2135,10
2020-09-06,Iceland,IS,1,0,356991,Europe,2136,10
2020-09-07,Iceland,IS,5,0,356991,Europe,2141,10
2020-09-08,Iceland,IS,2,0,356991,Europe,2143,10
2020-09-09,Iceland,IS,7,0,356991,Europe,2150,10
2020-09-10,Iceland,IS,3,0,356991,Europe,2153,10
2020-09-11,Iceland,IS,4,0,356991,Europe,2157,10
2020-09-12,Iceland,IS,4,0,356991,Europe,2161,10
2020-09-13,Iceland,IS,1,0,356991,Europe,2162,10
2020-09-14,Iceland,IS,3,0,356991,Europe,2165,10
2020-09-15,Iceland,IS,3,0,356991,Europe,2168,10
2020-09-16,Iceland,IS,6,0,356991,Europe,2174,10
2020-09-17,Iceland,IS,15,0,356991,Europe,2189,10
2020-09-18,Iceland,IS,17,0,356991,Europe,2206,10
2020-09-19,Iceland,IS,24,0,356991,Europe,2230,10
2020-09-20,Iceland,IS,77,0,356991,Europe,2307,10
2020-09-21,Iceland,IS,39,0,356991,Europe,2346,10
2020-09-22,Iceland,IS,31,0,356991,Europe,2377,10
2020-09-23,Iceland,IS,42,0,356991,Europe,2419,10
2020-09-24,Iceland,IS,57,0,356991,Europe,2476,10
2020-09-25,Iceland,IS,36,0,356991,Europe,2512,10
2020-09-26,Iceland,IS,49,0,356991,Europe,2561,10
2020-09-27,Iceland,IS,40,0,356991,Europe,2601,10
2020-09-28,Iceland,IS,22,0,356991,Europe,2623,10
2020-09-29,Iceland,IS,40,0,356991,Europe,2663,10
2020-09-30,Iceland,IS,32,0,356991,Europe,2695,10
2020-10-01,Iceland,IS,33,0,356991,Europe,2728,10
2020-10-02,Iceland,IS,41,0,356991,Europe,2769,10
2020-10-03,Iceland,IS,40,0,356991,Europe,2809,10
2020-10-04,Iceland,IS,63,0,356991,Europe,2872,10
2020-10-05,Iceland,IS,49,0,356991,Europe,2921,10
2020-10-06,Iceland,IS,59,0,356991,Europe,2980,10
2020-10-07,Iceland,IS,101,0,356991,Europe,3081,10
2020-10-08,Iceland,IS,91,0,356991,Europe,3172,10
2020-10-09,Iceland,IS,95,0,356991,Europe,3267,10
2020-10-10,Iceland,IS,106,0,356991,Europe,3373,10
2020-10-11,Iceland,IS,87,0,356991,Europe,3460,10
2020-10-12,Iceland,IS,66,0,356991,Europe,3526,10
2020-10-13,Iceland,IS,56,0,356991,Europe,3582,10
2020-10-14,Iceland,IS,86,0,356991,Europe,3668,10
2020-10-15,Iceland,IS,89,0,356991,Europe,3757,10
2020-10-16,Iceland,IS,80,0,356991,Europe,3837,10
2020-10-17,Iceland,IS,92,1,356991,Europe,3929,11
2020-10-18,Iceland,IS,69,0,356991,Europe,3998,11
2020-10-19,Iceland,IS,57,0,356991,Europe,4055,11
2020-10-20,Iceland,IS,46,0,356991,Europe,4101,11
2020-10-21,Iceland,IS,92,0,356991,Europe,4193,11
2020-10-22,Iceland,IS,37,0,356991,Europe,4230,11
2020-10-23,Iceland,IS,38,0,356991,Europe,4268,11
2020-10-24,Iceland,IS,40,0,356991,Europe,4308,11
2020-10-25,Iceland,IS,86,0,356991,Europe,4394,11
2020-10-26,Iceland,IS,54,0,356991,Europe,4448,11
2020-10-27,Iceland,IS,56,0,356991,Europe,4504,11
2020-10-28,Iceland,IS,70,0,356991,Europe,4574,11
2020-10-29,Iceland,IS,97,1,356991,Europe,4671,12
2020-10-30,Iceland,IS,48,0,356991,Europe,4719,12
2020-10-31,Iceland,IS,78,0,356991,Europe,4797,12
2020-11-01,Iceland,IS,68,0,356991,Europe,4865,12
2020-11-02,Iceland,IS,25,0,356991,Europe,4890,12
2020-11-03,Iceland,IS,41,0,356991,Europe,4931,12
2020-11-04,Iceland,IS,26,5,356991,Europe,4957,17
2020-11-05,Iceland,IS,32,0,356991,Europe,4989,17
2020-11-06,Iceland,IS,28,1,356991,Europe,5017,18
2020-11-07,Iceland,IS,22,0,356991,Europe,5039,18
2020-11-08,Iceland,IS,24,0,356991,Europe,5063,18
2020-11-09,Iceland,IS,15,2,356991,Europe,5078,20
2020-11-10,Iceland,IS,23,3,356991,Europe,5101,23
2020-11-11,Iceland,IS,13,1,356991,Europe,5114,24
2020-11-12,Iceland,IS,28,0,356991,Europe,5142,24
2020-11-13,Iceland,IS,18,1,356991,Europe,5160,25
2020-11-14,Iceland,IS,10,0,356991,Europe,5170,25
2020-11-15,Iceland,IS,16,0,356991,Europe,5186,25
2020-11-16,Iceland,IS,3,0,356991,Europe,5189,25
2020-11-17,Iceland,IS,16,0,356991,Europe,5205,25
2020-11-18,Iceland,IS,10,0,356991,Europe,5215,25
2020-11-19,Iceland,IS,11,0,356991,Europe,5226,25
2020-11-20,Iceland,IS,5,0,356991,Europe,5231,25
2020-11-21,Iceland,IS,20,1,356991,Europe,5251,26
2020-11-22,Iceland,IS,18,0,356991,Europe,5269,26
2020-11-23,Iceland,IS,8,0,356991,Europe,5277,26
2020-11-24,Iceland,IS,12,0,356991,Europe,5289,26
2020-11-25,Iceland,IS,9,0,356991,Europe,5298,26
2020-11-26,Iceland,IS,14,0,356991,Europe,5312,26
2020-11-27,Iceland,IS,11,0,356991,Europe,5323,26
2020-11-28,Iceland,IS,23,0,356991,Europe,5346,26
2020-11-29,Iceland,IS,25,0,356991,Europe,5371,26
2020-11-30,Iceland,IS,10,0,356991,Europe,5381,26
2020-12-01,Iceland,IS,11,0,356991,Europe,5392,26
2020-12-02,Iceland,IS,21,1,356991,Europe,5413,27
2020-12-03,Iceland,IS,20,0,356991,Europe,5433,27
2020-12-04,Iceland,IS,15,0,356991,Europe,5448,27
2020-12-05,Iceland,IS,14,0,356991,Europe,5462,27
2020-12-06,Iceland,IS,14,0,356991,Europe,5476,27
2020-12-07,Iceland,IS,6,0,356991,Europe,5482,27
2020-12-08,Iceland,IS,14,0,356991,Europe,5496,27
2020-12-09,Iceland,IS,10,1,356991,Europe,5506,28
2020-12-10,Iceland,IS,10,0,356991,Europe,5516,28
2020-12-11,Iceland,IS,8,0,356991,Europe,5524,28
2020-12-12,Iceland,IS,15,0,356991,Europe,5539,28
2020-12-13,Iceland,IS,13,0,356991,Europe,5552,28
2020-12-14,Iceland,IS,5,0,356991,Europe,5557,28
2019-12-31,Italy,IT,0,0,60359546,Europe,0,0
2020-01-01,Italy,IT,0,0,60359546,Europe,0,0
2020-01-02,Italy,IT,0,0,60359546,Europe,0,0
2020-01-03,Italy,IT,0,0,60359546,Europe,0,0
2020-01-04,Italy,IT,0,0,60359546,Europe,0,0
2020-01-05,Italy,IT,0,0,60359546,Europe,0,0
2020-01-06,Italy,IT,0,0,60359546,Europe,0,0
2020-01-07,Italy,IT,0,0,60359546,Europe,0,0
2020-01-08,Italy,IT,0,0,60359546,Europe,0,0
2020-01-09,Italy,IT,0,0,60359546,Europe,0,0
2020-01-10,Italy,IT,0,0,60359546,Europe,0,0
2020-01-11,Italy,IT,0,0,60359546,Europe,0,0
2020-01-12,Italy,IT,0,0,60359546,Europe,0,0
2020-01-13,Italy,IT,0,0,60359546,Europe,0,0
2020-01-14,Italy,IT,0,0,60359546,Europe,0,0
2020-01-15,Italy,IT,0,0,60359546,Europe,0,0
2020-01-16,Italy,IT,0,0,60359546,Europe,0,0
2020-01-17,Italy,IT,0,0,60359546,Europe,0,0
2020-01-18,Italy,IT,0,0,60359546,Europe,0,0
2020-01-19,Italy,IT,0,0,60359546,Europe,0,0
2020-01-20,Italy,IT,0,0,60359546,Europe,0,0
2020-01-21,Italy,IT,0,0,60359546,Europe,0,0
2020-01-22,Italy,IT,0,0,60359546,Europe,0,0
2020-01-23,Italy,IT,0,0,60359546,Europe,0,0
2020-01-24,Italy,IT,0,0,60359546,Europe,0,0
2020-01-25,Italy,IT,0,0,60359546,Europe,0,0
2020-01-26,Italy,IT,0,0,60359546,Europe,0,0
2020-01-27,Italy,IT,0,0,60359546,Europe,0,0
2020-01-28,Italy,IT,0,0,60359546,Europe,0,0
2020-01-29,Italy,IT,0,0,60359546,Europe,0,0
2020-01-30,Italy,IT,0,0,60359546,Europe,0,0
2020-01-31,Italy,IT,3,0,60359546,Europe,3,0
2020-02-01,Italy,IT,0,0,60359546,Europe,3,0
2020-02-02,Italy,IT,0,0,60359546,Europe,3,0
2020-02-03,Italy,IT,0,0,60359546,Europe,3,0
2020-02-04,Italy,IT,0,0,60359546,Europe,3,0
2020-02-05,Italy,IT,0,0,60359546,Europe,3,0
2020-02-06,Italy,IT,0,0,60359546,Europe,3,0
2020-02-07,Italy,IT,0,0,60359546,Europe,3,0
2020-02-08,Italy,IT,0,0,60359546,Europe,3,0
2020-02-09,Italy,IT,0,0,60359546,Europe,3,0
2020-02-10,Italy,IT,0,0,60359546,Europe,3,0
2020-02-11,Italy,IT,0,0,60359546,Europe,3,0
2020-02-12,Italy,IT,0,0,60359546,Europe,3,0
2020-02-13,Italy,IT,0,0,60359546,Europe,3,0
2020-02-14,Italy,IT,0,0,60359546,Europe,3,0
2020-02-15,Italy,IT,0,0,60359546,Europe,3,0
2020-02-16,Italy,IT,0,0,60359546,Europe,3,0
2020-02-17,Italy,IT,0,0,60359546,Europe,3,0
2020-02-18,Italy,IT,0,0,60359546,Europe,3,0
2020-02-19,Italy,IT,0,0,60359546,Europe,3,0
2020-02-20,Italy,IT,0,0,60359546,Europe,3,0
2020-02-21,Italy,IT,0,0,60359546,Europe,3,0
2020-02-22,Italy,IT,14,0,60359546,Europe,17,0
2020-02-23,Italy,IT,62,2,60359546,Europe,79,2
2020-02-24,Italy,IT,53,0,60359546,Europe,132,2
2020-02-25,Italy,IT,97,4,60359546,Europe,229,6
2020-02-26,Italy,IT,93,5,60359546,Europe,322,11
2020-02-27,Italy,IT,78,1,60359546,Europe,400,12
2020-02-28,Italy,IT,250,5,60359546,Europe,650,17
2020-02-29,Italy,IT,238,4,60359546,Europe,888,21
2020-03-01,Italy,IT,240,8,60359546,Europe,1128,29
2020-03-02,Italy,IT,561,6,60359546,Europe,1689,35
2020-03-03,Italy,IT,347,17,60359546,Europe,2036,52
2020-03-04,Italy,IT,466,28,60359546,Europe,2502,80
2020-03-05,Italy,IT,587,27,60359546,Europe,3089,107
2020-03-06,Italy,IT,769,41,60359546,Europe,3858,148
2020-03-07,Italy,IT,778,49,60359546,Europe,4636,197
2020-03-08,Italy,IT,1247,36,60359546,Europe,5883,233
2020-03-09,Italy,IT,1492,133,60359546,Europe,7375,366
2020-03-10,Italy,IT,1797,98,60359546,Europe,9172,464
2020-03-11,Italy,IT,977,167,60359546,Europe,10149,631
2020-03-12,Italy,IT,2313,196,60359546,Europe,12462,827
2020-03-13,Italy,IT,2651,189,60359546,Europe,15113,1016
2020-03-14,Italy,IT,2547,252,60359546,Europe,17660,1268
2020-03-15,Italy,IT,3497,173,60359546,Europe,21157,1441
2020-03-16,Italy,IT,2823,370,60359546,Europe,23980,1811
2020-03-17,Italy,IT,4000,347,60359546,Europe,27980,2158
2020-03-18,Italy,IT,3526,347,60359546,Europe,31506,2505
2020-03-19,Italy,IT,4207,473,60359546,Europe,35713,2978
2020-03-20,Italy,IT,5322,429,60359546,Europe,41035,3407
2020-03-21,Italy,IT,5986,625,60359546,Europe,47021,4032
2020-03-22,Italy,IT,6557,795,60359546,Europe,53578,4827
2020-03-23,Italy,IT,5560,649,60359546,Europe,59138,5476
2020-03-24,Italy,IT,4789,601,60359546,Europe,63927,6077
2020-03-25,Italy,IT,5249,743,60359546,Europe,69176,6820
2020-03-26,Italy,IT,5210,685,60359546,Europe,74386,7505
2020-03-27,Italy,IT,6153,660,60359546,Europe,80539,8165
2020-03-28,Italy,IT,5959,971,60359546,Europe,86498,9136
2020-03-29,Italy,IT,5974,887,60359546,Europe,92472,10023
2020-03-30,Italy,IT,5217,758,60359546,Europe,97689,10781
2020-03-31,Italy,IT,4050,810,60359546,Europe,101739,11591
2020-04-01,Italy,IT,4053,839,60359546,Europe,105792,12430
2020-04-02,Italy,IT,4782,727,60359546,Europe,110574,13157
2020-04-03,Italy,IT,4668,760,60359546,Europe,115242,13917
2020-04-04,Italy,IT,4585,764,60359546,Europe,119827,14681
2020-04-05,Italy,IT,4805,681,60359546,Europe,124632,15362
2020-04-06,Italy,IT,4316,527,60359546,Europe,128948,15889
2020-04-07,Italy,IT,3599,636,60359546,Europe,132547,16525
2020-04-08,Italy,IT,3039,604,60359546,Europe,135586,17129
2020-04-09,Italy,IT,3836,540,60359546,Europe,139422,17669
2020-04-10,Italy,IT,4204,612,60359546,Europe,143626,18281
2020-04-11,Italy,IT,3951,570,60359546,Europe,147577,18851
2020-04-12,Italy,IT,4694,619,60359546,Europe,152271,19470
2020-04-13,Italy,IT,4092,431,60359546,Europe,156363,19901
2020-04-14,Italy,IT,3153,564,60359546,Europe,159516,20465
2020-04-15,Italy,IT,2972,604,60359546,Europe,162488,21069
2020-04-16,Italy,IT,2667,578,60359546,Europe,165155,21647
2020-04-17,Italy,IT,3786,525,60359546,Europe,168941,22172
2020-04-18,Italy,IT,3493,575,60359546,Europe,172434,22747
2020-04-19,Italy,IT,3491,480,60359546,Europe,175925,23227
2020-04-20,Italy,IT,3047,433,60359546,Europe,178972,23660
2020-04-21,Italy,IT,2256,454,60359546,Europe,181228,24114
2020-04-22,Italy,IT,2729,534,60359546,Europe,183957,24648
2020-04-23,Italy,IT,3370,437,60359546,Europe,187327,25085
2020-04-24,Italy,IT,2646,464,60359546,Europe,189973,25549
2020-04-25,Italy,IT,3021,420,60359546,Europe,192994,25969
2020-04-26,Italy,IT,2357,415,60359546,Europe,195351,26384
2020-04-27,Italy,IT,2324,260,60359546,Europe,197675,26644
2020-04-28,Italy,IT,1739,333,60359546,Europe,199414,26977
2020-04-29,Italy,IT,2091,382,60359546,Europe,201505,27359
2020-04-30,Italy,IT,2086,323,60359546,Europe,203591,27682
2020-05-01,Italy,IT,1872,285,60359546,Europe,205463,27967
2020-05-02,Italy,IT,1965,269,60359546,Europe,207428,28236
2020-05-03,Italy,IT,1900,474,60359546,Europe,209328,28710
2020-05-04,Italy,IT,1389,174,60359546,Europe,210717,28884
2020-05-05,Italy,IT,1221,195,60359546,Europe,211938,29079
2020-05-06,Italy,IT,1075,236,60359546,Europe,213013,29315
2020-05-07,Italy,IT,1444,369,60359546,Europe,214457,29684
2020-05-08,Italy,IT,1401,274,60359546,Europe,215858,29958
2020-05-09,Italy,IT,1327,243,60359546,Europe,217185,30201
2020-05-10,Italy,IT,1083,194,60359546,Europe,218268,30395
2020-05-11,Italy,IT,802,165,60359546,Europe,219070,30560
2020-05-12,Italy,IT,744,179,60359546,Europe,219814,30739
2020-05-13,Italy,IT,1402,172,60359546,Europe,221216,30911
2020-05-14,Italy,IT,888,195,60359546,Europe,222104,31106
2020-05-15,Italy,IT,992,262,60359546,Europe,223096,31368
2020-05-16,Italy,IT,789,242,60359546,Europe,223885,31610
2020-05-17,Italy,IT,875,153,60359546,Europe,224760,31763
2020-05-18,Italy,IT,675,145,60359546,Europe,225435,31908
2020-05-19,Italy,IT,451,99,60359546,Europe,225886,32007
2020-05-20,Italy,IT,813,162,60359546,Europe,226699,32169
2020-05-21,Italy,IT,665,161,60359546,Europe,227364,32330
2020-05-22,Italy,IT,642,156,60359546,Europe,228006,32486
2020-05-23,Italy,IT,652,130,60359546,Europe,228658,32616
2020-05-24,Italy,IT,669,119,60359546,Europe,229327,32735
2020-05-25,Italy,IT,531,50,60359546,Europe,229858,32785
2020-05-26,Italy,IT,300,92,60359546,Europe,230158,32877
2020-05-27,Italy,IT,397,78,60359546,Europe,230555,32955
2020-05-28,Italy,IT,584,117,60359546,Europe,231139,33072
2020-05-29,Italy,IT,593,70,60359546,Europe,231732,33142
2020-05-30,Italy,IT,516,87,60359546,Europe,232248,33229
2020-05-31,Italy,IT,416,111,60359546,Europe,232664,33340
2020-06-01,Italy,IT,355,75,60359546,Europe,233019,33415
2020-06-02,Italy,IT,178,60,60359546,Europe,233197,33475
2020-06-03,Italy,IT,318,55,60359546,Europe,233515,33530
2020-06-04,Italy,IT,321,71,60359546,Europe,233836,33601
2020-06-05,Italy,IT,177,88,60359546,Europe,234013,33689
2020-06-06,Italy,IT,518,85,60359546,Europe,234531,33774
2020-06-07,Italy,IT,270,72,60359546,Europe,234801,33846
2020-06-08,Italy,IT,197,53,60359546,Europe,234998,33899
2020-06-09,Italy,IT,280,65,60359546,Europe,235278,33964
2020-06-10,Italy,IT,283,79,60359546,Europe,235561,34043
2020-06-11,Italy,IT,202,71,60359546,Europe,235763,34114
2020-06-12,Italy,IT,379,53,60359546,Europe,236142,34167
2020-06-13,Italy,IT,163,56,60359546,Europe,236305,34223
2020-06-14,Italy,IT,346,78,60359546,Europe,236651,34301
2020-06-15,Italy,IT,338,44,60359546,Europe,236989,34345
2020-06-16,Italy,IT,301,26,60359546,Europe,237290,34371
2020-06-17,Italy,IT,210,34,60359546,Europe,237500,34405
2020-06-18,Italy,IT,328,43,60359546,Europe,237828,34448
2020-06-19,Italy,IT,331,66,60359546,Europe,238159,34514
2020-06-20,Italy,IT,-148,47,60359546,Europe,238011,34561
2020-06-21,Italy,IT,264,49,60359546,Europe,238275,34610
2020-06-22,Italy,IT,224,24,60359546,Europe,238499,34634
2020-06-23,Italy,IT,221,23,60359546,Europe,238720,34657
2020-06-24,Italy,IT,113,18,60359546,Europe,238833,34675
2020-06-25,Italy,IT,577,-31,60359546,Europe,239410,34644
2020-06-26,Italy,IT,296,34,60359546,Europe,239706,34678
2020-06-27,Italy,IT,255,30,60359546,Europe,239961,34708
2020-06-28,Italy,IT,175,8,60359546,Europe,240136,34716
2020-06-29,Italy,IT,174,22,60359546,Europe,240310,34738
2020-06-30,Italy,IT,126,6,60359546,Europe,240436,34744
2020-07-01,Italy,IT,142,23,60359546,Europe,240578,34767
2020-07-02,Italy,IT,182,21,60359546,Europe,240760,34788
2020-07-03,Italy,IT,201,30,60359546,Europe,240961,34818
2020-07-04,Italy,IT,223,15,60359546,Europe,241184,34833
2020-07-05,Italy,IT,235,21,60359546,Europe,241419,34854
2020-07-06,Italy,IT,192,7,60359546,Europe,241611,34861
2020-07-07,Italy,IT,208,8,60359546,Europe,241819,34869
2020-07-08,Italy,IT,137,30,60359546,Europe,241956,34899
2020-07-09,Italy,IT,193,15,60359546,Europe,242149,34914
2020-07-10,Italy,IT,214,12,60359546,Europe,242363,34926
2020-07-11,Italy,IT,276,12,60359546,Europe,242639,34938
2020-07-12,Italy,IT,188,7,60359546,Europe,242827,34945
2020-07-13,Italy,IT,234,9,60359546,Europe,243061,34954
2020-07-14,Italy,IT,169,13,60359546,Europe,243230,34967
2020-07-15,Italy,IT,114,17,60359546,Europe,243344,34984
2020-07-16,Italy,IT,162,13,60359546,Europe,243506,34997
2020-07-17,Italy,IT,230,20,60359546,Europe,243736,35017
2020-07-18,Italy,IT,231,11,60359546,Europe,243967,35028
2020-07-19,Italy,IT,249,14,60359546,Europe,244216,35042
2020-07-20,Italy,IT,218,3,60359546,Europe,244434,35045
2020-07-21,Italy,IT,190,13,60359546,Europe,244624,35058
2020-07-22,Italy,IT,128,15,60359546,Europe,244752,35073
2020-07-23,Italy,IT,280,9,60359546,Europe,245032,35082
2020-07-24,Italy,IT,306,10,60359546,Europe,245338,35092
2020-07-25,Italy,IT,252,5,60359546,Europe,245590,35097
2020-07-26,Italy,IT,274,5,60359546,Europe,245864,35102
2020-07-27,Italy,IT,254,5,60359546,Europe,246118,35107
2020-07-28,Italy,IT,168,5,60359546,Europe,246286,35112
2020-07-29,Italy,IT,202,11,60359546,Europe,246488,35123
2020-07-30,Italy,IT,288,6,60359546,Europe,246776,35129
2020-07-31,Italy,IT,382,3,60359546,Europe,247158,35132
2020-08-01,Italy,IT,379,9,60359546,Europe,247537,35141
2020-08-02,Italy,IT,295,5,60359546,Europe,247832,35146
2020-08-03,Italy,IT,238,8,60359546,Europe,248070,35154
2020-08-04,Italy,IT,159,12,60359546,Europe,248229,35166
2020-08-05,Italy,IT,190,5,60359546,Europe,248419,35171
2020-08-06,Italy,IT,384,10,60359546,Europe,248803,35181
2020-08-07,Italy,IT,401,6,60359546,Europe,249204,35187
2020-08-08,Italy,IT,552,3,60359546,Europe,249756,35190
2020-08-09,Italy,IT,347,13,60359546,Europe,250103,35203
2020-08-10,Italy,IT,463,2,60359546,Europe,250566,35205
2020-08-11,Italy,IT,259,4,60359546,Europe,250825,35209
2020-08-12,Italy,IT,412,6,60359546,Europe,251237,35215
2020-08-13,Italy,IT,476,10,60359546,Europe,251713,35225
2020-08-14,Italy,IT,522,6,60359546,Europe,252235,35231
2020-08-15,Italy,IT,574,3,60359546,Europe,252809,35234
2020-08-16,Italy,IT,629,158,60359546,Europe,253438,35392
2020-08-17,Italy,IT,477,4,60359546,Europe,253915,35396
2020-08-18,Italy,IT,320,4,60359546,Europe,254235,35400
2020-08-19,Italy,IT,401,5,60359546,Europe,254636,35405
2020-08-20,Italy,IT,642,7,60359546,Europe,255278,35412
2020-08-21,Italy,IT,840,6,60359546,Europe,256118,35418
2020-08-22,Italy,IT,947,9,60359546,Europe,257065,35427
2020-08-23,Italy,IT,1071,3,60359546,Europe,258136,35430
2020-08-24,Italy,IT,1209,7,60359546,Europe,259345,35437
2020-08-25,Italy,IT,953,4,60359546,Europe,260298,35441
2020-08-26,Italy,IT,876,4,60359546,Europe,261174,35445
2020-08-27,Italy,IT,1366,13,60359546,Europe,262540,35458
2020-08-28,Italy,IT,1409,5,60359546,Europe,263949,35463
2020-08-29,Italy,IT,1460,9,60359546,Europe,265409,35472
2020-08-30,Italy,IT,1444,1,60359546,Europe,266853,35473
2020-08-31,Italy,IT,1365,4,60359546,Europe,268218,35477
2020-09-01,Italy,IT,996,6,60359546,Europe,269214,35483
2020-09-02,Italy,IT,975,8,60359546,Europe,270189,35491
2020-09-03,Italy,IT,1326,6,60359546,Europe,271515,35497
2020-09-04,Italy,IT,1397,10,60359546,Europe,272912,35507
2020-09-05,Italy,IT,1732,11,60359546,Europe,274644,35518
2020-09-06,Italy,IT,1694,16,60359546,Europe,276338,35534
2020-09-07,Italy,IT,1296,7,60359546,Europe,277634,35541
2020-09-08,Italy,IT,1150,12,60359546,Europe,278784,35553
2020-09-09,Italy,IT,1369,10,60359546,Europe,280153,35563
2020-09-10,Italy,IT,1430,14,60359546,Europe,281583,35577
2020-09-11,Italy,IT,1597,10,60359546,Europe,283180,35587
2020-09-12,Italy,IT,1616,10,60359546,Europe,284796,35597
2020-09-13,Italy,IT,1501,6,60359546,Europe,286297,35603
2020-09-14,Italy,IT,1456,7,60359546,Europe,287753,35610
2020-09-15,Italy,IT,1008,14,60359546,Europe,288761,35624
2020-09-16,Italy,IT,1229,9,60359546,Europe,289990,35633
2020-09-17,Italy,IT,1452,12,60359546,Europe,291442,35645
2020-09-18,Italy,IT,1583,13,60359546,Europe,293025,35658
2020-09-19,Italy,IT,1907,10,60359546,Europe,294932,35668
2020-09-20,Italy,IT,1637,24,60359546,Europe,296569,35692
2020-09-21,Italy,IT,1587,15,60359546,Europe,298156,35707
2020-09-22,Italy,IT,1350,17,60359546,Europe,299506,35724
2020-09-23,Italy,IT,1391,14,60359546,Europe,300897,35738
2020-09-24,Italy,IT,1640,20,60359546,Europe,302537,35758
2020-09-25,Italy,IT,1786,23,60359546,Europe,304323,35781
2020-09-26,Italy,IT,1912,20,60359546,Europe,306235,35801
2020-09-27,Italy,IT,1869,17,60359546,Europe,308104,35818
2020-09-28,Italy,IT,1766,17,60359546,Europe,309870,35835
2020-09-29,Italy,IT,1494,16,60359546,Europe,311364,35851
2020-09-30,Italy,IT,1647,24,60359546,Europe,313011,35875
2020-10-01,Italy,IT,1850,19,60359546,Europe,314861,35894
2020-10-02,Italy,IT,2548,24,60359546,Europe,317409,35918
2020-10-03,Italy,IT,2499,23,60359546,Europe,319908,35941
2020-10-04,Italy,IT,2843,27,60359546,Europe,322751,35968
2020-10-05,Italy,IT,2578,18,60359546,Europe,325329,35986
2020-10-06,Italy,IT,2257,16,60359546,Europe,327586,36002
2020-10-07,Italy,IT,2677,28,60359546,Europe,330263,36030
2020-10-08,Italy,IT,3677,31,60359546,Europe,333940,36061
2020-10-09,Italy,IT,4458,22,60359546,Europe,338398,36083
2020-10-10,Italy,IT,5372,28,60359546,Europe,343770,36111
2020-10-11,Italy,IT,5724,29,60359546,Europe,349494,36140
2020-10-12,Italy,IT,5456,26,60359546,Europe,354950,36166
2020-10-13,Italy,IT,4619,39,60359546,Europe,359569,36205
2020-10-14,Italy,IT,5898,41,60359546,Europe,365467,36246
2020-10-15,Italy,IT,7332,43,60359546,Europe,372799,36289
2020-10-16,Italy,IT,8803,83,60359546,Europe,381602,36372
2020-10-17,Italy,IT,10009,55,60359546,Europe,391611,36427
2020-10-18,Italy,IT,10925,47,60359546,Europe,402536,36474
2020-10-19,Italy,IT,11705,69,60359546,Europe,414241,36543
2020-10-20,Italy,IT,9337,73,60359546,Europe,423578,36616
2020-10-21,Italy,IT,10871,89,60359546,Europe,434449,36705
2020-10-22,Italy,IT,15199,127,60359546,Europe,449648,36832
2020-10-23,Italy,IT,16078,136,60359546,Europe,465726,36968
2020-10-24,Italy,IT,19143,91,60359546,Europe,484869,37059
2020-10-25,Italy,IT,19640,151,60359546,Europe,504509,37210
2020-10-26,Italy,IT,21273,128,60359546,Europe,525782,37338
2020-10-27,Italy,IT,17007,141,60359546,Europe,542789,37479
2020-10-28,Italy,IT,21989,221,60359546,Europe,564778,37700
2020-10-29,Italy,IT,24988,205,60359546,Europe,589766,37905
2020-10-30,Italy,IT,26829,217,60359546,Europe,616595,38122
2020-10-31,Italy,IT,31079,199,60359546,Europe,647674,38321
2020-11-01,Italy,IT,31756,297,60359546,Europe,679430,38618
2020-11-02,Italy,IT,29905,208,60359546,Europe,709335,38826
2020-11-03,Italy,IT,22253,233,60359546,Europe,731588,39059
2020-11-04,Italy,IT,28241,353,60359546,Europe,759829,39412
2020-11-05,Italy,IT,30548,352,60359546,Europe,790377,39764
2020-11-06,Italy,IT,34502,428,60359546,Europe,824879,40192
2020-11-07,Italy,IT,37802,446,60359546,Europe,862681,40638
2020-11-08,Italy,IT,39809,425,60359546,Europe,902490,41063
2020-11-09,Italy,IT,32614,331,60359546,Europe,935104,41394
2020-11-10,Italy,IT,25269,356,60359546,Europe,960373,41750
2020-11-11,Italy,IT,35090,580,60359546,Europe,995463,42330
2020-11-12,Italy,IT,32961,623,60359546,Europe,1028424,42953
2020-11-13,Italy,IT,37977,636,60359546,Europe,1066401,43589
2020-11-14,Italy,IT,40902,550,60359546,Europe,1107303,44139
2020-11-15,Italy,IT,37249,544,60359546,Europe,1144552,44683
2020-11-16,Italy,IT,33977,546,60359546,Europe,1178529,45229
2020-11-17,Italy,IT,27352,504,60359546,Europe,1205881,45733
2020-11-18,Italy,IT,32191,731,60359546,Europe,1238072,46464
2020-11-19,Italy,IT,34280,753,60359546,Europe,1272352,47217
2020-11-20,Italy,IT,36176,653,60359546,Europe,1308528,47870
2020-11-21,Italy,IT,37239,699,60359546,Europe,1345767,48569
2020-11-22,Italy,IT,34764,692,60359546,Europe,1380531,49261
2020-11-23,Italy,IT,28337,562,60359546,Europe,1408868,49823
2020-11-24,Italy,IT,22927,630,60359546,Europe,1431795,50453
2020-11-25,Italy,IT,23227,853,60359546,Europe,1455022,51306
2020-11-26,Italy,IT,25852,722,60359546,Europe,1480874,52028
2020-11-27,Italy,IT,29001,822,60359546,Europe,1509875,52850
2020-11-28,Italy,IT,28342,827,60359546,Europe,1538217,53677
2020-11-29,Italy,IT,26315,686,60359546,Europe,1564532,54363
2020-11-30,Italy,IT,20646,541,60359546,Europe,1585178,54904
2020-12-01,Italy,IT,16376,672,60359546,Europe,1601554,55576
2020-12-02,Italy,IT,19347,785,60359546,Europe,1620901,56361
2020-12-03,Italy,IT,20709,684,60359546,Europe,1641610,57045
2020-12-04,Italy,IT,23219,993,60359546,Europe,1664829,58038
2020-12-05,Italy,IT,24110,814,60359546,Europe,1688939,58852
2020-12-06,Italy,IT,21052,662,60359546,Europe,1709991,59514
2020-12-07,Italy,IT,18887,564,60359546,Europe,1728878,60078
2020-12-08,Italy,IT,13679,528,60359546,Europe,1742557,60606
2020-12-09,Italy,IT,14837,634,60359546,Europe,1757394,61240
2020-12-10,Italy,IT,12755,499,60359546,Europe,1770149,61739
2020-12-11,Italy,IT,16998,887,60359546,Europe,1787147,62626
2020-12-12,Italy,IT,18726,761,60359546,Europe,1805873,63387
2020-12-13,Italy,IT,19902,649,60359546,Europe,1825775,64036
2020-12-14,Italy,IT,17937,484,60359546,Europe,1843712,64520
2020-03-20,Jersey,JE,5,0,107796,Europe,5,0
2020-03-21,Jersey,JE,7,0,107796,Europe,12,0
2020-03-22,Jersey,JE,0,0,107796,Europe,12,0
2020-03-23,Jersey,JE,3,0,107796,Europe,15,0
2020-03-24,Jersey,JE,3,0,107796,Europe,18,0
2020-03-25,Jersey,JE,0,0,107796,Europe,18,0
2020-03-26,Jersey,JE,0,0,107796,Europe,18,0
2020-03-27,Jersey,JE,14,1,107796,Europe,32,1
2020-03-28,Jersey,JE,20,0,107796,Europe,52,1
2020-03-29,Jersey,JE,9,0,107796,Europe,61,1
2020-03-30,Jersey,JE,2,1,107796,Europe,63,2
2020-03-31,Jersey,JE,0,0,107796,Europe,63,2
2020-04-01,Jersey,JE,18,0,107796,Europe,81,2
2020-04-02,Jersey,JE,0,0,107796,Europe,81,2
2020-04-03,Jersey,JE,0,0,107796,Europe,81,2
2020-04-04,Jersey,JE,37,0,107796,Europe,118,2
2020-04-05,Jersey,JE,5,1,107796,Europe,123,3
2020-04-06,Jersey,JE,32,0,107796,Europe,155,3
2020-04-07,Jersey,JE,14,0,107796,Europe,169,3
2020-04-08,Jersey,JE,1,0,107796,Europe,170,3
2020-04-09,Jersey,JE,0,0,107796,Europe,170,3
2020-04-10,Jersey,JE,13,0,107796,Europe,183,3
2020-04-11,Jersey,JE,15,1,107796,Europe,198,4
2020-04-12,Jersey,JE,0,0,107796,Europe,198,4
2020-04-13,Jersey,JE,15,0,107796,Europe,213,4
2020-04-14,Jersey,JE,4,0,107796,Europe,217,4
2020-04-15,Jersey,JE,0,0,107796,Europe,217,4
2020-04-16,Jersey,JE,0,2,107796,Europe,217,6
2020-04-17,Jersey,JE,6,4,107796,Europe,223,10
2020-04-18,Jersey,JE,1,1,107796,Europe,224,11
2020-04-19,Jersey,JE,21,1,107796,Europe,245,12
2020-04-20,Jersey,JE,4,0,107796,Europe,249,12
2020-04-21,Jersey,JE,0,2,107796,Europe,249,14
2020-04-22,Jersey,JE,6,0,107796,Europe,255,14
2020-04-23,Jersey,JE,0,4,107796,Europe,255,18
2020-04-24,Jersey,JE,21,1,107796,Europe,276,19
2020-04-25,Jersey,JE,2,0,107796,Europe,278,19
2020-04-26,Jersey,JE,2,0,107796,Europe,280,19
2020-04-27,Jersey,JE,1,0,107796,Europe,281,19
2020-04-28,Jersey,JE,2,0,107796,Europe,283,19
2020-04-29,Jersey,JE,1,1,107796,Europe,284,20
2020-04-30,Jersey,JE,2,1,107796,Europe,286,21
2020-05-01,Jersey,JE,0,2,107796,Europe,286,23
2020-05-02,Jersey,JE,0,1,107796,Europe,286,24
2020-05-03,Jersey,JE,5,0,107796,Europe,291,24
2020-05-04,Jersey,JE,1,0,107796,Europe,292,24
2020-05-05,Jersey,JE,1,0,107796,Europe,293,24
2020-05-06,Jersey,JE,0,0,107796,Europe,293,24
2020-05-07,Jersey,JE,0,1,107796,Europe,293,25
2020-05-08,Jersey,JE,0,0,107796,Europe,293,25
2020-05-09,Jersey,JE,0,0,107796,Europe,293,25
2020-05-10,Jersey,JE,0,0,107796,Europe,293,25
2020-05-11,Jersey,JE,1,0,107796,Europe,294,25
2020-05-12,Jersey,JE,0,0,107796,Europe,294,25
2020-05-13,Jersey,JE,1,1,107796,Europe,295,26
2020-05-14,Jersey,JE,1,1,107796,Europe,296,27
2020-05-15,Jersey,JE,1,0,107796,Europe,297,27
2020-05-16,Jersey,JE,0,0,107796,Europe,297,27
2020-05-17,Jersey,JE,5,0,107796,Europe,302,27
2020-05-18,Jersey,JE,0,0,107796,Europe,302,27
2020-05-19,Jersey,JE,1,0,107796,Europe,303,27
2020-05-20,Jersey,JE,0,1,107796,Europe,303,28
2020-05-21,Jersey,JE,3,1,107796,Europe,306,29
2020-05-22,Jersey,JE,0,0,107796,Europe,306,29
2020-05-23,Jersey,JE,0,0,107796,Europe,306,29
2020-05-24,Jersey,JE,0,0,107796,Europe,306,29
2020-05-25,Jersey,JE,0,0,107796,Europe,306,29
2020-05-26,Jersey,JE,1,0,107796,Europe,307,29
2020-05-27,Jersey,JE,0,0,107796,Europe,307,29
2020-05-28,Jersey,JE,1,0,107796,Europe,308,29
2020-05-29,Jersey,JE,0,0,107796,Europe,308,29
2020-05-30,Jersey,JE,0,0,107796,Europe,308,29
2020-05-31,Jersey,JE,0,0,107796,Europe,308,29
2020-06-01,Jersey,JE,0,0,107796,Europe,308,29
2020-06-02,Jersey,JE,0,0,107796,Europe,308,29
2020-06-03,Jersey,JE,0,1,107796,Europe,308,30
2020-06-04,Jersey,JE,1,0,107796,Europe,309,30
2020-06-05,Jersey,JE,0,0,107796,Europe,309,30
2020-06-06,Jersey,JE,0,0,107796,Europe,309,30
2020-06-07,Jersey,JE,2,0,107796,Europe,311,30
2020-06-08,Jersey,JE,0,0,107796,Europe,311,30
2020-06-09,Jersey,JE,1,0,107796,Europe,312,30
2020-06-10,Jersey,JE,1,0,107796,Europe,313,30
2020-06-11,Jersey,JE,0,0,107796,Europe,313,30
2020-06-12,Jersey,JE,0,0,107796,Europe,313,30
2020-06-13,Jersey,JE,0,0,107796,Europe,313,30
2020-06-14,Jersey,JE,0,0,107796,Europe,313,30
2020-06-15,Jersey,JE,0,0,107796,Europe,313,30
2020-06-16,Jersey,JE,3,0,107796,Europe,316,30
2020-06-17,Jersey,JE,0,0,107796,Europe,316,30
2020-06-18,Jersey,JE,2,0,107796,Europe,318,30
2020-06-19,Jersey,JE,0,0,107796,Europe,318,30
2020-06-20,Jersey,JE,0,1,107796,Europe,318,31
2020-06-21,Jersey,JE,0,0,107796,Europe,318,31
2020-06-22,Jersey,JE,0,0,107796,Europe,318,31
2020-06-23,Jersey,JE,0,0,107796,Europe,318,31
2020-06-24,Jersey,JE,0,0,107796,Europe,318,31
2020-06-25,Jersey,JE,1,0,107796,Europe,319,31
2020-06-26,Jersey,JE,0,0,107796,Europe,319,31
2020-06-27,Jersey,JE,0,0,107796,Europe,319,31
2020-06-28,Jersey,JE,0,0,107796,Europe,319,31
2020-06-29,Jersey,JE,0,0,107796,Europe,319,31
2020-06-30,Jersey,JE,0,0,107796,Europe,319,31
2020-07-01,Jersey,JE,0,0,107796,Europe,319,31
2020-07-02,Jersey,JE,0,0,107796,Europe,319,31
2020-07-03,Jersey,JE,1,0,107796,Europe,320,31
2020-07-04,Jersey,JE,0,0,107796,Europe,320,31
2020-07-05,Jersey,JE,0,0,107796,Europe,320,31
2020-07-06,Jersey,JE,0,0,107796,Europe,320,31
2020-07-07,Jersey,JE,5,0,107796,Europe,325,31
2020-07-08,Jersey,JE,0,0,107796,Europe,325,31
2020-07-09,Jersey,JE,0,0,107796,Europe,325,31
2020-07-10,Jersey,JE,0,0,107796,Europe,325,31
2020-07-11,Jersey,JE,0,0,107796,Europe,325,31
2020-07-12,Jersey,JE,0,0,107796,Europe,325,31
2020-07-13,Jersey,JE,0,0,107796,Europe,325,31
2020-07-14,Jersey,JE,4,0,107796,Europe,329,31
2020-07-15,Jersey,JE,0,0,107796,Europe,329,31
2020-07-16,Jersey,JE,0,0,107796,Europe,329,31
2020-07-17,Jersey,JE,2,0,107796,Europe,331,31
2020-07-18,Jersey,JE,0,0,107796,Europe,331,31
2020-07-19,Jersey,JE,0,0,107796,Europe,331,31
2020-07-20,Jersey,JE,0,0,107796,Europe,331,31
2020-07-21,Jersey,JE,0,0,107796,Europe,331,31
2020-07-22,Jersey,JE,0,0,107796,Europe,331,31
2020-07-23,Jersey,JE,0,0,107796,Europe,331,31
2020-07-24,Jersey,JE,0,0,107796,Europe,331,31
2020-07-25,Jersey,JE,1,0,107796,Europe,332,31
2020-07-26,Jersey,JE,0,0,107796,Europe,332,31
2020-07-27,Jersey,JE,0,0,107796,Europe,332,31
2020-07-28,Jersey,JE,2,0,107796,Europe,334,31
2020-07-29,Jersey,JE,1,0,107796,Europe,335,31
2020-07-30,Jersey,JE,0,0,107796,Europe,335,31
2020-07-31,Jersey,JE,0,0,107796,Europe,335,31
2020-08-01,Jersey,JE,0,0,107796,Europe,335,31
2020-08-02,Jersey,JE,0,0,107796,Europe,335,31
2020-08-03,Jersey,JE,0,0,107796,Europe,335,31
2020-08-04,Jersey,JE,4,0,107796,Europe,339,31
2020-08-05,Jersey,JE,4,0,107796,Europe,343,31
2020-08-06,Jersey,JE,1,0,107796,Europe,344,31
2020-08-07,Jersey,JE,1,0,107796,Europe,345,31
2020-08-08,Jersey,JE,0,0,107796,Europe,345,31
2020-08-09,Jersey,JE,0,0,107796,Europe,345,31
2020-08-10,Jersey,JE,0,0,107796,Europe,345,31
2020-08-11,Jersey,JE,2,0,107796,Europe,347,31
2020-08-12,Jersey,JE,0,0,107796,Europe,347,31
2020-08-13,Jersey,JE,4,0,107796,Europe,351,31
2020-08-14,Jersey,JE,1,0,107796,Europe,352,31
2020-08-15,Jersey,JE,3,0,107796,Europe,355,31
2020-08-16,Jersey,JE,0,0,107796,Europe,355,31
2020-08-17,Jersey,JE,0,0,107796,Europe,355,31
2020-08-18,Jersey,JE,2,1,107796,Europe,357,32
2020-08-19,Jersey,JE,0,0,107796,Europe,357,32
2020-08-20,Jersey,JE,4,0,107796,Europe,361,32
2020-08-21,Jersey,JE,1,0,107796,Europe,362,32
2020-08-22,Jersey,JE,1,0,107796,Europe,363,32
2020-08-23,Jersey,JE,0,0,107796,Europe,363,32
2020-08-24,Jersey,JE,0,0,107796,Europe,363,32
2020-08-25,Jersey,JE,1,0,107796,Europe,364,32
2020-08-26,Jersey,JE,4,0,107796,Europe,368,32
2020-08-27,Jersey,JE,3,0,107796,Europe,371,32
2020-08-28,Jersey,JE,1,0,107796,Europe,372,32
2020-08-29,Jersey,JE,1,0,107796,Europe,373,32
2020-08-30,Jersey,JE,1,0,107796,Europe,374,32
2020-08-31,Jersey,JE,0,0,107796,Europe,374,32
2020-09-01,Jersey,JE,0,0,107796,Europe,374,32
2020-09-02,Jersey,JE,5,0,107796,Europe,379,32
2020-09-03,Jersey,JE,2,0,107796,Europe,381,32
2020-09-04,Jersey,JE,0,0,107796,Europe,381,32
2020-09-05,Jersey,JE,2,0,107796,Europe,383,32
2020-09-06,Jersey,JE,1,0,107796,Europe,384,32
2020-09-07,Jersey,JE,0,0,107796,Europe,384,32
2020-09-08,Jersey,JE,0,0,107796,Europe,384,32
2020-09-09,Jersey,JE,1,0,107796,Europe,385,32
2020-09-10,Jersey,JE,0,0,107796,Europe,385,32
2020-09-11,Jersey,JE,-6,0,107796,Europe,379,32
2020-09-12,Jersey,JE,1,0,107796,Europe,380,32
2020-09-13,Jersey,JE,0,0,107796,Europe,380,32
2020-09-14,Jersey,JE,0,0,107796,Europe,380,32
2020-09-15,Jersey,JE,6,0,107796,Europe,386,32
2020-09-16,Jersey,JE,0,0,107796,Europe,386,32
2020-09-17,Jersey,JE,3,0,107796,Europe,389,32
2020-09-18,Jersey,JE,2,0,107796,Europe,391,32
2020-09-19,Jersey,JE,2,0,107796,Europe,393,32
2020-09-20,Jersey,JE,0,0,107796,Europe,393,32
2020-09-21,Jersey,JE,0,0,107796,Europe,393,32
2020-09-22,Jersey,JE,3,0,107796,Europe,396,32
2020-09-23,Jersey,JE,2,0,107796,Europe,398,32
2020-09-24,Jersey,JE,1,0,107796,Europe,399,32
2020-09-25,Jersey,JE,0,0,107796,Europe,399,32
2020-09-26,Jersey,JE,1,0,107796,Europe,400,32
2020-09-27,Jersey,JE,0,0,107796,Europe,400,32
2020-09-28,Jersey,JE,0,0,107796,Europe,400,32
2020-09-29,Jersey,JE,8,0,107796,Europe,408,32
2020-09-30,Jersey,JE,1,0,107796,Europe,409,32
2020-10-01,Jersey,JE,5,0,107796,Europe,414,32
2020-10-02,Jersey,JE,5,0,107796,Europe,419,32
2020-10-03,Jersey,JE,2,0,107796,Europe,421,32
2020-10-04,Jersey,JE,0,0,107796,Europe,421,32
2020-10-05,Jersey,JE,0,0,107796,Europe,421,32
2020-10-06,Jersey,JE,10,0,107796,Europe,431,32
2020-10-07,Jersey,JE,7,0,107796,Europe,438,32
2020-10-08,Jersey,JE,3,0,107796,Europe,441,32
2020-10-09,Jersey,JE,2,0,107796,Europe,443,32
2020-10-10,Jersey,JE,6,0,107796,Europe,449,32
2020-10-11,Jersey,JE,0,0,107796,Europe,449,32
2020-10-12,Jersey,JE,0,0,107796,Europe,449,32
2020-10-13,Jersey,JE,30,0,107796,Europe,479,32
2020-10-14,Jersey,JE,4,0,107796,Europe,483,32
2020-10-15,Jersey,JE,4,0,107796,Europe,487,32
2020-10-16,Jersey,JE,3,0,107796,Europe,490,32
2020-10-17,Jersey,JE,0,0,107796,Europe,490,32
2020-10-18,Jersey,JE,0,0,107796,Europe,490,32
2020-10-19,Jersey,JE,0,0,107796,Europe,490,32
2020-10-20,Jersey,JE,19,0,107796,Europe,509,32
2020-10-21,Jersey,JE,7,0,107796,Europe,516,32
2020-10-22,Jersey,JE,7,0,107796,Europe,523,32
2020-10-23,Jersey,JE,3,0,107796,Europe,526,32
2020-10-24,Jersey,JE,4,0,107796,Europe,530,32
2020-10-25,Jersey,JE,0,0,107796,Europe,530,32
2020-10-26,Jersey,JE,0,0,107796,Europe,530,32
2020-10-27,Jersey,JE,26,0,107796,Europe,556,32
2020-10-28,Jersey,JE,4,0,107796,Europe,560,32
2020-10-29,Jersey,JE,6,0,107796,Europe,566,32
2020-10-30,Jersey,JE,3,0,107796,Europe,569,32
2020-10-31,Jersey,JE,5,0,107796,Europe,574,32
2020-11-01,Jersey,JE,0,0,107796,Europe,574,32
2020-11-02,Jersey,JE,0,0,107796,Europe,574,32
2020-11-03,Jersey,JE,17,0,107796,Europe,591,32
2020-11-04,Jersey,JE,17,0,107796,Europe,608,32
2020-11-05,Jersey,JE,12,0,107796,Europe,620,32
2020-11-06,Jersey,JE,12,0,107796,Europe,632,32
2020-11-07,Jersey,JE,11,0,107796,Europe,643,32
2020-11-08,Jersey,JE,0,0,107796,Europe,643,32
2020-11-09,Jersey,JE,0,0,107796,Europe,643,32
2020-11-10,Jersey,JE,29,0,107796,Europe,672,32
2020-11-11,Jersey,JE,18,0,107796,Europe,690,32
2020-11-12,Jersey,JE,14,0,107796,Europe,704,32
2020-11-13,Jersey,JE,17,0,107796,Europe,721,32
2020-11-14,Jersey,JE,11,0,107796,Europe,732,32
2020-11-15,Jersey,JE,0,0,107796,Europe,732,32
2020-11-16,Jersey,JE,0,0,107796,Europe,732,32
2020-11-17,Jersey,JE,32,0,107796,Europe,764,32
2020-11-18,Jersey,JE,11,0,107796,Europe,775,32
2020-11-19,Jersey,JE,11,0,107796,Europe,786,32
2020-11-20,Jersey,JE,11,0,107796,Europe,797,32
2020-11-21,Jersey,JE,14,0,107796,Europe,811,32
2020-11-22,Jersey,JE,0,0,107796,Europe,811,32
2020-11-23,Jersey,JE,0,0,107796,Europe,811,32
2020-11-24,Jersey,JE,24,0,107796,Europe,835,32
2020-11-25,Jersey,JE,6,0,107796,Europe,841,32
2020-11-26,Jersey,JE,21,0,107796,Europe,862,32
2020-11-27,Jersey,JE,35,0,107796,Europe,897,32
2020-11-28,Jersey,JE,31,0,107796,Europe,928,32
2020-11-29,Jersey,JE,0,0,107796,Europe,928,32
2020-11-30,Jersey,JE,0,0,107796,Europe,928,32
2020-12-01,Jersey,JE,84,0,107796,Europe,1012,32
2020-12-02,Jersey,JE,42,0,107796,Europe,1054,32
2020-12-03,Jersey,JE,56,0,107796,Europe,1110,32
2020-12-04,Jersey,JE,60,0,107796,Europe,1170,32
2020-12-05,Jersey,JE,68,0,107796,Europe,1238,32
2020-12-06,Jersey,JE,23,0,107796,Europe,1261,32
2020-12-07,Jersey,JE,96,0,107796,Europe,1357,32
2020-12-08,Jersey,JE,31,0,107796,Europe,1388,32
2020-12-09,Jersey,JE,72,0,107796,Europe,1460,32
2020-12-10,Jersey,JE,37,0,107796,Europe,1497,32
2020-12-11,Jersey,JE,58,0,107796,Europe,1555,32
2020-12-12,Jersey,JE,82,0,107796,Europe,1637,32
2020-12-13,Jersey,JE,51,0,107796,Europe,1688,32
2020-12-14,Jersey,JE,91,0,107796,Europe,1779,32
2020-03-12,Jamaica,JM,2,0,2948277,America,2,0
2020-03-13,Jamaica,JM,4,0,2948277,America,6,0
2020-03-14,Jamaica,JM,2,0,2948277,America,8,0
2020-03-16,Jamaica,JM,2,0,2948277,America,10,0
2020-03-17,Jamaica,JM,0,0,2948277,America,10,0
2020-03-18,Jamaica,JM,3,0,2948277,America,13,0
2020-03-19,Jamaica,JM,2,0,2948277,America,15,0
2020-03-20,Jamaica,JM,1,0,2948277,America,16,0
2020-03-21,Jamaica,JM,3,0,2948277,America,19,0
2020-03-22,Jamaica,JM,0,0,2948277,America,19,0
2020-03-23,Jamaica,JM,0,0,2948277,America,19,0
2020-03-24,Jamaica,JM,0,0,2948277,America,19,0
2020-03-25,Jamaica,JM,2,1,2948277,America,21,1
2020-03-26,Jamaica,JM,4,0,2948277,America,25,1
2020-03-27,Jamaica,JM,1,0,2948277,America,26,1
2020-03-28,Jamaica,JM,0,0,2948277,America,26,1
2020-03-29,Jamaica,JM,6,0,2948277,America,32,1
2020-03-30,Jamaica,JM,2,0,2948277,America,34,1
2020-03-31,Jamaica,JM,4,0,2948277,America,38,1
2020-04-01,Jamaica,JM,0,0,2948277,America,38,1
2020-04-02,Jamaica,JM,6,2,2948277,America,44,3
2020-04-03,Jamaica,JM,3,0,2948277,America,47,3
2020-04-04,Jamaica,JM,6,0,2948277,America,53,3
2020-04-05,Jamaica,JM,2,0,2948277,America,55,3
2020-04-06,Jamaica,JM,3,0,2948277,America,58,3
2020-04-07,Jamaica,JM,1,0,2948277,America,59,3
2020-04-08,Jamaica,JM,4,0,2948277,America,63,3
2020-04-09,Jamaica,JM,0,1,2948277,America,63,4
2020-04-10,Jamaica,JM,0,0,2948277,America,63,4
2020-04-11,Jamaica,JM,2,0,2948277,America,65,4
2020-04-12,Jamaica,JM,4,0,2948277,America,69,4
2020-04-13,Jamaica,JM,3,0,2948277,America,72,4
2020-04-14,Jamaica,JM,1,0,2948277,America,73,4
2020-04-15,Jamaica,JM,32,1,2948277,America,105,5
2020-04-16,Jamaica,JM,20,0,2948277,America,125,5
2020-04-17,Jamaica,JM,18,0,2948277,America,143,5
2020-04-18,Jamaica,JM,20,0,2948277,America,163,5
2020-04-19,Jamaica,JM,10,0,2948277,America,173,5
2020-04-20,Jamaica,JM,23,0,2948277,America,196,5
2020-04-21,Jamaica,JM,27,1,2948277,America,223,6
2020-04-22,Jamaica,JM,10,0,2948277,America,233,6
2020-04-23,Jamaica,JM,19,0,2948277,America,252,6
2020-04-24,Jamaica,JM,0,0,2948277,America,252,6
2020-04-25,Jamaica,JM,36,1,2948277,America,288,7
2020-04-26,Jamaica,JM,17,0,2948277,America,305,7
2020-04-27,Jamaica,JM,45,0,2948277,America,350,7
2020-04-28,Jamaica,JM,14,0,2948277,America,364,7
2020-04-29,Jamaica,JM,17,0,2948277,America,381,7
2020-04-30,Jamaica,JM,15,0,2948277,America,396,7
2020-05-01,Jamaica,JM,26,1,2948277,America,422,8
2020-05-02,Jamaica,JM,10,0,2948277,America,432,8
2020-05-03,Jamaica,JM,31,0,2948277,America,463,8
2020-05-04,Jamaica,JM,6,1,2948277,America,469,9
2020-05-05,Jamaica,JM,2,0,2948277,America,471,9
2020-05-06,Jamaica,JM,2,0,2948277,America,473,9
2020-05-07,Jamaica,JM,5,0,2948277,America,478,9
2020-05-08,Jamaica,JM,10,0,2948277,America,488,9
2020-05-09,Jamaica,JM,2,0,2948277,America,490,9
2020-05-10,Jamaica,JM,8,0,2948277,America,498,9
2020-05-11,Jamaica,JM,4,0,2948277,America,502,9
2020-05-12,Jamaica,JM,3,0,2948277,America,505,9
2020-05-13,Jamaica,JM,2,0,2948277,America,507,9
2020-05-14,Jamaica,JM,2,0,2948277,America,509,9
2020-05-15,Jamaica,JM,0,0,2948277,America,509,9
2020-05-16,Jamaica,JM,2,0,2948277,America,511,9
2020-05-17,Jamaica,JM,6,0,2948277,America,517,9
2020-05-18,Jamaica,JM,3,0,2948277,America,520,9
2020-05-19,Jamaica,JM,0,0,2948277,America,520,9
2020-05-20,Jamaica,JM,0,0,2948277,America,520,9
2020-05-21,Jamaica,JM,9,0,2948277,America,529,9
2020-05-22,Jamaica,JM,5,0,2948277,America,534,9
2020-05-23,Jamaica,JM,10,0,2948277,America,544,9
2020-05-24,Jamaica,JM,6,0,2948277,America,550,9
2020-05-25,Jamaica,JM,2,0,2948277,America,552,9
2020-05-26,Jamaica,JM,4,0,2948277,America,556,9
2020-05-27,Jamaica,JM,8,0,2948277,America,564,9
2020-05-28,Jamaica,JM,5,0,2948277,America,569,9
2020-05-29,Jamaica,JM,0,0,2948277,America,569,9
2020-05-30,Jamaica,JM,6,0,2948277,America,575,9
2020-05-31,Jamaica,JM,6,0,2948277,America,581,9
2020-06-01,Jamaica,JM,5,0,2948277,America,586,9
2020-06-02,Jamaica,JM,2,0,2948277,America,588,9
2020-06-03,Jamaica,JM,2,0,2948277,America,590,9
2020-06-04,Jamaica,JM,0,0,2948277,America,590,9
2020-06-05,Jamaica,JM,1,1,2948277,America,591,10
2020-06-06,Jamaica,JM,4,0,2948277,America,595,10
2020-06-07,Jamaica,JM,1,0,2948277,America,596,10
2020-06-08,Jamaica,JM,2,0,2948277,America,598,10
2020-06-09,Jamaica,JM,1,0,2948277,America,599,10
2020-06-10,Jamaica,JM,6,0,2948277,America,605,10
2020-06-11,Jamaica,JM,0,0,2948277,America,605,10
2020-06-12,Jamaica,JM,6,0,2948277,America,611,10
2020-06-13,Jamaica,JM,3,0,2948277,America,614,10
2020-06-14,Jamaica,JM,1,0,2948277,America,615,10
2020-06-15,Jamaica,JM,2,0,2948277,America,617,10
2020-06-16,Jamaica,JM,4,0,2948277,America,621,10
2020-06-17,Jamaica,JM,0,0,2948277,America,621,10
2020-06-18,Jamaica,JM,5,0,2948277,America,626,10
2020-06-19,Jamaica,JM,0,0,2948277,America,626,10
2020-06-20,Jamaica,JM,26,0,2948277,America,652,10
2020-06-21,Jamaica,JM,5,0,2948277,America,657,10
2020-06-22,Jamaica,JM,2,0,2948277,America,659,10
2020-06-23,Jamaica,JM,6,0,2948277,America,665,10
2020-06-24,Jamaica,JM,5,0,2948277,America,670,10
2020-06-25,Jamaica,JM,8,0,2948277,America,678,10
2020-06-26,Jamaica,JM,6,0,2948277,America,684,10
2020-06-27,Jamaica,JM,2,0,2948277,America,686,10
2020-06-28,Jamaica,JM,4,0,2948277,America,690,10
2020-06-29,Jamaica,JM,6,0,2948277,America,696,10
2020-06-30,Jamaica,JM,2,0,2948277,America,698,10
2020-07-01,Jamaica,JM,4,0,2948277,America,702,10
2020-07-02,Jamaica,JM,5,0,2948277,America,707,10
2020-07-03,Jamaica,JM,8,0,2948277,America,715,10
2020-07-04,Jamaica,JM,6,0,2948277,America,721,10
2020-07-05,Jamaica,JM,7,0,2948277,America,728,10
2020-07-06,Jamaica,JM,4,0,2948277,America,732,10
2020-07-07,Jamaica,JM,5,0,2948277,America,737,10
2020-07-08,Jamaica,JM,8,0,2948277,America,745,10
2020-07-09,Jamaica,JM,6,0,2948277,America,751,10
2020-07-10,Jamaica,JM,2,0,2948277,America,753,10
2020-07-11,Jamaica,JM,0,0,2948277,America,753,10
2020-07-12,Jamaica,JM,5,0,2948277,America,758,10
2020-07-13,Jamaica,JM,0,0,2948277,America,758,10
2020-07-14,Jamaica,JM,1,0,2948277,America,759,10
2020-07-15,Jamaica,JM,3,0,2948277,America,762,10
2020-07-16,Jamaica,JM,1,0,2948277,America,763,10
2020-07-17,Jamaica,JM,2,0,2948277,America,765,10
2020-07-18,Jamaica,JM,3,0,2948277,America,768,10
2020-07-19,Jamaica,JM,6,0,2948277,America,774,10
2020-07-20,Jamaica,JM,16,0,2948277,America,790,10
2020-07-21,Jamaica,JM,19,0,2948277,America,809,10
2020-07-22,Jamaica,JM,0,0,2948277,America,809,10
2020-07-23,Jamaica,JM,7,0,2948277,America,816,10
2020-07-24,Jamaica,JM,0,0,2948277,America,816,10
2020-07-25,Jamaica,JM,5,0,2948277,America,821,10
2020-07-26,Jamaica,JM,16,0,2948277,America,837,10
2020-07-27,Jamaica,JM,5,0,2948277,America,842,10
2020-07-28,Jamaica,JM,11,0,2948277,America,853,10
2020-07-29,Jamaica,JM,2,0,2948277,America,855,10
2020-07-30,Jamaica,JM,1,0,2948277,America,856,10
2020-07-31,Jamaica,JM,8,0,2948277,America,864,10
2020-08-01,Jamaica,JM,0,0,2948277,America,864,10
2020-08-02,Jamaica,JM,19,0,2948277,America,883,10
2020-08-03,Jamaica,JM,11,2,2948277,America,894,12
2020-08-04,Jamaica,JM,11,0,2948277,America,905,12
2020-08-05,Jamaica,JM,15,0,2948277,America,920,12
2020-08-06,Jamaica,JM,8,0,2948277,America,928,12
2020-08-07,Jamaica,JM,30,0,2948277,America,958,12
2020-08-08,Jamaica,JM,29,1,2948277,America,987,13
2020-08-09,Jamaica,JM,16,0,2948277,America,1003,13
2020-08-10,Jamaica,JM,20,1,2948277,America,1023,14
2020-08-11,Jamaica,JM,8,0,2948277,America,1031,14
2020-08-12,Jamaica,JM,16,0,2948277,America,1047,14
2020-08-13,Jamaica,JM,18,0,2948277,America,1065,14
2020-08-14,Jamaica,JM,6,0,2948277,America,1071,14
2020-08-15,Jamaica,JM,11,0,2948277,America,1082,14
2020-08-16,Jamaica,JM,0,0,2948277,America,1082,14
2020-08-17,Jamaica,JM,31,0,2948277,America,1113,14
2020-08-18,Jamaica,JM,16,0,2948277,America,1129,14
2020-08-19,Jamaica,JM,17,0,2948277,America,1146,14
2020-08-20,Jamaica,JM,46,0,2948277,America,1192,14
2020-08-21,Jamaica,JM,98,1,2948277,America,1290,15
2020-08-22,Jamaica,JM,56,1,2948277,America,1346,16
2020-08-23,Jamaica,JM,67,0,2948277,America,1413,16
2020-08-24,Jamaica,JM,116,0,2948277,America,1529,16
2020-08-25,Jamaica,JM,83,0,2948277,America,1612,16
2020-08-26,Jamaica,JM,120,3,2948277,America,1732,19
2020-08-27,Jamaica,JM,72,0,2948277,America,1804,19
2020-08-28,Jamaica,JM,66,0,2948277,America,1870,19
2020-08-29,Jamaica,JM,141,0,2948277,America,2011,19
2020-08-30,Jamaica,JM,102,1,2948277,America,2113,20
2020-08-31,Jamaica,JM,244,1,2948277,America,2357,21
2020-09-01,Jamaica,JM,0,0,2948277,America,2357,21
2020-09-02,Jamaica,JM,326,3,2948277,America,2683,24
2020-09-03,Jamaica,JM,139,3,2948277,America,2822,27
2020-09-04,Jamaica,JM,74,2,2948277,America,2896,29
2020-09-05,Jamaica,JM,68,1,2948277,America,2964,30
2020-09-06,Jamaica,JM,60,2,2948277,America,3024,32
2020-09-07,Jamaica,JM,79,1,2948277,America,3103,33
2020-09-08,Jamaica,JM,80,1,2948277,America,3183,34
2020-09-09,Jamaica,JM,140,2,2948277,America,3323,36
2020-09-10,Jamaica,JM,114,2,2948277,America,3437,38
2020-09-11,Jamaica,JM,74,2,2948277,America,3511,40
2020-09-12,Jamaica,JM,0,0,2948277,America,3511,40
2020-09-13,Jamaica,JM,112,0,2948277,America,3623,40
2020-09-14,Jamaica,JM,148,2,2948277,America,3771,42
2020-09-15,Jamaica,JM,162,2,2948277,America,3933,44
2020-09-16,Jamaica,JM,109,2,2948277,America,4042,46
2020-09-17,Jamaica,JM,109,0,2948277,America,4151,46
2020-09-18,Jamaica,JM,223,5,2948277,America,4374,51
2020-09-19,Jamaica,JM,197,4,2948277,America,4571,55
2020-09-20,Jamaica,JM,187,5,2948277,America,4758,60
2020-09-21,Jamaica,JM,230,7,2948277,America,4988,67
2020-09-22,Jamaica,JM,134,3,2948277,America,5122,70
2020-09-23,Jamaica,JM,129,5,2948277,America,5251,75
2020-09-24,Jamaica,JM,122,1,2948277,America,5373,76
2020-09-25,Jamaica,JM,192,1,2948277,America,5565,77
2020-09-26,Jamaica,JM,135,3,2948277,America,5700,80
2020-09-27,Jamaica,JM,129,8,2948277,America,5829,88
2020-09-28,Jamaica,JM,164,1,2948277,America,5993,89
2020-09-29,Jamaica,JM,150,4,2948277,America,6143,93
2020-09-30,Jamaica,JM,239,7,2948277,America,6382,100
2020-10-01,Jamaica,JM,80,7,2948277,America,6462,107
2020-10-02,Jamaica,JM,93,4,2948277,America,6555,111
2020-10-03,Jamaica,JM,136,5,2948277,America,6691,116
2020-10-04,Jamaica,JM,104,3,2948277,America,6795,119
2020-10-05,Jamaica,JM,100,1,2948277,America,6895,120
2020-10-06,Jamaica,JM,117,0,2948277,America,7012,120
2020-10-07,Jamaica,JM,97,3,2948277,America,7109,123
2020-10-08,Jamaica,JM,82,3,2948277,America,7191,126
2020-10-09,Jamaica,JM,82,2,2948277,America,7273,128
2020-10-10,Jamaica,JM,90,4,2948277,America,7363,132
2020-10-11,Jamaica,JM,196,6,2948277,America,7559,138
2020-10-12,Jamaica,JM,159,1,2948277,America,7718,139
2020-10-13,Jamaica,JM,95,7,2948277,America,7813,146
2020-10-14,Jamaica,JM,97,0,2948277,America,7910,146
2020-10-15,Jamaica,JM,79,5,2948277,America,7989,151
2020-10-16,Jamaica,JM,78,9,2948277,America,8067,160
2020-10-17,Jamaica,JM,65,2,2948277,America,8132,162
2020-10-18,Jamaica,JM,63,6,2948277,America,8195,168
2020-10-19,Jamaica,JM,79,3,2948277,America,8274,171
2020-10-20,Jamaica,JM,47,2,2948277,America,8321,173
2020-10-21,Jamaica,JM,53,1,2948277,America,8374,174
2020-10-22,Jamaica,JM,71,0,2948277,America,8445,174
2020-10-23,Jamaica,JM,155,5,2948277,America,8600,179
2020-10-24,Jamaica,JM,38,3,2948277,America,8638,182
2020-10-25,Jamaica,JM,32,4,2948277,America,8670,186
2020-10-26,Jamaica,JM,44,2,2948277,America,8714,188
2020-10-27,Jamaica,JM,35,4,2948277,America,8749,192
2020-10-28,Jamaica,JM,38,4,2948277,America,8787,196
2020-10-29,Jamaica,JM,64,2,2948277,America,8851,198
2020-10-30,Jamaica,JM,76,4,2948277,America,8927,202
2020-10-31,Jamaica,JM,78,3,2948277,America,9005,205
2020-11-01,Jamaica,JM,89,1,2948277,America,9094,206
2020-11-02,Jamaica,JM,37,3,2948277,America,9131,209
2020-11-03,Jamaica,JM,126,1,2948277,America,9257,210
2020-11-04,Jamaica,JM,39,4,2948277,America,9296,214
2020-11-05,Jamaica,JM,30,1,2948277,America,9326,215
2020-11-06,Jamaica,JM,47,2,2948277,America,9373,217
2020-11-07,Jamaica,JM,53,1,2948277,America,9426,218
2020-11-08,Jamaica,JM,46,0,2948277,America,9472,218
2020-11-09,Jamaica,JM,34,3,2948277,America,9506,221
2020-11-10,Jamaica,JM,36,0,2948277,America,9542,221
2020-11-11,Jamaica,JM,31,3,2948277,America,9573,224
2020-11-12,Jamaica,JM,8,1,2948277,America,9581,225
2020-11-13,Jamaica,JM,53,0,2948277,America,9634,225
2020-11-14,Jamaica,JM,89,2,2948277,America,9723,227
2020-11-15,Jamaica,JM,57,2,2948277,America,9780,229
2020-11-16,Jamaica,JM,104,2,2948277,America,9884,231
2020-11-17,Jamaica,JM,45,0,2948277,America,9929,231
2020-11-18,Jamaica,JM,0,0,2948277,America,9929,231
2020-11-19,Jamaica,JM,90,2,2948277,America,10019,233
2020-11-20,Jamaica,JM,69,2,2948277,America,10088,235
2020-11-21,Jamaica,JM,63,0,2948277,America,10151,235
2020-11-22,Jamaica,JM,89,2,2948277,America,10240,237
2020-11-23,Jamaica,JM,44,1,2948277,America,10284,238
2020-11-24,Jamaica,JM,59,1,2948277,America,10343,239
2020-11-25,Jamaica,JM,79,4,2948277,America,10422,243
2020-11-26,Jamaica,JM,66,4,2948277,America,10488,247
2020-11-27,Jamaica,JM,53,1,2948277,America,10541,248
2020-11-28,Jamaica,JM,59,2,2948277,America,10600,250
2020-11-29,Jamaica,JM,69,1,2948277,America,10669,251
2020-11-30,Jamaica,JM,40,5,2948277,America,10709,256
2020-12-01,Jamaica,JM,54,1,2948277,America,10763,257
2020-12-02,Jamaica,JM,47,1,2948277,America,10810,258
2020-12-03,Jamaica,JM,54,0,2948277,America,10864,258
2020-12-04,Jamaica,JM,47,1,2948277,America,10911,259
2020-12-05,Jamaica,JM,76,1,2948277,America,10987,260
2020-12-06,Jamaica,JM,76,1,2948277,America,11063,261
2020-12-07,Jamaica,JM,57,4,2948277,America,11120,265
2020-12-08,Jamaica,JM,64,0,2948277,America,11184,265
2020-12-09,Jamaica,JM,87,0,2948277,America,11271,265
2020-12-10,Jamaica,JM,98,1,2948277,America,11369,266
2020-12-11,Jamaica,JM,74,4,2948277,America,11443,270
2020-12-12,Jamaica,JM,66,0,2948277,America,11509,270
2020-12-13,Jamaica,JM,99,1,2948277,America,11608,271
2020-12-14,Jamaica,JM,102,2,2948277,America,11710,273
2020-03-03,Jordan,JO,1,0,10101697,Asia,1,0
2020-03-08,Jordan,JO,0,0,10101697,Asia,1,0
2020-03-15,Jordan,JO,0,0,10101697,Asia,1,0
2020-03-16,Jordan,JO,14,0,10101697,Asia,15,0
2020-03-17,Jordan,JO,1,0,10101697,Asia,16,0
2020-03-18,Jordan,JO,19,0,10101697,Asia,35,0
2020-03-19,Jordan,JO,17,0,10101697,Asia,52,0
2020-03-20,Jordan,JO,4,0,10101697,Asia,56,0
2020-03-21,Jordan,JO,13,0,10101697,Asia,69,0
2020-03-22,Jordan,JO,15,0,10101697,Asia,84,0
2020-03-23,Jordan,JO,15,0,10101697,Asia,99,0
2020-03-24,Jordan,JO,13,0,10101697,Asia,112,0
2020-03-25,Jordan,JO,15,0,10101697,Asia,127,0
2020-03-26,Jordan,JO,26,0,10101697,Asia,153,0
2020-03-27,Jordan,JO,19,0,10101697,Asia,172,0
2020-03-28,Jordan,JO,40,0,10101697,Asia,212,0
2020-03-29,Jordan,JO,23,1,10101697,Asia,235,1
2020-03-30,Jordan,JO,24,0,10101697,Asia,259,1
2020-03-31,Jordan,JO,9,4,10101697,Asia,268,5
2020-04-01,Jordan,JO,6,0,10101697,Asia,274,5
2020-04-02,Jordan,JO,4,0,10101697,Asia,278,5
2020-04-03,Jordan,JO,21,0,10101697,Asia,299,5
2020-04-04,Jordan,JO,0,0,10101697,Asia,299,5
2020-04-05,Jordan,JO,24,0,10101697,Asia,323,5
2020-04-06,Jordan,JO,22,0,10101697,Asia,345,5
2020-04-07,Jordan,JO,4,1,10101697,Asia,349,6
2020-04-08,Jordan,JO,0,0,10101697,Asia,349,6
2020-04-09,Jordan,JO,9,0,10101697,Asia,358,6
2020-04-10,Jordan,JO,14,1,10101697,Asia,372,7
2020-04-11,Jordan,JO,0,0,10101697,Asia,372,7
2020-04-12,Jordan,JO,9,0,10101697,Asia,381,7
2020-04-13,Jordan,JO,8,0,10101697,Asia,389,7
2020-04-14,Jordan,JO,2,0,10101697,Asia,391,7
2020-04-15,Jordan,JO,6,0,10101697,Asia,397,7
2020-04-16,Jordan,JO,4,0,10101697,Asia,401,7
2020-04-17,Jordan,JO,1,0,10101697,Asia,402,7
2020-04-18,Jordan,JO,5,0,10101697,Asia,407,7
2020-04-19,Jordan,JO,6,0,10101697,Asia,413,7
2020-04-20,Jordan,JO,4,0,10101697,Asia,417,7
2020-04-21,Jordan,JO,8,0,10101697,Asia,425,7
2020-04-22,Jordan,JO,0,0,10101697,Asia,425,7
2020-04-23,Jordan,JO,3,0,10101697,Asia,428,7
2020-04-24,Jordan,JO,9,0,10101697,Asia,437,7
2020-04-25,Jordan,JO,4,0,10101697,Asia,441,7
2020-04-26,Jordan,JO,3,0,10101697,Asia,444,7
2020-04-27,Jordan,JO,3,0,10101697,Asia,447,7
2020-04-28,Jordan,JO,2,0,10101697,Asia,449,7
2020-04-29,Jordan,JO,0,1,10101697,Asia,449,8
2020-04-30,Jordan,JO,2,0,10101697,Asia,451,8
2020-05-01,Jordan,JO,2,0,10101697,Asia,453,8
2020-05-02,Jordan,JO,6,0,10101697,Asia,459,8
2020-05-03,Jordan,JO,1,1,10101697,Asia,460,9
2020-05-04,Jordan,JO,1,0,10101697,Asia,461,9
2020-05-05,Jordan,JO,4,0,10101697,Asia,465,9
2020-05-06,Jordan,JO,6,0,10101697,Asia,471,9
2020-05-07,Jordan,JO,2,0,10101697,Asia,473,9
2020-05-08,Jordan,JO,21,0,10101697,Asia,494,9
2020-05-09,Jordan,JO,14,0,10101697,Asia,508,9
2020-05-10,Jordan,JO,14,0,10101697,Asia,522,9
2020-05-11,Jordan,JO,18,0,10101697,Asia,540,9
2020-05-12,Jordan,JO,22,0,10101697,Asia,562,9
2020-05-13,Jordan,JO,14,0,10101697,Asia,576,9
2020-05-14,Jordan,JO,6,0,10101697,Asia,582,9
2020-05-15,Jordan,JO,4,0,10101697,Asia,586,9
2020-05-16,Jordan,JO,10,0,10101697,Asia,596,9
2020-05-17,Jordan,JO,11,0,10101697,Asia,607,9
2020-05-18,Jordan,JO,6,0,10101697,Asia,613,9
2020-05-19,Jordan,JO,16,0,10101697,Asia,629,9
2020-05-20,Jordan,JO,20,0,10101697,Asia,649,9
2020-05-21,Jordan,JO,23,0,10101697,Asia,672,9
2020-05-22,Jordan,JO,12,0,10101697,Asia,684,9
2020-05-23,Jordan,JO,16,0,10101697,Asia,700,9
2020-05-24,Jordan,JO,4,0,10101697,Asia,704,9
2020-05-25,Jordan,JO,4,0,10101697,Asia,708,9
2020-05-26,Jordan,JO,3,0,10101697,Asia,711,9
2020-05-27,Jordan,JO,7,0,10101697,Asia,718,9
2020-05-28,Jordan,JO,2,0,10101697,Asia,720,9
2020-05-29,Jordan,JO,8,0,10101697,Asia,728,9
2020-05-30,Jordan,JO,2,0,10101697,Asia,730,9
2020-05-31,Jordan,JO,4,0,10101697,Asia,734,9
2020-06-01,Jordan,JO,5,0,10101697,Asia,739,9
2020-06-02,Jordan,JO,7,0,10101697,Asia,746,9
2020-06-03,Jordan,JO,9,0,10101697,Asia,755,9
2020-06-04,Jordan,JO,2,0,10101697,Asia,757,9
2020-06-05,Jordan,JO,8,0,10101697,Asia,765,9
2020-06-06,Jordan,JO,19,0,10101697,Asia,784,9
2020-06-07,Jordan,JO,11,0,10101697,Asia,795,9
2020-06-08,Jordan,JO,13,0,10101697,Asia,808,9
2020-06-09,Jordan,JO,23,0,10101697,Asia,831,9
2020-06-10,Jordan,JO,14,0,10101697,Asia,845,9
2020-06-11,Jordan,JO,18,0,10101697,Asia,863,9
2020-06-12,Jordan,JO,27,0,10101697,Asia,890,9
2020-06-13,Jordan,JO,25,0,10101697,Asia,915,9
2020-06-14,Jordan,JO,38,0,10101697,Asia,953,9
2020-06-15,Jordan,JO,8,0,10101697,Asia,961,9
2020-06-16,Jordan,JO,18,0,10101697,Asia,979,9
2020-06-17,Jordan,JO,2,0,10101697,Asia,981,9
2020-06-18,Jordan,JO,6,0,10101697,Asia,987,9
2020-06-19,Jordan,JO,14,0,10101697,Asia,1001,9
2020-06-20,Jordan,JO,7,0,10101697,Asia,1008,9
2020-06-21,Jordan,JO,7,0,10101697,Asia,1015,9
2020-06-22,Jordan,JO,18,0,10101697,Asia,1033,9
2020-06-23,Jordan,JO,9,0,10101697,Asia,1042,9
2020-06-24,Jordan,JO,5,0,10101697,Asia,1047,9
2020-06-25,Jordan,JO,24,0,10101697,Asia,1071,9
2020-06-26,Jordan,JO,15,0,10101697,Asia,1086,9
2020-06-27,Jordan,JO,18,0,10101697,Asia,1104,9
2020-06-28,Jordan,JO,7,0,10101697,Asia,1111,9
2020-06-29,Jordan,JO,10,0,10101697,Asia,1121,9
2020-06-30,Jordan,JO,7,0,10101697,Asia,1128,9
2020-07-01,Jordan,JO,4,0,10101697,Asia,1132,9
2020-07-02,Jordan,JO,1,0,10101697,Asia,1133,9
2020-07-03,Jordan,JO,3,0,10101697,Asia,1136,9
2020-07-04,Jordan,JO,11,1,10101697,Asia,1147,10
2020-07-05,Jordan,JO,3,0,10101697,Asia,1150,10
2020-07-06,Jordan,JO,14,0,10101697,Asia,1164,10
2020-07-07,Jordan,JO,3,0,10101697,Asia,1167,10
2020-07-08,Jordan,JO,2,0,10101697,Asia,1169,10
2020-07-09,Jordan,JO,0,0,10101697,Asia,1169,10
2020-07-10,Jordan,JO,0,0,10101697,Asia,1169,10
2020-07-11,Jordan,JO,4,0,10101697,Asia,1173,10
2020-07-12,Jordan,JO,3,0,10101697,Asia,1176,10
2020-07-13,Jordan,JO,3,0,10101697,Asia,1179,10
2020-07-14,Jordan,JO,4,0,10101697,Asia,1183,10
2020-07-15,Jordan,JO,15,0,10101697,Asia,1198,10
2020-07-16,Jordan,JO,3,0,10101697,Asia,1201,10
2020-07-17,Jordan,JO,5,0,10101697,Asia,1206,10
2020-07-18,Jordan,JO,3,0,10101697,Asia,1209,10
2020-07-19,Jordan,JO,5,1,10101697,Asia,1214,11
2020-07-20,Jordan,JO,4,0,10101697,Asia,1218,11
2020-07-21,Jordan,JO,5,0,10101697,Asia,1223,11
2020-07-22,Jordan,JO,-110,0,10101697,Asia,1113,11
2020-07-23,Jordan,JO,7,0,10101697,Asia,1120,11
2020-07-24,Jordan,JO,11,0,10101697,Asia,1131,11
2020-07-25,Jordan,JO,15,0,10101697,Asia,1146,11
2020-07-26,Jordan,JO,8,0,10101697,Asia,1154,11
2020-07-27,Jordan,JO,14,0,10101697,Asia,1168,11
2020-07-28,Jordan,JO,8,0,10101697,Asia,1176,11
2020-07-29,Jordan,JO,6,0,10101697,Asia,1182,11
2020-07-30,Jordan,JO,5,0,10101697,Asia,1187,11
2020-07-31,Jordan,JO,4,0,10101697,Asia,1191,11
2020-08-01,Jordan,JO,2,0,10101697,Asia,1193,11
2020-08-02,Jordan,JO,1,0,10101697,Asia,1194,11
2020-08-03,Jordan,JO,19,0,10101697,Asia,1213,11
2020-08-04,Jordan,JO,5,0,10101697,Asia,1218,11
2020-08-05,Jordan,JO,6,0,10101697,Asia,1224,11
2020-08-06,Jordan,JO,7,0,10101697,Asia,1231,11
2020-08-07,Jordan,JO,1,0,10101697,Asia,1232,11
2020-08-08,Jordan,JO,5,0,10101697,Asia,1237,11
2020-08-09,Jordan,JO,9,0,10101697,Asia,1246,11
2020-08-10,Jordan,JO,6,0,10101697,Asia,1252,11
2020-08-11,Jordan,JO,16,0,10101697,Asia,1268,11
2020-08-12,Jordan,JO,15,0,10101697,Asia,1283,11
2020-08-13,Jordan,JO,20,0,10101697,Asia,1303,11
2020-08-14,Jordan,JO,17,0,10101697,Asia,1320,11
2020-08-15,Jordan,JO,9,0,10101697,Asia,1329,11
2020-08-16,Jordan,JO,10,0,10101697,Asia,1339,11
2020-08-17,Jordan,JO,39,0,10101697,Asia,1378,11
2020-08-18,Jordan,JO,20,0,10101697,Asia,1398,11
2020-08-19,Jordan,JO,40,0,10101697,Asia,1438,11
2020-08-20,Jordan,JO,44,0,10101697,Asia,1482,11
2020-08-21,Jordan,JO,16,0,10101697,Asia,1498,11
2020-08-22,Jordan,JO,34,0,10101697,Asia,1532,11
2020-08-23,Jordan,JO,44,0,10101697,Asia,1576,11
2020-08-24,Jordan,JO,33,1,10101697,Asia,1609,12
2020-08-25,Jordan,JO,30,2,10101697,Asia,1639,14
2020-08-26,Jordan,JO,77,0,10101697,Asia,1716,14
2020-08-27,Jordan,JO,40,1,10101697,Asia,1756,15
2020-08-28,Jordan,JO,45,0,10101697,Asia,1801,15
2020-08-29,Jordan,JO,68,0,10101697,Asia,1869,15
2020-08-30,Jordan,JO,24,0,10101697,Asia,1893,15
2020-08-31,Jordan,JO,73,0,10101697,Asia,1966,15
2020-09-01,Jordan,JO,68,0,10101697,Asia,2034,15
2020-09-02,Jordan,JO,63,0,10101697,Asia,2097,15
2020-09-03,Jordan,JO,64,0,10101697,Asia,2161,15
2020-09-04,Jordan,JO,72,1,10101697,Asia,2233,16
2020-09-05,Jordan,JO,68,0,10101697,Asia,2301,16
2020-09-06,Jordan,JO,52,0,10101697,Asia,2353,16
2020-09-07,Jordan,JO,58,0,10101697,Asia,2411,16
2020-09-08,Jordan,JO,67,1,10101697,Asia,2478,17
2020-09-09,Jordan,JO,103,2,10101697,Asia,2581,19
2020-09-10,Jordan,JO,78,0,10101697,Asia,2659,19
2020-09-11,Jordan,JO,80,1,10101697,Asia,2739,20
2020-09-12,Jordan,JO,206,1,10101697,Asia,2945,21
2020-09-13,Jordan,JO,117,1,10101697,Asia,3062,22
2020-09-14,Jordan,JO,252,2,10101697,Asia,3314,24
2020-09-15,Jordan,JO,214,2,10101697,Asia,3528,26
2020-09-16,Jordan,JO,149,0,10101697,Asia,3677,26
2020-09-17,Jordan,JO,175,0,10101697,Asia,3852,26
2020-09-18,Jordan,JO,279,0,10101697,Asia,4131,26
2020-09-19,Jordan,JO,213,3,10101697,Asia,4344,29
2020-09-20,Jordan,JO,196,1,10101697,Asia,4540,30
2020-09-21,Jordan,JO,239,0,10101697,Asia,4779,30
2020-09-22,Jordan,JO,266,2,10101697,Asia,5045,32
2020-09-23,Jordan,JO,634,1,10101697,Asia,5679,33
2020-09-24,Jordan,JO,363,2,10101697,Asia,6042,35
2020-09-25,Jordan,JO,549,1,10101697,Asia,6591,36
2020-09-26,Jordan,JO,620,3,10101697,Asia,7211,39
2020-09-27,Jordan,JO,850,4,10101697,Asia,8061,43
2020-09-28,Jordan,JO,431,2,10101697,Asia,8492,45
2020-09-29,Jordan,JO,734,6,10101697,Asia,9226,51
2020-09-30,Jordan,JO,823,6,10101697,Asia,10049,57
2020-10-01,Jordan,JO,1776,4,10101697,Asia,11825,61
2020-10-02,Jordan,JO,1276,8,10101697,Asia,13101,69
2020-10-03,Jordan,JO,549,10,10101697,Asia,13650,79
2020-10-04,Jordan,JO,1099,9,10101697,Asia,14749,88
2020-10-05,Jordan,JO,891,13,10101697,Asia,15640,101
2020-10-06,Jordan,JO,1824,9,10101697,Asia,17464,110
2020-10-07,Jordan,JO,1537,12,10101697,Asia,19001,122
2020-10-08,Jordan,JO,1199,9,10101697,Asia,20200,131
2020-10-09,Jordan,JO,1317,13,10101697,Asia,21517,144
2020-10-10,Jordan,JO,1246,22,10101697,Asia,22763,166
2020-10-11,Jordan,JO,1235,15,10101697,Asia,23998,181
2020-10-12,Jordan,JO,928,10,10101697,Asia,24926,191
2020-10-13,Jordan,JO,1147,16,10101697,Asia,26073,207
2020-10-14,Jordan,JO,2054,18,10101697,Asia,28127,225
2020-10-15,Jordan,JO,2423,32,10101697,Asia,30550,257
2020-10-16,Jordan,JO,2459,25,10101697,Asia,33009,282
2020-10-17,Jordan,JO,1539,28,10101697,Asia,34548,310
2020-10-18,Jordan,JO,1505,20,10101697,Asia,36053,330
2020-10-19,Jordan,JO,1520,15,10101697,Asia,37573,345
2020-10-20,Jordan,JO,1364,35,10101697,Asia,38937,380
2020-10-21,Jordan,JO,2035,34,10101697,Asia,40972,414
2020-10-22,Jordan,JO,2648,29,10101697,Asia,43620,443
2020-10-23,Jordan,JO,2821,38,10101697,Asia,46441,481
2020-10-24,Jordan,JO,2489,27,10101697,Asia,48930,508
2020-10-25,Jordan,JO,1820,32,10101697,Asia,50750,540
2020-10-26,Jordan,JO,2337,39,10101697,Asia,53087,579
2020-10-27,Jordan,JO,1968,45,10101697,Asia,55055,624
2020-10-28,Jordan,JO,3800,44,10101697,Asia,58855,668
2020-10-29,Jordan,JO,3087,32,10101697,Asia,61942,700
2020-10-30,Jordan,JO,3443,40,10101697,Asia,65385,740
2020-10-31,Jordan,JO,3921,32,10101697,Asia,69306,772
2020-11-01,Jordan,JO,3301,57,10101697,Asia,72607,829
2020-11-02,Jordan,JO,3259,37,10101697,Asia,75866,866
2020-11-03,Jordan,JO,5877,47,10101697,Asia,81743,913
2020-11-04,Jordan,JO,4833,54,10101697,Asia,86576,967
2020-11-05,Jordan,JO,4658,62,10101697,Asia,91234,1029
2020-11-06,Jordan,JO,4630,40,10101697,Asia,95864,1069
2020-11-07,Jordan,JO,5384,67,10101697,Asia,101248,1136
2020-11-08,Jordan,JO,3554,45,10101697,Asia,104802,1181
2020-11-09,Jordan,JO,4519,52,10101697,Asia,109321,1233
2020-11-10,Jordan,JO,5665,62,10101697,Asia,114986,1295
2020-11-11,Jordan,JO,5996,91,10101697,Asia,120982,1386
2020-11-12,Jordan,JO,5419,81,10101697,Asia,126401,1467
2020-11-13,Jordan,JO,5685,80,10101697,Asia,132086,1547
2020-11-14,Jordan,JO,4469,71,10101697,Asia,136555,1618
2020-11-15,Jordan,JO,4750,86,10101697,Asia,141305,1704
2020-11-16,Jordan,JO,2373,68,10101697,Asia,143678,1772
2020-11-17,Jordan,JO,5861,71,10101697,Asia,149539,1843
2020-11-18,Jordan,JO,6454,66,10101697,Asia,155993,1909
2020-11-19,Jordan,JO,7933,60,10101697,Asia,163926,1969
2020-11-20,Jordan,JO,5469,84,10101697,Asia,169395,2053
2020-11-21,Jordan,JO,4940,63,10101697,Asia,174335,2116
2020-11-22,Jordan,JO,3826,56,10101697,Asia,178161,2172
2020-11-23,Jordan,JO,5268,64,10101697,Asia,183429,2236
2020-11-24,Jordan,JO,4981,66,10101697,Asia,188410,2302
2020-11-25,Jordan,JO,4586,78,10101697,Asia,192996,2380
2020-11-26,Jordan,JO,5025,62,10101697,Asia,198021,2442
2020-11-27,Jordan,JO,5000,67,10101697,Asia,203021,2509
2020-11-28,Jordan,JO,4580,61,10101697,Asia,207601,2570
2020-11-29,Jordan,JO,3108,56,10101697,Asia,210709,2626
2020-11-30,Jordan,JO,3598,68,10101697,Asia,214307,2694
2020-12-01,Jordan,JO,5123,57,10101697,Asia,219430,2751
2020-12-02,Jordan,JO,4187,51,10101697,Asia,223617,2802
2020-12-03,Jordan,JO,3591,52,10101697,Asia,227208,2854
2020-12-04,Jordan,JO,4029,55,10101697,Asia,231237,2909
2020-12-05,Jordan,JO,3116,51,10101697,Asia,234353,2960
2020-12-06,Jordan,JO,3160,50,10101697,Asia,237513,3010
2020-12-07,Jordan,JO,2576,46,10101697,Asia,240089,3056
2020-12-08,Jordan,JO,3980,60,10101697,Asia,244069,3116
2020-12-09,Jordan,JO,3062,46,10101697,Asia,247131,3162
2020-12-10,Jordan,JO,3088,44,10101697,Asia,250219,3206
2020-12-11,Jordan,JO,2902,44,10101697,Asia,253121,3250
2020-12-12,Jordan,JO,2338,36,10101697,Asia,255459,3286
2020-12-13,Jordan,JO,1816,49,10101697,Asia,257275,3335
2020-12-14,Jordan,JO,2339,30,10101697,Asia,259614,3365
2019-12-31,Japan,JP,0,0,126860299,Asia,0,0
2020-01-01,Japan,JP,0,0,126860299,Asia,0,0
2020-01-02,Japan,JP,0,0,126860299,Asia,0,0
2020-01-03,Japan,JP,0,0,126860299,Asia,0,0
2020-01-04,Japan,JP,0,0,126860299,Asia,0,0
2020-01-05,Japan,JP,0,0,126860299,Asia,0,0
2020-01-06,Japan,JP,0,0,126860299,Asia,0,0
2020-01-07,Japan,JP,0,0,126860299,Asia,0,0
2020-01-08,Japan,JP,0,0,126860299,Asia,0,0
2020-01-09,Japan,JP,0,0,126860299,Asia,0,0
2020-01-10,Japan,JP,0,0,126860299,Asia,0,0
2020-01-11,Japan,JP,0,0,126860299,Asia,0,0
2020-01-12,Japan,JP,0,0,126860299,Asia,0,0
2020-01-13,Japan,JP,0,0,126860299,Asia,0,0
2020-01-14,Japan,JP,0,0,126860299,Asia,0,0
2020-01-15,Japan,JP,1,0,126860299,Asia,1,0
2020-01-16,Japan,JP,0,0,126860299,Asia,1,0
2020-01-17,Japan,JP,0,0,126860299,Asia,1,0
2020-01-18,Japan,JP,0,0,126860299,Asia,1,0
2020-01-19,Japan,JP,0,0,126860299,Asia,1,0
2020-01-20,Japan,JP,0,0,126860299,Asia,1,0
2020-01-21,Japan,JP,0,0,126860299,Asia,1,0
2020-01-22,Japan,JP,0,0,126860299,Asia,1,0
2020-01-23,Japan,JP,0,0,126860299,Asia,1,0
2020-01-24,Japan,JP,1,0,126860299,Asia,2,0
2020-01-25,Japan,JP,0,0,126860299,Asia,2,0
2020-01-26,Japan,JP,1,0,126860299,Asia,3,0
2020-01-27,Japan,JP,0,0,126860299,Asia,3,0
2020-01-28,Japan,JP,1,0,126860299,Asia,4,0
2020-01-29,Japan,JP,3,0,126860299,Asia,7,0
2020-01-30,Japan,JP,4,0,126860299,Asia,11,0
2020-01-31,Japan,JP,3,0,126860299,Asia,14,0
2020-02-01,Japan,JP,1,0,126860299,Asia,15,0
2020-02-02,Japan,JP,4,0,126860299,Asia,19,0
2020-02-03,Japan,JP,1,0,126860299,Asia,20,0
2020-02-04,Japan,JP,0,0,126860299,Asia,20,0
2020-02-05,Japan,JP,5,0,126860299,Asia,25,0
2020-02-06,Japan,JP,0,0,126860299,Asia,25,0
2020-02-07,Japan,JP,0,0,126860299,Asia,25,0
2020-02-08,Japan,JP,0,0,126860299,Asia,25,0
2020-02-09,Japan,JP,0,0,126860299,Asia,25,0
2020-02-10,Japan,JP,0,0,126860299,Asia,25,0
2020-02-11,Japan,JP,0,0,126860299,Asia,25,0
2020-02-12,Japan,JP,0,0,126860299,Asia,25,0
2020-02-13,Japan,JP,4,1,126860299,Asia,29,1
2020-02-14,Japan,JP,1,0,126860299,Asia,30,1
2020-02-15,Japan,JP,8,0,126860299,Asia,38,1
2020-02-16,Japan,JP,14,0,126860299,Asia,52,1
2020-02-17,Japan,JP,7,0,126860299,Asia,59,1
2020-02-18,Japan,JP,0,0,126860299,Asia,59,1
2020-02-19,Japan,JP,7,0,126860299,Asia,66,1
2020-02-20,Japan,JP,18,0,126860299,Asia,84,1
2020-02-21,Japan,JP,9,0,126860299,Asia,93,1
2020-02-22,Japan,JP,12,0,126860299,Asia,105,1
2020-02-23,Japan,JP,27,0,126860299,Asia,132,1
2020-02-24,Japan,JP,12,0,126860299,Asia,144,1
2020-02-25,Japan,JP,0,0,126860299,Asia,144,1
2020-02-26,Japan,JP,20,0,126860299,Asia,164,1
2020-02-27,Japan,JP,22,2,126860299,Asia,186,3
2020-02-28,Japan,JP,24,0,126860299,Asia,210,3
2020-02-29,Japan,JP,20,0,126860299,Asia,230,3
2020-03-01,Japan,JP,9,2,126860299,Asia,239,5
2020-03-02,Japan,JP,15,1,126860299,Asia,254,6
2020-03-03,Japan,JP,0,0,126860299,Asia,254,6
2020-03-04,Japan,JP,14,0,126860299,Asia,268,6
2020-03-05,Japan,JP,49,0,126860299,Asia,317,6
2020-03-06,Japan,JP,32,0,126860299,Asia,349,6
2020-03-07,Japan,JP,59,0,126860299,Asia,408,6
2020-03-08,Japan,JP,47,0,126860299,Asia,455,6
2020-03-09,Japan,JP,33,1,126860299,Asia,488,7
2020-03-10,Japan,JP,26,2,126860299,Asia,514,9
2020-03-11,Japan,JP,54,3,126860299,Asia,568,12
2020-03-12,Japan,JP,51,3,126860299,Asia,619,15
2020-03-13,Japan,JP,56,4,126860299,Asia,675,19
2020-03-14,Japan,JP,62,2,126860299,Asia,737,21
2020-03-15,Japan,JP,43,1,126860299,Asia,780,22
2020-03-16,Japan,JP,34,2,126860299,Asia,814,24
2020-03-17,Japan,JP,10,4,126860299,Asia,824,28
2020-03-18,Japan,JP,5,0,126860299,Asia,829,28
2020-03-19,Japan,JP,44,1,126860299,Asia,873,29
2020-03-20,Japan,JP,77,4,126860299,Asia,950,33
2020-03-21,Japan,JP,57,2,126860299,Asia,1007,35
2020-03-22,Japan,JP,39,1,126860299,Asia,1046,36
2020-03-23,Japan,JP,43,5,126860299,Asia,1089,41
2020-03-24,Japan,JP,39,1,126860299,Asia,1128,42
2020-03-25,Japan,JP,65,1,126860299,Asia,1193,43
2020-03-26,Japan,JP,75,2,126860299,Asia,1268,45
2020-03-27,Japan,JP,96,1,126860299,Asia,1364,46
2020-03-28,Japan,JP,135,3,126860299,Asia,1499,49
2020-03-29,Japan,JP,194,3,126860299,Asia,1693,52
2020-03-30,Japan,JP,173,2,126860299,Asia,1866,54
2020-03-31,Japan,JP,87,2,126860299,Asia,1953,56
2020-04-01,Japan,JP,0,0,126860299,Asia,1953,56
2020-04-02,Japan,JP,225,1,126860299,Asia,2178,57
2020-04-03,Japan,JP,439,6,126860299,Asia,2617,63
2020-04-04,Japan,JP,318,6,126860299,Asia,2935,69
2020-04-05,Japan,JP,336,1,126860299,Asia,3271,70
2020-04-06,Japan,JP,383,3,126860299,Asia,3654,73
2020-04-07,Japan,JP,252,7,126860299,Asia,3906,80
2020-04-08,Japan,JP,351,1,126860299,Asia,4257,81
2020-04-09,Japan,JP,511,4,126860299,Asia,4768,85
2020-04-10,Japan,JP,579,3,126860299,Asia,5347,88
2020-04-11,Japan,JP,658,6,126860299,Asia,6005,94
2020-04-12,Japan,JP,743,4,126860299,Asia,6748,98
2020-04-13,Japan,JP,507,4,126860299,Asia,7255,102
2020-04-14,Japan,JP,390,7,126860299,Asia,7645,109
2020-04-15,Japan,JP,455,10,126860299,Asia,8100,119
2020-04-16,Japan,JP,482,17,126860299,Asia,8582,136
2020-04-17,Japan,JP,585,12,126860299,Asia,9167,148
2020-04-18,Japan,JP,628,6,126860299,Asia,9795,154
2020-04-19,Japan,JP,566,7,126860299,Asia,10361,161
2020-04-20,Japan,JP,390,10,126860299,Asia,10751,171
2020-04-21,Japan,JP,367,15,126860299,Asia,11118,186
2020-04-22,Japan,JP,378,0,126860299,Asia,11496,186
2020-04-23,Japan,JP,276,101,126860299,Asia,11772,287
2020-04-24,Japan,JP,468,30,126860299,Asia,12240,317
2020-04-25,Japan,JP,652,17,126860299,Asia,12892,334
2020-04-26,Japan,JP,290,14,126860299,Asia,13182,348
2020-04-27,Japan,JP,203,3,126860299,Asia,13385,351
2020-04-28,Japan,JP,191,25,126860299,Asia,13576,376
2020-04-29,Japan,JP,276,13,126860299,Asia,13852,389
2020-04-30,Japan,JP,236,26,126860299,Asia,14088,415
2020-05-01,Japan,JP,193,17,126860299,Asia,14281,432
2020-05-02,Japan,JP,263,26,126860299,Asia,14544,458
2020-05-03,Japan,JP,295,34,126860299,Asia,14839,492
2020-05-04,Japan,JP,218,18,126860299,Asia,15057,510
2020-05-05,Japan,JP,174,11,126860299,Asia,15231,521
2020-05-06,Japan,JP,123,22,126860299,Asia,15354,543
2020-05-07,Japan,JP,109,8,126860299,Asia,15463,551
2020-05-08,Japan,JP,84,6,126860299,Asia,15547,557
2020-05-09,Japan,JP,81,44,126860299,Asia,15628,601
2020-05-10,Japan,JP,119,12,126860299,Asia,15747,613
2020-05-11,Japan,JP,51,8,126860299,Asia,15798,621
2020-05-12,Japan,JP,76,22,126860299,Asia,15874,643
2020-05-13,Japan,JP,150,25,126860299,Asia,16024,668
2020-05-14,Japan,JP,55,19,126860299,Asia,16079,687
2020-05-15,Japan,JP,114,23,126860299,Asia,16193,710
2020-05-16,Japan,JP,44,15,126860299,Asia,16237,725
2020-05-17,Japan,JP,48,19,126860299,Asia,16285,744
2020-05-18,Japan,JP,20,5,126860299,Asia,16305,749
2020-05-19,Japan,JP,60,14,126860299,Asia,16365,763
2020-05-20,Japan,JP,20,8,126860299,Asia,16385,771
2020-05-21,Japan,JP,39,6,126860299,Asia,16424,777
2020-05-22,Japan,JP,89,19,126860299,Asia,16513,796
2020-05-23,Japan,JP,23,12,126860299,Asia,16536,808
2020-05-24,Japan,JP,14,12,126860299,Asia,16550,820
2020-05-25,Japan,JP,31,10,126860299,Asia,16581,830
2020-05-26,Japan,JP,42,16,126860299,Asia,16623,846
2020-05-27,Japan,JP,28,12,126860299,Asia,16651,858
2020-05-28,Japan,JP,0,0,126860299,Asia,16651,858
2020-05-29,Japan,JP,68,16,126860299,Asia,16719,874
2020-05-30,Japan,JP,85,12,126860299,Asia,16804,886
2020-05-31,Japan,JP,47,5,126860299,Asia,16851,891
2020-06-01,Japan,JP,33,1,126860299,Asia,16884,892
2020-06-02,Japan,JP,46,2,126860299,Asia,16930,894
2020-06-03,Japan,JP,56,6,126860299,Asia,16986,900
2020-06-04,Japan,JP,32,3,126860299,Asia,17018,903
2020-06-05,Japan,JP,46,4,126860299,Asia,17064,907
2020-06-06,Japan,JP,39,7,126860299,Asia,17103,914
2020-06-07,Japan,JP,38,2,126860299,Asia,17141,916
2020-06-08,Japan,JP,33,0,126860299,Asia,17174,916
2020-06-09,Japan,JP,36,0,126860299,Asia,17210,916
2020-06-10,Japan,JP,41,3,126860299,Asia,17251,919
2020-06-11,Japan,JP,41,1,126860299,Asia,17292,920
2020-06-12,Japan,JP,40,2,126860299,Asia,17332,922
2020-06-13,Japan,JP,50,2,126860299,Asia,17382,924
2020-06-14,Japan,JP,47,1,126860299,Asia,17429,925
2020-06-15,Japan,JP,73,0,126860299,Asia,17502,925
2020-06-16,Japan,JP,85,2,126860299,Asia,17587,927
2020-06-17,Japan,JP,41,4,126860299,Asia,17628,931
2020-06-18,Japan,JP,40,4,126860299,Asia,17668,935
2020-06-19,Japan,JP,72,0,126860299,Asia,17740,935
2020-06-20,Japan,JP,59,17,126860299,Asia,17799,952
2020-06-21,Japan,JP,0,0,126860299,Asia,17799,952
2020-06-22,Japan,JP,117,1,126860299,Asia,17916,953
2020-06-23,Japan,JP,52,2,126860299,Asia,17968,955
2020-06-24,Japan,JP,59,8,126860299,Asia,18027,963
2020-06-25,Japan,JP,83,5,126860299,Asia,18110,968
2020-06-26,Japan,JP,87,1,126860299,Asia,18197,969
2020-06-27,Japan,JP,100,2,126860299,Asia,18297,971
2020-06-28,Japan,JP,93,0,126860299,Asia,18390,971
2020-06-29,Japan,JP,86,1,126860299,Asia,18476,972
2020-06-30,Japan,JP,117,0,126860299,Asia,18593,972
2020-07-01,Japan,JP,130,2,126860299,Asia,18723,974
2020-07-02,Japan,JP,151,1,126860299,Asia,18874,975
2020-07-03,Japan,JP,194,1,126860299,Asia,19068,976
2020-07-04,Japan,JP,214,1,126860299,Asia,19282,977
2020-07-05,Japan,JP,240,0,126860299,Asia,19522,977
2020-07-06,Japan,JP,253,0,126860299,Asia,19775,977
2020-07-07,Japan,JP,206,1,126860299,Asia,19981,978
2020-07-08,Japan,JP,193,2,126860299,Asia,20174,980
2020-07-09,Japan,JP,197,1,126860299,Asia,20371,981
2020-07-10,Japan,JP,348,1,126860299,Asia,20719,982
2020-07-11,Japan,JP,410,0,126860299,Asia,21129,982
2020-07-12,Japan,JP,373,0,126860299,Asia,21502,982
2020-07-13,Japan,JP,366,0,126860299,Asia,21868,982
2020-07-14,Japan,JP,352,0,126860299,Asia,22220,982
2020-07-15,Japan,JP,288,2,126860299,Asia,22508,984
2020-07-16,Japan,JP,382,1,126860299,Asia,22890,985
2020-07-17,Japan,JP,583,0,126860299,Asia,23473,985
2020-07-18,Japan,JP,659,0,126860299,Asia,24132,985
2020-07-19,Japan,JP,510,0,126860299,Asia,24642,985
2020-07-20,Japan,JP,454,0,126860299,Asia,25096,985
2020-07-21,Japan,JP,640,3,126860299,Asia,25736,988
2020-07-22,Japan,JP,567,1,126860299,Asia,26303,989
2020-07-23,Japan,JP,726,1,126860299,Asia,27029,990
2020-07-24,Japan,JP,927,2,126860299,Asia,27956,992
2020-07-25,Japan,JP,830,1,126860299,Asia,28786,993
2020-07-26,Japan,JP,596,3,126860299,Asia,29382,996
2020-07-27,Japan,JP,607,0,126860299,Asia,29989,996
2020-07-28,Japan,JP,0,0,126860299,Asia,29989,996
2020-07-29,Japan,JP,1344,4,126860299,Asia,31333,1000
2020-07-30,Japan,JP,1126,3,126860299,Asia,32459,1003
2020-07-31,Japan,JP,1315,2,126860299,Asia,33774,1005
2020-08-01,Japan,JP,598,1,126860299,Asia,34372,1006
2020-08-02,Japan,JP,1709,4,126860299,Asia,36081,1010
2020-08-03,Japan,JP,1991,1,126860299,Asia,38072,1011
2020-08-04,Japan,JP,1786,5,126860299,Asia,39858,1016
2020-08-05,Japan,JP,1271,6,126860299,Asia,41129,1022
2020-08-06,Japan,JP,1134,4,126860299,Asia,42263,1026
2020-08-07,Japan,JP,1552,7,126860299,Asia,43815,1033
2020-08-08,Japan,JP,1624,6,126860299,Asia,45439,1039
2020-08-09,Japan,JP,1344,1,126860299,Asia,46783,1040
2020-08-10,Japan,JP,1207,7,126860299,Asia,47990,1047
2020-08-11,Japan,JP,248,4,126860299,Asia,48238,1051
2020-08-12,Japan,JP,1274,7,126860299,Asia,49512,1058
2020-08-13,Japan,JP,932,4,126860299,Asia,50444,1062
2020-08-14,Japan,JP,1069,10,126860299,Asia,51513,1072
2020-08-15,Japan,JP,2064,13,126860299,Asia,53577,1085
2020-08-16,Japan,JP,1137,3,126860299,Asia,54714,1088
2020-08-17,Japan,JP,238,10,126860299,Asia,54952,1098
2020-08-18,Japan,JP,1006,16,126860299,Asia,55958,1114
2020-08-19,Japan,JP,1592,14,126860299,Asia,57550,1128
2020-08-20,Japan,JP,951,16,126860299,Asia,58501,1144
2020-08-21,Japan,JP,1220,11,126860299,Asia,59721,1155
2020-08-22,Japan,JP,1012,14,126860299,Asia,60733,1169
2020-08-23,Japan,JP,1014,7,126860299,Asia,61747,1176
2020-08-24,Japan,JP,7,4,126860299,Asia,61754,1180
2020-08-25,Japan,JP,1367,16,126860299,Asia,63121,1196
2020-08-26,Japan,JP,701,13,126860299,Asia,63822,1209
2020-08-27,Japan,JP,846,17,126860299,Asia,64668,1226
2020-08-28,Japan,JP,905,12,126860299,Asia,65573,1238
2020-08-29,Japan,JP,850,17,126860299,Asia,66423,1255
2020-08-30,Japan,JP,841,9,126860299,Asia,67264,1264
2020-08-31,Japan,JP,601,15,126860299,Asia,67865,1279
2020-09-01,Japan,JP,527,17,126860299,Asia,68392,1296
2020-09-02,Japan,JP,609,11,126860299,Asia,69001,1307
2020-09-03,Japan,JP,598,12,126860299,Asia,69599,1319
2020-09-04,Japan,JP,669,11,126860299,Asia,70268,1330
2020-09-05,Japan,JP,608,19,126860299,Asia,70876,1349
2020-09-06,Japan,JP,543,8,126860299,Asia,71419,1357
2020-09-07,Japan,JP,437,6,126860299,Asia,71856,1363
2020-09-08,Japan,JP,378,14,126860299,Asia,72234,1377
2020-09-09,Japan,JP,492,16,126860299,Asia,72726,1393
2020-09-10,Japan,JP,495,13,126860299,Asia,73221,1406
2020-09-11,Japan,JP,680,6,126860299,Asia,73901,1412
2020-09-12,Japan,JP,643,11,126860299,Asia,74544,1423
2020-09-13,Japan,JP,674,16,126860299,Asia,75218,1439
2020-09-14,Japan,JP,439,3,126860299,Asia,75657,1442
2020-09-15,Japan,JP,301,9,126860299,Asia,75958,1451
2020-09-16,Japan,JP,490,10,126860299,Asia,76448,1461
2020-09-17,Japan,JP,561,12,126860299,Asia,77009,1473
2020-09-18,Japan,JP,485,9,126860299,Asia,77494,1482
2020-09-19,Japan,JP,579,13,126860299,Asia,78073,1495
2020-09-20,Japan,JP,584,5,126860299,Asia,78657,1500
2020-09-21,Japan,JP,0,0,126860299,Asia,78657,1500
2020-09-22,Japan,JP,781,8,126860299,Asia,79438,1508
2020-09-23,Japan,JP,330,4,126860299,Asia,79768,1512
2020-09-24,Japan,JP,273,8,126860299,Asia,80041,1520
2020-09-25,Japan,JP,456,12,126860299,Asia,80497,1532
2020-09-26,Japan,JP,558,8,126860299,Asia,81055,1540
2020-09-27,Japan,JP,635,5,126860299,Asia,81690,1545
2020-09-28,Japan,JP,441,3,126860299,Asia,82131,1548
2020-09-29,Japan,JP,363,9,126860299,Asia,82494,1557
2020-09-30,Japan,JP,516,7,126860299,Asia,83010,1564
2020-10-01,Japan,JP,0,0,126860299,Asia,83010,1564
2020-10-02,Japan,JP,1205,14,126860299,Asia,84215,1578
2020-10-03,Japan,JP,553,12,126860299,Asia,84768,1590
2020-10-04,Japan,JP,571,7,126860299,Asia,85339,1597
2020-10-05,Japan,JP,400,2,126860299,Asia,85739,1599
2020-10-06,Japan,JP,308,3,126860299,Asia,86047,1602
2020-10-07,Japan,JP,496,3,126860299,Asia,86543,1605
2020-10-08,Japan,JP,477,8,126860299,Asia,87020,1613
2020-10-09,Japan,JP,619,3,126860299,Asia,87639,1616
2020-10-10,Japan,JP,594,8,126860299,Asia,88233,1624
2020-10-11,Japan,JP,679,3,126860299,Asia,88912,1627
2020-10-12,Japan,JP,435,2,126860299,Asia,89347,1629
2020-10-13,Japan,JP,326,5,126860299,Asia,89673,1634
2020-10-14,Japan,JP,467,4,126860299,Asia,90140,1638
2020-10-15,Japan,JP,570,8,126860299,Asia,90710,1646
2020-10-16,Japan,JP,721,4,126860299,Asia,91431,1650
2020-10-17,Japan,JP,632,11,126860299,Asia,92063,1661
2020-10-18,Japan,JP,593,9,126860299,Asia,92656,1670
2020-10-19,Japan,JP,471,4,126860299,Asia,93127,1674
2020-10-20,Japan,JP,353,2,126860299,Asia,93480,1676
2020-10-21,Japan,JP,453,3,126860299,Asia,93933,1679
2020-10-22,Japan,JP,591,6,126860299,Asia,94524,1685
2020-10-23,Japan,JP,614,9,126860299,Asia,95138,1694
2020-10-24,Japan,JP,697,12,126860299,Asia,95835,1706
2020-10-25,Japan,JP,699,5,126860299,Asia,96534,1711
2020-10-26,Japan,JP,540,7,126860299,Asia,97074,1718
2020-10-27,Japan,JP,424,7,126860299,Asia,97498,1725
2020-10-28,Japan,JP,618,5,126860299,Asia,98116,1730
2020-10-29,Japan,JP,736,3,126860299,Asia,98852,1733
2020-10-30,Japan,JP,770,11,126860299,Asia,99622,1744
2020-10-31,Japan,JP,770,11,126860299,Asia,100392,1755
2020-11-01,Japan,JP,754,11,126860299,Asia,101146,1766
2020-11-02,Japan,JP,667,8,126860299,Asia,101813,1774
2020-11-03,Japan,JP,468,6,126860299,Asia,102281,1780
2020-11-04,Japan,JP,619,6,126860299,Asia,102900,1786
2020-11-05,Japan,JP,938,8,126860299,Asia,103838,1794
2020-11-06,Japan,JP,944,12,126860299,Asia,104782,1806
2020-11-07,Japan,JP,1132,3,126860299,Asia,105914,1809
2020-11-08,Japan,JP,1172,3,126860299,Asia,107086,1812
2020-11-09,Japan,JP,998,6,126860299,Asia,108084,1818
2020-11-10,Japan,JP,899,11,126860299,Asia,108983,1829
2020-11-11,Japan,JP,1173,12,126860299,Asia,110156,1841
2020-11-12,Japan,JP,1555,10,126860299,Asia,111711,1851
2020-11-13,Japan,JP,1587,16,126860299,Asia,113298,1867
2020-11-14,Japan,JP,1685,13,126860299,Asia,114983,1880
2020-11-15,Japan,JP,1694,3,126860299,Asia,116677,1883
2020-11-16,Japan,JP,0,0,126860299,Asia,116677,1883
2020-11-17,Japan,JP,2649,20,126860299,Asia,119326,1903
2020-11-18,Japan,JP,1489,10,126860299,Asia,120815,1913
2020-11-19,Japan,JP,2151,9,126860299,Asia,122966,1922
2020-11-20,Japan,JP,2301,21,126860299,Asia,125267,1943
2020-11-21,Japan,JP,2398,20,126860299,Asia,127665,1963
2020-11-22,Japan,JP,2514,11,126860299,Asia,130179,1974
2020-11-23,Japan,JP,738,6,126860299,Asia,130917,1980
2020-11-24,Japan,JP,3012,9,126860299,Asia,133929,1989
2020-11-25,Japan,JP,1471,12,126860299,Asia,135400,2001
2020-11-26,Japan,JP,1861,21,126860299,Asia,137261,2022
2020-11-27,Japan,JP,2230,29,126860299,Asia,139491,2051
2020-11-28,Japan,JP,2577,23,126860299,Asia,142068,2074
2020-11-29,Japan,JP,2585,32,126860299,Asia,144653,2106
2020-11-30,Japan,JP,2107,13,126860299,Asia,146760,2119
2020-12-01,Japan,JP,1934,20,126860299,Asia,148694,2139
2020-12-02,Japan,JP,1692,33,126860299,Asia,150386,2172
2020-12-03,Japan,JP,2441,41,126860299,Asia,152827,2213
2020-12-04,Japan,JP,2405,27,126860299,Asia,155232,2240
2020-12-05,Japan,JP,2442,43,126860299,Asia,157674,2283
2020-12-06,Japan,JP,2424,32,126860299,Asia,160098,2315
2020-12-07,Japan,JP,1969,20,126860299,Asia,162067,2335
2020-12-08,Japan,JP,1862,47,126860299,Asia,163929,2382
2020-12-09,Japan,JP,1911,38,126860299,Asia,165840,2420
2020-12-10,Japan,JP,2733,45,126860299,Asia,168573,2465
2020-12-11,Japan,JP,2969,37,126860299,Asia,171542,2502
2020-12-12,Japan,JP,2757,32,126860299,Asia,174299,2534
2020-12-13,Japan,JP,2988,28,126860299,Asia,177287,2562
2020-12-14,Japan,JP,2366,23,126860299,Asia,179653,2585
2019-12-31,Cases_on_an_international_conveyance_Japan,JPG11668,0,0,0,Other,0,0
2020-01-01,Cases_on_an_international_conveyance_Japan,JPG11668,0,0,0,Other,0,0
2020-01-02,Cases_on_an_international_conveyance_Japan,JPG11668,0,0,0,Other,0,0
2020-01-03,Cases_on_an_international_conveyance_Japan,JPG11668,0,0,0,Other,0,0
2020-01-04,Cases_on_an_international_conveyance_Japan,JPG11668,0,0,0,Other,0,0
2020-01-05,Cases_on_an_international_conveyance_Japan,JPG11668,0,0,0,Other,0,0
2020-01-06,Cases_on_an_international_conveyance_Japan,JPG11668,0,0,0,Other,0,0
2020-01-07,Cases_on_an_international_conveyance_Japan,JPG11668,0,0,0,Other,0,0
2020-01-08,Cases_on_an_international_conveyance_Japan,JPG11668,0,0,0,Other,0,0
2020-01-09,Cases_on_an_international_conveyance_Japan,JPG11668,0,0,0,Other,0,0
2020-01-10,Cases_on_an_international_conveyance_Japan,JPG11668,0,0,0,Other,0,0
2020-01-11,Cases_on_an_international_conveyance_Japan,JPG11668,0,0,0,Other,0,0
2020-01-12,Cases_on_an_international_conveyance_Japan,JPG11668,0,0,0,Other,0,0
2020-01-13,Cases_on_an_international_conveyance_Japan,JPG11668,0,0,0,Other,0,0
2020-01-14,Cases_on_an_international_conveyance_Japan,JPG11668,0,0,0,Other,0,0
2020-01-15,Cases_on_an_international_conveyance_Japan,JPG11668,0,0,0,Other,0,0
2020-01-16,Cases_on_an_international_conveyance_Japan,JPG11668,0,0,0,Other,0,0
2020-01-17,Cases_on_an_international_conveyance_Japan,JPG11668,0,0,0,Other,0,0
2020-01-18,Cases_on_an_international_conveyance_Japan,JPG11668,0,0,0,Other,0,0
2020-01-19,Cases_on_an_international_conveyance_Japan,JPG11668,0,0,0,Other,0,0
2020-01-20,Cases_on_an_international_conveyance_Japan,JPG11668,0,0,0,Other,0,0
2020-01-21,Cases_on_an_international_conveyance_Japan,JPG11668,0,0,0,Other,0,0
2020-01-22,Cases_on_an_international_conveyance_Japan,JPG11668,0,0,0,Other,0,0
2020-01-23,Cases_on_an_international_conveyance_Japan,JPG11668,0,0,0,Other,0,0
2020-01-24,Cases_on_an_international_conveyance_Japan,JPG11668,0,0,0,Other,0,0
2020-01-25,Cases_on_an_international_conveyance_Japan,JPG11668,0,0,0,Other,0,0
2020-01-26,Cases_on_an_international_conveyance_Japan,JPG11668,0,0,0,Other,0,0
2020-01-27,Cases_on_an_international_conveyance_Japan,JPG11668,0,0,0,Other,0,0
2020-01-28,Cases_on_an_international_conveyance_Japan,JPG11668,0,0,0,Other,0,0
2020-01-29,Cases_on_an_international_conveyance_Japan,JPG11668,0,0,0,Other,0,0
2020-01-30,Cases_on_an_international_conveyance_Japan,JPG11668,0,0,0,Other,0,0
2020-01-31,Cases_on_an_international_conveyance_Japan,JPG11668,0,0,0,Other,0,0
2020-02-01,Cases_on_an_international_conveyance_Japan,JPG11668,0,0,0,Other,0,0
2020-02-02,Cases_on_an_international_conveyance_Japan,JPG11668,0,0,0,Other,0,0
2020-02-03,Cases_on_an_international_conveyance_Japan,JPG11668,0,0,0,Other,0,0
2020-02-04,Cases_on_an_international_conveyance_Japan,JPG11668,0,0,0,Other,0,0
2020-02-05,Cases_on_an_international_conveyance_Japan,JPG11668,10,0,0,Other,10,0
2020-02-06,Cases_on_an_international_conveyance_Japan,JPG11668,10,0,0,Other,20,0
2020-02-07,Cases_on_an_international_conveyance_Japan,JPG11668,41,0,0,Other,61,0
2020-02-08,Cases_on_an_international_conveyance_Japan,JPG11668,3,0,0,Other,64,0
2020-02-09,Cases_on_an_international_conveyance_Japan,JPG11668,0,0,0,Other,64,0
2020-02-10,Cases_on_an_international_conveyance_Japan,JPG11668,6,0,0,Other,70,0
2020-02-11,Cases_on_an_international_conveyance_Japan,JPG11668,65,0,0,Other,135,0
2020-02-12,Cases_on_an_international_conveyance_Japan,JPG11668,39,0,0,Other,174,0
2020-02-13,Cases_on_an_international_conveyance_Japan,JPG11668,0,0,0,Other,174,0
2020-02-14,Cases_on_an_international_conveyance_Japan,JPG11668,47,0,0,Other,221,0
2020-02-15,Cases_on_an_international_conveyance_Japan,JPG11668,0,0,0,Other,221,0
2020-02-16,Cases_on_an_international_conveyance_Japan,JPG11668,134,0,0,Other,355,0
2020-02-17,Cases_on_an_international_conveyance_Japan,JPG11668,0,0,0,Other,355,0
2020-02-18,Cases_on_an_international_conveyance_Japan,JPG11668,99,0,0,Other,454,0
2020-02-19,Cases_on_an_international_conveyance_Japan,JPG11668,88,0,0,Other,542,0
2020-02-20,Cases_on_an_international_conveyance_Japan,JPG11668,79,2,0,Other,621,2
2020-02-21,Cases_on_an_international_conveyance_Japan,JPG11668,13,0,0,Other,634,2
2020-02-22,Cases_on_an_international_conveyance_Japan,JPG11668,0,0,0,Other,634,2
2020-02-23,Cases_on_an_international_conveyance_Japan,JPG11668,0,0,0,Other,634,2
2020-02-24,Cases_on_an_international_conveyance_Japan,JPG11668,57,1,0,Other,691,3
2020-02-25,Cases_on_an_international_conveyance_Japan,JPG11668,0,0,0,Other,691,3
2020-02-26,Cases_on_an_international_conveyance_Japan,JPG11668,0,1,0,Other,691,4
2020-02-27,Cases_on_an_international_conveyance_Japan,JPG11668,14,0,0,Other,705,4
2020-02-28,Cases_on_an_international_conveyance_Japan,JPG11668,0,0,0,Other,705,4
2020-02-29,Cases_on_an_international_conveyance_Japan,JPG11668,0,2,0,Other,705,6
2020-03-01,Cases_on_an_international_conveyance_Japan,JPG11668,0,0,0,Other,705,6
2020-03-02,Cases_on_an_international_conveyance_Japan,JPG11668,0,0,0,Other,705,6
2020-03-10,Cases_on_an_international_conveyance_Japan,JPG11668,-9,1,0,Other,696,7
2020-03-14,Kenya,KE,1,0,52573967,Africa,1,0
2020-03-15,Kenya,KE,0,0,52573967,Africa,1,0
2020-03-16,Kenya,KE,2,0,52573967,Africa,3,0
2020-03-17,Kenya,KE,0,0,52573967,Africa,3,0
2020-03-18,Kenya,KE,1,0,52573967,Africa,4,0
2020-03-19,Kenya,KE,3,0,52573967,Africa,7,0
2020-03-20,Kenya,KE,0,0,52573967,Africa,7,0
2020-03-21,Kenya,KE,0,0,52573967,Africa,7,0
2020-03-22,Kenya,KE,0,0,52573967,Africa,7,0
2020-03-23,Kenya,KE,8,0,52573967,Africa,15,0
2020-03-24,Kenya,KE,1,0,52573967,Africa,16,0
2020-03-25,Kenya,KE,9,0,52573967,Africa,25,0
2020-03-26,Kenya,KE,0,0,52573967,Africa,25,0
2020-03-27,Kenya,KE,6,1,52573967,Africa,31,1
2020-03-28,Kenya,KE,0,0,52573967,Africa,31,1
2020-03-29,Kenya,KE,7,0,52573967,Africa,38,1
2020-03-30,Kenya,KE,4,0,52573967,Africa,42,1
2020-03-31,Kenya,KE,8,0,52573967,Africa,50,1
2020-04-01,Kenya,KE,9,0,52573967,Africa,59,1
2020-04-02,Kenya,KE,22,0,52573967,Africa,81,1
2020-04-03,Kenya,KE,29,2,52573967,Africa,110,3
2020-04-04,Kenya,KE,12,1,52573967,Africa,122,4
2020-04-05,Kenya,KE,4,0,52573967,Africa,126,4
2020-04-06,Kenya,KE,16,0,52573967,Africa,142,4
2020-04-07,Kenya,KE,16,0,52573967,Africa,158,4
2020-04-08,Kenya,KE,14,2,52573967,Africa,172,6
2020-04-09,Kenya,KE,7,0,52573967,Africa,179,6
2020-04-10,Kenya,KE,5,1,52573967,Africa,184,7
2020-04-11,Kenya,KE,5,0,52573967,Africa,189,7
2020-04-12,Kenya,KE,2,0,52573967,Africa,191,7
2020-04-13,Kenya,KE,6,1,52573967,Africa,197,8
2020-04-14,Kenya,KE,11,1,52573967,Africa,208,9
2020-04-15,Kenya,KE,8,0,52573967,Africa,216,9
2020-04-16,Kenya,KE,9,1,52573967,Africa,225,10
2020-04-17,Kenya,KE,9,1,52573967,Africa,234,11
2020-04-18,Kenya,KE,12,0,52573967,Africa,246,11
2020-04-19,Kenya,KE,16,1,52573967,Africa,262,12
2020-04-20,Kenya,KE,8,2,52573967,Africa,270,14
2020-04-21,Kenya,KE,11,0,52573967,Africa,281,14
2020-04-22,Kenya,KE,0,0,52573967,Africa,281,14
2020-04-23,Kenya,KE,22,0,52573967,Africa,303,14
2020-04-24,Kenya,KE,17,0,52573967,Africa,320,14
2020-04-25,Kenya,KE,16,0,52573967,Africa,336,14
2020-04-26,Kenya,KE,7,0,52573967,Africa,343,14
2020-04-27,Kenya,KE,12,0,52573967,Africa,355,14
2020-04-28,Kenya,KE,8,0,52573967,Africa,363,14
2020-04-29,Kenya,KE,11,0,52573967,Africa,374,14
2020-04-30,Kenya,KE,10,1,52573967,Africa,384,15
2020-05-01,Kenya,KE,12,2,52573967,Africa,396,17
2020-05-02,Kenya,KE,15,4,52573967,Africa,411,21
2020-05-03,Kenya,KE,24,1,52573967,Africa,435,22
2020-05-04,Kenya,KE,30,2,52573967,Africa,465,24
2020-05-05,Kenya,KE,25,0,52573967,Africa,490,24
2020-05-06,Kenya,KE,45,0,52573967,Africa,535,24
2020-05-07,Kenya,KE,47,2,52573967,Africa,582,26
2020-05-08,Kenya,KE,25,3,52573967,Africa,607,29
2020-05-09,Kenya,KE,14,0,52573967,Africa,621,29
2020-05-10,Kenya,KE,28,1,52573967,Africa,649,30
2020-05-11,Kenya,KE,23,2,52573967,Africa,672,32
2020-05-12,Kenya,KE,28,1,52573967,Africa,700,33
2020-05-13,Kenya,KE,15,3,52573967,Africa,715,36
2020-05-14,Kenya,KE,22,4,52573967,Africa,737,40
2020-05-15,Kenya,KE,21,2,52573967,Africa,758,42
2020-05-16,Kenya,KE,23,3,52573967,Africa,781,45
2020-05-17,Kenya,KE,49,5,52573967,Africa,830,50
2020-05-18,Kenya,KE,57,0,52573967,Africa,887,50
2020-05-19,Kenya,KE,25,0,52573967,Africa,912,50
2020-05-20,Kenya,KE,51,0,52573967,Africa,963,50
2020-05-21,Kenya,KE,66,0,52573967,Africa,1029,50
2020-05-22,Kenya,KE,80,0,52573967,Africa,1109,50
2020-05-23,Kenya,KE,52,0,52573967,Africa,1161,50
2020-05-24,Kenya,KE,31,0,52573967,Africa,1192,50
2020-05-25,Kenya,KE,22,1,52573967,Africa,1214,51
2020-05-26,Kenya,KE,72,1,52573967,Africa,1286,52
2020-05-27,Kenya,KE,62,0,52573967,Africa,1348,52
2020-05-28,Kenya,KE,123,3,52573967,Africa,1471,55
2020-05-29,Kenya,KE,147,3,52573967,Africa,1618,58
2020-05-30,Kenya,KE,127,4,52573967,Africa,1745,62
2020-05-31,Kenya,KE,143,1,52573967,Africa,1888,63
2020-06-01,Kenya,KE,74,1,52573967,Africa,1962,64
2020-06-02,Kenya,KE,59,5,52573967,Africa,2021,69
2020-06-03,Kenya,KE,72,2,52573967,Africa,2093,71
2020-06-04,Kenya,KE,123,3,52573967,Africa,2216,74
2020-06-05,Kenya,KE,124,4,52573967,Africa,2340,78
2020-06-06,Kenya,KE,134,1,52573967,Africa,2474,79
2020-06-07,Kenya,KE,126,4,52573967,Africa,2600,83
2020-06-08,Kenya,KE,167,1,52573967,Africa,2767,84
2020-06-09,Kenya,KE,95,1,52573967,Africa,2862,85
2020-06-10,Kenya,KE,127,3,52573967,Africa,2989,88
2020-06-11,Kenya,KE,105,1,52573967,Africa,3094,89
2020-06-12,Kenya,KE,121,3,52573967,Africa,3215,92
2020-06-13,Kenya,KE,90,4,52573967,Africa,3305,96
2020-06-14,Kenya,KE,152,4,52573967,Africa,3457,100
2020-06-15,Kenya,KE,137,3,52573967,Africa,3594,103
2020-06-16,Kenya,KE,133,1,52573967,Africa,3727,104
2020-06-17,Kenya,KE,133,1,52573967,Africa,3860,105
2020-06-18,Kenya,KE,184,2,52573967,Africa,4044,107
2020-06-19,Kenya,KE,213,10,52573967,Africa,4257,117
2020-06-20,Kenya,KE,117,2,52573967,Africa,4374,119
2020-06-21,Kenya,KE,104,2,52573967,Africa,4478,121
2020-06-22,Kenya,KE,260,2,52573967,Africa,4738,123
2020-06-23,Kenya,KE,59,2,52573967,Africa,4797,125
2020-06-24,Kenya,KE,155,3,52573967,Africa,4952,128
2020-06-25,Kenya,KE,254,2,52573967,Africa,5206,130
2020-06-26,Kenya,KE,178,2,52573967,Africa,5384,132
2020-06-27,Kenya,KE,149,5,52573967,Africa,5533,137
2020-06-28,Kenya,KE,278,4,52573967,Africa,5811,141
2020-06-29,Kenya,KE,259,2,52573967,Africa,6070,143
2020-06-30,Kenya,KE,120,1,52573967,Africa,6190,144
2020-07-01,Kenya,KE,176,4,52573967,Africa,6366,148
2020-07-02,Kenya,KE,307,1,52573967,Africa,6673,149
2020-07-03,Kenya,KE,268,3,52573967,Africa,6941,152
2020-07-04,Kenya,KE,247,2,52573967,Africa,7188,154
2020-07-05,Kenya,KE,389,5,52573967,Africa,7577,159
2020-07-06,Kenya,KE,309,1,52573967,Africa,7886,160
2020-07-07,Kenya,KE,181,4,52573967,Africa,8067,164
2020-07-08,Kenya,KE,183,3,52573967,Africa,8250,167
2020-07-09,Kenya,KE,278,2,52573967,Africa,8528,169
2020-07-10,Kenya,KE,447,4,52573967,Africa,8975,173
2020-07-11,Kenya,KE,473,8,52573967,Africa,9448,181
2020-07-12,Kenya,KE,278,3,52573967,Africa,9726,184
2020-07-13,Kenya,KE,379,1,52573967,Africa,10105,185
2020-07-14,Kenya,KE,189,12,52573967,Africa,10294,197
2020-07-15,Kenya,KE,497,5,52573967,Africa,10791,202
2020-07-16,Kenya,KE,461,7,52573967,Africa,11252,209
2020-07-17,Kenya,KE,421,4,52573967,Africa,11673,213
2020-07-18,Kenya,KE,389,9,52573967,Africa,12062,222
2020-07-19,Kenya,KE,688,3,52573967,Africa,12750,225
2020-07-20,Kenya,KE,603,9,52573967,Africa,13353,234
2020-07-21,Kenya,KE,418,4,52573967,Africa,13771,238
2020-07-22,Kenya,KE,397,12,52573967,Africa,14168,250
2020-07-23,Kenya,KE,637,10,52573967,Africa,14805,260
2020-07-24,Kenya,KE,796,3,52573967,Africa,15601,263
2020-07-25,Kenya,KE,667,11,52573967,Africa,16268,274
2020-07-26,Kenya,KE,375,4,52573967,Africa,16643,278
2020-07-27,Kenya,KE,960,2,52573967,Africa,17603,280
2020-07-28,Kenya,KE,372,5,52573967,Africa,17975,285
2020-07-29,Kenya,KE,606,14,52573967,Africa,18581,299
2020-07-30,Kenya,KE,544,12,52573967,Africa,19125,311
2020-07-31,Kenya,KE,788,14,52573967,Africa,19913,325
2020-08-01,Kenya,KE,723,16,52573967,Africa,20636,341
2020-08-02,Kenya,KE,727,23,52573967,Africa,21363,364
2020-08-03,Kenya,KE,690,5,52573967,Africa,22053,369
2020-08-04,Kenya,KE,544,13,52573967,Africa,22597,382
2020-08-05,Kenya,KE,605,6,52573967,Africa,23202,388
2020-08-06,Kenya,KE,671,3,52573967,Africa,23873,391
2020-08-07,Kenya,KE,538,8,52573967,Africa,24411,399
2020-08-08,Kenya,KE,727,14,52573967,Africa,25138,413
2020-08-09,Kenya,KE,699,5,52573967,Africa,25837,418
2020-08-10,Kenya,KE,599,2,52573967,Africa,26436,420
2020-08-11,Kenya,KE,492,3,52573967,Africa,26928,423
2020-08-12,Kenya,KE,497,15,52573967,Africa,27425,438
2020-08-13,Kenya,KE,679,18,52573967,Africa,28104,456
2020-08-14,Kenya,KE,650,4,52573967,Africa,28754,460
2020-08-15,Kenya,KE,580,5,52573967,Africa,29334,465
2020-08-16,Kenya,KE,515,7,52573967,Africa,29849,472
2020-08-17,Kenya,KE,271,2,52573967,Africa,30120,474
2020-08-18,Kenya,KE,245,8,52573967,Africa,30365,482
2020-08-19,Kenya,KE,271,5,52573967,Africa,30636,487
2020-08-20,Kenya,KE,379,19,52573967,Africa,31015,506
2020-08-21,Kenya,KE,426,10,52573967,Africa,31441,516
2020-08-22,Kenya,KE,322,16,52573967,Africa,31763,532
2020-08-23,Kenya,KE,355,10,52573967,Africa,32118,542
2020-08-24,Kenya,KE,246,6,52573967,Africa,32364,548
2020-08-25,Kenya,KE,193,6,52573967,Africa,32557,554
2020-08-26,Kenya,KE,246,5,52573967,Africa,32803,559
2020-08-27,Kenya,KE,213,5,52573967,Africa,33016,564
2020-08-28,Kenya,KE,373,3,52573967,Africa,33389,567
2020-08-29,Kenya,KE,241,0,52573967,Africa,33630,567
2020-08-30,Kenya,KE,164,5,52573967,Africa,33794,572
2020-08-31,Kenya,KE,263,2,52573967,Africa,34057,574
2020-09-01,Kenya,KE,144,3,52573967,Africa,34201,577
2020-09-02,Kenya,KE,114,0,52573967,Africa,34315,577
2020-09-03,Kenya,KE,178,0,52573967,Africa,34493,577
2020-09-04,Kenya,KE,212,8,52573967,Africa,34705,585
2020-09-05,Kenya,KE,179,4,52573967,Africa,34884,589
2020-09-06,Kenya,KE,136,5,52573967,Africa,35020,594
2020-09-07,Kenya,KE,83,3,52573967,Africa,35103,597
2020-09-08,Kenya,KE,102,2,52573967,Africa,35205,599
2020-09-09,Kenya,KE,151,0,52573967,Africa,35356,599
2020-09-10,Kenya,KE,104,8,52573967,Africa,35460,607
2020-09-11,Kenya,KE,143,5,52573967,Africa,35603,612
2020-09-12,Kenya,KE,190,4,52573967,Africa,35793,616
2020-09-13,Kenya,KE,176,3,52573967,Africa,35969,619
2020-09-14,Kenya,KE,188,3,52573967,Africa,36157,622
2020-09-15,Kenya,KE,0,0,52573967,Africa,36157,622
2020-09-16,Kenya,KE,48,2,52573967,Africa,36205,624
2020-09-17,Kenya,KE,96,10,52573967,Africa,36301,634
2020-09-18,Kenya,KE,275,8,52573967,Africa,36576,642
2020-09-19,Kenya,KE,148,4,52573967,Africa,36724,646
2020-09-20,Kenya,KE,105,0,52573967,Africa,36829,646
2020-09-21,Kenya,KE,152,2,52573967,Africa,36981,648
2020-09-22,Kenya,KE,98,2,52573967,Africa,37079,650
2020-09-23,Kenya,KE,139,9,52573967,Africa,37218,659
2020-09-24,Kenya,KE,130,5,52573967,Africa,37348,664
2020-09-25,Kenya,KE,141,5,52573967,Africa,37489,669
2020-09-26,Kenya,KE,218,13,52573967,Africa,37707,682
2020-09-27,Kenya,KE,164,7,52573967,Africa,37871,689
2020-09-28,Kenya,KE,244,2,52573967,Africa,38115,691
2020-09-29,Kenya,KE,53,9,52573967,Africa,38168,700
2020-09-30,Kenya,KE,210,7,52573967,Africa,38378,707
2020-10-01,Kenya,KE,151,4,52573967,Africa,38529,711
2020-10-02,Kenya,KE,184,7,52573967,Africa,38713,718
2020-10-03,Kenya,KE,210,7,52573967,Africa,38923,725
2020-10-04,Kenya,KE,261,3,52573967,Africa,39184,728
2020-10-05,Kenya,KE,243,3,52573967,Africa,39427,731
2020-10-06,Kenya,KE,22,4,52573967,Africa,39449,735
2020-10-07,Kenya,KE,137,8,52573967,Africa,39586,743
2020-10-08,Kenya,KE,321,5,52573967,Africa,39907,748
2020-10-09,Kenya,KE,271,3,52573967,Africa,40178,751
2020-10-10,Kenya,KE,442,4,52573967,Africa,40620,755
2020-10-11,Kenya,KE,538,5,52573967,Africa,41158,760
2020-10-12,Kenya,KE,388,6,52573967,Africa,41546,766
2020-10-13,Kenya,KE,73,11,52573967,Africa,41619,777
2020-10-14,Kenya,KE,318,10,52573967,Africa,41937,787
2020-10-15,Kenya,KE,604,10,52573967,Africa,42541,797
2020-10-16,Kenya,KE,602,8,52573967,Africa,43143,805
2020-10-17,Kenya,KE,437,8,52573967,Africa,43580,813
2020-10-18,Kenya,KE,616,12,52573967,Africa,44196,825
2020-10-19,Kenya,KE,685,7,52573967,Africa,44881,832
2020-10-20,Kenya,KE,195,7,52573967,Africa,45076,839
2020-10-21,Kenya,KE,571,3,52573967,Africa,45647,842
2020-10-22,Kenya,KE,497,16,52573967,Africa,46144,858
2020-10-23,Kenya,KE,1068,12,52573967,Africa,47212,870
2020-10-24,Kenya,KE,631,14,52573967,Africa,47843,884
2020-10-25,Kenya,KE,947,12,52573967,Africa,48790,896
2020-10-26,Kenya,KE,931,6,52573967,Africa,49721,902
2020-10-27,Kenya,KE,276,18,52573967,Africa,49997,920
2020-10-28,Kenya,KE,836,14,52573967,Africa,50833,934
2020-10-29,Kenya,KE,1018,0,52573967,Africa,51851,934
2020-10-30,Kenya,KE,761,30,52573967,Africa,52612,964
2020-10-31,Kenya,KE,1185,17,52573967,Africa,53797,981
2020-11-01,Kenya,KE,1395,15,52573967,Africa,55192,996
2020-11-02,Kenya,KE,685,17,52573967,Africa,55877,1013
2020-11-03,Kenya,KE,724,14,52573967,Africa,56601,1027
2020-11-04,Kenya,KE,492,12,52573967,Africa,57093,1039
2020-11-05,Kenya,KE,1494,12,52573967,Africa,58587,1051
2020-11-06,Kenya,KE,1008,21,52573967,Africa,59595,1072
2020-11-07,Kenya,KE,1109,21,52573967,Africa,60704,1093
2020-11-08,Kenya,KE,1065,10,52573967,Africa,61769,1103
2020-11-09,Kenya,KE,719,8,52573967,Africa,62488,1111
2020-11-10,Kenya,KE,756,19,52573967,Africa,63244,1130
2020-11-11,Kenya,KE,1344,24,52573967,Africa,64588,1154
2020-11-12,Kenya,KE,0,0,52573967,Africa,64588,1154
2020-11-13,Kenya,KE,2135,49,52573967,Africa,66723,1203
2020-11-14,Kenya,KE,1470,25,52573967,Africa,68193,1228
2020-11-15,Kenya,KE,1080,21,52573967,Africa,69273,1249
2020-11-16,Kenya,KE,972,20,52573967,Africa,70245,1269
2020-11-17,Kenya,KE,559,18,52573967,Africa,70804,1287
2020-11-18,Kenya,KE,925,15,52573967,Africa,71729,1302
2020-11-19,Kenya,KE,957,11,52573967,Africa,72686,1313
2020-11-20,Kenya,KE,1459,17,52573967,Africa,74145,1330
2020-11-21,Kenya,KE,1048,19,52573967,Africa,75193,1349
2020-11-22,Kenya,KE,1211,17,52573967,Africa,76404,1366
2020-11-23,Kenya,KE,968,14,52573967,Africa,77372,1380
2020-11-24,Kenya,KE,413,12,52573967,Africa,77785,1392
2020-11-25,Kenya,KE,727,17,52573967,Africa,78512,1409
2020-11-26,Kenya,KE,810,8,52573967,Africa,79322,1417
2020-11-27,Kenya,KE,780,10,52573967,Africa,80102,1427
2020-11-28,Kenya,KE,1554,14,52573967,Africa,81656,1441
2020-11-29,Kenya,KE,949,4,52573967,Africa,82605,1445
2020-11-30,Kenya,KE,711,7,52573967,Africa,83316,1452
2020-12-01,Kenya,KE,302,17,52573967,Africa,83618,1469
2020-12-02,Kenya,KE,551,5,52573967,Africa,84169,1474
2020-12-03,Kenya,KE,961,10,52573967,Africa,85130,1484
2020-12-04,Kenya,KE,1253,16,52573967,Africa,86383,1500
2020-12-05,Kenya,KE,866,6,52573967,Africa,87249,1506
2020-12-06,Kenya,KE,735,12,52573967,Africa,87984,1518
2020-12-07,Kenya,KE,396,8,52573967,Africa,88380,1526
2020-12-08,Kenya,KE,199,5,52573967,Africa,88579,1531
2020-12-09,Kenya,KE,521,14,52573967,Africa,89100,1545
2020-12-10,Kenya,KE,561,7,52573967,Africa,89661,1552
2020-12-11,Kenya,KE,644,16,52573967,Africa,90305,1568
2020-12-12,Kenya,KE,673,14,52573967,Africa,90978,1582
2020-12-13,Kenya,KE,548,4,52573967,Africa,91526,1586
2020-12-14,Kenya,KE,366,1,52573967,Africa,91892,1587
2020-03-19,Kyrgyzstan,KG,3,0,6415851,Asia,3,0
2020-03-20,Kyrgyzstan,KG,3,0,6415851,Asia,6,0
2020-03-21,Kyrgyzstan,KG,0,0,6415851,Asia,6,0
2020-03-22,Kyrgyzstan,KG,8,0,6415851,Asia,14,0
2020-03-23,Kyrgyzstan,KG,0,0,6415851,Asia,14,0
2020-03-24,Kyrgyzstan,KG,2,0,6415851,Asia,16,0
2020-03-25,Kyrgyzstan,KG,26,0,6415851,Asia,42,0
2020-03-26,Kyrgyzstan,KG,2,0,6415851,Asia,44,0
2020-03-27,Kyrgyzstan,KG,0,0,6415851,Asia,44,0
2020-03-28,Kyrgyzstan,KG,14,0,6415851,Asia,58,0
2020-03-29,Kyrgyzstan,KG,26,0,6415851,Asia,84,0
2020-03-30,Kyrgyzstan,KG,0,0,6415851,Asia,84,0
2020-03-31,Kyrgyzstan,KG,0,0,6415851,Asia,84,0
2020-04-01,Kyrgyzstan,KG,23,0,6415851,Asia,107,0
2020-04-02,Kyrgyzstan,KG,5,1,6415851,Asia,112,1
2020-04-03,Kyrgyzstan,KG,13,0,6415851,Asia,125,1
2020-04-04,Kyrgyzstan,KG,19,0,6415851,Asia,144,1
2020-04-05,Kyrgyzstan,KG,0,0,6415851,Asia,144,1
2020-04-06,Kyrgyzstan,KG,72,3,6415851,Asia,216,4
2020-04-07,Kyrgyzstan,KG,12,0,6415851,Asia,228,4
2020-04-08,Kyrgyzstan,KG,42,0,6415851,Asia,270,4
2020-04-09,Kyrgyzstan,KG,10,0,6415851,Asia,280,4
2020-04-10,Kyrgyzstan,KG,18,1,6415851,Asia,298,5
2020-04-11,Kyrgyzstan,KG,41,0,6415851,Asia,339,5
2020-04-12,Kyrgyzstan,KG,38,0,6415851,Asia,377,5
2020-04-13,Kyrgyzstan,KG,42,0,6415851,Asia,419,5
2020-04-14,Kyrgyzstan,KG,11,0,6415851,Asia,430,5
2020-04-15,Kyrgyzstan,KG,19,0,6415851,Asia,449,5
2020-04-16,Kyrgyzstan,KG,17,0,6415851,Asia,466,5
2020-04-17,Kyrgyzstan,KG,23,0,6415851,Asia,489,5
2020-04-18,Kyrgyzstan,KG,17,0,6415851,Asia,506,5
2020-04-19,Kyrgyzstan,KG,48,0,6415851,Asia,554,5
2020-04-20,Kyrgyzstan,KG,14,2,6415851,Asia,568,7
2020-04-21,Kyrgyzstan,KG,22,0,6415851,Asia,590,7
2020-04-22,Kyrgyzstan,KG,22,0,6415851,Asia,612,7
2020-04-23,Kyrgyzstan,KG,19,1,6415851,Asia,631,8
2020-04-24,Kyrgyzstan,KG,25,0,6415851,Asia,656,8
2020-04-25,Kyrgyzstan,KG,9,0,6415851,Asia,665,8
2020-04-26,Kyrgyzstan,KG,17,0,6415851,Asia,682,8
2020-04-27,Kyrgyzstan,KG,13,0,6415851,Asia,695,8
2020-04-28,Kyrgyzstan,KG,13,0,6415851,Asia,708,8
2020-04-29,Kyrgyzstan,KG,21,0,6415851,Asia,729,8
2020-04-30,Kyrgyzstan,KG,17,0,6415851,Asia,746,8
2020-05-01,Kyrgyzstan,KG,0,0,6415851,Asia,746,8
2020-05-02,Kyrgyzstan,KG,23,0,6415851,Asia,769,8
2020-05-03,Kyrgyzstan,KG,26,2,6415851,Asia,795,10
2020-05-04,Kyrgyzstan,KG,35,0,6415851,Asia,830,10
2020-05-05,Kyrgyzstan,KG,13,1,6415851,Asia,843,11
2020-05-06,Kyrgyzstan,KG,28,1,6415851,Asia,871,12
2020-05-07,Kyrgyzstan,KG,24,0,6415851,Asia,895,12
2020-05-08,Kyrgyzstan,KG,11,0,6415851,Asia,906,12
2020-05-09,Kyrgyzstan,KG,25,0,6415851,Asia,931,12
2020-05-10,Kyrgyzstan,KG,71,0,6415851,Asia,1002,12
2020-05-11,Kyrgyzstan,KG,14,0,6415851,Asia,1016,12
2020-05-12,Kyrgyzstan,KG,21,0,6415851,Asia,1037,12
2020-05-13,Kyrgyzstan,KG,7,0,6415851,Asia,1044,12
2020-05-14,Kyrgyzstan,KG,38,0,6415851,Asia,1082,12
2020-05-15,Kyrgyzstan,KG,29,2,6415851,Asia,1111,14
2020-05-16,Kyrgyzstan,KG,6,0,6415851,Asia,1117,14
2020-05-17,Kyrgyzstan,KG,21,0,6415851,Asia,1138,14
2020-05-18,Kyrgyzstan,KG,78,0,6415851,Asia,1216,14
2020-05-19,Kyrgyzstan,KG,27,0,6415851,Asia,1243,14
2020-05-20,Kyrgyzstan,KG,27,0,6415851,Asia,1270,14
2020-05-21,Kyrgyzstan,KG,43,0,6415851,Asia,1313,14
2020-05-22,Kyrgyzstan,KG,37,0,6415851,Asia,1350,14
2020-05-23,Kyrgyzstan,KG,14,0,6415851,Asia,1364,14
2020-05-24,Kyrgyzstan,KG,39,0,6415851,Asia,1403,14
2020-05-25,Kyrgyzstan,KG,30,2,6415851,Asia,1433,16
2020-05-26,Kyrgyzstan,KG,35,0,6415851,Asia,1468,16
2020-05-27,Kyrgyzstan,KG,52,0,6415851,Asia,1520,16
2020-05-28,Kyrgyzstan,KG,74,0,6415851,Asia,1594,16
2020-05-29,Kyrgyzstan,KG,68,0,6415851,Asia,1662,16
2020-05-30,Kyrgyzstan,KG,60,0,6415851,Asia,1722,16
2020-05-31,Kyrgyzstan,KG,26,0,6415851,Asia,1748,16
2020-06-01,Kyrgyzstan,KG,69,0,6415851,Asia,1817,16
2020-06-02,Kyrgyzstan,KG,28,1,6415851,Asia,1845,17
2020-06-03,Kyrgyzstan,KG,26,3,6415851,Asia,1871,20
2020-06-04,Kyrgyzstan,KG,28,0,6415851,Asia,1899,20
2020-06-05,Kyrgyzstan,KG,37,2,6415851,Asia,1936,22
2020-06-06,Kyrgyzstan,KG,38,0,6415851,Asia,1974,22
2020-06-07,Kyrgyzstan,KG,33,0,6415851,Asia,2007,22
2020-06-08,Kyrgyzstan,KG,25,1,6415851,Asia,2032,23
2020-06-09,Kyrgyzstan,KG,23,1,6415851,Asia,2055,24
2020-06-10,Kyrgyzstan,KG,38,2,6415851,Asia,2093,26
2020-06-11,Kyrgyzstan,KG,36,0,6415851,Asia,2129,26
2020-06-12,Kyrgyzstan,KG,37,0,6415851,Asia,2166,26
2020-06-13,Kyrgyzstan,KG,41,1,6415851,Asia,2207,27
2020-06-14,Kyrgyzstan,KG,78,0,6415851,Asia,2285,27
2020-06-15,Kyrgyzstan,KG,87,0,6415851,Asia,2372,27
2020-06-16,Kyrgyzstan,KG,100,1,6415851,Asia,2472,28
2020-06-17,Kyrgyzstan,KG,90,2,6415851,Asia,2562,30
2020-06-18,Kyrgyzstan,KG,95,1,6415851,Asia,2657,31
2020-06-19,Kyrgyzstan,KG,132,1,6415851,Asia,2789,32
2020-06-20,Kyrgyzstan,KG,192,3,6415851,Asia,2981,35
2020-06-21,Kyrgyzstan,KG,170,2,6415851,Asia,3151,37
2020-06-22,Kyrgyzstan,KG,205,3,6415851,Asia,3356,40
2020-06-23,Kyrgyzstan,KG,163,1,6415851,Asia,3519,41
2020-06-24,Kyrgyzstan,KG,207,1,6415851,Asia,3726,42
2020-06-25,Kyrgyzstan,KG,228,1,6415851,Asia,3954,43
2020-06-26,Kyrgyzstan,KG,250,0,6415851,Asia,4204,43
2020-06-27,Kyrgyzstan,KG,309,3,6415851,Asia,4513,46
2020-06-28,Kyrgyzstan,KG,235,1,6415851,Asia,4748,47
2020-06-29,Kyrgyzstan,KG,269,3,6415851,Asia,5017,50
2020-06-30,Kyrgyzstan,KG,279,7,6415851,Asia,5296,57
2020-07-01,Kyrgyzstan,KG,439,5,6415851,Asia,5735,62
2020-07-02,Kyrgyzstan,KG,0,0,6415851,Asia,5735,62
2020-07-03,Kyrgyzstan,KG,1032,14,6415851,Asia,6767,76
2020-07-04,Kyrgyzstan,KG,327,2,6415851,Asia,7094,78
2020-07-05,Kyrgyzstan,KG,283,10,6415851,Asia,7377,88
2020-07-06,Kyrgyzstan,KG,314,4,6415851,Asia,7691,92
2020-07-07,Kyrgyzstan,KG,450,7,6415851,Asia,8141,99
2020-07-08,Kyrgyzstan,KG,345,13,6415851,Asia,8486,112
2020-07-09,Kyrgyzstan,KG,361,4,6415851,Asia,8847,116
2020-07-10,Kyrgyzstan,KG,511,6,6415851,Asia,9358,122
2020-07-11,Kyrgyzstan,KG,552,3,6415851,Asia,9910,125
2020-07-12,Kyrgyzstan,KG,719,7,6415851,Asia,10629,132
2020-07-13,Kyrgyzstan,KG,488,15,6415851,Asia,11117,147
2020-07-14,Kyrgyzstan,KG,421,2,6415851,Asia,11538,149
2020-07-15,Kyrgyzstan,KG,439,11,6415851,Asia,11977,160
2020-07-16,Kyrgyzstan,KG,521,7,6415851,Asia,12498,167
2020-07-17,Kyrgyzstan,KG,603,5,6415851,Asia,13101,172
2020-07-18,Kyrgyzstan,KG,11505,728,6415851,Asia,24606,900
2020-07-19,Kyrgyzstan,KG,1926,103,6415851,Asia,26532,1003
2020-07-20,Kyrgyzstan,KG,611,34,6415851,Asia,27143,1037
2020-07-21,Kyrgyzstan,KG,1108,42,6415851,Asia,28251,1079
2020-07-22,Kyrgyzstan,KG,1108,44,6415851,Asia,29359,1123
2020-07-23,Kyrgyzstan,KG,967,46,6415851,Asia,30326,1169
2020-07-24,Kyrgyzstan,KG,921,42,6415851,Asia,31247,1211
2020-07-25,Kyrgyzstan,KG,317,38,6415851,Asia,31564,1249
2020-07-26,Kyrgyzstan,KG,1249,28,6415851,Asia,32813,1277
2020-07-27,Kyrgyzstan,KG,483,24,6415851,Asia,33296,1301
2020-07-28,Kyrgyzstan,KG,548,28,6415851,Asia,33844,1329
2020-07-29,Kyrgyzstan,KG,748,18,6415851,Asia,34592,1347
2020-07-30,Kyrgyzstan,KG,631,17,6415851,Asia,35223,1364
2020-07-31,Kyrgyzstan,KG,582,14,6415851,Asia,35805,1378
2020-08-01,Kyrgyzstan,KG,494,19,6415851,Asia,36299,1397
2020-08-02,Kyrgyzstan,KG,420,12,6415851,Asia,36719,1409
2020-08-03,Kyrgyzstan,KG,410,11,6415851,Asia,37129,1420
2020-08-04,Kyrgyzstan,KG,412,7,6415851,Asia,37541,1427
2020-08-05,Kyrgyzstan,KG,569,11,6415851,Asia,38110,1438
2020-08-06,Kyrgyzstan,KG,549,9,6415851,Asia,38659,1447
2020-08-07,Kyrgyzstan,KG,503,4,6415851,Asia,39162,1451
2020-08-08,Kyrgyzstan,KG,425,9,6415851,Asia,39587,1460
2020-08-09,Kyrgyzstan,KG,332,8,6415851,Asia,39919,1468
2020-08-10,Kyrgyzstan,KG,258,6,6415851,Asia,40177,1474
2020-08-11,Kyrgyzstan,KG,278,4,6415851,Asia,40455,1478
2020-08-12,Kyrgyzstan,KG,304,6,6415851,Asia,40759,1484
2020-08-13,Kyrgyzstan,KG,0,0,6415851,Asia,40759,1484
2020-08-14,Kyrgyzstan,KG,310,3,6415851,Asia,41069,1487
2020-08-15,Kyrgyzstan,KG,304,4,6415851,Asia,41373,1491
2020-08-16,Kyrgyzstan,KG,483,4,6415851,Asia,41856,1495
2020-08-17,Kyrgyzstan,KG,135,1,6415851,Asia,41991,1496
2020-08-18,Kyrgyzstan,KG,155,2,6415851,Asia,42146,1498
2020-08-19,Kyrgyzstan,KG,0,0,6415851,Asia,42146,1498
2020-08-20,Kyrgyzstan,KG,179,0,6415851,Asia,42325,1498
2020-08-21,Kyrgyzstan,KG,378,1,6415851,Asia,42703,1499
2020-08-22,Kyrgyzstan,KG,0,0,6415851,Asia,42703,1499
2020-08-23,Kyrgyzstan,KG,186,1,6415851,Asia,42889,1500
2020-08-24,Kyrgyzstan,KG,237,-443,6415851,Asia,43126,1057
2020-08-25,Kyrgyzstan,KG,119,0,6415851,Asia,43245,1057
2020-08-26,Kyrgyzstan,KG,113,0,6415851,Asia,43358,1057
2020-08-27,Kyrgyzstan,KG,101,0,6415851,Asia,43459,1057
2020-08-28,Kyrgyzstan,KG,128,0,6415851,Asia,43587,1057
2020-08-29,Kyrgyzstan,KG,125,0,6415851,Asia,43712,1057
2020-08-30,Kyrgyzstan,KG,108,1,6415851,Asia,43820,1058
2020-08-31,Kyrgyzstan,KG,78,0,6415851,Asia,43898,1058
2020-09-01,Kyrgyzstan,KG,60,1,6415851,Asia,43958,1059
2020-09-02,Kyrgyzstan,KG,78,0,6415851,Asia,44036,1059
2020-09-03,Kyrgyzstan,KG,99,0,6415851,Asia,44135,1059
2020-09-04,Kyrgyzstan,KG,92,1,6415851,Asia,44227,1060
2020-09-05,Kyrgyzstan,KG,89,0,6415851,Asia,44316,1060
2020-09-06,Kyrgyzstan,KG,87,0,6415851,Asia,44403,1060
2020-09-07,Kyrgyzstan,KG,48,0,6415851,Asia,44451,1060
2020-09-08,Kyrgyzstan,KG,75,0,6415851,Asia,44526,1060
2020-09-09,Kyrgyzstan,KG,87,1,6415851,Asia,44613,1061
2020-09-10,Kyrgyzstan,KG,71,0,6415851,Asia,44684,1061
2020-09-11,Kyrgyzstan,KG,0,2,6415851,Asia,44684,1063
2020-09-12,Kyrgyzstan,KG,144,0,6415851,Asia,44828,1063
2020-09-13,Kyrgyzstan,KG,53,0,6415851,Asia,44881,1063
2020-09-14,Kyrgyzstan,KG,47,0,6415851,Asia,44928,1063
2020-09-15,Kyrgyzstan,KG,0,0,6415851,Asia,44928,1063
2020-09-16,Kyrgyzstan,KG,144,0,6415851,Asia,45072,1063
2020-09-17,Kyrgyzstan,KG,81,0,6415851,Asia,45153,1063
2020-09-18,Kyrgyzstan,KG,91,0,6415851,Asia,45244,1063
2020-09-19,Kyrgyzstan,KG,91,0,6415851,Asia,45335,1063
2020-09-20,Kyrgyzstan,KG,81,0,6415851,Asia,45416,1063
2020-09-21,Kyrgyzstan,KG,55,0,6415851,Asia,45471,1063
2020-09-22,Kyrgyzstan,KG,71,0,6415851,Asia,45542,1063
2020-09-23,Kyrgyzstan,KG,88,0,6415851,Asia,45630,1063
2020-09-24,Kyrgyzstan,KG,127,0,6415851,Asia,45757,1063
2020-09-25,Kyrgyzstan,KG,175,0,6415851,Asia,45932,1063
2020-09-26,Kyrgyzstan,KG,158,0,6415851,Asia,46090,1063
2020-09-27,Kyrgyzstan,KG,161,0,6415851,Asia,46251,1063
2020-09-28,Kyrgyzstan,KG,104,1,6415851,Asia,46355,1064
2020-09-29,Kyrgyzstan,KG,167,0,6415851,Asia,46522,1064
2020-09-30,Kyrgyzstan,KG,147,0,6415851,Asia,46669,1064
2020-10-01,Kyrgyzstan,KG,172,1,6415851,Asia,46841,1065
2020-10-02,Kyrgyzstan,KG,215,0,6415851,Asia,47056,1065
2020-10-03,Kyrgyzstan,KG,128,0,6415851,Asia,47184,1065
2020-10-04,Kyrgyzstan,KG,244,1,6415851,Asia,47428,1066
2020-10-05,Kyrgyzstan,KG,207,0,6415851,Asia,47635,1066
2020-10-06,Kyrgyzstan,KG,164,0,6415851,Asia,47799,1066
2020-10-07,Kyrgyzstan,KG,0,0,6415851,Asia,47799,1066
2020-10-08,Kyrgyzstan,KG,298,3,6415851,Asia,48097,1069
2020-10-09,Kyrgyzstan,KG,520,8,6415851,Asia,48617,1077
2020-10-10,Kyrgyzstan,KG,307,5,6415851,Asia,48924,1082
2020-10-11,Kyrgyzstan,KG,0,0,6415851,Asia,48924,1082
2020-10-12,Kyrgyzstan,KG,306,3,6415851,Asia,49230,1085
2020-10-13,Kyrgyzstan,KG,641,7,6415851,Asia,49871,1092
2020-10-14,Kyrgyzstan,KG,330,2,6415851,Asia,50201,1094
2020-10-15,Kyrgyzstan,KG,388,5,6415851,Asia,50589,1099
2020-10-16,Kyrgyzstan,KG,431,4,6415851,Asia,51020,1103
2020-10-17,Kyrgyzstan,KG,470,5,6415851,Asia,51490,1108
2020-10-18,Kyrgyzstan,KG,0,0,6415851,Asia,51490,1108
2020-10-19,Kyrgyzstan,KG,1036,3,6415851,Asia,52526,1111
2020-10-20,Kyrgyzstan,KG,384,2,6415851,Asia,52910,1113
2020-10-21,Kyrgyzstan,KG,549,5,6415851,Asia,53459,1118
2020-10-22,Kyrgyzstan,KG,547,4,6415851,Asia,54006,1122
2020-10-23,Kyrgyzstan,KG,582,4,6415851,Asia,54588,1126
2020-10-24,Kyrgyzstan,KG,556,4,6415851,Asia,55144,1130
2020-10-25,Kyrgyzstan,KG,606,4,6415851,Asia,55750,1134
2020-10-26,Kyrgyzstan,KG,420,0,6415851,Asia,56170,1134
2020-10-27,Kyrgyzstan,KG,568,2,6415851,Asia,56738,1136
2020-10-28,Kyrgyzstan,KG,538,2,6415851,Asia,57276,1138
2020-10-29,Kyrgyzstan,KG,522,1,6415851,Asia,57798,1139
2020-10-30,Kyrgyzstan,KG,596,3,6415851,Asia,58394,1142
2020-10-31,Kyrgyzstan,KG,484,3,6415851,Asia,58878,1145
2020-11-01,Kyrgyzstan,KG,565,5,6415851,Asia,59443,1150
2020-11-02,Kyrgyzstan,KG,436,5,6415851,Asia,59879,1155
2020-11-03,Kyrgyzstan,KG,400,4,6415851,Asia,60279,1159
2020-11-04,Kyrgyzstan,KG,495,4,6415851,Asia,60774,1163
2020-11-05,Kyrgyzstan,KG,535,4,6415851,Asia,61309,1167
2020-11-06,Kyrgyzstan,KG,439,3,6415851,Asia,61748,1170
2020-11-07,Kyrgyzstan,KG,556,2,6415851,Asia,62304,1172
2020-11-08,Kyrgyzstan,KG,515,5,6415851,Asia,62819,1177
2020-11-09,Kyrgyzstan,KG,571,5,6415851,Asia,63390,1182
2020-11-10,Kyrgyzstan,KG,570,3,6415851,Asia,63960,1185
2020-11-11,Kyrgyzstan,KG,400,3,6415851,Asia,64360,1188
2020-11-12,Kyrgyzstan,KG,527,5,6415851,Asia,64887,1193
2020-11-13,Kyrgyzstan,KG,567,2,6415851,Asia,65454,1195
2020-11-14,Kyrgyzstan,KG,499,1,6415851,Asia,65953,1196
2020-11-15,Kyrgyzstan,KG,551,3,6415851,Asia,66504,1199
2020-11-16,Kyrgyzstan,KG,479,4,6415851,Asia,66983,1203
2020-11-17,Kyrgyzstan,KG,486,4,6415851,Asia,67469,1207
2020-11-18,Kyrgyzstan,KG,425,5,6415851,Asia,67894,1212
2020-11-19,Kyrgyzstan,KG,422,5,6415851,Asia,68316,1217
2020-11-20,Kyrgyzstan,KG,386,6,6415851,Asia,68702,1223
2020-11-21,Kyrgyzstan,KG,447,4,6415851,Asia,69149,1227
2020-11-22,Kyrgyzstan,KG,432,4,6415851,Asia,69581,1231
2020-11-23,Kyrgyzstan,KG,304,6,6415851,Asia,69885,1237
2020-11-24,Kyrgyzstan,KG,481,4,6415851,Asia,70366,1241
2020-11-25,Kyrgyzstan,KG,378,4,6415851,Asia,70744,1245
2020-11-26,Kyrgyzstan,KG,427,6,6415851,Asia,71171,1251
2020-11-27,Kyrgyzstan,KG,377,5,6415851,Asia,71548,1256
2020-11-28,Kyrgyzstan,KG,423,6,6415851,Asia,71971,1262
2020-11-29,Kyrgyzstan,KG,456,4,6415851,Asia,72427,1266
2020-11-30,Kyrgyzstan,KG,380,5,6415851,Asia,72807,1271
2020-12-01,Kyrgyzstan,KG,371,4,6415851,Asia,73178,1275
2020-12-02,Kyrgyzstan,KG,335,2,6415851,Asia,73513,1277
2020-12-03,Kyrgyzstan,KG,420,4,6415851,Asia,73933,1281
2020-12-04,Kyrgyzstan,KG,440,4,6415851,Asia,74373,1285
2020-12-05,Kyrgyzstan,KG,401,5,6415851,Asia,74774,1290
2020-12-06,Kyrgyzstan,KG,199,5,6415851,Asia,74973,1295
2020-12-07,Kyrgyzstan,KG,422,2,6415851,Asia,75395,1297
2020-12-08,Kyrgyzstan,KG,295,4,6415851,Asia,75690,1301
2020-12-09,Kyrgyzstan,KG,322,2,6415851,Asia,76012,1303
2020-12-10,Kyrgyzstan,KG,379,3,6415851,Asia,76391,1306
2020-12-11,Kyrgyzstan,KG,327,1,6415851,Asia,76718,1307
2020-12-12,Kyrgyzstan,KG,341,0,6415851,Asia,77059,1307
2020-12-13,Kyrgyzstan,KG,297,0,6415851,Asia,77356,1307
2020-12-14,Kyrgyzstan,KG,318,5,6415851,Asia,77674,1312
2019-12-31,Cambodia,KH,0,0,16486542,Asia,0,0
2020-01-01,Cambodia,KH,0,0,16486542,Asia,0,0
2020-01-02,Cambodia,KH,0,0,16486542,Asia,0,0
2020-01-03,Cambodia,KH,0,0,16486542,Asia,0,0
2020-01-04,Cambodia,KH,0,0,16486542,Asia,0,0
2020-01-05,Cambodia,KH,0,0,16486542,Asia,0,0
2020-01-06,Cambodia,KH,0,0,16486542,Asia,0,0
2020-01-07,Cambodia,KH,0,0,16486542,Asia,0,0
2020-01-08,Cambodia,KH,0,0,16486542,Asia,0,0
2020-01-09,Cambodia,KH,0,0,16486542,Asia,0,0
2020-01-10,Cambodia,KH,0,0,16486542,Asia,0,0
2020-01-11,Cambodia,KH,0,0,16486542,Asia,0,0
2020-01-12,Cambodia,KH,0,0,16486542,Asia,0,0
2020-01-13,Cambodia,KH,0,0,16486542,Asia,0,0
2020-01-14,Cambodia,KH,0,0,16486542,Asia,0,0
2020-01-15,Cambodia,KH,0,0,16486542,Asia,0,0
2020-01-16,Cambodia,KH,0,0,16486542,Asia,0,0
2020-01-17,Cambodia,KH,0,0,16486542,Asia,0,0
2020-01-18,Cambodia,KH,0,0,16486542,Asia,0,0
2020-01-19,Cambodia,KH,0,0,16486542,Asia,0,0
2020-01-20,Cambodia,KH,0,0,16486542,Asia,0,0
2020-01-21,Cambodia,KH,0,0,16486542,Asia,0,0
2020-01-22,Cambodia,KH,0,0,16486542,Asia,0,0
2020-01-23,Cambodia,KH,0,0,16486542,Asia,0,0
2020-01-24,Cambodia,KH,0,0,16486542,Asia,0,0
2020-01-25,Cambodia,KH,0,0,16486542,Asia,0,0
2020-01-26,Cambodia,KH,0,0,16486542,Asia,0,0
2020-01-27,Cambodia,KH,0,0,16486542,Asia,0,0
2020-01-28,Cambodia,KH,1,0,16486542,Asia,1,0
2020-01-29,Cambodia,KH,0,0,16486542,Asia,1,0
2020-01-30,Cambodia,KH,0,0,16486542,Asia,1,0
2020-01-31,Cambodia,KH,0,0,16486542,Asia,1,0
2020-02-01,Cambodia,KH,0,0,16486542,Asia,1,0
2020-02-02,Cambodia,KH,0,0,16486542,Asia,1,0
2020-02-03,Cambodia,KH,0,0,16486542,Asia,1,0
2020-02-04,Cambodia,KH,0,0,16486542,Asia,1,0
2020-02-05,Cambodia,KH,0,0,16486542,Asia,1,0
2020-02-06,Cambodia,KH,0,0,16486542,Asia,1,0
2020-02-07,Cambodia,KH,0,0,16486542,Asia,1,0
2020-02-08,Cambodia,KH,0,0,16486542,Asia,1,0
2020-02-09,Cambodia,KH,0,0,16486542,Asia,1,0
2020-02-10,Cambodia,KH,0,0,16486542,Asia,1,0
2020-02-11,Cambodia,KH,0,0,16486542,Asia,1,0
2020-02-12,Cambodia,KH,0,0,16486542,Asia,1,0
2020-02-13,Cambodia,KH,0,0,16486542,Asia,1,0
2020-02-14,Cambodia,KH,0,0,16486542,Asia,1,0
2020-02-15,Cambodia,KH,0,0,16486542,Asia,1,0
2020-02-16,Cambodia,KH,0,0,16486542,Asia,1,0
2020-02-17,Cambodia,KH,0,0,16486542,Asia,1,0
2020-02-18,Cambodia,KH,0,0,16486542,Asia,1,0
2020-02-19,Cambodia,KH,0,0,16486542,Asia,1,0
2020-02-20,Cambodia,KH,0,0,16486542,Asia,1,0
2020-02-21,Cambodia,KH,0,0,16486542,Asia,1,0
2020-02-22,Cambodia,KH,0,0,16486542,Asia,1,0
2020-02-23,Cambodia,KH,0,0,16486542,Asia,1,0
2020-02-24,Cambodia,KH,0,0,16486542,Asia,1,0
2020-02-25,Cambodia,KH,0,0,16486542,Asia,1,0
2020-02-26,Cambodia,KH,0,0,16486542,Asia,1,0
2020-02-27,Cambodia,KH,0,0,16486542,Asia,1,0
2020-02-28,Cambodia,KH,0,0,16486542,Asia,1,0
2020-02-29,Cambodia,KH,0,0,16486542,Asia,1,0
2020-03-01,Cambodia,KH,0,0,16486542,Asia,1,0
2020-03-02,Cambodia,KH,0,0,16486542,Asia,1,0
2020-03-08,Cambodia,KH,1,0,16486542,Asia,2,0
2020-03-12,Cambodia,KH,1,0,16486542,Asia,3,0
2020-03-13,Cambodia,KH,2,0,16486542,Asia,5,0
2020-03-15,Cambodia,KH,2,0,16486542,Asia,7,0
2020-03-16,Cambodia,KH,5,0,16486542,Asia,12,0
2020-03-17,Cambodia,KH,12,0,16486542,Asia,24,0
2020-03-18,Cambodia,KH,0,0,16486542,Asia,24,0
2020-03-19,Cambodia,KH,0,0,16486542,Asia,24,0
2020-03-20,Cambodia,KH,0,0,16486542,Asia,24,0
2020-03-21,Cambodia,KH,23,0,16486542,Asia,47,0
2020-03-22,Cambodia,KH,4,0,16486542,Asia,51,0
2020-03-23,Cambodia,KH,35,0,16486542,Asia,86,0
2020-03-24,Cambodia,KH,1,0,16486542,Asia,87,0
2020-03-25,Cambodia,KH,4,0,16486542,Asia,91,0
2020-03-26,Cambodia,KH,5,0,16486542,Asia,96,0
2020-03-27,Cambodia,KH,2,0,16486542,Asia,98,0
2020-03-28,Cambodia,KH,4,0,16486542,Asia,102,0
2020-03-29,Cambodia,KH,1,0,16486542,Asia,103,0
2020-03-30,Cambodia,KH,4,0,16486542,Asia,107,0
2020-03-31,Cambodia,KH,2,0,16486542,Asia,109,0
2020-04-01,Cambodia,KH,0,0,16486542,Asia,109,0
2020-04-02,Cambodia,KH,1,0,16486542,Asia,110,0
2020-04-03,Cambodia,KH,4,0,16486542,Asia,114,0
2020-04-04,Cambodia,KH,0,0,16486542,Asia,114,0
2020-04-05,Cambodia,KH,0,0,16486542,Asia,114,0
2020-04-06,Cambodia,KH,0,0,16486542,Asia,114,0
2020-04-07,Cambodia,KH,1,0,16486542,Asia,115,0
2020-04-08,Cambodia,KH,2,0,16486542,Asia,117,0
2020-04-09,Cambodia,KH,1,0,16486542,Asia,118,0
2020-04-10,Cambodia,KH,1,0,16486542,Asia,119,0
2020-04-11,Cambodia,KH,1,0,16486542,Asia,120,0
2020-04-12,Cambodia,KH,2,0,16486542,Asia,122,0
2020-04-13,Cambodia,KH,0,0,16486542,Asia,122,0
2020-04-14,Cambodia,KH,0,0,16486542,Asia,122,0
2020-04-15,Cambodia,KH,0,0,16486542,Asia,122,0
2020-04-16,Cambodia,KH,0,0,16486542,Asia,122,0
2020-04-17,Cambodia,KH,0,0,16486542,Asia,122,0
2020-04-18,Cambodia,KH,0,0,16486542,Asia,122,0
2020-04-19,Cambodia,KH,0,0,16486542,Asia,122,0
2020-04-20,Cambodia,KH,0,0,16486542,Asia,122,0
2020-04-21,Cambodia,KH,0,0,16486542,Asia,122,0
2020-04-22,Cambodia,KH,0,0,16486542,Asia,122,0
2020-04-23,Cambodia,KH,0,0,16486542,Asia,122,0
2020-04-24,Cambodia,KH,0,0,16486542,Asia,122,0
2020-04-25,Cambodia,KH,0,0,16486542,Asia,122,0
2020-04-26,Cambodia,KH,0,0,16486542,Asia,122,0
2020-04-27,Cambodia,KH,0,0,16486542,Asia,122,0
2020-04-28,Cambodia,KH,0,0,16486542,Asia,122,0
2020-04-29,Cambodia,KH,0,0,16486542,Asia,122,0
2020-04-30,Cambodia,KH,0,0,16486542,Asia,122,0
2020-05-01,Cambodia,KH,0,0,16486542,Asia,122,0
2020-05-02,Cambodia,KH,0,0,16486542,Asia,122,0
2020-05-03,Cambodia,KH,0,0,16486542,Asia,122,0
2020-05-04,Cambodia,KH,0,0,16486542,Asia,122,0
2020-05-05,Cambodia,KH,0,0,16486542,Asia,122,0
2020-05-06,Cambodia,KH,0,0,16486542,Asia,122,0
2020-05-07,Cambodia,KH,0,0,16486542,Asia,122,0
2020-05-08,Cambodia,KH,0,0,16486542,Asia,122,0
2020-05-09,Cambodia,KH,0,0,16486542,Asia,122,0
2020-05-10,Cambodia,KH,0,0,16486542,Asia,122,0
2020-05-11,Cambodia,KH,0,0,16486542,Asia,122,0
2020-05-12,Cambodia,KH,0,0,16486542,Asia,122,0
2020-05-13,Cambodia,KH,0,0,16486542,Asia,122,0
2020-05-14,Cambodia,KH,0,0,16486542,Asia,122,0
2020-05-15,Cambodia,KH,0,0,16486542,Asia,122,0
2020-05-16,Cambodia,KH,0,0,16486542,Asia,122,0
2020-05-17,Cambodia,KH,0,0,16486542,Asia,122,0
2020-05-18,Cambodia,KH,0,0,16486542,Asia,122,0
2020-05-19,Cambodia,KH,0,0,16486542,Asia,122,0
2020-05-20,Cambodia,KH,0,0,16486542,Asia,122,0
2020-05-21,Cambodia,KH,0,0,16486542,Asia,122,0
2020-05-22,Cambodia,KH,1,0,16486542,Asia,123,0
2020-05-23,Cambodia,KH,1,0,16486542,Asia,124,0
2020-05-24,Cambodia,KH,0,0,16486542,Asia,124,0
2020-05-25,Cambodia,KH,0,0,16486542,Asia,124,0
2020-05-26,Cambodia,KH,0,0,16486542,Asia,124,0
2020-05-27,Cambodia,KH,0,0,16486542,Asia,124,0
2020-05-28,Cambodia,KH,0,0,16486542,Asia,124,0
2020-05-29,Cambodia,KH,0,0,16486542,Asia,124,0
2020-05-30,Cambodia,KH,1,0,16486542,Asia,125,0
2020-05-31,Cambodia,KH,0,0,16486542,Asia,125,0
2020-06-01,Cambodia,KH,0,0,16486542,Asia,125,0
2020-06-02,Cambodia,KH,0,0,16486542,Asia,125,0
2020-06-03,Cambodia,KH,0,0,16486542,Asia,125,0
2020-06-04,Cambodia,KH,0,0,16486542,Asia,125,0
2020-06-05,Cambodia,KH,0,0,16486542,Asia,125,0
2020-06-06,Cambodia,KH,0,0,16486542,Asia,125,0
2020-06-07,Cambodia,KH,0,0,16486542,Asia,125,0
2020-06-08,Cambodia,KH,1,0,16486542,Asia,126,0
2020-06-09,Cambodia,KH,0,0,16486542,Asia,126,0
2020-06-10,Cambodia,KH,0,0,16486542,Asia,126,0
2020-06-11,Cambodia,KH,0,0,16486542,Asia,126,0
2020-06-12,Cambodia,KH,0,0,16486542,Asia,126,0
2020-06-13,Cambodia,KH,0,0,16486542,Asia,126,0
2020-06-14,Cambodia,KH,2,0,16486542,Asia,128,0
2020-06-15,Cambodia,KH,0,0,16486542,Asia,128,0
2020-06-16,Cambodia,KH,0,0,16486542,Asia,128,0
2020-06-17,Cambodia,KH,0,0,16486542,Asia,128,0
2020-06-18,Cambodia,KH,1,0,16486542,Asia,129,0
2020-06-19,Cambodia,KH,0,0,16486542,Asia,129,0
2020-06-20,Cambodia,KH,0,0,16486542,Asia,129,0
2020-06-21,Cambodia,KH,0,0,16486542,Asia,129,0
2020-06-22,Cambodia,KH,0,0,16486542,Asia,129,0
2020-06-23,Cambodia,KH,1,0,16486542,Asia,130,0
2020-06-24,Cambodia,KH,0,0,16486542,Asia,130,0
2020-06-25,Cambodia,KH,0,0,16486542,Asia,130,0
2020-06-26,Cambodia,KH,0,0,16486542,Asia,130,0
2020-06-27,Cambodia,KH,9,0,16486542,Asia,139,0
2020-06-28,Cambodia,KH,2,0,16486542,Asia,141,0
2020-06-29,Cambodia,KH,0,0,16486542,Asia,141,0
2020-06-30,Cambodia,KH,0,0,16486542,Asia,141,0
2020-07-01,Cambodia,KH,0,0,16486542,Asia,141,0
2020-07-02,Cambodia,KH,0,0,16486542,Asia,141,0
2020-07-03,Cambodia,KH,0,0,16486542,Asia,141,0
2020-07-04,Cambodia,KH,0,0,16486542,Asia,141,0
2020-07-05,Cambodia,KH,0,0,16486542,Asia,141,0
2020-07-06,Cambodia,KH,0,0,16486542,Asia,141,0
2020-07-07,Cambodia,KH,0,0,16486542,Asia,141,0
2020-07-08,Cambodia,KH,0,0,16486542,Asia,141,0
2020-07-09,Cambodia,KH,0,0,16486542,Asia,141,0
2020-07-10,Cambodia,KH,0,0,16486542,Asia,141,0
2020-07-11,Cambodia,KH,0,0,16486542,Asia,141,0
2020-07-12,Cambodia,KH,15,0,16486542,Asia,156,0
2020-07-13,Cambodia,KH,0,0,16486542,Asia,156,0
2020-07-14,Cambodia,KH,9,0,16486542,Asia,165,0
2020-07-15,Cambodia,KH,0,0,16486542,Asia,165,0
2020-07-16,Cambodia,KH,1,0,16486542,Asia,166,0
2020-07-17,Cambodia,KH,5,0,16486542,Asia,171,0
2020-07-18,Cambodia,KH,0,0,16486542,Asia,171,0
2020-07-19,Cambodia,KH,0,0,16486542,Asia,171,0
2020-07-20,Cambodia,KH,0,0,16486542,Asia,171,0
2020-07-21,Cambodia,KH,26,0,16486542,Asia,197,0
2020-07-22,Cambodia,KH,0,0,16486542,Asia,197,0
2020-07-23,Cambodia,KH,1,0,16486542,Asia,198,0
2020-07-24,Cambodia,KH,4,0,16486542,Asia,202,0
2020-07-25,Cambodia,KH,0,0,16486542,Asia,202,0
2020-07-26,Cambodia,KH,23,0,16486542,Asia,225,0
2020-07-27,Cambodia,KH,0,0,16486542,Asia,225,0
2020-07-28,Cambodia,KH,0,0,16486542,Asia,225,0
2020-07-29,Cambodia,KH,1,0,16486542,Asia,226,0
2020-07-30,Cambodia,KH,8,0,16486542,Asia,234,0
2020-07-31,Cambodia,KH,0,0,16486542,Asia,234,0
2020-08-01,Cambodia,KH,5,0,16486542,Asia,239,0
2020-08-02,Cambodia,KH,1,0,16486542,Asia,240,0
2020-08-03,Cambodia,KH,0,0,16486542,Asia,240,0
2020-08-04,Cambodia,KH,0,0,16486542,Asia,240,0
2020-08-05,Cambodia,KH,3,0,16486542,Asia,243,0
2020-08-06,Cambodia,KH,0,0,16486542,Asia,243,0
2020-08-07,Cambodia,KH,0,0,16486542,Asia,243,0
2020-08-08,Cambodia,KH,3,0,16486542,Asia,246,0
2020-08-09,Cambodia,KH,0,0,16486542,Asia,246,0
2020-08-10,Cambodia,KH,5,0,16486542,Asia,251,0
2020-08-11,Cambodia,KH,15,0,16486542,Asia,266,0
2020-08-12,Cambodia,KH,2,0,16486542,Asia,268,0
2020-08-13,Cambodia,KH,4,0,16486542,Asia,272,0
2020-08-14,Cambodia,KH,1,0,16486542,Asia,273,0
2020-08-15,Cambodia,KH,0,0,16486542,Asia,273,0
2020-08-16,Cambodia,KH,0,0,16486542,Asia,273,0
2020-08-17,Cambodia,KH,0,0,16486542,Asia,273,0
2020-08-18,Cambodia,KH,0,0,16486542,Asia,273,0
2020-08-19,Cambodia,KH,0,0,16486542,Asia,273,0
2020-08-20,Cambodia,KH,0,0,16486542,Asia,273,0
2020-08-21,Cambodia,KH,0,0,16486542,Asia,273,0
2020-08-22,Cambodia,KH,0,0,16486542,Asia,273,0
2020-08-23,Cambodia,KH,0,0,16486542,Asia,273,0
2020-08-24,Cambodia,KH,0,0,16486542,Asia,273,0
2020-08-25,Cambodia,KH,0,0,16486542,Asia,273,0
2020-08-26,Cambodia,KH,0,0,16486542,Asia,273,0
2020-08-27,Cambodia,KH,0,0,16486542,Asia,273,0
2020-08-28,Cambodia,KH,0,0,16486542,Asia,273,0
2020-08-29,Cambodia,KH,0,0,16486542,Asia,273,0
2020-08-30,Cambodia,KH,0,0,16486542,Asia,273,0
2020-08-31,Cambodia,KH,1,0,16486542,Asia,274,0
2020-09-01,Cambodia,KH,0,0,16486542,Asia,274,0
2020-09-02,Cambodia,KH,0,0,16486542,Asia,274,0
2020-09-03,Cambodia,KH,0,0,16486542,Asia,274,0
2020-09-04,Cambodia,KH,0,0,16486542,Asia,274,0
2020-09-05,Cambodia,KH,0,0,16486542,Asia,274,0
2020-09-06,Cambodia,KH,0,0,16486542,Asia,274,0
2020-09-07,Cambodia,KH,0,0,16486542,Asia,274,0
2020-09-08,Cambodia,KH,0,0,16486542,Asia,274,0
2020-09-09,Cambodia,KH,0,0,16486542,Asia,274,0
2020-09-10,Cambodia,KH,0,0,16486542,Asia,274,0
2020-09-11,Cambodia,KH,0,0,16486542,Asia,274,0
2020-09-12,Cambodia,KH,0,0,16486542,Asia,274,0
2020-09-13,Cambodia,KH,1,0,16486542,Asia,275,0
2020-09-14,Cambodia,KH,0,0,16486542,Asia,275,0
2020-09-15,Cambodia,KH,0,0,16486542,Asia,275,0
2020-09-16,Cambodia,KH,0,0,16486542,Asia,275,0
2020-09-17,Cambodia,KH,0,0,16486542,Asia,275,0
2020-09-18,Cambodia,KH,0,0,16486542,Asia,275,0
2020-09-19,Cambodia,KH,0,0,16486542,Asia,275,0
2020-09-20,Cambodia,KH,0,0,16486542,Asia,275,0
2020-09-21,Cambodia,KH,0,0,16486542,Asia,275,0
2020-09-22,Cambodia,KH,0,0,16486542,Asia,275,0
2020-09-23,Cambodia,KH,0,0,16486542,Asia,275,0
2020-09-24,Cambodia,KH,0,0,16486542,Asia,275,0
2020-09-25,Cambodia,KH,0,0,16486542,Asia,275,0
2020-09-26,Cambodia,KH,0,0,16486542,Asia,275,0
2020-09-27,Cambodia,KH,1,0,16486542,Asia,276,0
2020-09-28,Cambodia,KH,0,0,16486542,Asia,276,0
2020-09-29,Cambodia,KH,1,0,16486542,Asia,277,0
2020-09-30,Cambodia,KH,0,0,16486542,Asia,277,0
2020-10-01,Cambodia,KH,0,0,16486542,Asia,277,0
2020-10-02,Cambodia,KH,0,0,16486542,Asia,277,0
2020-10-03,Cambodia,KH,1,0,16486542,Asia,278,0
2020-10-04,Cambodia,KH,0,0,16486542,Asia,278,0
2020-10-05,Cambodia,KH,2,0,16486542,Asia,280,0
2020-10-06,Cambodia,KH,0,0,16486542,Asia,280,0
2020-10-07,Cambodia,KH,0,0,16486542,Asia,280,0
2020-10-08,Cambodia,KH,1,0,16486542,Asia,281,0
2020-10-09,Cambodia,KH,1,0,16486542,Asia,282,0
2020-10-10,Cambodia,KH,1,0,16486542,Asia,283,0
2020-10-11,Cambodia,KH,0,0,16486542,Asia,283,0
2020-10-12,Cambodia,KH,0,0,16486542,Asia,283,0
2020-10-13,Cambodia,KH,0,0,16486542,Asia,283,0
2020-10-14,Cambodia,KH,0,0,16486542,Asia,283,0
2020-10-15,Cambodia,KH,0,0,16486542,Asia,283,0
2020-10-16,Cambodia,KH,0,0,16486542,Asia,283,0
2020-10-17,Cambodia,KH,0,0,16486542,Asia,283,0
2020-10-18,Cambodia,KH,0,0,16486542,Asia,283,0
2020-10-19,Cambodia,KH,0,0,16486542,Asia,283,0
2020-10-20,Cambodia,KH,2,0,16486542,Asia,285,0
2020-10-21,Cambodia,KH,1,0,16486542,Asia,286,0
2020-10-22,Cambodia,KH,0,0,16486542,Asia,286,0
2020-10-23,Cambodia,KH,0,0,16486542,Asia,286,0
2020-10-24,Cambodia,KH,1,0,16486542,Asia,287,0
2020-10-25,Cambodia,KH,0,0,16486542,Asia,287,0
2020-10-26,Cambodia,KH,0,0,16486542,Asia,287,0
2020-10-27,Cambodia,KH,1,0,16486542,Asia,288,0
2020-10-28,Cambodia,KH,2,0,16486542,Asia,290,0
2020-10-29,Cambodia,KH,0,0,16486542,Asia,290,0
2020-10-30,Cambodia,KH,0,0,16486542,Asia,290,0
2020-10-31,Cambodia,KH,0,0,16486542,Asia,290,0
2020-11-01,Cambodia,KH,1,0,16486542,Asia,291,0
2020-11-02,Cambodia,KH,0,0,16486542,Asia,291,0
2020-11-03,Cambodia,KH,1,0,16486542,Asia,292,0
2020-11-04,Cambodia,KH,0,0,16486542,Asia,292,0
2020-11-05,Cambodia,KH,0,0,16486542,Asia,292,0
2020-11-06,Cambodia,KH,0,0,16486542,Asia,292,0
2020-11-07,Cambodia,KH,2,0,16486542,Asia,294,0
2020-11-08,Cambodia,KH,1,0,16486542,Asia,295,0
2020-11-09,Cambodia,KH,2,0,16486542,Asia,297,0
2020-11-10,Cambodia,KH,3,0,16486542,Asia,300,0
2020-11-11,Cambodia,KH,0,0,16486542,Asia,300,0
2020-11-12,Cambodia,KH,1,0,16486542,Asia,301,0
2020-11-13,Cambodia,KH,0,0,16486542,Asia,301,0
2020-11-14,Cambodia,KH,1,0,16486542,Asia,302,0
2020-11-15,Cambodia,KH,0,0,16486542,Asia,302,0
2020-11-16,Cambodia,KH,0,0,16486542,Asia,302,0
2020-11-17,Cambodia,KH,1,0,16486542,Asia,303,0
2020-11-18,Cambodia,KH,1,0,16486542,Asia,304,0
2020-11-19,Cambodia,KH,0,0,16486542,Asia,304,0
2020-11-20,Cambodia,KH,0,0,16486542,Asia,304,0
2020-11-21,Cambodia,KH,1,0,16486542,Asia,305,0
2020-11-22,Cambodia,KH,1,0,16486542,Asia,306,0
2020-11-23,Cambodia,KH,0,0,16486542,Asia,306,0
2020-11-24,Cambodia,KH,0,0,16486542,Asia,306,0
2020-11-25,Cambodia,KH,1,0,16486542,Asia,307,0
2020-11-26,Cambodia,KH,0,0,16486542,Asia,307,0
2020-11-27,Cambodia,KH,0,0,16486542,Asia,307,0
2020-11-28,Cambodia,KH,0,0,16486542,Asia,307,0
2020-11-29,Cambodia,KH,0,0,16486542,Asia,307,0
2020-11-30,Cambodia,KH,16,0,16486542,Asia,323,0
2020-12-01,Cambodia,KH,3,0,16486542,Asia,326,0
2020-12-02,Cambodia,KH,3,0,16486542,Asia,329,0
2020-12-03,Cambodia,KH,2,0,16486542,Asia,331,0
2020-12-04,Cambodia,KH,0,0,16486542,Asia,331,0
2020-12-05,Cambodia,KH,14,0,16486542,Asia,345,0
2020-12-06,Cambodia,KH,1,0,16486542,Asia,346,0
2020-12-07,Cambodia,KH,2,0,16486542,Asia,348,0
2020-12-08,Cambodia,KH,2,0,16486542,Asia,350,0
2020-12-09,Cambodia,KH,4,0,16486542,Asia,354,0
2020-12-10,Cambodia,KH,2,0,16486542,Asia,356,0
2020-12-11,Cambodia,KH,0,0,16486542,Asia,356,0
2020-12-12,Cambodia,KH,1,0,16486542,Asia,357,0
2020-12-13,Cambodia,KH,2,0,16486542,Asia,359,0
2020-12-14,Cambodia,KH,0,0,16486542,Asia,359,0
2020-05-02,Comoros,KM,1,0,850891,Africa,1,0
2020-05-03,Comoros,KM,0,0,850891,Africa,1,0
2020-05-04,Comoros,KM,2,0,850891,Africa,3,0
2020-05-05,Comoros,KM,1,1,850891,Africa,4,1
2020-05-06,Comoros,KM,0,0,850891,Africa,4,1
2020-05-07,Comoros,KM,4,0,850891,Africa,8,1
2020-05-08,Comoros,KM,0,0,850891,Africa,8,1
2020-05-09,Comoros,KM,0,0,850891,Africa,8,1
2020-05-10,Comoros,KM,3,0,850891,Africa,11,1
2020-05-11,Comoros,KM,0,0,850891,Africa,11,1
2020-05-12,Comoros,KM,0,0,850891,Africa,11,1
2020-05-13,Comoros,KM,0,0,850891,Africa,11,1
2020-05-14,Comoros,KM,0,0,850891,Africa,11,1
2020-05-15,Comoros,KM,0,0,850891,Africa,11,1
2020-05-16,Comoros,KM,0,0,850891,Africa,11,1
2020-05-17,Comoros,KM,0,0,850891,Africa,11,1
2020-05-18,Comoros,KM,0,0,850891,Africa,11,1
2020-05-19,Comoros,KM,0,0,850891,Africa,11,1
2020-05-20,Comoros,KM,23,0,850891,Africa,34,1
2020-05-21,Comoros,KM,0,0,850891,Africa,34,1
2020-05-22,Comoros,KM,0,0,850891,Africa,34,1
2020-05-23,Comoros,KM,44,0,850891,Africa,78,1
2020-05-24,Comoros,KM,0,0,850891,Africa,78,1
2020-05-25,Comoros,KM,9,0,850891,Africa,87,1
2020-05-26,Comoros,KM,0,0,850891,Africa,87,1
2020-05-27,Comoros,KM,0,0,850891,Africa,87,1
2020-05-28,Comoros,KM,0,1,850891,Africa,87,2
2020-05-29,Comoros,KM,0,0,850891,Africa,87,2
2020-05-30,Comoros,KM,0,0,850891,Africa,87,2
2020-05-31,Comoros,KM,19,0,850891,Africa,106,2
2020-06-01,Comoros,KM,0,0,850891,Africa,106,2
2020-06-02,Comoros,KM,0,0,850891,Africa,106,2
2020-06-03,Comoros,KM,26,0,850891,Africa,132,2
2020-06-04,Comoros,KM,0,0,850891,Africa,132,2
2020-06-05,Comoros,KM,0,0,850891,Africa,132,2
2020-06-06,Comoros,KM,0,0,850891,Africa,132,2
2020-06-07,Comoros,KM,9,0,850891,Africa,141,2
2020-06-08,Comoros,KM,0,0,850891,Africa,141,2
2020-06-09,Comoros,KM,0,0,850891,Africa,141,2
2020-06-10,Comoros,KM,21,0,850891,Africa,162,2
2020-06-11,Comoros,KM,0,0,850891,Africa,162,2
2020-06-12,Comoros,KM,0,0,850891,Africa,162,2
2020-06-13,Comoros,KM,0,0,850891,Africa,162,2
2020-06-14,Comoros,KM,14,0,850891,Africa,176,2
2020-06-15,Comoros,KM,0,0,850891,Africa,176,2
2020-06-16,Comoros,KM,0,0,850891,Africa,176,2
2020-06-17,Comoros,KM,21,1,850891,Africa,197,3
2020-06-18,Comoros,KM,0,0,850891,Africa,197,3
2020-06-19,Comoros,KM,13,2,850891,Africa,210,5
2020-06-20,Comoros,KM,0,0,850891,Africa,210,5
2020-06-21,Comoros,KM,37,0,850891,Africa,247,5
2020-06-22,Comoros,KM,0,0,850891,Africa,247,5
2020-06-23,Comoros,KM,0,0,850891,Africa,247,5
2020-06-24,Comoros,KM,0,2,850891,Africa,247,7
2020-06-25,Comoros,KM,0,0,850891,Africa,247,7
2020-06-26,Comoros,KM,0,0,850891,Africa,247,7
2020-06-27,Comoros,KM,0,0,850891,Africa,247,7
2020-06-28,Comoros,KM,0,0,850891,Africa,247,7
2020-06-29,Comoros,KM,25,0,850891,Africa,272,7
2020-06-30,Comoros,KM,0,0,850891,Africa,272,7
2020-07-01,Comoros,KM,31,0,850891,Africa,303,7
2020-07-02,Comoros,KM,0,0,850891,Africa,303,7
2020-07-03,Comoros,KM,0,0,850891,Africa,303,7
2020-07-04,Comoros,KM,6,0,850891,Africa,309,7
2020-07-05,Comoros,KM,0,0,850891,Africa,309,7
2020-07-06,Comoros,KM,2,0,850891,Africa,311,7
2020-07-07,Comoros,KM,0,0,850891,Africa,311,7
2020-07-08,Comoros,KM,2,0,850891,Africa,313,7
2020-07-09,Comoros,KM,0,0,850891,Africa,313,7
2020-07-10,Comoros,KM,0,0,850891,Africa,313,7
2020-07-11,Comoros,KM,0,0,850891,Africa,313,7
2020-07-12,Comoros,KM,4,0,850891,Africa,317,7
2020-07-13,Comoros,KM,0,0,850891,Africa,317,7
2020-07-14,Comoros,KM,0,0,850891,Africa,317,7
2020-07-15,Comoros,KM,0,0,850891,Africa,317,7
2020-07-16,Comoros,KM,4,0,850891,Africa,321,7
2020-07-17,Comoros,KM,7,0,850891,Africa,328,7
2020-07-18,Comoros,KM,0,0,850891,Africa,328,7
2020-07-19,Comoros,KM,0,0,850891,Africa,328,7
2020-07-20,Comoros,KM,6,0,850891,Africa,334,7
2020-07-21,Comoros,KM,0,0,850891,Africa,334,7
2020-07-22,Comoros,KM,3,0,850891,Africa,337,7
2020-07-23,Comoros,KM,0,0,850891,Africa,337,7
2020-07-24,Comoros,KM,3,0,850891,Africa,340,7
2020-07-25,Comoros,KM,0,0,850891,Africa,340,7
2020-07-26,Comoros,KM,0,0,850891,Africa,340,7
2020-07-27,Comoros,KM,0,0,850891,Africa,340,7
2020-07-28,Comoros,KM,0,0,850891,Africa,340,7
2020-07-29,Comoros,KM,0,0,850891,Africa,340,7
2020-07-30,Comoros,KM,38,0,850891,Africa,378,7
2020-07-31,Comoros,KM,0,0,850891,Africa,378,7
2020-08-01,Comoros,KM,4,0,850891,Africa,382,7
2020-08-02,Comoros,KM,4,0,850891,Africa,386,7
2020-08-03,Comoros,KM,0,0,850891,Africa,386,7
2020-08-04,Comoros,KM,0,0,850891,Africa,386,7
2020-08-05,Comoros,KM,2,0,850891,Africa,388,7
2020-08-06,Comoros,KM,0,0,850891,Africa,388,7
2020-08-07,Comoros,KM,8,0,850891,Africa,396,7
2020-08-08,Comoros,KM,0,0,850891,Africa,396,7
2020-08-09,Comoros,KM,3,0,850891,Africa,399,7
2020-08-10,Comoros,KM,0,0,850891,Africa,399,7
2020-08-11,Comoros,KM,0,0,850891,Africa,399,7
2020-08-12,Comoros,KM,0,0,850891,Africa,399,7
2020-08-13,Comoros,KM,0,0,850891,Africa,399,7
2020-08-14,Comoros,KM,0,0,850891,Africa,399,7
2020-08-15,Comoros,KM,0,0,850891,Africa,399,7
2020-08-16,Comoros,KM,4,0,850891,Africa,403,7
2020-08-17,Comoros,KM,2,0,850891,Africa,405,7
2020-08-18,Comoros,KM,0,0,850891,Africa,405,7
2020-08-19,Comoros,KM,0,0,850891,Africa,405,7
2020-08-20,Comoros,KM,0,0,850891,Africa,405,7
2020-08-21,Comoros,KM,1,0,850891,Africa,406,7
2020-08-22,Comoros,KM,0,0,850891,Africa,406,7
2020-08-23,Comoros,KM,0,0,850891,Africa,406,7
2020-08-24,Comoros,KM,11,0,850891,Africa,417,7
2020-08-25,Comoros,KM,0,0,850891,Africa,417,7
2020-08-26,Comoros,KM,0,0,850891,Africa,417,7
2020-08-27,Comoros,KM,0,0,850891,Africa,417,7
2020-08-28,Comoros,KM,0,0,850891,Africa,417,7
2020-08-29,Comoros,KM,0,0,850891,Africa,417,7
2020-08-30,Comoros,KM,5,0,850891,Africa,422,7
2020-08-31,Comoros,KM,1,0,850891,Africa,423,7
2020-09-01,Comoros,KM,0,0,850891,Africa,423,7
2020-09-02,Comoros,KM,0,0,850891,Africa,423,7
2020-09-03,Comoros,KM,4,0,850891,Africa,427,7
2020-09-04,Comoros,KM,21,0,850891,Africa,448,7
2020-09-05,Comoros,KM,0,0,850891,Africa,448,7
2020-09-06,Comoros,KM,0,0,850891,Africa,448,7
2020-09-07,Comoros,KM,4,0,850891,Africa,452,7
2020-09-08,Comoros,KM,0,0,850891,Africa,452,7
2020-09-09,Comoros,KM,0,0,850891,Africa,452,7
2020-09-10,Comoros,KM,4,0,850891,Africa,456,7
2020-09-11,Comoros,KM,0,0,850891,Africa,456,7
2020-09-12,Comoros,KM,0,0,850891,Africa,456,7
2020-09-13,Comoros,KM,0,0,850891,Africa,456,7
2020-09-14,Comoros,KM,0,0,850891,Africa,456,7
2020-09-15,Comoros,KM,0,0,850891,Africa,456,7
2020-09-16,Comoros,KM,1,0,850891,Africa,457,7
2020-09-17,Comoros,KM,0,0,850891,Africa,457,7
2020-09-18,Comoros,KM,10,0,850891,Africa,467,7
2020-09-19,Comoros,KM,3,0,850891,Africa,470,7
2020-09-20,Comoros,KM,0,0,850891,Africa,470,7
2020-09-21,Comoros,KM,0,0,850891,Africa,470,7
2020-09-22,Comoros,KM,0,0,850891,Africa,470,7
2020-09-23,Comoros,KM,0,0,850891,Africa,470,7
2020-09-24,Comoros,KM,0,0,850891,Africa,470,7
2020-09-25,Comoros,KM,4,0,850891,Africa,474,7
2020-09-26,Comoros,KM,0,0,850891,Africa,474,7
2020-09-27,Comoros,KM,4,0,850891,Africa,478,7
2020-09-28,Comoros,KM,0,0,850891,Africa,478,7
2020-09-29,Comoros,KM,0,0,850891,Africa,478,7
2020-09-30,Comoros,KM,1,0,850891,Africa,479,7
2020-10-01,Comoros,KM,0,0,850891,Africa,479,7
2020-10-02,Comoros,KM,5,0,850891,Africa,484,7
2020-10-03,Comoros,KM,0,0,850891,Africa,484,7
2020-10-04,Comoros,KM,3,0,850891,Africa,487,7
2020-10-05,Comoros,KM,0,0,850891,Africa,487,7
2020-10-06,Comoros,KM,0,0,850891,Africa,487,7
2020-10-07,Comoros,KM,4,0,850891,Africa,491,7
2020-10-08,Comoros,KM,0,0,850891,Africa,491,7
2020-10-09,Comoros,KM,4,0,850891,Africa,495,7
2020-10-10,Comoros,KM,0,0,850891,Africa,495,7
2020-10-11,Comoros,KM,0,0,850891,Africa,495,7
2020-10-12,Comoros,KM,0,0,850891,Africa,495,7
2020-10-13,Comoros,KM,0,0,850891,Africa,495,7
2020-10-14,Comoros,KM,1,0,850891,Africa,496,7
2020-10-15,Comoros,KM,0,0,850891,Africa,496,7
2020-10-16,Comoros,KM,0,0,850891,Africa,496,7
2020-10-17,Comoros,KM,6,0,850891,Africa,502,7
2020-10-18,Comoros,KM,0,0,850891,Africa,502,7
2020-10-19,Comoros,KM,0,0,850891,Africa,502,7
2020-10-20,Comoros,KM,0,0,850891,Africa,502,7
2020-10-21,Comoros,KM,2,0,850891,Africa,504,7
2020-10-22,Comoros,KM,0,0,850891,Africa,504,7
2020-10-23,Comoros,KM,13,0,850891,Africa,517,7
2020-10-24,Comoros,KM,0,0,850891,Africa,517,7
2020-10-25,Comoros,KM,0,0,850891,Africa,517,7
2020-10-26,Comoros,KM,0,0,850891,Africa,517,7
2020-10-27,Comoros,KM,0,0,850891,Africa,517,7
2020-10-28,Comoros,KM,0,0,850891,Africa,517,7
2020-10-29,Comoros,KM,8,0,850891,Africa,525,7
2020-10-30,Comoros,KM,5,0,850891,Africa,530,7
2020-10-31,Comoros,KM,7,0,850891,Africa,537,7
2020-11-01,Comoros,KM,8,0,850891,Africa,545,7
2020-11-02,Comoros,KM,0,0,850891,Africa,545,7
2020-11-03,Comoros,KM,0,0,850891,Africa,545,7
2020-11-04,Comoros,KM,9,0,850891,Africa,554,7
2020-11-05,Comoros,KM,0,0,850891,Africa,554,7
2020-11-06,Comoros,KM,3,0,850891,Africa,557,7
2020-11-07,Comoros,KM,0,0,850891,Africa,557,7
2020-11-08,Comoros,KM,6,0,850891,Africa,563,7
2020-11-09,Comoros,KM,0,0,850891,Africa,563,7
2020-11-10,Comoros,KM,0,0,850891,Africa,563,7
2020-11-11,Comoros,KM,6,0,850891,Africa,569,7
2020-11-12,Comoros,KM,0,0,850891,Africa,569,7
2020-11-13,Comoros,KM,5,0,850891,Africa,574,7
2020-11-14,Comoros,KM,0,0,850891,Africa,574,7
2020-11-15,Comoros,KM,5,0,850891,Africa,579,7
2020-11-16,Comoros,KM,0,0,850891,Africa,579,7
2020-11-17,Comoros,KM,0,0,850891,Africa,579,7
2020-11-18,Comoros,KM,12,0,850891,Africa,591,7
2020-11-19,Comoros,KM,0,0,850891,Africa,591,7
2020-11-20,Comoros,KM,1,0,850891,Africa,592,7
2020-11-21,Comoros,KM,0,0,850891,Africa,592,7
2020-11-22,Comoros,KM,4,0,850891,Africa,596,7
2020-11-23,Comoros,KM,0,0,850891,Africa,596,7
2020-11-24,Comoros,KM,0,0,850891,Africa,596,7
2020-11-25,Comoros,KM,11,0,850891,Africa,607,7
2020-11-26,Comoros,KM,0,0,850891,Africa,607,7
2020-11-27,Comoros,KM,3,0,850891,Africa,610,7
2020-11-28,Comoros,KM,0,0,850891,Africa,610,7
2020-11-29,Comoros,KM,1,0,850891,Africa,611,7
2020-11-30,Comoros,KM,0,0,850891,Africa,611,7
2020-12-01,Comoros,KM,0,0,850891,Africa,611,7
2020-12-02,Comoros,KM,2,0,850891,Africa,613,7
2020-12-03,Comoros,KM,0,0,850891,Africa,613,7
2020-12-04,Comoros,KM,2,0,850891,Africa,615,7
2020-12-05,Comoros,KM,0,0,850891,Africa,615,7
2020-12-06,Comoros,KM,1,0,850891,Africa,616,7
2020-12-07,Comoros,KM,0,0,850891,Africa,616,7
2020-12-08,Comoros,KM,0,0,850891,Africa,616,7
2020-12-09,Comoros,KM,1,0,850891,Africa,617,7
2020-12-10,Comoros,KM,0,0,850891,Africa,617,7
2020-12-11,Comoros,KM,0,0,850891,Africa,617,7
2020-12-12,Comoros,KM,0,0,850891,Africa,617,7
2020-12-13,Comoros,KM,11,0,850891,Africa,628,7
2020-12-14,Comoros,KM,0,0,850891,Africa,628,7
2020-03-26,Saint_Kitts_and_Nevis,KN,2,0,52834,America,2,0
2020-03-27,Saint_Kitts_and_Nevis,KN,0,0,52834,America,2,0
2020-03-28,Saint_Kitts_and_Nevis,KN,0,0,52834,America,2,0
2020-03-29,Saint_Kitts_and_Nevis,KN,0,0,52834,America,2,0
2020-03-30,Saint_Kitts_and_Nevis,KN,5,0,52834,America,7,0
2020-03-31,Saint_Kitts_and_Nevis,KN,0,0,52834,America,7,0
2020-04-01,Saint_Kitts_and_Nevis,KN,1,0,52834,America,8,0
2020-04-02,Saint_Kitts_and_Nevis,KN,0,0,52834,America,8,0
2020-04-03,Saint_Kitts_and_Nevis,KN,0,0,52834,America,8,0
2020-04-04,Saint_Kitts_and_Nevis,KN,1,0,52834,America,9,0
2020-04-05,Saint_Kitts_and_Nevis,KN,1,0,52834,America,10,0
2020-04-06,Saint_Kitts_and_Nevis,KN,0,0,52834,America,10,0
2020-04-07,Saint_Kitts_and_Nevis,KN,1,0,52834,America,11,0
2020-04-08,Saint_Kitts_and_Nevis,KN,0,0,52834,America,11,0
2020-04-09,Saint_Kitts_and_Nevis,KN,0,0,52834,America,11,0
2020-04-10,Saint_Kitts_and_Nevis,KN,0,0,52834,America,11,0
2020-04-11,Saint_Kitts_and_Nevis,KN,1,0,52834,America,12,0
2020-04-12,Saint_Kitts_and_Nevis,KN,0,0,52834,America,12,0
2020-04-13,Saint_Kitts_and_Nevis,KN,0,0,52834,America,12,0
2020-04-14,Saint_Kitts_and_Nevis,KN,0,0,52834,America,12,0
2020-04-15,Saint_Kitts_and_Nevis,KN,2,0,52834,America,14,0
2020-04-16,Saint_Kitts_and_Nevis,KN,0,0,52834,America,14,0
2020-04-17,Saint_Kitts_and_Nevis,KN,0,0,52834,America,14,0
2020-04-18,Saint_Kitts_and_Nevis,KN,0,0,52834,America,14,0
2020-04-19,Saint_Kitts_and_Nevis,KN,0,0,52834,America,14,0
2020-04-20,Saint_Kitts_and_Nevis,KN,1,0,52834,America,15,0
2020-04-21,Saint_Kitts_and_Nevis,KN,0,0,52834,America,15,0
2020-04-22,Saint_Kitts_and_Nevis,KN,0,0,52834,America,15,0
2020-04-23,Saint_Kitts_and_Nevis,KN,0,0,52834,America,15,0
2020-04-24,Saint_Kitts_and_Nevis,KN,0,0,52834,America,15,0
2020-04-25,Saint_Kitts_and_Nevis,KN,0,0,52834,America,15,0
2020-04-26,Saint_Kitts_and_Nevis,KN,0,0,52834,America,15,0
2020-04-27,Saint_Kitts_and_Nevis,KN,0,0,52834,America,15,0
2020-04-28,Saint_Kitts_and_Nevis,KN,0,0,52834,America,15,0
2020-04-29,Saint_Kitts_and_Nevis,KN,0,0,52834,America,15,0
2020-04-30,Saint_Kitts_and_Nevis,KN,0,0,52834,America,15,0
2020-05-01,Saint_Kitts_and_Nevis,KN,0,0,52834,America,15,0
2020-05-02,Saint_Kitts_and_Nevis,KN,0,0,52834,America,15,0
2020-05-03,Saint_Kitts_and_Nevis,KN,0,0,52834,America,15,0
2020-05-04,Saint_Kitts_and_Nevis,KN,0,0,52834,America,15,0
2020-05-05,Saint_Kitts_and_Nevis,KN,0,0,52834,America,15,0
2020-05-06,Saint_Kitts_and_Nevis,KN,0,0,52834,America,15,0
2020-05-07,Saint_Kitts_and_Nevis,KN,0,0,52834,America,15,0
2020-05-08,Saint_Kitts_and_Nevis,KN,0,0,52834,America,15,0
2020-05-09,Saint_Kitts_and_Nevis,KN,0,0,52834,America,15,0
2020-05-10,Saint_Kitts_and_Nevis,KN,0,0,52834,America,15,0
2020-05-11,Saint_Kitts_and_Nevis,KN,0,0,52834,America,15,0
2020-05-12,Saint_Kitts_and_Nevis,KN,0,0,52834,America,15,0
2020-05-13,Saint_Kitts_and_Nevis,KN,0,0,52834,America,15,0
2020-05-14,Saint_Kitts_and_Nevis,KN,0,0,52834,America,15,0
2020-05-15,Saint_Kitts_and_Nevis,KN,0,0,52834,America,15,0
2020-05-16,Saint_Kitts_and_Nevis,KN,0,0,52834,America,15,0
2020-05-17,Saint_Kitts_and_Nevis,KN,0,0,52834,America,15,0
2020-05-18,Saint_Kitts_and_Nevis,KN,0,0,52834,America,15,0
2020-05-19,Saint_Kitts_and_Nevis,KN,0,0,52834,America,15,0
2020-05-20,Saint_Kitts_and_Nevis,KN,0,0,52834,America,15,0
2020-05-21,Saint_Kitts_and_Nevis,KN,0,0,52834,America,15,0
2020-05-22,Saint_Kitts_and_Nevis,KN,0,0,52834,America,15,0
2020-05-23,Saint_Kitts_and_Nevis,KN,0,0,52834,America,15,0
2020-05-24,Saint_Kitts_and_Nevis,KN,0,0,52834,America,15,0
2020-05-25,Saint_Kitts_and_Nevis,KN,0,0,52834,America,15,0
2020-05-26,Saint_Kitts_and_Nevis,KN,0,0,52834,America,15,0
2020-05-27,Saint_Kitts_and_Nevis,KN,0,0,52834,America,15,0
2020-05-28,Saint_Kitts_and_Nevis,KN,0,0,52834,America,15,0
2020-05-29,Saint_Kitts_and_Nevis,KN,0,0,52834,America,15,0
2020-05-30,Saint_Kitts_and_Nevis,KN,0,0,52834,America,15,0
2020-05-31,Saint_Kitts_and_Nevis,KN,0,0,52834,America,15,0
2020-06-01,Saint_Kitts_and_Nevis,KN,0,0,52834,America,15,0
2020-06-02,Saint_Kitts_and_Nevis,KN,0,0,52834,America,15,0
2020-06-03,Saint_Kitts_and_Nevis,KN,0,0,52834,America,15,0
2020-06-04,Saint_Kitts_and_Nevis,KN,0,0,52834,America,15,0
2020-06-05,Saint_Kitts_and_Nevis,KN,0,0,52834,America,15,0
2020-06-06,Saint_Kitts_and_Nevis,KN,0,0,52834,America,15,0
2020-06-07,Saint_Kitts_and_Nevis,KN,0,0,52834,America,15,0
2020-06-08,Saint_Kitts_and_Nevis,KN,0,0,52834,America,15,0
2020-06-09,Saint_Kitts_and_Nevis,KN,0,0,52834,America,15,0
2020-06-10,Saint_Kitts_and_Nevis,KN,0,0,52834,America,15,0
2020-06-11,Saint_Kitts_and_Nevis,KN,0,0,52834,America,15,0
2020-06-12,Saint_Kitts_and_Nevis,KN,0,0,52834,America,15,0
2020-06-13,Saint_Kitts_and_Nevis,KN,0,0,52834,America,15,0
2020-06-14,Saint_Kitts_and_Nevis,KN,0,0,52834,America,15,0
2020-06-15,Saint_Kitts_and_Nevis,KN,0,0,52834,America,15,0
2020-06-16,Saint_Kitts_and_Nevis,KN,0,0,52834,America,15,0
2020-06-17,Saint_Kitts_and_Nevis,KN,0,0,52834,America,15,0
2020-06-18,Saint_Kitts_and_Nevis,KN,0,0,52834,America,15,0
2020-06-19,Saint_Kitts_and_Nevis,KN,0,0,52834,America,15,0
2020-06-20,Saint_Kitts_and_Nevis,KN,0,0,52834,America,15,0
2020-06-21,Saint_Kitts_and_Nevis,KN,0,0,52834,America,15,0
2020-06-22,Saint_Kitts_and_Nevis,KN,0,0,52834,America,15,0
2020-06-23,Saint_Kitts_and_Nevis,KN,0,0,52834,America,15,0
2020-06-24,Saint_Kitts_and_Nevis,KN,0,0,52834,America,15,0
2020-06-25,Saint_Kitts_and_Nevis,KN,0,0,52834,America,15,0
2020-06-26,Saint_Kitts_and_Nevis,KN,0,0,52834,America,15,0
2020-06-27,Saint_Kitts_and_Nevis,KN,0,0,52834,America,15,0
2020-06-28,Saint_Kitts_and_Nevis,KN,0,0,52834,America,15,0
2020-06-29,Saint_Kitts_and_Nevis,KN,0,0,52834,America,15,0
2020-06-30,Saint_Kitts_and_Nevis,KN,0,0,52834,America,15,0
2020-07-01,Saint_Kitts_and_Nevis,KN,0,0,52834,America,15,0
2020-07-02,Saint_Kitts_and_Nevis,KN,0,0,52834,America,15,0
2020-07-03,Saint_Kitts_and_Nevis,KN,0,0,52834,America,15,0
2020-07-04,Saint_Kitts_and_Nevis,KN,0,0,52834,America,15,0
2020-07-05,Saint_Kitts_and_Nevis,KN,1,0,52834,America,16,0
2020-07-06,Saint_Kitts_and_Nevis,KN,0,0,52834,America,16,0
2020-07-07,Saint_Kitts_and_Nevis,KN,0,0,52834,America,16,0
2020-07-08,Saint_Kitts_and_Nevis,KN,0,0,52834,America,16,0
2020-07-09,Saint_Kitts_and_Nevis,KN,0,0,52834,America,16,0
2020-07-10,Saint_Kitts_and_Nevis,KN,0,0,52834,America,16,0
2020-07-11,Saint_Kitts_and_Nevis,KN,1,0,52834,America,17,0
2020-07-12,Saint_Kitts_and_Nevis,KN,0,0,52834,America,17,0
2020-07-13,Saint_Kitts_and_Nevis,KN,0,0,52834,America,17,0
2020-07-14,Saint_Kitts_and_Nevis,KN,0,0,52834,America,17,0
2020-07-15,Saint_Kitts_and_Nevis,KN,0,0,52834,America,17,0
2020-07-16,Saint_Kitts_and_Nevis,KN,0,0,52834,America,17,0
2020-07-17,Saint_Kitts_and_Nevis,KN,0,0,52834,America,17,0
2020-07-18,Saint_Kitts_and_Nevis,KN,0,0,52834,America,17,0
2020-07-19,Saint_Kitts_and_Nevis,KN,0,0,52834,America,17,0
2020-07-20,Saint_Kitts_and_Nevis,KN,0,0,52834,America,17,0
2020-07-21,Saint_Kitts_and_Nevis,KN,0,0,52834,America,17,0
2020-07-22,Saint_Kitts_and_Nevis,KN,0,0,52834,America,17,0
2020-07-23,Saint_Kitts_and_Nevis,KN,0,0,52834,America,17,0
2020-07-24,Saint_Kitts_and_Nevis,KN,0,0,52834,America,17,0
2020-07-25,Saint_Kitts_and_Nevis,KN,0,0,52834,America,17,0
2020-07-26,Saint_Kitts_and_Nevis,KN,0,0,52834,America,17,0
2020-07-27,Saint_Kitts_and_Nevis,KN,0,0,52834,America,17,0
2020-07-28,Saint_Kitts_and_Nevis,KN,0,0,52834,America,17,0
2020-07-29,Saint_Kitts_and_Nevis,KN,0,0,52834,America,17,0
2020-07-30,Saint_Kitts_and_Nevis,KN,0,0,52834,America,17,0
2020-07-31,Saint_Kitts_and_Nevis,KN,0,0,52834,America,17,0
2020-08-01,Saint_Kitts_and_Nevis,KN,0,0,52834,America,17,0
2020-08-02,Saint_Kitts_and_Nevis,KN,0,0,52834,America,17,0
2020-08-03,Saint_Kitts_and_Nevis,KN,0,0,52834,America,17,0
2020-08-04,Saint_Kitts_and_Nevis,KN,0,0,52834,America,17,0
2020-08-05,Saint_Kitts_and_Nevis,KN,0,0,52834,America,17,0
2020-08-06,Saint_Kitts_and_Nevis,KN,0,0,52834,America,17,0
2020-08-07,Saint_Kitts_and_Nevis,KN,0,0,52834,America,17,0
2020-08-08,Saint_Kitts_and_Nevis,KN,0,0,52834,America,17,0
2020-08-09,Saint_Kitts_and_Nevis,KN,0,0,52834,America,17,0
2020-08-10,Saint_Kitts_and_Nevis,KN,0,0,52834,America,17,0
2020-08-11,Saint_Kitts_and_Nevis,KN,0,0,52834,America,17,0
2020-08-12,Saint_Kitts_and_Nevis,KN,0,0,52834,America,17,0
2020-08-13,Saint_Kitts_and_Nevis,KN,0,0,52834,America,17,0
2020-08-14,Saint_Kitts_and_Nevis,KN,0,0,52834,America,17,0
2020-08-15,Saint_Kitts_and_Nevis,KN,0,0,52834,America,17,0
2020-08-16,Saint_Kitts_and_Nevis,KN,0,0,52834,America,17,0
2020-08-17,Saint_Kitts_and_Nevis,KN,0,0,52834,America,17,0
2020-08-18,Saint_Kitts_and_Nevis,KN,0,0,52834,America,17,0
2020-08-19,Saint_Kitts_and_Nevis,KN,0,0,52834,America,17,0
2020-08-20,Saint_Kitts_and_Nevis,KN,0,0,52834,America,17,0
2020-08-21,Saint_Kitts_and_Nevis,KN,0,0,52834,America,17,0
2020-08-22,Saint_Kitts_and_Nevis,KN,0,0,52834,America,17,0
2020-08-23,Saint_Kitts_and_Nevis,KN,0,0,52834,America,17,0
2020-08-24,Saint_Kitts_and_Nevis,KN,0,0,52834,America,17,0
2020-08-25,Saint_Kitts_and_Nevis,KN,0,0,52834,America,17,0
2020-08-26,Saint_Kitts_and_Nevis,KN,0,0,52834,America,17,0
2020-08-27,Saint_Kitts_and_Nevis,KN,0,0,52834,America,17,0
2020-08-28,Saint_Kitts_and_Nevis,KN,0,0,52834,America,17,0
2020-08-29,Saint_Kitts_and_Nevis,KN,0,0,52834,America,17,0
2020-08-30,Saint_Kitts_and_Nevis,KN,0,0,52834,America,17,0
2020-08-31,Saint_Kitts_and_Nevis,KN,0,0,52834,America,17,0
2020-09-01,Saint_Kitts_and_Nevis,KN,0,0,52834,America,17,0
2020-09-02,Saint_Kitts_and_Nevis,KN,0,0,52834,America,17,0
2020-09-03,Saint_Kitts_and_Nevis,KN,0,0,52834,America,17,0
2020-09-04,Saint_Kitts_and_Nevis,KN,0,0,52834,America,17,0
2020-09-05,Saint_Kitts_and_Nevis,KN,0,0,52834,America,17,0
2020-09-06,Saint_Kitts_and_Nevis,KN,0,0,52834,America,17,0
2020-09-07,Saint_Kitts_and_Nevis,KN,0,0,52834,America,17,0
2020-09-08,Saint_Kitts_and_Nevis,KN,0,0,52834,America,17,0
2020-09-09,Saint_Kitts_and_Nevis,KN,0,0,52834,America,17,0
2020-09-10,Saint_Kitts_and_Nevis,KN,0,0,52834,America,17,0
2020-09-11,Saint_Kitts_and_Nevis,KN,0,0,52834,America,17,0
2020-09-12,Saint_Kitts_and_Nevis,KN,0,0,52834,America,17,0
2020-09-13,Saint_Kitts_and_Nevis,KN,0,0,52834,America,17,0
2020-09-14,Saint_Kitts_and_Nevis,KN,0,0,52834,America,17,0
2020-09-15,Saint_Kitts_and_Nevis,KN,0,0,52834,America,17,0
2020-09-16,Saint_Kitts_and_Nevis,KN,0,0,52834,America,17,0
2020-09-17,Saint_Kitts_and_Nevis,KN,0,0,52834,America,17,0
2020-09-18,Saint_Kitts_and_Nevis,KN,0,0,52834,America,17,0
2020-09-19,Saint_Kitts_and_Nevis,KN,0,0,52834,America,17,0
2020-09-20,Saint_Kitts_and_Nevis,KN,0,0,52834,America,17,0
2020-09-21,Saint_Kitts_and_Nevis,KN,0,0,52834,America,17,0
2020-09-22,Saint_Kitts_and_Nevis,KN,2,0,52834,America,19,0
2020-09-23,Saint_Kitts_and_Nevis,KN,0,0,52834,America,19,0
2020-09-24,Saint_Kitts_and_Nevis,KN,0,0,52834,America,19,0
2020-09-25,Saint_Kitts_and_Nevis,KN,0,0,52834,America,19,0
2020-09-26,Saint_Kitts_and_Nevis,KN,0,0,52834,America,19,0
2020-09-27,Saint_Kitts_and_Nevis,KN,0,0,52834,America,19,0
2020-09-28,Saint_Kitts_and_Nevis,KN,0,0,52834,America,19,0
2020-09-29,Saint_Kitts_and_Nevis,KN,0,0,52834,America,19,0
2020-09-30,Saint_Kitts_and_Nevis,KN,0,0,52834,America,19,0
2020-10-01,Saint_Kitts_and_Nevis,KN,0,0,52834,America,19,0
2020-10-02,Saint_Kitts_and_Nevis,KN,0,0,52834,America,19,0
2020-10-03,Saint_Kitts_and_Nevis,KN,0,0,52834,America,19,0
2020-10-04,Saint_Kitts_and_Nevis,KN,0,0,52834,America,19,0
2020-10-05,Saint_Kitts_and_Nevis,KN,0,0,52834,America,19,0
2020-10-06,Saint_Kitts_and_Nevis,KN,0,0,52834,America,19,0
2020-10-07,Saint_Kitts_and_Nevis,KN,0,0,52834,America,19,0
2020-10-08,Saint_Kitts_and_Nevis,KN,0,0,52834,America,19,0
2020-10-09,Saint_Kitts_and_Nevis,KN,0,0,52834,America,19,0
2020-10-10,Saint_Kitts_and_Nevis,KN,0,0,52834,America,19,0
2020-10-11,Saint_Kitts_and_Nevis,KN,0,0,52834,America,19,0
2020-10-12,Saint_Kitts_and_Nevis,KN,0,0,52834,America,19,0
2020-10-13,Saint_Kitts_and_Nevis,KN,0,0,52834,America,19,0
2020-10-14,Saint_Kitts_and_Nevis,KN,0,0,52834,America,19,0
2020-10-15,Saint_Kitts_and_Nevis,KN,0,0,52834,America,19,0
2020-10-16,Saint_Kitts_and_Nevis,KN,0,0,52834,America,19,0
2020-10-17,Saint_Kitts_and_Nevis,KN,0,0,52834,America,19,0
2020-10-18,Saint_Kitts_and_Nevis,KN,0,0,52834,America,19,0
2020-10-19,Saint_Kitts_and_Nevis,KN,0,0,52834,America,19,0
2020-10-20,Saint_Kitts_and_Nevis,KN,0,0,52834,America,19,0
2020-10-21,Saint_Kitts_and_Nevis,KN,0,0,52834,America,19,0
2020-10-22,Saint_Kitts_and_Nevis,KN,0,0,52834,America,19,0
2020-10-23,Saint_Kitts_and_Nevis,KN,0,0,52834,America,19,0
2020-10-24,Saint_Kitts_and_Nevis,KN,0,0,52834,America,19,0
2020-10-25,Saint_Kitts_and_Nevis,KN,0,0,52834,America,19,0
2020-10-26,Saint_Kitts_and_Nevis,KN,0,0,52834,America,19,0
2020-10-27,Saint_Kitts_and_Nevis,KN,0,0,52834,America,19,0
2020-10-28,Saint_Kitts_and_Nevis,KN,0,0,52834,America,19,0
2020-10-29,Saint_Kitts_and_Nevis,KN,0,0,52834,America,19,0
2020-10-30,Saint_Kitts_and_Nevis,KN,0,0,52834,America,19,0
2020-10-31,Saint_Kitts_and_Nevis,KN,0,0,52834,America,19,0
2020-11-01,Saint_Kitts_and_Nevis,KN,0,0,52834,America,19,0
2020-11-02,Saint_Kitts_and_Nevis,KN,0,0,52834,America,19,0
2020-11-03,Saint_Kitts_and_Nevis,KN,0,0,52834,America,19,0
2020-11-04,Saint_Kitts_and_Nevis,KN,0,0,52834,America,19,0
2020-11-05,Saint_Kitts_and_Nevis,KN,0,0,52834,America,19,0
2020-11-06,Saint_Kitts_and_Nevis,KN,0,0,52834,America,19,0
2020-11-07,Saint_Kitts_and_Nevis,KN,0,0,52834,America,19,0
2020-11-08,Saint_Kitts_and_Nevis,KN,0,0,52834,America,19,0
2020-11-09,Saint_Kitts_and_Nevis,KN,0,0,52834,America,19,0
2020-11-10,Saint_Kitts_and_Nevis,KN,0,0,52834,America,19,0
2020-11-11,Saint_Kitts_and_Nevis,KN,0,0,52834,America,19,0
2020-11-12,Saint_Kitts_and_Nevis,KN,0,0,52834,America,19,0
2020-11-13,Saint_Kitts_and_Nevis,KN,0,0,52834,America,19,0
2020-11-14,Saint_Kitts_and_Nevis,KN,0,0,52834,America,19,0
2020-11-15,Saint_Kitts_and_Nevis,KN,0,0,52834,America,19,0
2020-11-16,Saint_Kitts_and_Nevis,KN,0,0,52834,America,19,0
2020-11-17,Saint_Kitts_and_Nevis,KN,0,0,52834,America,19,0
2020-11-18,Saint_Kitts_and_Nevis,KN,0,0,52834,America,19,0
2020-11-19,Saint_Kitts_and_Nevis,KN,0,0,52834,America,19,0
2020-11-20,Saint_Kitts_and_Nevis,KN,0,0,52834,America,19,0
2020-11-21,Saint_Kitts_and_Nevis,KN,0,0,52834,America,19,0
2020-11-22,Saint_Kitts_and_Nevis,KN,0,0,52834,America,19,0
2020-11-23,Saint_Kitts_and_Nevis,KN,1,0,52834,America,20,0
2020-11-24,Saint_Kitts_and_Nevis,KN,0,0,52834,America,20,0
2020-11-25,Saint_Kitts_and_Nevis,KN,0,0,52834,America,20,0
2020-11-26,Saint_Kitts_and_Nevis,KN,2,0,52834,America,22,0
2020-11-27,Saint_Kitts_and_Nevis,KN,0,0,52834,America,22,0
2020-11-28,Saint_Kitts_and_Nevis,KN,0,0,52834,America,22,0
2020-11-29,Saint_Kitts_and_Nevis,KN,0,0,52834,America,22,0
2020-11-30,Saint_Kitts_and_Nevis,KN,0,0,52834,America,22,0
2020-12-01,Saint_Kitts_and_Nevis,KN,0,0,52834,America,22,0
2020-12-02,Saint_Kitts_and_Nevis,KN,0,0,52834,America,22,0
2020-12-03,Saint_Kitts_and_Nevis,KN,0,0,52834,America,22,0
2020-12-04,Saint_Kitts_and_Nevis,KN,0,0,52834,America,22,0
2020-12-05,Saint_Kitts_and_Nevis,KN,0,0,52834,America,22,0
2020-12-06,Saint_Kitts_and_Nevis,KN,3,0,52834,America,25,0
2020-12-07,Saint_Kitts_and_Nevis,KN,0,0,52834,America,25,0
2020-12-08,Saint_Kitts_and_Nevis,KN,0,0,52834,America,25,0
2020-12-09,Saint_Kitts_and_Nevis,KN,0,0,52834,America,25,0
2020-12-10,Saint_Kitts_and_Nevis,KN,0,0,52834,America,25,0
2020-12-11,Saint_Kitts_and_Nevis,KN,1,0,52834,America,26,0
2020-12-12,Saint_Kitts_and_Nevis,KN,1,0,52834,America,27,0
2020-12-13,Saint_Kitts_and_Nevis,KN,0,0,52834,America,27,0
2020-12-14,Saint_Kitts_and_Nevis,KN,0,0,52834,America,27,0
2019-12-31,South_Korea,KR,0,0,51225321,Asia,0,0
2020-01-01,South_Korea,KR,0,0,51225321,Asia,0,0
2020-01-02,South_Korea,KR,0,0,51225321,Asia,0,0
2020-01-03,South_Korea,KR,0,0,51225321,Asia,0,0
2020-01-04,South_Korea,KR,0,0,51225321,Asia,0,0
2020-01-05,South_Korea,KR,0,0,51225321,Asia,0,0
2020-01-06,South_Korea,KR,0,0,51225321,Asia,0,0
2020-01-07,South_Korea,KR,0,0,51225321,Asia,0,0
2020-01-08,South_Korea,KR,0,0,51225321,Asia,0,0
2020-01-09,South_Korea,KR,0,0,51225321,Asia,0,0
2020-01-10,South_Korea,KR,0,0,51225321,Asia,0,0
2020-01-11,South_Korea,KR,0,0,51225321,Asia,0,0
2020-01-12,South_Korea,KR,0,0,51225321,Asia,0,0
2020-01-13,South_Korea,KR,0,0,51225321,Asia,0,0
2020-01-14,South_Korea,KR,0,0,51225321,Asia,0,0
2020-01-15,South_Korea,KR,0,0,51225321,Asia,0,0
2020-01-16,South_Korea,KR,0,0,51225321,Asia,0,0
2020-01-17,South_Korea,KR,0,0,51225321,Asia,0,0
2020-01-18,South_Korea,KR,0,0,51225321,Asia,0,0
2020-01-19,South_Korea,KR,0,0,51225321,Asia,0,0
2020-01-20,South_Korea,KR,1,0,51225321,Asia,1,0
2020-01-21,South_Korea,KR,0,0,51225321,Asia,1,0
2020-01-22,South_Korea,KR,0,0,51225321,Asia,1,0
2020-01-23,South_Korea,KR,0,0,51225321,Asia,1,0
2020-01-24,South_Korea,KR,1,0,51225321,Asia,2,0
2020-01-25,South_Korea,KR,0,0,51225321,Asia,2,0
2020-01-26,South_Korea,KR,1,0,51225321,Asia,3,0
2020-01-27,South_Korea,KR,1,0,51225321,Asia,4,0
2020-01-28,South_Korea,KR,0,0,51225321,Asia,4,0
2020-01-29,South_Korea,KR,0,0,51225321,Asia,4,0
2020-01-30,South_Korea,KR,0,0,51225321,Asia,4,0
2020-01-31,South_Korea,KR,3,0,51225321,Asia,7,0
2020-02-01,South_Korea,KR,5,0,51225321,Asia,12,0
2020-02-02,South_Korea,KR,3,0,51225321,Asia,15,0
2020-02-03,South_Korea,KR,0,0,51225321,Asia,15,0
2020-02-04,South_Korea,KR,1,0,51225321,Asia,16,0
2020-02-05,South_Korea,KR,2,0,51225321,Asia,18,0
2020-02-06,South_Korea,KR,5,0,51225321,Asia,23,0
2020-02-07,South_Korea,KR,1,0,51225321,Asia,24,0
2020-02-08,South_Korea,KR,0,0,51225321,Asia,24,0
2020-02-09,South_Korea,KR,1,0,51225321,Asia,25,0
2020-02-10,South_Korea,KR,2,0,51225321,Asia,27,0
2020-02-11,South_Korea,KR,1,0,51225321,Asia,28,0
2020-02-12,South_Korea,KR,0,0,51225321,Asia,28,0
2020-02-13,South_Korea,KR,0,0,51225321,Asia,28,0
2020-02-14,South_Korea,KR,0,0,51225321,Asia,28,0
2020-02-15,South_Korea,KR,0,0,51225321,Asia,28,0
2020-02-16,South_Korea,KR,1,0,51225321,Asia,29,0
2020-02-17,South_Korea,KR,1,0,51225321,Asia,30,0
2020-02-18,South_Korea,KR,1,0,51225321,Asia,31,0
2020-02-19,South_Korea,KR,15,0,51225321,Asia,46,0
2020-02-20,South_Korea,KR,34,0,51225321,Asia,80,0
2020-02-21,South_Korea,KR,75,1,51225321,Asia,155,1
2020-02-22,South_Korea,KR,190,1,51225321,Asia,345,2
2020-02-23,South_Korea,KR,256,3,51225321,Asia,601,5
2020-02-24,South_Korea,KR,161,2,51225321,Asia,762,7
2020-02-25,South_Korea,KR,130,1,51225321,Asia,892,8
2020-02-26,South_Korea,KR,254,3,51225321,Asia,1146,11
2020-02-27,South_Korea,KR,449,1,51225321,Asia,1595,12
2020-02-28,South_Korea,KR,427,1,51225321,Asia,2022,13
2020-02-29,South_Korea,KR,909,3,51225321,Asia,2931,16
2020-03-01,South_Korea,KR,595,1,51225321,Asia,3526,17
2020-03-02,South_Korea,KR,686,5,51225321,Asia,4212,22
2020-03-03,South_Korea,KR,600,6,51225321,Asia,4812,28
2020-03-04,South_Korea,KR,516,4,51225321,Asia,5328,32
2020-03-05,South_Korea,KR,438,3,51225321,Asia,5766,35
2020-03-06,South_Korea,KR,518,7,51225321,Asia,6284,42
2020-03-07,South_Korea,KR,483,2,51225321,Asia,6767,44
2020-03-08,South_Korea,KR,367,6,51225321,Asia,7134,50
2020-03-09,South_Korea,KR,248,1,51225321,Asia,7382,51
2020-03-10,South_Korea,KR,131,3,51225321,Asia,7513,54
2020-03-11,South_Korea,KR,242,6,51225321,Asia,7755,60
2020-03-12,South_Korea,KR,114,6,51225321,Asia,7869,66
2020-03-13,South_Korea,KR,110,1,51225321,Asia,7979,67
2020-03-14,South_Korea,KR,107,5,51225321,Asia,8086,72
2020-03-15,South_Korea,KR,76,3,51225321,Asia,8162,75
2020-03-16,South_Korea,KR,74,0,51225321,Asia,8236,75
2020-03-17,South_Korea,KR,84,6,51225321,Asia,8320,81
2020-03-18,South_Korea,KR,93,5,51225321,Asia,8413,86
2020-03-19,South_Korea,KR,152,5,51225321,Asia,8565,91
2020-03-20,South_Korea,KR,87,9,51225321,Asia,8652,100
2020-03-21,South_Korea,KR,147,3,51225321,Asia,8799,103
2020-03-22,South_Korea,KR,98,1,51225321,Asia,8897,104
2020-03-23,South_Korea,KR,64,9,51225321,Asia,8961,113
2020-03-24,South_Korea,KR,76,7,51225321,Asia,9037,120
2020-03-25,South_Korea,KR,100,6,51225321,Asia,9137,126
2020-03-26,South_Korea,KR,104,5,51225321,Asia,9241,131
2020-03-27,South_Korea,KR,91,8,51225321,Asia,9332,139
2020-03-28,South_Korea,KR,146,5,51225321,Asia,9478,144
2020-03-29,South_Korea,KR,105,8,51225321,Asia,9583,152
2020-03-30,South_Korea,KR,78,6,51225321,Asia,9661,158
2020-03-31,South_Korea,KR,125,5,51225321,Asia,9786,163
2020-04-01,South_Korea,KR,0,0,51225321,Asia,9786,163
2020-04-02,South_Korea,KR,190,6,51225321,Asia,9976,169
2020-04-03,South_Korea,KR,86,5,51225321,Asia,10062,174
2020-04-04,South_Korea,KR,94,3,51225321,Asia,10156,177
2020-04-05,South_Korea,KR,81,6,51225321,Asia,10237,183
2020-04-06,South_Korea,KR,47,3,51225321,Asia,10284,186
2020-04-07,South_Korea,KR,47,6,51225321,Asia,10331,192
2020-04-08,South_Korea,KR,53,8,51225321,Asia,10384,200
2020-04-09,South_Korea,KR,39,4,51225321,Asia,10423,204
2020-04-10,South_Korea,KR,27,4,51225321,Asia,10450,208
2020-04-11,South_Korea,KR,0,0,51225321,Asia,10450,208
2020-04-12,South_Korea,KR,62,6,51225321,Asia,10512,214
2020-04-13,South_Korea,KR,25,3,51225321,Asia,10537,217
2020-04-14,South_Korea,KR,27,5,51225321,Asia,10564,222
2020-04-15,South_Korea,KR,27,3,51225321,Asia,10591,225
2020-04-16,South_Korea,KR,22,4,51225321,Asia,10613,229
2020-04-17,South_Korea,KR,22,1,51225321,Asia,10635,230
2020-04-18,South_Korea,KR,18,2,51225321,Asia,10653,232
2020-04-19,South_Korea,KR,8,2,51225321,Asia,10661,234
2020-04-20,South_Korea,KR,13,2,51225321,Asia,10674,236
2020-04-21,South_Korea,KR,9,1,51225321,Asia,10683,237
2020-04-22,South_Korea,KR,11,1,51225321,Asia,10694,238
2020-04-23,South_Korea,KR,8,2,51225321,Asia,10702,240
2020-04-24,South_Korea,KR,6,0,51225321,Asia,10708,240
2020-04-25,South_Korea,KR,10,0,51225321,Asia,10718,240
2020-04-26,South_Korea,KR,10,2,51225321,Asia,10728,242
2020-04-27,South_Korea,KR,10,1,51225321,Asia,10738,243
2020-04-28,South_Korea,KR,14,1,51225321,Asia,10752,244
2020-04-29,South_Korea,KR,9,2,51225321,Asia,10761,246
2020-04-30,South_Korea,KR,4,1,51225321,Asia,10765,247
2020-05-01,South_Korea,KR,9,1,51225321,Asia,10774,248
2020-05-02,South_Korea,KR,6,2,51225321,Asia,10780,250
2020-05-03,South_Korea,KR,13,0,51225321,Asia,10793,250
2020-05-04,South_Korea,KR,8,2,51225321,Asia,10801,252
2020-05-05,South_Korea,KR,3,2,51225321,Asia,10804,254
2020-05-06,South_Korea,KR,2,1,51225321,Asia,10806,255
2020-05-07,South_Korea,KR,4,1,51225321,Asia,10810,256
2020-05-08,South_Korea,KR,12,0,51225321,Asia,10822,256
2020-05-09,South_Korea,KR,18,0,51225321,Asia,10840,256
2020-05-10,South_Korea,KR,34,0,51225321,Asia,10874,256
2020-05-11,South_Korea,KR,35,0,51225321,Asia,10909,256
2020-05-12,South_Korea,KR,27,2,51225321,Asia,10936,258
2020-05-13,South_Korea,KR,26,1,51225321,Asia,10962,259
2020-05-14,South_Korea,KR,29,1,51225321,Asia,10991,260
2020-05-15,South_Korea,KR,27,0,51225321,Asia,11018,260
2020-05-16,South_Korea,KR,19,2,51225321,Asia,11037,262
2020-05-17,South_Korea,KR,13,0,51225321,Asia,11050,262
2020-05-18,South_Korea,KR,15,1,51225321,Asia,11065,263
2020-05-19,South_Korea,KR,13,0,51225321,Asia,11078,263
2020-05-20,South_Korea,KR,32,0,51225321,Asia,11110,263
2020-05-21,South_Korea,KR,12,1,51225321,Asia,11122,264
2020-05-22,South_Korea,KR,20,0,51225321,Asia,11142,264
2020-05-23,South_Korea,KR,23,2,51225321,Asia,11165,266
2020-05-24,South_Korea,KR,25,0,51225321,Asia,11190,266
2020-05-25,South_Korea,KR,16,1,51225321,Asia,11206,267
2020-05-26,South_Korea,KR,19,2,51225321,Asia,11225,269
2020-05-27,South_Korea,KR,40,0,51225321,Asia,11265,269
2020-05-28,South_Korea,KR,79,0,51225321,Asia,11344,269
2020-05-29,South_Korea,KR,58,0,51225321,Asia,11402,269
2020-05-30,South_Korea,KR,39,0,51225321,Asia,11441,269
2020-05-31,South_Korea,KR,27,1,51225321,Asia,11468,270
2020-06-01,South_Korea,KR,35,1,51225321,Asia,11503,271
2020-06-02,South_Korea,KR,38,1,51225321,Asia,11541,272
2020-06-03,South_Korea,KR,49,1,51225321,Asia,11590,273
2020-06-04,South_Korea,KR,39,0,51225321,Asia,11629,273
2020-06-05,South_Korea,KR,39,0,51225321,Asia,11668,273
2020-06-06,South_Korea,KR,51,0,51225321,Asia,11719,273
2020-06-07,South_Korea,KR,57,0,51225321,Asia,11776,273
2020-06-08,South_Korea,KR,38,0,51225321,Asia,11814,273
2020-06-09,South_Korea,KR,38,1,51225321,Asia,11852,274
2020-06-10,South_Korea,KR,50,2,51225321,Asia,11902,276
2020-06-11,South_Korea,KR,45,0,51225321,Asia,11947,276
2020-06-12,South_Korea,KR,56,1,51225321,Asia,12003,277
2020-06-13,South_Korea,KR,48,0,51225321,Asia,12051,277
2020-06-14,South_Korea,KR,33,0,51225321,Asia,12084,277
2020-06-15,South_Korea,KR,37,0,51225321,Asia,12121,277
2020-06-16,South_Korea,KR,34,1,51225321,Asia,12155,278
2020-06-17,South_Korea,KR,43,1,51225321,Asia,12198,279
2020-06-18,South_Korea,KR,59,1,51225321,Asia,12257,280
2020-06-19,South_Korea,KR,49,0,51225321,Asia,12306,280
2020-06-20,South_Korea,KR,67,0,51225321,Asia,12373,280
2020-06-21,South_Korea,KR,48,0,51225321,Asia,12421,280
2020-06-22,South_Korea,KR,17,0,51225321,Asia,12438,280
2020-06-23,South_Korea,KR,46,1,51225321,Asia,12484,281
2020-06-24,South_Korea,KR,51,0,51225321,Asia,12535,281
2020-06-25,South_Korea,KR,28,1,51225321,Asia,12563,282
2020-06-26,South_Korea,KR,39,0,51225321,Asia,12602,282
2020-06-27,South_Korea,KR,51,0,51225321,Asia,12653,282
2020-06-28,South_Korea,KR,62,0,51225321,Asia,12715,282
2020-06-29,South_Korea,KR,42,0,51225321,Asia,12757,282
2020-06-30,South_Korea,KR,43,0,51225321,Asia,12800,282
2020-07-01,South_Korea,KR,50,0,51225321,Asia,12850,282
2020-07-02,South_Korea,KR,54,0,51225321,Asia,12904,282
2020-07-03,South_Korea,KR,63,0,51225321,Asia,12967,282
2020-07-04,South_Korea,KR,63,1,51225321,Asia,13030,283
2020-07-05,South_Korea,KR,61,0,51225321,Asia,13091,283
2020-07-06,South_Korea,KR,0,0,51225321,Asia,13091,283
2020-07-07,South_Korea,KR,90,2,51225321,Asia,13181,285
2020-07-08,South_Korea,KR,63,0,51225321,Asia,13244,285
2020-07-09,South_Korea,KR,49,2,51225321,Asia,13293,287
2020-07-10,South_Korea,KR,45,1,51225321,Asia,13338,288
2020-07-11,South_Korea,KR,35,0,51225321,Asia,13373,288
2020-07-12,South_Korea,KR,44,1,51225321,Asia,13417,289
2020-07-13,South_Korea,KR,62,0,51225321,Asia,13479,289
2020-07-14,South_Korea,KR,33,0,51225321,Asia,13512,289
2020-07-15,South_Korea,KR,39,0,51225321,Asia,13551,289
2020-07-16,South_Korea,KR,61,2,51225321,Asia,13612,291
2020-07-17,South_Korea,KR,60,2,51225321,Asia,13672,293
2020-07-18,South_Korea,KR,39,1,51225321,Asia,13711,294
2020-07-19,South_Korea,KR,34,1,51225321,Asia,13745,295
2020-07-20,South_Korea,KR,26,1,51225321,Asia,13771,296
2020-07-21,South_Korea,KR,45,0,51225321,Asia,13816,296
2020-07-22,South_Korea,KR,63,1,51225321,Asia,13879,297
2020-07-23,South_Korea,KR,59,0,51225321,Asia,13938,297
2020-07-24,South_Korea,KR,41,1,51225321,Asia,13979,298
2020-07-25,South_Korea,KR,113,0,51225321,Asia,14092,298
2020-07-26,South_Korea,KR,58,0,51225321,Asia,14150,298
2020-07-27,South_Korea,KR,25,1,51225321,Asia,14175,299
2020-07-28,South_Korea,KR,28,1,51225321,Asia,14203,300
2020-07-29,South_Korea,KR,48,0,51225321,Asia,14251,300
2020-07-30,South_Korea,KR,18,0,51225321,Asia,14269,300
2020-07-31,South_Korea,KR,36,1,51225321,Asia,14305,301
2020-08-01,South_Korea,KR,31,0,51225321,Asia,14336,301
2020-08-02,South_Korea,KR,0,0,51225321,Asia,14336,301
2020-08-03,South_Korea,KR,53,0,51225321,Asia,14389,301
2020-08-04,South_Korea,KR,34,0,51225321,Asia,14423,301
2020-08-05,South_Korea,KR,33,1,51225321,Asia,14456,302
2020-08-06,South_Korea,KR,43,0,51225321,Asia,14499,302
2020-08-07,South_Korea,KR,20,1,51225321,Asia,14519,303
2020-08-08,South_Korea,KR,43,1,51225321,Asia,14562,304
2020-08-09,South_Korea,KR,36,1,51225321,Asia,14598,305
2020-08-10,South_Korea,KR,28,0,51225321,Asia,14626,305
2020-08-11,South_Korea,KR,34,0,51225321,Asia,14660,305
2020-08-12,South_Korea,KR,54,0,51225321,Asia,14714,305
2020-08-13,South_Korea,KR,56,0,51225321,Asia,14770,305
2020-08-14,South_Korea,KR,103,0,51225321,Asia,14873,305
2020-08-15,South_Korea,KR,166,0,51225321,Asia,15039,305
2020-08-16,South_Korea,KR,279,0,51225321,Asia,15318,305
2020-08-17,South_Korea,KR,197,0,51225321,Asia,15515,305
2020-08-18,South_Korea,KR,246,1,51225321,Asia,15761,306
2020-08-19,South_Korea,KR,297,0,51225321,Asia,16058,306
2020-08-20,South_Korea,KR,288,1,51225321,Asia,16346,307
2020-08-21,South_Korea,KR,324,2,51225321,Asia,16670,309
2020-08-22,South_Korea,KR,332,0,51225321,Asia,17002,309
2020-08-23,South_Korea,KR,397,0,51225321,Asia,17399,309
2020-08-24,South_Korea,KR,266,0,51225321,Asia,17665,309
2020-08-25,South_Korea,KR,280,1,51225321,Asia,17945,310
2020-08-26,South_Korea,KR,320,2,51225321,Asia,18265,312
2020-08-27,South_Korea,KR,441,1,51225321,Asia,18706,313
2020-08-28,South_Korea,KR,371,3,51225321,Asia,19077,316
2020-08-29,South_Korea,KR,323,5,51225321,Asia,19400,321
2020-08-30,South_Korea,KR,299,2,51225321,Asia,19699,323
2020-08-31,South_Korea,KR,248,1,51225321,Asia,19947,324
2020-09-01,South_Korea,KR,235,0,51225321,Asia,20182,324
2020-09-02,South_Korea,KR,267,2,51225321,Asia,20449,326
2020-09-03,South_Korea,KR,195,3,51225321,Asia,20644,329
2020-09-04,South_Korea,KR,198,2,51225321,Asia,20842,331
2020-09-05,South_Korea,KR,0,0,51225321,Asia,20842,331
2020-09-06,South_Korea,KR,335,3,51225321,Asia,21177,334
2020-09-07,South_Korea,KR,119,2,51225321,Asia,21296,336
2020-09-08,South_Korea,KR,136,5,51225321,Asia,21432,341
2020-09-09,South_Korea,KR,156,3,51225321,Asia,21588,344
2020-09-10,South_Korea,KR,155,2,51225321,Asia,21743,346
2020-09-11,South_Korea,KR,176,4,51225321,Asia,21919,350
2020-09-12,South_Korea,KR,136,5,51225321,Asia,22055,355
2020-09-13,South_Korea,KR,121,3,51225321,Asia,22176,358
2020-09-14,South_Korea,KR,109,5,51225321,Asia,22285,363
2020-09-15,South_Korea,KR,106,4,51225321,Asia,22391,367
2020-09-16,South_Korea,KR,113,0,51225321,Asia,22504,367
2020-09-17,South_Korea,KR,153,5,51225321,Asia,22657,372
2020-09-18,South_Korea,KR,126,5,51225321,Asia,22783,377
2020-09-19,South_Korea,KR,110,1,51225321,Asia,22893,378
2020-09-20,South_Korea,KR,82,5,51225321,Asia,22975,383
2020-09-21,South_Korea,KR,70,2,51225321,Asia,23045,385
2020-09-22,South_Korea,KR,61,3,51225321,Asia,23106,388
2020-09-23,South_Korea,KR,110,0,51225321,Asia,23216,388
2020-09-24,South_Korea,KR,125,5,51225321,Asia,23341,393
2020-09-25,South_Korea,KR,114,2,51225321,Asia,23455,395
2020-09-26,South_Korea,KR,61,4,51225321,Asia,23516,399
2020-09-27,South_Korea,KR,95,2,51225321,Asia,23611,401
2020-09-28,South_Korea,KR,50,5,51225321,Asia,23661,406
2020-09-29,South_Korea,KR,38,1,51225321,Asia,23699,407
2020-09-30,South_Korea,KR,113,6,51225321,Asia,23812,413
2020-10-01,South_Korea,KR,0,0,51225321,Asia,23812,413
2020-10-02,South_Korea,KR,140,3,51225321,Asia,23952,416
2020-10-03,South_Korea,KR,75,4,51225321,Asia,24027,420
2020-10-04,South_Korea,KR,64,1,51225321,Asia,24091,421
2020-10-05,South_Korea,KR,73,1,51225321,Asia,24164,422
2020-10-06,South_Korea,KR,75,0,51225321,Asia,24239,422
2020-10-07,South_Korea,KR,114,3,51225321,Asia,24353,425
2020-10-08,South_Korea,KR,69,2,51225321,Asia,24422,427
2020-10-09,South_Korea,KR,54,1,51225321,Asia,24476,428
2020-10-10,South_Korea,KR,72,2,51225321,Asia,24548,430
2020-10-11,South_Korea,KR,58,2,51225321,Asia,24606,432
2020-10-12,South_Korea,KR,97,1,51225321,Asia,24703,433
2020-10-13,South_Korea,KR,102,1,51225321,Asia,24805,434
2020-10-14,South_Korea,KR,84,4,51225321,Asia,24889,438
2020-10-15,South_Korea,KR,99,1,51225321,Asia,24988,439
2020-10-16,South_Korea,KR,47,2,51225321,Asia,25035,441
2020-10-17,South_Korea,KR,73,2,51225321,Asia,25108,443
2020-10-18,South_Korea,KR,91,1,51225321,Asia,25199,444
2020-10-19,South_Korea,KR,76,0,51225321,Asia,25275,444
2020-10-20,South_Korea,KR,58,3,51225321,Asia,25333,447
2020-10-21,South_Korea,KR,91,3,51225321,Asia,25424,450
2020-10-22,South_Korea,KR,119,3,51225321,Asia,25543,453
2020-10-23,South_Korea,KR,155,2,51225321,Asia,25698,455
2020-10-24,South_Korea,KR,77,2,51225321,Asia,25775,457
2020-10-25,South_Korea,KR,61,0,51225321,Asia,25836,457
2020-10-26,South_Korea,KR,119,0,51225321,Asia,25955,457
2020-10-27,South_Korea,KR,88,3,51225321,Asia,26043,460
2020-10-28,South_Korea,KR,103,1,51225321,Asia,26146,461
2020-10-29,South_Korea,KR,125,1,51225321,Asia,26271,462
2020-10-30,South_Korea,KR,114,2,51225321,Asia,26385,464
2020-10-31,South_Korea,KR,126,0,51225321,Asia,26511,464
2020-11-01,South_Korea,KR,124,2,51225321,Asia,26635,466
2020-11-02,South_Korea,KR,97,2,51225321,Asia,26732,468
2020-11-03,South_Korea,KR,75,4,51225321,Asia,26807,472
2020-11-04,South_Korea,KR,118,2,51225321,Asia,26925,474
2020-11-05,South_Korea,KR,125,1,51225321,Asia,27050,475
2020-11-06,South_Korea,KR,145,1,51225321,Asia,27195,476
2020-11-07,South_Korea,KR,89,1,51225321,Asia,27284,477
2020-11-08,South_Korea,KR,143,1,51225321,Asia,27427,478
2020-11-09,South_Korea,KR,126,2,51225321,Asia,27553,480
2020-11-10,South_Korea,KR,100,5,51225321,Asia,27653,485
2020-11-11,South_Korea,KR,146,2,51225321,Asia,27799,487
2020-11-12,South_Korea,KR,143,0,51225321,Asia,27942,487
2020-11-13,South_Korea,KR,191,1,51225321,Asia,28133,488
2020-11-14,South_Korea,KR,205,4,51225321,Asia,28338,492
2020-11-15,South_Korea,KR,208,1,51225321,Asia,28546,493
2020-11-16,South_Korea,KR,223,1,51225321,Asia,28769,494
2020-11-17,South_Korea,KR,229,0,51225321,Asia,28998,494
2020-11-18,South_Korea,KR,313,2,51225321,Asia,29311,496
2020-11-19,South_Korea,KR,343,2,51225321,Asia,29654,498
2020-11-20,South_Korea,KR,363,3,51225321,Asia,30017,501
2020-11-21,South_Korea,KR,386,2,51225321,Asia,30403,503
2020-11-22,South_Korea,KR,330,2,51225321,Asia,30733,505
2020-11-23,South_Korea,KR,271,4,51225321,Asia,31004,509
2020-11-24,South_Korea,KR,349,1,51225321,Asia,31353,510
2020-11-25,South_Korea,KR,382,3,51225321,Asia,31735,513
2020-11-26,South_Korea,KR,583,2,51225321,Asia,32318,515
2020-11-27,South_Korea,KR,569,1,51225321,Asia,32887,516
2020-11-28,South_Korea,KR,488,6,51225321,Asia,33375,522
2020-11-29,South_Korea,KR,449,1,51225321,Asia,33824,523
2020-11-30,South_Korea,KR,377,3,51225321,Asia,34201,526
2020-12-01,South_Korea,KR,451,0,51225321,Asia,34652,526
2020-12-02,South_Korea,KR,511,0,51225321,Asia,35163,526
2020-12-03,South_Korea,KR,540,3,51225321,Asia,35703,529
2020-12-04,South_Korea,KR,629,7,51225321,Asia,36332,536
2020-12-05,South_Korea,KR,583,4,51225321,Asia,36915,540
2020-12-06,South_Korea,KR,631,5,51225321,Asia,37546,545
2020-12-07,South_Korea,KR,615,4,51225321,Asia,38161,549
2020-12-08,South_Korea,KR,594,3,51225321,Asia,38755,552
2020-12-09,South_Korea,KR,677,4,51225321,Asia,39432,556
2020-12-10,South_Korea,KR,666,8,51225321,Asia,40098,564
2020-12-11,South_Korea,KR,688,8,51225321,Asia,40786,572
2020-12-12,South_Korea,KR,950,6,51225321,Asia,41736,578
2020-12-13,South_Korea,KR,1030,2,51225321,Asia,42766,580
2020-12-14,South_Korea,KR,718,7,51225321,Asia,43484,587
2019-12-31,Kuwait,KW,0,0,4207077,Asia,0,0
2020-01-01,Kuwait,KW,0,0,4207077,Asia,0,0
2020-01-02,Kuwait,KW,0,0,4207077,Asia,0,0
2020-01-03,Kuwait,KW,0,0,4207077,Asia,0,0
2020-01-04,Kuwait,KW,0,0,4207077,Asia,0,0
2020-01-05,Kuwait,KW,0,0,4207077,Asia,0,0
2020-01-06,Kuwait,KW,0,0,4207077,Asia,0,0
2020-01-07,Kuwait,KW,0,0,4207077,Asia,0,0
2020-01-08,Kuwait,KW,0,0,4207077,Asia,0,0
2020-01-09,Kuwait,KW,0,0,4207077,Asia,0,0
2020-01-10,Kuwait,KW,0,0,4207077,Asia,0,0
2020-01-11,Kuwait,KW,0,0,4207077,Asia,0,0
2020-01-12,Kuwait,KW,0,0,4207077,Asia,0,0
2020-01-13,Kuwait,KW,0,0,4207077,Asia,0,0
2020-01-14,Kuwait,KW,0,0,4207077,Asia,0,0
2020-01-15,Kuwait,KW,0,0,4207077,Asia,0,0
2020-01-16,Kuwait,KW,0,0,4207077,Asia,0,0
2020-01-17,Kuwait,KW,0,0,4207077,Asia,0,0
2020-01-18,Kuwait,KW,0,0,4207077,Asia,0,0
2020-01-19,Kuwait,KW,0,0,4207077,Asia,0,0
2020-01-20,Kuwait,KW,0,0,4207077,Asia,0,0
2020-01-21,Kuwait,KW,0,0,4207077,Asia,0,0
2020-01-22,Kuwait,KW,0,0,4207077,Asia,0,0
2020-01-23,Kuwait,KW,0,0,4207077,Asia,0,0
2020-01-24,Kuwait,KW,0,0,4207077,Asia,0,0
2020-01-25,Kuwait,KW,0,0,4207077,Asia,0,0
2020-01-26,Kuwait,KW,0,0,4207077,Asia,0,0
2020-01-27,Kuwait,KW,0,0,4207077,Asia,0,0
2020-01-28,Kuwait,KW,0,0,4207077,Asia,0,0
2020-01-29,Kuwait,KW,0,0,4207077,Asia,0,0
2020-01-30,Kuwait,KW,0,0,4207077,Asia,0,0
2020-01-31,Kuwait,KW,0,0,4207077,Asia,0,0
2020-02-01,Kuwait,KW,0,0,4207077,Asia,0,0
2020-02-02,Kuwait,KW,0,0,4207077,Asia,0,0
2020-02-03,Kuwait,KW,0,0,4207077,Asia,0,0
2020-02-04,Kuwait,KW,0,0,4207077,Asia,0,0
2020-02-05,Kuwait,KW,0,0,4207077,Asia,0,0
2020-02-06,Kuwait,KW,0,0,4207077,Asia,0,0
2020-02-07,Kuwait,KW,0,0,4207077,Asia,0,0
2020-02-08,Kuwait,KW,0,0,4207077,Asia,0,0
2020-02-09,Kuwait,KW,0,0,4207077,Asia,0,0
2020-02-10,Kuwait,KW,0,0,4207077,Asia,0,0
2020-02-11,Kuwait,KW,0,0,4207077,Asia,0,0
2020-02-12,Kuwait,KW,0,0,4207077,Asia,0,0
2020-02-13,Kuwait,KW,0,0,4207077,Asia,0,0
2020-02-14,Kuwait,KW,0,0,4207077,Asia,0,0
2020-02-15,Kuwait,KW,0,0,4207077,Asia,0,0
2020-02-16,Kuwait,KW,0,0,4207077,Asia,0,0
2020-02-17,Kuwait,KW,0,0,4207077,Asia,0,0
2020-02-18,Kuwait,KW,0,0,4207077,Asia,0,0
2020-02-19,Kuwait,KW,0,0,4207077,Asia,0,0
2020-02-20,Kuwait,KW,0,0,4207077,Asia,0,0
2020-02-21,Kuwait,KW,0,0,4207077,Asia,0,0
2020-02-22,Kuwait,KW,0,0,4207077,Asia,0,0
2020-02-23,Kuwait,KW,0,0,4207077,Asia,0,0
2020-02-24,Kuwait,KW,3,0,4207077,Asia,3,0
2020-02-25,Kuwait,KW,2,0,4207077,Asia,5,0
2020-02-26,Kuwait,KW,6,0,4207077,Asia,11,0
2020-02-27,Kuwait,KW,15,0,4207077,Asia,26,0
2020-02-28,Kuwait,KW,17,0,4207077,Asia,43,0
2020-02-29,Kuwait,KW,2,0,4207077,Asia,45,0
2020-03-01,Kuwait,KW,0,0,4207077,Asia,45,0
2020-03-02,Kuwait,KW,1,0,4207077,Asia,46,0
2020-03-03,Kuwait,KW,10,0,4207077,Asia,56,0
2020-03-06,Kuwait,KW,2,0,4207077,Asia,58,0
2020-03-08,Kuwait,KW,3,0,4207077,Asia,61,0
2020-03-09,Kuwait,KW,3,0,4207077,Asia,64,0
2020-03-10,Kuwait,KW,1,0,4207077,Asia,65,0
2020-03-11,Kuwait,KW,4,0,4207077,Asia,69,0
2020-03-12,Kuwait,KW,3,0,4207077,Asia,72,0
2020-03-13,Kuwait,KW,8,0,4207077,Asia,80,0
2020-03-14,Kuwait,KW,20,0,4207077,Asia,100,0
2020-03-15,Kuwait,KW,4,0,4207077,Asia,104,0
2020-03-16,Kuwait,KW,8,0,4207077,Asia,112,0
2020-03-17,Kuwait,KW,11,0,4207077,Asia,123,0
2020-03-18,Kuwait,KW,7,0,4207077,Asia,130,0
2020-03-19,Kuwait,KW,12,0,4207077,Asia,142,0
2020-03-20,Kuwait,KW,6,0,4207077,Asia,148,0
2020-03-21,Kuwait,KW,11,0,4207077,Asia,159,0
2020-03-22,Kuwait,KW,17,0,4207077,Asia,176,0
2020-03-23,Kuwait,KW,12,0,4207077,Asia,188,0
2020-03-24,Kuwait,KW,1,0,4207077,Asia,189,0
2020-03-25,Kuwait,KW,2,0,4207077,Asia,191,0
2020-03-26,Kuwait,KW,4,0,4207077,Asia,195,0
2020-03-27,Kuwait,KW,13,0,4207077,Asia,208,0
2020-03-28,Kuwait,KW,17,0,4207077,Asia,225,0
2020-03-29,Kuwait,KW,10,0,4207077,Asia,235,0
2020-03-30,Kuwait,KW,20,0,4207077,Asia,255,0
2020-03-31,Kuwait,KW,11,0,4207077,Asia,266,0
2020-04-01,Kuwait,KW,23,0,4207077,Asia,289,0
2020-04-02,Kuwait,KW,28,0,4207077,Asia,317,0
2020-04-03,Kuwait,KW,25,0,4207077,Asia,342,0
2020-04-04,Kuwait,KW,0,0,4207077,Asia,342,0
2020-04-05,Kuwait,KW,137,1,4207077,Asia,479,1
2020-04-06,Kuwait,KW,77,0,4207077,Asia,556,1
2020-04-07,Kuwait,KW,109,0,4207077,Asia,665,1
2020-04-08,Kuwait,KW,78,0,4207077,Asia,743,1
2020-04-09,Kuwait,KW,112,0,4207077,Asia,855,1
2020-04-10,Kuwait,KW,55,0,4207077,Asia,910,1
2020-04-11,Kuwait,KW,83,0,4207077,Asia,993,1
2020-04-12,Kuwait,KW,161,0,4207077,Asia,1154,1
2020-04-13,Kuwait,KW,80,0,4207077,Asia,1234,1
2020-04-14,Kuwait,KW,66,1,4207077,Asia,1300,2
2020-04-15,Kuwait,KW,55,1,4207077,Asia,1355,3
2020-04-16,Kuwait,KW,50,0,4207077,Asia,1405,3
2020-04-17,Kuwait,KW,119,0,4207077,Asia,1524,3
2020-04-18,Kuwait,KW,134,2,4207077,Asia,1658,5
2020-04-19,Kuwait,KW,94,1,4207077,Asia,1752,6
2020-04-20,Kuwait,KW,163,1,4207077,Asia,1915,7
2020-04-21,Kuwait,KW,80,2,4207077,Asia,1995,9
2020-04-22,Kuwait,KW,85,2,4207077,Asia,2080,11
2020-04-23,Kuwait,KW,168,2,4207077,Asia,2248,13
2020-04-24,Kuwait,KW,151,1,4207077,Asia,2399,14
2020-04-25,Kuwait,KW,215,1,4207077,Asia,2614,15
2020-04-26,Kuwait,KW,278,4,4207077,Asia,2892,19
2020-04-27,Kuwait,KW,183,1,4207077,Asia,3075,20
2020-04-28,Kuwait,KW,213,2,4207077,Asia,3288,22
2020-04-29,Kuwait,KW,152,1,4207077,Asia,3440,23
2020-04-30,Kuwait,KW,300,1,4207077,Asia,3740,24
2020-05-01,Kuwait,KW,284,2,4207077,Asia,4024,26
2020-05-02,Kuwait,KW,353,4,4207077,Asia,4377,30
2020-05-03,Kuwait,KW,242,3,4207077,Asia,4619,33
2020-05-04,Kuwait,KW,364,5,4207077,Asia,4983,38
2020-05-05,Kuwait,KW,295,2,4207077,Asia,5278,40
2020-05-06,Kuwait,KW,526,0,4207077,Asia,5804,40
2020-05-07,Kuwait,KW,485,2,4207077,Asia,6289,42
2020-05-08,Kuwait,KW,278,2,4207077,Asia,6567,44
2020-05-09,Kuwait,KW,641,3,4207077,Asia,7208,47
2020-05-10,Kuwait,KW,415,2,4207077,Asia,7623,49
2020-05-11,Kuwait,KW,1065,9,4207077,Asia,8688,58
2020-05-12,Kuwait,KW,598,7,4207077,Asia,9286,65
2020-05-13,Kuwait,KW,991,10,4207077,Asia,10277,75
2020-05-14,Kuwait,KW,751,7,4207077,Asia,11028,82
2020-05-15,Kuwait,KW,947,6,4207077,Asia,11975,88
2020-05-16,Kuwait,KW,885,8,4207077,Asia,12860,96
2020-05-17,Kuwait,KW,942,11,4207077,Asia,13802,107
2020-05-18,Kuwait,KW,1048,5,4207077,Asia,14850,112
2020-05-19,Kuwait,KW,841,6,4207077,Asia,15691,118
2020-05-20,Kuwait,KW,1073,3,4207077,Asia,16764,121
2020-05-21,Kuwait,KW,804,3,4207077,Asia,17568,124
2020-05-22,Kuwait,KW,1041,5,4207077,Asia,18609,129
2020-05-23,Kuwait,KW,955,9,4207077,Asia,19564,138
2020-05-24,Kuwait,KW,900,10,4207077,Asia,20464,148
2020-05-25,Kuwait,KW,838,8,4207077,Asia,21302,156
2020-05-26,Kuwait,KW,665,9,4207077,Asia,21967,165
2020-05-27,Kuwait,KW,608,7,4207077,Asia,22575,172
2020-05-28,Kuwait,KW,692,3,4207077,Asia,23267,175
2020-05-29,Kuwait,KW,845,10,4207077,Asia,24112,185
2020-05-30,Kuwait,KW,1072,9,4207077,Asia,25184,194
2020-05-31,Kuwait,KW,1008,11,4207077,Asia,26192,205
2020-06-01,Kuwait,KW,851,7,4207077,Asia,27043,212
2020-06-02,Kuwait,KW,719,8,4207077,Asia,27762,220
2020-06-03,Kuwait,KW,887,6,4207077,Asia,28649,226
2020-06-04,Kuwait,KW,710,4,4207077,Asia,29359,230
2020-06-05,Kuwait,KW,562,6,4207077,Asia,29921,236
2020-06-06,Kuwait,KW,723,8,4207077,Asia,30644,244
2020-06-07,Kuwait,KW,487,10,4207077,Asia,31131,254
2020-06-08,Kuwait,KW,717,10,4207077,Asia,31848,264
2020-06-09,Kuwait,KW,662,5,4207077,Asia,32510,269
2020-06-10,Kuwait,KW,630,4,4207077,Asia,33140,273
2020-06-11,Kuwait,KW,683,2,4207077,Asia,33823,275
2020-06-12,Kuwait,KW,609,4,4207077,Asia,34432,279
2020-06-13,Kuwait,KW,520,6,4207077,Asia,34952,285
2020-06-14,Kuwait,KW,514,4,4207077,Asia,35466,289
2020-06-15,Kuwait,KW,454,7,4207077,Asia,35920,296
2020-06-16,Kuwait,KW,511,2,4207077,Asia,36431,298
2020-06-17,Kuwait,KW,527,5,4207077,Asia,36958,303
2020-06-18,Kuwait,KW,575,3,4207077,Asia,37533,306
2020-06-19,Kuwait,KW,541,2,4207077,Asia,38074,308
2020-06-20,Kuwait,KW,604,5,4207077,Asia,38678,313
2020-06-21,Kuwait,KW,467,6,4207077,Asia,39145,319
2020-06-22,Kuwait,KW,505,7,4207077,Asia,39650,326
2020-06-23,Kuwait,KW,641,4,4207077,Asia,40291,330
2020-06-24,Kuwait,KW,742,4,4207077,Asia,41033,334
2020-06-25,Kuwait,KW,846,3,4207077,Asia,41879,337
2020-06-26,Kuwait,KW,909,2,4207077,Asia,42788,339
2020-06-27,Kuwait,KW,915,2,4207077,Asia,43703,341
2020-06-28,Kuwait,KW,688,3,4207077,Asia,44391,344
2020-06-29,Kuwait,KW,551,4,4207077,Asia,44942,348
2020-06-30,Kuwait,KW,582,2,4207077,Asia,45524,350
2020-07-01,Kuwait,KW,671,4,4207077,Asia,46195,354
2020-07-02,Kuwait,KW,745,4,4207077,Asia,46940,358
2020-07-03,Kuwait,KW,919,1,4207077,Asia,47859,359
2020-07-04,Kuwait,KW,813,1,4207077,Asia,48672,360
2020-07-05,Kuwait,KW,631,5,4207077,Asia,49303,365
2020-07-06,Kuwait,KW,638,3,4207077,Asia,49941,368
2020-07-07,Kuwait,KW,703,5,4207077,Asia,50644,373
2020-07-08,Kuwait,KW,601,4,4207077,Asia,51245,377
2020-07-09,Kuwait,KW,762,2,4207077,Asia,52007,379
2020-07-10,Kuwait,KW,833,3,4207077,Asia,52840,382
2020-07-11,Kuwait,KW,740,1,4207077,Asia,53580,383
2020-07-12,Kuwait,KW,478,3,4207077,Asia,54058,386
2020-07-13,Kuwait,KW,836,4,4207077,Asia,54894,390
2020-07-14,Kuwait,KW,614,3,4207077,Asia,55508,393
2020-07-15,Kuwait,KW,666,3,4207077,Asia,56174,396
2020-07-16,Kuwait,KW,703,3,4207077,Asia,56877,399
2020-07-17,Kuwait,KW,791,3,4207077,Asia,57668,402
2020-07-18,Kuwait,KW,553,2,4207077,Asia,58221,404
2020-07-19,Kuwait,KW,683,3,4207077,Asia,58904,407
2020-07-20,Kuwait,KW,300,1,4207077,Asia,59204,408
2020-07-21,Kuwait,KW,559,0,4207077,Asia,59763,408
2020-07-22,Kuwait,KW,671,4,4207077,Asia,60434,412
2020-07-23,Kuwait,KW,751,5,4207077,Asia,61185,417
2020-07-24,Kuwait,KW,687,4,4207077,Asia,61872,421
2020-07-25,Kuwait,KW,753,4,4207077,Asia,62625,425
2020-07-26,Kuwait,KW,684,4,4207077,Asia,63309,429
2020-07-27,Kuwait,KW,464,4,4207077,Asia,63773,433
2020-07-28,Kuwait,KW,606,5,4207077,Asia,64379,438
2020-07-29,Kuwait,KW,770,4,4207077,Asia,65149,442
2020-07-30,Kuwait,KW,754,2,4207077,Asia,65903,444
2020-07-31,Kuwait,KW,626,1,4207077,Asia,66529,445
2020-08-01,Kuwait,KW,428,2,4207077,Asia,66957,447
2020-08-02,Kuwait,KW,491,6,4207077,Asia,67448,453
2020-08-03,Kuwait,KW,463,4,4207077,Asia,67911,457
2020-08-04,Kuwait,KW,388,4,4207077,Asia,68299,461
2020-08-05,Kuwait,KW,475,4,4207077,Asia,68774,465
2020-08-06,Kuwait,KW,651,3,4207077,Asia,69425,468
2020-08-07,Kuwait,KW,620,1,4207077,Asia,70045,469
2020-08-08,Kuwait,KW,682,2,4207077,Asia,70727,471
2020-08-09,Kuwait,KW,472,3,4207077,Asia,71199,474
2020-08-10,Kuwait,KW,514,4,4207077,Asia,71713,478
2020-08-11,Kuwait,KW,687,4,4207077,Asia,72400,482
2020-08-12,Kuwait,KW,668,4,4207077,Asia,73068,486
2020-08-13,Kuwait,KW,717,3,4207077,Asia,73785,489
2020-08-14,Kuwait,KW,701,0,4207077,Asia,74486,489
2020-08-15,Kuwait,KW,699,5,4207077,Asia,75185,494
2020-08-16,Kuwait,KW,512,4,4207077,Asia,75697,498
2020-08-17,Kuwait,KW,508,3,4207077,Asia,76205,501
2020-08-18,Kuwait,KW,622,1,4207077,Asia,76827,502
2020-08-19,Kuwait,KW,643,3,4207077,Asia,77470,505
2020-08-20,Kuwait,KW,675,2,4207077,Asia,78145,507
2020-08-21,Kuwait,KW,622,2,4207077,Asia,78767,509
2020-08-22,Kuwait,KW,502,2,4207077,Asia,79269,511
2020-08-23,Kuwait,KW,688,2,4207077,Asia,79957,513
2020-08-24,Kuwait,KW,571,2,4207077,Asia,80528,515
2020-08-25,Kuwait,KW,432,3,4207077,Asia,80960,518
2020-08-26,Kuwait,KW,613,1,4207077,Asia,81573,519
2020-08-27,Kuwait,KW,698,2,4207077,Asia,82271,521
2020-08-28,Kuwait,KW,674,1,4207077,Asia,82945,522
2020-08-29,Kuwait,KW,633,3,4207077,Asia,83578,525
2020-08-30,Kuwait,KW,646,3,4207077,Asia,84224,528
2020-08-31,Kuwait,KW,412,2,4207077,Asia,84636,530
2020-09-01,Kuwait,KW,473,1,4207077,Asia,85109,531
2020-09-02,Kuwait,KW,702,3,4207077,Asia,85811,534
2020-09-03,Kuwait,KW,667,1,4207077,Asia,86478,535
2020-09-04,Kuwait,KW,900,1,4207077,Asia,87378,536
2020-09-05,Kuwait,KW,865,1,4207077,Asia,88243,537
2020-09-06,Kuwait,KW,720,3,4207077,Asia,88963,540
2020-09-07,Kuwait,KW,619,4,4207077,Asia,89582,544
2020-09-08,Kuwait,KW,805,2,4207077,Asia,90387,546
2020-09-09,Kuwait,KW,857,2,4207077,Asia,91244,548
2020-09-10,Kuwait,KW,838,4,4207077,Asia,92082,552
2020-09-11,Kuwait,KW,740,4,4207077,Asia,92822,556
2020-09-12,Kuwait,KW,653,1,4207077,Asia,93475,557
2020-09-13,Kuwait,KW,736,1,4207077,Asia,94211,558
2020-09-14,Kuwait,KW,553,2,4207077,Asia,94764,560
2020-09-15,Kuwait,KW,708,3,4207077,Asia,95472,563
2020-09-16,Kuwait,KW,829,5,4207077,Asia,96301,568
2020-09-17,Kuwait,KW,698,3,4207077,Asia,96999,571
2020-09-18,Kuwait,KW,825,5,4207077,Asia,97824,576
2020-09-19,Kuwait,KW,704,4,4207077,Asia,98528,580
2020-09-20,Kuwait,KW,521,1,4207077,Asia,99049,581
2020-09-21,Kuwait,KW,385,3,4207077,Asia,99434,584
2020-09-22,Kuwait,KW,530,1,4207077,Asia,99964,585
2020-09-23,Kuwait,KW,719,3,4207077,Asia,100683,588
2020-09-24,Kuwait,KW,616,2,4207077,Asia,101299,590
2020-09-25,Kuwait,KW,552,2,4207077,Asia,101851,592
2020-09-26,Kuwait,KW,590,3,4207077,Asia,102441,595
2020-09-27,Kuwait,KW,758,2,4207077,Asia,103199,597
2020-09-28,Kuwait,KW,345,4,4207077,Asia,103544,601
2020-09-29,Kuwait,KW,437,4,4207077,Asia,103981,605
2020-09-30,Kuwait,KW,587,2,4207077,Asia,104568,607
2020-10-01,Kuwait,KW,614,3,4207077,Asia,105182,610
2020-10-02,Kuwait,KW,494,2,4207077,Asia,105676,612
2020-10-03,Kuwait,KW,411,3,4207077,Asia,106087,615
2020-10-04,Kuwait,KW,371,5,4207077,Asia,106458,620
2020-10-05,Kuwait,KW,567,4,4207077,Asia,107025,624
2020-10-06,Kuwait,KW,567,4,4207077,Asia,107592,628
2020-10-07,Kuwait,KW,676,4,4207077,Asia,108268,632
2020-10-08,Kuwait,KW,475,7,4207077,Asia,108743,639
2020-10-09,Kuwait,KW,698,3,4207077,Asia,109441,642
2020-10-10,Kuwait,KW,635,7,4207077,Asia,110076,649
2020-10-11,Kuwait,KW,492,6,4207077,Asia,110568,655
2020-10-12,Kuwait,KW,548,3,4207077,Asia,111116,658
2020-10-13,Kuwait,KW,777,6,4207077,Asia,111893,664
2020-10-14,Kuwait,KW,844,8,4207077,Asia,112737,672
2020-10-15,Kuwait,KW,532,4,4207077,Asia,113269,676
2020-10-16,Kuwait,KW,746,8,4207077,Asia,114015,684
2020-10-17,Kuwait,KW,729,6,4207077,Asia,114744,690
2020-10-18,Kuwait,KW,739,4,4207077,Asia,115483,694
2020-10-19,Kuwait,KW,663,7,4207077,Asia,116146,701
2020-10-20,Kuwait,KW,686,9,4207077,Asia,116832,710
2020-10-21,Kuwait,KW,886,4,4207077,Asia,117718,714
2020-10-22,Kuwait,KW,813,7,4207077,Asia,118531,721
2020-10-23,Kuwait,KW,889,9,4207077,Asia,119420,730
2020-10-24,Kuwait,KW,812,10,4207077,Asia,120232,740
2020-10-25,Kuwait,KW,695,4,4207077,Asia,120927,744
2020-10-26,Kuwait,KW,708,2,4207077,Asia,121635,746
2020-10-27,Kuwait,KW,682,3,4207077,Asia,122317,749
2020-10-28,Kuwait,KW,775,7,4207077,Asia,123092,756
2020-10-29,Kuwait,KW,814,7,4207077,Asia,123906,763
2020-10-30,Kuwait,KW,760,4,4207077,Asia,124666,767
2020-10-31,Kuwait,KW,671,6,4207077,Asia,125337,773
2020-11-01,Kuwait,KW,589,6,4207077,Asia,125926,779
2020-11-02,Kuwait,KW,608,3,4207077,Asia,126534,782
2020-11-03,Kuwait,KW,759,4,4207077,Asia,127293,786
2020-11-04,Kuwait,KW,787,3,4207077,Asia,128080,789
2020-11-05,Kuwait,KW,763,5,4207077,Asia,128843,794
2020-11-06,Kuwait,KW,795,5,4207077,Asia,129638,799
2020-11-07,Kuwait,KW,825,5,4207077,Asia,130463,804
2020-11-08,Kuwait,KW,742,4,4207077,Asia,131205,808
2020-11-09,Kuwait,KW,538,3,4207077,Asia,131743,811
2020-11-10,Kuwait,KW,735,5,4207077,Asia,132478,816
2020-11-11,Kuwait,KW,903,5,4207077,Asia,133381,821
2020-11-12,Kuwait,KW,778,5,4207077,Asia,134159,826
2020-11-13,Kuwait,KW,773,4,4207077,Asia,134932,830
2020-11-14,Kuwait,KW,718,3,4207077,Asia,135650,833
2020-11-15,Kuwait,KW,691,2,4207077,Asia,136341,835
2020-11-16,Kuwait,KW,499,3,4207077,Asia,136840,838
2020-11-17,Kuwait,KW,489,4,4207077,Asia,137329,842
2020-11-18,Kuwait,KW,556,6,4207077,Asia,137885,848
2020-11-19,Kuwait,KW,452,9,4207077,Asia,138337,857
2020-11-20,Kuwait,KW,485,2,4207077,Asia,138822,859
2020-11-21,Kuwait,KW,486,2,4207077,Asia,139308,861
2020-11-22,Kuwait,KW,426,2,4207077,Asia,139734,863
2020-11-23,Kuwait,KW,322,3,4207077,Asia,140056,866
2020-11-24,Kuwait,KW,337,2,4207077,Asia,140393,868
2020-11-25,Kuwait,KW,402,2,4207077,Asia,140795,870
2020-11-26,Kuwait,KW,422,1,4207077,Asia,141217,871
2020-11-27,Kuwait,KW,330,1,4207077,Asia,141547,872
2020-11-28,Kuwait,KW,329,2,4207077,Asia,141876,874
2020-11-29,Kuwait,KW,319,1,4207077,Asia,142195,875
2020-11-30,Kuwait,KW,231,3,4207077,Asia,142426,878
2020-12-01,Kuwait,KW,209,2,4207077,Asia,142635,880
2020-12-02,Kuwait,KW,357,1,4207077,Asia,142992,881
2020-12-03,Kuwait,KW,268,1,4207077,Asia,143260,882
2020-12-04,Kuwait,KW,314,2,4207077,Asia,143574,884
2020-12-05,Kuwait,KW,343,2,4207077,Asia,143917,886
2020-12-06,Kuwait,KW,247,3,4207077,Asia,144164,889
2020-12-07,Kuwait,KW,205,2,4207077,Asia,144369,891
2020-12-08,Kuwait,KW,230,6,4207077,Asia,144599,897
2020-12-09,Kuwait,KW,301,3,4207077,Asia,144900,900
2020-12-10,Kuwait,KW,304,5,4207077,Asia,145204,905
2020-12-11,Kuwait,KW,291,5,4207077,Asia,145495,910
2020-12-12,Kuwait,KW,294,0,4207077,Asia,145789,910
2020-12-13,Kuwait,KW,255,1,4207077,Asia,146044,911
2020-12-14,Kuwait,KW,174,0,4207077,Asia,146218,911
2020-03-20,Cayman_Islands,KY,1,0,64948,America,1,0
2020-03-21,Cayman_Islands,KY,2,1,64948,America,3,1
2020-03-22,Cayman_Islands,KY,0,0,64948,America,3,1
2020-03-23,Cayman_Islands,KY,0,0,64948,America,3,1
2020-03-24,Cayman_Islands,KY,0,0,64948,America,3,1
2020-03-25,Cayman_Islands,KY,0,0,64948,America,3,1
2020-03-26,Cayman_Islands,KY,0,0,64948,America,3,1
2020-03-27,Cayman_Islands,KY,3,0,64948,America,6,1
2020-03-28,Cayman_Islands,KY,2,0,64948,America,8,1
2020-03-29,Cayman_Islands,KY,0,0,64948,America,8,1
2020-03-30,Cayman_Islands,KY,0,0,64948,America,8,1
2020-03-31,Cayman_Islands,KY,4,0,64948,America,12,1
2020-04-01,Cayman_Islands,KY,2,0,64948,America,14,1
2020-04-02,Cayman_Islands,KY,8,0,64948,America,22,1
2020-04-03,Cayman_Islands,KY,6,0,64948,America,28,1
2020-04-04,Cayman_Islands,KY,1,0,64948,America,29,1
2020-04-05,Cayman_Islands,KY,6,0,64948,America,35,1
2020-04-06,Cayman_Islands,KY,4,0,64948,America,39,1
2020-04-07,Cayman_Islands,KY,0,0,64948,America,39,1
2020-04-08,Cayman_Islands,KY,6,0,64948,America,45,1
2020-04-09,Cayman_Islands,KY,0,0,64948,America,45,1
2020-04-10,Cayman_Islands,KY,0,0,64948,America,45,1
2020-04-11,Cayman_Islands,KY,0,0,64948,America,45,1
2020-04-12,Cayman_Islands,KY,8,0,64948,America,53,1
2020-04-13,Cayman_Islands,KY,0,0,64948,America,53,1
2020-04-14,Cayman_Islands,KY,0,0,64948,America,53,1
2020-04-15,Cayman_Islands,KY,1,0,64948,America,54,1
2020-04-16,Cayman_Islands,KY,6,0,64948,America,60,1
2020-04-17,Cayman_Islands,KY,1,0,64948,America,61,1
2020-04-18,Cayman_Islands,KY,0,0,64948,America,61,1
2020-04-19,Cayman_Islands,KY,0,0,64948,America,61,1
2020-04-20,Cayman_Islands,KY,0,0,64948,America,61,1
2020-04-21,Cayman_Islands,KY,5,0,64948,America,66,1
2020-04-22,Cayman_Islands,KY,0,0,64948,America,66,1
2020-04-23,Cayman_Islands,KY,0,0,64948,America,66,1
2020-04-24,Cayman_Islands,KY,0,0,64948,America,66,1
2020-04-25,Cayman_Islands,KY,0,0,64948,America,66,1
2020-04-26,Cayman_Islands,KY,4,0,64948,America,70,1
2020-04-27,Cayman_Islands,KY,0,0,64948,America,70,1
2020-04-28,Cayman_Islands,KY,0,0,64948,America,70,1
2020-04-29,Cayman_Islands,KY,0,0,64948,America,70,1
2020-04-30,Cayman_Islands,KY,3,0,64948,America,73,1
2020-05-01,Cayman_Islands,KY,0,0,64948,America,73,1
2020-05-02,Cayman_Islands,KY,1,0,64948,America,74,1
2020-05-03,Cayman_Islands,KY,0,0,64948,America,74,1
2020-05-04,Cayman_Islands,KY,0,0,64948,America,74,1
2020-05-05,Cayman_Islands,KY,1,0,64948,America,75,1
2020-05-06,Cayman_Islands,KY,0,0,64948,America,75,1
2020-05-07,Cayman_Islands,KY,3,0,64948,America,78,1
2020-05-08,Cayman_Islands,KY,0,0,64948,America,78,1
2020-05-09,Cayman_Islands,KY,3,0,64948,America,81,1
2020-05-10,Cayman_Islands,KY,0,0,64948,America,81,1
2020-05-11,Cayman_Islands,KY,0,0,64948,America,81,1
2020-05-12,Cayman_Islands,KY,3,0,64948,America,84,1
2020-05-13,Cayman_Islands,KY,1,0,64948,America,85,1
2020-05-14,Cayman_Islands,KY,0,0,64948,America,85,1
2020-05-15,Cayman_Islands,KY,8,0,64948,America,93,1
2020-05-16,Cayman_Islands,KY,0,0,64948,America,93,1
2020-05-17,Cayman_Islands,KY,1,0,64948,America,94,1
2020-05-18,Cayman_Islands,KY,0,0,64948,America,94,1
2020-05-19,Cayman_Islands,KY,0,0,64948,America,94,1
2020-05-20,Cayman_Islands,KY,17,0,64948,America,111,1
2020-05-21,Cayman_Islands,KY,0,0,64948,America,111,1
2020-05-22,Cayman_Islands,KY,0,0,64948,America,111,1
2020-05-23,Cayman_Islands,KY,10,0,64948,America,121,1
2020-05-24,Cayman_Islands,KY,8,0,64948,America,129,1
2020-05-25,Cayman_Islands,KY,0,0,64948,America,129,1
2020-05-26,Cayman_Islands,KY,5,0,64948,America,134,1
2020-05-27,Cayman_Islands,KY,3,0,64948,America,137,1
2020-05-28,Cayman_Islands,KY,3,0,64948,America,140,1
2020-05-29,Cayman_Islands,KY,0,0,64948,America,140,1
2020-05-30,Cayman_Islands,KY,1,0,64948,America,141,1
2020-05-31,Cayman_Islands,KY,0,0,64948,America,141,1
2020-06-01,Cayman_Islands,KY,0,0,64948,America,141,1
2020-06-02,Cayman_Islands,KY,9,0,64948,America,150,1
2020-06-03,Cayman_Islands,KY,1,0,64948,America,151,1
2020-06-04,Cayman_Islands,KY,5,0,64948,America,156,1
2020-06-05,Cayman_Islands,KY,4,0,64948,America,160,1
2020-06-06,Cayman_Islands,KY,4,0,64948,America,164,1
2020-06-07,Cayman_Islands,KY,0,0,64948,America,164,1
2020-06-08,Cayman_Islands,KY,0,0,64948,America,164,1
2020-06-09,Cayman_Islands,KY,7,0,64948,America,171,1
2020-06-10,Cayman_Islands,KY,5,0,64948,America,176,1
2020-06-11,Cayman_Islands,KY,4,0,64948,America,180,1
2020-06-12,Cayman_Islands,KY,0,0,64948,America,180,1
2020-06-13,Cayman_Islands,KY,7,0,64948,America,187,1
2020-06-14,Cayman_Islands,KY,0,0,64948,America,187,1
2020-06-15,Cayman_Islands,KY,0,0,64948,America,187,1
2020-06-16,Cayman_Islands,KY,0,0,64948,America,187,1
2020-06-17,Cayman_Islands,KY,6,0,64948,America,193,1
2020-06-18,Cayman_Islands,KY,0,0,64948,America,193,1
2020-06-19,Cayman_Islands,KY,0,0,64948,America,193,1
2020-06-20,Cayman_Islands,KY,2,0,64948,America,195,1
2020-06-21,Cayman_Islands,KY,0,0,64948,America,195,1
2020-06-22,Cayman_Islands,KY,0,0,64948,America,195,1
2020-06-23,Cayman_Islands,KY,0,0,64948,America,195,1
2020-06-24,Cayman_Islands,KY,0,0,64948,America,195,1
2020-06-25,Cayman_Islands,KY,1,0,64948,America,196,1
2020-06-26,Cayman_Islands,KY,0,0,64948,America,196,1
2020-06-27,Cayman_Islands,KY,0,0,64948,America,196,1
2020-06-28,Cayman_Islands,KY,0,0,64948,America,196,1
2020-06-29,Cayman_Islands,KY,0,0,64948,America,196,1
2020-06-30,Cayman_Islands,KY,3,0,64948,America,199,1
2020-07-01,Cayman_Islands,KY,1,0,64948,America,200,1
2020-07-02,Cayman_Islands,KY,1,0,64948,America,201,1
2020-07-03,Cayman_Islands,KY,0,0,64948,America,201,1
2020-07-04,Cayman_Islands,KY,0,0,64948,America,201,1
2020-07-05,Cayman_Islands,KY,0,0,64948,America,201,1
2020-07-06,Cayman_Islands,KY,0,0,64948,America,201,1
2020-07-07,Cayman_Islands,KY,0,0,64948,America,201,1
2020-07-08,Cayman_Islands,KY,0,0,64948,America,201,1
2020-07-09,Cayman_Islands,KY,0,0,64948,America,201,1
2020-07-10,Cayman_Islands,KY,0,0,64948,America,201,1
2020-07-11,Cayman_Islands,KY,0,0,64948,America,201,1
2020-07-12,Cayman_Islands,KY,0,0,64948,America,201,1
2020-07-13,Cayman_Islands,KY,0,0,64948,America,201,1
2020-07-14,Cayman_Islands,KY,0,0,64948,America,201,1
2020-07-15,Cayman_Islands,KY,2,0,64948,America,203,1
2020-07-16,Cayman_Islands,KY,0,0,64948,America,203,1
2020-07-17,Cayman_Islands,KY,0,0,64948,America,203,1
2020-07-18,Cayman_Islands,KY,0,0,64948,America,203,1
2020-07-19,Cayman_Islands,KY,0,0,64948,America,203,1
2020-07-20,Cayman_Islands,KY,0,0,64948,America,203,1
2020-07-21,Cayman_Islands,KY,0,0,64948,America,203,1
2020-07-22,Cayman_Islands,KY,0,0,64948,America,203,1
2020-07-23,Cayman_Islands,KY,0,0,64948,America,203,1
2020-07-24,Cayman_Islands,KY,0,0,64948,America,203,1
2020-07-25,Cayman_Islands,KY,0,0,64948,America,203,1
2020-07-26,Cayman_Islands,KY,0,0,64948,America,203,1
2020-07-27,Cayman_Islands,KY,0,0,64948,America,203,1
2020-07-28,Cayman_Islands,KY,0,0,64948,America,203,1
2020-07-29,Cayman_Islands,KY,0,0,64948,America,203,1
2020-07-30,Cayman_Islands,KY,0,0,64948,America,203,1
2020-07-31,Cayman_Islands,KY,0,0,64948,America,203,1
2020-08-01,Cayman_Islands,KY,0,0,64948,America,203,1
2020-08-02,Cayman_Islands,KY,0,0,64948,America,203,1
2020-08-03,Cayman_Islands,KY,0,0,64948,America,203,1
2020-08-04,Cayman_Islands,KY,0,0,64948,America,203,1
2020-08-05,Cayman_Islands,KY,0,0,64948,America,203,1
2020-08-06,Cayman_Islands,KY,0,0,64948,America,203,1
2020-08-07,Cayman_Islands,KY,0,0,64948,America,203,1
2020-08-08,Cayman_Islands,KY,0,0,64948,America,203,1
2020-08-09,Cayman_Islands,KY,0,0,64948,America,203,1
2020-08-10,Cayman_Islands,KY,0,0,64948,America,203,1
2020-08-11,Cayman_Islands,KY,0,0,64948,America,203,1
2020-08-12,Cayman_Islands,KY,0,0,64948,America,203,1
2020-08-13,Cayman_Islands,KY,0,0,64948,America,203,1
2020-08-14,Cayman_Islands,KY,0,0,64948,America,203,1
2020-08-15,Cayman_Islands,KY,0,0,64948,America,203,1
2020-08-16,Cayman_Islands,KY,0,0,64948,America,203,1
2020-08-17,Cayman_Islands,KY,0,0,64948,America,203,1
2020-08-18,Cayman_Islands,KY,0,0,64948,America,203,1
2020-08-19,Cayman_Islands,KY,0,0,64948,America,203,1
2020-08-20,Cayman_Islands,KY,2,0,64948,America,205,1
2020-08-21,Cayman_Islands,KY,0,0,64948,America,205,1
2020-08-22,Cayman_Islands,KY,0,0,64948,America,205,1
2020-08-23,Cayman_Islands,KY,0,0,64948,America,205,1
2020-08-24,Cayman_Islands,KY,0,0,64948,America,205,1
2020-08-25,Cayman_Islands,KY,0,0,64948,America,205,1
2020-08-26,Cayman_Islands,KY,0,0,64948,America,205,1
2020-08-27,Cayman_Islands,KY,0,0,64948,America,205,1
2020-08-28,Cayman_Islands,KY,0,0,64948,America,205,1
2020-08-29,Cayman_Islands,KY,0,0,64948,America,205,1
2020-08-30,Cayman_Islands,KY,0,0,64948,America,205,1
2020-08-31,Cayman_Islands,KY,0,0,64948,America,205,1
2020-09-01,Cayman_Islands,KY,0,0,64948,America,205,1
2020-09-02,Cayman_Islands,KY,0,0,64948,America,205,1
2020-09-03,Cayman_Islands,KY,0,0,64948,America,205,1
2020-09-04,Cayman_Islands,KY,0,0,64948,America,205,1
2020-09-05,Cayman_Islands,KY,0,0,64948,America,205,1
2020-09-06,Cayman_Islands,KY,0,0,64948,America,205,1
2020-09-07,Cayman_Islands,KY,0,0,64948,America,205,1
2020-09-08,Cayman_Islands,KY,0,0,64948,America,205,1
2020-09-09,Cayman_Islands,KY,0,0,64948,America,205,1
2020-09-10,Cayman_Islands,KY,2,0,64948,America,207,1
2020-09-11,Cayman_Islands,KY,1,0,64948,America,208,1
2020-09-12,Cayman_Islands,KY,0,0,64948,America,208,1
2020-09-13,Cayman_Islands,KY,0,0,64948,America,208,1
2020-09-14,Cayman_Islands,KY,0,0,64948,America,208,1
2020-09-15,Cayman_Islands,KY,0,0,64948,America,208,1
2020-09-16,Cayman_Islands,KY,0,0,64948,America,208,1
2020-09-17,Cayman_Islands,KY,0,0,64948,America,208,1
2020-09-18,Cayman_Islands,KY,0,0,64948,America,208,1
2020-09-19,Cayman_Islands,KY,1,0,64948,America,209,1
2020-09-20,Cayman_Islands,KY,0,0,64948,America,209,1
2020-09-21,Cayman_Islands,KY,0,0,64948,America,209,1
2020-09-22,Cayman_Islands,KY,1,0,64948,America,210,1
2020-09-23,Cayman_Islands,KY,0,0,64948,America,210,1
2020-09-24,Cayman_Islands,KY,0,0,64948,America,210,1
2020-09-25,Cayman_Islands,KY,0,0,64948,America,210,1
2020-09-26,Cayman_Islands,KY,0,0,64948,America,210,1
2020-09-27,Cayman_Islands,KY,0,0,64948,America,210,1
2020-09-28,Cayman_Islands,KY,0,0,64948,America,210,1
2020-09-29,Cayman_Islands,KY,1,0,64948,America,211,1
2020-09-30,Cayman_Islands,KY,0,0,64948,America,211,1
2020-10-01,Cayman_Islands,KY,0,0,64948,America,211,1
2020-10-02,Cayman_Islands,KY,0,0,64948,America,211,1
2020-10-03,Cayman_Islands,KY,2,0,64948,America,213,1
2020-10-04,Cayman_Islands,KY,0,0,64948,America,213,1
2020-10-05,Cayman_Islands,KY,0,0,64948,America,213,1
2020-10-06,Cayman_Islands,KY,0,0,64948,America,213,1
2020-10-07,Cayman_Islands,KY,0,0,64948,America,213,1
2020-10-08,Cayman_Islands,KY,0,0,64948,America,213,1
2020-10-09,Cayman_Islands,KY,1,0,64948,America,214,1
2020-10-10,Cayman_Islands,KY,0,0,64948,America,214,1
2020-10-11,Cayman_Islands,KY,7,0,64948,America,221,1
2020-10-12,Cayman_Islands,KY,0,0,64948,America,221,1
2020-10-13,Cayman_Islands,KY,0,0,64948,America,221,1
2020-10-14,Cayman_Islands,KY,0,0,64948,America,221,1
2020-10-15,Cayman_Islands,KY,4,0,64948,America,225,1
2020-10-16,Cayman_Islands,KY,0,0,64948,America,225,1
2020-10-17,Cayman_Islands,KY,8,0,64948,America,233,1
2020-10-18,Cayman_Islands,KY,0,0,64948,America,233,1
2020-10-19,Cayman_Islands,KY,0,0,64948,America,233,1
2020-10-20,Cayman_Islands,KY,2,0,64948,America,235,1
2020-10-21,Cayman_Islands,KY,0,0,64948,America,235,1
2020-10-22,Cayman_Islands,KY,0,0,64948,America,235,1
2020-10-23,Cayman_Islands,KY,1,0,64948,America,236,1
2020-10-24,Cayman_Islands,KY,3,0,64948,America,239,1
2020-10-25,Cayman_Islands,KY,0,0,64948,America,239,1
2020-10-26,Cayman_Islands,KY,0,0,64948,America,239,1
2020-10-27,Cayman_Islands,KY,0,0,64948,America,239,1
2020-10-28,Cayman_Islands,KY,0,0,64948,America,239,1
2020-10-29,Cayman_Islands,KY,0,0,64948,America,239,1
2020-10-30,Cayman_Islands,KY,0,0,64948,America,239,1
2020-10-31,Cayman_Islands,KY,1,0,64948,America,240,1
2020-11-01,Cayman_Islands,KY,0,0,64948,America,240,1
2020-11-02,Cayman_Islands,KY,0,0,64948,America,240,1
2020-11-03,Cayman_Islands,KY,0,0,64948,America,240,1
2020-11-04,Cayman_Islands,KY,2,0,64948,America,242,1
2020-11-05,Cayman_Islands,KY,0,0,64948,America,242,1
2020-11-06,Cayman_Islands,KY,2,0,64948,America,244,1
2020-11-07,Cayman_Islands,KY,1,0,64948,America,245,1
2020-11-08,Cayman_Islands,KY,5,0,64948,America,250,1
2020-11-09,Cayman_Islands,KY,0,0,64948,America,250,1
2020-11-10,Cayman_Islands,KY,0,0,64948,America,250,1
2020-11-11,Cayman_Islands,KY,3,0,64948,America,253,1
2020-11-12,Cayman_Islands,KY,0,0,64948,America,253,1
2020-11-13,Cayman_Islands,KY,0,0,64948,America,253,1
2020-11-14,Cayman_Islands,KY,1,0,64948,America,254,1
2020-11-15,Cayman_Islands,KY,0,0,64948,America,254,1
2020-11-16,Cayman_Islands,KY,0,0,64948,America,254,1
2020-11-17,Cayman_Islands,KY,3,1,64948,America,257,2
2020-11-18,Cayman_Islands,KY,0,0,64948,America,257,2
2020-11-19,Cayman_Islands,KY,1,0,64948,America,258,2
2020-11-20,Cayman_Islands,KY,1,0,64948,America,259,2
2020-11-21,Cayman_Islands,KY,2,0,64948,America,261,2
2020-11-22,Cayman_Islands,KY,0,0,64948,America,261,2
2020-11-23,Cayman_Islands,KY,0,0,64948,America,261,2
2020-11-24,Cayman_Islands,KY,4,0,64948,America,265,2
2020-11-25,Cayman_Islands,KY,0,0,64948,America,265,2
2020-11-26,Cayman_Islands,KY,1,0,64948,America,266,2
2020-11-27,Cayman_Islands,KY,3,0,64948,America,269,2
2020-11-28,Cayman_Islands,KY,0,0,64948,America,269,2
2020-11-29,Cayman_Islands,KY,5,0,64948,America,274,2
2020-11-30,Cayman_Islands,KY,0,0,64948,America,274,2
2020-12-01,Cayman_Islands,KY,8,0,64948,America,282,2
2020-12-02,Cayman_Islands,KY,3,0,64948,America,285,2
2020-12-03,Cayman_Islands,KY,0,0,64948,America,285,2
2020-12-04,Cayman_Islands,KY,3,0,64948,America,288,2
2020-12-05,Cayman_Islands,KY,0,0,64948,America,288,2
2020-12-06,Cayman_Islands,KY,0,0,64948,America,288,2
2020-12-07,Cayman_Islands,KY,0,0,64948,America,288,2
2020-12-08,Cayman_Islands,KY,2,0,64948,America,290,2
2020-12-09,Cayman_Islands,KY,1,0,64948,America,291,2
2020-12-10,Cayman_Islands,KY,1,0,64948,America,292,2
2020-12-11,Cayman_Islands,KY,0,0,64948,America,292,2
2020-12-12,Cayman_Islands,KY,6,0,64948,America,298,2
2020-12-13,Cayman_Islands,KY,0,0,64948,America,298,2
2020-12-14,Cayman_Islands,KY,0,0,64948,America,298,2
2020-03-15,Kazakhstan,KZ,6,0,18551428,Asia,6,0
2020-03-16,Kazakhstan,KZ,3,0,18551428,Asia,9,0
2020-03-17,Kazakhstan,KZ,2,0,18551428,Asia,11,0
2020-03-18,Kazakhstan,KZ,22,0,18551428,Asia,33,0
2020-03-19,Kazakhstan,KZ,4,0,18551428,Asia,37,0
2020-03-20,Kazakhstan,KZ,12,0,18551428,Asia,49,0
2020-03-21,Kazakhstan,KZ,4,0,18551428,Asia,53,0
2020-03-22,Kazakhstan,KZ,3,0,18551428,Asia,56,0
2020-03-23,Kazakhstan,KZ,4,0,18551428,Asia,60,0
2020-03-24,Kazakhstan,KZ,2,0,18551428,Asia,62,0
2020-03-25,Kazakhstan,KZ,17,0,18551428,Asia,79,0
2020-03-26,Kazakhstan,KZ,9,0,18551428,Asia,88,0
2020-03-27,Kazakhstan,KZ,32,0,18551428,Asia,120,0
2020-03-28,Kazakhstan,KZ,73,0,18551428,Asia,193,0
2020-03-29,Kazakhstan,KZ,36,0,18551428,Asia,229,0
2020-03-30,Kazakhstan,KZ,55,1,18551428,Asia,284,1
2020-03-31,Kazakhstan,KZ,41,0,18551428,Asia,325,1
2020-04-01,Kazakhstan,KZ,15,0,18551428,Asia,340,1
2020-04-02,Kazakhstan,KZ,8,1,18551428,Asia,348,2
2020-04-03,Kazakhstan,KZ,38,1,18551428,Asia,386,3
2020-04-04,Kazakhstan,KZ,74,0,18551428,Asia,460,3
2020-04-05,Kazakhstan,KZ,0,0,18551428,Asia,460,3
2020-04-06,Kazakhstan,KZ,71,2,18551428,Asia,531,5
2020-04-07,Kazakhstan,KZ,139,1,18551428,Asia,670,6
2020-04-08,Kazakhstan,KZ,34,0,18551428,Asia,704,6
2020-04-09,Kazakhstan,KZ,55,1,18551428,Asia,759,7
2020-04-10,Kazakhstan,KZ,43,2,18551428,Asia,802,9
2020-04-11,Kazakhstan,KZ,38,1,18551428,Asia,840,10
2020-04-12,Kazakhstan,KZ,40,0,18551428,Asia,880,10
2020-04-13,Kazakhstan,KZ,81,0,18551428,Asia,961,10
2020-04-14,Kazakhstan,KZ,218,4,18551428,Asia,1179,14
2020-04-15,Kazakhstan,KZ,88,0,18551428,Asia,1267,14
2020-04-16,Kazakhstan,KZ,64,2,18551428,Asia,1331,16
2020-04-17,Kazakhstan,KZ,139,1,18551428,Asia,1470,17
2020-04-18,Kazakhstan,KZ,121,0,18551428,Asia,1591,17
2020-04-19,Kazakhstan,KZ,63,0,18551428,Asia,1654,17
2020-04-20,Kazakhstan,KZ,81,2,18551428,Asia,1735,19
2020-04-21,Kazakhstan,KZ,214,0,18551428,Asia,1949,19
2020-04-22,Kazakhstan,KZ,76,0,18551428,Asia,2025,19
2020-04-23,Kazakhstan,KZ,166,0,18551428,Asia,2191,19
2020-04-24,Kazakhstan,KZ,143,3,18551428,Asia,2334,22
2020-04-25,Kazakhstan,KZ,148,3,18551428,Asia,2482,25
2020-04-26,Kazakhstan,KZ,170,0,18551428,Asia,2652,25
2020-04-27,Kazakhstan,KZ,65,0,18551428,Asia,2717,25
2020-04-28,Kazakhstan,KZ,143,0,18551428,Asia,2860,25
2020-04-29,Kazakhstan,KZ,203,0,18551428,Asia,3063,25
2020-04-30,Kazakhstan,KZ,142,0,18551428,Asia,3205,25
2020-05-01,Kazakhstan,KZ,299,0,18551428,Asia,3504,25
2020-05-02,Kazakhstan,KZ,167,0,18551428,Asia,3671,25
2020-05-03,Kazakhstan,KZ,206,0,18551428,Asia,3877,25
2020-05-04,Kazakhstan,KZ,87,2,18551428,Asia,3964,27
2020-05-05,Kazakhstan,KZ,157,2,18551428,Asia,4121,29
2020-05-06,Kazakhstan,KZ,156,0,18551428,Asia,4277,29
2020-05-07,Kazakhstan,KZ,225,1,18551428,Asia,4502,30
2020-05-08,Kazakhstan,KZ,188,1,18551428,Asia,4690,31
2020-05-09,Kazakhstan,KZ,144,0,18551428,Asia,4834,31
2020-05-10,Kazakhstan,KZ,202,0,18551428,Asia,5036,31
2020-05-11,Kazakhstan,KZ,90,0,18551428,Asia,5126,31
2020-05-12,Kazakhstan,KZ,114,1,18551428,Asia,5240,32
2020-05-13,Kazakhstan,KZ,177,0,18551428,Asia,5417,32
2020-05-14,Kazakhstan,KZ,154,0,18551428,Asia,5571,32
2020-05-15,Kazakhstan,KZ,0,0,18551428,Asia,5571,32
2020-05-16,Kazakhstan,KZ,279,2,18551428,Asia,5850,34
2020-05-17,Kazakhstan,KZ,307,0,18551428,Asia,6157,34
2020-05-18,Kazakhstan,KZ,283,0,18551428,Asia,6440,34
2020-05-19,Kazakhstan,KZ,311,1,18551428,Asia,6751,35
2020-05-20,Kazakhstan,KZ,218,0,18551428,Asia,6969,35
2020-05-21,Kazakhstan,KZ,265,0,18551428,Asia,7234,35
2020-05-22,Kazakhstan,KZ,363,0,18551428,Asia,7597,35
2020-05-23,Kazakhstan,KZ,322,0,18551428,Asia,7919,35
2020-05-24,Kazakhstan,KZ,403,0,18551428,Asia,8322,35
2020-05-25,Kazakhstan,KZ,209,0,18551428,Asia,8531,35
2020-05-26,Kazakhstan,KZ,438,0,18551428,Asia,8969,35
2020-05-27,Kazakhstan,KZ,335,2,18551428,Asia,9304,37
2020-05-28,Kazakhstan,KZ,272,0,18551428,Asia,9576,37
2020-05-29,Kazakhstan,KZ,356,0,18551428,Asia,9932,37
2020-05-30,Kazakhstan,KZ,450,0,18551428,Asia,10382,37
2020-05-31,Kazakhstan,KZ,476,1,18551428,Asia,10858,38
2020-06-01,Kazakhstan,KZ,450,3,18551428,Asia,11308,41
2020-06-02,Kazakhstan,KZ,263,0,18551428,Asia,11571,41
2020-06-03,Kazakhstan,KZ,225,3,18551428,Asia,11796,44
2020-06-04,Kazakhstan,KZ,271,4,18551428,Asia,12067,48
2020-06-05,Kazakhstan,KZ,245,4,18551428,Asia,12312,52
2020-06-06,Kazakhstan,KZ,199,0,18551428,Asia,12511,52
2020-06-07,Kazakhstan,KZ,183,1,18551428,Asia,12694,53
2020-06-08,Kazakhstan,KZ,165,3,18551428,Asia,12859,56
2020-06-09,Kazakhstan,KZ,215,2,18551428,Asia,13074,58
2020-06-10,Kazakhstan,KZ,245,3,18551428,Asia,13319,61
2020-06-11,Kazakhstan,KZ,239,6,18551428,Asia,13558,67
2020-06-12,Kazakhstan,KZ,314,0,18551428,Asia,13872,67
2020-06-13,Kazakhstan,KZ,366,3,18551428,Asia,14238,70
2020-06-14,Kazakhstan,KZ,258,3,18551428,Asia,14496,73
2020-06-15,Kazakhstan,KZ,313,4,18551428,Asia,14809,77
2020-06-16,Kazakhstan,KZ,383,4,18551428,Asia,15192,81
2020-06-17,Kazakhstan,KZ,350,7,18551428,Asia,15542,88
2020-06-18,Kazakhstan,KZ,335,12,18551428,Asia,15877,100
2020-06-19,Kazakhstan,KZ,474,5,18551428,Asia,16351,105
2020-06-20,Kazakhstan,KZ,428,8,18551428,Asia,16779,113
2020-06-21,Kazakhstan,KZ,446,5,18551428,Asia,17225,118
2020-06-22,Kazakhstan,KZ,507,2,18551428,Asia,17732,120
2020-06-23,Kazakhstan,KZ,499,7,18551428,Asia,18231,127
2020-06-24,Kazakhstan,KZ,534,7,18551428,Asia,18765,134
2020-06-25,Kazakhstan,KZ,520,2,18551428,Asia,19285,136
2020-06-26,Kazakhstan,KZ,465,11,18551428,Asia,19750,147
2020-06-27,Kazakhstan,KZ,569,3,18551428,Asia,20319,150
2020-06-28,Kazakhstan,KZ,461,23,18551428,Asia,20780,173
2020-06-29,Kazakhstan,KZ,547,10,18551428,Asia,21327,183
2020-06-30,Kazakhstan,KZ,492,5,18551428,Asia,21819,188
2020-07-01,Kazakhstan,KZ,19246,0,18551428,Asia,41065,188
2020-07-02,Kazakhstan,KZ,1509,0,18551428,Asia,42574,188
2020-07-03,Kazakhstan,KZ,1501,0,18551428,Asia,44075,188
2020-07-04,Kazakhstan,KZ,1644,0,18551428,Asia,45719,188
2020-07-05,Kazakhstan,KZ,1452,0,18551428,Asia,47171,188
2020-07-06,Kazakhstan,KZ,1403,0,18551428,Asia,48574,188
2020-07-07,Kazakhstan,KZ,1109,76,18551428,Asia,49683,264
2020-07-08,Kazakhstan,KZ,1376,0,18551428,Asia,51059,264
2020-07-09,Kazakhstan,KZ,1962,0,18551428,Asia,53021,264
2020-07-10,Kazakhstan,KZ,1726,0,18551428,Asia,54747,264
2020-07-11,Kazakhstan,KZ,1708,0,18551428,Asia,56455,264
2020-07-12,Kazakhstan,KZ,1798,0,18551428,Asia,58253,264
2020-07-13,Kazakhstan,KZ,1636,111,18551428,Asia,59889,375
2020-07-14,Kazakhstan,KZ,1866,0,18551428,Asia,61755,375
2020-07-15,Kazakhstan,KZ,1759,0,18551428,Asia,63514,375
2020-07-16,Kazakhstan,KZ,1674,0,18551428,Asia,65188,375
2020-07-17,Kazakhstan,KZ,1707,0,18551428,Asia,66895,375
2020-07-18,Kazakhstan,KZ,1808,0,18551428,Asia,68703,375
2020-07-19,Kazakhstan,KZ,1636,0,18551428,Asia,70339,375
2020-07-20,Kazakhstan,KZ,1499,0,18551428,Asia,71838,375
2020-07-21,Kazakhstan,KZ,1630,210,18551428,Asia,73468,585
2020-07-22,Kazakhstan,KZ,1685,0,18551428,Asia,75153,585
2020-07-23,Kazakhstan,KZ,1646,0,18551428,Asia,76799,585
2020-07-24,Kazakhstan,KZ,1687,0,18551428,Asia,78486,585
2020-07-25,Kazakhstan,KZ,1740,0,18551428,Asia,80226,585
2020-07-26,Kazakhstan,KZ,1494,0,18551428,Asia,81720,585
2020-07-27,Kazakhstan,KZ,1402,0,18551428,Asia,83122,585
2020-07-28,Kazakhstan,KZ,1526,0,18551428,Asia,84648,585
2020-07-29,Kazakhstan,KZ,1544,208,18551428,Asia,86192,793
2020-07-30,Kazakhstan,KZ,1472,0,18551428,Asia,87664,793
2020-07-31,Kazakhstan,KZ,1414,0,18551428,Asia,89078,793
2020-08-01,Kazakhstan,KZ,1289,0,18551428,Asia,90367,793
2020-08-02,Kazakhstan,KZ,6407,30,18551428,Asia,96774,823
2020-08-03,Kazakhstan,KZ,1867,286,18551428,Asia,98641,1109
2020-08-04,Kazakhstan,KZ,1434,0,18551428,Asia,100075,1109
2020-08-05,Kazakhstan,KZ,2861,0,18551428,Asia,102936,1109
2020-08-06,Kazakhstan,KZ,2590,0,18551428,Asia,105526,1109
2020-08-07,Kazakhstan,KZ,2404,0,18551428,Asia,107930,1109
2020-08-08,Kazakhstan,KZ,2009,0,18551428,Asia,109939,1109
2020-08-09,Kazakhstan,KZ,1883,0,18551428,Asia,111822,1109
2020-08-10,Kazakhstan,KZ,900,324,18551428,Asia,112722,1433
2020-08-11,Kazakhstan,KZ,779,0,18551428,Asia,113501,1433
2020-08-12,Kazakhstan,KZ,2114,0,18551428,Asia,115615,1433
2020-08-13,Kazakhstan,KZ,1489,0,18551428,Asia,117104,1433
2020-08-14,Kazakhstan,KZ,1410,0,18551428,Asia,118514,1433
2020-08-15,Kazakhstan,KZ,1267,47,18551428,Asia,119781,1480
2020-08-16,Kazakhstan,KZ,1380,5,18551428,Asia,121161,1485
2020-08-17,Kazakhstan,KZ,478,2,18551428,Asia,121639,1487
2020-08-18,Kazakhstan,KZ,334,148,18551428,Asia,121973,1635
2020-08-19,Kazakhstan,KZ,1352,11,18551428,Asia,123325,1646
2020-08-20,Kazakhstan,KZ,1031,6,18551428,Asia,124356,1652
2020-08-21,Kazakhstan,KZ,979,6,18551428,Asia,125335,1658
2020-08-22,Kazakhstan,KZ,908,5,18551428,Asia,126243,1663
2020-08-23,Kazakhstan,KZ,960,8,18551428,Asia,127203,1671
2020-08-24,Kazakhstan,KZ,259,2,18551428,Asia,127462,1673
2020-08-25,Kazakhstan,KZ,0,108,18551428,Asia,127462,1781
2020-08-26,Kazakhstan,KZ,0,0,18551428,Asia,127462,1781
2020-08-27,Kazakhstan,KZ,202,0,18551428,Asia,127664,1781
2020-08-28,Kazakhstan,KZ,954,0,18551428,Asia,128618,1781
2020-08-29,Kazakhstan,KZ,1422,0,18551428,Asia,130040,1781
2020-08-30,Kazakhstan,KZ,633,0,18551428,Asia,130673,1781
2020-08-31,Kazakhstan,KZ,0,0,18551428,Asia,130673,1781
2020-09-01,Kazakhstan,KZ,923,34,18551428,Asia,131596,1815
2020-09-02,Kazakhstan,KZ,99,68,18551428,Asia,131695,1883
2020-09-03,Kazakhstan,KZ,659,6,18551428,Asia,132354,1889
2020-09-04,Kazakhstan,KZ,570,4,18551428,Asia,132924,1893
2020-09-05,Kazakhstan,KZ,104,0,18551428,Asia,133028,1893
2020-09-06,Kazakhstan,KZ,896,8,18551428,Asia,133924,1901
2020-09-07,Kazakhstan,KZ,199,1,18551428,Asia,134123,1902
2020-09-08,Kazakhstan,KZ,80,1,18551428,Asia,134203,1903
2020-09-09,Kazakhstan,KZ,523,47,18551428,Asia,134726,1950
2020-09-10,Kazakhstan,KZ,433,1,18551428,Asia,135159,1951
2020-09-11,Kazakhstan,KZ,430,1,18551428,Asia,135589,1952
2020-09-12,Kazakhstan,KZ,375,2,18551428,Asia,135964,1954
2020-09-13,Kazakhstan,KZ,420,1,18551428,Asia,136384,1955
2020-09-14,Kazakhstan,KZ,129,7,18551428,Asia,136513,1962
2020-09-15,Kazakhstan,KZ,73,3,18551428,Asia,136586,1965
2020-09-16,Kazakhstan,KZ,472,38,18551428,Asia,137058,2003
2020-09-17,Kazakhstan,KZ,335,3,18551428,Asia,137393,2006
2020-09-18,Kazakhstan,KZ,320,2,18551428,Asia,137713,2008
2020-09-19,Kazakhstan,KZ,300,1,18551428,Asia,138013,2009
2020-09-20,Kazakhstan,KZ,335,5,18551428,Asia,138348,2014
2020-09-21,Kazakhstan,KZ,107,1,18551428,Asia,138455,2015
2020-09-22,Kazakhstan,KZ,87,1,18551428,Asia,138542,2016
2020-09-23,Kazakhstan,KZ,440,28,18551428,Asia,138982,2044
2020-09-24,Kazakhstan,KZ,307,1,18551428,Asia,139289,2045
2020-09-25,Kazakhstan,KZ,292,1,18551428,Asia,139581,2046
2020-09-26,Kazakhstan,KZ,301,0,18551428,Asia,139882,2046
2020-09-27,Kazakhstan,KZ,293,2,18551428,Asia,140175,2048
2020-09-28,Kazakhstan,KZ,90,1,18551428,Asia,140265,2049
2020-09-29,Kazakhstan,KZ,68,1,18551428,Asia,140333,2050
2020-09-30,Kazakhstan,KZ,374,28,18551428,Asia,140707,2078
2020-10-01,Kazakhstan,KZ,251,2,18551428,Asia,140958,2080
2020-10-02,Kazakhstan,KZ,298,2,18551428,Asia,141256,2082
2020-10-03,Kazakhstan,KZ,228,1,18551428,Asia,141484,2083
2020-10-04,Kazakhstan,KZ,264,0,18551428,Asia,141748,2083
2020-10-05,Kazakhstan,KZ,96,2,18551428,Asia,141844,2085
2020-10-06,Kazakhstan,KZ,60,0,18551428,Asia,141904,2085
2020-10-07,Kazakhstan,KZ,335,22,18551428,Asia,142239,2107
2020-10-08,Kazakhstan,KZ,358,1,18551428,Asia,142597,2108
2020-10-09,Kazakhstan,KZ,348,2,18551428,Asia,142945,2110
2020-10-10,Kazakhstan,KZ,335,1,18551428,Asia,143280,2111
2020-10-11,Kazakhstan,KZ,352,2,18551428,Asia,143632,2113
2020-10-12,Kazakhstan,KZ,108,1,18551428,Asia,143740,2114
2020-10-13,Kazakhstan,KZ,74,2,18551428,Asia,143814,2116
2020-10-14,Kazakhstan,KZ,404,25,18551428,Asia,144218,2141
2020-10-15,Kazakhstan,KZ,110,0,18551428,Asia,144328,2141
2020-10-16,Kazakhstan,KZ,433,3,18551428,Asia,144761,2144
2020-10-17,Kazakhstan,KZ,258,4,18551428,Asia,145019,2148
2020-10-18,Kazakhstan,KZ,301,1,18551428,Asia,145320,2149
2020-10-19,Kazakhstan,KZ,153,1,18551428,Asia,145473,2150
2020-10-20,Kazakhstan,KZ,130,5,18551428,Asia,145603,2155
2020-10-21,Kazakhstan,KZ,363,29,18551428,Asia,145966,2184
2020-10-22,Kazakhstan,KZ,322,2,18551428,Asia,146288,2186
2020-10-23,Kazakhstan,KZ,365,1,18551428,Asia,146653,2187
2020-10-24,Kazakhstan,KZ,329,2,18551428,Asia,146982,2189
2020-10-25,Kazakhstan,KZ,315,0,18551428,Asia,147297,2189
2020-10-26,Kazakhstan,KZ,166,1,18551428,Asia,147463,2190
2020-10-27,Kazakhstan,KZ,152,1,18551428,Asia,147615,2191
2020-10-28,Kazakhstan,KZ,422,30,18551428,Asia,148037,2221
2020-10-29,Kazakhstan,KZ,442,1,18551428,Asia,148479,2222
2020-10-30,Kazakhstan,KZ,587,2,18551428,Asia,149066,2224
2020-10-31,Kazakhstan,KZ,633,2,18551428,Asia,149699,2226
2020-11-01,Kazakhstan,KZ,681,1,18551428,Asia,150380,2227
2020-11-02,Kazakhstan,KZ,483,0,18551428,Asia,150863,2227
2020-11-03,Kazakhstan,KZ,458,34,18551428,Asia,151321,2261
2020-11-04,Kazakhstan,KZ,701,1,18551428,Asia,152022,2262
2020-11-05,Kazakhstan,KZ,703,1,18551428,Asia,152725,2263
2020-11-06,Kazakhstan,KZ,822,0,18551428,Asia,153547,2263
2020-11-07,Kazakhstan,KZ,774,2,18551428,Asia,154321,2265
2020-11-08,Kazakhstan,KZ,899,1,18551428,Asia,155220,2266
2020-11-09,Kazakhstan,KZ,656,0,18551428,Asia,155876,2266
2020-11-10,Kazakhstan,KZ,575,1,18551428,Asia,156451,2267
2020-11-11,Kazakhstan,KZ,810,0,18551428,Asia,157261,2267
2020-11-12,Kazakhstan,KZ,775,44,18551428,Asia,158036,2311
2020-11-13,Kazakhstan,KZ,817,3,18551428,Asia,158853,2314
2020-11-14,Kazakhstan,KZ,903,1,18551428,Asia,159756,2315
2020-11-15,Kazakhstan,KZ,856,2,18551428,Asia,160612,2317
2020-11-16,Kazakhstan,KZ,636,2,18551428,Asia,161248,2319
2020-11-17,Kazakhstan,KZ,625,1,18551428,Asia,161873,2320
2020-11-18,Kazakhstan,KZ,950,0,18551428,Asia,162823,2320
2020-11-19,Kazakhstan,KZ,964,48,18551428,Asia,163787,2368
2020-11-20,Kazakhstan,KZ,949,1,18551428,Asia,164736,2369
2020-11-21,Kazakhstan,KZ,976,1,18551428,Asia,165712,2370
2020-11-22,Kazakhstan,KZ,756,0,18551428,Asia,166468,2370
2020-11-23,Kazakhstan,KZ,917,2,18551428,Asia,167385,2372
2020-11-24,Kazakhstan,KZ,678,1,18551428,Asia,168063,2373
2020-11-25,Kazakhstan,KZ,944,4,18551428,Asia,169007,2377
2020-11-26,Kazakhstan,KZ,988,47,18551428,Asia,169995,2424
2020-11-27,Kazakhstan,KZ,974,5,18551428,Asia,170969,2429
2020-11-28,Kazakhstan,KZ,1010,1,18551428,Asia,171979,2430
2020-11-29,Kazakhstan,KZ,990,3,18551428,Asia,172969,2433
2020-11-30,Kazakhstan,KZ,837,0,18551428,Asia,173806,2433
2020-12-01,Kazakhstan,KZ,757,0,18551428,Asia,174563,2433
2020-12-02,Kazakhstan,KZ,1002,1,18551428,Asia,175565,2434
2020-12-03,Kazakhstan,KZ,777,2,18551428,Asia,176342,2436
2020-12-04,Kazakhstan,KZ,1044,2,18551428,Asia,177386,2438
2020-12-05,Kazakhstan,KZ,992,46,18551428,Asia,178378,2484
2020-12-06,Kazakhstan,KZ,966,4,18551428,Asia,179344,2488
2020-12-07,Kazakhstan,KZ,745,0,18551428,Asia,180089,2488
2020-12-08,Kazakhstan,KZ,688,2,18551428,Asia,180777,2490
2020-12-09,Kazakhstan,KZ,944,54,18551428,Asia,181721,2544
2020-12-10,Kazakhstan,KZ,936,2,18551428,Asia,182657,2546
2020-12-11,Kazakhstan,KZ,973,4,18551428,Asia,183630,2550
2020-12-12,Kazakhstan,KZ,927,1,18551428,Asia,184557,2551
2020-12-13,Kazakhstan,KZ,956,1,18551428,Asia,185513,2552
2020-12-14,Kazakhstan,KZ,764,0,18551428,Asia,186277,2552
2020-03-25,Laos,LA,2,0,7169456,Asia,2,0
2020-03-26,Laos,LA,0,0,7169456,Asia,2,0
2020-03-27,Laos,LA,4,0,7169456,Asia,6,0
2020-03-28,Laos,LA,0,0,7169456,Asia,6,0
2020-03-29,Laos,LA,0,0,7169456,Asia,6,0
2020-03-30,Laos,LA,0,0,7169456,Asia,6,0
2020-03-31,Laos,LA,3,0,7169456,Asia,9,0
2020-04-01,Laos,LA,0,0,7169456,Asia,9,0
2020-04-02,Laos,LA,1,0,7169456,Asia,10,0
2020-04-03,Laos,LA,0,0,7169456,Asia,10,0
2020-04-04,Laos,LA,0,0,7169456,Asia,10,0
2020-04-05,Laos,LA,0,0,7169456,Asia,10,0
2020-04-06,Laos,LA,1,0,7169456,Asia,11,0
2020-04-07,Laos,LA,1,0,7169456,Asia,12,0
2020-04-08,Laos,LA,0,0,7169456,Asia,12,0
2020-04-09,Laos,LA,3,0,7169456,Asia,15,0
2020-04-10,Laos,LA,1,0,7169456,Asia,16,0
2020-04-11,Laos,LA,0,0,7169456,Asia,16,0
2020-04-12,Laos,LA,2,0,7169456,Asia,18,0
2020-04-13,Laos,LA,1,0,7169456,Asia,19,0
2020-04-14,Laos,LA,0,0,7169456,Asia,19,0
2020-04-15,Laos,LA,0,0,7169456,Asia,19,0
2020-04-16,Laos,LA,0,0,7169456,Asia,19,0
2020-04-17,Laos,LA,0,0,7169456,Asia,19,0
2020-04-18,Laos,LA,0,0,7169456,Asia,19,0
2020-04-19,Laos,LA,0,0,7169456,Asia,19,0
2020-04-20,Laos,LA,0,0,7169456,Asia,19,0
2020-04-21,Laos,LA,0,0,7169456,Asia,19,0
2020-04-22,Laos,LA,0,0,7169456,Asia,19,0
2020-04-23,Laos,LA,0,0,7169456,Asia,19,0
2020-04-24,Laos,LA,0,0,7169456,Asia,19,0
2020-04-25,Laos,LA,0,0,7169456,Asia,19,0
2020-04-26,Laos,LA,0,0,7169456,Asia,19,0
2020-04-27,Laos,LA,0,0,7169456,Asia,19,0
2020-04-28,Laos,LA,0,0,7169456,Asia,19,0
2020-04-29,Laos,LA,0,0,7169456,Asia,19,0
2020-04-30,Laos,LA,0,0,7169456,Asia,19,0
2020-05-01,Laos,LA,0,0,7169456,Asia,19,0
2020-05-02,Laos,LA,0,0,7169456,Asia,19,0
2020-05-03,Laos,LA,0,0,7169456,Asia,19,0
2020-05-04,Laos,LA,0,0,7169456,Asia,19,0
2020-05-05,Laos,LA,0,0,7169456,Asia,19,0
2020-05-06,Laos,LA,0,0,7169456,Asia,19,0
2020-05-07,Laos,LA,0,0,7169456,Asia,19,0
2020-05-08,Laos,LA,0,0,7169456,Asia,19,0
2020-05-09,Laos,LA,0,0,7169456,Asia,19,0
2020-05-10,Laos,LA,0,0,7169456,Asia,19,0
2020-05-11,Laos,LA,0,0,7169456,Asia,19,0
2020-05-12,Laos,LA,0,0,7169456,Asia,19,0
2020-05-13,Laos,LA,0,0,7169456,Asia,19,0
2020-05-14,Laos,LA,0,0,7169456,Asia,19,0
2020-05-15,Laos,LA,0,0,7169456,Asia,19,0
2020-05-16,Laos,LA,0,0,7169456,Asia,19,0
2020-05-17,Laos,LA,0,0,7169456,Asia,19,0
2020-05-18,Laos,LA,0,0,7169456,Asia,19,0
2020-05-19,Laos,LA,0,0,7169456,Asia,19,0
2020-05-20,Laos,LA,0,0,7169456,Asia,19,0
2020-05-21,Laos,LA,0,0,7169456,Asia,19,0
2020-05-22,Laos,LA,0,0,7169456,Asia,19,0
2020-05-23,Laos,LA,0,0,7169456,Asia,19,0
2020-05-24,Laos,LA,0,0,7169456,Asia,19,0
2020-05-25,Laos,LA,0,0,7169456,Asia,19,0
2020-05-26,Laos,LA,0,0,7169456,Asia,19,0
2020-05-27,Laos,LA,0,0,7169456,Asia,19,0
2020-05-28,Laos,LA,0,0,7169456,Asia,19,0
2020-05-29,Laos,LA,0,0,7169456,Asia,19,0
2020-05-30,Laos,LA,0,0,7169456,Asia,19,0
2020-05-31,Laos,LA,0,0,7169456,Asia,19,0
2020-06-01,Laos,LA,0,0,7169456,Asia,19,0
2020-06-02,Laos,LA,0,0,7169456,Asia,19,0
2020-06-03,Laos,LA,0,0,7169456,Asia,19,0
2020-06-04,Laos,LA,0,0,7169456,Asia,19,0
2020-06-05,Laos,LA,0,0,7169456,Asia,19,0
2020-06-06,Laos,LA,0,0,7169456,Asia,19,0
2020-06-07,Laos,LA,0,0,7169456,Asia,19,0
2020-06-08,Laos,LA,0,0,7169456,Asia,19,0
2020-06-09,Laos,LA,0,0,7169456,Asia,19,0
2020-06-10,Laos,LA,0,0,7169456,Asia,19,0
2020-06-11,Laos,LA,0,0,7169456,Asia,19,0
2020-06-12,Laos,LA,0,0,7169456,Asia,19,0
2020-06-13,Laos,LA,0,0,7169456,Asia,19,0
2020-06-14,Laos,LA,0,0,7169456,Asia,19,0
2020-06-15,Laos,LA,0,0,7169456,Asia,19,0
2020-06-16,Laos,LA,0,0,7169456,Asia,19,0
2020-06-17,Laos,LA,0,0,7169456,Asia,19,0
2020-06-18,Laos,LA,0,0,7169456,Asia,19,0
2020-06-19,Laos,LA,0,0,7169456,Asia,19,0
2020-06-20,Laos,LA,0,0,7169456,Asia,19,0
2020-06-21,Laos,LA,0,0,7169456,Asia,19,0
2020-06-22,Laos,LA,0,0,7169456,Asia,19,0
2020-06-23,Laos,LA,0,0,7169456,Asia,19,0
2020-06-24,Laos,LA,0,0,7169456,Asia,19,0
2020-06-25,Laos,LA,0,0,7169456,Asia,19,0
2020-06-26,Laos,LA,0,0,7169456,Asia,19,0
2020-06-27,Laos,LA,0,0,7169456,Asia,19,0
2020-06-28,Laos,LA,0,0,7169456,Asia,19,0
2020-06-29,Laos,LA,0,0,7169456,Asia,19,0
2020-06-30,Laos,LA,0,0,7169456,Asia,19,0
2020-07-01,Laos,LA,0,0,7169456,Asia,19,0
2020-07-02,Laos,LA,0,0,7169456,Asia,19,0
2020-07-03,Laos,LA,0,0,7169456,Asia,19,0
2020-07-04,Laos,LA,0,0,7169456,Asia,19,0
2020-07-05,Laos,LA,0,0,7169456,Asia,19,0
2020-07-06,Laos,LA,0,0,7169456,Asia,19,0
2020-07-07,Laos,LA,0,0,7169456,Asia,19,0
2020-07-08,Laos,LA,0,0,7169456,Asia,19,0
2020-07-09,Laos,LA,0,0,7169456,Asia,19,0
2020-07-10,Laos,LA,0,0,7169456,Asia,19,0
2020-07-11,Laos,LA,0,0,7169456,Asia,19,0
2020-07-12,Laos,LA,0,0,7169456,Asia,19,0
2020-07-13,Laos,LA,0,0,7169456,Asia,19,0
2020-07-14,Laos,LA,0,0,7169456,Asia,19,0
2020-07-15,Laos,LA,0,0,7169456,Asia,19,0
2020-07-16,Laos,LA,0,0,7169456,Asia,19,0
2020-07-17,Laos,LA,0,0,7169456,Asia,19,0
2020-07-18,Laos,LA,0,0,7169456,Asia,19,0
2020-07-19,Laos,LA,0,0,7169456,Asia,19,0
2020-07-20,Laos,LA,0,0,7169456,Asia,19,0
2020-07-21,Laos,LA,0,0,7169456,Asia,19,0
2020-07-22,Laos,LA,0,0,7169456,Asia,19,0
2020-07-23,Laos,LA,0,0,7169456,Asia,19,0
2020-07-24,Laos,LA,0,0,7169456,Asia,19,0
2020-07-25,Laos,LA,1,0,7169456,Asia,20,0
2020-07-26,Laos,LA,0,0,7169456,Asia,20,0
2020-07-27,Laos,LA,0,0,7169456,Asia,20,0
2020-07-28,Laos,LA,0,0,7169456,Asia,20,0
2020-07-29,Laos,LA,0,0,7169456,Asia,20,0
2020-07-30,Laos,LA,0,0,7169456,Asia,20,0
2020-07-31,Laos,LA,0,0,7169456,Asia,20,0
2020-08-01,Laos,LA,0,0,7169456,Asia,20,0
2020-08-02,Laos,LA,0,0,7169456,Asia,20,0
2020-08-03,Laos,LA,0,0,7169456,Asia,20,0
2020-08-04,Laos,LA,0,0,7169456,Asia,20,0
2020-08-05,Laos,LA,0,0,7169456,Asia,20,0
2020-08-06,Laos,LA,0,0,7169456,Asia,20,0
2020-08-07,Laos,LA,0,0,7169456,Asia,20,0
2020-08-08,Laos,LA,0,0,7169456,Asia,20,0
2020-08-09,Laos,LA,0,0,7169456,Asia,20,0
2020-08-10,Laos,LA,0,0,7169456,Asia,20,0
2020-08-11,Laos,LA,0,0,7169456,Asia,20,0
2020-08-12,Laos,LA,0,0,7169456,Asia,20,0
2020-08-13,Laos,LA,0,0,7169456,Asia,20,0
2020-08-14,Laos,LA,0,0,7169456,Asia,20,0
2020-08-15,Laos,LA,0,0,7169456,Asia,20,0
2020-08-16,Laos,LA,0,0,7169456,Asia,20,0
2020-08-17,Laos,LA,0,0,7169456,Asia,20,0
2020-08-18,Laos,LA,0,0,7169456,Asia,20,0
2020-08-19,Laos,LA,0,0,7169456,Asia,20,0
2020-08-20,Laos,LA,0,0,7169456,Asia,20,0
2020-08-21,Laos,LA,0,0,7169456,Asia,20,0
2020-08-22,Laos,LA,2,0,7169456,Asia,22,0
2020-08-23,Laos,LA,0,0,7169456,Asia,22,0
2020-08-24,Laos,LA,0,0,7169456,Asia,22,0
2020-08-25,Laos,LA,0,0,7169456,Asia,22,0
2020-08-26,Laos,LA,0,0,7169456,Asia,22,0
2020-08-27,Laos,LA,0,0,7169456,Asia,22,0
2020-08-28,Laos,LA,0,0,7169456,Asia,22,0
2020-08-29,Laos,LA,0,0,7169456,Asia,22,0
2020-08-30,Laos,LA,0,0,7169456,Asia,22,0
2020-08-31,Laos,LA,0,0,7169456,Asia,22,0
2020-09-01,Laos,LA,0,0,7169456,Asia,22,0
2020-09-02,Laos,LA,0,0,7169456,Asia,22,0
2020-09-03,Laos,LA,0,0,7169456,Asia,22,0
2020-09-04,Laos,LA,0,0,7169456,Asia,22,0
2020-09-05,Laos,LA,0,0,7169456,Asia,22,0
2020-09-06,Laos,LA,0,0,7169456,Asia,22,0
2020-09-07,Laos,LA,0,0,7169456,Asia,22,0
2020-09-08,Laos,LA,0,0,7169456,Asia,22,0
2020-09-09,Laos,LA,0,0,7169456,Asia,22,0
2020-09-10,Laos,LA,0,0,7169456,Asia,22,0
2020-09-11,Laos,LA,0,0,7169456,Asia,22,0
2020-09-12,Laos,LA,1,0,7169456,Asia,23,0
2020-09-13,Laos,LA,0,0,7169456,Asia,23,0
2020-09-14,Laos,LA,0,0,7169456,Asia,23,0
2020-09-15,Laos,LA,0,0,7169456,Asia,23,0
2020-09-16,Laos,LA,0,0,7169456,Asia,23,0
2020-09-17,Laos,LA,0,0,7169456,Asia,23,0
2020-09-18,Laos,LA,0,0,7169456,Asia,23,0
2020-09-19,Laos,LA,0,0,7169456,Asia,23,0
2020-09-20,Laos,LA,0,0,7169456,Asia,23,0
2020-09-21,Laos,LA,0,0,7169456,Asia,23,0
2020-09-22,Laos,LA,0,0,7169456,Asia,23,0
2020-09-23,Laos,LA,0,0,7169456,Asia,23,0
2020-09-24,Laos,LA,0,0,7169456,Asia,23,0
2020-09-25,Laos,LA,0,0,7169456,Asia,23,0
2020-09-26,Laos,LA,0,0,7169456,Asia,23,0
2020-09-27,Laos,LA,0,0,7169456,Asia,23,0
2020-09-28,Laos,LA,0,0,7169456,Asia,23,0
2020-09-29,Laos,LA,0,0,7169456,Asia,23,0
2020-09-30,Laos,LA,0,0,7169456,Asia,23,0
2020-10-01,Laos,LA,0,0,7169456,Asia,23,0
2020-10-02,Laos,LA,0,0,7169456,Asia,23,0
2020-10-03,Laos,LA,0,0,7169456,Asia,23,0
2020-10-04,Laos,LA,0,0,7169456,Asia,23,0
2020-10-05,Laos,LA,0,0,7169456,Asia,23,0
2020-10-06,Laos,LA,0,0,7169456,Asia,23,0
2020-10-07,Laos,LA,0,0,7169456,Asia,23,0
2020-10-08,Laos,LA,0,0,7169456,Asia,23,0
2020-10-09,Laos,LA,0,0,7169456,Asia,23,0
2020-10-10,Laos,LA,0,0,7169456,Asia,23,0
2020-10-11,Laos,LA,0,0,7169456,Asia,23,0
2020-10-12,Laos,LA,0,0,7169456,Asia,23,0
2020-10-13,Laos,LA,0,0,7169456,Asia,23,0
2020-10-14,Laos,LA,0,0,7169456,Asia,23,0
2020-10-15,Laos,LA,0,0,7169456,Asia,23,0
2020-10-16,Laos,LA,0,0,7169456,Asia,23,0
2020-10-17,Laos,LA,0,0,7169456,Asia,23,0
2020-10-18,Laos,LA,0,0,7169456,Asia,23,0
2020-10-19,Laos,LA,0,0,7169456,Asia,23,0
2020-10-20,Laos,LA,0,0,7169456,Asia,23,0
2020-10-21,Laos,LA,0,0,7169456,Asia,23,0
2020-10-22,Laos,LA,1,0,7169456,Asia,24,0
2020-10-23,Laos,LA,0,0,7169456,Asia,24,0
2020-10-24,Laos,LA,0,0,7169456,Asia,24,0
2020-10-25,Laos,LA,0,0,7169456,Asia,24,0
2020-10-26,Laos,LA,0,0,7169456,Asia,24,0
2020-10-27,Laos,LA,0,0,7169456,Asia,24,0
2020-10-28,Laos,LA,0,0,7169456,Asia,24,0
2020-10-29,Laos,LA,0,0,7169456,Asia,24,0
2020-10-30,Laos,LA,0,0,7169456,Asia,24,0
2020-10-31,Laos,LA,0,0,7169456,Asia,24,0
2020-11-01,Laos,LA,0,0,7169456,Asia,24,0
2020-11-02,Laos,LA,0,0,7169456,Asia,24,0
2020-11-03,Laos,LA,0,0,7169456,Asia,24,0
2020-11-04,Laos,LA,0,0,7169456,Asia,24,0
2020-11-05,Laos,LA,0,0,7169456,Asia,24,0
2020-11-06,Laos,LA,0,0,7169456,Asia,24,0
2020-11-07,Laos,LA,0,0,7169456,Asia,24,0
2020-11-08,Laos,LA,0,0,7169456,Asia,24,0
2020-11-09,Laos,LA,0,0,7169456,Asia,24,0
2020-11-10,Laos,LA,0,0,7169456,Asia,24,0
2020-11-11,Laos,LA,0,0,7169456,Asia,24,0
2020-11-12,Laos,LA,0,0,7169456,Asia,24,0
2020-11-13,Laos,LA,0,0,7169456,Asia,24,0
2020-11-14,Laos,LA,0,0,7169456,Asia,24,0
2020-11-15,Laos,LA,0,0,7169456,Asia,24,0
2020-11-16,Laos,LA,0,0,7169456,Asia,24,0
2020-11-17,Laos,LA,0,0,7169456,Asia,24,0
2020-11-18,Laos,LA,0,0,7169456,Asia,24,0
2020-11-19,Laos,LA,0,0,7169456,Asia,24,0
2020-11-20,Laos,LA,0,0,7169456,Asia,24,0
2020-11-21,Laos,LA,0,0,7169456,Asia,24,0
2020-11-22,Laos,LA,0,0,7169456,Asia,24,0
2020-11-23,Laos,LA,0,0,7169456,Asia,24,0
2020-11-24,Laos,LA,14,0,7169456,Asia,38,0
2020-11-25,Laos,LA,0,0,7169456,Asia,38,0
2020-11-26,Laos,LA,0,0,7169456,Asia,38,0
2020-11-27,Laos,LA,0,0,7169456,Asia,38,0
2020-11-28,Laos,LA,1,0,7169456,Asia,39,0
2020-11-29,Laos,LA,0,0,7169456,Asia,39,0
2020-11-30,Laos,LA,0,0,7169456,Asia,39,0
2020-12-01,Laos,LA,0,0,7169456,Asia,39,0
2020-12-02,Laos,LA,0,0,7169456,Asia,39,0
2020-12-03,Laos,LA,0,0,7169456,Asia,39,0
2020-12-04,Laos,LA,0,0,7169456,Asia,39,0
2020-12-05,Laos,LA,0,0,7169456,Asia,39,0
2020-12-06,Laos,LA,0,0,7169456,Asia,39,0
2020-12-07,Laos,LA,2,0,7169456,Asia,41,0
2020-12-08,Laos,LA,0,0,7169456,Asia,41,0
2020-12-09,Laos,LA,0,0,7169456,Asia,41,0
2020-12-10,Laos,LA,0,0,7169456,Asia,41,0
2020-12-11,Laos,LA,0,0,7169456,Asia,41,0
2020-12-12,Laos,LA,0,0,7169456,Asia,41,0
2020-12-13,Laos,LA,0,0,7169456,Asia,41,0
2020-12-14,Laos,LA,0,0,7169456,Asia,41,0
2019-12-31,Lebanon,LB,0,0,6855709,Asia,0,0
2020-01-01,Lebanon,LB,0,0,6855709,Asia,0,0
2020-01-02,Lebanon,LB,0,0,6855709,Asia,0,0
2020-01-03,Lebanon,LB,0,0,6855709,Asia,0,0
2020-01-04,Lebanon,LB,0,0,6855709,Asia,0,0
2020-01-05,Lebanon,LB,0,0,6855709,Asia,0,0
2020-01-06,Lebanon,LB,0,0,6855709,Asia,0,0
2020-01-07,Lebanon,LB,0,0,6855709,Asia,0,0
2020-01-08,Lebanon,LB,0,0,6855709,Asia,0,0
2020-01-09,Lebanon,LB,0,0,6855709,Asia,0,0
2020-01-10,Lebanon,LB,0,0,6855709,Asia,0,0
2020-01-11,Lebanon,LB,0,0,6855709,Asia,0,0
2020-01-12,Lebanon,LB,0,0,6855709,Asia,0,0
2020-01-13,Lebanon,LB,0,0,6855709,Asia,0,0
2020-01-14,Lebanon,LB,0,0,6855709,Asia,0,0
2020-01-15,Lebanon,LB,0,0,6855709,Asia,0,0
2020-01-16,Lebanon,LB,0,0,6855709,Asia,0,0
2020-01-17,Lebanon,LB,0,0,6855709,Asia,0,0
2020-01-18,Lebanon,LB,0,0,6855709,Asia,0,0
2020-01-19,Lebanon,LB,0,0,6855709,Asia,0,0
2020-01-20,Lebanon,LB,0,0,6855709,Asia,0,0
2020-01-21,Lebanon,LB,0,0,6855709,Asia,0,0
2020-01-22,Lebanon,LB,0,0,6855709,Asia,0,0
2020-01-23,Lebanon,LB,0,0,6855709,Asia,0,0
2020-01-24,Lebanon,LB,0,0,6855709,Asia,0,0
2020-01-25,Lebanon,LB,0,0,6855709,Asia,0,0
2020-01-26,Lebanon,LB,0,0,6855709,Asia,0,0
2020-01-27,Lebanon,LB,0,0,6855709,Asia,0,0
2020-01-28,Lebanon,LB,0,0,6855709,Asia,0,0
2020-01-29,Lebanon,LB,0,0,6855709,Asia,0,0
2020-01-30,Lebanon,LB,0,0,6855709,Asia,0,0
2020-01-31,Lebanon,LB,0,0,6855709,Asia,0,0
2020-02-01,Lebanon,LB,0,0,6855709,Asia,0,0
2020-02-02,Lebanon,LB,0,0,6855709,Asia,0,0
2020-02-03,Lebanon,LB,0,0,6855709,Asia,0,0
2020-02-04,Lebanon,LB,0,0,6855709,Asia,0,0
2020-02-05,Lebanon,LB,0,0,6855709,Asia,0,0
2020-02-06,Lebanon,LB,0,0,6855709,Asia,0,0
2020-02-07,Lebanon,LB,0,0,6855709,Asia,0,0
2020-02-08,Lebanon,LB,0,0,6855709,Asia,0,0
2020-02-09,Lebanon,LB,0,0,6855709,Asia,0,0
2020-02-10,Lebanon,LB,0,0,6855709,Asia,0,0
2020-02-11,Lebanon,LB,0,0,6855709,Asia,0,0
2020-02-12,Lebanon,LB,0,0,6855709,Asia,0,0
2020-02-13,Lebanon,LB,0,0,6855709,Asia,0,0
2020-02-14,Lebanon,LB,0,0,6855709,Asia,0,0
2020-02-15,Lebanon,LB,0,0,6855709,Asia,0,0
2020-02-16,Lebanon,LB,0,0,6855709,Asia,0,0
2020-02-17,Lebanon,LB,0,0,6855709,Asia,0,0
2020-02-18,Lebanon,LB,0,0,6855709,Asia,0,0
2020-02-19,Lebanon,LB,0,0,6855709,Asia,0,0
2020-02-20,Lebanon,LB,0,0,6855709,Asia,0,0
2020-02-21,Lebanon,LB,0,0,6855709,Asia,0,0
2020-02-22,Lebanon,LB,1,0,6855709,Asia,1,0
2020-02-23,Lebanon,LB,0,0,6855709,Asia,1,0
2020-02-24,Lebanon,LB,0,0,6855709,Asia,1,0
2020-02-25,Lebanon,LB,0,0,6855709,Asia,1,0
2020-02-26,Lebanon,LB,0,0,6855709,Asia,1,0
2020-02-27,Lebanon,LB,1,0,6855709,Asia,2,0
2020-02-28,Lebanon,LB,1,0,6855709,Asia,3,0
2020-02-29,Lebanon,LB,0,0,6855709,Asia,3,0
2020-03-01,Lebanon,LB,1,0,6855709,Asia,4,0
2020-03-02,Lebanon,LB,6,0,6855709,Asia,10,0
2020-03-03,Lebanon,LB,3,0,6855709,Asia,13,0
2020-03-06,Lebanon,LB,3,0,6855709,Asia,16,0
2020-03-07,Lebanon,LB,6,0,6855709,Asia,22,0
2020-03-09,Lebanon,LB,10,0,6855709,Asia,32,0
2020-03-10,Lebanon,LB,9,0,6855709,Asia,41,0
2020-03-11,Lebanon,LB,0,1,6855709,Asia,41,1
2020-03-12,Lebanon,LB,20,1,6855709,Asia,61,2
2020-03-13,Lebanon,LB,5,0,6855709,Asia,66,2
2020-03-15,Lebanon,LB,27,1,6855709,Asia,93,3
2020-03-16,Lebanon,LB,6,0,6855709,Asia,99,3
2020-03-17,Lebanon,LB,21,0,6855709,Asia,120,3
2020-03-18,Lebanon,LB,0,0,6855709,Asia,120,3
2020-03-19,Lebanon,LB,13,1,6855709,Asia,133,4
2020-03-20,Lebanon,LB,16,0,6855709,Asia,149,4
2020-03-21,Lebanon,LB,14,0,6855709,Asia,163,4
2020-03-22,Lebanon,LB,67,0,6855709,Asia,230,4
2020-03-23,Lebanon,LB,18,0,6855709,Asia,248,4
2020-03-24,Lebanon,LB,19,0,6855709,Asia,267,4
2020-03-25,Lebanon,LB,37,0,6855709,Asia,304,4
2020-03-26,Lebanon,LB,29,0,6855709,Asia,333,4
2020-03-27,Lebanon,LB,35,2,6855709,Asia,368,6
2020-03-28,Lebanon,LB,23,1,6855709,Asia,391,7
2020-03-29,Lebanon,LB,21,1,6855709,Asia,412,8
2020-03-30,Lebanon,LB,26,2,6855709,Asia,438,10
2020-03-31,Lebanon,LB,8,1,6855709,Asia,446,11
2020-04-01,Lebanon,LB,17,1,6855709,Asia,463,12
2020-04-02,Lebanon,LB,16,0,6855709,Asia,479,12
2020-04-03,Lebanon,LB,15,4,6855709,Asia,494,16
2020-04-04,Lebanon,LB,0,0,6855709,Asia,494,16
2020-04-05,Lebanon,LB,26,1,6855709,Asia,520,17
2020-04-06,Lebanon,LB,7,1,6855709,Asia,527,18
2020-04-07,Lebanon,LB,14,1,6855709,Asia,541,19
2020-04-08,Lebanon,LB,7,0,6855709,Asia,548,19
2020-04-09,Lebanon,LB,27,0,6855709,Asia,575,19
2020-04-10,Lebanon,LB,7,0,6855709,Asia,582,19
2020-04-11,Lebanon,LB,27,1,6855709,Asia,609,20
2020-04-12,Lebanon,LB,10,0,6855709,Asia,619,20
2020-04-13,Lebanon,LB,11,0,6855709,Asia,630,20
2020-04-14,Lebanon,LB,2,0,6855709,Asia,632,20
2020-04-15,Lebanon,LB,9,1,6855709,Asia,641,21
2020-04-16,Lebanon,LB,17,0,6855709,Asia,658,21
2020-04-17,Lebanon,LB,5,0,6855709,Asia,663,21
2020-04-18,Lebanon,LB,5,0,6855709,Asia,668,21
2020-04-19,Lebanon,LB,4,0,6855709,Asia,672,21
2020-04-20,Lebanon,LB,1,0,6855709,Asia,673,21
2020-04-21,Lebanon,LB,4,0,6855709,Asia,677,21
2020-04-22,Lebanon,LB,0,0,6855709,Asia,677,21
2020-04-23,Lebanon,LB,5,1,6855709,Asia,682,22
2020-04-24,Lebanon,LB,6,0,6855709,Asia,688,22
2020-04-25,Lebanon,LB,8,0,6855709,Asia,696,22
2020-04-26,Lebanon,LB,8,2,6855709,Asia,704,24
2020-04-27,Lebanon,LB,3,0,6855709,Asia,707,24
2020-04-28,Lebanon,LB,3,0,6855709,Asia,710,24
2020-04-29,Lebanon,LB,7,0,6855709,Asia,717,24
2020-04-30,Lebanon,LB,4,0,6855709,Asia,721,24
2020-05-01,Lebanon,LB,4,0,6855709,Asia,725,24
2020-05-02,Lebanon,LB,4,0,6855709,Asia,729,24
2020-05-03,Lebanon,LB,4,1,6855709,Asia,733,25
2020-05-04,Lebanon,LB,4,0,6855709,Asia,737,25
2020-05-05,Lebanon,LB,3,0,6855709,Asia,740,25
2020-05-06,Lebanon,LB,1,0,6855709,Asia,741,25
2020-05-07,Lebanon,LB,9,0,6855709,Asia,750,25
2020-05-08,Lebanon,LB,34,0,6855709,Asia,784,25
2020-05-09,Lebanon,LB,12,1,6855709,Asia,796,26
2020-05-10,Lebanon,LB,13,0,6855709,Asia,809,26
2020-05-11,Lebanon,LB,36,0,6855709,Asia,845,26
2020-05-12,Lebanon,LB,14,0,6855709,Asia,859,26
2020-05-13,Lebanon,LB,11,0,6855709,Asia,870,26
2020-05-14,Lebanon,LB,8,0,6855709,Asia,878,26
2020-05-15,Lebanon,LB,8,0,6855709,Asia,886,26
2020-05-16,Lebanon,LB,5,0,6855709,Asia,891,26
2020-05-17,Lebanon,LB,11,0,6855709,Asia,902,26
2020-05-18,Lebanon,LB,9,0,6855709,Asia,911,26
2020-05-19,Lebanon,LB,20,0,6855709,Asia,931,26
2020-05-20,Lebanon,LB,23,0,6855709,Asia,954,26
2020-05-21,Lebanon,LB,7,0,6855709,Asia,961,26
2020-05-22,Lebanon,LB,63,0,6855709,Asia,1024,26
2020-05-23,Lebanon,LB,62,0,6855709,Asia,1086,26
2020-05-24,Lebanon,LB,11,0,6855709,Asia,1097,26
2020-05-25,Lebanon,LB,17,0,6855709,Asia,1114,26
2020-05-26,Lebanon,LB,5,0,6855709,Asia,1119,26
2020-05-27,Lebanon,LB,21,0,6855709,Asia,1140,26
2020-05-28,Lebanon,LB,21,0,6855709,Asia,1161,26
2020-05-29,Lebanon,LB,7,0,6855709,Asia,1168,26
2020-05-30,Lebanon,LB,4,0,6855709,Asia,1172,26
2020-05-31,Lebanon,LB,19,0,6855709,Asia,1191,26
2020-06-01,Lebanon,LB,29,1,6855709,Asia,1220,27
2020-06-02,Lebanon,LB,13,0,6855709,Asia,1233,27
2020-06-03,Lebanon,LB,9,0,6855709,Asia,1242,27
2020-06-04,Lebanon,LB,14,0,6855709,Asia,1256,27
2020-06-05,Lebanon,LB,50,1,6855709,Asia,1306,28
2020-06-06,Lebanon,LB,6,0,6855709,Asia,1312,28
2020-06-07,Lebanon,LB,8,1,6855709,Asia,1320,29
2020-06-08,Lebanon,LB,11,1,6855709,Asia,1331,30
2020-06-09,Lebanon,LB,19,0,6855709,Asia,1350,30
2020-06-10,Lebanon,LB,18,0,6855709,Asia,1368,30
2020-06-11,Lebanon,LB,20,0,6855709,Asia,1388,30
2020-06-12,Lebanon,LB,14,1,6855709,Asia,1402,31
2020-06-13,Lebanon,LB,20,0,6855709,Asia,1422,31
2020-06-14,Lebanon,LB,20,1,6855709,Asia,1442,32
2020-06-15,Lebanon,LB,4,0,6855709,Asia,1446,32
2020-06-16,Lebanon,LB,18,0,6855709,Asia,1464,32
2020-06-17,Lebanon,LB,9,0,6855709,Asia,1473,32
2020-06-18,Lebanon,LB,16,0,6855709,Asia,1489,32
2020-06-19,Lebanon,LB,6,0,6855709,Asia,1495,32
2020-06-20,Lebanon,LB,15,0,6855709,Asia,1510,32
2020-06-21,Lebanon,LB,26,0,6855709,Asia,1536,32
2020-06-22,Lebanon,LB,51,0,6855709,Asia,1587,32
2020-06-23,Lebanon,LB,16,0,6855709,Asia,1603,32
2020-06-24,Lebanon,LB,19,0,6855709,Asia,1622,32
2020-06-25,Lebanon,LB,22,1,6855709,Asia,1644,33
2020-06-26,Lebanon,LB,18,0,6855709,Asia,1662,33
2020-06-27,Lebanon,LB,35,0,6855709,Asia,1697,33
2020-06-28,Lebanon,LB,22,0,6855709,Asia,1719,33
2020-06-29,Lebanon,LB,21,1,6855709,Asia,1740,34
2020-06-30,Lebanon,LB,5,0,6855709,Asia,1745,34
2020-07-01,Lebanon,LB,33,0,6855709,Asia,1778,34
2020-07-02,Lebanon,LB,10,0,6855709,Asia,1788,34
2020-07-03,Lebanon,LB,8,1,6855709,Asia,1796,35
2020-07-04,Lebanon,LB,34,0,6855709,Asia,1830,35
2020-07-05,Lebanon,LB,25,0,6855709,Asia,1855,35
2020-07-06,Lebanon,LB,18,1,6855709,Asia,1873,36
2020-07-07,Lebanon,LB,12,0,6855709,Asia,1885,36
2020-07-08,Lebanon,LB,22,0,6855709,Asia,1907,36
2020-07-09,Lebanon,LB,39,0,6855709,Asia,1946,36
2020-07-10,Lebanon,LB,65,0,6855709,Asia,2011,36
2020-07-11,Lebanon,LB,71,0,6855709,Asia,2082,36
2020-07-12,Lebanon,LB,86,0,6855709,Asia,2168,36
2020-07-13,Lebanon,LB,166,0,6855709,Asia,2334,36
2020-07-14,Lebanon,LB,85,0,6855709,Asia,2419,36
2020-07-15,Lebanon,LB,32,1,6855709,Asia,2451,37
2020-07-16,Lebanon,LB,91,1,6855709,Asia,2542,38
2020-07-17,Lebanon,LB,57,2,6855709,Asia,2599,40
2020-07-18,Lebanon,LB,101,0,6855709,Asia,2700,40
2020-07-19,Lebanon,LB,75,0,6855709,Asia,2775,40
2020-07-20,Lebanon,LB,84,0,6855709,Asia,2859,40
2020-07-21,Lebanon,LB,46,1,6855709,Asia,2905,41
2020-07-22,Lebanon,LB,75,0,6855709,Asia,2980,41
2020-07-23,Lebanon,LB,124,2,6855709,Asia,3104,43
2020-07-24,Lebanon,LB,156,0,6855709,Asia,3260,43
2020-07-25,Lebanon,LB,147,3,6855709,Asia,3407,46
2020-07-26,Lebanon,LB,175,1,6855709,Asia,3582,47
2020-07-27,Lebanon,LB,168,4,6855709,Asia,3750,51
2020-07-28,Lebanon,LB,132,0,6855709,Asia,3882,51
2020-07-29,Lebanon,LB,141,3,6855709,Asia,4023,54
2020-07-30,Lebanon,LB,182,1,6855709,Asia,4205,55
2020-07-31,Lebanon,LB,129,2,6855709,Asia,4334,57
2020-08-01,Lebanon,LB,221,4,6855709,Asia,4555,61
2020-08-02,Lebanon,LB,175,0,6855709,Asia,4730,61
2020-08-03,Lebanon,LB,155,1,6855709,Asia,4885,62
2020-08-04,Lebanon,LB,177,3,6855709,Asia,5062,65
2020-08-05,Lebanon,LB,0,0,6855709,Asia,5062,65
2020-08-06,Lebanon,LB,355,3,6855709,Asia,5417,68
2020-08-07,Lebanon,LB,255,2,6855709,Asia,5672,70
2020-08-08,Lebanon,LB,279,0,6855709,Asia,5951,70
2020-08-09,Lebanon,LB,272,6,6855709,Asia,6223,76
2020-08-10,Lebanon,LB,294,0,6855709,Asia,6517,76
2020-08-11,Lebanon,LB,295,4,6855709,Asia,6812,80
2020-08-12,Lebanon,LB,309,7,6855709,Asia,7121,87
2020-08-13,Lebanon,LB,292,2,6855709,Asia,7413,89
2020-08-14,Lebanon,LB,298,3,6855709,Asia,7711,92
2020-08-15,Lebanon,LB,334,2,6855709,Asia,8045,94
2020-08-16,Lebanon,LB,397,3,6855709,Asia,8442,97
2020-08-17,Lebanon,LB,439,6,6855709,Asia,8881,103
2020-08-18,Lebanon,LB,456,2,6855709,Asia,9337,105
2020-08-19,Lebanon,LB,0,0,6855709,Asia,9337,105
2020-08-20,Lebanon,LB,1010,4,6855709,Asia,10347,109
2020-08-21,Lebanon,LB,605,4,6855709,Asia,10952,113
2020-08-22,Lebanon,LB,628,3,6855709,Asia,11580,116
2020-08-23,Lebanon,LB,611,5,6855709,Asia,12191,121
2020-08-24,Lebanon,LB,0,0,6855709,Asia,12191,121
2020-08-25,Lebanon,LB,964,5,6855709,Asia,13155,126
2020-08-26,Lebanon,LB,532,12,6855709,Asia,13687,138
2020-08-27,Lebanon,LB,561,1,6855709,Asia,14248,139
2020-08-28,Lebanon,LB,689,7,6855709,Asia,14937,146
2020-08-29,Lebanon,LB,676,2,6855709,Asia,15613,148
2020-08-30,Lebanon,LB,662,7,6855709,Asia,16275,155
2020-08-31,Lebanon,LB,595,5,6855709,Asia,16870,160
2020-09-01,Lebanon,LB,438,7,6855709,Asia,17308,167
2020-09-02,Lebanon,LB,469,4,6855709,Asia,17777,171
2020-09-03,Lebanon,LB,598,6,6855709,Asia,18375,177
2020-09-04,Lebanon,LB,588,2,6855709,Asia,18963,179
2020-09-05,Lebanon,LB,527,4,6855709,Asia,19490,183
2020-09-06,Lebanon,LB,521,4,6855709,Asia,20011,187
2020-09-07,Lebanon,LB,415,4,6855709,Asia,20426,191
2020-09-08,Lebanon,LB,400,9,6855709,Asia,20826,200
2020-09-09,Lebanon,LB,498,7,6855709,Asia,21324,207
2020-09-10,Lebanon,LB,553,5,6855709,Asia,21877,212
2020-09-11,Lebanon,LB,560,7,6855709,Asia,22437,219
2020-09-12,Lebanon,LB,546,10,6855709,Asia,22983,229
2020-09-13,Lebanon,LB,686,10,6855709,Asia,23669,239
2020-09-14,Lebanon,LB,641,2,6855709,Asia,24310,241
2020-09-15,Lebanon,LB,547,5,6855709,Asia,24857,246
2020-09-16,Lebanon,LB,592,6,6855709,Asia,25449,252
2020-09-17,Lebanon,LB,634,7,6855709,Asia,26083,259
2020-09-18,Lebanon,LB,685,4,6855709,Asia,26768,263
2020-09-19,Lebanon,LB,750,18,6855709,Asia,27518,281
2020-09-20,Lebanon,LB,779,5,6855709,Asia,28297,286
2020-09-21,Lebanon,LB,1006,11,6855709,Asia,29303,297
2020-09-22,Lebanon,LB,684,10,6855709,Asia,29987,307
2020-09-23,Lebanon,LB,865,8,6855709,Asia,30852,315
2020-09-24,Lebanon,LB,940,13,6855709,Asia,31792,328
2020-09-25,Lebanon,LB,1027,1,6855709,Asia,32819,329
2020-09-26,Lebanon,LB,1143,4,6855709,Asia,33962,333
2020-09-27,Lebanon,LB,1280,7,6855709,Asia,35242,340
2020-09-28,Lebanon,LB,1012,7,6855709,Asia,36254,347
2020-09-29,Lebanon,LB,1018,4,6855709,Asia,37272,351
2020-09-30,Lebanon,LB,1105,10,6855709,Asia,38377,361
2020-10-01,Lebanon,LB,1257,6,6855709,Asia,39634,367
2020-10-02,Lebanon,LB,1248,7,6855709,Asia,40882,374
2020-10-03,Lebanon,LB,1291,12,6855709,Asia,42173,386
2020-10-04,Lebanon,LB,1321,12,6855709,Asia,43494,398
2020-10-05,Lebanon,LB,988,8,6855709,Asia,44482,406
2020-10-06,Lebanon,LB,1175,8,6855709,Asia,45657,414
2020-10-07,Lebanon,LB,1261,10,6855709,Asia,46918,424
2020-10-08,Lebanon,LB,1459,9,6855709,Asia,48377,433
2020-10-09,Lebanon,LB,1367,6,6855709,Asia,49744,439
2020-10-10,Lebanon,LB,1426,11,6855709,Asia,51170,450
2020-10-11,Lebanon,LB,1388,5,6855709,Asia,52558,455
2020-10-12,Lebanon,LB,0,0,6855709,Asia,52558,455
2020-10-13,Lebanon,LB,2066,11,6855709,Asia,54624,466
2020-10-14,Lebanon,LB,1245,13,6855709,Asia,55869,479
2020-10-15,Lebanon,LB,1377,20,6855709,Asia,57246,499
2020-10-16,Lebanon,LB,1499,2,6855709,Asia,58745,501
2020-10-17,Lebanon,LB,1368,8,6855709,Asia,60113,509
2020-10-18,Lebanon,LB,1171,8,6855709,Asia,61284,517
2020-10-19,Lebanon,LB,1002,3,6855709,Asia,62286,520
2020-10-20,Lebanon,LB,658,6,6855709,Asia,62944,526
2020-10-21,Lebanon,LB,1392,5,6855709,Asia,64336,531
2020-10-22,Lebanon,LB,1241,5,6855709,Asia,65577,536
2020-10-23,Lebanon,LB,1450,16,6855709,Asia,67027,552
2020-10-24,Lebanon,LB,1452,7,6855709,Asia,68479,559
2020-10-25,Lebanon,LB,1427,3,6855709,Asia,69906,562
2020-10-26,Lebanon,LB,1484,3,6855709,Asia,71390,565
2020-10-27,Lebanon,LB,796,14,6855709,Asia,72186,579
2020-10-28,Lebanon,LB,1809,11,6855709,Asia,73995,590
2020-10-29,Lebanon,LB,1850,12,6855709,Asia,75845,602
2020-10-30,Lebanon,LB,1933,8,6855709,Asia,77778,610
2020-10-31,Lebanon,LB,1751,15,6855709,Asia,79529,625
2020-11-01,Lebanon,LB,1699,12,6855709,Asia,81228,637
2020-11-02,Lebanon,LB,1389,6,6855709,Asia,82617,643
2020-11-03,Lebanon,LB,1080,9,6855709,Asia,83697,652
2020-11-04,Lebanon,LB,1512,15,6855709,Asia,85209,667
2020-11-05,Lebanon,LB,1888,9,6855709,Asia,87097,676
2020-11-06,Lebanon,LB,2089,7,6855709,Asia,89186,683
2020-11-07,Lebanon,LB,2142,17,6855709,Asia,91328,700
2020-11-08,Lebanon,LB,1769,13,6855709,Asia,93097,713
2020-11-09,Lebanon,LB,1139,10,6855709,Asia,94236,723
2020-11-10,Lebanon,LB,1119,9,6855709,Asia,95355,732
2020-11-11,Lebanon,LB,1552,17,6855709,Asia,96907,749
2020-11-12,Lebanon,LB,1922,14,6855709,Asia,98829,763
2020-11-13,Lebanon,LB,1874,12,6855709,Asia,100703,775
2020-11-14,Lebanon,LB,1904,21,6855709,Asia,102607,796
2020-11-15,Lebanon,LB,1660,10,6855709,Asia,104267,806
2020-11-16,Lebanon,LB,1163,11,6855709,Asia,105430,817
2020-11-17,Lebanon,LB,1016,10,6855709,Asia,106446,827
2020-11-18,Lebanon,LB,1507,12,6855709,Asia,107953,839
2020-11-19,Lebanon,LB,2084,13,6855709,Asia,110037,852
2020-11-20,Lebanon,LB,1909,16,6855709,Asia,111946,868
2020-11-21,Lebanon,LB,1709,16,6855709,Asia,113655,884
2020-11-22,Lebanon,LB,1628,10,6855709,Asia,115283,894
2020-11-23,Lebanon,LB,1193,6,6855709,Asia,116476,900
2020-11-24,Lebanon,LB,1041,11,6855709,Asia,117517,911
2020-11-25,Lebanon,LB,1188,23,6855709,Asia,118705,934
2020-11-26,Lebanon,LB,1636,16,6855709,Asia,120341,950
2020-11-27,Lebanon,LB,1859,24,6855709,Asia,122200,974
2020-11-28,Lebanon,LB,1782,6,6855709,Asia,123982,980
2020-11-29,Lebanon,LB,1696,10,6855709,Asia,125678,990
2020-11-30,Lebanon,LB,1266,14,6855709,Asia,126944,1004
2020-12-01,Lebanon,LB,1000,14,6855709,Asia,127944,1018
2020-12-02,Lebanon,LB,1511,15,6855709,Asia,129455,1033
2020-12-03,Lebanon,LB,1842,22,6855709,Asia,131297,1055
2020-12-04,Lebanon,LB,1520,12,6855709,Asia,132817,1067
2020-12-05,Lebanon,LB,1478,11,6855709,Asia,134295,1078
2020-12-06,Lebanon,LB,0,0,6855709,Asia,134295,1078
2020-12-07,Lebanon,LB,2858,21,6855709,Asia,137153,1099
2020-12-08,Lebanon,LB,943,16,6855709,Asia,138096,1115
2020-12-09,Lebanon,LB,1039,21,6855709,Asia,139135,1136
2020-12-10,Lebanon,LB,1274,20,6855709,Asia,140409,1156
2020-12-11,Lebanon,LB,1778,14,6855709,Asia,142187,1170
2020-12-12,Lebanon,LB,1518,12,6855709,Asia,143705,1182
2020-12-13,Lebanon,LB,1540,8,6855709,Asia,145245,1190
2020-12-14,Lebanon,LB,1275,10,6855709,Asia,146520,1200
2020-03-15,Saint_Lucia,LC,2,0,182795,America,2,0
2020-03-16,Saint_Lucia,LC,0,0,182795,America,2,0
2020-03-17,Saint_Lucia,LC,0,0,182795,America,2,0
2020-03-18,Saint_Lucia,LC,0,0,182795,America,2,0
2020-03-19,Saint_Lucia,LC,0,0,182795,America,2,0
2020-03-20,Saint_Lucia,LC,0,0,182795,America,2,0
2020-03-21,Saint_Lucia,LC,0,0,182795,America,2,0
2020-03-22,Saint_Lucia,LC,0,0,182795,America,2,0
2020-03-23,Saint_Lucia,LC,0,0,182795,America,2,0
2020-03-24,Saint_Lucia,LC,0,0,182795,America,2,0
2020-03-25,Saint_Lucia,LC,0,0,182795,America,2,0
2020-03-26,Saint_Lucia,LC,1,0,182795,America,3,0
2020-03-27,Saint_Lucia,LC,0,0,182795,America,3,0
2020-03-28,Saint_Lucia,LC,0,0,182795,America,3,0
2020-03-29,Saint_Lucia,LC,1,0,182795,America,4,0
2020-03-30,Saint_Lucia,LC,5,0,182795,America,9,0
2020-03-31,Saint_Lucia,LC,0,0,182795,America,9,0
2020-04-01,Saint_Lucia,LC,4,0,182795,America,13,0
2020-04-02,Saint_Lucia,LC,0,0,182795,America,13,0
2020-04-03,Saint_Lucia,LC,0,0,182795,America,13,0
2020-04-04,Saint_Lucia,LC,0,0,182795,America,13,0
2020-04-05,Saint_Lucia,LC,1,0,182795,America,14,0
2020-04-06,Saint_Lucia,LC,0,0,182795,America,14,0
2020-04-07,Saint_Lucia,LC,0,0,182795,America,14,0
2020-04-08,Saint_Lucia,LC,0,0,182795,America,14,0
2020-04-09,Saint_Lucia,LC,0,0,182795,America,14,0
2020-04-10,Saint_Lucia,LC,0,0,182795,America,14,0
2020-04-11,Saint_Lucia,LC,1,0,182795,America,15,0
2020-04-12,Saint_Lucia,LC,0,0,182795,America,15,0
2020-04-13,Saint_Lucia,LC,0,0,182795,America,15,0
2020-04-14,Saint_Lucia,LC,0,0,182795,America,15,0
2020-04-15,Saint_Lucia,LC,0,0,182795,America,15,0
2020-04-16,Saint_Lucia,LC,0,0,182795,America,15,0
2020-04-17,Saint_Lucia,LC,0,0,182795,America,15,0
2020-04-18,Saint_Lucia,LC,0,0,182795,America,15,0
2020-04-19,Saint_Lucia,LC,0,0,182795,America,15,0
2020-04-20,Saint_Lucia,LC,0,0,182795,America,15,0
2020-04-21,Saint_Lucia,LC,0,0,182795,America,15,0
2020-04-22,Saint_Lucia,LC,0,0,182795,America,15,0
2020-04-23,Saint_Lucia,LC,0,0,182795,America,15,0
2020-04-24,Saint_Lucia,LC,0,0,182795,America,15,0
2020-04-25,Saint_Lucia,LC,0,0,182795,America,15,0
2020-04-26,Saint_Lucia,LC,0,0,182795,America,15,0
2020-04-27,Saint_Lucia,LC,0,0,182795,America,15,0
2020-04-28,Saint_Lucia,LC,0,0,182795,America,15,0
2020-04-29,Saint_Lucia,LC,0,0,182795,America,15,0
2020-04-30,Saint_Lucia,LC,2,0,182795,America,17,0
2020-05-01,Saint_Lucia,LC,0,0,182795,America,17,0
2020-05-02,Saint_Lucia,LC,0,0,182795,America,17,0
2020-05-03,Saint_Lucia,LC,0,0,182795,America,17,0
2020-05-04,Saint_Lucia,LC,1,0,182795,America,18,0
2020-05-05,Saint_Lucia,LC,0,0,182795,America,18,0
2020-05-06,Saint_Lucia,LC,0,0,182795,America,18,0
2020-05-07,Saint_Lucia,LC,0,0,182795,America,18,0
2020-05-08,Saint_Lucia,LC,0,0,182795,America,18,0
2020-05-09,Saint_Lucia,LC,0,0,182795,America,18,0
2020-05-10,Saint_Lucia,LC,0,0,182795,America,18,0
2020-05-11,Saint_Lucia,LC,0,0,182795,America,18,0
2020-05-12,Saint_Lucia,LC,0,0,182795,America,18,0
2020-05-13,Saint_Lucia,LC,0,0,182795,America,18,0
2020-05-14,Saint_Lucia,LC,0,0,182795,America,18,0
2020-05-15,Saint_Lucia,LC,0,0,182795,America,18,0
2020-05-16,Saint_Lucia,LC,0,0,182795,America,18,0
2020-05-17,Saint_Lucia,LC,0,0,182795,America,18,0
2020-05-18,Saint_Lucia,LC,0,0,182795,America,18,0
2020-05-19,Saint_Lucia,LC,0,0,182795,America,18,0
2020-05-20,Saint_Lucia,LC,0,0,182795,America,18,0
2020-05-21,Saint_Lucia,LC,0,0,182795,America,18,0
2020-05-22,Saint_Lucia,LC,0,0,182795,America,18,0
2020-05-23,Saint_Lucia,LC,0,0,182795,America,18,0
2020-05-24,Saint_Lucia,LC,0,0,182795,America,18,0
2020-05-25,Saint_Lucia,LC,0,0,182795,America,18,0
2020-05-26,Saint_Lucia,LC,0,0,182795,America,18,0
2020-05-27,Saint_Lucia,LC,0,0,182795,America,18,0
2020-05-28,Saint_Lucia,LC,0,0,182795,America,18,0
2020-05-29,Saint_Lucia,LC,0,0,182795,America,18,0
2020-05-30,Saint_Lucia,LC,0,0,182795,America,18,0
2020-05-31,Saint_Lucia,LC,0,0,182795,America,18,0
2020-06-01,Saint_Lucia,LC,0,0,182795,America,18,0
2020-06-02,Saint_Lucia,LC,0,0,182795,America,18,0
2020-06-03,Saint_Lucia,LC,0,0,182795,America,18,0
2020-06-04,Saint_Lucia,LC,0,0,182795,America,18,0
2020-06-05,Saint_Lucia,LC,1,0,182795,America,19,0
2020-06-06,Saint_Lucia,LC,0,0,182795,America,19,0
2020-06-07,Saint_Lucia,LC,0,0,182795,America,19,0
2020-06-08,Saint_Lucia,LC,0,0,182795,America,19,0
2020-06-09,Saint_Lucia,LC,0,0,182795,America,19,0
2020-06-10,Saint_Lucia,LC,0,0,182795,America,19,0
2020-06-11,Saint_Lucia,LC,0,0,182795,America,19,0
2020-06-12,Saint_Lucia,LC,0,0,182795,America,19,0
2020-06-13,Saint_Lucia,LC,0,0,182795,America,19,0
2020-06-14,Saint_Lucia,LC,0,0,182795,America,19,0
2020-06-15,Saint_Lucia,LC,0,0,182795,America,19,0
2020-06-16,Saint_Lucia,LC,0,0,182795,America,19,0
2020-06-17,Saint_Lucia,LC,0,0,182795,America,19,0
2020-06-18,Saint_Lucia,LC,0,0,182795,America,19,0
2020-06-19,Saint_Lucia,LC,0,0,182795,America,19,0
2020-06-20,Saint_Lucia,LC,0,0,182795,America,19,0
2020-06-21,Saint_Lucia,LC,0,0,182795,America,19,0
2020-06-22,Saint_Lucia,LC,0,0,182795,America,19,0
2020-06-23,Saint_Lucia,LC,0,0,182795,America,19,0
2020-06-24,Saint_Lucia,LC,0,0,182795,America,19,0
2020-06-25,Saint_Lucia,LC,0,0,182795,America,19,0
2020-06-26,Saint_Lucia,LC,0,0,182795,America,19,0
2020-06-27,Saint_Lucia,LC,0,0,182795,America,19,0
2020-06-28,Saint_Lucia,LC,0,0,182795,America,19,0
2020-06-29,Saint_Lucia,LC,0,0,182795,America,19,0
2020-06-30,Saint_Lucia,LC,0,0,182795,America,19,0
2020-07-01,Saint_Lucia,LC,0,0,182795,America,19,0
2020-07-02,Saint_Lucia,LC,0,0,182795,America,19,0
2020-07-03,Saint_Lucia,LC,3,0,182795,America,22,0
2020-07-04,Saint_Lucia,LC,0,0,182795,America,22,0
2020-07-05,Saint_Lucia,LC,0,0,182795,America,22,0
2020-07-06,Saint_Lucia,LC,0,0,182795,America,22,0
2020-07-07,Saint_Lucia,LC,0,0,182795,America,22,0
2020-07-08,Saint_Lucia,LC,0,0,182795,America,22,0
2020-07-09,Saint_Lucia,LC,0,0,182795,America,22,0
2020-07-10,Saint_Lucia,LC,0,0,182795,America,22,0
2020-07-11,Saint_Lucia,LC,0,0,182795,America,22,0
2020-07-12,Saint_Lucia,LC,0,0,182795,America,22,0
2020-07-13,Saint_Lucia,LC,0,0,182795,America,22,0
2020-07-14,Saint_Lucia,LC,0,0,182795,America,22,0
2020-07-15,Saint_Lucia,LC,0,0,182795,America,22,0
2020-07-16,Saint_Lucia,LC,0,0,182795,America,22,0
2020-07-17,Saint_Lucia,LC,1,0,182795,America,23,0
2020-07-18,Saint_Lucia,LC,0,0,182795,America,23,0
2020-07-19,Saint_Lucia,LC,0,0,182795,America,23,0
2020-07-20,Saint_Lucia,LC,0,0,182795,America,23,0
2020-07-21,Saint_Lucia,LC,0,0,182795,America,23,0
2020-07-22,Saint_Lucia,LC,0,0,182795,America,23,0
2020-07-23,Saint_Lucia,LC,0,0,182795,America,23,0
2020-07-24,Saint_Lucia,LC,1,0,182795,America,24,0
2020-07-25,Saint_Lucia,LC,0,0,182795,America,24,0
2020-07-26,Saint_Lucia,LC,0,0,182795,America,24,0
2020-07-27,Saint_Lucia,LC,0,0,182795,America,24,0
2020-07-28,Saint_Lucia,LC,0,0,182795,America,24,0
2020-07-29,Saint_Lucia,LC,0,0,182795,America,24,0
2020-07-30,Saint_Lucia,LC,0,0,182795,America,24,0
2020-07-31,Saint_Lucia,LC,1,0,182795,America,25,0
2020-08-01,Saint_Lucia,LC,0,0,182795,America,25,0
2020-08-02,Saint_Lucia,LC,0,0,182795,America,25,0
2020-08-03,Saint_Lucia,LC,0,0,182795,America,25,0
2020-08-04,Saint_Lucia,LC,0,0,182795,America,25,0
2020-08-05,Saint_Lucia,LC,0,0,182795,America,25,0
2020-08-06,Saint_Lucia,LC,0,0,182795,America,25,0
2020-08-07,Saint_Lucia,LC,0,0,182795,America,25,0
2020-08-08,Saint_Lucia,LC,0,0,182795,America,25,0
2020-08-09,Saint_Lucia,LC,0,0,182795,America,25,0
2020-08-10,Saint_Lucia,LC,0,0,182795,America,25,0
2020-08-11,Saint_Lucia,LC,0,0,182795,America,25,0
2020-08-12,Saint_Lucia,LC,0,0,182795,America,25,0
2020-08-13,Saint_Lucia,LC,0,0,182795,America,25,0
2020-08-14,Saint_Lucia,LC,0,0,182795,America,25,0
2020-08-15,Saint_Lucia,LC,0,0,182795,America,25,0
2020-08-16,Saint_Lucia,LC,0,0,182795,America,25,0
2020-08-17,Saint_Lucia,LC,0,0,182795,America,25,0
2020-08-18,Saint_Lucia,LC,0,0,182795,America,25,0
2020-08-19,Saint_Lucia,LC,1,0,182795,America,26,0
2020-08-20,Saint_Lucia,LC,0,0,182795,America,26,0
2020-08-21,Saint_Lucia,LC,0,0,182795,America,26,0
2020-08-22,Saint_Lucia,LC,0,0,182795,America,26,0
2020-08-23,Saint_Lucia,LC,0,0,182795,America,26,0
2020-08-24,Saint_Lucia,LC,0,0,182795,America,26,0
2020-08-25,Saint_Lucia,LC,0,0,182795,America,26,0
2020-08-26,Saint_Lucia,LC,0,0,182795,America,26,0
2020-08-27,Saint_Lucia,LC,0,0,182795,America,26,0
2020-08-28,Saint_Lucia,LC,0,0,182795,America,26,0
2020-08-29,Saint_Lucia,LC,0,0,182795,America,26,0
2020-08-30,Saint_Lucia,LC,0,0,182795,America,26,0
2020-08-31,Saint_Lucia,LC,0,0,182795,America,26,0
2020-09-01,Saint_Lucia,LC,0,0,182795,America,26,0
2020-09-02,Saint_Lucia,LC,0,0,182795,America,26,0
2020-09-03,Saint_Lucia,LC,0,0,182795,America,26,0
2020-09-04,Saint_Lucia,LC,0,0,182795,America,26,0
2020-09-05,Saint_Lucia,LC,0,0,182795,America,26,0
2020-09-06,Saint_Lucia,LC,0,0,182795,America,26,0
2020-09-07,Saint_Lucia,LC,0,0,182795,America,26,0
2020-09-08,Saint_Lucia,LC,0,0,182795,America,26,0
2020-09-09,Saint_Lucia,LC,0,0,182795,America,26,0
2020-09-10,Saint_Lucia,LC,1,0,182795,America,27,0
2020-09-11,Saint_Lucia,LC,0,0,182795,America,27,0
2020-09-12,Saint_Lucia,LC,0,0,182795,America,27,0
2020-09-13,Saint_Lucia,LC,0,0,182795,America,27,0
2020-09-14,Saint_Lucia,LC,0,0,182795,America,27,0
2020-09-15,Saint_Lucia,LC,0,0,182795,America,27,0
2020-09-16,Saint_Lucia,LC,0,0,182795,America,27,0
2020-09-17,Saint_Lucia,LC,0,0,182795,America,27,0
2020-09-18,Saint_Lucia,LC,0,0,182795,America,27,0
2020-09-19,Saint_Lucia,LC,0,0,182795,America,27,0
2020-09-20,Saint_Lucia,LC,0,0,182795,America,27,0
2020-09-21,Saint_Lucia,LC,0,0,182795,America,27,0
2020-09-22,Saint_Lucia,LC,0,0,182795,America,27,0
2020-09-23,Saint_Lucia,LC,0,0,182795,America,27,0
2020-09-24,Saint_Lucia,LC,0,0,182795,America,27,0
2020-09-25,Saint_Lucia,LC,0,0,182795,America,27,0
2020-09-26,Saint_Lucia,LC,0,0,182795,America,27,0
2020-09-27,Saint_Lucia,LC,0,0,182795,America,27,0
2020-09-28,Saint_Lucia,LC,0,0,182795,America,27,0
2020-09-29,Saint_Lucia,LC,0,0,182795,America,27,0
2020-09-30,Saint_Lucia,LC,0,0,182795,America,27,0
2020-10-01,Saint_Lucia,LC,0,0,182795,America,27,0
2020-10-02,Saint_Lucia,LC,0,0,182795,America,27,0
2020-10-03,Saint_Lucia,LC,0,0,182795,America,27,0
2020-10-04,Saint_Lucia,LC,0,0,182795,America,27,0
2020-10-05,Saint_Lucia,LC,0,0,182795,America,27,0
2020-10-06,Saint_Lucia,LC,0,0,182795,America,27,0
2020-10-07,Saint_Lucia,LC,0,0,182795,America,27,0
2020-10-08,Saint_Lucia,LC,1,0,182795,America,28,0
2020-10-09,Saint_Lucia,LC,0,0,182795,America,28,0
2020-10-10,Saint_Lucia,LC,0,0,182795,America,28,0
2020-10-11,Saint_Lucia,LC,1,0,182795,America,29,0
2020-10-12,Saint_Lucia,LC,0,0,182795,America,29,0
2020-10-13,Saint_Lucia,LC,0,0,182795,America,29,0
2020-10-14,Saint_Lucia,LC,0,0,182795,America,29,0
2020-10-15,Saint_Lucia,LC,2,0,182795,America,31,0
2020-10-16,Saint_Lucia,LC,0,0,182795,America,31,0
2020-10-17,Saint_Lucia,LC,1,0,182795,America,32,0
2020-10-18,Saint_Lucia,LC,1,0,182795,America,33,0
2020-10-19,Saint_Lucia,LC,0,0,182795,America,33,0
2020-10-20,Saint_Lucia,LC,3,0,182795,America,36,0
2020-10-21,Saint_Lucia,LC,0,0,182795,America,36,0
2020-10-22,Saint_Lucia,LC,3,0,182795,America,39,0
2020-10-23,Saint_Lucia,LC,3,0,182795,America,42,0
2020-10-24,Saint_Lucia,LC,6,0,182795,America,48,0
2020-10-25,Saint_Lucia,LC,4,0,182795,America,52,0
2020-10-26,Saint_Lucia,LC,2,0,182795,America,54,0
2020-10-27,Saint_Lucia,LC,9,0,182795,America,63,0
2020-10-28,Saint_Lucia,LC,0,0,182795,America,63,0
2020-10-29,Saint_Lucia,LC,10,0,182795,America,73,0
2020-10-30,Saint_Lucia,LC,3,0,182795,America,76,0
2020-10-31,Saint_Lucia,LC,2,0,182795,America,78,0
2020-11-01,Saint_Lucia,LC,0,0,182795,America,78,0
2020-11-02,Saint_Lucia,LC,6,0,182795,America,84,0
2020-11-03,Saint_Lucia,LC,0,0,182795,America,84,0
2020-11-04,Saint_Lucia,LC,13,0,182795,America,97,0
2020-11-05,Saint_Lucia,LC,8,0,182795,America,105,0
2020-11-06,Saint_Lucia,LC,1,0,182795,America,106,0
2020-11-07,Saint_Lucia,LC,4,0,182795,America,110,0
2020-11-08,Saint_Lucia,LC,13,0,182795,America,123,0
2020-11-09,Saint_Lucia,LC,8,0,182795,America,131,0
2020-11-10,Saint_Lucia,LC,10,0,182795,America,141,0
2020-11-11,Saint_Lucia,LC,7,2,182795,America,148,2
2020-11-12,Saint_Lucia,LC,0,0,182795,America,148,2
2020-11-13,Saint_Lucia,LC,8,0,182795,America,156,2
2020-11-14,Saint_Lucia,LC,4,0,182795,America,160,2
2020-11-15,Saint_Lucia,LC,2,0,182795,America,162,2
2020-11-16,Saint_Lucia,LC,9,0,182795,America,171,2
2020-11-17,Saint_Lucia,LC,2,0,182795,America,173,2
2020-11-18,Saint_Lucia,LC,5,0,182795,America,178,2
2020-11-19,Saint_Lucia,LC,5,0,182795,America,183,2
2020-11-20,Saint_Lucia,LC,20,0,182795,America,203,2
2020-11-21,Saint_Lucia,LC,0,0,182795,America,203,2
2020-11-22,Saint_Lucia,LC,1,0,182795,America,204,2
2020-11-23,Saint_Lucia,LC,16,0,182795,America,220,2
2020-11-24,Saint_Lucia,LC,3,0,182795,America,223,2
2020-11-25,Saint_Lucia,LC,3,0,182795,America,226,2
2020-11-26,Saint_Lucia,LC,9,0,182795,America,235,2
2020-11-27,Saint_Lucia,LC,3,0,182795,America,238,2
2020-11-28,Saint_Lucia,LC,8,0,182795,America,246,2
2020-11-29,Saint_Lucia,LC,6,0,182795,America,252,2
2020-11-30,Saint_Lucia,LC,5,0,182795,America,257,2
2020-12-01,Saint_Lucia,LC,2,0,182795,America,259,2
2020-12-02,Saint_Lucia,LC,0,0,182795,America,259,2
2020-12-03,Saint_Lucia,LC,2,0,182795,America,261,2
2020-12-04,Saint_Lucia,LC,1,0,182795,America,262,2
2020-12-05,Saint_Lucia,LC,0,0,182795,America,262,2
2020-12-06,Saint_Lucia,LC,3,0,182795,America,265,2
2020-12-07,Saint_Lucia,LC,0,0,182795,America,265,2
2020-12-08,Saint_Lucia,LC,5,0,182795,America,270,2
2020-12-09,Saint_Lucia,LC,0,0,182795,America,270,2
2020-12-10,Saint_Lucia,LC,0,1,182795,America,270,3
2020-12-11,Saint_Lucia,LC,4,1,182795,America,274,4
2020-12-12,Saint_Lucia,LC,0,0,182795,America,274,4
2020-12-13,Saint_Lucia,LC,0,0,182795,America,274,4
2020-12-14,Saint_Lucia,LC,1,0,182795,America,275,4
2020-03-05,Liechtenstein,LI,1,0,38378,Europe,1,0
2020-03-12,Liechtenstein,LI,2,0,38378,Europe,3,0
2020-03-13,Liechtenstein,LI,1,0,38378,Europe,4,0
2020-03-14,Liechtenstein,LI,0,0,38378,Europe,4,0
2020-03-15,Liechtenstein,LI,0,0,38378,Europe,4,0
2020-03-16,Liechtenstein,LI,3,0,38378,Europe,7,0
2020-03-17,Liechtenstein,LI,0,0,38378,Europe,7,0
2020-03-18,Liechtenstein,LI,0,0,38378,Europe,7,0
2020-03-19,Liechtenstein,LI,18,0,38378,Europe,25,0
2020-03-20,Liechtenstein,LI,0,0,38378,Europe,25,0
2020-03-21,Liechtenstein,LI,9,0,38378,Europe,34,0
2020-03-22,Liechtenstein,LI,2,0,38378,Europe,36,0
2020-03-23,Liechtenstein,LI,10,0,38378,Europe,46,0
2020-03-24,Liechtenstein,LI,0,0,38378,Europe,46,0
2020-03-25,Liechtenstein,LI,1,0,38378,Europe,47,0
2020-03-26,Liechtenstein,LI,4,0,38378,Europe,51,0
2020-03-27,Liechtenstein,LI,5,0,38378,Europe,56,0
2020-03-28,Liechtenstein,LI,4,0,38378,Europe,60,0
2020-03-29,Liechtenstein,LI,1,0,38378,Europe,61,0
2020-03-30,Liechtenstein,LI,1,0,38378,Europe,62,0
2020-03-31,Liechtenstein,LI,2,0,38378,Europe,64,0
2020-04-01,Liechtenstein,LI,4,0,38378,Europe,68,0
2020-04-02,Liechtenstein,LI,4,0,38378,Europe,72,0
2020-04-03,Liechtenstein,LI,3,0,38378,Europe,75,0
2020-04-04,Liechtenstein,LI,0,0,38378,Europe,75,0
2020-04-05,Liechtenstein,LI,2,1,38378,Europe,77,1
2020-04-06,Liechtenstein,LI,1,0,38378,Europe,78,1
2020-04-07,Liechtenstein,LI,0,0,38378,Europe,78,1
2020-04-08,Liechtenstein,LI,0,0,38378,Europe,78,1
2020-04-09,Liechtenstein,LI,1,0,38378,Europe,79,1
2020-04-10,Liechtenstein,LI,0,0,38378,Europe,79,1
2020-04-11,Liechtenstein,LI,1,0,38378,Europe,80,1
2020-04-12,Liechtenstein,LI,0,0,38378,Europe,80,1
2020-04-13,Liechtenstein,LI,0,0,38378,Europe,80,1
2020-04-14,Liechtenstein,LI,1,0,38378,Europe,81,1
2020-04-15,Liechtenstein,LI,0,0,38378,Europe,81,1
2020-04-16,Liechtenstein,LI,0,0,38378,Europe,81,1
2020-04-17,Liechtenstein,LI,0,0,38378,Europe,81,1
2020-04-18,Liechtenstein,LI,0,0,38378,Europe,81,1
2020-04-19,Liechtenstein,LI,1,0,38378,Europe,82,1
2020-04-20,Liechtenstein,LI,0,0,38378,Europe,82,1
2020-04-21,Liechtenstein,LI,0,0,38378,Europe,82,1
2020-04-22,Liechtenstein,LI,0,0,38378,Europe,82,1
2020-04-23,Liechtenstein,LI,0,0,38378,Europe,82,1
2020-04-24,Liechtenstein,LI,0,0,38378,Europe,82,1
2020-04-25,Liechtenstein,LI,0,0,38378,Europe,82,1
2020-04-26,Liechtenstein,LI,1,0,38378,Europe,83,1
2020-04-27,Liechtenstein,LI,0,0,38378,Europe,83,1
2020-04-28,Liechtenstein,LI,0,0,38378,Europe,83,1
2020-04-29,Liechtenstein,LI,0,0,38378,Europe,83,1
2020-04-30,Liechtenstein,LI,0,0,38378,Europe,83,1
2020-05-01,Liechtenstein,LI,0,0,38378,Europe,83,1
2020-05-02,Liechtenstein,LI,0,0,38378,Europe,83,1
2020-05-03,Liechtenstein,LI,0,0,38378,Europe,83,1
2020-05-04,Liechtenstein,LI,0,0,38378,Europe,83,1
2020-05-05,Liechtenstein,LI,0,0,38378,Europe,83,1
2020-05-06,Liechtenstein,LI,0,0,38378,Europe,83,1
2020-05-07,Liechtenstein,LI,0,0,38378,Europe,83,1
2020-05-08,Liechtenstein,LI,0,0,38378,Europe,83,1
2020-05-09,Liechtenstein,LI,0,0,38378,Europe,83,1
2020-05-10,Liechtenstein,LI,0,0,38378,Europe,83,1
2020-05-11,Liechtenstein,LI,0,0,38378,Europe,83,1
2020-05-12,Liechtenstein,LI,0,0,38378,Europe,83,1
2020-05-13,Liechtenstein,LI,0,0,38378,Europe,83,1
2020-05-14,Liechtenstein,LI,0,0,38378,Europe,83,1
2020-05-15,Liechtenstein,LI,0,0,38378,Europe,83,1
2020-05-16,Liechtenstein,LI,0,0,38378,Europe,83,1
2020-05-17,Liechtenstein,LI,0,0,38378,Europe,83,1
2020-05-18,Liechtenstein,LI,0,0,38378,Europe,83,1
2020-05-19,Liechtenstein,LI,0,0,38378,Europe,83,1
2020-05-20,Liechtenstein,LI,0,0,38378,Europe,83,1
2020-05-21,Liechtenstein,LI,0,0,38378,Europe,83,1
2020-05-22,Liechtenstein,LI,0,0,38378,Europe,83,1
2020-05-23,Liechtenstein,LI,0,0,38378,Europe,83,1
2020-05-24,Liechtenstein,LI,0,0,38378,Europe,83,1
2020-05-25,Liechtenstein,LI,0,0,38378,Europe,83,1
2020-05-26,Liechtenstein,LI,0,0,38378,Europe,83,1
2020-05-27,Liechtenstein,LI,0,0,38378,Europe,83,1
2020-05-28,Liechtenstein,LI,0,0,38378,Europe,83,1
2020-05-29,Liechtenstein,LI,0,0,38378,Europe,83,1
2020-05-30,Liechtenstein,LI,0,0,38378,Europe,83,1
2020-05-31,Liechtenstein,LI,0,0,38378,Europe,83,1
2020-06-01,Liechtenstein,LI,0,0,38378,Europe,83,1
2020-06-02,Liechtenstein,LI,0,0,38378,Europe,83,1
2020-06-03,Liechtenstein,LI,0,0,38378,Europe,83,1
2020-06-04,Liechtenstein,LI,0,0,38378,Europe,83,1
2020-06-05,Liechtenstein,LI,0,0,38378,Europe,83,1
2020-06-06,Liechtenstein,LI,0,0,38378,Europe,83,1
2020-06-07,Liechtenstein,LI,0,0,38378,Europe,83,1
2020-06-08,Liechtenstein,LI,0,0,38378,Europe,83,1
2020-06-09,Liechtenstein,LI,0,0,38378,Europe,83,1
2020-06-10,Liechtenstein,LI,0,0,38378,Europe,83,1
2020-06-11,Liechtenstein,LI,0,0,38378,Europe,83,1
2020-06-12,Liechtenstein,LI,0,0,38378,Europe,83,1
2020-06-13,Liechtenstein,LI,0,0,38378,Europe,83,1
2020-06-14,Liechtenstein,LI,0,0,38378,Europe,83,1
2020-06-15,Liechtenstein,LI,0,0,38378,Europe,83,1
2020-06-16,Liechtenstein,LI,0,0,38378,Europe,83,1
2020-06-17,Liechtenstein,LI,0,0,38378,Europe,83,1
2020-06-18,Liechtenstein,LI,0,0,38378,Europe,83,1
2020-06-19,Liechtenstein,LI,0,0,38378,Europe,83,1
2020-06-20,Liechtenstein,LI,0,0,38378,Europe,83,1
2020-06-21,Liechtenstein,LI,0,0,38378,Europe,83,1
2020-06-22,Liechtenstein,LI,0,0,38378,Europe,83,1
2020-06-23,Liechtenstein,LI,0,0,38378,Europe,83,1
2020-06-24,Liechtenstein,LI,0,0,38378,Europe,83,1
2020-06-25,Liechtenstein,LI,0,0,38378,Europe,83,1
2020-06-26,Liechtenstein,LI,0,0,38378,Europe,83,1
2020-06-27,Liechtenstein,LI,0,0,38378,Europe,83,1
2020-06-28,Liechtenstein,LI,0,0,38378,Europe,83,1
2020-06-29,Liechtenstein,LI,0,0,38378,Europe,83,1
2020-06-30,Liechtenstein,LI,0,0,38378,Europe,83,1
2020-07-01,Liechtenstein,LI,0,0,38378,Europe,83,1
2020-07-02,Liechtenstein,LI,0,0,38378,Europe,83,1
2020-07-03,Liechtenstein,LI,0,0,38378,Europe,83,1
2020-07-04,Liechtenstein,LI,1,0,38378,Europe,84,1
2020-07-05,Liechtenstein,LI,0,0,38378,Europe,84,1
2020-07-06,Liechtenstein,LI,0,0,38378,Europe,84,1
2020-07-07,Liechtenstein,LI,1,0,38378,Europe,85,1
2020-07-08,Liechtenstein,LI,0,0,38378,Europe,85,1
2020-07-09,Liechtenstein,LI,0,0,38378,Europe,85,1
2020-07-10,Liechtenstein,LI,0,0,38378,Europe,85,1
2020-07-11,Liechtenstein,LI,0,0,38378,Europe,85,1
2020-07-12,Liechtenstein,LI,0,0,38378,Europe,85,1
2020-07-13,Liechtenstein,LI,0,0,38378,Europe,85,1
2020-07-14,Liechtenstein,LI,0,0,38378,Europe,85,1
2020-07-15,Liechtenstein,LI,0,0,38378,Europe,85,1
2020-07-16,Liechtenstein,LI,0,0,38378,Europe,85,1
2020-07-17,Liechtenstein,LI,0,0,38378,Europe,85,1
2020-07-18,Liechtenstein,LI,1,0,38378,Europe,86,1
2020-07-19,Liechtenstein,LI,0,0,38378,Europe,86,1
2020-07-20,Liechtenstein,LI,1,0,38378,Europe,87,1
2020-07-21,Liechtenstein,LI,0,0,38378,Europe,87,1
2020-07-22,Liechtenstein,LI,0,0,38378,Europe,87,1
2020-07-23,Liechtenstein,LI,0,0,38378,Europe,87,1
2020-07-24,Liechtenstein,LI,0,0,38378,Europe,87,1
2020-07-25,Liechtenstein,LI,0,0,38378,Europe,87,1
2020-07-26,Liechtenstein,LI,0,0,38378,Europe,87,1
2020-07-27,Liechtenstein,LI,0,0,38378,Europe,87,1
2020-07-28,Liechtenstein,LI,0,0,38378,Europe,87,1
2020-07-29,Liechtenstein,LI,0,0,38378,Europe,87,1
2020-07-30,Liechtenstein,LI,1,0,38378,Europe,88,1
2020-07-31,Liechtenstein,LI,1,0,38378,Europe,89,1
2020-08-01,Liechtenstein,LI,0,0,38378,Europe,89,1
2020-08-02,Liechtenstein,LI,0,0,38378,Europe,89,1
2020-08-03,Liechtenstein,LI,0,0,38378,Europe,89,1
2020-08-04,Liechtenstein,LI,0,0,38378,Europe,89,1
2020-08-05,Liechtenstein,LI,0,0,38378,Europe,89,1
2020-08-06,Liechtenstein,LI,0,0,38378,Europe,89,1
2020-08-07,Liechtenstein,LI,0,0,38378,Europe,89,1
2020-08-08,Liechtenstein,LI,0,0,38378,Europe,89,1
2020-08-09,Liechtenstein,LI,0,0,38378,Europe,89,1
2020-08-10,Liechtenstein,LI,0,0,38378,Europe,89,1
2020-08-11,Liechtenstein,LI,0,0,38378,Europe,89,1
2020-08-12,Liechtenstein,LI,0,0,38378,Europe,89,1
2020-08-13,Liechtenstein,LI,1,0,38378,Europe,90,1
2020-08-14,Liechtenstein,LI,1,0,38378,Europe,91,1
2020-08-15,Liechtenstein,LI,0,0,38378,Europe,91,1
2020-08-16,Liechtenstein,LI,2,0,38378,Europe,93,1
2020-08-17,Liechtenstein,LI,0,0,38378,Europe,93,1
2020-08-18,Liechtenstein,LI,1,0,38378,Europe,94,1
2020-08-19,Liechtenstein,LI,3,0,38378,Europe,97,1
2020-08-20,Liechtenstein,LI,1,0,38378,Europe,98,1
2020-08-21,Liechtenstein,LI,2,0,38378,Europe,100,1
2020-08-22,Liechtenstein,LI,0,0,38378,Europe,100,1
2020-08-23,Liechtenstein,LI,1,0,38378,Europe,101,1
2020-08-24,Liechtenstein,LI,0,0,38378,Europe,101,1
2020-08-25,Liechtenstein,LI,0,0,38378,Europe,101,1
2020-08-26,Liechtenstein,LI,0,0,38378,Europe,101,1
2020-08-27,Liechtenstein,LI,4,0,38378,Europe,105,1
2020-08-28,Liechtenstein,LI,1,0,38378,Europe,106,1
2020-08-29,Liechtenstein,LI,0,0,38378,Europe,106,1
2020-08-30,Liechtenstein,LI,1,0,38378,Europe,107,1
2020-08-31,Liechtenstein,LI,1,0,38378,Europe,108,1
2020-09-01,Liechtenstein,LI,0,0,38378,Europe,108,1
2020-09-02,Liechtenstein,LI,0,0,38378,Europe,108,1
2020-09-03,Liechtenstein,LI,0,0,38378,Europe,108,1
2020-09-04,Liechtenstein,LI,0,0,38378,Europe,108,1
2020-09-05,Liechtenstein,LI,0,0,38378,Europe,108,1
2020-09-06,Liechtenstein,LI,0,0,38378,Europe,108,1
2020-09-07,Liechtenstein,LI,0,0,38378,Europe,108,1
2020-09-08,Liechtenstein,LI,0,0,38378,Europe,108,1
2020-09-09,Liechtenstein,LI,0,0,38378,Europe,108,1
2020-09-10,Liechtenstein,LI,1,0,38378,Europe,109,1
2020-09-11,Liechtenstein,LI,0,0,38378,Europe,109,1
2020-09-12,Liechtenstein,LI,0,0,38378,Europe,109,1
2020-09-13,Liechtenstein,LI,0,0,38378,Europe,109,1
2020-09-14,Liechtenstein,LI,2,0,38378,Europe,111,1
2020-09-15,Liechtenstein,LI,0,0,38378,Europe,111,1
2020-09-16,Liechtenstein,LI,0,0,38378,Europe,111,1
2020-09-17,Liechtenstein,LI,0,0,38378,Europe,111,1
2020-09-18,Liechtenstein,LI,0,0,38378,Europe,111,1
2020-09-19,Liechtenstein,LI,1,0,38378,Europe,112,1
2020-09-20,Liechtenstein,LI,0,0,38378,Europe,112,1
2020-09-21,Liechtenstein,LI,0,0,38378,Europe,112,1
2020-09-22,Liechtenstein,LI,2,0,38378,Europe,114,1
2020-09-23,Liechtenstein,LI,2,0,38378,Europe,116,1
2020-09-24,Liechtenstein,LI,1,0,38378,Europe,117,1
2020-09-25,Liechtenstein,LI,0,0,38378,Europe,117,1
2020-09-26,Liechtenstein,LI,0,0,38378,Europe,117,1
2020-09-27,Liechtenstein,LI,0,0,38378,Europe,117,1
2020-09-28,Liechtenstein,LI,0,0,38378,Europe,117,1
2020-09-29,Liechtenstein,LI,1,0,38378,Europe,118,1
2020-09-30,Liechtenstein,LI,2,0,38378,Europe,120,1
2020-10-01,Liechtenstein,LI,0,0,38378,Europe,120,1
2020-10-02,Liechtenstein,LI,0,0,38378,Europe,120,1
2020-10-03,Liechtenstein,LI,1,0,38378,Europe,121,1
2020-10-04,Liechtenstein,LI,2,0,38378,Europe,123,1
2020-10-05,Liechtenstein,LI,3,0,38378,Europe,126,1
2020-10-06,Liechtenstein,LI,3,0,38378,Europe,129,1
2020-10-07,Liechtenstein,LI,1,0,38378,Europe,130,1
2020-10-08,Liechtenstein,LI,0,0,38378,Europe,130,1
2020-10-09,Liechtenstein,LI,6,0,38378,Europe,136,1
2020-10-10,Liechtenstein,LI,2,0,38378,Europe,138,1
2020-10-11,Liechtenstein,LI,0,0,38378,Europe,138,1
2020-10-12,Liechtenstein,LI,0,0,38378,Europe,138,1
2020-10-13,Liechtenstein,LI,11,0,38378,Europe,149,1
2020-10-14,Liechtenstein,LI,6,0,38378,Europe,155,1
2020-10-15,Liechtenstein,LI,0,0,38378,Europe,155,1
2020-10-16,Liechtenstein,LI,22,0,38378,Europe,177,1
2020-10-17,Liechtenstein,LI,18,0,38378,Europe,195,1
2020-10-18,Liechtenstein,LI,22,0,38378,Europe,217,1
2020-10-19,Liechtenstein,LI,7,0,38378,Europe,224,1
2020-10-20,Liechtenstein,LI,3,0,38378,Europe,227,1
2020-10-21,Liechtenstein,LI,22,0,38378,Europe,249,1
2020-10-22,Liechtenstein,LI,13,0,38378,Europe,262,1
2020-10-23,Liechtenstein,LI,26,0,38378,Europe,288,1
2020-10-24,Liechtenstein,LI,42,0,38378,Europe,330,1
2020-10-25,Liechtenstein,LI,10,0,38378,Europe,340,1
2020-10-26,Liechtenstein,LI,25,0,38378,Europe,365,1
2020-10-27,Liechtenstein,LI,48,0,38378,Europe,413,1
2020-10-28,Liechtenstein,LI,25,0,38378,Europe,438,1
2020-10-29,Liechtenstein,LI,23,0,38378,Europe,461,1
2020-10-30,Liechtenstein,LI,25,0,38378,Europe,486,1
2020-10-31,Liechtenstein,LI,37,1,38378,Europe,523,2
2020-11-01,Liechtenstein,LI,10,1,38378,Europe,533,3
2020-11-02,Liechtenstein,LI,18,0,38378,Europe,551,3
2020-11-03,Liechtenstein,LI,56,0,38378,Europe,607,3
2020-11-04,Liechtenstein,LI,36,0,38378,Europe,643,3
2020-11-05,Liechtenstein,LI,30,0,38378,Europe,673,3
2020-11-06,Liechtenstein,LI,30,0,38378,Europe,703,3
2020-11-07,Liechtenstein,LI,50,0,38378,Europe,753,3
2020-11-08,Liechtenstein,LI,12,0,38378,Europe,765,3
2020-11-09,Liechtenstein,LI,23,0,38378,Europe,788,3
2020-11-10,Liechtenstein,LI,29,0,38378,Europe,817,3
2020-11-11,Liechtenstein,LI,45,1,38378,Europe,862,4
2020-11-12,Liechtenstein,LI,32,0,38378,Europe,894,4
2020-11-13,Liechtenstein,LI,31,0,38378,Europe,925,4
2020-11-14,Liechtenstein,LI,24,0,38378,Europe,949,4
2020-11-15,Liechtenstein,LI,21,0,38378,Europe,970,4
2020-11-16,Liechtenstein,LI,15,0,38378,Europe,985,4
2020-11-17,Liechtenstein,LI,4,3,38378,Europe,989,7
2020-11-18,Liechtenstein,LI,13,1,38378,Europe,1002,8
2020-11-19,Liechtenstein,LI,49,0,38378,Europe,1051,8
2020-11-20,Liechtenstein,LI,21,0,38378,Europe,1072,8
2020-11-21,Liechtenstein,LI,22,0,38378,Europe,1094,8
2020-11-22,Liechtenstein,LI,15,0,38378,Europe,1109,8
2020-11-23,Liechtenstein,LI,3,0,38378,Europe,1112,8
2020-11-24,Liechtenstein,LI,69,0,38378,Europe,1181,8
2020-11-25,Liechtenstein,LI,20,5,38378,Europe,1201,13
2020-11-26,Liechtenstein,LI,14,1,38378,Europe,1215,14
2020-11-27,Liechtenstein,LI,41,0,38378,Europe,1256,14
2020-11-28,Liechtenstein,LI,17,1,38378,Europe,1273,15
2020-11-29,Liechtenstein,LI,0,0,38378,Europe,1273,15
2020-11-30,Liechtenstein,LI,0,0,38378,Europe,1273,15
2020-12-01,Liechtenstein,LI,29,0,38378,Europe,1302,15
2020-12-02,Liechtenstein,LI,42,0,38378,Europe,1344,15
2020-12-03,Liechtenstein,LI,0,1,38378,Europe,1344,16
2020-12-04,Liechtenstein,LI,40,0,38378,Europe,1384,16
2020-12-05,Liechtenstein,LI,12,0,38378,Europe,1396,16
2020-12-06,Liechtenstein,LI,0,0,38378,Europe,1396,16
2020-12-07,Liechtenstein,LI,0,0,38378,Europe,1396,16
2020-12-08,Liechtenstein,LI,35,1,38378,Europe,1431,17
2020-12-09,Liechtenstein,LI,16,0,38378,Europe,1447,17
2020-12-10,Liechtenstein,LI,27,0,38378,Europe,1474,17
2020-12-11,Liechtenstein,LI,3,0,38378,Europe,1477,17
2020-12-12,Liechtenstein,LI,25,1,38378,Europe,1502,18
2020-12-13,Liechtenstein,LI,0,0,38378,Europe,1502,18
2020-12-14,Liechtenstein,LI,12,0,38378,Europe,1514,18
2019-12-31,Sri_Lanka,LK,0,0,21323734,Asia,0,0
2020-01-01,Sri_Lanka,LK,0,0,21323734,Asia,0,0
2020-01-02,Sri_Lanka,LK,0,0,21323734,Asia,0,0
2020-01-03,Sri_Lanka,LK,0,0,21323734,Asia,0,0
2020-01-04,Sri_Lanka,LK,0,0,21323734,Asia,0,0
2020-01-05,Sri_Lanka,LK,0,0,21323734,Asia,0,0
2020-01-06,Sri_Lanka,LK,0,0,21323734,Asia,0,0
2020-01-07,Sri_Lanka,LK,0,0,21323734,Asia,0,0
2020-01-08,Sri_Lanka,LK,0,0,21323734,Asia,0,0
2020-01-09,Sri_Lanka,LK,0,0,21323734,Asia,0,0
2020-01-10,Sri_Lanka,LK,0,0,21323734,Asia,0,0
2020-01-11,Sri_Lanka,LK,0,0,21323734,Asia,0,0
2020-01-12,Sri_Lanka,LK,0,0,21323734,Asia,0,0
2020-01-13,Sri_Lanka,LK,0,0,21323734,Asia,0,0
2020-01-14,Sri_Lanka,LK,0,0,21323734,Asia,0,0
2020-01-15,Sri_Lanka,LK,0,0,21323734,Asia,0,0
2020-01-16,Sri_Lanka,LK,0,0,21323734,Asia,0,0
2020-01-17,Sri_Lanka,LK,0,0,21323734,Asia,0,0
2020-01-18,Sri_Lanka,LK,0,0,21323734,Asia,0,0
2020-01-19,Sri_Lanka,LK,0,0,21323734,Asia,0,0
2020-01-20,Sri_Lanka,LK,0,0,21323734,Asia,0,0
2020-01-21,Sri_Lanka,LK,0,0,21323734,Asia,0,0
2020-01-22,Sri_Lanka,LK,0,0,21323734,Asia,0,0
2020-01-23,Sri_Lanka,LK,0,0,21323734,Asia,0,0
2020-01-24,Sri_Lanka,LK,0,0,21323734,Asia,0,0
2020-01-25,Sri_Lanka,LK,0,0,21323734,Asia,0,0
2020-01-26,Sri_Lanka,LK,0,0,21323734,Asia,0,0
2020-01-27,Sri_Lanka,LK,0,0,21323734,Asia,0,0
2020-01-28,Sri_Lanka,LK,1,0,21323734,Asia,1,0
2020-01-29,Sri_Lanka,LK,0,0,21323734,Asia,1,0
2020-01-30,Sri_Lanka,LK,0,0,21323734,Asia,1,0
2020-01-31,Sri_Lanka,LK,0,0,21323734,Asia,1,0
2020-02-01,Sri_Lanka,LK,0,0,21323734,Asia,1,0
2020-02-02,Sri_Lanka,LK,0,0,21323734,Asia,1,0
2020-02-03,Sri_Lanka,LK,0,0,21323734,Asia,1,0
2020-02-04,Sri_Lanka,LK,0,0,21323734,Asia,1,0
2020-02-05,Sri_Lanka,LK,0,0,21323734,Asia,1,0
2020-02-06,Sri_Lanka,LK,0,0,21323734,Asia,1,0
2020-02-07,Sri_Lanka,LK,0,0,21323734,Asia,1,0
2020-02-08,Sri_Lanka,LK,0,0,21323734,Asia,1,0
2020-02-09,Sri_Lanka,LK,0,0,21323734,Asia,1,0
2020-02-10,Sri_Lanka,LK,0,0,21323734,Asia,1,0
2020-02-11,Sri_Lanka,LK,0,0,21323734,Asia,1,0
2020-02-12,Sri_Lanka,LK,0,0,21323734,Asia,1,0
2020-02-13,Sri_Lanka,LK,0,0,21323734,Asia,1,0
2020-02-14,Sri_Lanka,LK,0,0,21323734,Asia,1,0
2020-02-15,Sri_Lanka,LK,0,0,21323734,Asia,1,0
2020-02-16,Sri_Lanka,LK,0,0,21323734,Asia,1,0
2020-02-17,Sri_Lanka,LK,0,0,21323734,Asia,1,0
2020-02-18,Sri_Lanka,LK,0,0,21323734,Asia,1,0
2020-02-19,Sri_Lanka,LK,0,0,21323734,Asia,1,0
2020-02-20,Sri_Lanka,LK,0,0,21323734,Asia,1,0
2020-02-21,Sri_Lanka,LK,0,0,21323734,Asia,1,0
2020-02-22,Sri_Lanka,LK,0,0,21323734,Asia,1,0
2020-02-23,Sri_Lanka,LK,0,0,21323734,Asia,1,0
2020-02-24,Sri_Lanka,LK,0,0,21323734,Asia,1,0
2020-02-25,Sri_Lanka,LK,0,0,21323734,Asia,1,0
2020-02-26,Sri_Lanka,LK,0,0,21323734,Asia,1,0
2020-02-27,Sri_Lanka,LK,0,0,21323734,Asia,1,0
2020-02-28,Sri_Lanka,LK,0,0,21323734,Asia,1,0
2020-02-29,Sri_Lanka,LK,0,0,21323734,Asia,1,0
2020-03-01,Sri_Lanka,LK,0,0,21323734,Asia,1,0
2020-03-02,Sri_Lanka,LK,0,0,21323734,Asia,1,0
2020-03-12,Sri_Lanka,LK,1,0,21323734,Asia,2,0
2020-03-13,Sri_Lanka,LK,1,0,21323734,Asia,3,0
2020-03-14,Sri_Lanka,LK,3,0,21323734,Asia,6,0
2020-03-15,Sri_Lanka,LK,5,0,21323734,Asia,11,0
2020-03-16,Sri_Lanka,LK,8,0,21323734,Asia,19,0
2020-03-17,Sri_Lanka,LK,10,0,21323734,Asia,29,0
2020-03-18,Sri_Lanka,LK,13,0,21323734,Asia,42,0
2020-03-19,Sri_Lanka,LK,0,0,21323734,Asia,42,0
2020-03-20,Sri_Lanka,LK,11,0,21323734,Asia,53,0
2020-03-21,Sri_Lanka,LK,13,0,21323734,Asia,66,0
2020-03-22,Sri_Lanka,LK,12,0,21323734,Asia,78,0
2020-03-23,Sri_Lanka,LK,9,0,21323734,Asia,87,0
2020-03-24,Sri_Lanka,LK,10,0,21323734,Asia,97,0
2020-03-25,Sri_Lanka,LK,5,0,21323734,Asia,102,0
2020-03-26,Sri_Lanka,LK,0,0,21323734,Asia,102,0
2020-03-27,Sri_Lanka,LK,4,0,21323734,Asia,106,0
2020-03-28,Sri_Lanka,LK,0,0,21323734,Asia,106,0
2020-03-29,Sri_Lanka,LK,9,1,21323734,Asia,115,1
2020-03-30,Sri_Lanka,LK,5,0,21323734,Asia,120,1
2020-03-31,Sri_Lanka,LK,0,0,21323734,Asia,120,1
2020-04-01,Sri_Lanka,LK,2,1,21323734,Asia,122,2
2020-04-02,Sri_Lanka,LK,21,0,21323734,Asia,143,2
2020-04-03,Sri_Lanka,LK,5,1,21323734,Asia,148,3
2020-04-04,Sri_Lanka,LK,3,1,21323734,Asia,151,4
2020-04-05,Sri_Lanka,LK,8,1,21323734,Asia,159,5
2020-04-06,Sri_Lanka,LK,7,0,21323734,Asia,166,5
2020-04-07,Sri_Lanka,LK,12,0,21323734,Asia,178,5
2020-04-08,Sri_Lanka,LK,7,1,21323734,Asia,185,6
2020-04-09,Sri_Lanka,LK,4,1,21323734,Asia,189,7
2020-04-10,Sri_Lanka,LK,1,0,21323734,Asia,190,7
2020-04-11,Sri_Lanka,LK,7,0,21323734,Asia,197,7
2020-04-12,Sri_Lanka,LK,2,0,21323734,Asia,199,7
2020-04-13,Sri_Lanka,LK,11,0,21323734,Asia,210,7
2020-04-14,Sri_Lanka,LK,8,0,21323734,Asia,218,7
2020-04-15,Sri_Lanka,LK,15,0,21323734,Asia,233,7
2020-04-16,Sri_Lanka,LK,4,0,21323734,Asia,237,7
2020-04-17,Sri_Lanka,LK,1,0,21323734,Asia,238,7
2020-04-18,Sri_Lanka,LK,6,0,21323734,Asia,244,7
2020-04-19,Sri_Lanka,LK,10,0,21323734,Asia,254,7
2020-04-20,Sri_Lanka,LK,41,0,21323734,Asia,295,7
2020-04-21,Sri_Lanka,LK,9,0,21323734,Asia,304,7
2020-04-22,Sri_Lanka,LK,6,0,21323734,Asia,310,7
2020-04-23,Sri_Lanka,LK,20,0,21323734,Asia,330,7
2020-04-24,Sri_Lanka,LK,38,0,21323734,Asia,368,7
2020-04-25,Sri_Lanka,LK,52,0,21323734,Asia,420,7
2020-04-26,Sri_Lanka,LK,42,0,21323734,Asia,462,7
2020-04-27,Sri_Lanka,LK,61,0,21323734,Asia,523,7
2020-04-28,Sri_Lanka,LK,65,0,21323734,Asia,588,7
2020-04-29,Sri_Lanka,LK,31,0,21323734,Asia,619,7
2020-04-30,Sri_Lanka,LK,30,0,21323734,Asia,649,7
2020-05-01,Sri_Lanka,LK,16,0,21323734,Asia,665,7
2020-05-02,Sri_Lanka,LK,25,0,21323734,Asia,690,7
2020-05-03,Sri_Lanka,LK,15,0,21323734,Asia,705,7
2020-05-04,Sri_Lanka,LK,13,0,21323734,Asia,718,7
2020-05-05,Sri_Lanka,LK,37,1,21323734,Asia,755,8
2020-05-06,Sri_Lanka,LK,16,1,21323734,Asia,771,9
2020-05-07,Sri_Lanka,LK,26,0,21323734,Asia,797,9
2020-05-08,Sri_Lanka,LK,27,0,21323734,Asia,824,9
2020-05-09,Sri_Lanka,LK,11,0,21323734,Asia,835,9
2020-05-10,Sri_Lanka,LK,12,0,21323734,Asia,847,9
2020-05-11,Sri_Lanka,LK,16,0,21323734,Asia,863,9
2020-05-12,Sri_Lanka,LK,6,0,21323734,Asia,869,9
2020-05-13,Sri_Lanka,LK,20,0,21323734,Asia,889,9
2020-05-14,Sri_Lanka,LK,26,0,21323734,Asia,915,9
2020-05-15,Sri_Lanka,LK,10,0,21323734,Asia,925,9
2020-05-16,Sri_Lanka,LK,10,0,21323734,Asia,935,9
2020-05-17,Sri_Lanka,LK,25,0,21323734,Asia,960,9
2020-05-18,Sri_Lanka,LK,21,0,21323734,Asia,981,9
2020-05-19,Sri_Lanka,LK,11,0,21323734,Asia,992,9
2020-05-20,Sri_Lanka,LK,35,0,21323734,Asia,1027,9
2020-05-21,Sri_Lanka,LK,1,0,21323734,Asia,1028,9
2020-05-22,Sri_Lanka,LK,27,0,21323734,Asia,1055,9
2020-05-23,Sri_Lanka,LK,13,0,21323734,Asia,1068,9
2020-05-24,Sri_Lanka,LK,21,0,21323734,Asia,1089,9
2020-05-25,Sri_Lanka,LK,52,0,21323734,Asia,1141,9
2020-05-26,Sri_Lanka,LK,41,1,21323734,Asia,1182,10
2020-05-27,Sri_Lanka,LK,137,0,21323734,Asia,1319,10
2020-05-28,Sri_Lanka,LK,150,0,21323734,Asia,1469,10
2020-05-29,Sri_Lanka,LK,61,0,21323734,Asia,1530,10
2020-05-30,Sri_Lanka,LK,28,0,21323734,Asia,1558,10
2020-05-31,Sri_Lanka,LK,62,0,21323734,Asia,1620,10
2020-06-01,Sri_Lanka,LK,13,0,21323734,Asia,1633,10
2020-06-02,Sri_Lanka,LK,10,1,21323734,Asia,1643,11
2020-06-03,Sri_Lanka,LK,40,0,21323734,Asia,1683,11
2020-06-04,Sri_Lanka,LK,66,0,21323734,Asia,1749,11
2020-06-05,Sri_Lanka,LK,48,0,21323734,Asia,1797,11
2020-06-06,Sri_Lanka,LK,4,0,21323734,Asia,1801,11
2020-06-07,Sri_Lanka,LK,13,0,21323734,Asia,1814,11
2020-06-08,Sri_Lanka,LK,21,0,21323734,Asia,1835,11
2020-06-09,Sri_Lanka,LK,22,0,21323734,Asia,1857,11
2020-06-10,Sri_Lanka,LK,2,0,21323734,Asia,1859,11
2020-06-11,Sri_Lanka,LK,10,0,21323734,Asia,1869,11
2020-06-12,Sri_Lanka,LK,8,0,21323734,Asia,1877,11
2020-06-13,Sri_Lanka,LK,3,0,21323734,Asia,1880,11
2020-06-14,Sri_Lanka,LK,4,0,21323734,Asia,1884,11
2020-06-15,Sri_Lanka,LK,5,0,21323734,Asia,1889,11
2020-06-16,Sri_Lanka,LK,16,0,21323734,Asia,1905,11
2020-06-17,Sri_Lanka,LK,10,0,21323734,Asia,1915,11
2020-06-18,Sri_Lanka,LK,9,0,21323734,Asia,1924,11
2020-06-19,Sri_Lanka,LK,23,0,21323734,Asia,1947,11
2020-06-20,Sri_Lanka,LK,3,0,21323734,Asia,1950,11
2020-06-21,Sri_Lanka,LK,0,0,21323734,Asia,1950,11
2020-06-22,Sri_Lanka,LK,0,0,21323734,Asia,1950,11
2020-06-23,Sri_Lanka,LK,1,0,21323734,Asia,1951,11
2020-06-24,Sri_Lanka,LK,40,0,21323734,Asia,1991,11
2020-06-25,Sri_Lanka,LK,10,0,21323734,Asia,2001,11
2020-06-26,Sri_Lanka,LK,9,0,21323734,Asia,2010,11
2020-06-27,Sri_Lanka,LK,4,0,21323734,Asia,2014,11
2020-06-28,Sri_Lanka,LK,19,0,21323734,Asia,2033,11
2020-06-29,Sri_Lanka,LK,4,0,21323734,Asia,2037,11
2020-06-30,Sri_Lanka,LK,5,0,21323734,Asia,2042,11
2020-07-01,Sri_Lanka,LK,5,0,21323734,Asia,2047,11
2020-07-02,Sri_Lanka,LK,7,0,21323734,Asia,2054,11
2020-07-03,Sri_Lanka,LK,12,0,21323734,Asia,2066,11
2020-07-04,Sri_Lanka,LK,3,0,21323734,Asia,2069,11
2020-07-05,Sri_Lanka,LK,5,0,21323734,Asia,2074,11
2020-07-06,Sri_Lanka,LK,2,0,21323734,Asia,2076,11
2020-07-07,Sri_Lanka,LK,2,0,21323734,Asia,2078,11
2020-07-08,Sri_Lanka,LK,3,0,21323734,Asia,2081,11
2020-07-09,Sri_Lanka,LK,13,0,21323734,Asia,2094,11
2020-07-10,Sri_Lanka,LK,256,0,21323734,Asia,2350,11
2020-07-11,Sri_Lanka,LK,104,0,21323734,Asia,2454,11
2020-07-12,Sri_Lanka,LK,57,0,21323734,Asia,2511,11
2020-07-13,Sri_Lanka,LK,106,0,21323734,Asia,2617,11
2020-07-14,Sri_Lanka,LK,29,0,21323734,Asia,2646,11
2020-07-15,Sri_Lanka,LK,19,0,21323734,Asia,2665,11
2020-07-16,Sri_Lanka,LK,9,0,21323734,Asia,2674,11
2020-07-17,Sri_Lanka,LK,13,0,21323734,Asia,2687,11
2020-07-18,Sri_Lanka,LK,10,0,21323734,Asia,2697,11
2020-07-19,Sri_Lanka,LK,7,0,21323734,Asia,2704,11
2020-07-20,Sri_Lanka,LK,20,0,21323734,Asia,2724,11
2020-07-21,Sri_Lanka,LK,6,0,21323734,Asia,2730,11
2020-07-22,Sri_Lanka,LK,0,0,21323734,Asia,2730,11
2020-07-23,Sri_Lanka,LK,22,0,21323734,Asia,2752,11
2020-07-24,Sri_Lanka,LK,1,0,21323734,Asia,2753,11
2020-07-25,Sri_Lanka,LK,11,0,21323734,Asia,2764,11
2020-07-26,Sri_Lanka,LK,6,0,21323734,Asia,2770,11
2020-07-27,Sri_Lanka,LK,12,0,21323734,Asia,2782,11
2020-07-28,Sri_Lanka,LK,23,0,21323734,Asia,2805,11
2020-07-29,Sri_Lanka,LK,5,0,21323734,Asia,2810,11
2020-07-30,Sri_Lanka,LK,1,0,21323734,Asia,2811,11
2020-07-31,Sri_Lanka,LK,3,0,21323734,Asia,2814,11
2020-08-01,Sri_Lanka,LK,1,0,21323734,Asia,2815,11
2020-08-02,Sri_Lanka,LK,0,0,21323734,Asia,2815,11
2020-08-03,Sri_Lanka,LK,8,0,21323734,Asia,2823,11
2020-08-04,Sri_Lanka,LK,5,0,21323734,Asia,2828,11
2020-08-05,Sri_Lanka,LK,6,0,21323734,Asia,2834,11
2020-08-06,Sri_Lanka,LK,5,0,21323734,Asia,2839,11
2020-08-07,Sri_Lanka,LK,0,0,21323734,Asia,2839,11
2020-08-08,Sri_Lanka,LK,0,0,21323734,Asia,2839,11
2020-08-09,Sri_Lanka,LK,2,0,21323734,Asia,2841,11
2020-08-10,Sri_Lanka,LK,3,0,21323734,Asia,2844,11
2020-08-11,Sri_Lanka,LK,27,0,21323734,Asia,2871,11
2020-08-12,Sri_Lanka,LK,9,0,21323734,Asia,2880,11
2020-08-13,Sri_Lanka,LK,1,0,21323734,Asia,2881,11
2020-08-14,Sri_Lanka,LK,1,0,21323734,Asia,2882,11
2020-08-15,Sri_Lanka,LK,4,0,21323734,Asia,2886,11
2020-08-16,Sri_Lanka,LK,4,0,21323734,Asia,2890,11
2020-08-17,Sri_Lanka,LK,3,0,21323734,Asia,2893,11
2020-08-18,Sri_Lanka,LK,7,0,21323734,Asia,2900,11
2020-08-19,Sri_Lanka,LK,2,0,21323734,Asia,2902,11
2020-08-20,Sri_Lanka,LK,0,0,21323734,Asia,2902,11
2020-08-21,Sri_Lanka,LK,16,0,21323734,Asia,2918,11
2020-08-22,Sri_Lanka,LK,23,0,21323734,Asia,2941,11
2020-08-23,Sri_Lanka,LK,6,1,21323734,Asia,2947,12
2020-08-24,Sri_Lanka,LK,6,0,21323734,Asia,2953,12
2020-08-25,Sri_Lanka,LK,6,0,21323734,Asia,2959,12
2020-08-26,Sri_Lanka,LK,12,0,21323734,Asia,2971,12
2020-08-27,Sri_Lanka,LK,13,0,21323734,Asia,2984,12
2020-08-28,Sri_Lanka,LK,2,0,21323734,Asia,2986,12
2020-08-29,Sri_Lanka,LK,3,0,21323734,Asia,2989,12
2020-08-30,Sri_Lanka,LK,6,0,21323734,Asia,2995,12
2020-08-31,Sri_Lanka,LK,17,0,21323734,Asia,3012,12
2020-09-01,Sri_Lanka,LK,37,0,21323734,Asia,3049,12
2020-09-02,Sri_Lanka,LK,43,0,21323734,Asia,3092,12
2020-09-03,Sri_Lanka,LK,9,0,21323734,Asia,3101,12
2020-09-04,Sri_Lanka,LK,10,0,21323734,Asia,3111,12
2020-09-05,Sri_Lanka,LK,4,0,21323734,Asia,3115,12
2020-09-06,Sri_Lanka,LK,6,0,21323734,Asia,3121,12
2020-09-07,Sri_Lanka,LK,2,0,21323734,Asia,3123,12
2020-09-08,Sri_Lanka,LK,0,0,21323734,Asia,3123,12
2020-09-09,Sri_Lanka,LK,17,0,21323734,Asia,3140,12
2020-09-10,Sri_Lanka,LK,7,0,21323734,Asia,3147,12
2020-09-11,Sri_Lanka,LK,8,0,21323734,Asia,3155,12
2020-09-12,Sri_Lanka,LK,14,0,21323734,Asia,3169,12
2020-09-13,Sri_Lanka,LK,27,0,21323734,Asia,3196,12
2020-09-14,Sri_Lanka,LK,38,0,21323734,Asia,3234,12
2020-09-15,Sri_Lanka,LK,28,1,21323734,Asia,3262,13
2020-09-16,Sri_Lanka,LK,9,0,21323734,Asia,3271,13
2020-09-17,Sri_Lanka,LK,0,0,21323734,Asia,3271,13
2020-09-18,Sri_Lanka,LK,5,0,21323734,Asia,3276,13
2020-09-19,Sri_Lanka,LK,5,0,21323734,Asia,3281,13
2020-09-20,Sri_Lanka,LK,2,0,21323734,Asia,3283,13
2020-09-21,Sri_Lanka,LK,4,0,21323734,Asia,3287,13
2020-09-22,Sri_Lanka,LK,12,0,21323734,Asia,3299,13
2020-09-23,Sri_Lanka,LK,14,0,21323734,Asia,3313,13
2020-09-24,Sri_Lanka,LK,11,0,21323734,Asia,3324,13
2020-09-25,Sri_Lanka,LK,9,0,21323734,Asia,3333,13
2020-09-26,Sri_Lanka,LK,12,0,21323734,Asia,3345,13
2020-09-27,Sri_Lanka,LK,4,0,21323734,Asia,3349,13
2020-09-28,Sri_Lanka,LK,11,0,21323734,Asia,3360,13
2020-09-29,Sri_Lanka,LK,3,0,21323734,Asia,3363,13
2020-09-30,Sri_Lanka,LK,11,0,21323734,Asia,3374,13
2020-10-01,Sri_Lanka,LK,6,0,21323734,Asia,3380,13
2020-10-02,Sri_Lanka,LK,2,0,21323734,Asia,3382,13
2020-10-03,Sri_Lanka,LK,6,0,21323734,Asia,3388,13
2020-10-04,Sri_Lanka,LK,8,0,21323734,Asia,3396,13
2020-10-05,Sri_Lanka,LK,6,0,21323734,Asia,3402,13
2020-10-06,Sri_Lanka,LK,331,0,21323734,Asia,3733,13
2020-10-07,Sri_Lanka,LK,519,0,21323734,Asia,4252,13
2020-10-08,Sri_Lanka,LK,207,0,21323734,Asia,4459,13
2020-10-09,Sri_Lanka,LK,29,0,21323734,Asia,4488,13
2020-10-10,Sri_Lanka,LK,35,0,21323734,Asia,4523,13
2020-10-11,Sri_Lanka,LK,105,0,21323734,Asia,4628,13
2020-10-12,Sri_Lanka,LK,124,0,21323734,Asia,4752,13
2020-10-13,Sri_Lanka,LK,92,0,21323734,Asia,4844,13
2020-10-14,Sri_Lanka,LK,194,0,21323734,Asia,5038,13
2020-10-15,Sri_Lanka,LK,132,0,21323734,Asia,5170,13
2020-10-16,Sri_Lanka,LK,74,0,21323734,Asia,5244,13
2020-10-17,Sri_Lanka,LK,110,0,21323734,Asia,5354,13
2020-10-18,Sri_Lanka,LK,121,0,21323734,Asia,5475,13
2020-10-19,Sri_Lanka,LK,63,0,21323734,Asia,5538,13
2020-10-20,Sri_Lanka,LK,87,0,21323734,Asia,5625,13
2020-10-21,Sri_Lanka,LK,186,0,21323734,Asia,5811,13
2020-10-22,Sri_Lanka,LK,167,0,21323734,Asia,5978,13
2020-10-23,Sri_Lanka,LK,309,1,21323734,Asia,6287,14
2020-10-24,Sri_Lanka,LK,866,0,21323734,Asia,7153,14
2020-10-25,Sri_Lanka,LK,368,1,21323734,Asia,7521,15
2020-10-26,Sri_Lanka,LK,351,0,21323734,Asia,7872,15
2020-10-27,Sri_Lanka,LK,541,1,21323734,Asia,8413,16
2020-10-28,Sri_Lanka,LK,457,3,21323734,Asia,8870,19
2020-10-29,Sri_Lanka,LK,335,0,21323734,Asia,9205,19
2020-10-30,Sri_Lanka,LK,586,0,21323734,Asia,9791,19
2020-10-31,Sri_Lanka,LK,633,0,21323734,Asia,10424,19
2020-11-01,Sri_Lanka,LK,239,1,21323734,Asia,10663,20
2020-11-02,Sri_Lanka,LK,397,1,21323734,Asia,11060,21
2020-11-03,Sri_Lanka,LK,275,0,21323734,Asia,11335,21
2020-11-04,Sri_Lanka,LK,409,2,21323734,Asia,11744,23
2020-11-05,Sri_Lanka,LK,443,1,21323734,Asia,12187,24
2020-11-06,Sri_Lanka,LK,383,5,21323734,Asia,12570,29
2020-11-07,Sri_Lanka,LK,400,1,21323734,Asia,12970,30
2020-11-08,Sri_Lanka,LK,449,4,21323734,Asia,13419,34
2020-11-09,Sri_Lanka,LK,510,1,21323734,Asia,13929,35
2020-11-10,Sri_Lanka,LK,356,1,21323734,Asia,14285,36
2020-11-11,Sri_Lanka,LK,430,5,21323734,Asia,14715,41
2020-11-12,Sri_Lanka,LK,635,5,21323734,Asia,15350,46
2020-11-13,Sri_Lanka,LK,373,2,21323734,Asia,15723,48
2020-11-14,Sri_Lanka,LK,468,5,21323734,Asia,16191,53
2020-11-15,Sri_Lanka,LK,392,0,21323734,Asia,16583,53
2020-11-16,Sri_Lanka,LK,704,5,21323734,Asia,17287,58
2020-11-17,Sri_Lanka,LK,387,3,21323734,Asia,17674,61
2020-11-18,Sri_Lanka,LK,401,5,21323734,Asia,18075,66
2020-11-19,Sri_Lanka,LK,327,3,21323734,Asia,18402,69
2020-11-20,Sri_Lanka,LK,439,4,21323734,Asia,18841,73
2020-11-21,Sri_Lanka,LK,439,1,21323734,Asia,19280,74
2020-11-22,Sri_Lanka,LK,491,9,21323734,Asia,19771,83
2020-11-23,Sri_Lanka,LK,400,4,21323734,Asia,20171,87
2020-11-24,Sri_Lanka,LK,337,3,21323734,Asia,20508,90
2020-11-25,Sri_Lanka,LK,459,4,21323734,Asia,20967,94
2020-11-26,Sri_Lanka,LK,502,2,21323734,Asia,21469,96
2020-11-27,Sri_Lanka,LK,559,3,21323734,Asia,22028,99
2020-11-28,Sri_Lanka,LK,473,8,21323734,Asia,22501,107
2020-11-29,Sri_Lanka,LK,487,2,21323734,Asia,22988,109
2020-11-30,Sri_Lanka,LK,496,7,21323734,Asia,23484,116
2020-12-01,Sri_Lanka,LK,503,2,21323734,Asia,23987,118
2020-12-02,Sri_Lanka,LK,545,4,21323734,Asia,24532,122
2020-12-03,Sri_Lanka,LK,878,2,21323734,Asia,25410,124
2020-12-04,Sri_Lanka,LK,628,5,21323734,Asia,26038,129
2020-12-05,Sri_Lanka,LK,521,1,21323734,Asia,26559,130
2020-12-06,Sri_Lanka,LK,669,7,21323734,Asia,27228,137
2020-12-07,Sri_Lanka,LK,649,3,21323734,Asia,27877,140
2020-12-08,Sri_Lanka,LK,703,2,21323734,Asia,28580,142
2020-12-09,Sri_Lanka,LK,798,0,21323734,Asia,29378,142
2020-12-10,Sri_Lanka,LK,697,2,21323734,Asia,30075,144
2020-12-11,Sri_Lanka,LK,538,2,21323734,Asia,30613,146
2020-12-12,Sri_Lanka,LK,762,1,21323734,Asia,31375,147
2020-12-13,Sri_Lanka,LK,760,2,21323734,Asia,32135,149
2020-12-14,Sri_Lanka,LK,655,3,21323734,Asia,32790,152
2020-03-17,Liberia,LR,1,0,4937374,Africa,1,0
2020-03-18,Liberia,LR,1,0,4937374,Africa,2,0
2020-03-19,Liberia,LR,0,0,4937374,Africa,2,0
2020-03-20,Liberia,LR,0,0,4937374,Africa,2,0
2020-03-21,Liberia,LR,0,0,4937374,Africa,2,0
2020-03-22,Liberia,LR,1,0,4937374,Africa,3,0
2020-03-23,Liberia,LR,0,0,4937374,Africa,3,0
2020-03-24,Liberia,LR,0,0,4937374,Africa,3,0
2020-03-25,Liberia,LR,0,0,4937374,Africa,3,0
2020-03-26,Liberia,LR,0,0,4937374,Africa,3,0
2020-03-27,Liberia,LR,0,0,4937374,Africa,3,0
2020-03-28,Liberia,LR,0,0,4937374,Africa,3,0
2020-03-29,Liberia,LR,0,0,4937374,Africa,3,0
2020-03-30,Liberia,LR,0,0,4937374,Africa,3,0
2020-03-31,Liberia,LR,0,0,4937374,Africa,3,0
2020-04-01,Liberia,LR,0,0,4937374,Africa,3,0
2020-04-02,Liberia,LR,3,0,4937374,Africa,6,0
2020-04-03,Liberia,LR,0,0,4937374,Africa,6,0
2020-04-04,Liberia,LR,1,0,4937374,Africa,7,0
2020-04-05,Liberia,LR,3,1,4937374,Africa,10,1
2020-04-06,Liberia,LR,3,2,4937374,Africa,13,3
2020-04-07,Liberia,LR,1,0,4937374,Africa,14,3
2020-04-08,Liberia,LR,0,0,4937374,Africa,14,3
2020-04-09,Liberia,LR,17,1,4937374,Africa,31,4
2020-04-10,Liberia,LR,0,0,4937374,Africa,31,4
2020-04-11,Liberia,LR,6,0,4937374,Africa,37,4
2020-04-12,Liberia,LR,11,1,4937374,Africa,48,5
2020-04-13,Liberia,LR,2,0,4937374,Africa,50,5
2020-04-14,Liberia,LR,9,1,4937374,Africa,59,6
2020-04-15,Liberia,LR,0,0,4937374,Africa,59,6
2020-04-16,Liberia,LR,0,0,4937374,Africa,59,6
2020-04-17,Liberia,LR,14,0,4937374,Africa,73,6
2020-04-18,Liberia,LR,3,1,4937374,Africa,76,7
2020-04-19,Liberia,LR,5,0,4937374,Africa,81,7
2020-04-20,Liberia,LR,10,1,4937374,Africa,91,8
2020-04-21,Liberia,LR,8,0,4937374,Africa,99,8
2020-04-22,Liberia,LR,2,0,4937374,Africa,101,8
2020-04-23,Liberia,LR,0,0,4937374,Africa,101,8
2020-04-24,Liberia,LR,0,0,4937374,Africa,101,8
2020-04-25,Liberia,LR,16,0,4937374,Africa,117,8
2020-04-26,Liberia,LR,3,3,4937374,Africa,120,11
2020-04-27,Liberia,LR,4,1,4937374,Africa,124,12
2020-04-28,Liberia,LR,9,4,4937374,Africa,133,16
2020-04-29,Liberia,LR,8,0,4937374,Africa,141,16
2020-04-30,Liberia,LR,0,0,4937374,Africa,141,16
2020-05-01,Liberia,LR,0,0,4937374,Africa,141,16
2020-05-02,Liberia,LR,11,2,4937374,Africa,152,18
2020-05-03,Liberia,LR,2,0,4937374,Africa,154,18
2020-05-04,Liberia,LR,4,0,4937374,Africa,158,18
2020-05-05,Liberia,LR,8,0,4937374,Africa,166,18
2020-05-06,Liberia,LR,4,2,4937374,Africa,170,20
2020-05-07,Liberia,LR,8,0,4937374,Africa,178,20
2020-05-08,Liberia,LR,11,0,4937374,Africa,189,20
2020-05-09,Liberia,LR,10,0,4937374,Africa,199,20
2020-05-10,Liberia,LR,0,0,4937374,Africa,199,20
2020-05-11,Liberia,LR,0,0,4937374,Africa,199,20
2020-05-12,Liberia,LR,12,0,4937374,Africa,211,20
2020-05-13,Liberia,LR,1,0,4937374,Africa,212,20
2020-05-14,Liberia,LR,1,0,4937374,Africa,213,20
2020-05-15,Liberia,LR,2,0,4937374,Africa,215,20
2020-05-16,Liberia,LR,4,0,4937374,Africa,219,20
2020-05-17,Liberia,LR,4,0,4937374,Africa,223,20
2020-05-18,Liberia,LR,3,1,4937374,Africa,226,21
2020-05-19,Liberia,LR,3,1,4937374,Africa,229,22
2020-05-20,Liberia,LR,4,1,4937374,Africa,233,23
2020-05-21,Liberia,LR,5,0,4937374,Africa,238,23
2020-05-22,Liberia,LR,2,0,4937374,Africa,240,23
2020-05-23,Liberia,LR,9,1,4937374,Africa,249,24
2020-05-24,Liberia,LR,6,2,4937374,Africa,255,26
2020-05-25,Liberia,LR,10,0,4937374,Africa,265,26
2020-05-26,Liberia,LR,0,0,4937374,Africa,265,26
2020-05-27,Liberia,LR,1,0,4937374,Africa,266,26
2020-05-28,Liberia,LR,0,1,4937374,Africa,266,27
2020-05-29,Liberia,LR,3,0,4937374,Africa,269,27
2020-05-30,Liberia,LR,4,0,4937374,Africa,273,27
2020-05-31,Liberia,LR,7,0,4937374,Africa,280,27
2020-06-01,Liberia,LR,8,0,4937374,Africa,288,27
2020-06-02,Liberia,LR,8,0,4937374,Africa,296,27
2020-06-03,Liberia,LR,15,1,4937374,Africa,311,28
2020-06-04,Liberia,LR,5,0,4937374,Africa,316,28
2020-06-05,Liberia,LR,5,0,4937374,Africa,321,28
2020-06-06,Liberia,LR,13,2,4937374,Africa,334,30
2020-06-07,Liberia,LR,11,0,4937374,Africa,345,30
2020-06-08,Liberia,LR,14,0,4937374,Africa,359,30
2020-06-09,Liberia,LR,11,0,4937374,Africa,370,30
2020-06-10,Liberia,LR,13,1,4937374,Africa,383,31
2020-06-11,Liberia,LR,14,0,4937374,Africa,397,31
2020-06-12,Liberia,LR,13,0,4937374,Africa,410,31
2020-06-13,Liberia,LR,11,1,4937374,Africa,421,32
2020-06-14,Liberia,LR,25,0,4937374,Africa,446,32
2020-06-15,Liberia,LR,12,0,4937374,Africa,458,32
2020-06-16,Liberia,LR,40,1,4937374,Africa,498,33
2020-06-17,Liberia,LR,11,0,4937374,Africa,509,33
2020-06-18,Liberia,LR,0,0,4937374,Africa,509,33
2020-06-19,Liberia,LR,33,0,4937374,Africa,542,33
2020-06-20,Liberia,LR,39,0,4937374,Africa,581,33
2020-06-21,Liberia,LR,20,0,4937374,Africa,601,33
2020-06-22,Liberia,LR,25,1,4937374,Africa,626,34
2020-06-23,Liberia,LR,24,0,4937374,Africa,650,34
2020-06-24,Liberia,LR,2,0,4937374,Africa,652,34
2020-06-25,Liberia,LR,10,0,4937374,Africa,662,34
2020-06-26,Liberia,LR,19,0,4937374,Africa,681,34
2020-06-27,Liberia,LR,3,0,4937374,Africa,684,34
2020-06-28,Liberia,LR,45,0,4937374,Africa,729,34
2020-06-29,Liberia,LR,39,0,4937374,Africa,768,34
2020-06-30,Liberia,LR,2,2,4937374,Africa,770,36
2020-07-01,Liberia,LR,10,0,4937374,Africa,780,36
2020-07-02,Liberia,LR,24,1,4937374,Africa,804,37
2020-07-03,Liberia,LR,15,0,4937374,Africa,819,37
2020-07-04,Liberia,LR,14,0,4937374,Africa,833,37
2020-07-05,Liberia,LR,36,0,4937374,Africa,869,37
2020-07-06,Liberia,LR,5,0,4937374,Africa,874,37
2020-07-07,Liberia,LR,17,2,4937374,Africa,891,39
2020-07-08,Liberia,LR,26,2,4937374,Africa,917,41
2020-07-09,Liberia,LR,9,0,4937374,Africa,926,41
2020-07-10,Liberia,LR,31,1,4937374,Africa,957,42
2020-07-11,Liberia,LR,6,5,4937374,Africa,963,47
2020-07-12,Liberia,LR,35,0,4937374,Africa,998,47
2020-07-13,Liberia,LR,12,4,4937374,Africa,1010,51
2020-07-14,Liberia,LR,14,0,4937374,Africa,1024,51
2020-07-15,Liberia,LR,0,0,4937374,Africa,1024,51
2020-07-16,Liberia,LR,32,15,4937374,Africa,1056,66
2020-07-17,Liberia,LR,14,2,4937374,Africa,1070,68
2020-07-18,Liberia,LR,15,1,4937374,Africa,1085,69
2020-07-19,Liberia,LR,3,1,4937374,Africa,1088,70
2020-07-20,Liberia,LR,3,0,4937374,Africa,1091,70
2020-07-21,Liberia,LR,16,0,4937374,Africa,1107,70
2020-07-22,Liberia,LR,1,0,4937374,Africa,1108,70
2020-07-23,Liberia,LR,6,0,4937374,Africa,1114,70
2020-07-24,Liberia,LR,3,1,4937374,Africa,1117,71
2020-07-25,Liberia,LR,18,0,4937374,Africa,1135,71
2020-07-26,Liberia,LR,20,0,4937374,Africa,1155,71
2020-07-27,Liberia,LR,7,1,4937374,Africa,1162,72
2020-07-28,Liberia,LR,5,0,4937374,Africa,1167,72
2020-07-29,Liberia,LR,10,0,4937374,Africa,1177,72
2020-07-30,Liberia,LR,2,0,4937374,Africa,1179,72
2020-07-31,Liberia,LR,2,1,4937374,Africa,1181,73
2020-08-01,Liberia,LR,5,2,4937374,Africa,1186,75
2020-08-02,Liberia,LR,3,0,4937374,Africa,1189,75
2020-08-03,Liberia,LR,18,2,4937374,Africa,1207,77
2020-08-04,Liberia,LR,7,1,4937374,Africa,1214,78
2020-08-05,Liberia,LR,2,0,4937374,Africa,1216,78
2020-08-06,Liberia,LR,5,0,4937374,Africa,1221,78
2020-08-07,Liberia,LR,3,0,4937374,Africa,1224,78
2020-08-08,Liberia,LR,6,0,4937374,Africa,1230,78
2020-08-09,Liberia,LR,4,1,4937374,Africa,1234,79
2020-08-10,Liberia,LR,3,0,4937374,Africa,1237,79
2020-08-11,Liberia,LR,3,0,4937374,Africa,1240,79
2020-08-12,Liberia,LR,10,2,4937374,Africa,1250,81
2020-08-13,Liberia,LR,2,1,4937374,Africa,1252,82
2020-08-14,Liberia,LR,0,0,4937374,Africa,1252,82
2020-08-15,Liberia,LR,0,0,4937374,Africa,1252,82
2020-08-16,Liberia,LR,5,0,4937374,Africa,1257,82
2020-08-17,Liberia,LR,0,0,4937374,Africa,1257,82
2020-08-18,Liberia,LR,20,0,4937374,Africa,1277,82
2020-08-19,Liberia,LR,5,0,4937374,Africa,1282,82
2020-08-20,Liberia,LR,0,0,4937374,Africa,1282,82
2020-08-21,Liberia,LR,2,0,4937374,Africa,1284,82
2020-08-22,Liberia,LR,1,0,4937374,Africa,1285,82
2020-08-23,Liberia,LR,1,0,4937374,Africa,1286,82
2020-08-24,Liberia,LR,0,0,4937374,Africa,1286,82
2020-08-25,Liberia,LR,4,0,4937374,Africa,1290,82
2020-08-26,Liberia,LR,5,0,4937374,Africa,1295,82
2020-08-27,Liberia,LR,3,0,4937374,Africa,1298,82
2020-08-28,Liberia,LR,0,0,4937374,Africa,1298,82
2020-08-29,Liberia,LR,0,0,4937374,Africa,1298,82
2020-08-30,Liberia,LR,6,0,4937374,Africa,1304,82
2020-08-31,Liberia,LR,0,0,4937374,Africa,1304,82
2020-09-01,Liberia,LR,0,0,4937374,Africa,1304,82
2020-09-02,Liberia,LR,1,0,4937374,Africa,1305,82
2020-09-03,Liberia,LR,0,0,4937374,Africa,1305,82
2020-09-04,Liberia,LR,1,0,4937374,Africa,1306,82
2020-09-05,Liberia,LR,0,0,4937374,Africa,1306,82
2020-09-06,Liberia,LR,0,0,4937374,Africa,1306,82
2020-09-07,Liberia,LR,1,0,4937374,Africa,1307,82
2020-09-08,Liberia,LR,4,0,4937374,Africa,1311,82
2020-09-09,Liberia,LR,0,0,4937374,Africa,1311,82
2020-09-10,Liberia,LR,2,0,4937374,Africa,1313,82
2020-09-11,Liberia,LR,2,0,4937374,Africa,1315,82
2020-09-12,Liberia,LR,0,0,4937374,Africa,1315,82
2020-09-13,Liberia,LR,1,0,4937374,Africa,1316,82
2020-09-14,Liberia,LR,3,0,4937374,Africa,1319,82
2020-09-15,Liberia,LR,2,0,4937374,Africa,1321,82
2020-09-16,Liberia,LR,6,0,4937374,Africa,1327,82
2020-09-17,Liberia,LR,5,0,4937374,Africa,1332,82
2020-09-18,Liberia,LR,1,0,4937374,Africa,1333,82
2020-09-19,Liberia,LR,1,0,4937374,Africa,1334,82
2020-09-20,Liberia,LR,1,0,4937374,Africa,1335,82
2020-09-21,Liberia,LR,0,0,4937374,Africa,1335,82
2020-09-22,Liberia,LR,1,0,4937374,Africa,1336,82
2020-09-23,Liberia,LR,0,0,4937374,Africa,1336,82
2020-09-24,Liberia,LR,1,0,4937374,Africa,1337,82
2020-09-25,Liberia,LR,1,0,4937374,Africa,1338,82
2020-09-26,Liberia,LR,0,0,4937374,Africa,1338,82
2020-09-27,Liberia,LR,0,0,4937374,Africa,1338,82
2020-09-28,Liberia,LR,1,0,4937374,Africa,1339,82
2020-09-29,Liberia,LR,3,0,4937374,Africa,1342,82
2020-09-30,Liberia,LR,1,0,4937374,Africa,1343,82
2020-10-01,Liberia,LR,0,0,4937374,Africa,1343,82
2020-10-02,Liberia,LR,0,0,4937374,Africa,1343,82
2020-10-03,Liberia,LR,3,0,4937374,Africa,1346,82
2020-10-04,Liberia,LR,1,0,4937374,Africa,1347,82
2020-10-05,Liberia,LR,1,0,4937374,Africa,1348,82
2020-10-06,Liberia,LR,6,0,4937374,Africa,1354,82
2020-10-07,Liberia,LR,0,0,4937374,Africa,1354,82
2020-10-08,Liberia,LR,1,0,4937374,Africa,1355,82
2020-10-09,Liberia,LR,5,0,4937374,Africa,1360,82
2020-10-10,Liberia,LR,0,0,4937374,Africa,1360,82
2020-10-11,Liberia,LR,3,0,4937374,Africa,1363,82
2020-10-12,Liberia,LR,0,0,4937374,Africa,1363,82
2020-10-13,Liberia,LR,8,0,4937374,Africa,1371,82
2020-10-14,Liberia,LR,0,0,4937374,Africa,1371,82
2020-10-15,Liberia,LR,1,0,4937374,Africa,1372,82
2020-10-16,Liberia,LR,2,0,4937374,Africa,1374,82
2020-10-17,Liberia,LR,3,0,4937374,Africa,1377,82
2020-10-18,Liberia,LR,0,0,4937374,Africa,1377,82
2020-10-19,Liberia,LR,0,0,4937374,Africa,1377,82
2020-10-20,Liberia,LR,4,0,4937374,Africa,1381,82
2020-10-21,Liberia,LR,3,0,4937374,Africa,1384,82
2020-10-22,Liberia,LR,1,0,4937374,Africa,1385,82
2020-10-23,Liberia,LR,0,0,4937374,Africa,1385,82
2020-10-24,Liberia,LR,8,0,4937374,Africa,1393,82
2020-10-25,Liberia,LR,0,0,4937374,Africa,1393,82
2020-10-26,Liberia,LR,0,0,4937374,Africa,1393,82
2020-10-27,Liberia,LR,23,0,4937374,Africa,1416,82
2020-10-28,Liberia,LR,3,0,4937374,Africa,1419,82
2020-10-29,Liberia,LR,0,0,4937374,Africa,1419,82
2020-10-30,Liberia,LR,7,0,4937374,Africa,1426,82
2020-10-31,Liberia,LR,0,0,4937374,Africa,1426,82
2020-11-01,Liberia,LR,0,0,4937374,Africa,1426,82
2020-11-02,Liberia,LR,0,0,4937374,Africa,1426,82
2020-11-03,Liberia,LR,10,0,4937374,Africa,1436,82
2020-11-04,Liberia,LR,0,0,4937374,Africa,1436,82
2020-11-05,Liberia,LR,2,0,4937374,Africa,1438,82
2020-11-06,Liberia,LR,2,0,4937374,Africa,1440,82
2020-11-07,Liberia,LR,2,0,4937374,Africa,1442,82
2020-11-08,Liberia,LR,0,0,4937374,Africa,1442,82
2020-11-09,Liberia,LR,0,0,4937374,Africa,1442,82
2020-11-10,Liberia,LR,10,0,4937374,Africa,1452,82
2020-11-11,Liberia,LR,9,0,4937374,Africa,1461,82
2020-11-12,Liberia,LR,0,0,4937374,Africa,1461,82
2020-11-13,Liberia,LR,7,0,4937374,Africa,1468,82
2020-11-14,Liberia,LR,23,0,4937374,Africa,1491,82
2020-11-15,Liberia,LR,7,0,4937374,Africa,1498,82
2020-11-16,Liberia,LR,9,0,4937374,Africa,1507,82
2020-11-17,Liberia,LR,5,0,4937374,Africa,1512,82
2020-11-18,Liberia,LR,0,0,4937374,Africa,1512,82
2020-11-19,Liberia,LR,16,0,4937374,Africa,1528,82
2020-11-20,Liberia,LR,11,0,4937374,Africa,1539,82
2020-11-21,Liberia,LR,12,0,4937374,Africa,1551,82
2020-11-22,Liberia,LR,0,0,4937374,Africa,1551,82
2020-11-23,Liberia,LR,0,0,4937374,Africa,1551,82
2020-11-24,Liberia,LR,0,0,4937374,Africa,1551,82
2020-11-25,Liberia,LR,3,0,4937374,Africa,1554,82
2020-11-26,Liberia,LR,24,0,4937374,Africa,1578,82
2020-11-27,Liberia,LR,0,1,4937374,Africa,1578,83
2020-11-28,Liberia,LR,17,0,4937374,Africa,1595,83
2020-11-29,Liberia,LR,0,0,4937374,Africa,1595,83
2020-11-30,Liberia,LR,0,0,4937374,Africa,1595,83
2020-12-01,Liberia,LR,3,0,4937374,Africa,1598,83
2020-12-02,Liberia,LR,0,0,4937374,Africa,1598,83
2020-12-03,Liberia,LR,0,0,4937374,Africa,1598,83
2020-12-04,Liberia,LR,65,0,4937374,Africa,1663,83
2020-12-05,Liberia,LR,13,0,4937374,Africa,1676,83
2020-12-06,Liberia,LR,0,0,4937374,Africa,1676,83
2020-12-07,Liberia,LR,0,0,4937374,Africa,1676,83
2020-12-08,Liberia,LR,0,0,4937374,Africa,1676,83
2020-12-09,Liberia,LR,0,0,4937374,Africa,1676,83
2020-12-10,Liberia,LR,0,0,4937374,Africa,1676,83
2020-12-11,Liberia,LR,0,0,4937374,Africa,1676,83
2020-12-12,Liberia,LR,0,0,4937374,Africa,1676,83
2020-12-13,Liberia,LR,0,0,4937374,Africa,1676,83
2020-12-14,Liberia,LR,0,0,4937374,Africa,1676,83
2020-05-15,Lesotho,LS,1,0,2125267,Africa,1,0
2020-05-16,Lesotho,LS,0,0,2125267,Africa,1,0
2020-05-17,Lesotho,LS,0,0,2125267,Africa,1,0
2020-05-18,Lesotho,LS,0,0,2125267,Africa,1,0
2020-05-19,Lesotho,LS,0,0,2125267,Africa,1,0
2020-05-20,Lesotho,LS,0,0,2125267,Africa,1,0
2020-05-21,Lesotho,LS,0,0,2125267,Africa,1,0
2020-05-22,Lesotho,LS,0,0,2125267,Africa,1,0
2020-05-23,Lesotho,LS,0,0,2125267,Africa,1,0
2020-05-24,Lesotho,LS,1,0,2125267,Africa,2,0
2020-05-25,Lesotho,LS,0,0,2125267,Africa,2,0
2020-05-26,Lesotho,LS,0,0,2125267,Africa,2,0
2020-05-27,Lesotho,LS,0,0,2125267,Africa,2,0
2020-05-28,Lesotho,LS,0,0,2125267,Africa,2,0
2020-05-29,Lesotho,LS,0,0,2125267,Africa,2,0
2020-05-30,Lesotho,LS,0,0,2125267,Africa,2,0
2020-05-31,Lesotho,LS,0,0,2125267,Africa,2,0
2020-06-01,Lesotho,LS,0,0,2125267,Africa,2,0
2020-06-02,Lesotho,LS,0,0,2125267,Africa,2,0
2020-06-03,Lesotho,LS,0,0,2125267,Africa,2,0
2020-06-04,Lesotho,LS,0,0,2125267,Africa,2,0
2020-06-05,Lesotho,LS,2,0,2125267,Africa,4,0
2020-06-06,Lesotho,LS,0,0,2125267,Africa,4,0
2020-06-07,Lesotho,LS,0,0,2125267,Africa,4,0
2020-06-08,Lesotho,LS,0,0,2125267,Africa,4,0
2020-06-09,Lesotho,LS,0,0,2125267,Africa,4,0
2020-06-10,Lesotho,LS,0,0,2125267,Africa,4,0
2020-06-11,Lesotho,LS,0,0,2125267,Africa,4,0
2020-06-12,Lesotho,LS,0,0,2125267,Africa,4,0
2020-06-13,Lesotho,LS,0,0,2125267,Africa,4,0
2020-06-14,Lesotho,LS,0,0,2125267,Africa,4,0
2020-06-15,Lesotho,LS,0,0,2125267,Africa,4,0
2020-06-16,Lesotho,LS,0,0,2125267,Africa,4,0
2020-06-17,Lesotho,LS,0,0,2125267,Africa,4,0
2020-06-18,Lesotho,LS,0,0,2125267,Africa,4,0
2020-06-19,Lesotho,LS,0,0,2125267,Africa,4,0
2020-06-20,Lesotho,LS,0,0,2125267,Africa,4,0
2020-06-21,Lesotho,LS,0,0,2125267,Africa,4,0
2020-06-22,Lesotho,LS,0,0,2125267,Africa,4,0
2020-06-23,Lesotho,LS,0,0,2125267,Africa,4,0
2020-06-24,Lesotho,LS,13,0,2125267,Africa,17,0
2020-06-25,Lesotho,LS,0,0,2125267,Africa,17,0
2020-06-26,Lesotho,LS,3,0,2125267,Africa,20,0
2020-06-27,Lesotho,LS,4,0,2125267,Africa,24,0
2020-06-28,Lesotho,LS,0,0,2125267,Africa,24,0
2020-06-29,Lesotho,LS,3,0,2125267,Africa,27,0
2020-06-30,Lesotho,LS,0,0,2125267,Africa,27,0
2020-07-01,Lesotho,LS,0,0,2125267,Africa,27,0
2020-07-02,Lesotho,LS,8,0,2125267,Africa,35,0
2020-07-03,Lesotho,LS,0,0,2125267,Africa,35,0
2020-07-04,Lesotho,LS,0,0,2125267,Africa,35,0
2020-07-05,Lesotho,LS,0,0,2125267,Africa,35,0
2020-07-06,Lesotho,LS,44,0,2125267,Africa,79,0
2020-07-07,Lesotho,LS,12,0,2125267,Africa,91,0
2020-07-08,Lesotho,LS,0,0,2125267,Africa,91,0
2020-07-09,Lesotho,LS,0,0,2125267,Africa,91,0
2020-07-10,Lesotho,LS,43,1,2125267,Africa,134,1
2020-07-11,Lesotho,LS,0,0,2125267,Africa,134,1
2020-07-12,Lesotho,LS,50,0,2125267,Africa,184,1
2020-07-13,Lesotho,LS,49,1,2125267,Africa,233,2
2020-07-14,Lesotho,LS,0,0,2125267,Africa,233,2
2020-07-15,Lesotho,LS,12,1,2125267,Africa,245,3
2020-07-16,Lesotho,LS,11,0,2125267,Africa,256,3
2020-07-17,Lesotho,LS,0,0,2125267,Africa,256,3
2020-07-18,Lesotho,LS,55,0,2125267,Africa,311,3
2020-07-19,Lesotho,LS,48,3,2125267,Africa,359,6
2020-07-20,Lesotho,LS,0,0,2125267,Africa,359,6
2020-07-21,Lesotho,LS,0,0,2125267,Africa,359,6
2020-07-22,Lesotho,LS,0,0,2125267,Africa,359,6
2020-07-23,Lesotho,LS,0,0,2125267,Africa,359,6
2020-07-24,Lesotho,LS,0,0,2125267,Africa,359,6
2020-07-25,Lesotho,LS,0,0,2125267,Africa,359,6
2020-07-26,Lesotho,LS,60,3,2125267,Africa,419,9
2020-07-27,Lesotho,LS,27,2,2125267,Africa,446,11
2020-07-28,Lesotho,LS,59,1,2125267,Africa,505,12
2020-07-29,Lesotho,LS,0,0,2125267,Africa,505,12
2020-07-30,Lesotho,LS,71,1,2125267,Africa,576,13
2020-07-31,Lesotho,LS,28,0,2125267,Africa,604,13
2020-08-01,Lesotho,LS,0,0,2125267,Africa,604,13
2020-08-02,Lesotho,LS,98,1,2125267,Africa,702,14
2020-08-03,Lesotho,LS,16,5,2125267,Africa,718,19
2020-08-04,Lesotho,LS,0,0,2125267,Africa,718,19
2020-08-05,Lesotho,LS,8,2,2125267,Africa,726,21
2020-08-06,Lesotho,LS,0,0,2125267,Africa,726,21
2020-08-07,Lesotho,LS,16,2,2125267,Africa,742,23
2020-08-08,Lesotho,LS,0,0,2125267,Africa,742,23
2020-08-09,Lesotho,LS,0,0,2125267,Africa,742,23
2020-08-10,Lesotho,LS,0,0,2125267,Africa,742,23
2020-08-11,Lesotho,LS,39,1,2125267,Africa,781,24
2020-08-12,Lesotho,LS,0,0,2125267,Africa,781,24
2020-08-13,Lesotho,LS,17,0,2125267,Africa,798,24
2020-08-14,Lesotho,LS,17,0,2125267,Africa,815,24
2020-08-15,Lesotho,LS,69,1,2125267,Africa,884,25
2020-08-16,Lesotho,LS,19,0,2125267,Africa,903,25
2020-08-17,Lesotho,LS,43,5,2125267,Africa,946,30
2020-08-18,Lesotho,LS,0,0,2125267,Africa,946,30
2020-08-19,Lesotho,LS,0,0,2125267,Africa,946,30
2020-08-20,Lesotho,LS,0,0,2125267,Africa,946,30
2020-08-21,Lesotho,LS,50,0,2125267,Africa,996,30
2020-08-22,Lesotho,LS,19,0,2125267,Africa,1015,30
2020-08-23,Lesotho,LS,0,0,2125267,Africa,1015,30
2020-08-24,Lesotho,LS,0,0,2125267,Africa,1015,30
2020-08-25,Lesotho,LS,0,0,2125267,Africa,1015,30
2020-08-26,Lesotho,LS,34,0,2125267,Africa,1049,30
2020-08-27,Lesotho,LS,2,1,2125267,Africa,1051,31
2020-08-28,Lesotho,LS,0,0,2125267,Africa,1051,31
2020-08-29,Lesotho,LS,0,0,2125267,Africa,1051,31
2020-08-30,Lesotho,LS,0,0,2125267,Africa,1051,31
2020-08-31,Lesotho,LS,15,0,2125267,Africa,1066,31
2020-09-01,Lesotho,LS,19,0,2125267,Africa,1085,31
2020-09-02,Lesotho,LS,0,0,2125267,Africa,1085,31
2020-09-03,Lesotho,LS,0,0,2125267,Africa,1085,31
2020-09-04,Lesotho,LS,0,0,2125267,Africa,1085,31
2020-09-05,Lesotho,LS,63,0,2125267,Africa,1148,31
2020-09-06,Lesotho,LS,0,0,2125267,Africa,1148,31
2020-09-07,Lesotho,LS,0,0,2125267,Africa,1148,31
2020-09-08,Lesotho,LS,0,0,2125267,Africa,1148,31
2020-09-09,Lesotho,LS,16,0,2125267,Africa,1164,31
2020-09-10,Lesotho,LS,0,0,2125267,Africa,1164,31
2020-09-11,Lesotho,LS,0,0,2125267,Africa,1164,31
2020-09-12,Lesotho,LS,81,2,2125267,Africa,1245,33
2020-09-13,Lesotho,LS,0,0,2125267,Africa,1245,33
2020-09-14,Lesotho,LS,0,0,2125267,Africa,1245,33
2020-09-15,Lesotho,LS,0,0,2125267,Africa,1245,33
2020-09-16,Lesotho,LS,0,0,2125267,Africa,1245,33
2020-09-17,Lesotho,LS,82,0,2125267,Africa,1327,33
2020-09-18,Lesotho,LS,0,0,2125267,Africa,1327,33
2020-09-19,Lesotho,LS,0,0,2125267,Africa,1327,33
2020-09-20,Lesotho,LS,63,0,2125267,Africa,1390,33
2020-09-21,Lesotho,LS,34,0,2125267,Africa,1424,33
2020-09-22,Lesotho,LS,0,0,2125267,Africa,1424,33
2020-09-23,Lesotho,LS,0,0,2125267,Africa,1424,33
2020-09-24,Lesotho,LS,0,0,2125267,Africa,1424,33
2020-09-25,Lesotho,LS,83,2,2125267,Africa,1507,35
2020-09-26,Lesotho,LS,51,0,2125267,Africa,1558,35
2020-09-27,Lesotho,LS,0,0,2125267,Africa,1558,35
2020-09-28,Lesotho,LS,0,0,2125267,Africa,1558,35
2020-09-29,Lesotho,LS,7,0,2125267,Africa,1565,35
2020-09-30,Lesotho,LS,11,0,2125267,Africa,1576,35
2020-10-01,Lesotho,LS,19,1,2125267,Africa,1595,36
2020-10-02,Lesotho,LS,44,2,2125267,Africa,1639,38
2020-10-03,Lesotho,LS,41,1,2125267,Africa,1680,39
2020-10-04,Lesotho,LS,0,0,2125267,Africa,1680,39
2020-10-05,Lesotho,LS,0,0,2125267,Africa,1680,39
2020-10-06,Lesotho,LS,3,0,2125267,Africa,1683,39
2020-10-07,Lesotho,LS,0,0,2125267,Africa,1683,39
2020-10-08,Lesotho,LS,0,0,2125267,Africa,1683,39
2020-10-09,Lesotho,LS,103,2,2125267,Africa,1786,41
2020-10-10,Lesotho,LS,14,1,2125267,Africa,1800,42
2020-10-11,Lesotho,LS,0,0,2125267,Africa,1800,42
2020-10-12,Lesotho,LS,5,0,2125267,Africa,1805,42
2020-10-13,Lesotho,LS,0,0,2125267,Africa,1805,42
2020-10-14,Lesotho,LS,0,0,2125267,Africa,1805,42
2020-10-15,Lesotho,LS,28,0,2125267,Africa,1833,42
2020-10-16,Lesotho,LS,0,0,2125267,Africa,1833,42
2020-10-17,Lesotho,LS,0,0,2125267,Africa,1833,42
2020-10-18,Lesotho,LS,0,0,2125267,Africa,1833,42
2020-10-19,Lesotho,LS,0,0,2125267,Africa,1833,42
2020-10-20,Lesotho,LS,0,0,2125267,Africa,1833,42
2020-10-21,Lesotho,LS,0,0,2125267,Africa,1833,42
2020-10-22,Lesotho,LS,85,1,2125267,Africa,1918,43
2020-10-23,Lesotho,LS,0,0,2125267,Africa,1918,43
2020-10-24,Lesotho,LS,5,0,2125267,Africa,1923,43
2020-10-25,Lesotho,LS,11,0,2125267,Africa,1934,43
2020-10-26,Lesotho,LS,6,0,2125267,Africa,1940,43
2020-10-27,Lesotho,LS,3,0,2125267,Africa,1943,43
2020-10-28,Lesotho,LS,4,0,2125267,Africa,1947,43
2020-10-29,Lesotho,LS,0,0,2125267,Africa,1947,43
2020-10-30,Lesotho,LS,0,0,2125267,Africa,1947,43
2020-10-31,Lesotho,LS,0,0,2125267,Africa,1947,43
2020-11-01,Lesotho,LS,0,0,2125267,Africa,1947,43
2020-11-02,Lesotho,LS,0,0,2125267,Africa,1947,43
2020-11-03,Lesotho,LS,6,1,2125267,Africa,1953,44
2020-11-04,Lesotho,LS,8,0,2125267,Africa,1961,44
2020-11-05,Lesotho,LS,2,0,2125267,Africa,1963,44
2020-11-06,Lesotho,LS,0,0,2125267,Africa,1963,44
2020-11-07,Lesotho,LS,4,0,2125267,Africa,1967,44
2020-11-08,Lesotho,LS,0,0,2125267,Africa,1967,44
2020-11-09,Lesotho,LS,0,0,2125267,Africa,1967,44
2020-11-10,Lesotho,LS,0,0,2125267,Africa,1967,44
2020-11-11,Lesotho,LS,59,0,2125267,Africa,2026,44
2020-11-12,Lesotho,LS,0,0,2125267,Africa,2026,44
2020-11-13,Lesotho,LS,0,0,2125267,Africa,2026,44
2020-11-14,Lesotho,LS,15,0,2125267,Africa,2041,44
2020-11-15,Lesotho,LS,0,0,2125267,Africa,2041,44
2020-11-16,Lesotho,LS,0,0,2125267,Africa,2041,44
2020-11-17,Lesotho,LS,0,0,2125267,Africa,2041,44
2020-11-18,Lesotho,LS,0,0,2125267,Africa,2041,44
2020-11-19,Lesotho,LS,17,0,2125267,Africa,2058,44
2020-11-20,Lesotho,LS,0,0,2125267,Africa,2058,44
2020-11-21,Lesotho,LS,8,0,2125267,Africa,2066,44
2020-11-22,Lesotho,LS,19,0,2125267,Africa,2085,44
2020-11-23,Lesotho,LS,0,0,2125267,Africa,2085,44
2020-11-24,Lesotho,LS,1,0,2125267,Africa,2086,44
2020-11-25,Lesotho,LS,6,0,2125267,Africa,2092,44
2020-11-26,Lesotho,LS,0,0,2125267,Africa,2092,44
2020-11-27,Lesotho,LS,0,0,2125267,Africa,2092,44
2020-11-28,Lesotho,LS,17,0,2125267,Africa,2109,44
2020-11-29,Lesotho,LS,0,0,2125267,Africa,2109,44
2020-11-30,Lesotho,LS,0,0,2125267,Africa,2109,44
2020-12-01,Lesotho,LS,0,0,2125267,Africa,2109,44
2020-12-02,Lesotho,LS,28,0,2125267,Africa,2137,44
2020-12-03,Lesotho,LS,5,0,2125267,Africa,2142,44
2020-12-04,Lesotho,LS,3,0,2125267,Africa,2145,44
2020-12-05,Lesotho,LS,5,0,2125267,Africa,2150,44
2020-12-06,Lesotho,LS,0,0,2125267,Africa,2150,44
2020-12-07,Lesotho,LS,0,0,2125267,Africa,2150,44
2020-12-08,Lesotho,LS,0,0,2125267,Africa,2150,44
2020-12-09,Lesotho,LS,0,0,2125267,Africa,2150,44
2020-12-10,Lesotho,LS,14,0,2125267,Africa,2164,44
2020-12-11,Lesotho,LS,14,0,2125267,Africa,2178,44
2020-12-12,Lesotho,LS,36,0,2125267,Africa,2214,44
2020-12-13,Lesotho,LS,36,0,2125267,Africa,2250,44
2020-12-14,Lesotho,LS,0,0,2125267,Africa,2250,44
2019-12-31,Lithuania,LT,0,0,2794184,Europe,0,0
2020-01-01,Lithuania,LT,0,0,2794184,Europe,0,0
2020-01-02,Lithuania,LT,0,0,2794184,Europe,0,0
2020-01-03,Lithuania,LT,0,0,2794184,Europe,0,0
2020-01-04,Lithuania,LT,0,0,2794184,Europe,0,0
2020-01-05,Lithuania,LT,0,0,2794184,Europe,0,0
2020-01-06,Lithuania,LT,0,0,2794184,Europe,0,0
2020-01-07,Lithuania,LT,0,0,2794184,Europe,0,0
2020-01-08,Lithuania,LT,0,0,2794184,Europe,0,0
2020-01-09,Lithuania,LT,0,0,2794184,Europe,0,0
2020-01-10,Lithuania,LT,0,0,2794184,Europe,0,0
2020-01-11,Lithuania,LT,0,0,2794184,Europe,0,0
2020-01-12,Lithuania,LT,0,0,2794184,Europe,0,0
2020-01-13,Lithuania,LT,0,0,2794184,Europe,0,0
2020-01-14,Lithuania,LT,0,0,2794184,Europe,0,0
2020-01-15,Lithuania,LT,0,0,2794184,Europe,0,0
2020-01-16,Lithuania,LT,0,0,2794184,Europe,0,0
2020-01-17,Lithuania,LT,0,0,2794184,Europe,0,0
2020-01-18,Lithuania,LT,0,0,2794184,Europe,0,0
2020-01-19,Lithuania,LT,0,0,2794184,Europe,0,0
2020-01-20,Lithuania,LT,0,0,2794184,Europe,0,0
2020-01-21,Lithuania,LT,0,0,2794184,Europe,0,0
2020-01-22,Lithuania,LT,0,0,2794184,Europe,0,0
2020-01-23,Lithuania,LT,0,0,2794184,Europe,0,0
2020-01-24,Lithuania,LT,0,0,2794184,Europe,0,0
2020-01-25,Lithuania,LT,0,0,2794184,Europe,0,0
2020-01-26,Lithuania,LT,0,0,2794184,Europe,0,0
2020-01-27,Lithuania,LT,0,0,2794184,Europe,0,0
2020-01-28,Lithuania,LT,0,0,2794184,Europe,0,0
2020-01-29,Lithuania,LT,0,0,2794184,Europe,0,0
2020-01-30,Lithuania,LT,0,0,2794184,Europe,0,0
2020-01-31,Lithuania,LT,0,0,2794184,Europe,0,0
2020-02-01,Lithuania,LT,0,0,2794184,Europe,0,0
2020-02-02,Lithuania,LT,0,0,2794184,Europe,0,0
2020-02-03,Lithuania,LT,0,0,2794184,Europe,0,0
2020-02-04,Lithuania,LT,0,0,2794184,Europe,0,0
2020-02-05,Lithuania,LT,0,0,2794184,Europe,0,0
2020-02-06,Lithuania,LT,0,0,2794184,Europe,0,0
2020-02-07,Lithuania,LT,0,0,2794184,Europe,0,0
2020-02-08,Lithuania,LT,0,0,2794184,Europe,0,0
2020-02-09,Lithuania,LT,0,0,2794184,Europe,0,0
2020-02-10,Lithuania,LT,0,0,2794184,Europe,0,0
2020-02-11,Lithuania,LT,0,0,2794184,Europe,0,0
2020-02-12,Lithuania,LT,0,0,2794184,Europe,0,0
2020-02-13,Lithuania,LT,0,0,2794184,Europe,0,0
2020-02-14,Lithuania,LT,0,0,2794184,Europe,0,0
2020-02-15,Lithuania,LT,0,0,2794184,Europe,0,0
2020-02-16,Lithuania,LT,0,0,2794184,Europe,0,0
2020-02-17,Lithuania,LT,0,0,2794184,Europe,0,0
2020-02-18,Lithuania,LT,0,0,2794184,Europe,0,0
2020-02-19,Lithuania,LT,0,0,2794184,Europe,0,0
2020-02-20,Lithuania,LT,0,0,2794184,Europe,0,0
2020-02-21,Lithuania,LT,0,0,2794184,Europe,0,0
2020-02-22,Lithuania,LT,0,0,2794184,Europe,0,0
2020-02-23,Lithuania,LT,0,0,2794184,Europe,0,0
2020-02-24,Lithuania,LT,0,0,2794184,Europe,0,0
2020-02-25,Lithuania,LT,0,0,2794184,Europe,0,0
2020-02-26,Lithuania,LT,0,0,2794184,Europe,0,0
2020-02-27,Lithuania,LT,0,0,2794184,Europe,0,0
2020-02-28,Lithuania,LT,1,0,2794184,Europe,1,0
2020-02-29,Lithuania,LT,0,0,2794184,Europe,1,0
2020-03-01,Lithuania,LT,0,0,2794184,Europe,1,0
2020-03-02,Lithuania,LT,0,0,2794184,Europe,1,0
2020-03-11,Lithuania,LT,2,0,2794184,Europe,3,0
2020-03-12,Lithuania,LT,0,0,2794184,Europe,3,0
2020-03-14,Lithuania,LT,3,0,2794184,Europe,6,0
2020-03-15,Lithuania,LT,3,0,2794184,Europe,9,0
2020-03-16,Lithuania,LT,5,0,2794184,Europe,14,0
2020-03-17,Lithuania,LT,3,0,2794184,Europe,17,0
2020-03-18,Lithuania,LT,8,0,2794184,Europe,25,0
2020-03-19,Lithuania,LT,8,0,2794184,Europe,33,0
2020-03-20,Lithuania,LT,15,0,2794184,Europe,48,0
2020-03-21,Lithuania,LT,21,1,2794184,Europe,69,1
2020-03-22,Lithuania,LT,36,0,2794184,Europe,105,1
2020-03-23,Lithuania,LT,38,0,2794184,Europe,143,1
2020-03-24,Lithuania,LT,36,0,2794184,Europe,179,1
2020-03-25,Lithuania,LT,30,1,2794184,Europe,209,2
2020-03-26,Lithuania,LT,65,2,2794184,Europe,274,4
2020-03-27,Lithuania,LT,25,0,2794184,Europe,299,4
2020-03-28,Lithuania,LT,59,1,2794184,Europe,358,5
2020-03-29,Lithuania,LT,36,2,2794184,Europe,394,7
2020-03-30,Lithuania,LT,90,0,2794184,Europe,484,7
2020-03-31,Lithuania,LT,0,0,2794184,Europe,484,7
2020-04-01,Lithuania,LT,49,0,2794184,Europe,533,7
2020-04-02,Lithuania,LT,48,1,2794184,Europe,581,8
2020-04-03,Lithuania,LT,68,1,2794184,Europe,649,9
2020-04-04,Lithuania,LT,122,0,2794184,Europe,771,9
2020-04-05,Lithuania,LT,0,0,2794184,Europe,771,9
2020-04-06,Lithuania,LT,40,4,2794184,Europe,811,13
2020-04-07,Lithuania,LT,32,1,2794184,Europe,843,14
2020-04-08,Lithuania,LT,37,1,2794184,Europe,880,15
2020-04-09,Lithuania,LT,32,0,2794184,Europe,912,15
2020-04-10,Lithuania,LT,43,0,2794184,Europe,955,15
2020-04-11,Lithuania,LT,44,2,2794184,Europe,999,17
2020-04-12,Lithuania,LT,54,6,2794184,Europe,1053,23
2020-04-13,Lithuania,LT,9,1,2794184,Europe,1062,24
2020-04-14,Lithuania,LT,8,0,2794184,Europe,1070,24
2020-04-15,Lithuania,LT,0,0,2794184,Europe,1070,24
2020-04-16,Lithuania,LT,21,5,2794184,Europe,1091,29
2020-04-17,Lithuania,LT,58,3,2794184,Europe,1149,32
2020-04-18,Lithuania,LT,90,1,2794184,Europe,1239,33
2020-04-19,Lithuania,LT,59,0,2794184,Europe,1298,33
2020-04-20,Lithuania,LT,28,3,2794184,Europe,1326,36
2020-04-21,Lithuania,LT,24,1,2794184,Europe,1350,37
2020-04-22,Lithuania,LT,20,1,2794184,Europe,1370,38
2020-04-23,Lithuania,LT,28,0,2794184,Europe,1398,38
2020-04-24,Lithuania,LT,12,2,2794184,Europe,1410,40
2020-04-25,Lithuania,LT,0,0,2794184,Europe,1410,40
2020-04-26,Lithuania,LT,16,1,2794184,Europe,1426,41
2020-04-27,Lithuania,LT,12,0,2794184,Europe,1438,41
2020-04-28,Lithuania,LT,11,0,2794184,Europe,1449,41
2020-04-29,Lithuania,LT,-105,3,2794184,Europe,1344,44
2020-04-30,Lithuania,LT,31,1,2794184,Europe,1375,45
2020-05-01,Lithuania,LT,10,0,2794184,Europe,1385,45
2020-05-02,Lithuania,LT,14,0,2794184,Europe,1399,45
2020-05-03,Lithuania,LT,7,1,2794184,Europe,1406,46
2020-05-04,Lithuania,LT,4,0,2794184,Europe,1410,46
2020-05-05,Lithuania,LT,9,0,2794184,Europe,1419,46
2020-05-06,Lithuania,LT,4,0,2794184,Europe,1423,46
2020-05-07,Lithuania,LT,5,2,2794184,Europe,1428,48
2020-05-08,Lithuania,LT,5,1,2794184,Europe,1433,49
2020-05-09,Lithuania,LT,3,0,2794184,Europe,1436,49
2020-05-10,Lithuania,LT,8,1,2794184,Europe,1444,50
2020-05-11,Lithuania,LT,35,0,2794184,Europe,1479,50
2020-05-12,Lithuania,LT,6,0,2794184,Europe,1485,50
2020-05-13,Lithuania,LT,6,0,2794184,Europe,1491,50
2020-05-14,Lithuania,LT,14,4,2794184,Europe,1505,54
2020-05-15,Lithuania,LT,6,0,2794184,Europe,1511,54
2020-05-16,Lithuania,LT,12,0,2794184,Europe,1523,54
2020-05-17,Lithuania,LT,11,1,2794184,Europe,1534,55
2020-05-18,Lithuania,LT,7,1,2794184,Europe,1541,56
2020-05-19,Lithuania,LT,6,3,2794184,Europe,1547,59
2020-05-20,Lithuania,LT,15,1,2794184,Europe,1562,60
2020-05-21,Lithuania,LT,15,0,2794184,Europe,1577,60
2020-05-22,Lithuania,LT,17,1,2794184,Europe,1594,61
2020-05-23,Lithuania,LT,10,0,2794184,Europe,1604,61
2020-05-24,Lithuania,LT,12,2,2794184,Europe,1616,63
2020-05-25,Lithuania,LT,7,0,2794184,Europe,1623,63
2020-05-26,Lithuania,LT,12,0,2794184,Europe,1635,63
2020-05-27,Lithuania,LT,4,2,2794184,Europe,1639,65
2020-05-28,Lithuania,LT,8,1,2794184,Europe,1647,66
2020-05-29,Lithuania,LT,9,2,2794184,Europe,1656,68
2020-05-30,Lithuania,LT,6,0,2794184,Europe,1662,68
2020-05-31,Lithuania,LT,8,2,2794184,Europe,1670,70
2020-06-01,Lithuania,LT,5,0,2794184,Europe,1675,70
2020-06-02,Lithuania,LT,3,0,2794184,Europe,1678,70
2020-06-03,Lithuania,LT,4,1,2794184,Europe,1682,71
2020-06-04,Lithuania,LT,2,0,2794184,Europe,1684,71
2020-06-05,Lithuania,LT,3,0,2794184,Europe,1687,71
2020-06-06,Lithuania,LT,7,0,2794184,Europe,1694,71
2020-06-07,Lithuania,LT,11,0,2794184,Europe,1705,71
2020-06-08,Lithuania,LT,9,0,2794184,Europe,1714,71
2020-06-09,Lithuania,LT,6,0,2794184,Europe,1720,71
2020-06-10,Lithuania,LT,7,1,2794184,Europe,1727,72
2020-06-11,Lithuania,LT,6,2,2794184,Europe,1733,74
2020-06-12,Lithuania,LT,19,0,2794184,Europe,1752,74
2020-06-13,Lithuania,LT,4,0,2794184,Europe,1756,74
2020-06-14,Lithuania,LT,7,1,2794184,Europe,1763,75
2020-06-15,Lithuania,LT,5,0,2794184,Europe,1768,75
2020-06-16,Lithuania,LT,5,1,2794184,Europe,1773,76
2020-06-17,Lithuania,LT,3,0,2794184,Europe,1776,76
2020-06-18,Lithuania,LT,2,0,2794184,Europe,1778,76
2020-06-19,Lithuania,LT,6,0,2794184,Europe,1784,76
2020-06-20,Lithuania,LT,8,0,2794184,Europe,1792,76
2020-06-21,Lithuania,LT,3,0,2794184,Europe,1795,76
2020-06-22,Lithuania,LT,3,0,2794184,Europe,1798,76
2020-06-23,Lithuania,LT,3,0,2794184,Europe,1801,76
2020-06-24,Lithuania,LT,2,1,2794184,Europe,1803,77
2020-06-25,Lithuania,LT,1,1,2794184,Europe,1804,78
2020-06-26,Lithuania,LT,2,0,2794184,Europe,1806,78
2020-06-27,Lithuania,LT,2,0,2794184,Europe,1808,78
2020-06-28,Lithuania,LT,5,0,2794184,Europe,1813,78
2020-06-29,Lithuania,LT,3,0,2794184,Europe,1816,78
2020-06-30,Lithuania,LT,0,0,2794184,Europe,1816,78
2020-07-01,Lithuania,LT,1,0,2794184,Europe,1817,78
2020-07-02,Lithuania,LT,1,0,2794184,Europe,1818,78
2020-07-03,Lithuania,LT,7,0,2794184,Europe,1825,78
2020-07-04,Lithuania,LT,3,1,2794184,Europe,1828,79
2020-07-05,Lithuania,LT,3,0,2794184,Europe,1831,79
2020-07-06,Lithuania,LT,5,0,2794184,Europe,1836,79
2020-07-07,Lithuania,LT,5,0,2794184,Europe,1841,79
2020-07-08,Lithuania,LT,3,0,2794184,Europe,1844,79
2020-07-09,Lithuania,LT,10,0,2794184,Europe,1854,79
2020-07-10,Lithuania,LT,3,0,2794184,Europe,1857,79
2020-07-11,Lithuania,LT,4,0,2794184,Europe,1861,79
2020-07-12,Lithuania,LT,4,0,2794184,Europe,1865,79
2020-07-13,Lithuania,LT,4,0,2794184,Europe,1869,79
2020-07-14,Lithuania,LT,5,0,2794184,Europe,1874,79
2020-07-15,Lithuania,LT,1,0,2794184,Europe,1875,79
2020-07-16,Lithuania,LT,7,0,2794184,Europe,1882,79
2020-07-17,Lithuania,LT,20,0,2794184,Europe,1902,79
2020-07-18,Lithuania,LT,6,0,2794184,Europe,1908,79
2020-07-19,Lithuania,LT,7,1,2794184,Europe,1915,80
2020-07-20,Lithuania,LT,17,0,2794184,Europe,1932,80
2020-07-21,Lithuania,LT,15,0,2794184,Europe,1947,80
2020-07-22,Lithuania,LT,2,0,2794184,Europe,1949,80
2020-07-23,Lithuania,LT,11,0,2794184,Europe,1960,80
2020-07-24,Lithuania,LT,0,0,2794184,Europe,1960,80
2020-07-25,Lithuania,LT,26,0,2794184,Europe,1986,80
2020-07-26,Lithuania,LT,15,0,2794184,Europe,2001,80
2020-07-27,Lithuania,LT,7,0,2794184,Europe,2008,80
2020-07-28,Lithuania,LT,11,0,2794184,Europe,2019,80
2020-07-29,Lithuania,LT,8,0,2794184,Europe,2027,80
2020-07-30,Lithuania,LT,16,0,2794184,Europe,2043,80
2020-07-31,Lithuania,LT,19,0,2794184,Europe,2062,80
2020-08-01,Lithuania,LT,13,0,2794184,Europe,2075,80
2020-08-02,Lithuania,LT,18,0,2794184,Europe,2093,80
2020-08-03,Lithuania,LT,17,0,2794184,Europe,2110,80
2020-08-04,Lithuania,LT,10,0,2794184,Europe,2120,80
2020-08-05,Lithuania,LT,17,0,2794184,Europe,2137,80
2020-08-06,Lithuania,LT,10,1,2794184,Europe,2147,81
2020-08-07,Lithuania,LT,24,0,2794184,Europe,2171,81
2020-08-08,Lithuania,LT,23,0,2794184,Europe,2194,81
2020-08-09,Lithuania,LT,37,0,2794184,Europe,2231,81
2020-08-10,Lithuania,LT,21,0,2794184,Europe,2252,81
2020-08-11,Lithuania,LT,13,0,2794184,Europe,2265,81
2020-08-12,Lithuania,LT,18,0,2794184,Europe,2283,81
2020-08-13,Lithuania,LT,26,0,2794184,Europe,2309,81
2020-08-14,Lithuania,LT,21,0,2794184,Europe,2330,81
2020-08-15,Lithuania,LT,22,0,2794184,Europe,2352,81
2020-08-16,Lithuania,LT,34,0,2794184,Europe,2386,81
2020-08-17,Lithuania,LT,30,0,2794184,Europe,2416,81
2020-08-18,Lithuania,LT,20,0,2794184,Europe,2436,81
2020-08-19,Lithuania,LT,38,0,2794184,Europe,2474,81
2020-08-20,Lithuania,LT,22,0,2794184,Europe,2496,81
2020-08-21,Lithuania,LT,32,1,2794184,Europe,2528,82
2020-08-22,Lithuania,LT,36,1,2794184,Europe,2564,83
2020-08-23,Lithuania,LT,30,1,2794184,Europe,2594,84
2020-08-24,Lithuania,LT,41,0,2794184,Europe,2635,84
2020-08-25,Lithuania,LT,38,1,2794184,Europe,2673,85
2020-08-26,Lithuania,LT,21,0,2794184,Europe,2694,85
2020-08-27,Lithuania,LT,32,0,2794184,Europe,2726,85
2020-08-28,Lithuania,LT,36,0,2794184,Europe,2762,85
2020-08-29,Lithuania,LT,48,1,2794184,Europe,2810,86
2020-08-30,Lithuania,LT,29,0,2794184,Europe,2839,86
2020-08-31,Lithuania,LT,35,0,2794184,Europe,2874,86
2020-09-01,Lithuania,LT,32,0,2794184,Europe,2906,86
2020-09-02,Lithuania,LT,23,0,2794184,Europe,2929,86
2020-09-03,Lithuania,LT,29,0,2794184,Europe,2958,86
2020-09-04,Lithuania,LT,20,0,2794184,Europe,2978,86
2020-09-05,Lithuania,LT,26,0,2794184,Europe,3004,86
2020-09-06,Lithuania,LT,36,0,2794184,Europe,3040,86
2020-09-07,Lithuania,LT,43,0,2794184,Europe,3083,86
2020-09-08,Lithuania,LT,17,0,2794184,Europe,3100,86
2020-09-09,Lithuania,LT,31,0,2794184,Europe,3131,86
2020-09-10,Lithuania,LT,32,0,2794184,Europe,3163,86
2020-09-11,Lithuania,LT,36,0,2794184,Europe,3199,86
2020-09-12,Lithuania,LT,44,0,2794184,Europe,3243,86
2020-09-13,Lithuania,LT,53,0,2794184,Europe,3296,86
2020-09-14,Lithuania,LT,39,1,2794184,Europe,3335,87
2020-09-15,Lithuania,LT,51,0,2794184,Europe,3386,87
2020-09-16,Lithuania,LT,56,0,2794184,Europe,3442,87
2020-09-17,Lithuania,LT,0,0,2794184,Europe,3442,87
2020-09-18,Lithuania,LT,62,0,2794184,Europe,3504,87
2020-09-19,Lithuania,LT,61,0,2794184,Europe,3565,87
2020-09-20,Lithuania,LT,99,0,2794184,Europe,3664,87
2020-09-21,Lithuania,LT,80,0,2794184,Europe,3744,87
2020-09-22,Lithuania,LT,70,0,2794184,Europe,3814,87
2020-09-23,Lithuania,LT,45,0,2794184,Europe,3859,87
2020-09-24,Lithuania,LT,73,0,2794184,Europe,3932,87
2020-09-25,Lithuania,LT,138,2,2794184,Europe,4070,89
2020-09-26,Lithuania,LT,114,0,2794184,Europe,4184,89
2020-09-27,Lithuania,LT,111,0,2794184,Europe,4295,89
2020-09-28,Lithuania,LT,90,2,2794184,Europe,4385,91
2020-09-29,Lithuania,LT,105,1,2794184,Europe,4490,92
2020-09-30,Lithuania,LT,88,0,2794184,Europe,4578,92
2020-10-01,Lithuania,LT,115,0,2794184,Europe,4693,92
2020-10-02,Lithuania,LT,91,0,2794184,Europe,4784,92
2020-10-03,Lithuania,LT,172,1,2794184,Europe,4956,93
2020-10-04,Lithuania,LT,125,1,2794184,Europe,5081,94
2020-10-05,Lithuania,LT,104,0,2794184,Europe,5185,94
2020-10-06,Lithuania,LT,100,0,2794184,Europe,5285,94
2020-10-07,Lithuania,LT,81,5,2794184,Europe,5366,99
2020-10-08,Lithuania,LT,117,2,2794184,Europe,5483,101
2020-10-09,Lithuania,LT,142,1,2794184,Europe,5625,102
2020-10-10,Lithuania,LT,133,1,2794184,Europe,5758,103
2020-10-11,Lithuania,LT,205,0,2794184,Europe,5963,103
2020-10-12,Lithuania,LT,159,0,2794184,Europe,6122,103
2020-10-13,Lithuania,LT,126,0,2794184,Europe,6248,103
2020-10-14,Lithuania,LT,118,3,2794184,Europe,6366,106
2020-10-15,Lithuania,LT,139,3,2794184,Europe,6505,109
2020-10-16,Lithuania,LT,255,1,2794184,Europe,6760,110
2020-10-17,Lithuania,LT,281,2,2794184,Europe,7041,112
2020-10-18,Lithuania,LT,228,1,2794184,Europe,7269,113
2020-10-19,Lithuania,LT,252,0,2794184,Europe,7521,113
2020-10-20,Lithuania,LT,205,0,2794184,Europe,7726,113
2020-10-21,Lithuania,LT,202,5,2794184,Europe,7928,118
2020-10-22,Lithuania,LT,311,2,2794184,Europe,8239,120
2020-10-23,Lithuania,LT,424,5,2794184,Europe,8663,125
2020-10-24,Lithuania,LT,441,1,2794184,Europe,9104,126
2020-10-25,Lithuania,LT,474,3,2794184,Europe,9578,129
2020-10-26,Lithuania,LT,606,5,2794184,Europe,10184,134
2020-10-27,Lithuania,LT,765,2,2794184,Europe,10949,136
2020-10-28,Lithuania,LT,413,5,2794184,Europe,11362,141
2020-10-29,Lithuania,LT,776,3,2794184,Europe,12138,144
2020-10-30,Lithuania,LT,950,6,2794184,Europe,13088,150
2020-10-31,Lithuania,LT,735,7,2794184,Europe,13823,157
2020-11-01,Lithuania,LT,1001,8,2794184,Europe,14824,165
2020-11-02,Lithuania,LT,895,1,2794184,Europe,15719,166
2020-11-03,Lithuania,LT,837,4,2794184,Europe,16556,170
2020-11-04,Lithuania,LT,897,5,2794184,Europe,17453,175
2020-11-05,Lithuania,LT,639,7,2794184,Europe,18092,182
2020-11-06,Lithuania,LT,999,4,2794184,Europe,19091,186
2020-11-07,Lithuania,LT,1656,6,2794184,Europe,20747,192
2020-11-08,Lithuania,LT,1972,11,2794184,Europe,22719,203
2020-11-09,Lithuania,LT,1980,4,2794184,Europe,24699,207
2020-11-10,Lithuania,LT,1056,3,2794184,Europe,25755,210
2020-11-11,Lithuania,LT,1086,11,2794184,Europe,26841,221
2020-11-12,Lithuania,LT,1421,14,2794184,Europe,28262,235
2020-11-13,Lithuania,LT,1550,9,2794184,Europe,29812,244
2020-11-14,Lithuania,LT,2066,9,2794184,Europe,31878,253
2020-11-15,Lithuania,LT,1509,13,2794184,Europe,33387,266
2020-11-16,Lithuania,LT,1371,11,2794184,Europe,34758,277
2020-11-17,Lithuania,LT,1153,8,2794184,Europe,35911,285
2020-11-18,Lithuania,LT,965,14,2794184,Europe,36876,299
2020-11-19,Lithuania,LT,1934,24,2794184,Europe,38810,323
2020-11-20,Lithuania,LT,1682,18,2794184,Europe,40492,341
2020-11-21,Lithuania,LT,2265,16,2794184,Europe,42757,357
2020-11-22,Lithuania,LT,1983,17,2794184,Europe,44740,374
2020-11-23,Lithuania,LT,2307,12,2794184,Europe,47047,386
2020-11-24,Lithuania,LT,1179,6,2794184,Europe,48226,392
2020-11-25,Lithuania,LT,1167,17,2794184,Europe,49393,409
2020-11-26,Lithuania,LT,2262,23,2794184,Europe,51655,432
2020-11-27,Lithuania,LT,2102,17,2794184,Europe,53757,449
2020-11-28,Lithuania,LT,4455,33,2794184,Europe,58212,482
2020-11-29,Lithuania,LT,1981,11,2794184,Europe,60193,493
2020-11-30,Lithuania,LT,1132,13,2794184,Europe,61325,506
2020-12-01,Lithuania,LT,1190,13,2794184,Europe,62515,519
2020-12-02,Lithuania,LT,2106,28,2794184,Europe,64621,547
2020-12-03,Lithuania,LT,2445,17,2794184,Europe,67066,564
2020-12-04,Lithuania,LT,2516,26,2794184,Europe,69582,590
2020-12-05,Lithuania,LT,2848,21,2794184,Europe,72430,611
2020-12-06,Lithuania,LT,2219,15,2794184,Europe,74649,626
2020-12-07,Lithuania,LT,1387,11,2794184,Europe,76036,637
2020-12-08,Lithuania,LT,1390,36,2794184,Europe,77426,673
2020-12-09,Lithuania,LT,3130,31,2794184,Europe,80556,704
2020-12-10,Lithuania,LT,3327,31,2794184,Europe,83883,735
2020-12-11,Lithuania,LT,3066,29,2794184,Europe,86949,764
2020-12-12,Lithuania,LT,3303,27,2794184,Europe,90252,791
2020-12-13,Lithuania,LT,2849,24,2794184,Europe,93101,815
2020-12-14,Lithuania,LT,1920,10,2794184,Europe,95021,825
2019-12-31,Luxembourg,LU,0,0,613894,Europe,0,0
2020-01-01,Luxembourg,LU,0,0,613894,Europe,0,0
2020-01-02,Luxembourg,LU,0,0,613894,Europe,0,0
2020-01-03,Luxembourg,LU,0,0,613894,Europe,0,0
2020-01-04,Luxembourg,LU,0,0,613894,Europe,0,0
2020-01-05,Luxembourg,LU,0,0,613894,Europe,0,0
2020-01-06,Luxembourg,LU,0,0,613894,Europe,0,0
2020-01-07,Luxembourg,LU,0,0,613894,Europe,0,0
2020-01-08,Luxembourg,LU,0,0,613894,Europe,0,0
2020-01-09,Luxembourg,LU,0,0,613894,Europe,0,0
2020-01-10,Luxembourg,LU,0,0,613894,Europe,0,0
2020-01-11,Luxembourg,LU,0,0,613894,Europe,0,0
2020-01-12,Luxembourg,LU,0,0,613894,Europe,0,0
2020-01-13,Luxembourg,LU,0,0,613894,Europe,0,0
2020-01-14,Luxembourg,LU,0,0,613894,Europe,0,0
2020-01-15,Luxembourg,LU,0,0,613894,Europe,0,0
2020-01-16,Luxembourg,LU,0,0,613894,Europe,0,0
2020-01-17,Luxembourg,LU,0,0,613894,Europe,0,0
2020-01-18,Luxembourg,LU,0,0,613894,Europe,0,0
2020-01-19,Luxembourg,LU,0,0,613894,Europe,0,0
2020-01-20,Luxembourg,LU,0,0,613894,Europe,0,0
2020-01-21,Luxembourg,LU,0,0,613894,Europe,0,0
2020-01-22,Luxembourg,LU,0,0,613894,Europe,0,0
2020-01-23,Luxembourg,LU,0,0,613894,Europe,0,0
2020-01-24,Luxembourg,LU,0,0,613894,Europe,0,0
2020-01-25,Luxembourg,LU,0,0,613894,Europe,0,0
2020-01-26,Luxembourg,LU,0,0,613894,Europe,0,0
2020-01-27,Luxembourg,LU,0,0,613894,Europe,0,0
2020-01-28,Luxembourg,LU,0,0,613894,Europe,0,0
2020-01-29,Luxembourg,LU,0,0,613894,Europe,0,0
2020-01-30,Luxembourg,LU,0,0,613894,Europe,0,0
2020-01-31,Luxembourg,LU,0,0,613894,Europe,0,0
2020-02-01,Luxembourg,LU,0,0,613894,Europe,0,0
2020-02-02,Luxembourg,LU,0,0,613894,Europe,0,0
2020-02-03,Luxembourg,LU,0,0,613894,Europe,0,0
2020-02-04,Luxembourg,LU,0,0,613894,Europe,0,0
2020-02-05,Luxembourg,LU,0,0,613894,Europe,0,0
2020-02-06,Luxembourg,LU,0,0,613894,Europe,0,0
2020-02-07,Luxembourg,LU,0,0,613894,Europe,0,0
2020-02-08,Luxembourg,LU,0,0,613894,Europe,0,0
2020-02-09,Luxembourg,LU,0,0,613894,Europe,0,0
2020-02-10,Luxembourg,LU,0,0,613894,Europe,0,0
2020-02-11,Luxembourg,LU,0,0,613894,Europe,0,0
2020-02-12,Luxembourg,LU,0,0,613894,Europe,0,0
2020-02-13,Luxembourg,LU,0,0,613894,Europe,0,0
2020-02-14,Luxembourg,LU,0,0,613894,Europe,0,0
2020-02-15,Luxembourg,LU,0,0,613894,Europe,0,0
2020-02-16,Luxembourg,LU,0,0,613894,Europe,0,0
2020-02-17,Luxembourg,LU,0,0,613894,Europe,0,0
2020-02-18,Luxembourg,LU,0,0,613894,Europe,0,0
2020-02-19,Luxembourg,LU,0,0,613894,Europe,0,0
2020-02-20,Luxembourg,LU,0,0,613894,Europe,0,0
2020-02-21,Luxembourg,LU,0,0,613894,Europe,0,0
2020-02-22,Luxembourg,LU,0,0,613894,Europe,0,0
2020-02-23,Luxembourg,LU,0,0,613894,Europe,0,0
2020-02-24,Luxembourg,LU,0,0,613894,Europe,0,0
2020-02-25,Luxembourg,LU,0,0,613894,Europe,0,0
2020-02-26,Luxembourg,LU,0,0,613894,Europe,0,0
2020-02-27,Luxembourg,LU,0,0,613894,Europe,0,0
2020-02-28,Luxembourg,LU,0,0,613894,Europe,0,0
2020-02-29,Luxembourg,LU,0,0,613894,Europe,0,0
2020-03-01,Luxembourg,LU,1,0,613894,Europe,1,0
2020-03-02,Luxembourg,LU,0,0,613894,Europe,1,0
2020-03-07,Luxembourg,LU,2,0,613894,Europe,3,0
2020-03-09,Luxembourg,LU,2,0,613894,Europe,5,0
2020-03-11,Luxembourg,LU,2,0,613894,Europe,7,0
2020-03-12,Luxembourg,LU,0,0,613894,Europe,7,0
2020-03-13,Luxembourg,LU,19,0,613894,Europe,26,0
2020-03-14,Luxembourg,LU,12,1,613894,Europe,38,1
2020-03-16,Luxembourg,LU,39,0,613894,Europe,77,1
2020-03-17,Luxembourg,LU,4,0,613894,Europe,81,1
2020-03-18,Luxembourg,LU,59,0,613894,Europe,140,1
2020-03-19,Luxembourg,LU,70,1,613894,Europe,210,2
2020-03-20,Luxembourg,LU,135,2,613894,Europe,345,4
2020-03-21,Luxembourg,LU,139,1,613894,Europe,484,5
2020-03-22,Luxembourg,LU,186,3,613894,Europe,670,8
2020-03-23,Luxembourg,LU,128,0,613894,Europe,798,8
2020-03-24,Luxembourg,LU,77,0,613894,Europe,875,8
2020-03-25,Luxembourg,LU,224,0,613894,Europe,1099,8
2020-03-26,Luxembourg,LU,234,0,613894,Europe,1333,8
2020-03-27,Luxembourg,LU,120,1,613894,Europe,1453,9
2020-03-28,Luxembourg,LU,152,6,613894,Europe,1605,15
2020-03-29,Luxembourg,LU,226,3,613894,Europe,1831,18
2020-03-30,Luxembourg,LU,119,3,613894,Europe,1950,21
2020-03-31,Luxembourg,LU,38,1,613894,Europe,1988,22
2020-04-01,Luxembourg,LU,190,1,613894,Europe,2178,23
2020-04-02,Luxembourg,LU,141,6,613894,Europe,2319,29
2020-04-03,Luxembourg,LU,168,1,613894,Europe,2487,30
2020-04-04,Luxembourg,LU,125,1,613894,Europe,2612,31
2020-04-05,Luxembourg,LU,117,0,613894,Europe,2729,31
2020-04-06,Luxembourg,LU,75,5,613894,Europe,2804,36
2020-04-07,Luxembourg,LU,39,5,613894,Europe,2843,41
2020-04-08,Luxembourg,LU,127,3,613894,Europe,2970,44
2020-04-09,Luxembourg,LU,64,2,613894,Europe,3034,46
2020-04-10,Luxembourg,LU,81,6,613894,Europe,3115,52
2020-04-11,Luxembourg,LU,108,2,613894,Europe,3223,54
2020-04-12,Luxembourg,LU,47,8,613894,Europe,3270,62
2020-04-13,Luxembourg,LU,11,4,613894,Europe,3281,66
2020-04-14,Luxembourg,LU,11,1,613894,Europe,3292,67
2020-04-15,Luxembourg,LU,15,0,613894,Europe,3307,67
2020-04-16,Luxembourg,LU,66,2,613894,Europe,3373,69
2020-04-17,Luxembourg,LU,71,0,613894,Europe,3444,69
2020-04-18,Luxembourg,LU,36,3,613894,Europe,3480,72
2020-04-19,Luxembourg,LU,57,0,613894,Europe,3537,72
2020-04-20,Luxembourg,LU,13,1,613894,Europe,3550,73
2020-04-21,Luxembourg,LU,8,2,613894,Europe,3558,75
2020-04-22,Luxembourg,LU,60,3,613894,Europe,3618,78
2020-04-23,Luxembourg,LU,36,2,613894,Europe,3654,80
2020-04-24,Luxembourg,LU,11,3,613894,Europe,3665,83
2020-04-25,Luxembourg,LU,30,2,613894,Europe,3695,85
2020-04-26,Luxembourg,LU,16,0,613894,Europe,3711,85
2020-04-27,Luxembourg,LU,12,3,613894,Europe,3723,88
2020-04-28,Luxembourg,LU,6,0,613894,Europe,3729,88
2020-04-29,Luxembourg,LU,12,1,613894,Europe,3741,89
2020-04-30,Luxembourg,LU,28,0,613894,Europe,3769,89
2020-05-01,Luxembourg,LU,15,1,613894,Europe,3784,90
2020-05-02,Luxembourg,LU,18,2,613894,Europe,3802,92
2020-05-03,Luxembourg,LU,10,0,613894,Europe,3812,92
2020-05-04,Luxembourg,LU,12,4,613894,Europe,3824,96
2020-05-05,Luxembourg,LU,4,0,613894,Europe,3828,96
2020-05-06,Luxembourg,LU,12,0,613894,Europe,3840,96
2020-05-07,Luxembourg,LU,11,2,613894,Europe,3851,98
2020-05-08,Luxembourg,LU,8,2,613894,Europe,3859,100
2020-05-09,Luxembourg,LU,12,0,613894,Europe,3871,100
2020-05-10,Luxembourg,LU,6,1,613894,Europe,3877,101
2020-05-11,Luxembourg,LU,9,0,613894,Europe,3886,101
2020-05-12,Luxembourg,LU,2,0,613894,Europe,3888,101
2020-05-13,Luxembourg,LU,6,1,613894,Europe,3894,102
2020-05-14,Luxembourg,LU,10,1,613894,Europe,3904,103
2020-05-15,Luxembourg,LU,11,0,613894,Europe,3915,103
2020-05-16,Luxembourg,LU,8,1,613894,Europe,3923,104
2020-05-17,Luxembourg,LU,7,0,613894,Europe,3930,104
2020-05-18,Luxembourg,LU,15,3,613894,Europe,3945,107
2020-05-19,Luxembourg,LU,2,0,613894,Europe,3947,107
2020-05-20,Luxembourg,LU,11,2,613894,Europe,3958,109
2020-05-21,Luxembourg,LU,13,0,613894,Europe,3971,109
2020-05-22,Luxembourg,LU,9,0,613894,Europe,3980,109
2020-05-23,Luxembourg,LU,1,0,613894,Europe,3981,109
2020-05-24,Luxembourg,LU,9,0,613894,Europe,3990,109
2020-05-25,Luxembourg,LU,2,1,613894,Europe,3992,110
2020-05-26,Luxembourg,LU,1,0,613894,Europe,3993,110
2020-05-27,Luxembourg,LU,2,0,613894,Europe,3995,110
2020-05-28,Luxembourg,LU,6,0,613894,Europe,4001,110
2020-05-29,Luxembourg,LU,7,0,613894,Europe,4008,110
2020-05-30,Luxembourg,LU,4,0,613894,Europe,4012,110
2020-05-31,Luxembourg,LU,4,0,613894,Europe,4016,110
2020-06-01,Luxembourg,LU,2,0,613894,Europe,4018,110
2020-06-02,Luxembourg,LU,1,0,613894,Europe,4019,110
2020-06-03,Luxembourg,LU,1,0,613894,Europe,4020,110
2020-06-04,Luxembourg,LU,0,0,613894,Europe,4020,110
2020-06-05,Luxembourg,LU,7,0,613894,Europe,4027,110
2020-06-06,Luxembourg,LU,5,0,613894,Europe,4032,110
2020-06-07,Luxembourg,LU,3,0,613894,Europe,4035,110
2020-06-08,Luxembourg,LU,4,0,613894,Europe,4039,110
2020-06-09,Luxembourg,LU,1,0,613894,Europe,4040,110
2020-06-10,Luxembourg,LU,6,0,613894,Europe,4046,110
2020-06-11,Luxembourg,LU,3,0,613894,Europe,4049,110
2020-06-12,Luxembourg,LU,3,0,613894,Europe,4052,110
2020-06-13,Luxembourg,LU,3,0,613894,Europe,4055,110
2020-06-14,Luxembourg,LU,8,0,613894,Europe,4063,110
2020-06-15,Luxembourg,LU,7,0,613894,Europe,4070,110
2020-06-16,Luxembourg,LU,2,0,613894,Europe,4072,110
2020-06-17,Luxembourg,LU,3,0,613894,Europe,4075,110
2020-06-18,Luxembourg,LU,10,0,613894,Europe,4085,110
2020-06-19,Luxembourg,LU,6,0,613894,Europe,4091,110
2020-06-20,Luxembourg,LU,8,0,613894,Europe,4099,110
2020-06-21,Luxembourg,LU,6,0,613894,Europe,4105,110
2020-06-22,Luxembourg,LU,15,0,613894,Europe,4120,110
2020-06-23,Luxembourg,LU,1,0,613894,Europe,4121,110
2020-06-24,Luxembourg,LU,12,0,613894,Europe,4133,110
2020-06-25,Luxembourg,LU,7,0,613894,Europe,4140,110
2020-06-26,Luxembourg,LU,11,0,613894,Europe,4151,110
2020-06-27,Luxembourg,LU,22,0,613894,Europe,4173,110
2020-06-28,Luxembourg,LU,44,0,613894,Europe,4217,110
2020-06-29,Luxembourg,LU,25,0,613894,Europe,4242,110
2020-06-30,Luxembourg,LU,14,0,613894,Europe,4256,110
2020-07-01,Luxembourg,LU,43,0,613894,Europe,4299,110
2020-07-02,Luxembourg,LU,46,0,613894,Europe,4345,110
2020-07-03,Luxembourg,LU,50,0,613894,Europe,4395,110
2020-07-04,Luxembourg,LU,52,0,613894,Europe,4447,110
2020-07-05,Luxembourg,LU,29,0,613894,Europe,4476,110
2020-07-06,Luxembourg,LU,46,0,613894,Europe,4522,110
2020-07-07,Luxembourg,LU,20,0,613894,Europe,4542,110
2020-07-08,Luxembourg,LU,61,0,613894,Europe,4603,110
2020-07-09,Luxembourg,LU,47,0,613894,Europe,4650,110
2020-07-10,Luxembourg,LU,69,0,613894,Europe,4719,110
2020-07-11,Luxembourg,LU,58,0,613894,Europe,4777,110
2020-07-12,Luxembourg,LU,65,0,613894,Europe,4842,110
2020-07-13,Luxembourg,LU,83,1,613894,Europe,4925,111
2020-07-14,Luxembourg,LU,31,0,613894,Europe,4956,111
2020-07-15,Luxembourg,LU,100,0,613894,Europe,5056,111
2020-07-16,Luxembourg,LU,0,0,613894,Europe,5056,111
2020-07-17,Luxembourg,LU,66,0,613894,Europe,5122,111
2020-07-18,Luxembourg,LU,163,0,613894,Europe,5285,111
2020-07-19,Luxembourg,LU,124,0,613894,Europe,5409,111
2020-07-20,Luxembourg,LU,74,0,613894,Europe,5483,111
2020-07-21,Luxembourg,LU,122,0,613894,Europe,5605,111
2020-07-22,Luxembourg,LU,120,0,613894,Europe,5725,111
2020-07-23,Luxembourg,LU,129,0,613894,Europe,5854,111
2020-07-24,Luxembourg,LU,98,1,613894,Europe,5952,112
2020-07-25,Luxembourg,LU,104,0,613894,Europe,6056,112
2020-07-26,Luxembourg,LU,133,0,613894,Europe,6189,112
2020-07-27,Luxembourg,LU,83,0,613894,Europe,6272,112
2020-07-28,Luxembourg,LU,49,0,613894,Europe,6321,112
2020-07-29,Luxembourg,LU,54,1,613894,Europe,6375,113
2020-07-30,Luxembourg,LU,158,1,613894,Europe,6533,114
2020-07-31,Luxembourg,LU,83,0,613894,Europe,6616,114
2020-08-01,Luxembourg,LU,79,0,613894,Europe,6695,114
2020-08-02,Luxembourg,LU,0,0,613894,Europe,6695,114
2020-08-03,Luxembourg,LU,0,3,613894,Europe,6695,117
2020-08-04,Luxembourg,LU,169,1,613894,Europe,6864,118
2020-08-05,Luxembourg,LU,53,0,613894,Europe,6917,118
2020-08-06,Luxembourg,LU,90,0,613894,Europe,7007,118
2020-08-07,Luxembourg,LU,66,1,613894,Europe,7073,119
2020-08-08,Luxembourg,LU,40,0,613894,Europe,7113,119
2020-08-09,Luxembourg,LU,0,0,613894,Europe,7113,119
2020-08-10,Luxembourg,LU,0,0,613894,Europe,7113,119
2020-08-11,Luxembourg,LU,103,2,613894,Europe,7216,121
2020-08-12,Luxembourg,LU,26,1,613894,Europe,7242,122
2020-08-13,Luxembourg,LU,58,0,613894,Europe,7300,122
2020-08-14,Luxembourg,LU,68,0,613894,Europe,7368,122
2020-08-15,Luxembourg,LU,37,0,613894,Europe,7405,122
2020-08-16,Luxembourg,LU,34,1,613894,Europe,7439,123
2020-08-17,Luxembourg,LU,0,0,613894,Europe,7439,123
2020-08-18,Luxembourg,LU,30,1,613894,Europe,7469,124
2020-08-19,Luxembourg,LU,30,0,613894,Europe,7499,124
2020-08-20,Luxembourg,LU,67,0,613894,Europe,7566,124
2020-08-21,Luxembourg,LU,71,0,613894,Europe,7637,124
2020-08-22,Luxembourg,LU,67,0,613894,Europe,7704,124
2020-08-23,Luxembourg,LU,0,0,613894,Europe,7704,124
2020-08-24,Luxembourg,LU,0,0,613894,Europe,7704,124
2020-08-25,Luxembourg,LU,90,0,613894,Europe,7794,124
2020-08-26,Luxembourg,LU,44,0,613894,Europe,7838,124
2020-08-27,Luxembourg,LU,90,0,613894,Europe,7928,124
2020-08-28,Luxembourg,LU,-1385,0,613894,Europe,6543,124
2020-08-29,Luxembourg,LU,37,0,613894,Europe,6580,124
2020-08-30,Luxembourg,LU,0,0,613894,Europe,6580,124
2020-08-31,Luxembourg,LU,45,0,613894,Europe,6625,124
2020-09-01,Luxembourg,LU,52,0,613894,Europe,6677,124
2020-09-02,Luxembourg,LU,0,0,613894,Europe,6677,124
2020-09-03,Luxembourg,LU,68,0,613894,Europe,6745,124
2020-09-04,Luxembourg,LU,0,0,613894,Europe,6745,124
2020-09-05,Luxembourg,LU,109,0,613894,Europe,6854,124
2020-09-06,Luxembourg,LU,0,0,613894,Europe,6854,124
2020-09-07,Luxembourg,LU,42,0,613894,Europe,6896,124
2020-09-08,Luxembourg,LU,54,0,613894,Europe,6950,124
2020-09-09,Luxembourg,LU,24,0,613894,Europe,6974,124
2020-09-10,Luxembourg,LU,49,0,613894,Europe,7023,124
2020-09-11,Luxembourg,LU,65,0,613894,Europe,7088,124
2020-09-12,Luxembourg,LU,71,0,613894,Europe,7159,124
2020-09-13,Luxembourg,LU,0,0,613894,Europe,7159,124
2020-09-14,Luxembourg,LU,35,0,613894,Europe,7194,124
2020-09-15,Luxembourg,LU,50,0,613894,Europe,7244,124
2020-09-16,Luxembourg,LU,40,0,613894,Europe,7284,124
2020-09-17,Luxembourg,LU,110,0,613894,Europe,7394,124
2020-09-18,Luxembourg,LU,147,0,613894,Europe,7541,124
2020-09-19,Luxembourg,LU,177,0,613894,Europe,7718,124
2020-09-20,Luxembourg,LU,0,0,613894,Europe,7718,124
2020-09-21,Luxembourg,LU,86,0,613894,Europe,7804,124
2020-09-22,Luxembourg,LU,112,0,613894,Europe,7916,124
2020-09-23,Luxembourg,LU,100,0,613894,Europe,8016,124
2020-09-24,Luxembourg,LU,74,0,613894,Europe,8090,124
2020-09-25,Luxembourg,LU,68,0,613894,Europe,8158,124
2020-09-26,Luxembourg,LU,75,0,613894,Europe,8233,124
2020-09-27,Luxembourg,LU,78,0,613894,Europe,8311,124
2020-09-28,Luxembourg,LU,46,0,613894,Europe,8357,124
2020-09-29,Luxembourg,LU,19,0,613894,Europe,8376,124
2020-09-30,Luxembourg,LU,55,0,613894,Europe,8431,124
2020-10-01,Luxembourg,LU,78,0,613894,Europe,8509,124
2020-10-02,Luxembourg,LU,86,1,613894,Europe,8595,125
2020-10-03,Luxembourg,LU,114,0,613894,Europe,8709,125
2020-10-04,Luxembourg,LU,0,0,613894,Europe,8709,125
2020-10-05,Luxembourg,LU,0,0,613894,Europe,8709,125
2020-10-06,Luxembourg,LU,216,2,613894,Europe,8925,127
2020-10-07,Luxembourg,LU,54,1,613894,Europe,8979,128
2020-10-08,Luxembourg,LU,140,0,613894,Europe,9119,128
2020-10-09,Luxembourg,LU,100,1,613894,Europe,9219,129
2020-10-10,Luxembourg,LU,141,1,613894,Europe,9360,130
2020-10-11,Luxembourg,LU,0,0,613894,Europe,9360,130
2020-10-12,Luxembourg,LU,0,0,613894,Europe,9360,130
2020-10-13,Luxembourg,LU,371,3,613894,Europe,9731,133
2020-10-14,Luxembourg,LU,109,0,613894,Europe,9840,133
2020-10-15,Luxembourg,LU,190,0,613894,Europe,10030,133
2020-10-16,Luxembourg,LU,214,0,613894,Europe,10244,133
2020-10-17,Luxembourg,LU,227,0,613894,Europe,10471,133
2020-10-18,Luxembourg,LU,0,0,613894,Europe,10471,133
2020-10-19,Luxembourg,LU,175,0,613894,Europe,10646,133
2020-10-20,Luxembourg,LU,242,0,613894,Europe,10888,133
2020-10-21,Luxembourg,LU,353,3,613894,Europe,11241,136
2020-10-22,Luxembourg,LU,430,2,613894,Europe,11671,138
2020-10-23,Luxembourg,LU,662,2,613894,Europe,12333,140
2020-10-24,Luxembourg,LU,518,1,613894,Europe,12851,141
2020-10-25,Luxembourg,LU,862,3,613894,Europe,13713,144
2020-10-26,Luxembourg,LU,491,1,613894,Europe,14204,145
2020-10-27,Luxembourg,LU,195,2,613894,Europe,14399,147
2020-10-28,Luxembourg,LU,485,0,613894,Europe,14884,147
2020-10-29,Luxembourg,LU,774,0,613894,Europe,15658,147
2020-10-30,Luxembourg,LU,698,3,613894,Europe,16356,150
2020-10-31,Luxembourg,LU,778,2,613894,Europe,17134,152
2020-11-01,Luxembourg,LU,799,5,613894,Europe,17933,157
2020-11-02,Luxembourg,LU,849,3,613894,Europe,18782,160
2020-11-03,Luxembourg,LU,319,0,613894,Europe,19101,160
2020-11-04,Luxembourg,LU,533,7,613894,Europe,19634,167
2020-11-05,Luxembourg,LU,710,4,613894,Europe,20344,171
2020-11-06,Luxembourg,LU,803,6,613894,Europe,21147,177
2020-11-07,Luxembourg,LU,659,3,613894,Europe,21806,180
2020-11-08,Luxembourg,LU,675,5,613894,Europe,22481,185
2020-11-09,Luxembourg,LU,0,0,613894,Europe,22481,185
2020-11-10,Luxembourg,LU,570,3,613894,Europe,23051,188
2020-11-11,Luxembourg,LU,176,5,613894,Europe,23227,193
2020-11-12,Luxembourg,LU,483,5,613894,Europe,23710,198
2020-11-13,Luxembourg,LU,795,8,613894,Europe,24505,206
2020-11-14,Luxembourg,LU,713,5,613894,Europe,25218,211
2020-11-15,Luxembourg,LU,713,8,613894,Europe,25931,219
2020-11-16,Luxembourg,LU,613,3,613894,Europe,26544,222
2020-11-17,Luxembourg,LU,548,4,613894,Europe,27092,226
2020-11-18,Luxembourg,LU,164,10,613894,Europe,27256,236
2020-11-19,Luxembourg,LU,425,4,613894,Europe,27681,240
2020-11-20,Luxembourg,LU,892,8,613894,Europe,28573,248
2020-11-21,Luxembourg,LU,670,6,613894,Europe,29243,254
2020-11-22,Luxembourg,LU,519,6,613894,Europe,29762,260
2020-11-23,Luxembourg,LU,571,2,613894,Europe,30333,262
2020-11-24,Luxembourg,LU,602,4,613894,Europe,30935,266
2020-11-25,Luxembourg,LU,176,7,613894,Europe,31111,273
2020-11-26,Luxembourg,LU,373,10,613894,Europe,31484,283
2020-11-27,Luxembourg,LU,616,5,613894,Europe,32100,288
2020-11-28,Luxembourg,LU,1309,12,613894,Europe,33409,300
2020-11-29,Luxembourg,LU,0,0,613894,Europe,33409,300
2020-11-30,Luxembourg,LU,564,6,613894,Europe,33973,306
2020-12-01,Luxembourg,LU,565,6,613894,Europe,34538,312
2020-12-02,Luxembourg,LU,140,9,613894,Europe,34678,321
2020-12-03,Luxembourg,LU,451,9,613894,Europe,35129,330
2020-12-04,Luxembourg,LU,673,4,613894,Europe,35802,334
2020-12-05,Luxembourg,LU,627,5,613894,Europe,36429,339
2020-12-06,Luxembourg,LU,588,6,613894,Europe,37017,345
2020-12-07,Luxembourg,LU,667,5,613894,Europe,37684,350
2020-12-08,Luxembourg,LU,531,3,613894,Europe,38215,353
2020-12-09,Luxembourg,LU,261,7,613894,Europe,38476,360
2020-12-10,Luxembourg,LU,388,9,613894,Europe,38864,369
2020-12-11,Luxembourg,LU,0,0,613894,Europe,38864,369
2020-12-12,Luxembourg,LU,1173,15,613894,Europe,40037,384
2020-12-13,Luxembourg,LU,718,8,613894,Europe,40755,392
2020-12-14,Luxembourg,LU,517,4,613894,Europe,41272,396
2020-03-03,Latvia,LV,1,0,1919968,Europe,1,0
2020-03-08,Latvia,LV,1,0,1919968,Europe,2,0
2020-03-09,Latvia,LV,1,0,1919968,Europe,3,0
2020-03-10,Latvia,LV,3,0,1919968,Europe,6,0
2020-03-11,Latvia,LV,2,0,1919968,Europe,8,0
2020-03-12,Latvia,LV,2,0,1919968,Europe,10,0
2020-03-13,Latvia,LV,6,0,1919968,Europe,16,0
2020-03-14,Latvia,LV,3,0,1919968,Europe,19,0
2020-03-15,Latvia,LV,7,0,1919968,Europe,26,0
2020-03-16,Latvia,LV,5,0,1919968,Europe,31,0
2020-03-17,Latvia,LV,5,0,1919968,Europe,36,0
2020-03-18,Latvia,LV,25,0,1919968,Europe,61,0
2020-03-19,Latvia,LV,10,0,1919968,Europe,71,0
2020-03-20,Latvia,LV,15,0,1919968,Europe,86,0
2020-03-21,Latvia,LV,25,0,1919968,Europe,111,0
2020-03-22,Latvia,LV,13,0,1919968,Europe,124,0
2020-03-23,Latvia,LV,15,0,1919968,Europe,139,0
2020-03-24,Latvia,LV,41,0,1919968,Europe,180,0
2020-03-25,Latvia,LV,17,0,1919968,Europe,197,0
2020-03-26,Latvia,LV,24,0,1919968,Europe,221,0
2020-03-27,Latvia,LV,23,0,1919968,Europe,244,0
2020-03-28,Latvia,LV,36,0,1919968,Europe,280,0
2020-03-29,Latvia,LV,25,0,1919968,Europe,305,0
2020-03-30,Latvia,LV,71,0,1919968,Europe,376,0
2020-03-31,Latvia,LV,0,0,1919968,Europe,376,0
2020-04-01,Latvia,LV,22,0,1919968,Europe,398,0
2020-04-02,Latvia,LV,48,0,1919968,Europe,446,0
2020-04-03,Latvia,LV,12,0,1919968,Europe,458,0
2020-04-04,Latvia,LV,35,1,1919968,Europe,493,1
2020-04-05,Latvia,LV,16,0,1919968,Europe,509,1
2020-04-06,Latvia,LV,24,0,1919968,Europe,533,1
2020-04-07,Latvia,LV,9,0,1919968,Europe,542,1
2020-04-08,Latvia,LV,6,1,1919968,Europe,548,2
2020-04-09,Latvia,LV,29,0,1919968,Europe,577,2
2020-04-10,Latvia,LV,12,0,1919968,Europe,589,2
2020-04-11,Latvia,LV,23,0,1919968,Europe,612,2
2020-04-12,Latvia,LV,18,1,1919968,Europe,630,3
2020-04-13,Latvia,LV,21,2,1919968,Europe,651,5
2020-04-14,Latvia,LV,4,0,1919968,Europe,655,5
2020-04-15,Latvia,LV,2,0,1919968,Europe,657,5
2020-04-16,Latvia,LV,9,0,1919968,Europe,666,5
2020-04-17,Latvia,LV,9,0,1919968,Europe,675,5
2020-04-18,Latvia,LV,7,0,1919968,Europe,682,5
2020-04-19,Latvia,LV,30,0,1919968,Europe,712,5
2020-04-20,Latvia,LV,15,0,1919968,Europe,727,5
2020-04-21,Latvia,LV,12,0,1919968,Europe,739,5
2020-04-22,Latvia,LV,9,4,1919968,Europe,748,9
2020-04-23,Latvia,LV,13,2,1919968,Europe,761,11
2020-04-24,Latvia,LV,17,0,1919968,Europe,778,11
2020-04-25,Latvia,LV,6,1,1919968,Europe,784,12
2020-04-26,Latvia,LV,20,0,1919968,Europe,804,12
2020-04-27,Latvia,LV,8,0,1919968,Europe,812,12
2020-04-28,Latvia,LV,6,1,1919968,Europe,818,13
2020-04-29,Latvia,LV,18,0,1919968,Europe,836,13
2020-04-30,Latvia,LV,13,2,1919968,Europe,849,15
2020-05-01,Latvia,LV,9,0,1919968,Europe,858,15
2020-05-02,Latvia,LV,12,1,1919968,Europe,870,16
2020-05-03,Latvia,LV,1,0,1919968,Europe,871,16
2020-05-04,Latvia,LV,8,0,1919968,Europe,879,16
2020-05-05,Latvia,LV,17,0,1919968,Europe,896,16
2020-05-06,Latvia,LV,0,1,1919968,Europe,896,17
2020-05-07,Latvia,LV,4,0,1919968,Europe,900,17
2020-05-08,Latvia,LV,9,1,1919968,Europe,909,18
2020-05-09,Latvia,LV,19,0,1919968,Europe,928,18
2020-05-10,Latvia,LV,2,0,1919968,Europe,930,18
2020-05-11,Latvia,LV,9,0,1919968,Europe,939,18
2020-05-12,Latvia,LV,7,0,1919968,Europe,946,18
2020-05-13,Latvia,LV,4,0,1919968,Europe,950,18
2020-05-14,Latvia,LV,1,1,1919968,Europe,951,19
2020-05-15,Latvia,LV,11,0,1919968,Europe,962,19
2020-05-16,Latvia,LV,8,0,1919968,Europe,970,19
2020-05-17,Latvia,LV,27,0,1919968,Europe,997,19
2020-05-18,Latvia,LV,11,0,1919968,Europe,1008,19
2020-05-19,Latvia,LV,1,0,1919968,Europe,1009,19
2020-05-20,Latvia,LV,3,2,1919968,Europe,1012,21
2020-05-21,Latvia,LV,4,0,1919968,Europe,1016,21
2020-05-22,Latvia,LV,9,1,1919968,Europe,1025,22
2020-05-23,Latvia,LV,5,0,1919968,Europe,1030,22
2020-05-24,Latvia,LV,16,0,1919968,Europe,1046,22
2020-05-25,Latvia,LV,1,0,1919968,Europe,1047,22
2020-05-26,Latvia,LV,2,0,1919968,Europe,1049,22
2020-05-27,Latvia,LV,4,0,1919968,Europe,1053,22
2020-05-28,Latvia,LV,4,1,1919968,Europe,1057,23
2020-05-29,Latvia,LV,4,1,1919968,Europe,1061,24
2020-05-30,Latvia,LV,3,0,1919968,Europe,1064,24
2020-05-31,Latvia,LV,1,0,1919968,Europe,1065,24
2020-06-01,Latvia,LV,1,0,1919968,Europe,1066,24
2020-06-02,Latvia,LV,5,0,1919968,Europe,1071,24
2020-06-03,Latvia,LV,8,0,1919968,Europe,1079,24
2020-06-04,Latvia,LV,0,0,1919968,Europe,1079,24
2020-06-05,Latvia,LV,3,1,1919968,Europe,1082,25
2020-06-06,Latvia,LV,0,0,1919968,Europe,1082,25
2020-06-07,Latvia,LV,4,0,1919968,Europe,1086,25
2020-06-08,Latvia,LV,2,0,1919968,Europe,1088,25
2020-06-09,Latvia,LV,0,1,1919968,Europe,1088,26
2020-06-10,Latvia,LV,1,0,1919968,Europe,1089,26
2020-06-11,Latvia,LV,3,0,1919968,Europe,1092,26
2020-06-12,Latvia,LV,2,0,1919968,Europe,1094,26
2020-06-13,Latvia,LV,2,1,1919968,Europe,1096,27
2020-06-14,Latvia,LV,1,1,1919968,Europe,1097,28
2020-06-15,Latvia,LV,0,0,1919968,Europe,1097,28
2020-06-16,Latvia,LV,0,0,1919968,Europe,1097,28
2020-06-17,Latvia,LV,1,0,1919968,Europe,1098,28
2020-06-18,Latvia,LV,6,2,1919968,Europe,1104,30
2020-06-19,Latvia,LV,4,0,1919968,Europe,1108,30
2020-06-20,Latvia,LV,2,0,1919968,Europe,1110,30
2020-06-21,Latvia,LV,1,0,1919968,Europe,1111,30
2020-06-22,Latvia,LV,0,0,1919968,Europe,1111,30
2020-06-23,Latvia,LV,0,0,1919968,Europe,1111,30
2020-06-24,Latvia,LV,0,0,1919968,Europe,1111,30
2020-06-25,Latvia,LV,0,0,1919968,Europe,1111,30
2020-06-26,Latvia,LV,0,0,1919968,Europe,1111,30
2020-06-27,Latvia,LV,1,0,1919968,Europe,1112,30
2020-06-28,Latvia,LV,3,0,1919968,Europe,1115,30
2020-06-29,Latvia,LV,1,0,1919968,Europe,1116,30
2020-06-30,Latvia,LV,1,0,1919968,Europe,1117,30
2020-07-01,Latvia,LV,1,0,1919968,Europe,1118,30
2020-07-02,Latvia,LV,3,0,1919968,Europe,1121,30
2020-07-03,Latvia,LV,1,0,1919968,Europe,1122,30
2020-07-04,Latvia,LV,0,0,1919968,Europe,1122,30
2020-07-05,Latvia,LV,1,0,1919968,Europe,1123,30
2020-07-06,Latvia,LV,1,0,1919968,Europe,1124,30
2020-07-07,Latvia,LV,3,0,1919968,Europe,1127,30
2020-07-08,Latvia,LV,7,0,1919968,Europe,1134,30
2020-07-09,Latvia,LV,7,0,1919968,Europe,1141,30
2020-07-10,Latvia,LV,13,0,1919968,Europe,1154,30
2020-07-11,Latvia,LV,0,0,1919968,Europe,1154,30
2020-07-12,Latvia,LV,19,0,1919968,Europe,1173,30
2020-07-13,Latvia,LV,0,0,1919968,Europe,1173,30
2020-07-14,Latvia,LV,1,1,1919968,Europe,1174,31
2020-07-15,Latvia,LV,4,0,1919968,Europe,1178,31
2020-07-16,Latvia,LV,0,0,1919968,Europe,1178,31
2020-07-17,Latvia,LV,1,0,1919968,Europe,1179,31
2020-07-18,Latvia,LV,6,0,1919968,Europe,1185,31
2020-07-19,Latvia,LV,4,0,1919968,Europe,1189,31
2020-07-20,Latvia,LV,3,0,1919968,Europe,1192,31
2020-07-21,Latvia,LV,0,0,1919968,Europe,1192,31
2020-07-22,Latvia,LV,1,0,1919968,Europe,1193,31
2020-07-23,Latvia,LV,4,0,1919968,Europe,1197,31
2020-07-24,Latvia,LV,6,0,1919968,Europe,1203,31
2020-07-25,Latvia,LV,2,0,1919968,Europe,1205,31
2020-07-26,Latvia,LV,1,0,1919968,Europe,1206,31
2020-07-27,Latvia,LV,13,0,1919968,Europe,1219,31
2020-07-28,Latvia,LV,1,0,1919968,Europe,1220,31
2020-07-29,Latvia,LV,0,0,1919968,Europe,1220,31
2020-07-30,Latvia,LV,4,0,1919968,Europe,1224,31
2020-07-31,Latvia,LV,4,0,1919968,Europe,1228,31
2020-08-01,Latvia,LV,3,1,1919968,Europe,1231,32
2020-08-02,Latvia,LV,7,0,1919968,Europe,1238,32
2020-08-03,Latvia,LV,5,0,1919968,Europe,1243,32
2020-08-04,Latvia,LV,3,0,1919968,Europe,1246,32
2020-08-05,Latvia,LV,3,0,1919968,Europe,1249,32
2020-08-06,Latvia,LV,8,0,1919968,Europe,1257,32
2020-08-07,Latvia,LV,18,0,1919968,Europe,1275,32
2020-08-08,Latvia,LV,6,0,1919968,Europe,1281,32
2020-08-09,Latvia,LV,7,0,1919968,Europe,1288,32
2020-08-10,Latvia,LV,2,0,1919968,Europe,1290,32
2020-08-11,Latvia,LV,3,0,1919968,Europe,1293,32
2020-08-12,Latvia,LV,10,0,1919968,Europe,1303,32
2020-08-13,Latvia,LV,0,0,1919968,Europe,1303,32
2020-08-14,Latvia,LV,4,0,1919968,Europe,1307,32
2020-08-15,Latvia,LV,1,0,1919968,Europe,1308,32
2020-08-16,Latvia,LV,7,0,1919968,Europe,1315,32
2020-08-17,Latvia,LV,7,0,1919968,Europe,1322,32
2020-08-18,Latvia,LV,1,0,1919968,Europe,1323,32
2020-08-19,Latvia,LV,0,1,1919968,Europe,1323,33
2020-08-20,Latvia,LV,3,0,1919968,Europe,1326,33
2020-08-21,Latvia,LV,1,0,1919968,Europe,1327,33
2020-08-22,Latvia,LV,3,0,1919968,Europe,1330,33
2020-08-23,Latvia,LV,3,0,1919968,Europe,1333,33
2020-08-24,Latvia,LV,4,0,1919968,Europe,1337,33
2020-08-25,Latvia,LV,0,0,1919968,Europe,1337,33
2020-08-26,Latvia,LV,5,0,1919968,Europe,1342,33
2020-08-27,Latvia,LV,18,0,1919968,Europe,1360,33
2020-08-28,Latvia,LV,6,1,1919968,Europe,1366,34
2020-08-29,Latvia,LV,9,0,1919968,Europe,1375,34
2020-08-30,Latvia,LV,0,0,1919968,Europe,1375,34
2020-08-31,Latvia,LV,18,0,1919968,Europe,1393,34
2020-09-01,Latvia,LV,3,0,1919968,Europe,1396,34
2020-09-02,Latvia,LV,8,0,1919968,Europe,1404,34
2020-09-03,Latvia,LV,2,0,1919968,Europe,1406,34
2020-09-04,Latvia,LV,4,0,1919968,Europe,1410,34
2020-09-05,Latvia,LV,6,1,1919968,Europe,1416,35
2020-09-06,Latvia,LV,9,0,1919968,Europe,1425,35
2020-09-07,Latvia,LV,3,0,1919968,Europe,1428,35
2020-09-08,Latvia,LV,1,0,1919968,Europe,1429,35
2020-09-09,Latvia,LV,3,0,1919968,Europe,1432,35
2020-09-10,Latvia,LV,11,0,1919968,Europe,1443,35
2020-09-11,Latvia,LV,5,0,1919968,Europe,1448,35
2020-09-12,Latvia,LV,11,0,1919968,Europe,1459,35
2020-09-13,Latvia,LV,5,0,1919968,Europe,1464,35
2020-09-14,Latvia,LV,10,0,1919968,Europe,1474,35
2020-09-15,Latvia,LV,3,0,1919968,Europe,1477,35
2020-09-16,Latvia,LV,5,0,1919968,Europe,1482,35
2020-09-17,Latvia,LV,4,0,1919968,Europe,1486,35
2020-09-18,Latvia,LV,8,1,1919968,Europe,1494,36
2020-09-19,Latvia,LV,4,0,1919968,Europe,1498,36
2020-09-20,Latvia,LV,17,0,1919968,Europe,1515,36
2020-09-21,Latvia,LV,10,0,1919968,Europe,1525,36
2020-09-22,Latvia,LV,1,0,1919968,Europe,1526,36
2020-09-23,Latvia,LV,34,0,1919968,Europe,1560,36
2020-09-24,Latvia,LV,12,0,1919968,Europe,1572,36
2020-09-25,Latvia,LV,22,0,1919968,Europe,1594,36
2020-09-26,Latvia,LV,31,0,1919968,Europe,1625,36
2020-09-27,Latvia,LV,29,0,1919968,Europe,1654,36
2020-09-28,Latvia,LV,22,0,1919968,Europe,1676,36
2020-09-29,Latvia,LV,21,0,1919968,Europe,1697,36
2020-09-30,Latvia,LV,32,1,1919968,Europe,1729,37
2020-10-01,Latvia,LV,95,0,1919968,Europe,1824,37
2020-10-02,Latvia,LV,44,0,1919968,Europe,1868,37
2020-10-03,Latvia,LV,77,1,1919968,Europe,1945,38
2020-10-04,Latvia,LV,74,0,1919968,Europe,2019,38
2020-10-05,Latvia,LV,67,0,1919968,Europe,2086,38
2020-10-06,Latvia,LV,40,1,1919968,Europe,2126,39
2020-10-07,Latvia,LV,68,0,1919968,Europe,2194,39
2020-10-08,Latvia,LV,67,1,1919968,Europe,2261,40
2020-10-09,Latvia,LV,109,0,1919968,Europe,2370,40
2020-10-10,Latvia,LV,137,0,1919968,Europe,2507,40
2020-10-11,Latvia,LV,89,0,1919968,Europe,2596,40
2020-10-12,Latvia,LV,74,0,1919968,Europe,2670,40
2020-10-13,Latvia,LV,95,0,1919968,Europe,2765,40
2020-10-14,Latvia,LV,75,1,1919968,Europe,2840,41
2020-10-15,Latvia,LV,102,0,1919968,Europe,2942,41
2020-10-16,Latvia,LV,114,0,1919968,Europe,3056,41
2020-10-17,Latvia,LV,148,1,1919968,Europe,3204,42
2020-10-18,Latvia,LV,188,0,1919968,Europe,3392,42
2020-10-19,Latvia,LV,58,0,1919968,Europe,3450,42
2020-10-20,Latvia,LV,44,0,1919968,Europe,3494,42
2020-10-21,Latvia,LV,115,4,1919968,Europe,3609,46
2020-10-22,Latvia,LV,188,2,1919968,Europe,3797,48
2020-10-23,Latvia,LV,161,1,1919968,Europe,3958,49
2020-10-24,Latvia,LV,250,1,1919968,Europe,4208,50
2020-10-25,Latvia,LV,259,4,1919968,Europe,4467,54
2020-10-26,Latvia,LV,211,2,1919968,Europe,4678,56
2020-10-27,Latvia,LV,79,4,1919968,Europe,4757,60
2020-10-28,Latvia,LV,136,3,1919968,Europe,4893,63
2020-10-29,Latvia,LV,251,0,1919968,Europe,5144,63
2020-10-30,Latvia,LV,251,1,1919968,Europe,5395,64
2020-10-31,Latvia,LV,284,5,1919968,Europe,5679,69
2020-11-01,Latvia,LV,215,2,1919968,Europe,5894,71
2020-11-02,Latvia,LV,242,3,1919968,Europe,6136,74
2020-11-03,Latvia,LV,132,3,1919968,Europe,6268,77
2020-11-04,Latvia,LV,171,2,1919968,Europe,6439,79
2020-11-05,Latvia,LV,313,6,1919968,Europe,6752,85
2020-11-06,Latvia,LV,367,3,1919968,Europe,7119,88
2020-11-07,Latvia,LV,357,7,1919968,Europe,7476,95
2020-11-08,Latvia,LV,404,1,1919968,Europe,7880,96
2020-11-09,Latvia,LV,215,3,1919968,Europe,8095,99
2020-11-10,Latvia,LV,92,2,1919968,Europe,8187,101
2020-11-11,Latvia,LV,208,2,1919968,Europe,8395,103
2020-11-12,Latvia,LV,453,0,1919968,Europe,8848,103
2020-11-13,Latvia,LV,533,4,1919968,Europe,9381,107
2020-11-14,Latvia,LV,455,9,1919968,Europe,9836,116
2020-11-15,Latvia,LV,395,5,1919968,Europe,10231,121
2020-11-16,Latvia,LV,316,2,1919968,Europe,10547,123
2020-11-17,Latvia,LV,89,3,1919968,Europe,10636,126
2020-11-18,Latvia,LV,278,6,1919968,Europe,10914,132
2020-11-19,Latvia,LV,442,5,1919968,Europe,11356,137
2020-11-20,Latvia,LV,366,4,1919968,Europe,11722,141
2020-11-21,Latvia,LV,380,5,1919968,Europe,12102,146
2020-11-22,Latvia,LV,642,7,1919968,Europe,12744,153
2020-11-23,Latvia,LV,376,0,1919968,Europe,13120,153
2020-11-24,Latvia,LV,116,9,1919968,Europe,13236,162
2020-11-25,Latvia,LV,457,13,1919968,Europe,13693,175
2020-11-26,Latvia,LV,580,9,1919968,Europe,14273,184
2020-11-27,Latvia,LV,898,4,1919968,Europe,15171,188
2020-11-28,Latvia,LV,637,2,1919968,Europe,15808,190
2020-11-29,Latvia,LV,753,3,1919968,Europe,16561,193
2020-11-30,Latvia,LV,414,4,1919968,Europe,16975,197
2020-12-01,Latvia,LV,100,9,1919968,Europe,17075,206
2020-12-02,Latvia,LV,612,4,1919968,Europe,17687,210
2020-12-03,Latvia,LV,690,14,1919968,Europe,18377,224
2020-12-04,Latvia,LV,930,11,1919968,Europe,19307,235
2020-12-05,Latvia,LV,686,7,1919968,Europe,19993,242
2020-12-06,Latvia,LV,794,11,1919968,Europe,20787,253
2020-12-07,Latvia,LV,526,9,1919968,Europe,21313,262
2020-12-08,Latvia,LV,207,10,1919968,Europe,21520,272
2020-12-09,Latvia,LV,584,16,1919968,Europe,22104,288
2020-12-10,Latvia,LV,712,5,1919968,Europe,22816,293
2020-12-11,Latvia,LV,890,11,1919968,Europe,23706,304
2020-12-12,Latvia,LV,680,15,1919968,Europe,24386,319
2020-12-13,Latvia,LV,660,5,1919968,Europe,25046,324
2020-12-14,Latvia,LV,629,25,1919968,Europe,25675,349
2020-03-25,Libya,LY,1,0,6777453,Africa,1,0
2020-03-26,Libya,LY,0,0,6777453,Africa,1,0
2020-03-27,Libya,LY,0,0,6777453,Africa,1,0
2020-03-28,Libya,LY,0,0,6777453,Africa,1,0
2020-03-29,Libya,LY,0,0,6777453,Africa,1,0
2020-03-30,Libya,LY,7,0,6777453,Africa,8,0
2020-03-31,Libya,LY,0,0,6777453,Africa,8,0
2020-04-01,Libya,LY,2,0,6777453,Africa,10,0
2020-04-02,Libya,LY,0,0,6777453,Africa,10,0
2020-04-03,Libya,LY,1,1,6777453,Africa,11,1
2020-04-04,Libya,LY,0,0,6777453,Africa,11,1
2020-04-05,Libya,LY,7,0,6777453,Africa,18,1
2020-04-06,Libya,LY,0,0,6777453,Africa,18,1
2020-04-07,Libya,LY,0,0,6777453,Africa,18,1
2020-04-08,Libya,LY,1,0,6777453,Africa,19,1
2020-04-09,Libya,LY,2,0,6777453,Africa,21,1
2020-04-10,Libya,LY,3,0,6777453,Africa,24,1
2020-04-11,Libya,LY,0,0,6777453,Africa,24,1
2020-04-12,Libya,LY,1,0,6777453,Africa,25,1
2020-04-13,Libya,LY,0,0,6777453,Africa,25,1
2020-04-14,Libya,LY,1,0,6777453,Africa,26,1
2020-04-15,Libya,LY,9,0,6777453,Africa,35,1
2020-04-16,Libya,LY,13,0,6777453,Africa,48,1
2020-04-17,Libya,LY,1,0,6777453,Africa,49,1
2020-04-18,Libya,LY,0,0,6777453,Africa,49,1
2020-04-19,Libya,LY,0,0,6777453,Africa,49,1
2020-04-20,Libya,LY,0,0,6777453,Africa,49,1
2020-04-21,Libya,LY,2,0,6777453,Africa,51,1
2020-04-22,Libya,LY,0,0,6777453,Africa,51,1
2020-04-23,Libya,LY,8,0,6777453,Africa,59,1
2020-04-24,Libya,LY,1,1,6777453,Africa,60,2
2020-04-25,Libya,LY,1,0,6777453,Africa,61,2
2020-04-26,Libya,LY,0,0,6777453,Africa,61,2
2020-04-27,Libya,LY,0,0,6777453,Africa,61,2
2020-04-28,Libya,LY,0,0,6777453,Africa,61,2
2020-04-29,Libya,LY,0,0,6777453,Africa,61,2
2020-04-30,Libya,LY,0,0,6777453,Africa,61,2
2020-05-01,Libya,LY,0,1,6777453,Africa,61,3
2020-05-02,Libya,LY,2,0,6777453,Africa,63,3
2020-05-03,Libya,LY,0,0,6777453,Africa,63,3
2020-05-04,Libya,LY,0,0,6777453,Africa,63,3
2020-05-05,Libya,LY,0,0,6777453,Africa,63,3
2020-05-06,Libya,LY,0,0,6777453,Africa,63,3
2020-05-07,Libya,LY,1,0,6777453,Africa,64,3
2020-05-08,Libya,LY,0,0,6777453,Africa,64,3
2020-05-09,Libya,LY,0,0,6777453,Africa,64,3
2020-05-10,Libya,LY,0,0,6777453,Africa,64,3
2020-05-11,Libya,LY,0,0,6777453,Africa,64,3
2020-05-12,Libya,LY,0,0,6777453,Africa,64,3
2020-05-13,Libya,LY,0,0,6777453,Africa,64,3
2020-05-14,Libya,LY,0,0,6777453,Africa,64,3
2020-05-15,Libya,LY,0,0,6777453,Africa,64,3
2020-05-16,Libya,LY,0,0,6777453,Africa,64,3
2020-05-17,Libya,LY,1,0,6777453,Africa,65,3
2020-05-18,Libya,LY,0,0,6777453,Africa,65,3
2020-05-19,Libya,LY,0,0,6777453,Africa,65,3
2020-05-20,Libya,LY,3,0,6777453,Africa,68,3
2020-05-21,Libya,LY,1,0,6777453,Africa,69,3
2020-05-22,Libya,LY,2,0,6777453,Africa,71,3
2020-05-23,Libya,LY,1,0,6777453,Africa,72,3
2020-05-24,Libya,LY,3,0,6777453,Africa,75,3
2020-05-25,Libya,LY,0,0,6777453,Africa,75,3
2020-05-26,Libya,LY,0,0,6777453,Africa,75,3
2020-05-27,Libya,LY,2,0,6777453,Africa,77,3
2020-05-28,Libya,LY,22,1,6777453,Africa,99,4
2020-05-29,Libya,LY,6,1,6777453,Africa,105,5
2020-05-30,Libya,LY,13,0,6777453,Africa,118,5
2020-05-31,Libya,LY,12,0,6777453,Africa,130,5
2020-06-01,Libya,LY,26,0,6777453,Africa,156,5
2020-06-02,Libya,LY,12,0,6777453,Africa,168,5
2020-06-03,Libya,LY,14,0,6777453,Africa,182,5
2020-06-04,Libya,LY,14,0,6777453,Africa,196,5
2020-06-05,Libya,LY,0,0,6777453,Africa,196,5
2020-06-06,Libya,LY,43,0,6777453,Africa,239,5
2020-06-07,Libya,LY,17,0,6777453,Africa,256,5
2020-06-08,Libya,LY,0,0,6777453,Africa,256,5
2020-06-09,Libya,LY,14,0,6777453,Africa,270,5
2020-06-10,Libya,LY,62,0,6777453,Africa,332,5
2020-06-11,Libya,LY,46,0,6777453,Africa,378,5
2020-06-12,Libya,LY,15,0,6777453,Africa,393,5
2020-06-13,Libya,LY,16,1,6777453,Africa,409,6
2020-06-14,Libya,LY,9,2,6777453,Africa,418,8
2020-06-15,Libya,LY,0,0,6777453,Africa,418,8
2020-06-16,Libya,LY,49,2,6777453,Africa,467,10
2020-06-17,Libya,LY,0,0,6777453,Africa,467,10
2020-06-18,Libya,LY,0,0,6777453,Africa,467,10
2020-06-19,Libya,LY,33,0,6777453,Africa,500,10
2020-06-20,Libya,LY,10,0,6777453,Africa,510,10
2020-06-21,Libya,LY,10,0,6777453,Africa,520,10
2020-06-22,Libya,LY,24,0,6777453,Africa,544,10
2020-06-23,Libya,LY,27,0,6777453,Africa,571,10
2020-06-24,Libya,LY,68,7,6777453,Africa,639,17
2020-06-25,Libya,LY,0,1,6777453,Africa,639,18
2020-06-26,Libya,LY,59,0,6777453,Africa,698,18
2020-06-27,Libya,LY,0,0,6777453,Africa,698,18
2020-06-28,Libya,LY,15,0,6777453,Africa,713,18
2020-06-29,Libya,LY,49,3,6777453,Africa,762,21
2020-06-30,Libya,LY,0,0,6777453,Africa,762,21
2020-07-01,Libya,LY,62,3,6777453,Africa,824,24
2020-07-02,Libya,LY,34,0,6777453,Africa,858,24
2020-07-03,Libya,LY,33,2,6777453,Africa,891,26
2020-07-04,Libya,LY,27,1,6777453,Africa,918,27
2020-07-05,Libya,LY,71,0,6777453,Africa,989,27
2020-07-06,Libya,LY,0,0,6777453,Africa,989,27
2020-07-07,Libya,LY,57,5,6777453,Africa,1046,32
2020-07-08,Libya,LY,136,3,6777453,Africa,1182,35
2020-07-09,Libya,LY,0,0,6777453,Africa,1182,35
2020-07-10,Libya,LY,86,1,6777453,Africa,1268,36
2020-07-11,Libya,LY,74,2,6777453,Africa,1342,38
2020-07-12,Libya,LY,47,0,6777453,Africa,1389,38
2020-07-13,Libya,LY,44,1,6777453,Africa,1433,39
2020-07-14,Libya,LY,79,1,6777453,Africa,1512,40
2020-07-15,Libya,LY,51,2,6777453,Africa,1563,42
2020-07-16,Libya,LY,26,1,6777453,Africa,1589,43
2020-07-17,Libya,LY,63,3,6777453,Africa,1652,46
2020-07-18,Libya,LY,52,1,6777453,Africa,1704,47
2020-07-19,Libya,LY,87,1,6777453,Africa,1791,48
2020-07-20,Libya,LY,75,0,6777453,Africa,1866,48
2020-07-21,Libya,LY,94,1,6777453,Africa,1960,49
2020-07-22,Libya,LY,128,1,6777453,Africa,2088,50
2020-07-23,Libya,LY,88,3,6777453,Africa,2176,53
2020-07-24,Libya,LY,138,3,6777453,Africa,2314,56
2020-07-25,Libya,LY,111,1,6777453,Africa,2425,57
2020-07-26,Libya,LY,122,1,6777453,Africa,2547,58
2020-07-27,Libya,LY,0,0,6777453,Africa,2547,58
2020-07-28,Libya,LY,280,6,6777453,Africa,2827,64
2020-07-29,Libya,LY,0,0,6777453,Africa,2827,64
2020-07-30,Libya,LY,190,3,6777453,Africa,3017,67
2020-07-31,Libya,LY,205,4,6777453,Africa,3222,71
2020-08-01,Libya,LY,0,0,6777453,Africa,3222,71
2020-08-02,Libya,LY,399,3,6777453,Africa,3621,74
2020-08-03,Libya,LY,70,6,6777453,Africa,3691,80
2020-08-04,Libya,LY,372,13,6777453,Africa,4063,93
2020-08-05,Libya,LY,0,0,6777453,Africa,4063,93
2020-08-06,Libya,LY,161,3,6777453,Africa,4224,96
2020-08-07,Libya,LY,251,3,6777453,Africa,4475,99
2020-08-08,Libya,LY,604,9,6777453,Africa,5079,108
2020-08-09,Libya,LY,0,0,6777453,Africa,5079,108
2020-08-10,Libya,LY,153,5,6777453,Africa,5232,113
2020-08-11,Libya,LY,309,7,6777453,Africa,5541,120
2020-08-12,Libya,LY,388,5,6777453,Africa,5929,125
2020-08-13,Libya,LY,373,7,6777453,Africa,6302,132
2020-08-14,Libya,LY,748,3,6777453,Africa,7050,135
2020-08-15,Libya,LY,277,4,6777453,Africa,7327,139
2020-08-16,Libya,LY,411,6,6777453,Africa,7738,145
2020-08-17,Libya,LY,0,0,6777453,Africa,7738,145
2020-08-18,Libya,LY,841,12,6777453,Africa,8579,157
2020-08-19,Libya,LY,0,0,6777453,Africa,8579,157
2020-08-20,Libya,LY,489,7,6777453,Africa,9068,164
2020-08-21,Libya,LY,395,5,6777453,Africa,9463,169
2020-08-22,Libya,LY,244,4,6777453,Africa,9707,173
2020-08-23,Libya,LY,414,7,6777453,Africa,10121,180
2020-08-24,Libya,LY,316,8,6777453,Africa,10437,188
2020-08-25,Libya,LY,572,11,6777453,Africa,11009,199
2020-08-26,Libya,LY,272,4,6777453,Africa,11281,203
2020-08-27,Libya,LY,553,7,6777453,Africa,11834,210
2020-08-28,Libya,LY,440,9,6777453,Africa,12274,219
2020-08-29,Libya,LY,355,7,6777453,Africa,12629,226
2020-08-30,Libya,LY,329,5,6777453,Africa,12958,231
2020-08-31,Libya,LY,465,1,6777453,Africa,13423,232
2020-09-01,Libya,LY,543,5,6777453,Africa,13966,237
2020-09-02,Libya,LY,658,5,6777453,Africa,14624,242
2020-09-03,Libya,LY,532,8,6777453,Africa,15156,250
2020-09-04,Libya,LY,617,4,6777453,Africa,15773,254
2020-09-05,Libya,LY,672,8,6777453,Africa,16445,262
2020-09-06,Libya,LY,649,10,6777453,Africa,17094,272
2020-09-07,Libya,LY,655,13,6777453,Africa,17749,285
2020-09-08,Libya,LY,1084,11,6777453,Africa,18833,296
2020-09-09,Libya,LY,750,18,6777453,Africa,19583,314
2020-09-10,Libya,LY,879,10,6777453,Africa,20462,324
2020-09-11,Libya,LY,477,15,6777453,Africa,20939,339
2020-09-12,Libya,LY,969,13,6777453,Africa,21908,352
2020-09-13,Libya,LY,440,2,6777453,Africa,22348,354
2020-09-14,Libya,LY,433,8,6777453,Africa,22781,362
2020-09-15,Libya,LY,734,6,6777453,Africa,23515,368
2020-09-16,Libya,LY,629,15,6777453,Africa,24144,383
2020-09-17,Libya,LY,792,11,6777453,Africa,24936,394
2020-09-18,Libya,LY,886,15,6777453,Africa,25822,409
2020-09-19,Libya,LY,616,13,6777453,Africa,26438,422
2020-09-20,Libya,LY,796,8,6777453,Africa,27234,430
2020-09-21,Libya,LY,715,8,6777453,Africa,27949,438
2020-09-22,Libya,LY,847,16,6777453,Africa,28796,454
2020-09-23,Libya,LY,650,10,6777453,Africa,29446,464
2020-09-24,Libya,LY,651,9,6777453,Africa,30097,473
2020-09-25,Libya,LY,535,1,6777453,Africa,30632,474
2020-09-26,Libya,LY,658,17,6777453,Africa,31290,491
2020-09-27,Libya,LY,538,8,6777453,Africa,31828,499
2020-09-28,Libya,LY,536,21,6777453,Africa,32364,520
2020-09-29,Libya,LY,849,7,6777453,Africa,33213,527
2020-09-30,Libya,LY,801,13,6777453,Africa,34014,540
2020-10-01,Libya,LY,511,11,6777453,Africa,34525,551
2020-10-02,Libya,LY,683,8,6777453,Africa,35208,559
2020-10-03,Libya,LY,509,11,6777453,Africa,35717,570
2020-10-04,Libya,LY,370,8,6777453,Africa,36087,578
2020-10-05,Libya,LY,722,14,6777453,Africa,36809,592
2020-10-06,Libya,LY,628,4,6777453,Africa,37437,596
2020-10-07,Libya,LY,1031,6,6777453,Africa,38468,602
2020-10-08,Libya,LY,1045,6,6777453,Africa,39513,608
2020-10-09,Libya,LY,779,8,6777453,Africa,40292,616
2020-10-10,Libya,LY,1076,5,6777453,Africa,41368,621
2020-10-11,Libya,LY,318,2,6777453,Africa,41686,623
2020-10-12,Libya,LY,1026,8,6777453,Africa,42712,631
2020-10-13,Libya,LY,1109,13,6777453,Africa,43821,644
2020-10-14,Libya,LY,1164,12,6777453,Africa,44985,656
2020-10-15,Libya,LY,836,13,6777453,Africa,45821,669
2020-10-16,Libya,LY,855,12,6777453,Africa,46676,681
2020-10-17,Libya,LY,1169,18,6777453,Africa,47845,699
2020-10-18,Libya,LY,0,0,6777453,Africa,47845,699
2020-10-19,Libya,LY,945,26,6777453,Africa,48790,725
2020-10-20,Libya,LY,1159,7,6777453,Africa,49949,732
2020-10-21,Libya,LY,957,14,6777453,Africa,50906,746
2020-10-22,Libya,LY,719,19,6777453,Africa,51625,765
2020-10-23,Libya,LY,995,3,6777453,Africa,52620,768
2020-10-24,Libya,LY,764,6,6777453,Africa,53384,774
2020-10-25,Libya,LY,990,16,6777453,Africa,54374,790
2020-10-26,Libya,LY,1639,5,6777453,Africa,56013,795
2020-10-27,Libya,LY,1210,6,6777453,Africa,57223,801
2020-10-28,Libya,LY,752,11,6777453,Africa,57975,812
2020-10-29,Libya,LY,899,11,6777453,Africa,58874,823
2020-10-30,Libya,LY,782,8,6777453,Africa,59656,831
2020-10-31,Libya,LY,972,16,6777453,Africa,60628,847
2020-11-01,Libya,LY,467,10,6777453,Africa,61095,857
2020-11-02,Libya,LY,950,14,6777453,Africa,62045,871
2020-11-03,Libya,LY,862,9,6777453,Africa,62907,880
2020-11-04,Libya,LY,781,13,6777453,Africa,63688,893
2020-11-05,Libya,LY,899,7,6777453,Africa,64587,900
2020-11-06,Libya,LY,853,7,6777453,Africa,65440,907
2020-11-07,Libya,LY,1004,8,6777453,Africa,66444,915
2020-11-08,Libya,LY,595,5,6777453,Africa,67039,920
2020-11-09,Libya,LY,1078,9,6777453,Africa,68117,929
2020-11-10,Libya,LY,923,15,6777453,Africa,69040,944
2020-11-11,Libya,LY,970,13,6777453,Africa,70010,957
2020-11-12,Libya,LY,875,13,6777453,Africa,70885,970
2020-11-13,Libya,LY,919,15,6777453,Africa,71804,985
2020-11-14,Libya,LY,824,10,6777453,Africa,72628,995
2020-11-15,Libya,LY,0,0,6777453,Africa,72628,995
2020-11-16,Libya,LY,974,22,6777453,Africa,73602,1017
2020-11-17,Libya,LY,722,8,6777453,Africa,74324,1025
2020-11-18,Libya,LY,612,16,6777453,Africa,74936,1041
2020-11-19,Libya,LY,529,12,6777453,Africa,75465,1053
2020-11-20,Libya,LY,541,9,6777453,Africa,76006,1062
2020-11-21,Libya,LY,802,6,6777453,Africa,76808,1068
2020-11-22,Libya,LY,0,0,6777453,Africa,76808,1068
2020-11-23,Libya,LY,1015,21,6777453,Africa,77823,1089
2020-11-24,Libya,LY,650,13,6777453,Africa,78473,1102
2020-11-25,Libya,LY,707,8,6777453,Africa,79180,1110
2020-11-26,Libya,LY,617,15,6777453,Africa,79797,1125
2020-11-27,Libya,LY,610,15,6777453,Africa,80407,1140
2020-11-28,Libya,LY,866,13,6777453,Africa,81273,1153
2020-11-29,Libya,LY,0,0,6777453,Africa,81273,1153
2020-11-30,Libya,LY,1157,13,6777453,Africa,82430,1166
2020-12-01,Libya,LY,379,17,6777453,Africa,82809,1183
2020-12-02,Libya,LY,608,13,6777453,Africa,83417,1196
2020-12-03,Libya,LY,1390,4,6777453,Africa,84807,1200
2020-12-04,Libya,LY,42,12,6777453,Africa,84849,1212
2020-12-05,Libya,LY,680,7,6777453,Africa,85529,1219
2020-12-06,Libya,LY,0,0,6777453,Africa,85529,1219
2020-12-07,Libya,LY,1051,12,6777453,Africa,86580,1231
2020-12-08,Libya,LY,517,12,6777453,Africa,87097,1243
2020-12-09,Libya,LY,889,12,6777453,Africa,87986,1255
2020-12-10,Libya,LY,536,6,6777453,Africa,88522,1261
2020-12-11,Libya,LY,661,12,6777453,Africa,89183,1273
2020-12-12,Libya,LY,697,5,6777453,Africa,89880,1278
2020-12-13,Libya,LY,0,0,6777453,Africa,89880,1278
2020-12-14,Libya,LY,899,21,6777453,Africa,90779,1299
2020-03-03,Morocco,MA,1,0,36471766,Africa,1,0
2020-03-06,Morocco,MA,1,0,36471766,Africa,2,0
2020-03-12,Morocco,MA,3,1,36471766,Africa,5,1
2020-03-13,Morocco,MA,1,0,36471766,Africa,6,1
2020-03-14,Morocco,MA,1,0,36471766,Africa,7,1
2020-03-15,Morocco,MA,11,0,36471766,Africa,18,1
2020-03-16,Morocco,MA,10,0,36471766,Africa,28,1
2020-03-17,Morocco,MA,9,0,36471766,Africa,37,1
2020-03-18,Morocco,MA,7,1,36471766,Africa,44,2
2020-03-19,Morocco,MA,10,0,36471766,Africa,54,2
2020-03-20,Morocco,MA,9,0,36471766,Africa,63,2
2020-03-21,Morocco,MA,23,1,36471766,Africa,86,3
2020-03-22,Morocco,MA,10,0,36471766,Africa,96,3
2020-03-23,Morocco,MA,19,1,36471766,Africa,115,4
2020-03-24,Morocco,MA,19,0,36471766,Africa,134,4
2020-03-25,Morocco,MA,36,1,36471766,Africa,170,5
2020-03-26,Morocco,MA,55,1,36471766,Africa,225,6
2020-03-27,Morocco,MA,50,4,36471766,Africa,275,10
2020-03-28,Morocco,MA,70,13,36471766,Africa,345,23
2020-03-29,Morocco,MA,13,0,36471766,Africa,358,23
2020-03-30,Morocco,MA,121,3,36471766,Africa,479,26
2020-03-31,Morocco,MA,77,7,36471766,Africa,556,33
2020-04-01,Morocco,MA,61,3,36471766,Africa,617,36
2020-04-02,Morocco,MA,37,3,36471766,Africa,654,39
2020-04-03,Morocco,MA,54,5,36471766,Africa,708,44
2020-04-04,Morocco,MA,0,0,36471766,Africa,708,44
2020-04-05,Morocco,MA,211,15,36471766,Africa,919,59
2020-04-06,Morocco,MA,102,11,36471766,Africa,1021,70
2020-04-07,Morocco,MA,99,10,36471766,Africa,1120,80
2020-04-08,Morocco,MA,64,10,36471766,Africa,1184,90
2020-04-09,Morocco,MA,91,3,36471766,Africa,1275,93
2020-04-10,Morocco,MA,99,4,36471766,Africa,1374,97
2020-04-11,Morocco,MA,74,10,36471766,Africa,1448,107
2020-04-12,Morocco,MA,97,4,36471766,Africa,1545,111
2020-04-13,Morocco,MA,116,7,36471766,Africa,1661,118
2020-04-14,Morocco,MA,102,8,36471766,Africa,1763,126
2020-04-15,Morocco,MA,125,0,36471766,Africa,1888,126
2020-04-16,Morocco,MA,136,1,36471766,Africa,2024,127
2020-04-17,Morocco,MA,259,3,36471766,Africa,2283,130
2020-04-18,Morocco,MA,281,5,36471766,Africa,2564,135
2020-04-19,Morocco,MA,121,2,36471766,Africa,2685,137
2020-04-20,Morocco,MA,170,4,36471766,Africa,2855,141
2020-04-21,Morocco,MA,191,2,36471766,Africa,3046,143
2020-04-22,Morocco,MA,163,2,36471766,Africa,3209,145
2020-04-23,Morocco,MA,168,4,36471766,Africa,3377,149
2020-04-24,Morocco,MA,191,6,36471766,Africa,3568,155
2020-04-25,Morocco,MA,190,3,36471766,Africa,3758,158
2020-04-26,Morocco,MA,139,1,36471766,Africa,3897,159
2020-04-27,Morocco,MA,168,2,36471766,Africa,4065,161
2020-04-28,Morocco,MA,55,1,36471766,Africa,4120,162
2020-04-29,Morocco,MA,132,3,36471766,Africa,4252,165
2020-04-30,Morocco,MA,69,3,36471766,Africa,4321,168
2020-05-01,Morocco,MA,102,2,36471766,Africa,4423,170
2020-05-02,Morocco,MA,146,1,36471766,Africa,4569,171
2020-05-03,Morocco,MA,160,2,36471766,Africa,4729,173
2020-05-04,Morocco,MA,174,1,36471766,Africa,4903,174
2020-05-05,Morocco,MA,140,5,36471766,Africa,5043,179
2020-05-06,Morocco,MA,176,2,36471766,Africa,5219,181
2020-05-07,Morocco,MA,189,2,36471766,Africa,5408,183
2020-05-08,Morocco,MA,140,0,36471766,Africa,5548,183
2020-05-09,Morocco,MA,163,3,36471766,Africa,5711,186
2020-05-10,Morocco,MA,199,0,36471766,Africa,5910,186
2020-05-11,Morocco,MA,153,2,36471766,Africa,6063,188
2020-05-12,Morocco,MA,218,0,36471766,Africa,6281,188
2020-05-13,Morocco,MA,137,0,36471766,Africa,6418,188
2020-05-14,Morocco,MA,94,0,36471766,Africa,6512,188
2020-05-15,Morocco,MA,95,2,36471766,Africa,6607,190
2020-05-16,Morocco,MA,45,0,36471766,Africa,6652,190
2020-05-17,Morocco,MA,89,2,36471766,Africa,6741,192
2020-05-18,Morocco,MA,129,0,36471766,Africa,6870,192
2020-05-19,Morocco,MA,82,0,36471766,Africa,6952,192
2020-05-20,Morocco,MA,71,1,36471766,Africa,7023,193
2020-05-21,Morocco,MA,110,1,36471766,Africa,7133,194
2020-05-22,Morocco,MA,78,2,36471766,Africa,7211,196
2020-05-23,Morocco,MA,121,1,36471766,Africa,7332,197
2020-05-24,Morocco,MA,74,1,36471766,Africa,7406,198
2020-05-25,Morocco,MA,27,1,36471766,Africa,7433,199
2020-05-26,Morocco,MA,99,1,36471766,Africa,7532,200
2020-05-27,Morocco,MA,45,2,36471766,Africa,7577,202
2020-05-28,Morocco,MA,24,0,36471766,Africa,7601,202
2020-05-29,Morocco,MA,42,0,36471766,Africa,7643,202
2020-05-30,Morocco,MA,71,0,36471766,Africa,7714,202
2020-05-31,Morocco,MA,66,2,36471766,Africa,7780,204
2020-06-01,Morocco,MA,27,1,36471766,Africa,7807,205
2020-06-02,Morocco,MA,26,0,36471766,Africa,7833,205
2020-06-03,Morocco,MA,33,1,36471766,Africa,7866,206
2020-06-04,Morocco,MA,56,0,36471766,Africa,7922,206
2020-06-05,Morocco,MA,81,2,36471766,Africa,8003,208
2020-06-06,Morocco,MA,68,0,36471766,Africa,8071,208
2020-06-07,Morocco,MA,61,0,36471766,Africa,8132,208
2020-06-08,Morocco,MA,92,0,36471766,Africa,8224,208
2020-06-09,Morocco,MA,78,0,36471766,Africa,8302,208
2020-06-10,Morocco,MA,135,2,36471766,Africa,8437,210
2020-06-11,Morocco,MA,18,0,36471766,Africa,8455,210
2020-06-12,Morocco,MA,82,1,36471766,Africa,8537,211
2020-06-13,Morocco,MA,73,1,36471766,Africa,8610,212
2020-06-14,Morocco,MA,82,0,36471766,Africa,8692,212
2020-06-15,Morocco,MA,42,0,36471766,Africa,8734,212
2020-06-16,Morocco,MA,104,0,36471766,Africa,8838,212
2020-06-17,Morocco,MA,83,0,36471766,Africa,8921,212
2020-06-18,Morocco,MA,76,1,36471766,Africa,8997,213
2020-06-19,Morocco,MA,77,0,36471766,Africa,9074,213
2020-06-20,Morocco,MA,539,0,36471766,Africa,9613,213
2020-06-21,Morocco,MA,188,0,36471766,Africa,9801,213
2020-06-22,Morocco,MA,176,1,36471766,Africa,9977,214
2020-06-23,Morocco,MA,195,0,36471766,Africa,10172,214
2020-06-24,Morocco,MA,92,0,36471766,Africa,10264,214
2020-06-25,Morocco,MA,643,2,36471766,Africa,10907,216
2020-06-26,Morocco,MA,431,1,36471766,Africa,11338,217
2020-06-27,Morocco,MA,295,1,36471766,Africa,11633,218
2020-06-28,Morocco,MA,244,2,36471766,Africa,11877,220
2020-06-29,Morocco,MA,175,1,36471766,Africa,12052,221
2020-06-30,Morocco,MA,238,4,36471766,Africa,12290,225
2020-07-01,Morocco,MA,243,3,36471766,Africa,12533,228
2020-07-02,Morocco,MA,103,0,36471766,Africa,12636,228
2020-07-03,Morocco,MA,333,1,36471766,Africa,12969,229
2020-07-04,Morocco,MA,319,1,36471766,Africa,13288,230
2020-07-05,Morocco,MA,534,2,36471766,Africa,13822,232
2020-07-06,Morocco,MA,393,3,36471766,Africa,14215,235
2020-07-07,Morocco,MA,114,0,36471766,Africa,14329,235
2020-07-08,Morocco,MA,0,0,36471766,Africa,14329,235
2020-07-09,Morocco,MA,442,7,36471766,Africa,14771,242
2020-07-10,Morocco,MA,178,0,36471766,Africa,14949,242
2020-07-11,Morocco,MA,379,1,36471766,Africa,15328,243
2020-07-12,Morocco,MA,214,2,36471766,Africa,15542,245
2020-07-13,Morocco,MA,203,5,36471766,Africa,15745,250
2020-07-14,Morocco,MA,191,5,36471766,Africa,15936,255
2020-07-15,Morocco,MA,161,2,36471766,Africa,16097,257
2020-07-16,Morocco,MA,165,2,36471766,Africa,16262,259
2020-07-17,Morocco,MA,162,1,36471766,Africa,16424,260
2020-07-18,Morocco,MA,302,4,36471766,Africa,16726,264
2020-07-19,Morocco,MA,289,5,36471766,Africa,17015,269
2020-07-20,Morocco,MA,221,4,36471766,Africa,17236,273
2020-07-21,Morocco,MA,326,3,36471766,Africa,17562,276
2020-07-22,Morocco,MA,180,4,36471766,Africa,17742,280
2020-07-23,Morocco,MA,220,5,36471766,Africa,17962,285
2020-07-24,Morocco,MA,302,7,36471766,Africa,18264,292
2020-07-25,Morocco,MA,570,7,36471766,Africa,18834,299
2020-07-26,Morocco,MA,811,6,36471766,Africa,19645,305
2020-07-27,Morocco,MA,633,8,36471766,Africa,20278,313
2020-07-28,Morocco,MA,609,3,36471766,Africa,20887,316
2020-07-29,Morocco,MA,500,11,36471766,Africa,21387,327
2020-07-30,Morocco,MA,826,7,36471766,Africa,22213,334
2020-07-31,Morocco,MA,1046,12,36471766,Africa,23259,346
2020-08-01,Morocco,MA,1063,7,36471766,Africa,24322,353
2020-08-02,Morocco,MA,693,14,36471766,Africa,25015,367
2020-08-03,Morocco,MA,522,15,36471766,Africa,25537,382
2020-08-04,Morocco,MA,659,19,36471766,Africa,26196,401
2020-08-05,Morocco,MA,1021,16,36471766,Africa,27217,417
2020-08-06,Morocco,MA,1283,18,36471766,Africa,28500,435
2020-08-07,Morocco,MA,1144,14,36471766,Africa,29644,449
2020-08-08,Morocco,MA,1018,12,36471766,Africa,30662,461
2020-08-09,Morocco,MA,1345,19,36471766,Africa,32007,480
2020-08-10,Morocco,MA,1230,18,36471766,Africa,33237,498
2020-08-11,Morocco,MA,826,18,36471766,Africa,34063,516
2020-08-12,Morocco,MA,1132,17,36471766,Africa,35195,533
2020-08-13,Morocco,MA,1499,23,36471766,Africa,36694,556
2020-08-14,Morocco,MA,1241,28,36471766,Africa,37935,584
2020-08-15,Morocco,MA,1306,27,36471766,Africa,39241,611
2020-08-16,Morocco,MA,1776,21,36471766,Africa,41017,632
2020-08-17,Morocco,MA,1472,26,36471766,Africa,42489,658
2020-08-18,Morocco,MA,1069,23,36471766,Africa,43558,681
2020-08-19,Morocco,MA,1245,33,36471766,Africa,44803,714
2020-08-20,Morocco,MA,1510,29,36471766,Africa,46313,743
2020-08-21,Morocco,MA,1325,32,36471766,Africa,47638,775
2020-08-22,Morocco,MA,1609,42,36471766,Africa,49247,817
2020-08-23,Morocco,MA,1565,41,36471766,Africa,50812,858
2020-08-24,Morocco,MA,1537,30,36471766,Africa,52349,888
2020-08-25,Morocco,MA,903,32,36471766,Africa,53252,920
2020-08-26,Morocco,MA,1276,35,36471766,Africa,54528,955
2020-08-27,Morocco,MA,1336,29,36471766,Africa,55864,984
2020-08-28,Morocco,MA,1221,27,36471766,Africa,57085,1011
2020-08-29,Morocco,MA,1404,41,36471766,Africa,58489,1052
2020-08-30,Morocco,MA,1567,26,36471766,Africa,60056,1078
2020-08-31,Morocco,MA,1343,33,36471766,Africa,61399,1111
2020-09-01,Morocco,MA,1191,30,36471766,Africa,62590,1141
2020-09-02,Morocco,MA,1191,43,36471766,Africa,63781,1184
2020-09-03,Morocco,MA,1672,32,36471766,Africa,65453,1216
2020-09-04,Morocco,MA,1402,37,36471766,Africa,66855,1253
2020-09-05,Morocco,MA,1750,39,36471766,Africa,68605,1292
2020-09-06,Morocco,MA,1555,37,36471766,Africa,70160,1329
2020-09-07,Morocco,MA,2234,32,36471766,Africa,72394,1361
2020-09-08,Morocco,MA,1386,33,36471766,Africa,73780,1394
2020-09-09,Morocco,MA,1941,33,36471766,Africa,75721,1427
2020-09-10,Morocco,MA,2157,26,36471766,Africa,77878,1453
2020-09-11,Morocco,MA,1889,38,36471766,Africa,79767,1491
2020-09-12,Morocco,MA,2430,33,36471766,Africa,82197,1524
2020-09-13,Morocco,MA,2238,29,36471766,Africa,84435,1553
2020-09-14,Morocco,MA,2251,25,36471766,Africa,86686,1578
2020-09-15,Morocco,MA,1517,36,36471766,Africa,88203,1614
2020-09-16,Morocco,MA,2121,34,36471766,Africa,90324,1648
2020-09-17,Morocco,MA,1692,38,36471766,Africa,92016,1686
2020-09-18,Morocco,MA,2488,28,36471766,Africa,94504,1714
2020-09-19,Morocco,MA,2760,41,36471766,Africa,97264,1755
2020-09-20,Morocco,MA,2552,40,36471766,Africa,99816,1795
2020-09-21,Morocco,MA,1927,35,36471766,Africa,101743,1830
2020-09-22,Morocco,MA,1376,25,36471766,Africa,103119,1855
2020-09-23,Morocco,MA,2227,34,36471766,Africa,105346,1889
2020-09-24,Morocco,MA,2397,29,36471766,Africa,107743,1918
2020-09-25,Morocco,MA,2356,38,36471766,Africa,110099,1956
2020-09-26,Morocco,MA,2423,42,36471766,Africa,112522,1998
2020-09-27,Morocco,MA,2719,43,36471766,Africa,115241,2041
2020-09-28,Morocco,MA,2444,28,36471766,Africa,117685,2069
2020-09-29,Morocco,MA,1422,44,36471766,Africa,119107,2113
2020-09-30,Morocco,MA,2076,39,36471766,Africa,121183,2152
2020-10-01,Morocco,MA,2470,42,36471766,Africa,123653,2194
2020-10-02,Morocco,MA,2391,35,36471766,Africa,126044,2229
2020-10-03,Morocco,MA,2521,34,36471766,Africa,128565,2263
2020-10-04,Morocco,MA,2663,30,36471766,Africa,131228,2293
2020-10-05,Morocco,MA,2044,37,36471766,Africa,133272,2330
2020-10-06,Morocco,MA,1423,39,36471766,Africa,134695,2369
2020-10-07,Morocco,MA,2553,41,36471766,Africa,137248,2410
2020-10-08,Morocco,MA,2776,29,36471766,Africa,140024,2439
2020-10-09,Morocco,MA,2929,47,36471766,Africa,142953,2486
2020-10-10,Morocco,MA,3445,44,36471766,Africa,146398,2530
2020-10-11,Morocco,MA,3443,42,36471766,Africa,149841,2572
2020-10-12,Morocco,MA,2563,33,36471766,Africa,152404,2605
2020-10-13,Morocco,MA,1357,31,36471766,Africa,153761,2636
2020-10-14,Morocco,MA,3185,49,36471766,Africa,156946,2685
2020-10-15,Morocco,MA,3387,41,36471766,Africa,160333,2726
2020-10-16,Morocco,MA,3317,46,36471766,Africa,163650,2772
2020-10-17,Morocco,MA,3498,46,36471766,Africa,167148,2818
2020-10-18,Morocco,MA,3763,60,36471766,Africa,170911,2878
2020-10-19,Morocco,MA,2721,50,36471766,Africa,173632,2928
2020-10-20,Morocco,MA,2117,48,36471766,Africa,175749,2976
2020-10-21,Morocco,MA,3254,51,36471766,Africa,179003,3027
2020-10-22,Morocco,MA,3577,70,36471766,Africa,182580,3097
2020-10-23,Morocco,MA,4151,35,36471766,Africa,186731,3132
2020-10-24,Morocco,MA,3685,73,36471766,Africa,190416,3205
2020-10-25,Morocco,MA,4045,50,36471766,Africa,194461,3255
2020-10-26,Morocco,MA,3020,46,36471766,Africa,197481,3301
2020-10-27,Morocco,MA,2264,72,36471766,Africa,199745,3373
2020-10-28,Morocco,MA,3988,72,36471766,Africa,203733,3445
2020-10-29,Morocco,MA,3985,61,36471766,Africa,207718,3506
2020-10-30,Morocco,MA,4320,66,36471766,Africa,212038,3572
2020-10-31,Morocco,MA,3256,53,36471766,Africa,215294,3625
2020-11-01,Morocco,MA,3790,70,36471766,Africa,219084,3695
2020-11-02,Morocco,MA,3460,67,36471766,Africa,222544,3762
2020-11-03,Morocco,MA,2526,64,36471766,Africa,225070,3826
2020-11-04,Morocco,MA,4495,74,36471766,Africa,229565,3900
2020-11-05,Morocco,MA,5745,82,36471766,Africa,235310,3982
2020-11-06,Morocco,MA,5641,77,36471766,Africa,240951,4059
2020-11-07,Morocco,MA,5398,68,36471766,Africa,246349,4127
2020-11-08,Morocco,MA,5836,70,36471766,Africa,252185,4197
2020-11-09,Morocco,MA,4596,75,36471766,Africa,256781,4272
2020-11-10,Morocco,MA,3170,84,36471766,Africa,259951,4356
2020-11-11,Morocco,MA,5214,69,36471766,Africa,265165,4425
2020-11-12,Morocco,MA,5461,81,36471766,Africa,270626,4506
2020-11-13,Morocco,MA,6195,64,36471766,Africa,276821,4570
2020-11-14,Morocco,MA,5515,61,36471766,Africa,282336,4631
2020-11-15,Morocco,MA,5875,66,36471766,Africa,288211,4697
2020-11-16,Morocco,MA,4966,82,36471766,Africa,293177,4779
2020-11-17,Morocco,MA,3012,71,36471766,Africa,296189,4850
2020-11-18,Morocco,MA,5415,82,36471766,Africa,301604,4932
2020-11-19,Morocco,MA,5391,81,36471766,Africa,306995,5013
2020-11-20,Morocco,MA,4559,77,36471766,Africa,311554,5090
2020-11-21,Morocco,MA,4706,92,36471766,Africa,316260,5182
2020-11-22,Morocco,MA,4702,74,36471766,Africa,320962,5256
2020-11-23,Morocco,MA,0,0,36471766,Africa,320962,5256
2020-11-24,Morocco,MA,6566,140,36471766,Africa,327528,5396
2020-11-25,Morocco,MA,3999,73,36471766,Africa,331527,5469
2020-11-26,Morocco,MA,4979,70,36471766,Africa,336506,5539
2020-11-27,Morocco,MA,4178,80,36471766,Africa,340684,5619
2020-11-28,Morocco,MA,4592,70,36471766,Africa,345276,5689
2020-11-29,Morocco,MA,4412,50,36471766,Africa,349688,5739
2020-11-30,Morocco,MA,4115,50,36471766,Africa,353803,5789
2020-12-01,Morocco,MA,2533,57,36471766,Africa,356336,5846
2020-12-02,Morocco,MA,3508,69,36471766,Africa,359844,5915
2020-12-03,Morocco,MA,4346,70,36471766,Africa,364190,5985
2020-12-04,Morocco,MA,4434,78,36471766,Africa,368624,6063
2020-12-05,Morocco,MA,3996,73,36471766,Africa,372620,6136
2020-12-06,Morocco,MA,4118,48,36471766,Africa,376738,6184
2020-12-07,Morocco,MA,2919,61,36471766,Africa,379657,6245
2020-12-08,Morocco,MA,1531,75,36471766,Africa,381188,6320
2020-12-09,Morocco,MA,2900,50,36471766,Africa,384088,6370
2020-12-10,Morocco,MA,4096,57,36471766,Africa,388184,6427
2020-12-11,Morocco,MA,3345,65,36471766,Africa,391529,6492
2020-12-12,Morocco,MA,3035,50,36471766,Africa,394564,6542
2020-12-13,Morocco,MA,3033,47,36471766,Africa,397597,6589
2020-12-14,Morocco,MA,2012,35,36471766,Africa,399609,6624
2019-12-31,Monaco,MC,0,0,33085,Europe,0,0
2020-01-01,Monaco,MC,0,0,33085,Europe,0,0
2020-01-02,Monaco,MC,0,0,33085,Europe,0,0
2020-01-03,Monaco,MC,0,0,33085,Europe,0,0
2020-01-04,Monaco,MC,0,0,33085,Europe,0,0
2020-01-05,Monaco,MC,0,0,33085,Europe,0,0
2020-01-06,Monaco,MC,0,0,33085,Europe,0,0
2020-01-07,Monaco,MC,0,0,33085,Europe,0,0
2020-01-08,Monaco,MC,0,0,33085,Europe,0,0
2020-01-09,Monaco,MC,0,0,33085,Europe,0,0
2020-01-10,Monaco,MC,0,0,33085,Europe,0,0
2020-01-11,Monaco,MC,0,0,33085,Europe,0,0
2020-01-12,Monaco,MC,0,0,33085,Europe,0,0
2020-01-13,Monaco,MC,0,0,33085,Europe,0,0
2020-01-14,Monaco,MC,0,0,33085,Europe,0,0
2020-01-15,Monaco,MC,0,0,33085,Europe,0,0
2020-01-16,Monaco,MC,0,0,33085,Europe,0,0
2020-01-17,Monaco,MC,0,0,33085,Europe,0,0
2020-01-18,Monaco,MC,0,0,33085,Europe,0,0
2020-01-19,Monaco,MC,0,0,33085,Europe,0,0
2020-01-20,Monaco,MC,0,0,33085,Europe,0,0
2020-01-21,Monaco,MC,0,0,33085,Europe,0,0
2020-01-22,Monaco,MC,0,0,33085,Europe,0,0
2020-01-23,Monaco,MC,0,0,33085,Europe,0,0
2020-01-24,Monaco,MC,0,0,33085,Europe,0,0
2020-01-25,Monaco,MC,0,0,33085,Europe,0,0
2020-01-26,Monaco,MC,0,0,33085,Europe,0,0
2020-01-27,Monaco,MC,0,0,33085,Europe,0,0
2020-01-28,Monaco,MC,0,0,33085,Europe,0,0
2020-01-29,Monaco,MC,0,0,33085,Europe,0,0
2020-01-30,Monaco,MC,0,0,33085,Europe,0,0
2020-01-31,Monaco,MC,0,0,33085,Europe,0,0
2020-02-01,Monaco,MC,0,0,33085,Europe,0,0
2020-02-02,Monaco,MC,0,0,33085,Europe,0,0
2020-02-03,Monaco,MC,0,0,33085,Europe,0,0
2020-02-04,Monaco,MC,0,0,33085,Europe,0,0
2020-02-05,Monaco,MC,0,0,33085,Europe,0,0
2020-02-06,Monaco,MC,0,0,33085,Europe,0,0
2020-02-07,Monaco,MC,0,0,33085,Europe,0,0
2020-02-08,Monaco,MC,0,0,33085,Europe,0,0
2020-02-09,Monaco,MC,0,0,33085,Europe,0,0
2020-02-10,Monaco,MC,0,0,33085,Europe,0,0
2020-02-11,Monaco,MC,0,0,33085,Europe,0,0
2020-02-12,Monaco,MC,0,0,33085,Europe,0,0
2020-02-13,Monaco,MC,0,0,33085,Europe,0,0
2020-02-14,Monaco,MC,0,0,33085,Europe,0,0
2020-02-15,Monaco,MC,0,0,33085,Europe,0,0
2020-02-16,Monaco,MC,0,0,33085,Europe,0,0
2020-02-17,Monaco,MC,0,0,33085,Europe,0,0
2020-02-18,Monaco,MC,0,0,33085,Europe,0,0
2020-02-19,Monaco,MC,0,0,33085,Europe,0,0
2020-02-20,Monaco,MC,0,0,33085,Europe,0,0
2020-02-21,Monaco,MC,0,0,33085,Europe,0,0
2020-02-22,Monaco,MC,0,0,33085,Europe,0,0
2020-02-23,Monaco,MC,0,0,33085,Europe,0,0
2020-02-24,Monaco,MC,0,0,33085,Europe,0,0
2020-02-25,Monaco,MC,0,0,33085,Europe,0,0
2020-02-26,Monaco,MC,0,0,33085,Europe,0,0
2020-02-27,Monaco,MC,0,0,33085,Europe,0,0
2020-02-28,Monaco,MC,0,0,33085,Europe,0,0
2020-02-29,Monaco,MC,1,0,33085,Europe,1,0
2020-03-01,Monaco,MC,0,0,33085,Europe,1,0
2020-03-02,Monaco,MC,0,0,33085,Europe,1,0
2020-03-15,Monaco,MC,6,0,33085,Europe,7,0
2020-03-16,Monaco,MC,2,0,33085,Europe,9,0
2020-03-17,Monaco,MC,0,0,33085,Europe,9,0
2020-03-18,Monaco,MC,0,0,33085,Europe,9,0
2020-03-19,Monaco,MC,0,0,33085,Europe,9,0
2020-03-20,Monaco,MC,3,0,33085,Europe,12,0
2020-03-21,Monaco,MC,6,0,33085,Europe,18,0
2020-03-22,Monaco,MC,0,0,33085,Europe,18,0
2020-03-23,Monaco,MC,2,0,33085,Europe,20,0
2020-03-24,Monaco,MC,2,0,33085,Europe,22,0
2020-03-25,Monaco,MC,1,0,33085,Europe,23,0
2020-03-26,Monaco,MC,0,0,33085,Europe,23,0
2020-03-27,Monaco,MC,3,0,33085,Europe,26,0
2020-03-28,Monaco,MC,6,0,33085,Europe,32,0
2020-03-29,Monaco,MC,1,0,33085,Europe,33,0
2020-03-30,Monaco,MC,2,0,33085,Europe,35,0
2020-03-31,Monaco,MC,1,0,33085,Europe,36,0
2020-04-01,Monaco,MC,1,0,33085,Europe,37,0
2020-04-02,Monaco,MC,3,0,33085,Europe,40,0
2020-04-03,Monaco,MC,3,0,33085,Europe,43,0
2020-04-04,Monaco,MC,4,0,33085,Europe,47,0
2020-04-05,Monaco,MC,1,0,33085,Europe,48,0
2020-04-06,Monaco,MC,3,0,33085,Europe,51,0
2020-04-07,Monaco,MC,1,0,33085,Europe,52,0
2020-04-08,Monaco,MC,2,0,33085,Europe,54,0
2020-04-09,Monaco,MC,0,0,33085,Europe,54,0
2020-04-10,Monaco,MC,3,0,33085,Europe,57,0
2020-04-11,Monaco,MC,6,1,33085,Europe,63,1
2020-04-12,Monaco,MC,0,0,33085,Europe,63,1
2020-04-13,Monaco,MC,1,0,33085,Europe,64,1
2020-04-14,Monaco,MC,0,0,33085,Europe,64,1
2020-04-15,Monaco,MC,0,0,33085,Europe,64,1
2020-04-16,Monaco,MC,0,0,33085,Europe,64,1
2020-04-17,Monaco,MC,0,0,33085,Europe,64,1
2020-04-18,Monaco,MC,1,0,33085,Europe,65,1
2020-04-19,Monaco,MC,0,0,33085,Europe,65,1
2020-04-20,Monaco,MC,0,0,33085,Europe,65,1
2020-04-21,Monaco,MC,0,0,33085,Europe,65,1
2020-04-22,Monaco,MC,0,0,33085,Europe,65,1
2020-04-23,Monaco,MC,0,0,33085,Europe,65,1
2020-04-24,Monaco,MC,0,0,33085,Europe,65,1
2020-04-25,Monaco,MC,0,0,33085,Europe,65,1
2020-04-26,Monaco,MC,0,0,33085,Europe,65,1
2020-04-27,Monaco,MC,0,0,33085,Europe,65,1
2020-04-28,Monaco,MC,1,0,33085,Europe,66,1
2020-04-29,Monaco,MC,0,0,33085,Europe,66,1
2020-04-30,Monaco,MC,0,0,33085,Europe,66,1
2020-05-01,Monaco,MC,0,0,33085,Europe,66,1
2020-05-02,Monaco,MC,0,0,33085,Europe,66,1
2020-05-03,Monaco,MC,0,0,33085,Europe,66,1
2020-05-04,Monaco,MC,0,0,33085,Europe,66,1
2020-05-05,Monaco,MC,0,0,33085,Europe,66,1
2020-05-06,Monaco,MC,0,0,33085,Europe,66,1
2020-05-07,Monaco,MC,0,0,33085,Europe,66,1
2020-05-08,Monaco,MC,0,0,33085,Europe,66,1
2020-05-09,Monaco,MC,0,0,33085,Europe,66,1
2020-05-10,Monaco,MC,0,0,33085,Europe,66,1
2020-05-11,Monaco,MC,0,0,33085,Europe,66,1
2020-05-12,Monaco,MC,0,0,33085,Europe,66,1
2020-05-13,Monaco,MC,0,0,33085,Europe,66,1
2020-05-14,Monaco,MC,0,0,33085,Europe,66,1
2020-05-15,Monaco,MC,0,0,33085,Europe,66,1
2020-05-16,Monaco,MC,0,0,33085,Europe,66,1
2020-05-17,Monaco,MC,0,0,33085,Europe,66,1
2020-05-18,Monaco,MC,0,0,33085,Europe,66,1
2020-05-19,Monaco,MC,1,0,33085,Europe,67,1
2020-05-20,Monaco,MC,0,0,33085,Europe,67,1
2020-05-21,Monaco,MC,0,0,33085,Europe,67,1
2020-05-22,Monaco,MC,0,0,33085,Europe,67,1
2020-05-23,Monaco,MC,0,0,33085,Europe,67,1
2020-05-24,Monaco,MC,0,0,33085,Europe,67,1
2020-05-25,Monaco,MC,0,0,33085,Europe,67,1
2020-05-26,Monaco,MC,0,0,33085,Europe,67,1
2020-05-27,Monaco,MC,0,0,33085,Europe,67,1
2020-05-28,Monaco,MC,0,0,33085,Europe,67,1
2020-05-29,Monaco,MC,0,0,33085,Europe,67,1
2020-05-30,Monaco,MC,0,0,33085,Europe,67,1
2020-05-31,Monaco,MC,0,0,33085,Europe,67,1
2020-06-01,Monaco,MC,0,0,33085,Europe,67,1
2020-06-02,Monaco,MC,0,0,33085,Europe,67,1
2020-06-03,Monaco,MC,0,0,33085,Europe,67,1
2020-06-04,Monaco,MC,0,0,33085,Europe,67,1
2020-06-05,Monaco,MC,0,0,33085,Europe,67,1
2020-06-06,Monaco,MC,0,0,33085,Europe,67,1
2020-06-07,Monaco,MC,0,0,33085,Europe,67,1
2020-06-08,Monaco,MC,0,0,33085,Europe,67,1
2020-06-09,Monaco,MC,0,0,33085,Europe,67,1
2020-06-10,Monaco,MC,0,0,33085,Europe,67,1
2020-06-11,Monaco,MC,0,0,33085,Europe,67,1
2020-06-12,Monaco,MC,0,0,33085,Europe,67,1
2020-06-13,Monaco,MC,0,0,33085,Europe,67,1
2020-06-14,Monaco,MC,0,0,33085,Europe,67,1
2020-06-15,Monaco,MC,0,0,33085,Europe,67,1
2020-06-16,Monaco,MC,0,0,33085,Europe,67,1
2020-06-17,Monaco,MC,0,0,33085,Europe,67,1
2020-06-18,Monaco,MC,0,0,33085,Europe,67,1
2020-06-19,Monaco,MC,0,0,33085,Europe,67,1
2020-06-20,Monaco,MC,0,0,33085,Europe,67,1
2020-06-21,Monaco,MC,0,0,33085,Europe,67,1
2020-06-22,Monaco,MC,1,0,33085,Europe,68,1
2020-06-23,Monaco,MC,0,0,33085,Europe,68,1
2020-06-24,Monaco,MC,0,0,33085,Europe,68,1
2020-06-25,Monaco,MC,1,0,33085,Europe,69,1
2020-06-26,Monaco,MC,0,0,33085,Europe,69,1
2020-06-27,Monaco,MC,0,0,33085,Europe,69,1
2020-06-28,Monaco,MC,1,0,33085,Europe,70,1
2020-06-29,Monaco,MC,0,0,33085,Europe,70,1
2020-06-30,Monaco,MC,0,0,33085,Europe,70,1
2020-07-01,Monaco,MC,0,0,33085,Europe,70,1
2020-07-02,Monaco,MC,0,0,33085,Europe,70,1
2020-07-03,Monaco,MC,3,0,33085,Europe,73,1
2020-07-04,Monaco,MC,0,0,33085,Europe,73,1
2020-07-05,Monaco,MC,0,0,33085,Europe,73,1
2020-07-06,Monaco,MC,2,0,33085,Europe,75,1
2020-07-07,Monaco,MC,0,0,33085,Europe,75,1
2020-07-08,Monaco,MC,0,0,33085,Europe,75,1
2020-07-09,Monaco,MC,0,0,33085,Europe,75,1
2020-07-10,Monaco,MC,0,0,33085,Europe,75,1
2020-07-11,Monaco,MC,0,0,33085,Europe,75,1
2020-07-12,Monaco,MC,1,0,33085,Europe,76,1
2020-07-13,Monaco,MC,0,0,33085,Europe,76,1
2020-07-14,Monaco,MC,0,0,33085,Europe,76,1
2020-07-15,Monaco,MC,0,0,33085,Europe,76,1
2020-07-16,Monaco,MC,0,0,33085,Europe,76,1
2020-07-17,Monaco,MC,0,0,33085,Europe,76,1
2020-07-18,Monaco,MC,0,0,33085,Europe,76,1
2020-07-19,Monaco,MC,0,0,33085,Europe,76,1
2020-07-20,Monaco,MC,0,0,33085,Europe,76,1
2020-07-21,Monaco,MC,0,0,33085,Europe,76,1
2020-07-22,Monaco,MC,2,0,33085,Europe,78,1
2020-07-23,Monaco,MC,1,0,33085,Europe,79,1
2020-07-24,Monaco,MC,1,0,33085,Europe,80,1
2020-07-25,Monaco,MC,1,0,33085,Europe,81,1
2020-07-26,Monaco,MC,0,0,33085,Europe,81,1
2020-07-27,Monaco,MC,0,0,33085,Europe,81,1
2020-07-28,Monaco,MC,0,0,33085,Europe,81,1
2020-07-29,Monaco,MC,1,0,33085,Europe,82,1
2020-07-30,Monaco,MC,2,0,33085,Europe,84,1
2020-07-31,Monaco,MC,0,0,33085,Europe,84,1
2020-08-01,Monaco,MC,0,0,33085,Europe,84,1
2020-08-02,Monaco,MC,0,0,33085,Europe,84,1
2020-08-03,Monaco,MC,0,0,33085,Europe,84,1
2020-08-04,Monaco,MC,1,0,33085,Europe,85,1
2020-08-05,Monaco,MC,2,0,33085,Europe,87,1
2020-08-06,Monaco,MC,3,0,33085,Europe,90,1
2020-08-07,Monaco,MC,1,0,33085,Europe,91,1
2020-08-08,Monaco,MC,2,0,33085,Europe,93,1
2020-08-09,Monaco,MC,1,0,33085,Europe,94,1
2020-08-10,Monaco,MC,0,0,33085,Europe,94,1
2020-08-11,Monaco,MC,0,0,33085,Europe,94,1
2020-08-12,Monaco,MC,1,0,33085,Europe,95,1
2020-08-13,Monaco,MC,2,0,33085,Europe,97,1
2020-08-14,Monaco,MC,2,0,33085,Europe,99,1
2020-08-15,Monaco,MC,0,0,33085,Europe,99,1
2020-08-16,Monaco,MC,0,0,33085,Europe,99,1
2020-08-17,Monaco,MC,0,0,33085,Europe,99,1
2020-08-18,Monaco,MC,1,0,33085,Europe,100,1
2020-08-19,Monaco,MC,0,0,33085,Europe,100,1
2020-08-20,Monaco,MC,0,0,33085,Europe,100,1
2020-08-21,Monaco,MC,2,0,33085,Europe,102,1
2020-08-22,Monaco,MC,4,0,33085,Europe,106,1
2020-08-23,Monaco,MC,2,0,33085,Europe,108,1
2020-08-24,Monaco,MC,3,0,33085,Europe,111,1
2020-08-25,Monaco,MC,4,0,33085,Europe,115,1
2020-08-26,Monaco,MC,6,0,33085,Europe,121,1
2020-08-27,Monaco,MC,1,0,33085,Europe,122,1
2020-08-28,Monaco,MC,3,0,33085,Europe,125,1
2020-08-29,Monaco,MC,0,0,33085,Europe,125,1
2020-08-30,Monaco,MC,5,0,33085,Europe,130,1
2020-08-31,Monaco,MC,1,0,33085,Europe,131,1
2020-09-01,Monaco,MC,7,0,33085,Europe,138,1
2020-09-02,Monaco,MC,2,0,33085,Europe,140,1
2020-09-03,Monaco,MC,2,0,33085,Europe,142,1
2020-09-04,Monaco,MC,1,0,33085,Europe,143,1
2020-09-05,Monaco,MC,4,0,33085,Europe,147,1
2020-09-06,Monaco,MC,0,0,33085,Europe,147,1
2020-09-07,Monaco,MC,1,0,33085,Europe,148,1
2020-09-08,Monaco,MC,5,0,33085,Europe,153,1
2020-09-09,Monaco,MC,3,0,33085,Europe,156,1
2020-09-10,Monaco,MC,5,0,33085,Europe,161,1
2020-09-11,Monaco,MC,4,0,33085,Europe,165,1
2020-09-12,Monaco,MC,3,0,33085,Europe,168,1
2020-09-13,Monaco,MC,1,0,33085,Europe,169,1
2020-09-14,Monaco,MC,2,0,33085,Europe,171,1
2020-09-15,Monaco,MC,6,0,33085,Europe,177,1
2020-09-16,Monaco,MC,1,0,33085,Europe,178,1
2020-09-17,Monaco,MC,3,0,33085,Europe,181,1
2020-09-18,Monaco,MC,5,0,33085,Europe,186,1
2020-09-19,Monaco,MC,5,0,33085,Europe,191,1
2020-09-20,Monaco,MC,1,0,33085,Europe,192,1
2020-09-21,Monaco,MC,1,0,33085,Europe,193,1
2020-09-22,Monaco,MC,2,0,33085,Europe,195,1
2020-09-23,Monaco,MC,2,0,33085,Europe,197,1
2020-09-24,Monaco,MC,2,0,33085,Europe,199,1
2020-09-25,Monaco,MC,6,0,33085,Europe,205,1
2020-09-26,Monaco,MC,3,0,33085,Europe,208,1
2020-09-27,Monaco,MC,2,0,33085,Europe,210,1
2020-09-28,Monaco,MC,0,0,33085,Europe,210,1
2020-09-29,Monaco,MC,2,0,33085,Europe,212,1
2020-09-30,Monaco,MC,2,0,33085,Europe,214,1
2020-10-01,Monaco,MC,4,0,33085,Europe,218,1
2020-10-02,Monaco,MC,1,0,33085,Europe,219,1
2020-10-03,Monaco,MC,2,0,33085,Europe,221,1
2020-10-04,Monaco,MC,1,0,33085,Europe,222,1
2020-10-05,Monaco,MC,0,0,33085,Europe,222,1
2020-10-06,Monaco,MC,1,0,33085,Europe,223,1
2020-10-07,Monaco,MC,1,0,33085,Europe,224,1
2020-10-08,Monaco,MC,3,0,33085,Europe,227,1
2020-10-09,Monaco,MC,2,0,33085,Europe,229,1
2020-10-10,Monaco,MC,4,0,33085,Europe,233,1
2020-10-11,Monaco,MC,0,0,33085,Europe,233,1
2020-10-12,Monaco,MC,1,0,33085,Europe,234,1
2020-10-13,Monaco,MC,2,0,33085,Europe,236,1
2020-10-14,Monaco,MC,5,0,33085,Europe,241,1
2020-10-15,Monaco,MC,7,0,33085,Europe,248,1
2020-10-16,Monaco,MC,5,0,33085,Europe,253,1
2020-10-17,Monaco,MC,2,0,33085,Europe,255,1
2020-10-18,Monaco,MC,5,0,33085,Europe,260,1
2020-10-19,Monaco,MC,5,0,33085,Europe,265,1
2020-10-20,Monaco,MC,3,0,33085,Europe,268,1
2020-10-21,Monaco,MC,3,0,33085,Europe,271,1
2020-10-22,Monaco,MC,2,0,33085,Europe,273,1
2020-10-23,Monaco,MC,8,0,33085,Europe,281,1
2020-10-24,Monaco,MC,14,0,33085,Europe,295,1
2020-10-25,Monaco,MC,1,0,33085,Europe,296,1
2020-10-26,Monaco,MC,10,0,33085,Europe,306,1
2020-10-27,Monaco,MC,4,0,33085,Europe,310,1
2020-10-28,Monaco,MC,10,0,33085,Europe,320,1
2020-10-29,Monaco,MC,17,0,33085,Europe,337,1
2020-10-30,Monaco,MC,10,0,33085,Europe,347,1
2020-10-31,Monaco,MC,8,0,33085,Europe,355,1
2020-11-01,Monaco,MC,4,0,33085,Europe,359,1
2020-11-02,Monaco,MC,7,0,33085,Europe,366,1
2020-11-03,Monaco,MC,9,0,33085,Europe,375,1
2020-11-04,Monaco,MC,22,0,33085,Europe,397,1
2020-11-05,Monaco,MC,15,0,33085,Europe,412,1
2020-11-06,Monaco,MC,18,0,33085,Europe,430,1
2020-11-07,Monaco,MC,24,0,33085,Europe,454,1
2020-11-08,Monaco,MC,29,0,33085,Europe,483,1
2020-11-09,Monaco,MC,3,0,33085,Europe,486,1
2020-11-10,Monaco,MC,4,0,33085,Europe,490,1
2020-11-11,Monaco,MC,22,0,33085,Europe,512,1
2020-11-12,Monaco,MC,12,0,33085,Europe,524,1
2020-11-13,Monaco,MC,8,0,33085,Europe,532,1
2020-11-14,Monaco,MC,8,0,33085,Europe,540,1
2020-11-15,Monaco,MC,5,0,33085,Europe,545,1
2020-11-16,Monaco,MC,3,0,33085,Europe,548,1
2020-11-17,Monaco,MC,4,0,33085,Europe,552,1
2020-11-18,Monaco,MC,5,1,33085,Europe,557,2
2020-11-19,Monaco,MC,8,0,33085,Europe,565,2
2020-11-20,Monaco,MC,8,0,33085,Europe,573,2
2020-11-21,Monaco,MC,4,0,33085,Europe,577,2
2020-11-22,Monaco,MC,4,0,33085,Europe,581,2
2020-11-23,Monaco,MC,1,0,33085,Europe,582,2
2020-11-24,Monaco,MC,1,0,33085,Europe,583,2
2020-11-25,Monaco,MC,4,0,33085,Europe,587,2
2020-11-26,Monaco,MC,7,0,33085,Europe,594,2
2020-11-27,Monaco,MC,6,0,33085,Europe,600,2
2020-11-28,Monaco,MC,3,0,33085,Europe,603,2
2020-11-29,Monaco,MC,4,0,33085,Europe,607,2
2020-11-30,Monaco,MC,1,0,33085,Europe,608,2
2020-12-01,Monaco,MC,1,0,33085,Europe,609,2
2020-12-02,Monaco,MC,8,0,33085,Europe,617,2
2020-12-03,Monaco,MC,4,0,33085,Europe,621,2
2020-12-04,Monaco,MC,9,0,33085,Europe,630,2
2020-12-05,Monaco,MC,0,0,33085,Europe,630,2
2020-12-06,Monaco,MC,7,0,33085,Europe,637,2
2020-12-07,Monaco,MC,1,0,33085,Europe,638,2
2020-12-08,Monaco,MC,3,0,33085,Europe,641,2
2020-12-09,Monaco,MC,7,0,33085,Europe,648,2
2020-12-10,Monaco,MC,7,0,33085,Europe,655,2
2020-12-11,Monaco,MC,2,0,33085,Europe,657,2
2020-12-12,Monaco,MC,2,0,33085,Europe,659,2
2020-12-13,Monaco,MC,9,0,33085,Europe,668,2
2020-12-14,Monaco,MC,0,0,33085,Europe,668,2
2020-03-08,Moldova,MD,1,0,4043258,Europe,1,0
2020-03-11,Moldova,MD,2,0,4043258,Europe,3,0
2020-03-12,Moldova,MD,1,0,4043258,Europe,4,0
2020-03-13,Moldova,MD,2,0,4043258,Europe,6,0
2020-03-14,Moldova,MD,2,0,4043258,Europe,8,0
2020-03-15,Moldova,MD,12,0,4043258,Europe,20,0
2020-03-16,Moldova,MD,3,0,4043258,Europe,23,0
2020-03-17,Moldova,MD,6,0,4043258,Europe,29,0
2020-03-18,Moldova,MD,1,0,4043258,Europe,30,0
2020-03-19,Moldova,MD,6,1,4043258,Europe,36,1
2020-03-20,Moldova,MD,13,0,4043258,Europe,49,1
2020-03-21,Moldova,MD,17,0,4043258,Europe,66,1
2020-03-22,Moldova,MD,14,0,4043258,Europe,80,1
2020-03-23,Moldova,MD,14,0,4043258,Europe,94,1
2020-03-24,Moldova,MD,15,0,4043258,Europe,109,1
2020-03-25,Moldova,MD,16,0,4043258,Europe,125,1
2020-03-26,Moldova,MD,24,0,4043258,Europe,149,1
2020-03-27,Moldova,MD,28,0,4043258,Europe,177,1
2020-03-28,Moldova,MD,22,1,4043258,Europe,199,2
2020-03-29,Moldova,MD,32,0,4043258,Europe,231,2
2020-03-30,Moldova,MD,32,0,4043258,Europe,263,2
2020-03-31,Moldova,MD,35,0,4043258,Europe,298,2
2020-04-01,Moldova,MD,55,2,4043258,Europe,353,4
2020-04-02,Moldova,MD,70,1,4043258,Europe,423,5
2020-04-03,Moldova,MD,82,1,4043258,Europe,505,6
2020-04-04,Moldova,MD,86,2,4043258,Europe,591,8
2020-04-05,Moldova,MD,161,4,4043258,Europe,752,12
2020-04-06,Moldova,MD,112,3,4043258,Europe,864,15
2020-04-07,Moldova,MD,101,4,4043258,Europe,965,19
2020-04-08,Moldova,MD,91,3,4043258,Europe,1056,22
2020-04-09,Moldova,MD,118,5,4043258,Europe,1174,27
2020-04-10,Moldova,MD,115,2,4043258,Europe,1289,29
2020-04-11,Moldova,MD,149,0,4043258,Europe,1438,29
2020-04-12,Moldova,MD,122,1,4043258,Europe,1560,30
2020-04-13,Moldova,MD,102,2,4043258,Europe,1662,32
2020-04-14,Moldova,MD,50,4,4043258,Europe,1712,36
2020-04-15,Moldova,MD,222,4,4043258,Europe,1934,40
2020-04-16,Moldova,MD,115,6,4043258,Europe,2049,46
2020-04-17,Moldova,MD,105,8,4043258,Europe,2154,54
2020-04-18,Moldova,MD,110,2,4043258,Europe,2264,56
2020-04-19,Moldova,MD,87,4,4043258,Europe,2351,60
2020-04-20,Moldova,MD,121,7,4043258,Europe,2472,67
2020-04-21,Moldova,MD,76,3,4043258,Europe,2548,70
2020-04-22,Moldova,MD,66,3,4043258,Europe,2614,73
2020-04-23,Moldova,MD,164,3,4043258,Europe,2778,76
2020-04-24,Moldova,MD,148,4,4043258,Europe,2926,80
2020-04-25,Moldova,MD,184,7,4043258,Europe,3110,87
2020-04-26,Moldova,MD,194,7,4043258,Europe,3304,94
2020-04-27,Moldova,MD,104,2,4043258,Europe,3408,96
2020-04-28,Moldova,MD,73,6,4043258,Europe,3481,102
2020-04-29,Moldova,MD,157,5,4043258,Europe,3638,107
2020-04-30,Moldova,MD,133,4,4043258,Europe,3771,111
2020-05-01,Moldova,MD,126,8,4043258,Europe,3897,119
2020-05-02,Moldova,MD,83,3,4043258,Europe,3980,122
2020-05-03,Moldova,MD,72,2,4043258,Europe,4052,124
2020-05-04,Moldova,MD,69,1,4043258,Europe,4121,125
2020-05-05,Moldova,MD,127,7,4043258,Europe,4248,132
2020-05-06,Moldova,MD,115,4,4043258,Europe,4363,136
2020-05-07,Moldova,MD,113,7,4043258,Europe,4476,143
2020-05-08,Moldova,MD,129,2,4043258,Europe,4605,145
2020-05-09,Moldova,MD,123,7,4043258,Europe,4728,152
2020-05-10,Moldova,MD,139,9,4043258,Europe,4867,161
2020-05-11,Moldova,MD,60,8,4043258,Europe,4927,169
2020-05-12,Moldova,MD,68,6,4043258,Europe,4995,175
2020-05-13,Moldova,MD,159,7,4043258,Europe,5154,182
2020-05-14,Moldova,MD,252,3,4043258,Europe,5406,185
2020-05-15,Moldova,MD,147,9,4043258,Europe,5553,194
2020-05-16,Moldova,MD,192,3,4043258,Europe,5745,197
2020-05-17,Moldova,MD,189,10,4043258,Europe,5934,207
2020-05-18,Moldova,MD,126,4,4043258,Europe,6060,211
2020-05-19,Moldova,MD,78,4,4043258,Europe,6138,215
2020-05-20,Moldova,MD,202,6,4043258,Europe,6340,221
2020-05-21,Moldova,MD,213,7,4043258,Europe,6553,228
2020-05-22,Moldova,MD,151,5,4043258,Europe,6704,233
2020-05-23,Moldova,MD,143,4,4043258,Europe,6847,237
2020-05-24,Moldova,MD,147,5,4043258,Europe,6994,242
2020-05-25,Moldova,MD,99,8,4043258,Europe,7093,250
2020-05-26,Moldova,MD,54,11,4043258,Europe,7147,261
2020-05-27,Moldova,MD,158,6,4043258,Europe,7305,267
2020-05-28,Moldova,MD,232,7,4043258,Europe,7537,274
2020-05-29,Moldova,MD,188,8,4043258,Europe,7725,282
2020-05-30,Moldova,MD,171,6,4043258,Europe,7896,288
2020-05-31,Moldova,MD,202,3,4043258,Europe,8098,291
2020-06-01,Moldova,MD,153,4,4043258,Europe,8251,295
2020-06-02,Moldova,MD,109,12,4043258,Europe,8360,307
2020-06-03,Moldova,MD,188,0,4043258,Europe,8548,307
2020-06-04,Moldova,MD,247,3,4043258,Europe,8795,310
2020-06-05,Moldova,MD,223,5,4043258,Europe,9018,315
2020-06-06,Moldova,MD,229,8,4043258,Europe,9247,323
2020-06-07,Moldova,MD,264,8,4043258,Europe,9511,331
2020-06-08,Moldova,MD,189,10,4043258,Europe,9700,341
2020-06-09,Moldova,MD,107,12,4043258,Europe,9807,353
2020-06-10,Moldova,MD,218,12,4043258,Europe,10025,365
2020-06-11,Moldova,MD,296,6,4043258,Europe,10321,371
2020-06-12,Moldova,MD,406,4,4043258,Europe,10727,375
2020-06-13,Moldova,MD,366,10,4043258,Europe,11093,385
2020-06-14,Moldova,MD,366,13,4043258,Europe,11459,398
2020-06-15,Moldova,MD,281,8,4043258,Europe,11740,406
2020-06-16,Moldova,MD,139,5,4043258,Europe,11879,411
2020-06-17,Moldova,MD,375,12,4043258,Europe,12254,423
2020-06-18,Moldova,MD,478,10,4043258,Europe,12732,433
2020-06-19,Moldova,MD,374,11,4043258,Europe,13106,444
2020-06-20,Moldova,MD,450,6,4043258,Europe,13556,450
2020-06-21,Moldova,MD,397,14,4043258,Europe,13953,464
2020-06-22,Moldova,MD,247,9,4043258,Europe,14200,473
2020-06-23,Moldova,MD,163,7,4043258,Europe,14363,480
2020-06-24,Moldova,MD,351,10,4043258,Europe,14714,490
2020-06-25,Moldova,MD,364,5,4043258,Europe,15078,495
2020-06-26,Moldova,MD,375,7,4043258,Europe,15453,502
2020-06-27,Moldova,MD,323,13,4043258,Europe,15776,515
2020-06-28,Moldova,MD,304,6,4043258,Europe,16080,521
2020-06-29,Moldova,MD,170,9,4043258,Europe,16250,530
2020-06-30,Moldova,MD,107,6,4043258,Europe,16357,536
2020-07-01,Moldova,MD,256,9,4043258,Europe,16613,545
2020-07-02,Moldova,MD,285,4,4043258,Europe,16898,549
2020-07-03,Moldova,MD,252,11,4043258,Europe,17150,560
2020-07-04,Moldova,MD,295,12,4043258,Europe,17445,572
2020-07-05,Moldova,MD,227,8,4043258,Europe,17672,580
2020-07-06,Moldova,MD,142,5,4043258,Europe,17814,585
2020-07-07,Moldova,MD,92,10,4043258,Europe,17906,595
2020-07-08,Moldova,MD,235,8,4043258,Europe,18141,603
2020-07-09,Moldova,MD,330,11,4043258,Europe,18471,614
2020-07-10,Moldova,MD,195,10,4043258,Europe,18666,624
2020-07-11,Moldova,MD,258,11,4043258,Europe,18924,635
2020-07-12,Moldova,MD,284,5,4043258,Europe,19208,640
2020-07-13,Moldova,MD,174,2,4043258,Europe,19382,642
2020-07-14,Moldova,MD,57,7,4043258,Europe,19439,649
2020-07-15,Moldova,MD,269,9,4043258,Europe,19708,658
2020-07-16,Moldova,MD,332,1,4043258,Europe,20040,659
2020-07-17,Moldova,MD,224,7,4043258,Europe,20264,666
2020-07-18,Moldova,MD,230,9,4043258,Europe,20494,675
2020-07-19,Moldova,MD,300,5,4043258,Europe,20794,680
2020-07-20,Moldova,MD,186,4,4043258,Europe,20980,684
2020-07-21,Moldova,MD,135,11,4043258,Europe,21115,695
2020-07-22,Moldova,MD,327,12,4043258,Europe,21442,707
2020-07-23,Moldova,MD,356,5,4043258,Europe,21798,712
2020-07-24,Moldova,MD,307,7,4043258,Europe,22105,719
2020-07-25,Moldova,MD,378,7,4043258,Europe,22483,726
2020-07-26,Moldova,MD,345,6,4043258,Europe,22828,732
2020-07-27,Moldova,MD,206,3,4043258,Europe,23034,735
2020-07-28,Moldova,MD,120,13,4043258,Europe,23154,748
2020-07-29,Moldova,MD,367,5,4043258,Europe,23521,753
2020-07-30,Moldova,MD,426,6,4043258,Europe,23947,759
2020-07-31,Moldova,MD,0,12,4043258,Europe,23947,771
2020-08-01,Moldova,MD,786,7,4043258,Europe,24733,778
2020-08-02,Moldova,MD,380,10,4043258,Europe,25113,788
2020-08-03,Moldova,MD,249,3,4043258,Europe,25362,791
2020-08-04,Moldova,MD,120,9,4043258,Europe,25482,800
2020-08-05,Moldova,MD,332,10,4043258,Europe,25814,810
2020-08-06,Moldova,MD,408,13,4043258,Europe,26222,823
2020-08-07,Moldova,MD,406,5,4043258,Europe,26628,828
2020-08-08,Moldova,MD,362,7,4043258,Europe,26990,835
2020-08-09,Moldova,MD,453,6,4043258,Europe,27443,841
2020-08-10,Moldova,MD,217,4,4043258,Europe,27660,845
2020-08-11,Moldova,MD,181,5,4043258,Europe,27841,850
2020-08-12,Moldova,MD,382,7,4043258,Europe,28223,857
2020-08-13,Moldova,MD,474,6,4043258,Europe,28697,863
2020-08-14,Moldova,MD,390,15,4043258,Europe,29087,878
2020-08-15,Moldova,MD,396,6,4043258,Europe,29483,884
2020-08-16,Moldova,MD,422,11,4043258,Europe,29905,895
2020-08-17,Moldova,MD,278,1,4043258,Europe,30183,896
2020-08-18,Moldova,MD,194,12,4043258,Europe,30377,908
2020-08-19,Moldova,MD,412,0,4043258,Europe,30789,908
2020-08-20,Moldova,MD,626,6,4043258,Europe,31415,914
2020-08-21,Moldova,MD,522,7,4043258,Europe,31937,921
2020-08-22,Moldova,MD,547,8,4043258,Europe,32484,929
2020-08-23,Moldova,MD,588,6,4043258,Europe,33072,935
2020-08-24,Moldova,MD,406,5,4043258,Europe,33478,940
2020-08-25,Moldova,MD,350,5,4043258,Europe,33828,945
2020-08-26,Moldova,MD,530,15,4043258,Europe,34358,960
2020-08-27,Moldova,MD,624,7,4043258,Europe,34982,967
2020-08-28,Moldova,MD,564,10,4043258,Europe,35546,977
2020-08-29,Moldova,MD,358,4,4043258,Europe,35904,981
2020-08-30,Moldova,MD,500,9,4043258,Europe,36404,990
2020-08-31,Moldova,MD,296,2,4043258,Europe,36700,992
2020-09-01,Moldova,MD,220,3,4043258,Europe,36920,995
2020-09-02,Moldova,MD,288,13,4043258,Europe,37208,1008
2020-09-03,Moldova,MD,532,16,4043258,Europe,37740,1024
2020-09-04,Moldova,MD,632,12,4043258,Europe,38372,1036
2020-09-05,Moldova,MD,534,11,4043258,Europe,38906,1047
2020-09-06,Moldova,MD,567,16,4043258,Europe,39473,1063
2020-09-07,Moldova,MD,324,0,4043258,Europe,39797,1063
2020-09-08,Moldova,MD,258,11,4043258,Europe,40055,1074
2020-09-09,Moldova,MD,501,13,4043258,Europe,40556,1087
2020-09-10,Moldova,MD,588,9,4043258,Europe,41144,1096
2020-09-11,Moldova,MD,560,10,4043258,Europe,41704,1106
2020-09-12,Moldova,MD,479,8,4043258,Europe,42183,1114
2020-09-13,Moldova,MD,531,4,4043258,Europe,42714,1118
2020-09-14,Moldova,MD,264,5,4043258,Europe,42978,1123
2020-09-15,Moldova,MD,229,7,4043258,Europe,43207,1130
2020-09-16,Moldova,MD,527,14,4043258,Europe,43734,1144
2020-09-17,Moldova,MD,627,15,4043258,Europe,44361,1159
2020-09-18,Moldova,MD,622,11,4043258,Europe,44983,1170
2020-09-19,Moldova,MD,665,16,4043258,Europe,45648,1186
2020-09-20,Moldova,MD,688,15,4043258,Europe,46336,1201
2020-09-21,Moldova,MD,260,2,4043258,Europe,46596,1203
2020-09-22,Moldova,MD,200,8,4043258,Europe,46796,1211
2020-09-23,Moldova,MD,650,19,4043258,Europe,47446,1230
2020-09-24,Moldova,MD,786,14,4043258,Europe,48232,1244
2020-09-25,Moldova,MD,721,8,4043258,Europe,48953,1252
2020-09-26,Moldova,MD,713,12,4043258,Europe,49666,1264
2020-09-27,Moldova,MD,868,15,4043258,Europe,50534,1279
2020-09-28,Moldova,MD,341,8,4043258,Europe,50875,1287
2020-09-29,Moldova,MD,319,14,4043258,Europe,51194,1301
2020-09-30,Moldova,MD,835,9,4043258,Europe,52029,1310
2020-10-01,Moldova,MD,1013,10,4043258,Europe,53042,1320
2020-10-02,Moldova,MD,1022,16,4043258,Europe,54064,1336
2020-10-03,Moldova,MD,952,8,4043258,Europe,55016,1344
2020-10-04,Moldova,MD,872,9,4043258,Europe,55888,1353
2020-10-05,Moldova,MD,691,13,4043258,Europe,56579,1366
2020-10-06,Moldova,MD,322,9,4043258,Europe,56901,1375
2020-10-07,Moldova,MD,831,14,4043258,Europe,57732,1389
2020-10-08,Moldova,MD,1062,17,4043258,Europe,58794,1406
2020-10-09,Moldova,MD,1121,18,4043258,Europe,59915,1424
2020-10-10,Moldova,MD,918,18,4043258,Europe,60833,1442
2020-10-11,Moldova,MD,929,16,4043258,Europe,61762,1458
2020-10-12,Moldova,MD,389,3,4043258,Europe,62151,1461
2020-10-13,Moldova,MD,467,17,4043258,Europe,62618,1478
2020-10-14,Moldova,MD,657,17,4043258,Europe,63275,1495
2020-10-15,Moldova,MD,1149,19,4043258,Europe,64424,1514
2020-10-16,Moldova,MD,652,16,4043258,Europe,65076,1530
2020-10-17,Moldova,MD,784,19,4043258,Europe,65860,1549
2020-10-18,Moldova,MD,792,20,4043258,Europe,66652,1569
2020-10-19,Moldova,MD,398,15,4043258,Europe,67050,1584
2020-10-20,Moldova,MD,252,17,4043258,Europe,67302,1601
2020-10-21,Moldova,MD,656,16,4043258,Europe,67958,1617
2020-10-22,Moldova,MD,833,13,4043258,Europe,68791,1630
2020-10-23,Moldova,MD,777,11,4043258,Europe,69568,1641
2020-10-24,Moldova,MD,688,14,4043258,Europe,70256,1655
2020-10-25,Moldova,MD,833,14,4043258,Europe,71089,1669
2020-10-26,Moldova,MD,414,16,4043258,Europe,71503,1685
2020-10-27,Moldova,MD,308,15,4043258,Europe,71811,1700
2020-10-28,Moldova,MD,649,10,4043258,Europe,72460,1710
2020-10-29,Moldova,MD,861,19,4043258,Europe,73321,1729
2020-10-30,Moldova,MD,912,18,4043258,Europe,74233,1747
2020-10-31,Moldova,MD,968,19,4043258,Europe,75201,1766
2020-11-01,Moldova,MD,839,19,4043258,Europe,76040,1785
2020-11-02,Moldova,MD,542,15,4043258,Europe,76582,1800
2020-11-03,Moldova,MD,195,18,4043258,Europe,76777,1818
2020-11-04,Moldova,MD,710,20,4043258,Europe,77487,1838
2020-11-05,Moldova,MD,1020,13,4043258,Europe,78507,1851
2020-11-06,Moldova,MD,1059,15,4043258,Europe,79566,1866
2020-11-07,Moldova,MD,935,16,4043258,Europe,80501,1882
2020-11-08,Moldova,MD,1174,9,4043258,Europe,81675,1891
2020-11-09,Moldova,MD,671,2,4043258,Europe,82346,1893
2020-11-10,Moldova,MD,331,19,4043258,Europe,82677,1912
2020-11-11,Moldova,MD,915,18,4043258,Europe,83592,1930
2020-11-12,Moldova,MD,1115,20,4043258,Europe,84707,1950
2020-11-13,Moldova,MD,1331,19,4043258,Europe,86038,1969
2020-11-14,Moldova,MD,1323,18,4043258,Europe,87361,1987
2020-11-15,Moldova,MD,1411,19,4043258,Europe,88772,2006
2020-11-16,Moldova,MD,507,13,4043258,Europe,89279,2019
2020-11-17,Moldova,MD,564,16,4043258,Europe,89843,2035
2020-11-18,Moldova,MD,1069,19,4043258,Europe,90912,2054
2020-11-19,Moldova,MD,1607,18,4043258,Europe,92519,2072
2020-11-20,Moldova,MD,1442,19,4043258,Europe,93961,2091
2020-11-21,Moldova,MD,1422,20,4043258,Europe,95383,2111
2020-11-22,Moldova,MD,1306,19,4043258,Europe,96689,2130
2020-11-23,Moldova,MD,1252,19,4043258,Europe,97941,2149
2020-11-24,Moldova,MD,477,20,4043258,Europe,98418,2169
2020-11-25,Moldova,MD,1215,19,4043258,Europe,99633,2188
2020-11-26,Moldova,MD,1570,21,4043258,Europe,101203,2209
2020-11-27,Moldova,MD,1691,20,4043258,Europe,102894,2229
2020-11-28,Moldova,MD,1246,21,4043258,Europe,104140,2250
2020-11-29,Moldova,MD,1712,19,4043258,Europe,105852,2269
2020-11-30,Moldova,MD,1165,21,4043258,Europe,107017,2290
2020-12-01,Moldova,MD,347,14,4043258,Europe,107364,2304
2020-12-02,Moldova,MD,1499,19,4043258,Europe,108863,2323
2020-12-03,Moldova,MD,1717,20,4043258,Europe,110580,2343
2020-12-04,Moldova,MD,1727,20,4043258,Europe,112307,2363
2020-12-05,Moldova,MD,1522,21,4043258,Europe,113829,2384
2020-12-06,Moldova,MD,1728,19,4043258,Europe,115557,2403
2020-12-07,Moldova,MD,1078,16,4043258,Europe,116635,2419
2020-12-08,Moldova,MD,860,19,4043258,Europe,117495,2438
2020-12-09,Moldova,MD,1709,22,4043258,Europe,119204,2460
2020-12-10,Moldova,MD,1766,21,4043258,Europe,120970,2481
2020-12-11,Moldova,MD,1715,19,4043258,Europe,122685,2500
2020-12-12,Moldova,MD,1579,21,4043258,Europe,124264,2521
2020-12-13,Moldova,MD,1459,26,4043258,Europe,125723,2547
2020-12-14,Moldova,MD,795,25,4043258,Europe,126518,2572
2020-03-18,Montenegro,ME,2,0,622182,Europe,2,0
2020-03-19,Montenegro,ME,6,0,622182,Europe,8,0
2020-03-20,Montenegro,ME,5,0,622182,Europe,13,0
2020-03-21,Montenegro,ME,1,0,622182,Europe,14,0
2020-03-22,Montenegro,ME,0,0,622182,Europe,14,0
2020-03-23,Montenegro,ME,7,0,622182,Europe,21,0
2020-03-24,Montenegro,ME,6,0,622182,Europe,27,0
2020-03-25,Montenegro,ME,20,0,622182,Europe,47,0
2020-03-26,Montenegro,ME,6,0,622182,Europe,53,0
2020-03-27,Montenegro,ME,14,1,622182,Europe,67,1
2020-03-28,Montenegro,ME,8,0,622182,Europe,75,1
2020-03-29,Montenegro,ME,9,0,622182,Europe,84,1
2020-03-30,Montenegro,ME,1,0,622182,Europe,85,1
2020-03-31,Montenegro,ME,6,0,622182,Europe,91,1
2020-04-01,Montenegro,ME,18,0,622182,Europe,109,1
2020-04-02,Montenegro,ME,14,0,622182,Europe,123,1
2020-04-03,Montenegro,ME,21,1,622182,Europe,144,2
2020-04-04,Montenegro,ME,30,0,622182,Europe,174,2
2020-04-05,Montenegro,ME,27,0,622182,Europe,201,2
2020-04-06,Montenegro,ME,13,0,622182,Europe,214,2
2020-04-07,Montenegro,ME,19,0,622182,Europe,233,2
2020-04-08,Montenegro,ME,8,0,622182,Europe,241,2
2020-04-09,Montenegro,ME,8,0,622182,Europe,249,2
2020-04-10,Montenegro,ME,3,0,622182,Europe,252,2
2020-04-11,Montenegro,ME,5,0,622182,Europe,257,2
2020-04-12,Montenegro,ME,6,0,622182,Europe,263,2
2020-04-13,Montenegro,ME,9,1,622182,Europe,272,3
2020-04-14,Montenegro,ME,2,0,622182,Europe,274,3
2020-04-15,Montenegro,ME,9,1,622182,Europe,283,4
2020-04-16,Montenegro,ME,5,0,622182,Europe,288,4
2020-04-17,Montenegro,ME,15,0,622182,Europe,303,4
2020-04-18,Montenegro,ME,0,0,622182,Europe,303,4
2020-04-19,Montenegro,ME,4,1,622182,Europe,307,5
2020-04-20,Montenegro,ME,1,0,622182,Europe,308,5
2020-04-21,Montenegro,ME,4,0,622182,Europe,312,5
2020-04-22,Montenegro,ME,1,0,622182,Europe,313,5
2020-04-23,Montenegro,ME,2,0,622182,Europe,315,5
2020-04-24,Montenegro,ME,4,0,622182,Europe,319,5
2020-04-25,Montenegro,ME,0,1,622182,Europe,319,6
2020-04-26,Montenegro,ME,1,0,622182,Europe,320,6
2020-04-27,Montenegro,ME,1,1,622182,Europe,321,7
2020-04-28,Montenegro,ME,0,0,622182,Europe,321,7
2020-04-29,Montenegro,ME,0,0,622182,Europe,321,7
2020-04-30,Montenegro,ME,1,0,622182,Europe,322,7
2020-05-01,Montenegro,ME,0,0,622182,Europe,322,7
2020-05-02,Montenegro,ME,0,0,622182,Europe,322,7
2020-05-03,Montenegro,ME,0,0,622182,Europe,322,7
2020-05-04,Montenegro,ME,0,1,622182,Europe,322,8
2020-05-05,Montenegro,ME,1,0,622182,Europe,323,8
2020-05-06,Montenegro,ME,1,0,622182,Europe,324,8
2020-05-07,Montenegro,ME,0,0,622182,Europe,324,8
2020-05-08,Montenegro,ME,0,0,622182,Europe,324,8
2020-05-09,Montenegro,ME,0,0,622182,Europe,324,8
2020-05-10,Montenegro,ME,0,0,622182,Europe,324,8
2020-05-11,Montenegro,ME,0,1,622182,Europe,324,9
2020-05-12,Montenegro,ME,0,0,622182,Europe,324,9
2020-05-13,Montenegro,ME,0,0,622182,Europe,324,9
2020-05-14,Montenegro,ME,0,0,622182,Europe,324,9
2020-05-15,Montenegro,ME,0,0,622182,Europe,324,9
2020-05-16,Montenegro,ME,0,0,622182,Europe,324,9
2020-05-17,Montenegro,ME,0,0,622182,Europe,324,9
2020-05-18,Montenegro,ME,0,0,622182,Europe,324,9
2020-05-19,Montenegro,ME,0,0,622182,Europe,324,9
2020-05-20,Montenegro,ME,0,0,622182,Europe,324,9
2020-05-21,Montenegro,ME,0,0,622182,Europe,324,9
2020-05-22,Montenegro,ME,0,0,622182,Europe,324,9
2020-05-23,Montenegro,ME,0,0,622182,Europe,324,9
2020-05-24,Montenegro,ME,0,0,622182,Europe,324,9
2020-05-25,Montenegro,ME,0,0,622182,Europe,324,9
2020-05-26,Montenegro,ME,0,0,622182,Europe,324,9
2020-05-27,Montenegro,ME,0,0,622182,Europe,324,9
2020-05-28,Montenegro,ME,0,0,622182,Europe,324,9
2020-05-29,Montenegro,ME,0,0,622182,Europe,324,9
2020-05-30,Montenegro,ME,0,0,622182,Europe,324,9
2020-05-31,Montenegro,ME,0,0,622182,Europe,324,9
2020-06-01,Montenegro,ME,0,0,622182,Europe,324,9
2020-06-02,Montenegro,ME,0,0,622182,Europe,324,9
2020-06-03,Montenegro,ME,0,0,622182,Europe,324,9
2020-06-04,Montenegro,ME,0,0,622182,Europe,324,9
2020-06-05,Montenegro,ME,0,0,622182,Europe,324,9
2020-06-06,Montenegro,ME,0,0,622182,Europe,324,9
2020-06-07,Montenegro,ME,0,0,622182,Europe,324,9
2020-06-08,Montenegro,ME,0,0,622182,Europe,324,9
2020-06-09,Montenegro,ME,0,0,622182,Europe,324,9
2020-06-10,Montenegro,ME,0,0,622182,Europe,324,9
2020-06-11,Montenegro,ME,0,0,622182,Europe,324,9
2020-06-12,Montenegro,ME,0,0,622182,Europe,324,9
2020-06-13,Montenegro,ME,0,0,622182,Europe,324,9
2020-06-14,Montenegro,ME,0,0,622182,Europe,324,9
2020-06-15,Montenegro,ME,1,0,622182,Europe,325,9
2020-06-16,Montenegro,ME,1,0,622182,Europe,326,9
2020-06-17,Montenegro,ME,0,0,622182,Europe,326,9
2020-06-18,Montenegro,ME,7,0,622182,Europe,333,9
2020-06-19,Montenegro,ME,4,0,622182,Europe,337,9
2020-06-20,Montenegro,ME,18,0,622182,Europe,355,9
2020-06-21,Montenegro,ME,4,0,622182,Europe,359,9
2020-06-22,Montenegro,ME,3,0,622182,Europe,362,9
2020-06-23,Montenegro,ME,5,0,622182,Europe,367,9
2020-06-24,Montenegro,ME,11,0,622182,Europe,378,9
2020-06-25,Montenegro,ME,11,0,622182,Europe,389,9
2020-06-26,Montenegro,ME,25,0,622182,Europe,414,9
2020-06-27,Montenegro,ME,25,0,622182,Europe,439,9
2020-06-28,Montenegro,ME,30,0,622182,Europe,469,9
2020-06-29,Montenegro,ME,12,2,622182,Europe,481,11
2020-06-30,Montenegro,ME,20,0,622182,Europe,501,11
2020-07-01,Montenegro,ME,47,1,622182,Europe,548,12
2020-07-02,Montenegro,ME,28,0,622182,Europe,576,12
2020-07-03,Montenegro,ME,40,1,622182,Europe,616,13
2020-07-04,Montenegro,ME,47,0,622182,Europe,663,13
2020-07-05,Montenegro,ME,57,1,622182,Europe,720,14
2020-07-06,Montenegro,ME,61,0,622182,Europe,781,14
2020-07-07,Montenegro,ME,60,0,622182,Europe,841,14
2020-07-08,Montenegro,ME,66,3,622182,Europe,907,17
2020-07-09,Montenegro,ME,53,0,622182,Europe,960,17
2020-07-10,Montenegro,ME,59,2,622182,Europe,1019,19
2020-07-11,Montenegro,ME,58,0,622182,Europe,1077,19
2020-07-12,Montenegro,ME,87,4,622182,Europe,1164,23
2020-07-13,Montenegro,ME,57,0,622182,Europe,1221,23
2020-07-14,Montenegro,ME,232,1,622182,Europe,1453,24
2020-07-15,Montenegro,ME,69,1,622182,Europe,1522,25
2020-07-16,Montenegro,ME,60,0,622182,Europe,1582,25
2020-07-17,Montenegro,ME,36,1,622182,Europe,1618,26
2020-07-18,Montenegro,ME,0,0,622182,Europe,1618,26
2020-07-19,Montenegro,ME,46,2,622182,Europe,1664,28
2020-07-20,Montenegro,ME,107,2,622182,Europe,1771,30
2020-07-21,Montenegro,ME,90,2,622182,Europe,1861,32
2020-07-22,Montenegro,ME,59,3,622182,Europe,1920,35
2020-07-23,Montenegro,ME,17,0,622182,Europe,1937,35
2020-07-24,Montenegro,ME,324,4,622182,Europe,2261,39
2020-07-25,Montenegro,ME,308,1,622182,Europe,2569,40
2020-07-26,Montenegro,ME,0,0,622182,Europe,2569,40
2020-07-27,Montenegro,ME,0,0,622182,Europe,2569,40
2020-07-28,Montenegro,ME,324,3,622182,Europe,2893,43
2020-07-29,Montenegro,ME,56,2,622182,Europe,2949,45
2020-07-30,Montenegro,ME,67,2,622182,Europe,3016,47
2020-07-31,Montenegro,ME,57,1,622182,Europe,3073,48
2020-08-01,Montenegro,ME,39,1,622182,Europe,3112,49
2020-08-02,Montenegro,ME,86,1,622182,Europe,3198,50
2020-08-03,Montenegro,ME,60,1,622182,Europe,3258,51
2020-08-04,Montenegro,ME,43,1,622182,Europe,3301,52
2020-08-05,Montenegro,ME,60,1,622182,Europe,3361,53
2020-08-06,Montenegro,ME,50,4,622182,Europe,3411,57
2020-08-07,Montenegro,ME,69,3,622182,Europe,3480,60
2020-08-08,Montenegro,ME,69,1,622182,Europe,3549,61
2020-08-09,Montenegro,ME,39,1,622182,Europe,3588,62
2020-08-10,Montenegro,ME,30,2,622182,Europe,3618,64
2020-08-11,Montenegro,ME,78,4,622182,Europe,3696,68
2020-08-12,Montenegro,ME,52,3,622182,Europe,3748,71
2020-08-13,Montenegro,ME,65,2,622182,Europe,3813,73
2020-08-14,Montenegro,ME,44,0,622182,Europe,3857,73
2020-08-15,Montenegro,ME,73,0,622182,Europe,3930,73
2020-08-16,Montenegro,ME,30,2,622182,Europe,3960,75
2020-08-17,Montenegro,ME,75,2,622182,Europe,4035,77
2020-08-18,Montenegro,ME,50,3,622182,Europe,4085,80
2020-08-19,Montenegro,ME,47,0,622182,Europe,4132,80
2020-08-20,Montenegro,ME,42,0,622182,Europe,4174,80
2020-08-21,Montenegro,ME,55,1,622182,Europe,4229,81
2020-08-22,Montenegro,ME,48,1,622182,Europe,4277,82
2020-08-23,Montenegro,ME,34,2,622182,Europe,4311,84
2020-08-24,Montenegro,ME,32,0,622182,Europe,4343,84
2020-08-25,Montenegro,ME,35,0,622182,Europe,4378,84
2020-08-26,Montenegro,ME,66,3,622182,Europe,4444,87
2020-08-27,Montenegro,ME,55,1,622182,Europe,4499,88
2020-08-28,Montenegro,ME,59,1,622182,Europe,4558,89
2020-08-29,Montenegro,ME,105,3,622182,Europe,4663,92
2020-08-30,Montenegro,ME,64,1,622182,Europe,4727,93
2020-08-31,Montenegro,ME,63,5,622182,Europe,4790,98
2020-09-01,Montenegro,ME,45,2,622182,Europe,4835,100
2020-09-02,Montenegro,ME,82,2,622182,Europe,4917,102
2020-09-03,Montenegro,ME,102,2,622182,Europe,5019,104
2020-09-04,Montenegro,ME,146,0,622182,Europe,5165,104
2020-09-05,Montenegro,ME,110,2,622182,Europe,5275,106
2020-09-06,Montenegro,ME,147,1,622182,Europe,5422,107
2020-09-07,Montenegro,ME,131,1,622182,Europe,5553,108
2020-09-08,Montenegro,ME,106,1,622182,Europe,5659,109
2020-09-09,Montenegro,ME,216,3,622182,Europe,5875,112
2020-09-10,Montenegro,ME,219,2,622182,Europe,6094,114
2020-09-11,Montenegro,ME,128,0,622182,Europe,6222,114
2020-09-12,Montenegro,ME,163,1,622182,Europe,6385,115
2020-09-13,Montenegro,ME,145,3,622182,Europe,6530,118
2020-09-14,Montenegro,ME,182,2,622182,Europe,6712,120
2020-09-15,Montenegro,ME,188,1,622182,Europe,6900,121
2020-09-16,Montenegro,ME,161,2,622182,Europe,7061,123
2020-09-17,Montenegro,ME,230,3,622182,Europe,7291,126
2020-09-18,Montenegro,ME,212,3,622182,Europe,7503,129
2020-09-19,Montenegro,ME,208,4,622182,Europe,7711,133
2020-09-20,Montenegro,ME,187,1,622182,Europe,7898,134
2020-09-21,Montenegro,ME,714,2,622182,Europe,8612,136
2020-09-22,Montenegro,ME,230,2,622182,Europe,8842,138
2020-09-23,Montenegro,ME,296,8,622182,Europe,9138,146
2020-09-24,Montenegro,ME,290,5,622182,Europe,9428,151
2020-09-25,Montenegro,ME,289,3,622182,Europe,9717,154
2020-09-26,Montenegro,ME,245,1,622182,Europe,9962,155
2020-09-27,Montenegro,ME,235,3,622182,Europe,10197,158
2020-09-28,Montenegro,ME,116,0,622182,Europe,10313,158
2020-09-29,Montenegro,ME,128,5,622182,Europe,10441,163
2020-09-30,Montenegro,ME,134,1,622182,Europe,10575,164
2020-10-01,Montenegro,ME,197,5,622182,Europe,10772,169
2020-10-02,Montenegro,ME,215,1,622182,Europe,10987,170
2020-10-03,Montenegro,ME,703,2,622182,Europe,11690,172
2020-10-04,Montenegro,ME,244,2,622182,Europe,11934,174
2020-10-05,Montenegro,ME,193,5,622182,Europe,12127,179
2020-10-06,Montenegro,ME,232,3,622182,Europe,12359,182
2020-10-07,Montenegro,ME,225,6,622182,Europe,12584,188
2020-10-08,Montenegro,ME,210,2,622182,Europe,12794,190
2020-10-09,Montenegro,ME,210,1,622182,Europe,13004,191
2020-10-10,Montenegro,ME,344,3,622182,Europe,13348,194
2020-10-11,Montenegro,ME,293,4,622182,Europe,13641,198
2020-10-12,Montenegro,ME,228,4,622182,Europe,13869,202
2020-10-13,Montenegro,ME,181,9,622182,Europe,14050,211
2020-10-14,Montenegro,ME,218,2,622182,Europe,14268,213
2020-10-15,Montenegro,ME,193,4,622182,Europe,14461,217
2020-10-16,Montenegro,ME,211,4,622182,Europe,14672,221
2020-10-17,Montenegro,ME,609,7,622182,Europe,15281,228
2020-10-18,Montenegro,ME,146,3,622182,Europe,15427,231
2020-10-19,Montenegro,ME,188,5,622182,Europe,15615,236
2020-10-20,Montenegro,ME,145,4,622182,Europe,15760,240
2020-10-21,Montenegro,ME,132,7,622182,Europe,15892,247
2020-10-22,Montenegro,ME,177,3,622182,Europe,16069,250
2020-10-23,Montenegro,ME,190,3,622182,Europe,16259,253
2020-10-24,Montenegro,ME,177,2,622182,Europe,16436,255
2020-10-25,Montenegro,ME,193,8,622182,Europe,16629,263
2020-10-26,Montenegro,ME,168,3,622182,Europe,16797,266
2020-10-27,Montenegro,ME,112,4,622182,Europe,16909,270
2020-10-28,Montenegro,ME,182,5,622182,Europe,17091,275
2020-10-29,Montenegro,ME,301,7,622182,Europe,17392,282
2020-10-30,Montenegro,ME,354,8,622182,Europe,17746,290
2020-10-31,Montenegro,ME,320,4,622182,Europe,18066,294
2020-11-01,Montenegro,ME,275,7,622182,Europe,18341,301
2020-11-02,Montenegro,ME,373,12,622182,Europe,18714,313
2020-11-03,Montenegro,ME,496,7,622182,Europe,19210,320
2020-11-04,Montenegro,ME,767,2,622182,Europe,19977,322
2020-11-05,Montenegro,ME,874,4,622182,Europe,20851,326
2020-11-06,Montenegro,ME,682,2,622182,Europe,21533,328
2020-11-07,Montenegro,ME,546,0,622182,Europe,22079,328
2020-11-08,Montenegro,ME,300,5,622182,Europe,22379,333
2020-11-09,Montenegro,ME,426,4,622182,Europe,22805,337
2020-11-10,Montenegro,ME,803,5,622182,Europe,23608,342
2020-11-11,Montenegro,ME,546,7,622182,Europe,24154,349
2020-11-12,Montenegro,ME,711,7,622182,Europe,24865,356
2020-11-13,Montenegro,ME,644,8,622182,Europe,25509,364
2020-11-14,Montenegro,ME,600,13,622182,Europe,26109,377
2020-11-15,Montenegro,ME,577,8,622182,Europe,26686,385
2020-11-16,Montenegro,ME,491,6,622182,Europe,27177,391
2020-11-17,Montenegro,ME,596,5,622182,Europe,27773,396
2020-11-18,Montenegro,ME,619,9,622182,Europe,28392,405
2020-11-19,Montenegro,ME,639,9,622182,Europe,29031,414
2020-11-20,Montenegro,ME,546,6,622182,Europe,29577,420
2020-11-21,Montenegro,ME,502,9,622182,Europe,30079,429
2020-11-22,Montenegro,ME,574,5,622182,Europe,30653,434
2020-11-23,Montenegro,ME,409,5,622182,Europe,31062,439
2020-11-24,Montenegro,ME,556,5,622182,Europe,31618,444
2020-11-25,Montenegro,ME,570,6,622182,Europe,32188,450
2020-11-26,Montenegro,ME,620,9,622182,Europe,32808,459
2020-11-27,Montenegro,ME,508,10,622182,Europe,33316,469
2020-11-28,Montenegro,ME,520,5,622182,Europe,33836,474
2020-11-29,Montenegro,ME,618,7,622182,Europe,34454,481
2020-11-30,Montenegro,ME,427,6,622182,Europe,34881,487
2020-12-01,Montenegro,ME,384,12,622182,Europe,35265,499
2020-12-02,Montenegro,ME,584,5,622182,Europe,35849,504
2020-12-03,Montenegro,ME,502,6,622182,Europe,36351,510
2020-12-04,Montenegro,ME,581,6,622182,Europe,36932,516
2020-12-05,Montenegro,ME,535,6,622182,Europe,37467,522
2020-12-06,Montenegro,ME,412,8,622182,Europe,37879,530
2020-12-07,Montenegro,ME,367,3,622182,Europe,38246,533
2020-12-08,Montenegro,ME,316,10,622182,Europe,38562,543
2020-12-09,Montenegro,ME,591,6,622182,Europe,39153,549
2020-12-10,Montenegro,ME,454,7,622182,Europe,39607,556
2020-12-11,Montenegro,ME,558,10,622182,Europe,40165,566
2020-12-12,Montenegro,ME,381,3,622182,Europe,40546,569
2020-12-13,Montenegro,ME,402,9,622182,Europe,40948,578
2020-12-14,Montenegro,ME,478,4,622182,Europe,41426,582
2020-03-21,Madagascar,MG,3,0,26969306,Africa,3,0
2020-03-22,Madagascar,MG,0,0,26969306,Africa,3,0
2020-03-23,Madagascar,MG,0,0,26969306,Africa,3,0
2020-03-24,Madagascar,MG,14,0,26969306,Africa,17,0
2020-03-25,Madagascar,MG,2,0,26969306,Africa,19,0
2020-03-26,Madagascar,MG,0,0,26969306,Africa,19,0
2020-03-27,Madagascar,MG,4,0,26969306,Africa,23,0
2020-03-28,Madagascar,MG,1,0,26969306,Africa,24,0
2020-03-29,Madagascar,MG,4,0,26969306,Africa,28,0
2020-03-30,Madagascar,MG,9,0,26969306,Africa,37,0
2020-03-31,Madagascar,MG,7,0,26969306,Africa,44,0
2020-04-01,Madagascar,MG,2,0,26969306,Africa,46,0
2020-04-02,Madagascar,MG,8,0,26969306,Africa,54,0
2020-04-03,Madagascar,MG,5,0,26969306,Africa,59,0
2020-04-04,Madagascar,MG,6,0,26969306,Africa,65,0
2020-04-05,Madagascar,MG,6,0,26969306,Africa,71,0
2020-04-06,Madagascar,MG,1,0,26969306,Africa,72,0
2020-04-07,Madagascar,MG,5,0,26969306,Africa,77,0
2020-04-08,Madagascar,MG,8,0,26969306,Africa,85,0
2020-04-09,Madagascar,MG,8,0,26969306,Africa,93,0
2020-04-10,Madagascar,MG,0,0,26969306,Africa,93,0
2020-04-11,Madagascar,MG,9,0,26969306,Africa,102,0
2020-04-12,Madagascar,MG,0,0,26969306,Africa,102,0
2020-04-13,Madagascar,MG,4,0,26969306,Africa,106,0
2020-04-14,Madagascar,MG,0,0,26969306,Africa,106,0
2020-04-15,Madagascar,MG,2,0,26969306,Africa,108,0
2020-04-16,Madagascar,MG,2,0,26969306,Africa,110,0
2020-04-17,Madagascar,MG,1,0,26969306,Africa,111,0
2020-04-18,Madagascar,MG,6,0,26969306,Africa,117,0
2020-04-19,Madagascar,MG,0,0,26969306,Africa,117,0
2020-04-20,Madagascar,MG,4,0,26969306,Africa,121,0
2020-04-21,Madagascar,MG,0,0,26969306,Africa,121,0
2020-04-22,Madagascar,MG,0,0,26969306,Africa,121,0
2020-04-23,Madagascar,MG,0,0,26969306,Africa,121,0
2020-04-24,Madagascar,MG,0,0,26969306,Africa,121,0
2020-04-25,Madagascar,MG,1,0,26969306,Africa,122,0
2020-04-26,Madagascar,MG,2,0,26969306,Africa,124,0
2020-04-27,Madagascar,MG,0,0,26969306,Africa,124,0
2020-04-28,Madagascar,MG,4,0,26969306,Africa,128,0
2020-04-29,Madagascar,MG,0,0,26969306,Africa,128,0
2020-04-30,Madagascar,MG,0,0,26969306,Africa,128,0
2020-05-01,Madagascar,MG,4,0,26969306,Africa,132,0
2020-05-02,Madagascar,MG,3,0,26969306,Africa,135,0
2020-05-03,Madagascar,MG,0,0,26969306,Africa,135,0
2020-05-04,Madagascar,MG,14,0,26969306,Africa,149,0
2020-05-05,Madagascar,MG,0,0,26969306,Africa,149,0
2020-05-06,Madagascar,MG,9,0,26969306,Africa,158,0
2020-05-07,Madagascar,MG,0,0,26969306,Africa,158,0
2020-05-08,Madagascar,MG,11,0,26969306,Africa,169,0
2020-05-09,Madagascar,MG,0,0,26969306,Africa,169,0
2020-05-10,Madagascar,MG,0,0,26969306,Africa,169,0
2020-05-11,Madagascar,MG,2,0,26969306,Africa,171,0
2020-05-12,Madagascar,MG,15,0,26969306,Africa,186,0
2020-05-13,Madagascar,MG,6,0,26969306,Africa,192,0
2020-05-14,Madagascar,MG,20,0,26969306,Africa,212,0
2020-05-15,Madagascar,MG,18,0,26969306,Africa,230,0
2020-05-16,Madagascar,MG,8,0,26969306,Africa,238,0
2020-05-17,Madagascar,MG,45,0,26969306,Africa,283,0
2020-05-18,Madagascar,MG,21,1,26969306,Africa,304,1
2020-05-19,Madagascar,MG,18,0,26969306,Africa,322,1
2020-05-20,Madagascar,MG,4,1,26969306,Africa,326,2
2020-05-21,Madagascar,MG,45,0,26969306,Africa,371,2
2020-05-22,Madagascar,MG,34,0,26969306,Africa,405,2
2020-05-23,Madagascar,MG,43,0,26969306,Africa,448,2
2020-05-24,Madagascar,MG,0,0,26969306,Africa,448,2
2020-05-25,Madagascar,MG,79,0,26969306,Africa,527,2
2020-05-26,Madagascar,MG,15,0,26969306,Africa,542,2
2020-05-27,Madagascar,MG,44,0,26969306,Africa,586,2
2020-05-28,Madagascar,MG,26,0,26969306,Africa,612,2
2020-05-29,Madagascar,MG,44,0,26969306,Africa,656,2
2020-05-30,Madagascar,MG,42,3,26969306,Africa,698,5
2020-05-31,Madagascar,MG,60,1,26969306,Africa,758,6
2020-06-01,Madagascar,MG,13,0,26969306,Africa,771,6
2020-06-02,Madagascar,MG,55,0,26969306,Africa,826,6
2020-06-03,Madagascar,MG,19,0,26969306,Africa,845,6
2020-06-04,Madagascar,MG,63,0,26969306,Africa,908,6
2020-06-05,Madagascar,MG,49,1,26969306,Africa,957,7
2020-06-06,Madagascar,MG,18,0,26969306,Africa,975,7
2020-06-07,Madagascar,MG,51,1,26969306,Africa,1026,8
2020-06-08,Madagascar,MG,26,1,26969306,Africa,1052,9
2020-06-09,Madagascar,MG,42,0,26969306,Africa,1094,9
2020-06-10,Madagascar,MG,44,0,26969306,Africa,1138,9
2020-06-11,Madagascar,MG,24,1,26969306,Africa,1162,10
2020-06-12,Madagascar,MG,41,0,26969306,Africa,1203,10
2020-06-13,Madagascar,MG,27,0,26969306,Africa,1230,10
2020-06-14,Madagascar,MG,22,0,26969306,Africa,1252,10
2020-06-15,Madagascar,MG,20,0,26969306,Africa,1272,10
2020-06-16,Madagascar,MG,18,0,26969306,Africa,1290,10
2020-06-17,Madagascar,MG,27,2,26969306,Africa,1317,12
2020-06-18,Madagascar,MG,61,0,26969306,Africa,1378,12
2020-06-19,Madagascar,MG,25,1,26969306,Africa,1403,13
2020-06-20,Madagascar,MG,40,0,26969306,Africa,1443,13
2020-06-21,Madagascar,MG,60,0,26969306,Africa,1503,13
2020-06-22,Madagascar,MG,93,1,26969306,Africa,1596,14
2020-06-23,Madagascar,MG,44,1,26969306,Africa,1640,15
2020-06-24,Madagascar,MG,84,0,26969306,Africa,1724,15
2020-06-25,Madagascar,MG,63,1,26969306,Africa,1787,16
2020-06-26,Madagascar,MG,42,0,26969306,Africa,1829,16
2020-06-27,Madagascar,MG,93,0,26969306,Africa,1922,16
2020-06-28,Madagascar,MG,83,0,26969306,Africa,2005,16
2020-06-29,Madagascar,MG,73,2,26969306,Africa,2078,18
2020-06-30,Madagascar,MG,60,2,26969306,Africa,2138,20
2020-07-01,Madagascar,MG,76,0,26969306,Africa,2214,20
2020-07-02,Madagascar,MG,89,2,26969306,Africa,2303,22
2020-07-03,Madagascar,MG,100,2,26969306,Africa,2403,24
2020-07-04,Madagascar,MG,109,2,26969306,Africa,2512,26
2020-07-05,Madagascar,MG,216,3,26969306,Africa,2728,29
2020-07-06,Madagascar,MG,0,0,26969306,Africa,2728,29
2020-07-07,Madagascar,MG,522,4,26969306,Africa,3250,33
2020-07-08,Madagascar,MG,222,0,26969306,Africa,3472,33
2020-07-09,Madagascar,MG,101,0,26969306,Africa,3573,33
2020-07-10,Madagascar,MG,209,0,26969306,Africa,3782,33
2020-07-11,Madagascar,MG,361,1,26969306,Africa,4143,34
2020-07-12,Madagascar,MG,435,0,26969306,Africa,4578,34
2020-07-13,Madagascar,MG,289,1,26969306,Africa,4867,35
2020-07-14,Madagascar,MG,213,2,26969306,Africa,5080,37
2020-07-15,Madagascar,MG,263,2,26969306,Africa,5343,39
2020-07-16,Madagascar,MG,262,4,26969306,Africa,5605,43
2020-07-17,Madagascar,MG,484,10,26969306,Africa,6089,53
2020-07-18,Madagascar,MG,378,1,26969306,Africa,6467,54
2020-07-19,Madagascar,MG,382,1,26969306,Africa,6849,55
2020-07-20,Madagascar,MG,200,4,26969306,Africa,7049,59
2020-07-21,Madagascar,MG,104,3,26969306,Africa,7153,62
2020-07-22,Madagascar,MG,395,3,26969306,Africa,7548,65
2020-07-23,Madagascar,MG,614,4,26969306,Africa,8162,69
2020-07-24,Madagascar,MG,219,1,26969306,Africa,8381,70
2020-07-25,Madagascar,MG,360,6,26969306,Africa,8741,76
2020-07-26,Madagascar,MG,125,2,26969306,Africa,8866,78
2020-07-27,Madagascar,MG,429,7,26969306,Africa,9295,85
2020-07-28,Madagascar,MG,395,6,26969306,Africa,9690,91
2020-07-29,Madagascar,MG,414,2,26969306,Africa,10104,93
2020-07-30,Madagascar,MG,213,6,26969306,Africa,10317,99
2020-07-31,Madagascar,MG,431,6,26969306,Africa,10748,105
2020-08-01,Madagascar,MG,120,1,26969306,Africa,10868,106
2020-08-02,Madagascar,MG,405,1,26969306,Africa,11273,107
2020-08-03,Madagascar,MG,255,7,26969306,Africa,11528,114
2020-08-04,Madagascar,MG,132,4,26969306,Africa,11660,118
2020-08-05,Madagascar,MG,235,5,26969306,Africa,11895,123
2020-08-06,Madagascar,MG,327,4,26969306,Africa,12222,127
2020-08-07,Madagascar,MG,304,7,26969306,Africa,12526,134
2020-08-08,Madagascar,MG,182,1,26969306,Africa,12708,135
2020-08-09,Madagascar,MG,214,6,26969306,Africa,12922,141
2020-08-10,Madagascar,MG,164,7,26969306,Africa,13086,148
2020-08-11,Madagascar,MG,116,3,26969306,Africa,13202,151
2020-08-12,Madagascar,MG,115,1,26969306,Africa,13317,152
2020-08-13,Madagascar,MG,80,4,26969306,Africa,13397,156
2020-08-14,Madagascar,MG,125,6,26969306,Africa,13522,162
2020-08-15,Madagascar,MG,121,2,26969306,Africa,13643,164
2020-08-16,Madagascar,MG,81,2,26969306,Africa,13724,166
2020-08-17,Madagascar,MG,103,4,26969306,Africa,13827,170
2020-08-18,Madagascar,MG,59,1,26969306,Africa,13886,171
2020-08-19,Madagascar,MG,123,2,26969306,Africa,14009,173
2020-08-20,Madagascar,MG,65,0,26969306,Africa,14074,173
2020-08-21,Madagascar,MG,80,4,26969306,Africa,14154,177
2020-08-22,Madagascar,MG,64,1,26969306,Africa,14218,178
2020-08-23,Madagascar,MG,59,0,26969306,Africa,14277,178
2020-08-24,Madagascar,MG,50,0,26969306,Africa,14327,178
2020-08-25,Madagascar,MG,75,0,26969306,Africa,14402,178
2020-08-26,Madagascar,MG,73,0,26969306,Africa,14475,178
2020-08-27,Madagascar,MG,79,3,26969306,Africa,14554,181
2020-08-28,Madagascar,MG,38,3,26969306,Africa,14592,184
2020-08-29,Madagascar,MG,104,3,26969306,Africa,14696,187
2020-08-30,Madagascar,MG,95,3,26969306,Africa,14791,190
2020-08-31,Madagascar,MG,52,1,26969306,Africa,14843,191
2020-09-01,Madagascar,MG,20,1,26969306,Africa,14863,192
2020-09-02,Madagascar,MG,94,3,26969306,Africa,14957,195
2020-09-03,Madagascar,MG,66,1,26969306,Africa,15023,196
2020-09-04,Madagascar,MG,83,1,26969306,Africa,15106,197
2020-09-05,Madagascar,MG,81,1,26969306,Africa,15187,198
2020-09-06,Madagascar,MG,82,1,26969306,Africa,15269,199
2020-09-07,Madagascar,MG,50,1,26969306,Africa,15319,200
2020-09-08,Madagascar,MG,33,2,26969306,Africa,15352,202
2020-09-09,Madagascar,MG,83,4,26969306,Africa,15435,206
2020-09-10,Madagascar,MG,85,0,26969306,Africa,15520,206
2020-09-11,Madagascar,MG,104,2,26969306,Africa,15624,208
2020-09-12,Madagascar,MG,45,1,26969306,Africa,15669,209
2020-09-13,Madagascar,MG,68,1,26969306,Africa,15737,210
2020-09-14,Madagascar,MG,20,1,26969306,Africa,15757,211
2020-09-15,Madagascar,MG,12,2,26969306,Africa,15769,213
2020-09-16,Madagascar,MG,34,1,26969306,Africa,15803,214
2020-09-17,Madagascar,MG,68,1,26969306,Africa,15871,215
2020-09-18,Madagascar,MG,0,0,26969306,Africa,15871,215
2020-09-19,Madagascar,MG,100,2,26969306,Africa,15971,217
2020-09-20,Madagascar,MG,49,2,26969306,Africa,16020,219
2020-09-21,Madagascar,MG,33,4,26969306,Africa,16053,223
2020-09-22,Madagascar,MG,20,2,26969306,Africa,16073,225
2020-09-23,Madagascar,MG,63,1,26969306,Africa,16136,226
2020-09-24,Madagascar,MG,31,0,26969306,Africa,16167,226
2020-09-25,Madagascar,MG,24,1,26969306,Africa,16191,227
2020-09-26,Madagascar,MG,30,1,26969306,Africa,16221,228
2020-09-27,Madagascar,MG,36,1,26969306,Africa,16257,229
2020-09-28,Madagascar,MG,28,0,26969306,Africa,16285,229
2020-09-29,Madagascar,MG,63,0,26969306,Africa,16348,229
2020-09-30,Madagascar,MG,29,0,26969306,Africa,16377,229
2020-10-01,Madagascar,MG,31,1,26969306,Africa,16408,230
2020-10-02,Madagascar,MG,46,2,26969306,Africa,16454,232
2020-10-03,Madagascar,MG,39,0,26969306,Africa,16493,232
2020-10-04,Madagascar,MG,36,0,26969306,Africa,16529,232
2020-10-05,Madagascar,MG,29,0,26969306,Africa,16558,232
2020-10-06,Madagascar,MG,12,1,26969306,Africa,16570,233
2020-10-07,Madagascar,MG,30,1,26969306,Africa,16600,234
2020-10-08,Madagascar,MG,33,1,26969306,Africa,16633,235
2020-10-09,Madagascar,MG,21,0,26969306,Africa,16654,235
2020-10-10,Madagascar,MG,22,2,26969306,Africa,16676,237
2020-10-11,Madagascar,MG,26,0,26969306,Africa,16702,237
2020-10-12,Madagascar,MG,16,0,26969306,Africa,16718,237
2020-10-13,Madagascar,MG,8,0,26969306,Africa,16726,237
2020-10-14,Madagascar,MG,28,0,26969306,Africa,16754,237
2020-10-15,Madagascar,MG,0,0,26969306,Africa,16754,237
2020-10-16,Madagascar,MG,0,0,26969306,Africa,16754,237
2020-10-17,Madagascar,MG,0,0,26969306,Africa,16754,237
2020-10-18,Madagascar,MG,56,1,26969306,Africa,16810,238
2020-10-19,Madagascar,MG,0,0,26969306,Africa,16810,238
2020-10-20,Madagascar,MG,0,0,26969306,Africa,16810,238
2020-10-21,Madagascar,MG,0,0,26969306,Africa,16810,238
2020-10-22,Madagascar,MG,0,0,26969306,Africa,16810,238
2020-10-23,Madagascar,MG,0,0,26969306,Africa,16810,238
2020-10-24,Madagascar,MG,0,0,26969306,Africa,16810,238
2020-10-25,Madagascar,MG,158,6,26969306,Africa,16968,244
2020-10-26,Madagascar,MG,0,0,26969306,Africa,16968,244
2020-10-27,Madagascar,MG,0,0,26969306,Africa,16968,244
2020-10-28,Madagascar,MG,0,0,26969306,Africa,16968,244
2020-10-29,Madagascar,MG,0,0,26969306,Africa,16968,244
2020-10-30,Madagascar,MG,0,0,26969306,Africa,16968,244
2020-10-31,Madagascar,MG,0,0,26969306,Africa,16968,244
2020-11-01,Madagascar,MG,0,0,26969306,Africa,16968,244
2020-11-02,Madagascar,MG,143,0,26969306,Africa,17111,244
2020-11-03,Madagascar,MG,0,0,26969306,Africa,17111,244
2020-11-04,Madagascar,MG,0,0,26969306,Africa,17111,244
2020-11-05,Madagascar,MG,0,0,26969306,Africa,17111,244
2020-11-06,Madagascar,MG,0,0,26969306,Africa,17111,244
2020-11-07,Madagascar,MG,102,5,26969306,Africa,17213,249
2020-11-08,Madagascar,MG,0,0,26969306,Africa,17213,249
2020-11-09,Madagascar,MG,10,0,26969306,Africa,17223,249
2020-11-10,Madagascar,MG,0,0,26969306,Africa,17223,249
2020-11-11,Madagascar,MG,0,0,26969306,Africa,17223,249
2020-11-12,Madagascar,MG,0,0,26969306,Africa,17223,249
2020-11-13,Madagascar,MG,0,0,26969306,Africa,17223,249
2020-11-14,Madagascar,MG,10,0,26969306,Africa,17233,249
2020-11-15,Madagascar,MG,0,0,26969306,Africa,17233,249
2020-11-16,Madagascar,MG,0,0,26969306,Africa,17233,249
2020-11-17,Madagascar,MG,0,0,26969306,Africa,17233,249
2020-11-18,Madagascar,MG,0,0,26969306,Africa,17233,249
2020-11-19,Madagascar,MG,0,0,26969306,Africa,17233,249
2020-11-20,Madagascar,MG,0,0,26969306,Africa,17233,249
2020-11-21,Madagascar,MG,0,0,26969306,Africa,17233,249
2020-11-22,Madagascar,MG,77,1,26969306,Africa,17310,250
2020-11-23,Madagascar,MG,31,1,26969306,Africa,17341,251
2020-11-24,Madagascar,MG,0,0,26969306,Africa,17341,251
2020-11-25,Madagascar,MG,0,0,26969306,Africa,17341,251
2020-11-26,Madagascar,MG,0,0,26969306,Africa,17341,251
2020-11-27,Madagascar,MG,0,0,26969306,Africa,17341,251
2020-11-28,Madagascar,MG,0,0,26969306,Africa,17341,251
2020-11-29,Madagascar,MG,0,0,26969306,Africa,17341,251
2020-11-30,Madagascar,MG,0,0,26969306,Africa,17341,251
2020-12-01,Madagascar,MG,0,0,26969306,Africa,17341,251
2020-12-02,Madagascar,MG,0,0,26969306,Africa,17341,251
2020-12-03,Madagascar,MG,0,0,26969306,Africa,17341,251
2020-12-04,Madagascar,MG,172,4,26969306,Africa,17513,255
2020-12-05,Madagascar,MG,0,0,26969306,Africa,17513,255
2020-12-06,Madagascar,MG,0,0,26969306,Africa,17513,255
2020-12-07,Madagascar,MG,0,0,26969306,Africa,17513,255
2020-12-08,Madagascar,MG,0,0,26969306,Africa,17513,255
2020-12-09,Madagascar,MG,0,0,26969306,Africa,17513,255
2020-12-10,Madagascar,MG,125,3,26969306,Africa,17638,258
2020-12-11,Madagascar,MG,0,0,26969306,Africa,17638,258
2020-12-12,Madagascar,MG,0,0,26969306,Africa,17638,258
2020-12-13,Madagascar,MG,0,0,26969306,Africa,17638,258
2020-12-14,Madagascar,MG,0,0,26969306,Africa,17638,258
2020-10-29,Marshall_Islands,MH,1,0,58791,Oceania,1,0
2020-10-30,Marshall_Islands,MH,0,0,58791,Oceania,1,0
2020-10-31,Marshall_Islands,MH,0,0,58791,Oceania,1,0
2020-11-01,Marshall_Islands,MH,0,0,58791,Oceania,1,0
2020-11-02,Marshall_Islands,MH,0,0,58791,Oceania,1,0
2020-11-03,Marshall_Islands,MH,0,0,58791,Oceania,1,0
2020-11-04,Marshall_Islands,MH,0,0,58791,Oceania,1,0
2020-11-05,Marshall_Islands,MH,0,0,58791,Oceania,1,0
2020-11-06,Marshall_Islands,MH,0,0,58791,Oceania,1,0
2020-11-07,Marshall_Islands,MH,0,0,58791,Oceania,1,0
2020-11-08,Marshall_Islands,MH,0,0,58791,Oceania,1,0
2020-11-09,Marshall_Islands,MH,0,0,58791,Oceania,1,0
2020-11-10,Marshall_Islands,MH,0,0,58791,Oceania,1,0
2020-11-11,Marshall_Islands,MH,0,0,58791,Oceania,1,0
2020-11-12,Marshall_Islands,MH,0,0,58791,Oceania,1,0
2020-11-13,Marshall_Islands,MH,0,0,58791,Oceania,1,0
2020-11-14,Marshall_Islands,MH,0,0,58791,Oceania,1,0
2020-11-15,Marshall_Islands,MH,0,0,58791,Oceania,1,0
2020-11-16,Marshall_Islands,MH,0,0,58791,Oceania,1,0
2020-11-17,Marshall_Islands,MH,0,0,58791,Oceania,1,0
2020-11-18,Marshall_Islands,MH,3,0,58791,Oceania,4,0
2020-11-19,Marshall_Islands,MH,0,0,58791,Oceania,4,0
2020-11-20,Marshall_Islands,MH,0,0,58791,Oceania,4,0
2020-11-21,Marshall_Islands,MH,0,0,58791,Oceania,4,0
2020-11-22,Marshall_Islands,MH,0,0,58791,Oceania,4,0
2020-11-23,Marshall_Islands,MH,0,0,58791,Oceania,4,0
2020-11-24,Marshall_Islands,MH,0,0,58791,Oceania,4,0
2020-11-25,Marshall_Islands,MH,0,0,58791,Oceania,4,0
2020-11-26,Marshall_Islands,MH,0,0,58791,Oceania,4,0
2020-11-27,Marshall_Islands,MH,0,0,58791,Oceania,4,0
2020-11-28,Marshall_Islands,MH,0,0,58791,Oceania,4,0
2020-11-29,Marshall_Islands,MH,0,0,58791,Oceania,4,0
2020-11-30,Marshall_Islands,MH,0,0,58791,Oceania,4,0
2020-12-01,Marshall_Islands,MH,0,0,58791,Oceania,4,0
2020-12-02,Marshall_Islands,MH,0,0,58791,Oceania,4,0
2020-12-03,Marshall_Islands,MH,0,0,58791,Oceania,4,0
2020-12-04,Marshall_Islands,MH,0,0,58791,Oceania,4,0
2020-12-05,Marshall_Islands,MH,0,0,58791,Oceania,4,0
2020-12-06,Marshall_Islands,MH,0,0,58791,Oceania,4,0
2020-12-07,Marshall_Islands,MH,0,0,58791,Oceania,4,0
2020-12-08,Marshall_Islands,MH,0,0,58791,Oceania,4,0
2020-12-09,Marshall_Islands,MH,0,0,58791,Oceania,4,0
2020-12-10,Marshall_Islands,MH,0,0,58791,Oceania,4,0
2020-12-11,Marshall_Islands,MH,0,0,58791,Oceania,4,0
2020-12-12,Marshall_Islands,MH,0,0,58791,Oceania,4,0
2020-12-13,Marshall_Islands,MH,0,0,58791,Oceania,4,0
2020-12-14,Marshall_Islands,MH,0,0,58791,Oceania,4,0
2019-12-31,North_Macedonia,MK,0,0,2077132,Europe,0,0
2020-01-01,North_Macedonia,MK,0,0,2077132,Europe,0,0
2020-01-02,North_Macedonia,MK,0,0,2077132,Europe,0,0
2020-01-03,North_Macedonia,MK,0,0,2077132,Europe,0,0
2020-01-04,North_Macedonia,MK,0,0,2077132,Europe,0,0
2020-01-05,North_Macedonia,MK,0,0,2077132,Europe,0,0
2020-01-06,North_Macedonia,MK,0,0,2077132,Europe,0,0
2020-01-07,North_Macedonia,MK,0,0,2077132,Europe,0,0
2020-01-08,North_Macedonia,MK,0,0,2077132,Europe,0,0
2020-01-09,North_Macedonia,MK,0,0,2077132,Europe,0,0
2020-01-10,North_Macedonia,MK,0,0,2077132,Europe,0,0
2020-01-11,North_Macedonia,MK,0,0,2077132,Europe,0,0
2020-01-12,North_Macedonia,MK,0,0,2077132,Europe,0,0
2020-01-13,North_Macedonia,MK,0,0,2077132,Europe,0,0
2020-01-14,North_Macedonia,MK,0,0,2077132,Europe,0,0
2020-01-15,North_Macedonia,MK,0,0,2077132,Europe,0,0
2020-01-16,North_Macedonia,MK,0,0,2077132,Europe,0,0
2020-01-17,North_Macedonia,MK,0,0,2077132,Europe,0,0
2020-01-18,North_Macedonia,MK,0,0,2077132,Europe,0,0
2020-01-19,North_Macedonia,MK,0,0,2077132,Europe,0,0
2020-01-20,North_Macedonia,MK,0,0,2077132,Europe,0,0
2020-01-21,North_Macedonia,MK,0,0,2077132,Europe,0,0
2020-01-22,North_Macedonia,MK,0,0,2077132,Europe,0,0
2020-01-23,North_Macedonia,MK,0,0,2077132,Europe,0,0
2020-01-24,North_Macedonia,MK,0,0,2077132,Europe,0,0
2020-01-25,North_Macedonia,MK,0,0,2077132,Europe,0,0
2020-01-26,North_Macedonia,MK,0,0,2077132,Europe,0,0
2020-01-27,North_Macedonia,MK,0,0,2077132,Europe,0,0
2020-01-28,North_Macedonia,MK,0,0,2077132,Europe,0,0
2020-01-29,North_Macedonia,MK,0,0,2077132,Europe,0,0
2020-01-30,North_Macedonia,MK,0,0,2077132,Europe,0,0
2020-01-31,North_Macedonia,MK,0,0,2077132,Europe,0,0
2020-02-01,North_Macedonia,MK,0,0,2077132,Europe,0,0
2020-02-02,North_Macedonia,MK,0,0,2077132,Europe,0,0
2020-02-03,North_Macedonia,MK,0,0,2077132,Europe,0,0
2020-02-04,North_Macedonia,MK,0,0,2077132,Europe,0,0
2020-02-05,North_Macedonia,MK,0,0,2077132,Europe,0,0
2020-02-06,North_Macedonia,MK,0,0,2077132,Europe,0,0
2020-02-07,North_Macedonia,MK,0,0,2077132,Europe,0,0
2020-02-08,North_Macedonia,MK,0,0,2077132,Europe,0,0
2020-02-09,North_Macedonia,MK,0,0,2077132,Europe,0,0
2020-02-10,North_Macedonia,MK,0,0,2077132,Europe,0,0
2020-02-11,North_Macedonia,MK,0,0,2077132,Europe,0,0
2020-02-12,North_Macedonia,MK,0,0,2077132,Europe,0,0
2020-02-13,North_Macedonia,MK,0,0,2077132,Europe,0,0
2020-02-14,North_Macedonia,MK,0,0,2077132,Europe,0,0
2020-02-15,North_Macedonia,MK,0,0,2077132,Europe,0,0
2020-02-16,North_Macedonia,MK,0,0,2077132,Europe,0,0
2020-02-17,North_Macedonia,MK,0,0,2077132,Europe,0,0
2020-02-18,North_Macedonia,MK,0,0,2077132,Europe,0,0
2020-02-19,North_Macedonia,MK,0,0,2077132,Europe,0,0
2020-02-20,North_Macedonia,MK,0,0,2077132,Europe,0,0
2020-02-21,North_Macedonia,MK,0,0,2077132,Europe,0,0
2020-02-22,North_Macedonia,MK,0,0,2077132,Europe,0,0
2020-02-23,North_Macedonia,MK,0,0,2077132,Europe,0,0
2020-02-24,North_Macedonia,MK,0,0,2077132,Europe,0,0
2020-02-25,North_Macedonia,MK,0,0,2077132,Europe,0,0
2020-02-26,North_Macedonia,MK,0,0,2077132,Europe,0,0
2020-02-27,North_Macedonia,MK,1,0,2077132,Europe,1,0
2020-02-28,North_Macedonia,MK,0,0,2077132,Europe,1,0
2020-02-29,North_Macedonia,MK,0,0,2077132,Europe,1,0
2020-03-01,North_Macedonia,MK,0,0,2077132,Europe,1,0
2020-03-02,North_Macedonia,MK,0,0,2077132,Europe,1,0
2020-03-07,North_Macedonia,MK,2,0,2077132,Europe,3,0
2020-03-11,North_Macedonia,MK,4,0,2077132,Europe,7,0
2020-03-13,North_Macedonia,MK,2,0,2077132,Europe,9,0
2020-03-14,North_Macedonia,MK,4,0,2077132,Europe,13,0
2020-03-16,North_Macedonia,MK,0,0,2077132,Europe,13,0
2020-03-17,North_Macedonia,MK,6,0,2077132,Europe,19,0
2020-03-18,North_Macedonia,MK,12,0,2077132,Europe,31,0
2020-03-19,North_Macedonia,MK,11,0,2077132,Europe,42,0
2020-03-20,North_Macedonia,MK,6,0,2077132,Europe,48,0
2020-03-21,North_Macedonia,MK,22,0,2077132,Europe,70,0
2020-03-22,North_Macedonia,MK,15,0,2077132,Europe,85,0
2020-03-23,North_Macedonia,MK,29,1,2077132,Europe,114,1
2020-03-24,North_Macedonia,MK,22,1,2077132,Europe,136,2
2020-03-25,North_Macedonia,MK,12,0,2077132,Europe,148,2
2020-03-26,North_Macedonia,MK,29,0,2077132,Europe,177,2
2020-03-27,North_Macedonia,MK,24,1,2077132,Europe,201,3
2020-03-28,North_Macedonia,MK,18,0,2077132,Europe,219,3
2020-03-29,North_Macedonia,MK,22,1,2077132,Europe,241,4
2020-03-30,North_Macedonia,MK,18,2,2077132,Europe,259,6
2020-03-31,North_Macedonia,MK,26,1,2077132,Europe,285,7
2020-04-01,North_Macedonia,MK,44,2,2077132,Europe,329,9
2020-04-02,North_Macedonia,MK,25,1,2077132,Europe,354,10
2020-04-03,North_Macedonia,MK,0,1,2077132,Europe,354,11
2020-04-04,North_Macedonia,MK,76,1,2077132,Europe,430,12
2020-04-05,North_Macedonia,MK,53,5,2077132,Europe,483,17
2020-04-06,North_Macedonia,MK,0,0,2077132,Europe,483,17
2020-04-07,North_Macedonia,MK,87,4,2077132,Europe,570,21
2020-04-08,North_Macedonia,MK,29,5,2077132,Europe,599,26
2020-04-09,North_Macedonia,MK,18,4,2077132,Europe,617,30
2020-04-10,North_Macedonia,MK,46,2,2077132,Europe,663,32
2020-04-11,North_Macedonia,MK,48,0,2077132,Europe,711,32
2020-04-12,North_Macedonia,MK,49,2,2077132,Europe,760,34
2020-04-13,North_Macedonia,MK,68,0,2077132,Europe,828,34
2020-04-14,North_Macedonia,MK,26,4,2077132,Europe,854,38
2020-04-15,North_Macedonia,MK,54,6,2077132,Europe,908,44
2020-04-16,North_Macedonia,MK,66,1,2077132,Europe,974,45
2020-04-17,North_Macedonia,MK,107,1,2077132,Europe,1081,46
2020-04-18,North_Macedonia,MK,36,3,2077132,Europe,1117,49
2020-04-19,North_Macedonia,MK,53,0,2077132,Europe,1170,49
2020-04-20,North_Macedonia,MK,37,2,2077132,Europe,1207,51
2020-04-21,North_Macedonia,MK,18,3,2077132,Europe,1225,54
2020-04-22,North_Macedonia,MK,6,1,2077132,Europe,1231,55
2020-04-23,North_Macedonia,MK,28,1,2077132,Europe,1259,56
2020-04-24,North_Macedonia,MK,41,0,2077132,Europe,1300,56
2020-04-25,North_Macedonia,MK,26,1,2077132,Europe,1326,57
2020-04-26,North_Macedonia,MK,41,2,2077132,Europe,1367,59
2020-04-27,North_Macedonia,MK,19,2,2077132,Europe,1386,61
2020-04-28,North_Macedonia,MK,13,4,2077132,Europe,1399,65
2020-04-29,North_Macedonia,MK,22,6,2077132,Europe,1421,71
2020-04-30,North_Macedonia,MK,21,2,2077132,Europe,1442,73
2020-05-01,North_Macedonia,MK,23,4,2077132,Europe,1465,77
2020-05-02,North_Macedonia,MK,29,4,2077132,Europe,1494,81
2020-05-03,North_Macedonia,MK,12,1,2077132,Europe,1506,82
2020-05-04,North_Macedonia,MK,5,2,2077132,Europe,1511,84
2020-05-05,North_Macedonia,MK,7,1,2077132,Europe,1518,85
2020-05-06,North_Macedonia,MK,8,1,2077132,Europe,1526,86
2020-05-07,North_Macedonia,MK,13,2,2077132,Europe,1539,88
2020-05-08,North_Macedonia,MK,33,1,2077132,Europe,1572,89
2020-05-09,North_Macedonia,MK,14,1,2077132,Europe,1586,90
2020-05-10,North_Macedonia,MK,36,1,2077132,Europe,1622,91
2020-05-11,North_Macedonia,MK,20,0,2077132,Europe,1642,91
2020-05-12,North_Macedonia,MK,22,0,2077132,Europe,1664,91
2020-05-13,North_Macedonia,MK,10,1,2077132,Europe,1674,92
2020-05-14,North_Macedonia,MK,20,3,2077132,Europe,1694,95
2020-05-15,North_Macedonia,MK,29,0,2077132,Europe,1723,95
2020-05-16,North_Macedonia,MK,17,2,2077132,Europe,1740,97
2020-05-17,North_Macedonia,MK,22,1,2077132,Europe,1762,98
2020-05-18,North_Macedonia,MK,30,3,2077132,Europe,1792,101
2020-05-19,North_Macedonia,MK,25,3,2077132,Europe,1817,104
2020-05-20,North_Macedonia,MK,22,2,2077132,Europe,1839,106
2020-05-21,North_Macedonia,MK,19,4,2077132,Europe,1858,110
2020-05-22,North_Macedonia,MK,40,1,2077132,Europe,1898,111
2020-05-23,North_Macedonia,MK,23,1,2077132,Europe,1921,112
2020-05-24,North_Macedonia,MK,20,1,2077132,Europe,1941,113
2020-05-25,North_Macedonia,MK,37,0,2077132,Europe,1978,113
2020-05-26,North_Macedonia,MK,21,0,2077132,Europe,1999,113
2020-05-27,North_Macedonia,MK,16,3,2077132,Europe,2015,116
2020-05-28,North_Macedonia,MK,25,3,2077132,Europe,2040,119
2020-05-29,North_Macedonia,MK,38,3,2077132,Europe,2078,122
2020-05-30,North_Macedonia,MK,52,4,2077132,Europe,2130,126
2020-05-31,North_Macedonia,MK,34,5,2077132,Europe,2164,131
2020-06-01,North_Macedonia,MK,62,2,2077132,Europe,2226,133
2020-06-02,North_Macedonia,MK,89,7,2077132,Europe,2315,140
2020-06-03,North_Macedonia,MK,76,1,2077132,Europe,2391,141
2020-06-04,North_Macedonia,MK,101,4,2077132,Europe,2492,145
2020-06-05,North_Macedonia,MK,120,2,2077132,Europe,2612,147
2020-06-06,North_Macedonia,MK,180,2,2077132,Europe,2792,149
2020-06-07,North_Macedonia,MK,125,2,2077132,Europe,2917,151
2020-06-08,North_Macedonia,MK,111,2,2077132,Europe,3028,153
2020-06-09,North_Macedonia,MK,127,3,2077132,Europe,3155,156
2020-06-10,North_Macedonia,MK,87,1,2077132,Europe,3242,157
2020-06-11,North_Macedonia,MK,125,7,2077132,Europe,3367,164
2020-06-12,North_Macedonia,MK,175,5,2077132,Europe,3542,169
2020-06-13,North_Macedonia,MK,164,2,2077132,Europe,3706,171
2020-06-14,North_Macedonia,MK,196,8,2077132,Europe,3902,179
2020-06-15,North_Macedonia,MK,155,9,2077132,Europe,4057,188
2020-06-16,North_Macedonia,MK,100,5,2077132,Europe,4157,193
2020-06-17,North_Macedonia,MK,132,8,2077132,Europe,4289,201
2020-06-18,North_Macedonia,MK,193,9,2077132,Europe,4482,210
2020-06-19,North_Macedonia,MK,182,6,2077132,Europe,4664,216
2020-06-20,North_Macedonia,MK,156,6,2077132,Europe,4820,222
2020-06-21,North_Macedonia,MK,185,11,2077132,Europe,5005,233
2020-06-22,North_Macedonia,MK,101,5,2077132,Europe,5106,238
2020-06-23,North_Macedonia,MK,90,9,2077132,Europe,5196,247
2020-06-24,North_Macedonia,MK,118,4,2077132,Europe,5314,251
2020-06-25,North_Macedonia,MK,136,8,2077132,Europe,5450,259
2020-06-26,North_Macedonia,MK,153,6,2077132,Europe,5603,265
2020-06-27,North_Macedonia,MK,163,3,2077132,Europe,5766,268
2020-06-28,North_Macedonia,MK,150,9,2077132,Europe,5916,277
2020-06-29,North_Macedonia,MK,176,9,2077132,Europe,6092,286
2020-06-30,North_Macedonia,MK,132,12,2077132,Europe,6224,298
2020-07-01,North_Macedonia,MK,126,4,2077132,Europe,6350,302
2020-07-02,North_Macedonia,MK,120,4,2077132,Europe,6470,306
2020-07-03,North_Macedonia,MK,173,15,2077132,Europe,6643,321
2020-07-04,North_Macedonia,MK,0,0,2077132,Europe,6643,321
2020-07-05,North_Macedonia,MK,289,13,2077132,Europe,6932,334
2020-07-06,North_Macedonia,MK,114,7,2077132,Europe,7046,341
2020-07-07,North_Macedonia,MK,76,5,2077132,Europe,7122,346
2020-07-08,North_Macedonia,MK,118,5,2077132,Europe,7240,351
2020-07-09,North_Macedonia,MK,161,8,2077132,Europe,7401,359
2020-07-10,North_Macedonia,MK,166,2,2077132,Europe,7567,361
2020-07-11,North_Macedonia,MK,203,6,2077132,Europe,7770,367
2020-07-12,North_Macedonia,MK,197,8,2077132,Europe,7967,375
2020-07-13,North_Macedonia,MK,144,7,2077132,Europe,8111,382
2020-07-14,North_Macedonia,MK,86,3,2077132,Europe,8197,385
2020-07-15,North_Macedonia,MK,131,4,2077132,Europe,8328,389
2020-07-16,North_Macedonia,MK,194,4,2077132,Europe,8522,393
2020-07-17,North_Macedonia,MK,90,8,2077132,Europe,8612,401
2020-07-18,North_Macedonia,MK,160,5,2077132,Europe,8772,406
2020-07-19,North_Macedonia,MK,237,8,2077132,Europe,9009,414
2020-07-20,North_Macedonia,MK,123,8,2077132,Europe,9132,422
2020-07-21,North_Macedonia,MK,117,10,2077132,Europe,9249,432
2020-07-22,North_Macedonia,MK,163,0,2077132,Europe,9412,432
2020-07-23,North_Macedonia,MK,135,10,2077132,Europe,9547,442
2020-07-24,North_Macedonia,MK,122,3,2077132,Europe,9669,445
2020-07-25,North_Macedonia,MK,128,6,2077132,Europe,9797,451
2020-07-26,North_Macedonia,MK,137,9,2077132,Europe,9934,460
2020-07-27,North_Macedonia,MK,152,0,2077132,Europe,10086,460
2020-07-28,North_Macedonia,MK,128,6,2077132,Europe,10214,466
2020-07-29,North_Macedonia,MK,102,5,2077132,Europe,10316,471
2020-07-30,North_Macedonia,MK,188,5,2077132,Europe,10504,476
2020-07-31,North_Macedonia,MK,119,4,2077132,Europe,10623,480
2020-08-01,North_Macedonia,MK,139,6,2077132,Europe,10762,486
2020-08-02,North_Macedonia,MK,138,7,2077132,Europe,10900,493
2020-08-03,North_Macedonia,MK,154,4,2077132,Europe,11054,497
2020-08-04,North_Macedonia,MK,86,3,2077132,Europe,11140,500
2020-08-05,North_Macedonia,MK,0,0,2077132,Europe,11140,500
2020-08-06,North_Macedonia,MK,61,5,2077132,Europe,11201,505
2020-08-07,North_Macedonia,MK,88,6,2077132,Europe,11289,511
2020-08-08,North_Macedonia,MK,282,8,2077132,Europe,11571,519
2020-08-09,North_Macedonia,MK,200,4,2077132,Europe,11771,523
2020-08-10,North_Macedonia,MK,85,4,2077132,Europe,11856,527
2020-08-11,North_Macedonia,MK,109,1,2077132,Europe,11965,528
2020-08-12,North_Macedonia,MK,0,0,2077132,Europe,11965,528
2020-08-13,North_Macedonia,MK,252,2,2077132,Europe,12217,530
2020-08-14,North_Macedonia,MK,140,2,2077132,Europe,12357,532
2020-08-15,North_Macedonia,MK,189,3,2077132,Europe,12546,535
2020-08-16,North_Macedonia,MK,107,4,2077132,Europe,12653,539
2020-08-17,North_Macedonia,MK,86,5,2077132,Europe,12739,544
2020-08-18,North_Macedonia,MK,35,1,2077132,Europe,12774,545
2020-08-19,North_Macedonia,MK,103,3,2077132,Europe,12877,548
2020-08-20,North_Macedonia,MK,108,2,2077132,Europe,12985,550
2020-08-21,North_Macedonia,MK,0,0,2077132,Europe,12985,550
2020-08-22,North_Macedonia,MK,233,6,2077132,Europe,13218,556
2020-08-23,North_Macedonia,MK,0,0,2077132,Europe,13218,556
2020-08-24,North_Macedonia,MK,296,7,2077132,Europe,13514,563
2020-08-25,North_Macedonia,MK,81,1,2077132,Europe,13595,564
2020-08-26,North_Macedonia,MK,78,4,2077132,Europe,13673,568
2020-08-27,North_Macedonia,MK,126,5,2077132,Europe,13799,573
2020-08-28,North_Macedonia,MK,128,11,2077132,Europe,13927,584
2020-08-29,North_Macedonia,MK,0,0,2077132,Europe,13927,584
2020-08-30,North_Macedonia,MK,0,0,2077132,Europe,13927,584
2020-08-31,North_Macedonia,MK,0,0,2077132,Europe,13927,584
2020-09-01,North_Macedonia,MK,403,16,2077132,Europe,14330,600
2020-09-02,North_Macedonia,MK,11,3,2077132,Europe,14341,603
2020-09-03,North_Macedonia,MK,114,1,2077132,Europe,14455,604
2020-09-04,North_Macedonia,MK,145,2,2077132,Europe,14600,606
2020-09-05,North_Macedonia,MK,162,0,2077132,Europe,14762,606
2020-09-06,North_Macedonia,MK,0,0,2077132,Europe,14762,606
2020-09-07,North_Macedonia,MK,0,0,2077132,Europe,14762,606
2020-09-08,North_Macedonia,MK,328,11,2077132,Europe,15090,617
2020-09-09,North_Macedonia,MK,37,6,2077132,Europe,15127,623
2020-09-10,North_Macedonia,MK,99,8,2077132,Europe,15226,631
2020-09-11,North_Macedonia,MK,67,3,2077132,Europe,15293,634
2020-09-12,North_Macedonia,MK,121,3,2077132,Europe,15414,637
2020-09-13,North_Macedonia,MK,141,5,2077132,Europe,15555,642
2020-09-14,North_Macedonia,MK,139,4,2077132,Europe,15694,646
2020-09-15,North_Macedonia,MK,97,2,2077132,Europe,15791,648
2020-09-16,North_Macedonia,MK,134,13,2077132,Europe,15925,661
2020-09-17,North_Macedonia,MK,163,7,2077132,Europe,16088,668
2020-09-18,North_Macedonia,MK,186,7,2077132,Europe,16274,675
2020-09-19,North_Macedonia,MK,143,8,2077132,Europe,16417,683
2020-09-20,North_Macedonia,MK,140,6,2077132,Europe,16557,689
2020-09-21,North_Macedonia,MK,178,4,2077132,Europe,16735,693
2020-09-22,North_Macedonia,MK,45,7,2077132,Europe,16780,700
2020-09-23,North_Macedonia,MK,87,5,2077132,Europe,16867,705
2020-09-24,North_Macedonia,MK,182,5,2077132,Europe,17049,710
2020-09-25,North_Macedonia,MK,151,2,2077132,Europe,17200,712
2020-09-26,North_Macedonia,MK,143,9,2077132,Europe,17343,721
2020-09-27,North_Macedonia,MK,140,1,2077132,Europe,17483,722
2020-09-28,North_Macedonia,MK,146,3,2077132,Europe,17629,725
2020-09-29,North_Macedonia,MK,45,4,2077132,Europe,17674,729
2020-09-30,North_Macedonia,MK,112,8,2077132,Europe,17786,737
2020-10-01,North_Macedonia,MK,191,2,2077132,Europe,17977,739
2020-10-02,North_Macedonia,MK,161,4,2077132,Europe,18138,743
2020-10-03,North_Macedonia,MK,225,6,2077132,Europe,18363,749
2020-10-04,North_Macedonia,MK,239,4,2077132,Europe,18602,753
2020-10-05,North_Macedonia,MK,0,0,2077132,Europe,18602,753
2020-10-06,North_Macedonia,MK,271,7,2077132,Europe,18873,760
2020-10-07,North_Macedonia,MK,224,8,2077132,Europe,19097,768
2020-10-08,North_Macedonia,MK,316,4,2077132,Europe,19413,772
2020-10-09,North_Macedonia,MK,364,3,2077132,Europe,19777,775
2020-10-10,North_Macedonia,MK,386,6,2077132,Europe,20163,781
2020-10-11,North_Macedonia,MK,392,4,2077132,Europe,20555,785
2020-10-12,North_Macedonia,MK,382,7,2077132,Europe,20937,792
2020-10-13,North_Macedonia,MK,176,5,2077132,Europe,21113,797
2020-10-14,North_Macedonia,MK,80,3,2077132,Europe,21193,800
2020-10-15,North_Macedonia,MK,443,9,2077132,Europe,21636,809
2020-10-16,North_Macedonia,MK,534,6,2077132,Europe,22170,815
2020-10-17,North_Macedonia,MK,437,6,2077132,Europe,22607,821
2020-10-18,North_Macedonia,MK,594,3,2077132,Europe,23201,824
2020-10-19,North_Macedonia,MK,427,10,2077132,Europe,23628,834
2020-10-20,North_Macedonia,MK,160,12,2077132,Europe,23788,846
2020-10-21,North_Macedonia,MK,408,4,2077132,Europe,24196,850
2020-10-22,North_Macedonia,MK,640,12,2077132,Europe,24836,862
2020-10-23,North_Macedonia,MK,637,12,2077132,Europe,25473,874
2020-10-24,North_Macedonia,MK,518,9,2077132,Europe,25991,883
2020-10-25,North_Macedonia,MK,403,14,2077132,Europe,26394,897
2020-10-26,North_Macedonia,MK,560,22,2077132,Europe,26954,919
2020-10-27,North_Macedonia,MK,245,14,2077132,Europe,27199,933
2020-10-28,North_Macedonia,MK,0,0,2077132,Europe,27199,933
2020-10-29,North_Macedonia,MK,1498,30,2077132,Europe,28697,963
2020-10-30,North_Macedonia,MK,861,14,2077132,Europe,29558,977
2020-10-31,North_Macedonia,MK,890,5,2077132,Europe,30448,982
2020-11-01,North_Macedonia,MK,1124,12,2077132,Europe,31572,994
2020-11-02,North_Macedonia,MK,864,10,2077132,Europe,32436,1004
2020-11-03,North_Macedonia,MK,561,21,2077132,Europe,32997,1025
2020-11-04,North_Macedonia,MK,911,24,2077132,Europe,33908,1049
2020-11-05,North_Macedonia,MK,1189,22,2077132,Europe,35097,1071
2020-11-06,North_Macedonia,MK,1275,13,2077132,Europe,36372,1084
2020-11-07,North_Macedonia,MK,1127,12,2077132,Europe,37499,1096
2020-11-08,North_Macedonia,MK,1283,14,2077132,Europe,38782,1110
2020-11-09,North_Macedonia,MK,978,26,2077132,Europe,39760,1136
2020-11-10,North_Macedonia,MK,515,20,2077132,Europe,40275,1156
2020-11-11,North_Macedonia,MK,947,30,2077132,Europe,41222,1186
2020-11-12,North_Macedonia,MK,1318,26,2077132,Europe,42540,1212
2020-11-13,North_Macedonia,MK,1295,26,2077132,Europe,43835,1238
2020-11-14,North_Macedonia,MK,1063,25,2077132,Europe,44898,1263
2020-11-15,North_Macedonia,MK,1164,18,2077132,Europe,46062,1281
2020-11-16,North_Macedonia,MK,988,24,2077132,Europe,47050,1305
2020-11-17,North_Macedonia,MK,586,40,2077132,Europe,47636,1345
2020-11-18,North_Macedonia,MK,977,31,2077132,Europe,48613,1376
2020-11-19,North_Macedonia,MK,1402,21,2077132,Europe,50015,1397
2020-11-20,North_Macedonia,MK,1198,26,2077132,Europe,51213,1423
2020-11-21,North_Macedonia,MK,1236,39,2077132,Europe,52449,1462
2020-11-22,North_Macedonia,MK,1182,25,2077132,Europe,53631,1487
2020-11-23,North_Macedonia,MK,1112,24,2077132,Europe,54743,1511
2020-11-24,North_Macedonia,MK,384,35,2077132,Europe,55127,1546
2020-11-25,North_Macedonia,MK,1037,15,2077132,Europe,56164,1561
2020-11-26,North_Macedonia,MK,1287,39,2077132,Europe,57451,1600
2020-11-27,North_Macedonia,MK,1157,30,2077132,Europe,58608,1630
2020-11-28,North_Macedonia,MK,1093,28,2077132,Europe,59701,1658
2020-11-29,North_Macedonia,MK,1022,41,2077132,Europe,60723,1699
2020-11-30,North_Macedonia,MK,820,32,2077132,Europe,61543,1731
2020-12-01,North_Macedonia,MK,335,32,2077132,Europe,61878,1763
2020-12-02,North_Macedonia,MK,1067,29,2077132,Europe,62945,1792
2020-12-03,North_Macedonia,MK,945,33,2077132,Europe,63890,1825
2020-12-04,North_Macedonia,MK,1341,22,2077132,Europe,65231,1847
2020-12-05,North_Macedonia,MK,1099,30,2077132,Europe,66330,1877
2020-12-06,North_Macedonia,MK,981,24,2077132,Europe,67311,1901
2020-12-07,North_Macedonia,MK,657,23,2077132,Europe,67968,1924
2020-12-08,North_Macedonia,MK,364,25,2077132,Europe,68332,1949
2020-12-09,North_Macedonia,MK,1120,28,2077132,Europe,69452,1977
2020-12-10,North_Macedonia,MK,502,46,2077132,Europe,69954,2023
2020-12-11,North_Macedonia,MK,929,28,2077132,Europe,70883,2051
2020-12-12,North_Macedonia,MK,1161,26,2077132,Europe,72044,2077
2020-12-13,North_Macedonia,MK,981,19,2077132,Europe,73025,2096
2020-12-14,North_Macedonia,MK,613,25,2077132,Europe,73638,2121
2020-03-26,Mali,ML,2,0,19658023,Africa,2,0
2020-03-27,Mali,ML,2,0,19658023,Africa,4,0
2020-03-28,Mali,ML,0,0,19658023,Africa,4,0
2020-03-29,Mali,ML,5,0,19658023,Africa,9,0
2020-03-30,Mali,ML,9,0,19658023,Africa,18,0
2020-03-31,Mali,ML,0,0,19658023,Africa,18,0
2020-04-01,Mali,ML,0,1,19658023,Africa,18,1
2020-04-02,Mali,ML,10,0,19658023,Africa,28,1
2020-04-03,Mali,ML,8,2,19658023,Africa,36,3
2020-04-04,Mali,ML,3,0,19658023,Africa,39,3
2020-04-05,Mali,ML,2,0,19658023,Africa,41,3
2020-04-06,Mali,ML,4,2,19658023,Africa,45,5
2020-04-07,Mali,ML,2,0,19658023,Africa,47,5
2020-04-08,Mali,ML,9,0,19658023,Africa,56,5
2020-04-09,Mali,ML,3,2,19658023,Africa,59,7
2020-04-10,Mali,ML,0,0,19658023,Africa,59,7
2020-04-11,Mali,ML,28,0,19658023,Africa,87,7
2020-04-12,Mali,ML,18,2,19658023,Africa,105,9
2020-04-13,Mali,ML,11,0,19658023,Africa,116,9
2020-04-14,Mali,ML,7,1,19658023,Africa,123,10
2020-04-15,Mali,ML,21,3,19658023,Africa,144,13
2020-04-16,Mali,ML,4,0,19658023,Africa,148,13
2020-04-17,Mali,ML,23,0,19658023,Africa,171,13
2020-04-18,Mali,ML,19,0,19658023,Africa,190,13
2020-04-19,Mali,ML,26,0,19658023,Africa,216,13
2020-04-20,Mali,ML,8,1,19658023,Africa,224,14
2020-04-21,Mali,ML,22,0,19658023,Africa,246,14
2020-04-22,Mali,ML,12,0,19658023,Africa,258,14
2020-04-23,Mali,ML,35,3,19658023,Africa,293,17
2020-04-24,Mali,ML,16,4,19658023,Africa,309,21
2020-04-25,Mali,ML,16,0,19658023,Africa,325,21
2020-04-26,Mali,ML,45,0,19658023,Africa,370,21
2020-04-27,Mali,ML,19,2,19658023,Africa,389,23
2020-04-28,Mali,ML,19,0,19658023,Africa,408,23
2020-04-29,Mali,ML,16,1,19658023,Africa,424,24
2020-04-30,Mali,ML,58,1,19658023,Africa,482,25
2020-05-01,Mali,ML,8,1,19658023,Africa,490,26
2020-05-02,Mali,ML,18,0,19658023,Africa,508,26
2020-05-03,Mali,ML,36,0,19658023,Africa,544,26
2020-05-04,Mali,ML,19,1,19658023,Africa,563,27
2020-05-05,Mali,ML,17,2,19658023,Africa,580,29
2020-05-06,Mali,ML,32,3,19658023,Africa,612,32
2020-05-07,Mali,ML,19,0,19658023,Africa,631,32
2020-05-08,Mali,ML,19,0,19658023,Africa,650,32
2020-05-09,Mali,ML,18,3,19658023,Africa,668,35
2020-05-10,Mali,ML,24,2,19658023,Africa,692,37
2020-05-11,Mali,ML,12,1,19658023,Africa,704,38
2020-05-12,Mali,ML,8,1,19658023,Africa,712,39
2020-05-13,Mali,ML,18,1,19658023,Africa,730,40
2020-05-14,Mali,ML,28,4,19658023,Africa,758,44
2020-05-15,Mali,ML,21,2,19658023,Africa,779,46
2020-05-16,Mali,ML,27,0,19658023,Africa,806,46
2020-05-17,Mali,ML,29,2,19658023,Africa,835,48
2020-05-18,Mali,ML,25,4,19658023,Africa,860,52
2020-05-19,Mali,ML,14,0,19658023,Africa,874,52
2020-05-20,Mali,ML,27,1,19658023,Africa,901,53
2020-05-21,Mali,ML,30,2,19658023,Africa,931,55
2020-05-22,Mali,ML,16,5,19658023,Africa,947,60
2020-05-23,Mali,ML,22,2,19658023,Africa,969,62
2020-05-24,Mali,ML,46,1,19658023,Africa,1015,63
2020-05-25,Mali,ML,15,2,19658023,Africa,1030,65
2020-05-26,Mali,ML,29,2,19658023,Africa,1059,67
2020-05-27,Mali,ML,18,3,19658023,Africa,1077,70
2020-05-28,Mali,ML,39,0,19658023,Africa,1116,70
2020-05-29,Mali,ML,78,2,19658023,Africa,1194,72
2020-05-30,Mali,ML,32,1,19658023,Africa,1226,73
2020-05-31,Mali,ML,24,3,19658023,Africa,1250,76
2020-06-01,Mali,ML,15,1,19658023,Africa,1265,77
2020-06-02,Mali,ML,50,1,19658023,Africa,1315,78
2020-06-03,Mali,ML,36,0,19658023,Africa,1351,78
2020-06-04,Mali,ML,0,0,19658023,Africa,1351,78
2020-06-05,Mali,ML,110,7,19658023,Africa,1461,85
2020-06-06,Mali,ML,24,2,19658023,Africa,1485,87
2020-06-07,Mali,ML,38,3,19658023,Africa,1523,90
2020-06-08,Mali,ML,10,2,19658023,Africa,1533,92
2020-06-09,Mali,ML,14,0,19658023,Africa,1547,92
2020-06-10,Mali,ML,39,2,19658023,Africa,1586,94
2020-06-11,Mali,ML,81,2,19658023,Africa,1667,96
2020-06-12,Mali,ML,55,1,19658023,Africa,1722,97
2020-06-13,Mali,ML,30,4,19658023,Africa,1752,101
2020-06-14,Mali,ML,24,3,19658023,Africa,1776,104
2020-06-15,Mali,ML,33,0,19658023,Africa,1809,104
2020-06-16,Mali,ML,51,0,19658023,Africa,1860,104
2020-06-17,Mali,ML,25,2,19658023,Africa,1885,106
2020-06-18,Mali,ML,5,1,19658023,Africa,1890,107
2020-06-19,Mali,ML,16,0,19658023,Africa,1906,107
2020-06-20,Mali,ML,17,1,19658023,Africa,1923,108
2020-06-21,Mali,ML,10,1,19658023,Africa,1933,109
2020-06-22,Mali,ML,28,2,19658023,Africa,1961,111
2020-06-23,Mali,ML,0,0,19658023,Africa,1961,111
2020-06-24,Mali,ML,17,0,19658023,Africa,1978,111
2020-06-25,Mali,ML,23,1,19658023,Africa,2001,112
2020-06-26,Mali,ML,6,1,19658023,Africa,2007,113
2020-06-27,Mali,ML,32,0,19658023,Africa,2039,113
2020-06-28,Mali,ML,79,0,19658023,Africa,2118,113
2020-06-29,Mali,ML,29,1,19658023,Africa,2147,114
2020-06-30,Mali,ML,26,1,19658023,Africa,2173,115
2020-07-01,Mali,ML,8,1,19658023,Africa,2181,116
2020-07-02,Mali,ML,21,0,19658023,Africa,2202,116
2020-07-03,Mali,ML,58,1,19658023,Africa,2260,117
2020-07-04,Mali,ML,25,0,19658023,Africa,2285,117
2020-07-05,Mali,ML,18,1,19658023,Africa,2303,118
2020-07-06,Mali,ML,27,1,19658023,Africa,2330,119
2020-07-07,Mali,ML,1,0,19658023,Africa,2331,119
2020-07-08,Mali,ML,17,0,19658023,Africa,2348,119
2020-07-09,Mali,ML,10,1,19658023,Africa,2358,120
2020-07-10,Mali,ML,0,0,19658023,Africa,2358,120
2020-07-11,Mali,ML,46,1,19658023,Africa,2404,121
2020-07-12,Mali,ML,2,0,19658023,Africa,2406,121
2020-07-13,Mali,ML,5,0,19658023,Africa,2411,121
2020-07-14,Mali,ML,1,0,19658023,Africa,2412,121
2020-07-15,Mali,ML,11,0,19658023,Africa,2423,121
2020-07-16,Mali,ML,10,0,19658023,Africa,2433,121
2020-07-17,Mali,ML,7,0,19658023,Africa,2440,121
2020-07-18,Mali,ML,27,0,19658023,Africa,2467,121
2020-07-19,Mali,ML,5,0,19658023,Africa,2472,121
2020-07-20,Mali,ML,3,0,19658023,Africa,2475,121
2020-07-21,Mali,ML,0,0,19658023,Africa,2475,121
2020-07-22,Mali,ML,2,1,19658023,Africa,2477,122
2020-07-23,Mali,ML,17,1,19658023,Africa,2494,123
2020-07-24,Mali,ML,0,0,19658023,Africa,2494,123
2020-07-25,Mali,ML,9,0,19658023,Africa,2503,123
2020-07-26,Mali,ML,0,0,19658023,Africa,2503,123
2020-07-27,Mali,ML,7,0,19658023,Africa,2510,123
2020-07-28,Mali,ML,3,1,19658023,Africa,2513,124
2020-07-29,Mali,ML,7,0,19658023,Africa,2520,124
2020-07-30,Mali,ML,1,0,19658023,Africa,2521,124
2020-07-31,Mali,ML,1,0,19658023,Africa,2522,124
2020-08-01,Mali,ML,13,0,19658023,Africa,2535,124
2020-08-02,Mali,ML,0,0,19658023,Africa,2535,124
2020-08-03,Mali,ML,6,0,19658023,Africa,2541,124
2020-08-04,Mali,ML,2,0,19658023,Africa,2543,124
2020-08-05,Mali,ML,0,0,19658023,Africa,2543,124
2020-08-06,Mali,ML,3,0,19658023,Africa,2546,124
2020-08-07,Mali,ML,6,0,19658023,Africa,2552,124
2020-08-08,Mali,ML,9,1,19658023,Africa,2561,125
2020-08-09,Mali,ML,4,0,19658023,Africa,2565,125
2020-08-10,Mali,ML,2,0,19658023,Africa,2567,125
2020-08-11,Mali,ML,6,0,19658023,Africa,2573,125
2020-08-12,Mali,ML,4,0,19658023,Africa,2577,125
2020-08-13,Mali,ML,5,0,19658023,Africa,2582,125
2020-08-14,Mali,ML,15,0,19658023,Africa,2597,125
2020-08-15,Mali,ML,0,0,19658023,Africa,2597,125
2020-08-16,Mali,ML,17,0,19658023,Africa,2614,125
2020-08-17,Mali,ML,0,0,19658023,Africa,2614,125
2020-08-18,Mali,ML,26,0,19658023,Africa,2640,125
2020-08-19,Mali,ML,26,0,19658023,Africa,2666,125
2020-08-20,Mali,ML,1,0,19658023,Africa,2667,125
2020-08-21,Mali,ML,0,0,19658023,Africa,2667,125
2020-08-22,Mali,ML,21,0,19658023,Africa,2688,125
2020-08-23,Mali,ML,11,0,19658023,Africa,2699,125
2020-08-24,Mali,ML,6,0,19658023,Africa,2705,125
2020-08-25,Mali,ML,3,0,19658023,Africa,2708,125
2020-08-26,Mali,ML,5,0,19658023,Africa,2713,125
2020-08-27,Mali,ML,4,1,19658023,Africa,2717,126
2020-08-28,Mali,ML,13,0,19658023,Africa,2730,126
2020-08-29,Mali,ML,6,0,19658023,Africa,2736,126
2020-08-30,Mali,ML,21,0,19658023,Africa,2757,126
2020-08-31,Mali,ML,16,0,19658023,Africa,2773,126
2020-09-01,Mali,ML,3,0,19658023,Africa,2776,126
2020-09-02,Mali,ML,1,0,19658023,Africa,2777,126
2020-09-03,Mali,ML,25,0,19658023,Africa,2802,126
2020-09-04,Mali,ML,5,0,19658023,Africa,2807,126
2020-09-05,Mali,ML,7,0,19658023,Africa,2814,126
2020-09-06,Mali,ML,19,0,19658023,Africa,2833,126
2020-09-07,Mali,ML,9,1,19658023,Africa,2842,127
2020-09-08,Mali,ML,28,0,19658023,Africa,2870,127
2020-09-09,Mali,ML,12,0,19658023,Africa,2882,127
2020-09-10,Mali,ML,16,1,19658023,Africa,2898,128
2020-09-11,Mali,ML,11,0,19658023,Africa,2909,128
2020-09-12,Mali,ML,3,0,19658023,Africa,2912,128
2020-09-13,Mali,ML,4,0,19658023,Africa,2916,128
2020-09-14,Mali,ML,8,0,19658023,Africa,2924,128
2020-09-15,Mali,ML,11,0,19658023,Africa,2935,128
2020-09-16,Mali,ML,5,0,19658023,Africa,2940,128
2020-09-17,Mali,ML,26,0,19658023,Africa,2966,128
2020-09-18,Mali,ML,0,0,19658023,Africa,2966,128
2020-09-19,Mali,ML,25,0,19658023,Africa,2991,128
2020-09-20,Mali,ML,15,0,19658023,Africa,3006,128
2020-09-21,Mali,ML,7,0,19658023,Africa,3013,128
2020-09-22,Mali,ML,11,0,19658023,Africa,3024,128
2020-09-23,Mali,ML,6,1,19658023,Africa,3030,129
2020-09-24,Mali,ML,4,1,19658023,Africa,3034,130
2020-09-25,Mali,ML,7,0,19658023,Africa,3041,130
2020-09-26,Mali,ML,23,0,19658023,Africa,3064,130
2020-09-27,Mali,ML,16,0,19658023,Africa,3080,130
2020-09-28,Mali,ML,6,0,19658023,Africa,3086,130
2020-09-29,Mali,ML,4,0,19658023,Africa,3090,130
2020-09-30,Mali,ML,0,0,19658023,Africa,3090,130
2020-10-01,Mali,ML,28,1,19658023,Africa,3118,131
2020-10-02,Mali,ML,13,0,19658023,Africa,3131,131
2020-10-03,Mali,ML,25,0,19658023,Africa,3156,131
2020-10-04,Mali,ML,14,0,19658023,Africa,3170,131
2020-10-05,Mali,ML,14,0,19658023,Africa,3184,131
2020-10-06,Mali,ML,5,0,19658023,Africa,3189,131
2020-10-07,Mali,ML,6,0,19658023,Africa,3195,131
2020-10-08,Mali,ML,15,0,19658023,Africa,3210,131
2020-10-09,Mali,ML,25,0,19658023,Africa,3235,131
2020-10-10,Mali,ML,13,0,19658023,Africa,3248,131
2020-10-11,Mali,ML,25,1,19658023,Africa,3273,132
2020-10-12,Mali,ML,13,0,19658023,Africa,3286,132
2020-10-13,Mali,ML,10,0,19658023,Africa,3296,132
2020-10-14,Mali,ML,0,0,19658023,Africa,3296,132
2020-10-15,Mali,ML,56,0,19658023,Africa,3352,132
2020-10-16,Mali,ML,16,0,19658023,Africa,3368,132
2020-10-17,Mali,ML,0,0,19658023,Africa,3368,132
2020-10-18,Mali,ML,11,0,19658023,Africa,3379,132
2020-10-19,Mali,ML,0,0,19658023,Africa,3379,132
2020-10-20,Mali,ML,28,0,19658023,Africa,3407,132
2020-10-21,Mali,ML,4,0,19658023,Africa,3411,132
2020-10-22,Mali,ML,17,0,19658023,Africa,3428,132
2020-10-23,Mali,ML,12,0,19658023,Africa,3440,132
2020-10-24,Mali,ML,4,0,19658023,Africa,3444,132
2020-10-25,Mali,ML,28,0,19658023,Africa,3472,132
2020-10-26,Mali,ML,18,1,19658023,Africa,3490,133
2020-10-27,Mali,ML,9,0,19658023,Africa,3499,133
2020-10-28,Mali,ML,16,3,19658023,Africa,3515,136
2020-10-29,Mali,ML,15,0,19658023,Africa,3530,136
2020-10-30,Mali,ML,0,0,19658023,Africa,3530,136
2020-10-31,Mali,ML,15,0,19658023,Africa,3545,136
2020-11-01,Mali,ML,0,0,19658023,Africa,3545,136
2020-11-02,Mali,ML,0,0,19658023,Africa,3545,136
2020-11-03,Mali,ML,28,0,19658023,Africa,3573,136
2020-11-04,Mali,ML,0,0,19658023,Africa,3573,136
2020-11-05,Mali,ML,36,1,19658023,Africa,3609,137
2020-11-06,Mali,ML,24,0,19658023,Africa,3633,137
2020-11-07,Mali,ML,24,0,19658023,Africa,3657,137
2020-11-08,Mali,ML,19,0,19658023,Africa,3676,137
2020-11-09,Mali,ML,0,0,19658023,Africa,3676,137
2020-11-10,Mali,ML,30,0,19658023,Africa,3706,137
2020-11-11,Mali,ML,0,0,19658023,Africa,3706,137
2020-11-12,Mali,ML,0,0,19658023,Africa,3706,137
2020-11-13,Mali,ML,47,1,19658023,Africa,3753,138
2020-11-14,Mali,ML,39,0,19658023,Africa,3792,138
2020-11-15,Mali,ML,14,1,19658023,Africa,3806,139
2020-11-16,Mali,ML,62,0,19658023,Africa,3868,139
2020-11-17,Mali,ML,0,0,19658023,Africa,3868,139
2020-11-18,Mali,ML,112,2,19658023,Africa,3980,141
2020-11-19,Mali,ML,0,0,19658023,Africa,3980,141
2020-11-20,Mali,ML,0,0,19658023,Africa,3980,141
2020-11-21,Mali,ML,113,1,19658023,Africa,4093,142
2020-11-22,Mali,ML,113,1,19658023,Africa,4206,143
2020-11-23,Mali,ML,0,0,19658023,Africa,4206,143
2020-11-24,Mali,ML,49,2,19658023,Africa,4255,145
2020-11-25,Mali,ML,71,1,19658023,Africa,4326,146
2020-11-26,Mali,ML,135,2,19658023,Africa,4461,148
2020-11-27,Mali,ML,0,0,19658023,Africa,4461,148
2020-11-28,Mali,ML,106,1,19658023,Africa,4567,149
2020-11-29,Mali,ML,92,0,19658023,Africa,4659,149
2020-11-30,Mali,ML,0,0,19658023,Africa,4659,149
2020-12-01,Mali,ML,51,7,19658023,Africa,4710,156
2020-12-02,Mali,ML,52,4,19658023,Africa,4762,160
2020-12-03,Mali,ML,75,1,19658023,Africa,4837,161
2020-12-04,Mali,ML,43,1,19658023,Africa,4880,162
2020-12-05,Mali,ML,58,1,19658023,Africa,4938,163
2020-12-06,Mali,ML,124,0,19658023,Africa,5062,163
2020-12-07,Mali,ML,73,1,19658023,Africa,5135,164
2020-12-08,Mali,ML,155,11,19658023,Africa,5290,175
2020-12-09,Mali,ML,0,0,19658023,Africa,5290,175
2020-12-10,Mali,ML,152,5,19658023,Africa,5442,180
2020-12-11,Mali,ML,134,4,19658023,Africa,5576,184
2020-12-12,Mali,ML,73,1,19658023,Africa,5649,185
2020-12-13,Mali,ML,72,4,19658023,Africa,5721,189
2020-12-14,Mali,ML,93,5,19658023,Africa,5814,194
2020-03-17,Myanmar,MM,0,0,54045422,Asia,0,0
2020-03-24,Myanmar,MM,2,0,54045422,Asia,2,0
2020-03-25,Myanmar,MM,1,0,54045422,Asia,3,0
2020-03-26,Myanmar,MM,0,0,54045422,Asia,3,0
2020-03-27,Myanmar,MM,2,0,54045422,Asia,5,0
2020-03-28,Myanmar,MM,0,0,54045422,Asia,5,0
2020-03-29,Myanmar,MM,3,0,54045422,Asia,8,0
2020-03-30,Myanmar,MM,0,0,54045422,Asia,8,0
2020-03-31,Myanmar,MM,6,0,54045422,Asia,14,0
2020-04-01,Myanmar,MM,1,1,54045422,Asia,15,1
2020-04-02,Myanmar,MM,1,0,54045422,Asia,16,1
2020-04-03,Myanmar,MM,4,0,54045422,Asia,20,1
2020-04-04,Myanmar,MM,0,0,54045422,Asia,20,1
2020-04-05,Myanmar,MM,1,0,54045422,Asia,21,1
2020-04-06,Myanmar,MM,0,0,54045422,Asia,21,1
2020-04-07,Myanmar,MM,1,0,54045422,Asia,22,1
2020-04-08,Myanmar,MM,0,0,54045422,Asia,22,1
2020-04-09,Myanmar,MM,0,2,54045422,Asia,22,3
2020-04-10,Myanmar,MM,5,0,54045422,Asia,27,3
2020-04-11,Myanmar,MM,1,0,54045422,Asia,28,3
2020-04-12,Myanmar,MM,3,0,54045422,Asia,31,3
2020-04-13,Myanmar,MM,10,1,54045422,Asia,41,4
2020-04-14,Myanmar,MM,21,0,54045422,Asia,62,4
2020-04-15,Myanmar,MM,12,0,54045422,Asia,74,4
2020-04-16,Myanmar,MM,0,0,54045422,Asia,74,4
2020-04-17,Myanmar,MM,11,0,54045422,Asia,85,4
2020-04-18,Myanmar,MM,9,1,54045422,Asia,94,5
2020-04-19,Myanmar,MM,13,0,54045422,Asia,107,5
2020-04-20,Myanmar,MM,4,0,54045422,Asia,111,5
2020-04-21,Myanmar,MM,8,0,54045422,Asia,119,5
2020-04-22,Myanmar,MM,2,0,54045422,Asia,121,5
2020-04-23,Myanmar,MM,6,0,54045422,Asia,127,5
2020-04-24,Myanmar,MM,5,0,54045422,Asia,132,5
2020-04-25,Myanmar,MM,12,0,54045422,Asia,144,5
2020-04-26,Myanmar,MM,2,0,54045422,Asia,146,5
2020-04-27,Myanmar,MM,0,0,54045422,Asia,146,5
2020-04-28,Myanmar,MM,0,0,54045422,Asia,146,5
2020-04-29,Myanmar,MM,4,0,54045422,Asia,150,5
2020-04-30,Myanmar,MM,0,1,54045422,Asia,150,6
2020-05-01,Myanmar,MM,1,0,54045422,Asia,151,6
2020-05-02,Myanmar,MM,0,0,54045422,Asia,151,6
2020-05-03,Myanmar,MM,0,0,54045422,Asia,151,6
2020-05-04,Myanmar,MM,4,0,54045422,Asia,155,6
2020-05-05,Myanmar,MM,6,0,54045422,Asia,161,6
2020-05-06,Myanmar,MM,0,0,54045422,Asia,161,6
2020-05-07,Myanmar,MM,1,0,54045422,Asia,162,6
2020-05-08,Myanmar,MM,14,0,54045422,Asia,176,6
2020-05-09,Myanmar,MM,1,0,54045422,Asia,177,6
2020-05-10,Myanmar,MM,1,0,54045422,Asia,178,6
2020-05-11,Myanmar,MM,2,0,54045422,Asia,180,6
2020-05-12,Myanmar,MM,0,0,54045422,Asia,180,6
2020-05-13,Myanmar,MM,0,0,54045422,Asia,180,6
2020-05-14,Myanmar,MM,1,0,54045422,Asia,181,6
2020-05-15,Myanmar,MM,0,0,54045422,Asia,181,6
2020-05-16,Myanmar,MM,1,0,54045422,Asia,182,6
2020-05-17,Myanmar,MM,0,0,54045422,Asia,182,6
2020-05-18,Myanmar,MM,5,0,54045422,Asia,187,6
2020-05-19,Myanmar,MM,4,0,54045422,Asia,191,6
2020-05-20,Myanmar,MM,2,0,54045422,Asia,193,6
2020-05-21,Myanmar,MM,6,0,54045422,Asia,199,6
2020-05-22,Myanmar,MM,0,0,54045422,Asia,199,6
2020-05-23,Myanmar,MM,2,0,54045422,Asia,201,6
2020-05-24,Myanmar,MM,0,0,54045422,Asia,201,6
2020-05-25,Myanmar,MM,0,0,54045422,Asia,201,6
2020-05-26,Myanmar,MM,2,0,54045422,Asia,203,6
2020-05-27,Myanmar,MM,3,0,54045422,Asia,206,6
2020-05-28,Myanmar,MM,0,0,54045422,Asia,206,6
2020-05-29,Myanmar,MM,0,0,54045422,Asia,206,6
2020-05-30,Myanmar,MM,18,0,54045422,Asia,224,6
2020-05-31,Myanmar,MM,0,0,54045422,Asia,224,6
2020-06-01,Myanmar,MM,4,0,54045422,Asia,228,6
2020-06-02,Myanmar,MM,0,0,54045422,Asia,228,6
2020-06-03,Myanmar,MM,5,0,54045422,Asia,233,6
2020-06-04,Myanmar,MM,1,0,54045422,Asia,234,6
2020-06-05,Myanmar,MM,2,0,54045422,Asia,236,6
2020-06-06,Myanmar,MM,0,0,54045422,Asia,236,6
2020-06-07,Myanmar,MM,4,0,54045422,Asia,240,6
2020-06-08,Myanmar,MM,3,0,54045422,Asia,243,6
2020-06-09,Myanmar,MM,1,0,54045422,Asia,244,6
2020-06-10,Myanmar,MM,2,0,54045422,Asia,246,6
2020-06-11,Myanmar,MM,3,0,54045422,Asia,249,6
2020-06-12,Myanmar,MM,12,0,54045422,Asia,261,6
2020-06-13,Myanmar,MM,0,0,54045422,Asia,261,6
2020-06-14,Myanmar,MM,0,0,54045422,Asia,261,6
2020-06-15,Myanmar,MM,1,0,54045422,Asia,262,6
2020-06-16,Myanmar,MM,0,0,54045422,Asia,262,6
2020-06-17,Myanmar,MM,0,0,54045422,Asia,262,6
2020-06-18,Myanmar,MM,1,0,54045422,Asia,263,6
2020-06-19,Myanmar,MM,23,0,54045422,Asia,286,6
2020-06-20,Myanmar,MM,0,0,54045422,Asia,286,6
2020-06-21,Myanmar,MM,1,0,54045422,Asia,287,6
2020-06-22,Myanmar,MM,3,0,54045422,Asia,290,6
2020-06-23,Myanmar,MM,1,0,54045422,Asia,291,6
2020-06-24,Myanmar,MM,1,0,54045422,Asia,292,6
2020-06-25,Myanmar,MM,1,0,54045422,Asia,293,6
2020-06-26,Myanmar,MM,0,0,54045422,Asia,293,6
2020-06-27,Myanmar,MM,0,0,54045422,Asia,293,6
2020-06-28,Myanmar,MM,3,0,54045422,Asia,296,6
2020-06-29,Myanmar,MM,3,0,54045422,Asia,299,6
2020-06-30,Myanmar,MM,0,0,54045422,Asia,299,6
2020-07-01,Myanmar,MM,0,0,54045422,Asia,299,6
2020-07-02,Myanmar,MM,5,0,54045422,Asia,304,6
2020-07-03,Myanmar,MM,0,0,54045422,Asia,304,6
2020-07-04,Myanmar,MM,2,0,54045422,Asia,306,6
2020-07-05,Myanmar,MM,7,0,54045422,Asia,313,6
2020-07-06,Myanmar,MM,0,0,54045422,Asia,313,6
2020-07-07,Myanmar,MM,3,0,54045422,Asia,316,6
2020-07-08,Myanmar,MM,0,0,54045422,Asia,316,6
2020-07-09,Myanmar,MM,2,0,54045422,Asia,318,6
2020-07-10,Myanmar,MM,3,0,54045422,Asia,321,6
2020-07-11,Myanmar,MM,5,0,54045422,Asia,326,6
2020-07-12,Myanmar,MM,4,0,54045422,Asia,330,6
2020-07-13,Myanmar,MM,1,0,54045422,Asia,331,6
2020-07-14,Myanmar,MM,5,0,54045422,Asia,336,6
2020-07-15,Myanmar,MM,1,0,54045422,Asia,337,6
2020-07-16,Myanmar,MM,0,0,54045422,Asia,337,6
2020-07-17,Myanmar,MM,2,0,54045422,Asia,339,6
2020-07-18,Myanmar,MM,0,0,54045422,Asia,339,6
2020-07-19,Myanmar,MM,2,0,54045422,Asia,341,6
2020-07-20,Myanmar,MM,0,0,54045422,Asia,341,6
2020-07-21,Myanmar,MM,0,0,54045422,Asia,341,6
2020-07-22,Myanmar,MM,0,0,54045422,Asia,341,6
2020-07-23,Myanmar,MM,2,0,54045422,Asia,343,6
2020-07-24,Myanmar,MM,0,0,54045422,Asia,343,6
2020-07-25,Myanmar,MM,3,0,54045422,Asia,346,6
2020-07-26,Myanmar,MM,3,0,54045422,Asia,349,6
2020-07-27,Myanmar,MM,1,0,54045422,Asia,350,6
2020-07-28,Myanmar,MM,0,0,54045422,Asia,350,6
2020-07-29,Myanmar,MM,1,0,54045422,Asia,351,6
2020-07-30,Myanmar,MM,2,0,54045422,Asia,353,6
2020-07-31,Myanmar,MM,0,0,54045422,Asia,353,6
2020-08-01,Myanmar,MM,0,0,54045422,Asia,353,6
2020-08-02,Myanmar,MM,0,0,54045422,Asia,353,6
2020-08-03,Myanmar,MM,0,0,54045422,Asia,353,6
2020-08-04,Myanmar,MM,2,0,54045422,Asia,355,6
2020-08-05,Myanmar,MM,1,0,54045422,Asia,356,6
2020-08-06,Myanmar,MM,1,0,54045422,Asia,357,6
2020-08-07,Myanmar,MM,2,0,54045422,Asia,359,6
2020-08-08,Myanmar,MM,0,0,54045422,Asia,359,6
2020-08-09,Myanmar,MM,0,0,54045422,Asia,359,6
2020-08-10,Myanmar,MM,1,0,54045422,Asia,360,6
2020-08-11,Myanmar,MM,0,0,54045422,Asia,360,6
2020-08-12,Myanmar,MM,0,0,54045422,Asia,360,6
2020-08-13,Myanmar,MM,1,0,54045422,Asia,361,6
2020-08-14,Myanmar,MM,8,0,54045422,Asia,369,6
2020-08-15,Myanmar,MM,5,0,54045422,Asia,374,6
2020-08-16,Myanmar,MM,0,0,54045422,Asia,374,6
2020-08-17,Myanmar,MM,1,0,54045422,Asia,375,6
2020-08-18,Myanmar,MM,1,0,54045422,Asia,376,6
2020-08-19,Myanmar,MM,3,0,54045422,Asia,379,6
2020-08-20,Myanmar,MM,17,0,54045422,Asia,396,6
2020-08-21,Myanmar,MM,13,0,54045422,Asia,409,6
2020-08-22,Myanmar,MM,26,0,54045422,Asia,435,6
2020-08-23,Myanmar,MM,9,0,54045422,Asia,444,6
2020-08-24,Myanmar,MM,19,0,54045422,Asia,463,6
2020-08-25,Myanmar,MM,11,0,54045422,Asia,474,6
2020-08-26,Myanmar,MM,30,0,54045422,Asia,504,6
2020-08-27,Myanmar,MM,82,0,54045422,Asia,586,6
2020-08-28,Myanmar,MM,42,0,54045422,Asia,628,6
2020-08-29,Myanmar,MM,28,0,54045422,Asia,656,6
2020-08-30,Myanmar,MM,93,0,54045422,Asia,749,6
2020-08-31,Myanmar,MM,38,0,54045422,Asia,787,6
2020-09-01,Myanmar,MM,100,0,54045422,Asia,887,6
2020-09-02,Myanmar,MM,51,0,54045422,Asia,938,6
2020-09-03,Myanmar,MM,120,0,54045422,Asia,1058,6
2020-09-04,Myanmar,MM,75,1,54045422,Asia,1133,7
2020-09-05,Myanmar,MM,83,0,54045422,Asia,1216,7
2020-09-06,Myanmar,MM,103,1,54045422,Asia,1319,8
2020-09-07,Myanmar,MM,145,0,54045422,Asia,1464,8
2020-09-08,Myanmar,MM,146,0,54045422,Asia,1610,8
2020-09-09,Myanmar,MM,197,4,54045422,Asia,1807,12
2020-09-10,Myanmar,MM,202,2,54045422,Asia,2009,14
2020-09-11,Myanmar,MM,256,0,54045422,Asia,2265,14
2020-09-12,Myanmar,MM,180,1,54045422,Asia,2445,15
2020-09-13,Myanmar,MM,351,1,54045422,Asia,2796,16
2020-09-14,Myanmar,MM,219,8,54045422,Asia,3015,24
2020-09-15,Myanmar,MM,284,8,54045422,Asia,3299,32
2020-09-16,Myanmar,MM,337,7,54045422,Asia,3636,39
2020-09-17,Myanmar,MM,258,7,54045422,Asia,3894,46
2020-09-18,Myanmar,MM,405,15,54045422,Asia,4299,61
2020-09-19,Myanmar,MM,322,14,54045422,Asia,4621,75
2020-09-20,Myanmar,MM,642,6,54045422,Asia,5263,81
2020-09-21,Myanmar,MM,542,13,54045422,Asia,5805,94
2020-09-22,Myanmar,MM,666,6,54045422,Asia,6471,100
2020-09-23,Myanmar,MM,488,16,54045422,Asia,6959,116
2020-09-24,Myanmar,MM,868,17,54045422,Asia,7827,133
2020-09-25,Myanmar,MM,688,22,54045422,Asia,8515,155
2020-09-26,Myanmar,MM,597,19,54045422,Asia,9112,174
2020-09-27,Myanmar,MM,879,24,54045422,Asia,9991,198
2020-09-28,Myanmar,MM,743,28,54045422,Asia,10734,226
2020-09-29,Myanmar,MM,897,30,54045422,Asia,11631,256
2020-09-30,Myanmar,MM,794,28,54045422,Asia,12425,284
2020-10-01,Myanmar,MM,948,26,54045422,Asia,13373,310
2020-10-02,Myanmar,MM,1010,11,54045422,Asia,14383,321
2020-10-03,Myanmar,MM,1142,32,54045422,Asia,15525,353
2020-10-04,Myanmar,MM,978,18,54045422,Asia,16503,371
2020-10-05,Myanmar,MM,1291,41,54045422,Asia,17794,412
2020-10-06,Myanmar,MM,987,32,54045422,Asia,18781,444
2020-10-07,Myanmar,MM,1252,27,54045422,Asia,20033,471
2020-10-08,Myanmar,MM,1400,39,54045422,Asia,21433,510
2020-10-09,Myanmar,MM,1012,25,54045422,Asia,22445,535
2020-10-10,Myanmar,MM,1461,31,54045422,Asia,23906,566
2020-10-11,Myanmar,MM,2158,32,54045422,Asia,26064,598
2020-10-12,Myanmar,MM,1910,48,54045422,Asia,27974,646
2020-10-13,Myanmar,MM,1340,18,54045422,Asia,29314,664
2020-10-14,Myanmar,MM,1123,29,54045422,Asia,30437,693
2020-10-15,Myanmar,MM,888,39,54045422,Asia,31325,732
2020-10-16,Myanmar,MM,1026,33,54045422,Asia,32351,765
2020-10-17,Myanmar,MM,1137,34,54045422,Asia,33488,799
2020-10-18,Myanmar,MM,1387,39,54045422,Asia,34875,838
2020-10-19,Myanmar,MM,1150,42,54045422,Asia,36025,880
2020-10-20,Myanmar,MM,1180,34,54045422,Asia,37205,914
2020-10-21,Myanmar,MM,1297,31,54045422,Asia,38502,945
2020-10-22,Myanmar,MM,1194,27,54045422,Asia,39696,972
2020-10-23,Myanmar,MM,1312,33,54045422,Asia,41008,1005
2020-10-24,Myanmar,MM,1357,33,54045422,Asia,42365,1038
2020-10-25,Myanmar,MM,1423,28,54045422,Asia,43788,1066
2020-10-26,Myanmar,MM,986,29,54045422,Asia,44774,1095
2020-10-27,Myanmar,MM,1426,27,54045422,Asia,46200,1122
2020-10-28,Myanmar,MM,1466,25,54045422,Asia,47666,1147
2020-10-29,Myanmar,MM,1406,25,54045422,Asia,49072,1172
2020-10-30,Myanmar,MM,1331,27,54045422,Asia,50403,1199
2020-10-31,Myanmar,MM,1093,20,54045422,Asia,51496,1219
2020-11-01,Myanmar,MM,1210,18,54045422,Asia,52706,1237
2020-11-02,Myanmar,MM,699,21,54045422,Asia,53405,1258
2020-11-03,Myanmar,MM,1202,24,54045422,Asia,54607,1282
2020-11-04,Myanmar,MM,1197,25,54045422,Asia,55804,1307
2020-11-05,Myanmar,MM,1136,23,54045422,Asia,56940,1330
2020-11-06,Myanmar,MM,995,22,54045422,Asia,57935,1352
2020-11-07,Myanmar,MM,1342,24,54045422,Asia,59277,1376
2020-11-08,Myanmar,MM,1071,20,54045422,Asia,60348,1396
2020-11-09,Myanmar,MM,1029,24,54045422,Asia,61377,1420
2020-11-10,Myanmar,MM,598,17,54045422,Asia,61975,1437
2020-11-11,Myanmar,MM,1266,24,54045422,Asia,63241,1461
2020-11-12,Myanmar,MM,1212,19,54045422,Asia,64453,1480
2020-11-13,Myanmar,MM,1145,28,54045422,Asia,65598,1508
2020-11-14,Myanmar,MM,1136,26,54045422,Asia,66734,1534
2020-11-15,Myanmar,MM,1277,18,54045422,Asia,68011,1552
2020-11-16,Myanmar,MM,983,25,54045422,Asia,68994,1577
2020-11-17,Myanmar,MM,1167,22,54045422,Asia,70161,1599
2020-11-18,Myanmar,MM,1569,26,54045422,Asia,71730,1625
2020-11-19,Myanmar,MM,1592,25,54045422,Asia,73322,1650
2020-11-20,Myanmar,MM,1560,26,54045422,Asia,74882,1676
2020-11-21,Myanmar,MM,1532,19,54045422,Asia,76414,1695
2020-11-22,Myanmar,MM,1434,27,54045422,Asia,77848,1722
2020-11-23,Myanmar,MM,1398,17,54045422,Asia,79246,1739
2020-11-24,Myanmar,MM,1259,26,54045422,Asia,80505,1765
2020-11-25,Myanmar,MM,1731,19,54045422,Asia,82236,1784
2020-11-26,Myanmar,MM,1330,26,54045422,Asia,83566,1810
2020-11-27,Myanmar,MM,1639,36,54045422,Asia,85205,1846
2020-11-28,Myanmar,MM,1428,19,54045422,Asia,86633,1865
2020-11-29,Myanmar,MM,1344,22,54045422,Asia,87977,1887
2020-11-30,Myanmar,MM,1509,31,54045422,Asia,89486,1918
2020-12-01,Myanmar,MM,1227,23,54045422,Asia,90713,1941
2020-12-02,Myanmar,MM,1476,31,54045422,Asia,92189,1972
2020-12-03,Myanmar,MM,1411,26,54045422,Asia,93600,1998
2020-12-04,Myanmar,MM,1418,30,54045422,Asia,95018,2028
2020-12-05,Myanmar,MM,1502,31,54045422,Asia,96520,2059
2020-12-06,Myanmar,MM,1527,22,54045422,Asia,98047,2081
2020-12-07,Myanmar,MM,1108,29,54045422,Asia,99155,2110
2020-12-08,Myanmar,MM,1276,22,54045422,Asia,100431,2132
2020-12-09,Myanmar,MM,1308,19,54045422,Asia,101739,2151
2020-12-10,Myanmar,MM,1427,23,54045422,Asia,103166,2174
2020-12-11,Myanmar,MM,1321,27,54045422,Asia,104487,2201
2020-12-12,Myanmar,MM,1376,19,54045422,Asia,105863,2220
2020-12-13,Myanmar,MM,1352,25,54045422,Asia,107215,2245
2020-12-14,Myanmar,MM,1127,23,54045422,Asia,108342,2268
2020-03-10,Mongolia,MN,1,0,3225166,Asia,1,0
2020-03-15,Mongolia,MN,0,0,3225166,Asia,1,0
2020-03-18,Mongolia,MN,3,0,3225166,Asia,4,0
2020-03-19,Mongolia,MN,1,0,3225166,Asia,5,0
2020-03-20,Mongolia,MN,0,0,3225166,Asia,5,0
2020-03-21,Mongolia,MN,1,0,3225166,Asia,6,0
2020-03-22,Mongolia,MN,4,0,3225166,Asia,10,0
2020-03-23,Mongolia,MN,0,0,3225166,Asia,10,0
2020-03-24,Mongolia,MN,0,0,3225166,Asia,10,0
2020-03-25,Mongolia,MN,0,0,3225166,Asia,10,0
2020-03-26,Mongolia,MN,0,0,3225166,Asia,10,0
2020-03-27,Mongolia,MN,1,0,3225166,Asia,11,0
2020-03-28,Mongolia,MN,0,0,3225166,Asia,11,0
2020-03-29,Mongolia,MN,1,0,3225166,Asia,12,0
2020-03-30,Mongolia,MN,0,0,3225166,Asia,12,0
2020-03-31,Mongolia,MN,0,0,3225166,Asia,12,0
2020-04-01,Mongolia,MN,0,0,3225166,Asia,12,0
2020-04-02,Mongolia,MN,2,0,3225166,Asia,14,0
2020-04-03,Mongolia,MN,0,0,3225166,Asia,14,0
2020-04-04,Mongolia,MN,0,0,3225166,Asia,14,0
2020-04-05,Mongolia,MN,0,0,3225166,Asia,14,0
2020-04-06,Mongolia,MN,0,0,3225166,Asia,14,0
2020-04-07,Mongolia,MN,1,0,3225166,Asia,15,0
2020-04-08,Mongolia,MN,0,0,3225166,Asia,15,0
2020-04-09,Mongolia,MN,1,0,3225166,Asia,16,0
2020-04-10,Mongolia,MN,0,0,3225166,Asia,16,0
2020-04-11,Mongolia,MN,0,0,3225166,Asia,16,0
2020-04-12,Mongolia,MN,0,0,3225166,Asia,16,0
2020-04-13,Mongolia,MN,0,0,3225166,Asia,16,0
2020-04-14,Mongolia,MN,0,0,3225166,Asia,16,0
2020-04-15,Mongolia,MN,14,0,3225166,Asia,30,0
2020-04-16,Mongolia,MN,0,0,3225166,Asia,30,0
2020-04-17,Mongolia,MN,1,0,3225166,Asia,31,0
2020-04-18,Mongolia,MN,0,0,3225166,Asia,31,0
2020-04-19,Mongolia,MN,0,0,3225166,Asia,31,0
2020-04-20,Mongolia,MN,1,0,3225166,Asia,32,0
2020-04-21,Mongolia,MN,2,0,3225166,Asia,34,0
2020-04-22,Mongolia,MN,1,0,3225166,Asia,35,0
2020-04-23,Mongolia,MN,0,0,3225166,Asia,35,0
2020-04-24,Mongolia,MN,1,0,3225166,Asia,36,0
2020-04-25,Mongolia,MN,0,0,3225166,Asia,36,0
2020-04-26,Mongolia,MN,2,0,3225166,Asia,38,0
2020-04-27,Mongolia,MN,0,0,3225166,Asia,38,0
2020-04-28,Mongolia,MN,0,0,3225166,Asia,38,0
2020-04-29,Mongolia,MN,0,0,3225166,Asia,38,0
2020-04-30,Mongolia,MN,0,0,3225166,Asia,38,0
2020-05-01,Mongolia,MN,0,0,3225166,Asia,38,0
2020-05-02,Mongolia,MN,1,0,3225166,Asia,39,0
2020-05-03,Mongolia,MN,0,0,3225166,Asia,39,0
2020-05-04,Mongolia,MN,1,0,3225166,Asia,40,0
2020-05-05,Mongolia,MN,1,0,3225166,Asia,41,0
2020-05-06,Mongolia,MN,0,0,3225166,Asia,41,0
2020-05-07,Mongolia,MN,0,0,3225166,Asia,41,0
2020-05-08,Mongolia,MN,1,0,3225166,Asia,42,0
2020-05-09,Mongolia,MN,0,0,3225166,Asia,42,0
2020-05-10,Mongolia,MN,0,0,3225166,Asia,42,0
2020-05-11,Mongolia,MN,0,0,3225166,Asia,42,0
2020-05-12,Mongolia,MN,0,0,3225166,Asia,42,0
2020-05-13,Mongolia,MN,0,0,3225166,Asia,42,0
2020-05-14,Mongolia,MN,19,0,3225166,Asia,61,0
2020-05-15,Mongolia,MN,0,0,3225166,Asia,61,0
2020-05-16,Mongolia,MN,74,0,3225166,Asia,135,0
2020-05-17,Mongolia,MN,1,0,3225166,Asia,136,0
2020-05-18,Mongolia,MN,4,0,3225166,Asia,140,0
2020-05-19,Mongolia,MN,0,0,3225166,Asia,140,0
2020-05-20,Mongolia,MN,0,0,3225166,Asia,140,0
2020-05-21,Mongolia,MN,0,0,3225166,Asia,140,0
2020-05-22,Mongolia,MN,1,0,3225166,Asia,141,0
2020-05-23,Mongolia,MN,0,0,3225166,Asia,141,0
2020-05-24,Mongolia,MN,0,0,3225166,Asia,141,0
2020-05-25,Mongolia,MN,0,0,3225166,Asia,141,0
2020-05-26,Mongolia,MN,0,0,3225166,Asia,141,0
2020-05-27,Mongolia,MN,7,0,3225166,Asia,148,0
2020-05-28,Mongolia,MN,13,0,3225166,Asia,161,0
2020-05-29,Mongolia,MN,18,0,3225166,Asia,179,0
2020-05-30,Mongolia,MN,0,0,3225166,Asia,179,0
2020-05-31,Mongolia,MN,0,0,3225166,Asia,179,0
2020-06-01,Mongolia,MN,6,0,3225166,Asia,185,0
2020-06-02,Mongolia,MN,0,0,3225166,Asia,185,0
2020-06-03,Mongolia,MN,0,0,3225166,Asia,185,0
2020-06-04,Mongolia,MN,1,0,3225166,Asia,186,0
2020-06-05,Mongolia,MN,5,0,3225166,Asia,191,0
2020-06-06,Mongolia,MN,0,0,3225166,Asia,191,0
2020-06-07,Mongolia,MN,2,0,3225166,Asia,193,0
2020-06-08,Mongolia,MN,1,0,3225166,Asia,194,0
2020-06-09,Mongolia,MN,0,0,3225166,Asia,194,0
2020-06-10,Mongolia,MN,0,0,3225166,Asia,194,0
2020-06-11,Mongolia,MN,0,0,3225166,Asia,194,0
2020-06-12,Mongolia,MN,3,0,3225166,Asia,197,0
2020-06-13,Mongolia,MN,0,0,3225166,Asia,197,0
2020-06-14,Mongolia,MN,0,0,3225166,Asia,197,0
2020-06-15,Mongolia,MN,0,0,3225166,Asia,197,0
2020-06-16,Mongolia,MN,0,0,3225166,Asia,197,0
2020-06-17,Mongolia,MN,0,0,3225166,Asia,197,0
2020-06-18,Mongolia,MN,4,0,3225166,Asia,201,0
2020-06-19,Mongolia,MN,3,0,3225166,Asia,204,0
2020-06-20,Mongolia,MN,0,0,3225166,Asia,204,0
2020-06-21,Mongolia,MN,2,0,3225166,Asia,206,0
2020-06-22,Mongolia,MN,7,0,3225166,Asia,213,0
2020-06-23,Mongolia,MN,2,0,3225166,Asia,215,0
2020-06-24,Mongolia,MN,0,0,3225166,Asia,215,0
2020-06-25,Mongolia,MN,1,0,3225166,Asia,216,0
2020-06-26,Mongolia,MN,3,0,3225166,Asia,219,0
2020-06-27,Mongolia,MN,0,0,3225166,Asia,219,0
2020-06-28,Mongolia,MN,0,0,3225166,Asia,219,0
2020-06-29,Mongolia,MN,1,0,3225166,Asia,220,0
2020-06-30,Mongolia,MN,0,0,3225166,Asia,220,0
2020-07-01,Mongolia,MN,0,0,3225166,Asia,220,0
2020-07-02,Mongolia,MN,0,0,3225166,Asia,220,0
2020-07-03,Mongolia,MN,0,0,3225166,Asia,220,0
2020-07-04,Mongolia,MN,0,0,3225166,Asia,220,0
2020-07-05,Mongolia,MN,0,0,3225166,Asia,220,0
2020-07-06,Mongolia,MN,0,0,3225166,Asia,220,0
2020-07-07,Mongolia,MN,0,0,3225166,Asia,220,0
2020-07-08,Mongolia,MN,0,0,3225166,Asia,220,0
2020-07-09,Mongolia,MN,7,0,3225166,Asia,227,0
2020-07-10,Mongolia,MN,0,0,3225166,Asia,227,0
2020-07-11,Mongolia,MN,0,0,3225166,Asia,227,0
2020-07-12,Mongolia,MN,3,0,3225166,Asia,230,0
2020-07-13,Mongolia,MN,0,0,3225166,Asia,230,0
2020-07-14,Mongolia,MN,13,0,3225166,Asia,243,0
2020-07-15,Mongolia,MN,18,0,3225166,Asia,261,0
2020-07-16,Mongolia,MN,0,0,3225166,Asia,261,0
2020-07-17,Mongolia,MN,1,0,3225166,Asia,262,0
2020-07-18,Mongolia,MN,25,0,3225166,Asia,287,0
2020-07-19,Mongolia,MN,0,0,3225166,Asia,287,0
2020-07-20,Mongolia,MN,0,0,3225166,Asia,287,0
2020-07-21,Mongolia,MN,0,0,3225166,Asia,287,0
2020-07-22,Mongolia,MN,0,0,3225166,Asia,287,0
2020-07-23,Mongolia,MN,0,0,3225166,Asia,287,0
2020-07-24,Mongolia,MN,1,0,3225166,Asia,288,0
2020-07-25,Mongolia,MN,0,0,3225166,Asia,288,0
2020-07-26,Mongolia,MN,0,0,3225166,Asia,288,0
2020-07-27,Mongolia,MN,0,0,3225166,Asia,288,0
2020-07-28,Mongolia,MN,1,0,3225166,Asia,289,0
2020-07-29,Mongolia,MN,2,0,3225166,Asia,291,0
2020-07-30,Mongolia,MN,0,0,3225166,Asia,291,0
2020-07-31,Mongolia,MN,0,0,3225166,Asia,291,0
2020-08-01,Mongolia,MN,0,0,3225166,Asia,291,0
2020-08-02,Mongolia,MN,2,0,3225166,Asia,293,0
2020-08-03,Mongolia,MN,0,0,3225166,Asia,293,0
2020-08-04,Mongolia,MN,0,0,3225166,Asia,293,0
2020-08-05,Mongolia,MN,0,0,3225166,Asia,293,0
2020-08-06,Mongolia,MN,0,0,3225166,Asia,293,0
2020-08-07,Mongolia,MN,0,0,3225166,Asia,293,0
2020-08-08,Mongolia,MN,0,0,3225166,Asia,293,0
2020-08-09,Mongolia,MN,0,0,3225166,Asia,293,0
2020-08-10,Mongolia,MN,0,0,3225166,Asia,293,0
2020-08-11,Mongolia,MN,0,0,3225166,Asia,293,0
2020-08-12,Mongolia,MN,0,0,3225166,Asia,293,0
2020-08-13,Mongolia,MN,4,0,3225166,Asia,297,0
2020-08-14,Mongolia,MN,0,0,3225166,Asia,297,0
2020-08-15,Mongolia,MN,1,0,3225166,Asia,298,0
2020-08-16,Mongolia,MN,0,0,3225166,Asia,298,0
2020-08-17,Mongolia,MN,0,0,3225166,Asia,298,0
2020-08-18,Mongolia,MN,0,0,3225166,Asia,298,0
2020-08-19,Mongolia,MN,0,0,3225166,Asia,298,0
2020-08-20,Mongolia,MN,0,0,3225166,Asia,298,0
2020-08-21,Mongolia,MN,0,0,3225166,Asia,298,0
2020-08-22,Mongolia,MN,0,0,3225166,Asia,298,0
2020-08-23,Mongolia,MN,0,0,3225166,Asia,298,0
2020-08-24,Mongolia,MN,0,0,3225166,Asia,298,0
2020-08-25,Mongolia,MN,0,0,3225166,Asia,298,0
2020-08-26,Mongolia,MN,2,0,3225166,Asia,300,0
2020-08-27,Mongolia,MN,1,0,3225166,Asia,301,0
2020-08-28,Mongolia,MN,0,0,3225166,Asia,301,0
2020-08-29,Mongolia,MN,0,0,3225166,Asia,301,0
2020-08-30,Mongolia,MN,0,0,3225166,Asia,301,0
2020-08-31,Mongolia,MN,0,0,3225166,Asia,301,0
2020-09-01,Mongolia,MN,3,0,3225166,Asia,304,0
2020-09-02,Mongolia,MN,2,0,3225166,Asia,306,0
2020-09-03,Mongolia,MN,0,0,3225166,Asia,306,0
2020-09-04,Mongolia,MN,0,0,3225166,Asia,306,0
2020-09-05,Mongolia,MN,0,0,3225166,Asia,306,0
2020-09-06,Mongolia,MN,4,0,3225166,Asia,310,0
2020-09-07,Mongolia,MN,0,0,3225166,Asia,310,0
2020-09-08,Mongolia,MN,0,0,3225166,Asia,310,0
2020-09-09,Mongolia,MN,0,0,3225166,Asia,310,0
2020-09-10,Mongolia,MN,0,0,3225166,Asia,310,0
2020-09-11,Mongolia,MN,1,0,3225166,Asia,311,0
2020-09-12,Mongolia,MN,0,0,3225166,Asia,311,0
2020-09-13,Mongolia,MN,0,0,3225166,Asia,311,0
2020-09-14,Mongolia,MN,0,0,3225166,Asia,311,0
2020-09-15,Mongolia,MN,0,0,3225166,Asia,311,0
2020-09-16,Mongolia,MN,0,0,3225166,Asia,311,0
2020-09-17,Mongolia,MN,0,0,3225166,Asia,311,0
2020-09-18,Mongolia,MN,0,0,3225166,Asia,311,0
2020-09-19,Mongolia,MN,0,0,3225166,Asia,311,0
2020-09-20,Mongolia,MN,1,0,3225166,Asia,312,0
2020-09-21,Mongolia,MN,0,0,3225166,Asia,312,0
2020-09-22,Mongolia,MN,1,0,3225166,Asia,313,0
2020-09-23,Mongolia,MN,0,0,3225166,Asia,313,0
2020-09-24,Mongolia,MN,0,0,3225166,Asia,313,0
2020-09-25,Mongolia,MN,0,0,3225166,Asia,313,0
2020-09-26,Mongolia,MN,0,0,3225166,Asia,313,0
2020-09-27,Mongolia,MN,0,0,3225166,Asia,313,0
2020-09-28,Mongolia,MN,0,0,3225166,Asia,313,0
2020-09-29,Mongolia,MN,0,0,3225166,Asia,313,0
2020-09-30,Mongolia,MN,0,0,3225166,Asia,313,0
2020-10-01,Mongolia,MN,0,0,3225166,Asia,313,0
2020-10-02,Mongolia,MN,0,0,3225166,Asia,313,0
2020-10-03,Mongolia,MN,0,0,3225166,Asia,313,0
2020-10-04,Mongolia,MN,0,0,3225166,Asia,313,0
2020-10-05,Mongolia,MN,1,0,3225166,Asia,314,0
2020-10-06,Mongolia,MN,1,0,3225166,Asia,315,0
2020-10-07,Mongolia,MN,0,0,3225166,Asia,315,0
2020-10-08,Mongolia,MN,0,0,3225166,Asia,315,0
2020-10-09,Mongolia,MN,0,0,3225166,Asia,315,0
2020-10-10,Mongolia,MN,0,0,3225166,Asia,315,0
2020-10-11,Mongolia,MN,1,0,3225166,Asia,316,0
2020-10-12,Mongolia,MN,2,0,3225166,Asia,318,0
2020-10-13,Mongolia,MN,2,0,3225166,Asia,320,0
2020-10-14,Mongolia,MN,0,0,3225166,Asia,320,0
2020-10-15,Mongolia,MN,0,0,3225166,Asia,320,0
2020-10-16,Mongolia,MN,0,0,3225166,Asia,320,0
2020-10-17,Mongolia,MN,0,0,3225166,Asia,320,0
2020-10-18,Mongolia,MN,4,0,3225166,Asia,324,0
2020-10-19,Mongolia,MN,0,0,3225166,Asia,324,0
2020-10-20,Mongolia,MN,2,0,3225166,Asia,326,0
2020-10-21,Mongolia,MN,1,0,3225166,Asia,327,0
2020-10-22,Mongolia,MN,1,0,3225166,Asia,328,0
2020-10-23,Mongolia,MN,0,0,3225166,Asia,328,0
2020-10-24,Mongolia,MN,9,0,3225166,Asia,337,0
2020-10-25,Mongolia,MN,1,0,3225166,Asia,338,0
2020-10-26,Mongolia,MN,1,0,3225166,Asia,339,0
2020-10-27,Mongolia,MN,1,0,3225166,Asia,340,0
2020-10-28,Mongolia,MN,0,0,3225166,Asia,340,0
2020-10-29,Mongolia,MN,0,0,3225166,Asia,340,0
2020-10-30,Mongolia,MN,0,0,3225166,Asia,340,0
2020-10-31,Mongolia,MN,6,0,3225166,Asia,346,0
2020-11-01,Mongolia,MN,0,0,3225166,Asia,346,0
2020-11-02,Mongolia,MN,3,0,3225166,Asia,349,0
2020-11-03,Mongolia,MN,1,0,3225166,Asia,350,0
2020-11-04,Mongolia,MN,2,0,3225166,Asia,352,0
2020-11-05,Mongolia,MN,1,0,3225166,Asia,353,0
2020-11-06,Mongolia,MN,3,0,3225166,Asia,356,0
2020-11-07,Mongolia,MN,1,0,3225166,Asia,357,0
2020-11-08,Mongolia,MN,4,0,3225166,Asia,361,0
2020-11-09,Mongolia,MN,7,0,3225166,Asia,368,0
2020-11-10,Mongolia,MN,0,0,3225166,Asia,368,0
2020-11-11,Mongolia,MN,14,0,3225166,Asia,382,0
2020-11-12,Mongolia,MN,24,0,3225166,Asia,406,0
2020-11-13,Mongolia,MN,6,0,3225166,Asia,412,0
2020-11-14,Mongolia,MN,4,0,3225166,Asia,416,0
2020-11-15,Mongolia,MN,12,0,3225166,Asia,428,0
2020-11-16,Mongolia,MN,3,0,3225166,Asia,431,0
2020-11-17,Mongolia,MN,3,0,3225166,Asia,434,0
2020-11-18,Mongolia,MN,21,0,3225166,Asia,455,0
2020-11-19,Mongolia,MN,50,0,3225166,Asia,505,0
2020-11-20,Mongolia,MN,0,0,3225166,Asia,505,0
2020-11-21,Mongolia,MN,73,0,3225166,Asia,578,0
2020-11-22,Mongolia,MN,30,0,3225166,Asia,608,0
2020-11-23,Mongolia,MN,32,0,3225166,Asia,640,0
2020-11-24,Mongolia,MN,32,0,3225166,Asia,672,0
2020-11-25,Mongolia,MN,27,0,3225166,Asia,699,0
2020-11-26,Mongolia,MN,13,0,3225166,Asia,712,0
2020-11-27,Mongolia,MN,26,0,3225166,Asia,738,0
2020-11-28,Mongolia,MN,22,0,3225166,Asia,760,0
2020-11-29,Mongolia,MN,24,0,3225166,Asia,784,0
2020-11-30,Mongolia,MN,7,0,3225166,Asia,791,0
2020-12-01,Mongolia,MN,10,0,3225166,Asia,801,0
2020-12-02,Mongolia,MN,11,0,3225166,Asia,812,0
2020-12-03,Mongolia,MN,7,0,3225166,Asia,819,0
2020-12-04,Mongolia,MN,12,0,3225166,Asia,831,0
2020-12-05,Mongolia,MN,11,0,3225166,Asia,842,0
2020-12-06,Mongolia,MN,7,0,3225166,Asia,849,0
2020-12-07,Mongolia,MN,38,0,3225166,Asia,887,0
2020-12-08,Mongolia,MN,1,0,3225166,Asia,888,0
2020-12-09,Mongolia,MN,5,0,3225166,Asia,893,0
2020-12-10,Mongolia,MN,5,0,3225166,Asia,898,0
2020-12-11,Mongolia,MN,7,0,3225166,Asia,905,0
2020-12-12,Mongolia,MN,1,0,3225166,Asia,906,0
2020-12-13,Mongolia,MN,1,0,3225166,Asia,907,0
2020-12-14,Mongolia,MN,5,0,3225166,Asia,912,0
2020-03-31,Northern_Mariana_Islands,MP,2,0,57213,Oceania,2,0
2020-04-01,Northern_Mariana_Islands,MP,4,0,57213,Oceania,6,0
2020-04-02,Northern_Mariana_Islands,MP,0,1,57213,Oceania,6,1
2020-04-03,Northern_Mariana_Islands,MP,2,0,57213,Oceania,8,1
2020-04-04,Northern_Mariana_Islands,MP,0,0,57213,Oceania,8,1
2020-04-05,Northern_Mariana_Islands,MP,0,0,57213,Oceania,8,1
2020-04-06,Northern_Mariana_Islands,MP,0,0,57213,Oceania,8,1
2020-04-07,Northern_Mariana_Islands,MP,0,0,57213,Oceania,8,1
2020-04-08,Northern_Mariana_Islands,MP,0,1,57213,Oceania,8,2
2020-04-09,Northern_Mariana_Islands,MP,3,0,57213,Oceania,11,2
2020-04-10,Northern_Mariana_Islands,MP,0,0,57213,Oceania,11,2
2020-04-11,Northern_Mariana_Islands,MP,0,0,57213,Oceania,11,2
2020-04-12,Northern_Mariana_Islands,MP,0,0,57213,Oceania,11,2
2020-04-13,Northern_Mariana_Islands,MP,0,0,57213,Oceania,11,2
2020-04-14,Northern_Mariana_Islands,MP,0,0,57213,Oceania,11,2
2020-04-15,Northern_Mariana_Islands,MP,2,0,57213,Oceania,13,2
2020-04-16,Northern_Mariana_Islands,MP,0,0,57213,Oceania,13,2
2020-04-17,Northern_Mariana_Islands,MP,0,0,57213,Oceania,13,2
2020-04-18,Northern_Mariana_Islands,MP,1,0,57213,Oceania,14,2
2020-04-19,Northern_Mariana_Islands,MP,0,0,57213,Oceania,14,2
2020-04-20,Northern_Mariana_Islands,MP,0,0,57213,Oceania,14,2
2020-04-21,Northern_Mariana_Islands,MP,0,0,57213,Oceania,14,2
2020-04-22,Northern_Mariana_Islands,MP,0,0,57213,Oceania,14,2
2020-04-23,Northern_Mariana_Islands,MP,0,0,57213,Oceania,14,2
2020-04-24,Northern_Mariana_Islands,MP,0,0,57213,Oceania,14,2
2020-04-25,Northern_Mariana_Islands,MP,0,0,57213,Oceania,14,2
2020-04-26,Northern_Mariana_Islands,MP,0,0,57213,Oceania,14,2
2020-04-27,Northern_Mariana_Islands,MP,0,0,57213,Oceania,14,2
2020-04-28,Northern_Mariana_Islands,MP,0,0,57213,Oceania,14,2
2020-04-29,Northern_Mariana_Islands,MP,0,0,57213,Oceania,14,2
2020-04-30,Northern_Mariana_Islands,MP,0,0,57213,Oceania,14,2
2020-05-01,Northern_Mariana_Islands,MP,0,0,57213,Oceania,14,2
2020-05-02,Northern_Mariana_Islands,MP,0,0,57213,Oceania,14,2
2020-05-03,Northern_Mariana_Islands,MP,0,0,57213,Oceania,14,2
2020-05-04,Northern_Mariana_Islands,MP,0,0,57213,Oceania,14,2
2020-05-05,Northern_Mariana_Islands,MP,0,0,57213,Oceania,14,2
2020-05-06,Northern_Mariana_Islands,MP,0,0,57213,Oceania,14,2
2020-05-07,Northern_Mariana_Islands,MP,1,0,57213,Oceania,15,2
2020-05-08,Northern_Mariana_Islands,MP,0,0,57213,Oceania,15,2
2020-05-09,Northern_Mariana_Islands,MP,0,0,57213,Oceania,15,2
2020-05-10,Northern_Mariana_Islands,MP,1,0,57213,Oceania,16,2
2020-05-11,Northern_Mariana_Islands,MP,0,0,57213,Oceania,16,2
2020-05-12,Northern_Mariana_Islands,MP,3,0,57213,Oceania,19,2
2020-05-13,Northern_Mariana_Islands,MP,0,0,57213,Oceania,19,2
2020-05-14,Northern_Mariana_Islands,MP,0,0,57213,Oceania,19,2
2020-05-15,Northern_Mariana_Islands,MP,0,0,57213,Oceania,19,2
2020-05-16,Northern_Mariana_Islands,MP,0,0,57213,Oceania,19,2
2020-05-17,Northern_Mariana_Islands,MP,2,0,57213,Oceania,21,2
2020-05-18,Northern_Mariana_Islands,MP,0,0,57213,Oceania,21,2
2020-05-19,Northern_Mariana_Islands,MP,0,0,57213,Oceania,21,2
2020-05-20,Northern_Mariana_Islands,MP,0,0,57213,Oceania,21,2
2020-05-21,Northern_Mariana_Islands,MP,1,0,57213,Oceania,22,2
2020-05-22,Northern_Mariana_Islands,MP,0,0,57213,Oceania,22,2
2020-05-23,Northern_Mariana_Islands,MP,0,0,57213,Oceania,22,2
2020-05-24,Northern_Mariana_Islands,MP,0,0,57213,Oceania,22,2
2020-05-25,Northern_Mariana_Islands,MP,0,0,57213,Oceania,22,2
2020-05-26,Northern_Mariana_Islands,MP,0,0,57213,Oceania,22,2
2020-05-27,Northern_Mariana_Islands,MP,0,0,57213,Oceania,22,2
2020-05-28,Northern_Mariana_Islands,MP,0,0,57213,Oceania,22,2
2020-05-29,Northern_Mariana_Islands,MP,0,0,57213,Oceania,22,2
2020-05-30,Northern_Mariana_Islands,MP,0,0,57213,Oceania,22,2
2020-05-31,Northern_Mariana_Islands,MP,0,0,57213,Oceania,22,2
2020-06-01,Northern_Mariana_Islands,MP,0,0,57213,Oceania,22,2
2020-06-02,Northern_Mariana_Islands,MP,0,0,57213,Oceania,22,2
2020-06-03,Northern_Mariana_Islands,MP,1,0,57213,Oceania,23,2
2020-06-04,Northern_Mariana_Islands,MP,1,0,57213,Oceania,24,2
2020-06-05,Northern_Mariana_Islands,MP,2,0,57213,Oceania,26,2
2020-06-06,Northern_Mariana_Islands,MP,0,0,57213,Oceania,26,2
2020-06-07,Northern_Mariana_Islands,MP,1,0,57213,Oceania,27,2
2020-06-08,Northern_Mariana_Islands,MP,0,0,57213,Oceania,27,2
2020-06-09,Northern_Mariana_Islands,MP,1,0,57213,Oceania,28,2
2020-06-10,Northern_Mariana_Islands,MP,2,0,57213,Oceania,30,2
2020-06-11,Northern_Mariana_Islands,MP,0,0,57213,Oceania,30,2
2020-06-12,Northern_Mariana_Islands,MP,0,0,57213,Oceania,30,2
2020-06-13,Northern_Mariana_Islands,MP,0,0,57213,Oceania,30,2
2020-06-14,Northern_Mariana_Islands,MP,0,0,57213,Oceania,30,2
2020-06-15,Northern_Mariana_Islands,MP,0,0,57213,Oceania,30,2
2020-06-16,Northern_Mariana_Islands,MP,0,0,57213,Oceania,30,2
2020-06-17,Northern_Mariana_Islands,MP,0,0,57213,Oceania,30,2
2020-06-18,Northern_Mariana_Islands,MP,0,0,57213,Oceania,30,2
2020-06-19,Northern_Mariana_Islands,MP,0,0,57213,Oceania,30,2
2020-06-20,Northern_Mariana_Islands,MP,0,0,57213,Oceania,30,2
2020-06-21,Northern_Mariana_Islands,MP,0,0,57213,Oceania,30,2
2020-06-22,Northern_Mariana_Islands,MP,0,0,57213,Oceania,30,2
2020-06-23,Northern_Mariana_Islands,MP,0,0,57213,Oceania,30,2
2020-06-24,Northern_Mariana_Islands,MP,0,0,57213,Oceania,30,2
2020-06-25,Northern_Mariana_Islands,MP,0,0,57213,Oceania,30,2
2020-06-26,Northern_Mariana_Islands,MP,0,0,57213,Oceania,30,2
2020-06-27,Northern_Mariana_Islands,MP,0,0,57213,Oceania,30,2
2020-06-28,Northern_Mariana_Islands,MP,0,0,57213,Oceania,30,2
2020-06-29,Northern_Mariana_Islands,MP,0,0,57213,Oceania,30,2
2020-06-30,Northern_Mariana_Islands,MP,0,0,57213,Oceania,30,2
2020-07-01,Northern_Mariana_Islands,MP,0,0,57213,Oceania,30,2
2020-07-02,Northern_Mariana_Islands,MP,0,0,57213,Oceania,30,2
2020-07-03,Northern_Mariana_Islands,MP,1,0,57213,Oceania,31,2
2020-07-04,Northern_Mariana_Islands,MP,0,0,57213,Oceania,31,2
2020-07-05,Northern_Mariana_Islands,MP,0,0,57213,Oceania,31,2
2020-07-06,Northern_Mariana_Islands,MP,0,0,57213,Oceania,31,2
2020-07-07,Northern_Mariana_Islands,MP,0,0,57213,Oceania,31,2
2020-07-08,Northern_Mariana_Islands,MP,0,0,57213,Oceania,31,2
2020-07-09,Northern_Mariana_Islands,MP,0,0,57213,Oceania,31,2
2020-07-10,Northern_Mariana_Islands,MP,0,0,57213,Oceania,31,2
2020-07-11,Northern_Mariana_Islands,MP,0,0,57213,Oceania,31,2
2020-07-12,Northern_Mariana_Islands,MP,2,0,57213,Oceania,33,2
2020-07-13,Northern_Mariana_Islands,MP,0,0,57213,Oceania,33,2
2020-07-14,Northern_Mariana_Islands,MP,0,0,57213,Oceania,33,2
2020-07-15,Northern_Mariana_Islands,MP,3,0,57213,Oceania,36,2
2020-07-16,Northern_Mariana_Islands,MP,0,0,57213,Oceania,36,2
2020-07-17,Northern_Mariana_Islands,MP,1,0,57213,Oceania,37,2
2020-07-18,Northern_Mariana_Islands,MP,0,0,57213,Oceania,37,2
2020-07-19,Northern_Mariana_Islands,MP,0,0,57213,Oceania,37,2
2020-07-20,Northern_Mariana_Islands,MP,0,0,57213,Oceania,37,2
2020-07-21,Northern_Mariana_Islands,MP,1,0,57213,Oceania,38,2
2020-07-22,Northern_Mariana_Islands,MP,0,0,57213,Oceania,38,2
2020-07-23,Northern_Mariana_Islands,MP,0,0,57213,Oceania,38,2
2020-07-24,Northern_Mariana_Islands,MP,0,0,57213,Oceania,38,2
2020-07-25,Northern_Mariana_Islands,MP,0,0,57213,Oceania,38,2
2020-07-26,Northern_Mariana_Islands,MP,2,0,57213,Oceania,40,2
2020-07-27,Northern_Mariana_Islands,MP,0,0,57213,Oceania,40,2
2020-07-28,Northern_Mariana_Islands,MP,0,0,57213,Oceania,40,2
2020-07-29,Northern_Mariana_Islands,MP,0,0,57213,Oceania,40,2
2020-07-30,Northern_Mariana_Islands,MP,2,0,57213,Oceania,42,2
2020-07-31,Northern_Mariana_Islands,MP,0,0,57213,Oceania,42,2
2020-08-01,Northern_Mariana_Islands,MP,0,0,57213,Oceania,42,2
2020-08-02,Northern_Mariana_Islands,MP,3,0,57213,Oceania,45,2
2020-08-03,Northern_Mariana_Islands,MP,1,0,57213,Oceania,46,2
2020-08-04,Northern_Mariana_Islands,MP,0,0,57213,Oceania,46,2
2020-08-05,Northern_Mariana_Islands,MP,0,0,57213,Oceania,46,2
2020-08-06,Northern_Mariana_Islands,MP,0,0,57213,Oceania,46,2
2020-08-07,Northern_Mariana_Islands,MP,1,0,57213,Oceania,47,2
2020-08-08,Northern_Mariana_Islands,MP,0,0,57213,Oceania,47,2
2020-08-09,Northern_Mariana_Islands,MP,1,0,57213,Oceania,48,2
2020-08-10,Northern_Mariana_Islands,MP,0,0,57213,Oceania,48,2
2020-08-11,Northern_Mariana_Islands,MP,1,0,57213,Oceania,49,2
2020-08-12,Northern_Mariana_Islands,MP,0,0,57213,Oceania,49,2
2020-08-13,Northern_Mariana_Islands,MP,0,0,57213,Oceania,49,2
2020-08-14,Northern_Mariana_Islands,MP,0,0,57213,Oceania,49,2
2020-08-15,Northern_Mariana_Islands,MP,1,0,57213,Oceania,50,2
2020-08-16,Northern_Mariana_Islands,MP,0,0,57213,Oceania,50,2
2020-08-17,Northern_Mariana_Islands,MP,0,0,57213,Oceania,50,2
2020-08-18,Northern_Mariana_Islands,MP,4,0,57213,Oceania,54,2
2020-08-19,Northern_Mariana_Islands,MP,0,0,57213,Oceania,54,2
2020-08-20,Northern_Mariana_Islands,MP,0,0,57213,Oceania,54,2
2020-08-21,Northern_Mariana_Islands,MP,0,0,57213,Oceania,54,2
2020-08-22,Northern_Mariana_Islands,MP,0,0,57213,Oceania,54,2
2020-08-23,Northern_Mariana_Islands,MP,0,0,57213,Oceania,54,2
2020-08-24,Northern_Mariana_Islands,MP,0,0,57213,Oceania,54,2
2020-08-25,Northern_Mariana_Islands,MP,0,0,57213,Oceania,54,2
2020-08-26,Northern_Mariana_Islands,MP,0,0,57213,Oceania,54,2
2020-08-27,Northern_Mariana_Islands,MP,0,0,57213,Oceania,54,2
2020-08-28,Northern_Mariana_Islands,MP,0,0,57213,Oceania,54,2
2020-08-29,Northern_Mariana_Islands,MP,2,0,57213,Oceania,56,2
2020-08-30,Northern_Mariana_Islands,MP,0,0,57213,Oceania,56,2
2020-08-31,Northern_Mariana_Islands,MP,0,0,57213,Oceania,56,2
2020-09-01,Northern_Mariana_Islands,MP,0,0,57213,Oceania,56,2
2020-09-02,Northern_Mariana_Islands,MP,1,0,57213,Oceania,57,2
2020-09-03,Northern_Mariana_Islands,MP,0,0,57213,Oceania,57,2
2020-09-04,Northern_Mariana_Islands,MP,0,0,57213,Oceania,57,2
2020-09-05,Northern_Mariana_Islands,MP,0,0,57213,Oceania,57,2
2020-09-06,Northern_Mariana_Islands,MP,1,0,57213,Oceania,58,2
2020-09-07,Northern_Mariana_Islands,MP,0,0,57213,Oceania,58,2
2020-09-08,Northern_Mariana_Islands,MP,1,0,57213,Oceania,59,2
2020-09-09,Northern_Mariana_Islands,MP,0,0,57213,Oceania,59,2
2020-09-10,Northern_Mariana_Islands,MP,0,0,57213,Oceania,59,2
2020-09-11,Northern_Mariana_Islands,MP,0,0,57213,Oceania,59,2
2020-09-12,Northern_Mariana_Islands,MP,0,0,57213,Oceania,59,2
2020-09-13,Northern_Mariana_Islands,MP,1,0,57213,Oceania,60,2
2020-09-14,Northern_Mariana_Islands,MP,0,0,57213,Oceania,60,2
2020-09-15,Northern_Mariana_Islands,MP,1,0,57213,Oceania,61,2
2020-09-16,Northern_Mariana_Islands,MP,0,0,57213,Oceania,61,2
2020-09-17,Northern_Mariana_Islands,MP,0,0,57213,Oceania,61,2
2020-09-18,Northern_Mariana_Islands,MP,1,0,57213,Oceania,62,2
2020-09-19,Northern_Mariana_Islands,MP,0,0,57213,Oceania,62,2
2020-09-20,Northern_Mariana_Islands,MP,6,0,57213,Oceania,68,2
2020-09-21,Northern_Mariana_Islands,MP,1,0,57213,Oceania,69,2
2020-09-22,Northern_Mariana_Islands,MP,0,0,57213,Oceania,69,2
2020-09-23,Northern_Mariana_Islands,MP,0,0,57213,Oceania,69,2
2020-09-24,Northern_Mariana_Islands,MP,0,0,57213,Oceania,69,2
2020-09-25,Northern_Mariana_Islands,MP,0,0,57213,Oceania,69,2
2020-09-26,Northern_Mariana_Islands,MP,0,0,57213,Oceania,69,2
2020-09-27,Northern_Mariana_Islands,MP,0,0,57213,Oceania,69,2
2020-09-28,Northern_Mariana_Islands,MP,1,0,57213,Oceania,70,2
2020-09-29,Northern_Mariana_Islands,MP,0,0,57213,Oceania,70,2
2020-09-30,Northern_Mariana_Islands,MP,0,0,57213,Oceania,70,2
2020-10-01,Northern_Mariana_Islands,MP,0,0,57213,Oceania,70,2
2020-10-02,Northern_Mariana_Islands,MP,3,0,57213,Oceania,73,2
2020-10-03,Northern_Mariana_Islands,MP,0,0,57213,Oceania,73,2
2020-10-04,Northern_Mariana_Islands,MP,0,0,57213,Oceania,73,2
2020-10-05,Northern_Mariana_Islands,MP,0,0,57213,Oceania,73,2
2020-10-06,Northern_Mariana_Islands,MP,2,0,57213,Oceania,75,2
2020-10-07,Northern_Mariana_Islands,MP,0,0,57213,Oceania,75,2
2020-10-08,Northern_Mariana_Islands,MP,0,0,57213,Oceania,75,2
2020-10-09,Northern_Mariana_Islands,MP,0,0,57213,Oceania,75,2
2020-10-10,Northern_Mariana_Islands,MP,0,0,57213,Oceania,75,2
2020-10-11,Northern_Mariana_Islands,MP,2,0,57213,Oceania,77,2
2020-10-12,Northern_Mariana_Islands,MP,0,0,57213,Oceania,77,2
2020-10-13,Northern_Mariana_Islands,MP,0,0,57213,Oceania,77,2
2020-10-14,Northern_Mariana_Islands,MP,0,0,57213,Oceania,77,2
2020-10-15,Northern_Mariana_Islands,MP,0,0,57213,Oceania,77,2
2020-10-16,Northern_Mariana_Islands,MP,3,0,57213,Oceania,80,2
2020-10-17,Northern_Mariana_Islands,MP,0,0,57213,Oceania,80,2
2020-10-18,Northern_Mariana_Islands,MP,6,0,57213,Oceania,86,2
2020-10-19,Northern_Mariana_Islands,MP,0,0,57213,Oceania,86,2
2020-10-20,Northern_Mariana_Islands,MP,2,0,57213,Oceania,88,2
2020-10-21,Northern_Mariana_Islands,MP,0,0,57213,Oceania,88,2
2020-10-22,Northern_Mariana_Islands,MP,0,0,57213,Oceania,88,2
2020-10-23,Northern_Mariana_Islands,MP,0,0,57213,Oceania,88,2
2020-10-24,Northern_Mariana_Islands,MP,0,0,57213,Oceania,88,2
2020-10-25,Northern_Mariana_Islands,MP,0,0,57213,Oceania,88,2
2020-10-26,Northern_Mariana_Islands,MP,4,0,57213,Oceania,92,2
2020-10-27,Northern_Mariana_Islands,MP,0,0,57213,Oceania,92,2
2020-10-28,Northern_Mariana_Islands,MP,0,0,57213,Oceania,92,2
2020-10-29,Northern_Mariana_Islands,MP,0,0,57213,Oceania,92,2
2020-10-30,Northern_Mariana_Islands,MP,0,0,57213,Oceania,92,2
2020-10-31,Northern_Mariana_Islands,MP,0,0,57213,Oceania,92,2
2020-11-01,Northern_Mariana_Islands,MP,4,0,57213,Oceania,96,2
2020-11-02,Northern_Mariana_Islands,MP,0,0,57213,Oceania,96,2
2020-11-03,Northern_Mariana_Islands,MP,0,0,57213,Oceania,96,2
2020-11-04,Northern_Mariana_Islands,MP,0,0,57213,Oceania,96,2
2020-11-05,Northern_Mariana_Islands,MP,0,0,57213,Oceania,96,2
2020-11-06,Northern_Mariana_Islands,MP,2,0,57213,Oceania,98,2
2020-11-07,Northern_Mariana_Islands,MP,0,0,57213,Oceania,98,2
2020-11-08,Northern_Mariana_Islands,MP,0,0,57213,Oceania,98,2
2020-11-09,Northern_Mariana_Islands,MP,2,0,57213,Oceania,100,2
2020-11-10,Northern_Mariana_Islands,MP,0,0,57213,Oceania,100,2
2020-11-11,Northern_Mariana_Islands,MP,0,0,57213,Oceania,100,2
2020-11-12,Northern_Mariana_Islands,MP,0,0,57213,Oceania,100,2
2020-11-13,Northern_Mariana_Islands,MP,0,0,57213,Oceania,100,2
2020-11-14,Northern_Mariana_Islands,MP,0,0,57213,Oceania,100,2
2020-11-15,Northern_Mariana_Islands,MP,0,0,57213,Oceania,100,2
2020-11-16,Northern_Mariana_Islands,MP,2,0,57213,Oceania,102,2
2020-11-17,Northern_Mariana_Islands,MP,1,0,57213,Oceania,103,2
2020-11-18,Northern_Mariana_Islands,MP,0,0,57213,Oceania,103,2
2020-11-19,Northern_Mariana_Islands,MP,0,0,57213,Oceania,103,2
2020-11-20,Northern_Mariana_Islands,MP,0,0,57213,Oceania,103,2
2020-11-21,Northern_Mariana_Islands,MP,0,0,57213,Oceania,103,2
2020-11-22,Northern_Mariana_Islands,MP,0,0,57213,Oceania,103,2
2020-11-23,Northern_Mariana_Islands,MP,1,0,57213,Oceania,104,2
2020-11-24,Northern_Mariana_Islands,MP,0,0,57213,Oceania,104,2
2020-11-25,Northern_Mariana_Islands,MP,0,0,57213,Oceania,104,2
2020-11-26,Northern_Mariana_Islands,MP,0,0,57213,Oceania,104,2
2020-11-27,Northern_Mariana_Islands,MP,0,0,57213,Oceania,104,2
2020-11-28,Northern_Mariana_Islands,MP,0,0,57213,Oceania,104,2
2020-11-29,Northern_Mariana_Islands,MP,0,0,57213,Oceania,104,2
2020-11-30,Northern_Mariana_Islands,MP,2,0,57213,Oceania,106,2
2020-12-01,Northern_Mariana_Islands,MP,0,0,57213,Oceania,106,2
2020-12-02,Northern_Mariana_Islands,MP,0,0,57213,Oceania,106,2
2020-12-03,Northern_Mariana_Islands,MP,0,0,57213,Oceania,106,2
2020-12-04,Northern_Mariana_Islands,MP,0,0,57213,Oceania,106,2
2020-12-05,Northern_Mariana_Islands,MP,0,0,57213,Oceania,106,2
2020-12-06,Northern_Mariana_Islands,MP,0,0,57213,Oceania,106,2
2020-12-07,Northern_Mariana_Islands,MP,3,0,57213,Oceania,109,2
2020-12-08,Northern_Mariana_Islands,MP,2,0,57213,Oceania,111,2
2020-12-09,Northern_Mariana_Islands,MP,2,0,57213,Oceania,113,2
2020-12-10,Northern_Mariana_Islands,MP,0,0,57213,Oceania,113,2
2020-12-11,Northern_Mariana_Islands,MP,0,0,57213,Oceania,113,2
2020-12-12,Northern_Mariana_Islands,MP,0,0,57213,Oceania,113,2
2020-12-13,Northern_Mariana_Islands,MP,0,0,57213,Oceania,113,2
2020-12-14,Northern_Mariana_Islands,MP,0,0,57213,Oceania,113,2
2020-03-15,Mauritania,MR,1,0,4525698,Africa,1,0
2020-03-16,Mauritania,MR,0,0,4525698,Africa,1,0
2020-03-17,Mauritania,MR,0,0,4525698,Africa,1,0
2020-03-18,Mauritania,MR,0,0,4525698,Africa,1,0
2020-03-19,Mauritania,MR,0,0,4525698,Africa,1,0
2020-03-20,Mauritania,MR,1,0,4525698,Africa,2,0
2020-03-21,Mauritania,MR,0,0,4525698,Africa,2,0
2020-03-22,Mauritania,MR,0,0,4525698,Africa,2,0
2020-03-23,Mauritania,MR,0,0,4525698,Africa,2,0
2020-03-24,Mauritania,MR,0,0,4525698,Africa,2,0
2020-03-25,Mauritania,MR,0,0,4525698,Africa,2,0
2020-03-26,Mauritania,MR,0,0,4525698,Africa,2,0
2020-03-27,Mauritania,MR,1,0,4525698,Africa,3,0
2020-03-28,Mauritania,MR,0,0,4525698,Africa,3,0
2020-03-29,Mauritania,MR,2,0,4525698,Africa,5,0
2020-03-30,Mauritania,MR,0,0,4525698,Africa,5,0
2020-03-31,Mauritania,MR,0,0,4525698,Africa,5,0
2020-04-01,Mauritania,MR,0,0,4525698,Africa,5,0
2020-04-02,Mauritania,MR,0,0,4525698,Africa,5,0
2020-04-03,Mauritania,MR,1,1,4525698,Africa,6,1
2020-04-04,Mauritania,MR,0,0,4525698,Africa,6,1
2020-04-05,Mauritania,MR,0,0,4525698,Africa,6,1
2020-04-06,Mauritania,MR,0,0,4525698,Africa,6,1
2020-04-07,Mauritania,MR,0,0,4525698,Africa,6,1
2020-04-08,Mauritania,MR,0,0,4525698,Africa,6,1
2020-04-09,Mauritania,MR,0,0,4525698,Africa,6,1
2020-04-10,Mauritania,MR,1,0,4525698,Africa,7,1
2020-04-11,Mauritania,MR,0,0,4525698,Africa,7,1
2020-04-12,Mauritania,MR,0,0,4525698,Africa,7,1
2020-04-13,Mauritania,MR,0,0,4525698,Africa,7,1
2020-04-14,Mauritania,MR,0,0,4525698,Africa,7,1
2020-04-15,Mauritania,MR,0,0,4525698,Africa,7,1
2020-04-16,Mauritania,MR,0,0,4525698,Africa,7,1
2020-04-17,Mauritania,MR,0,0,4525698,Africa,7,1
2020-04-18,Mauritania,MR,0,0,4525698,Africa,7,1
2020-04-19,Mauritania,MR,0,0,4525698,Africa,7,1
2020-04-20,Mauritania,MR,0,0,4525698,Africa,7,1
2020-04-21,Mauritania,MR,0,0,4525698,Africa,7,1
2020-04-22,Mauritania,MR,0,0,4525698,Africa,7,1
2020-04-23,Mauritania,MR,0,0,4525698,Africa,7,1
2020-04-24,Mauritania,MR,0,0,4525698,Africa,7,1
2020-04-25,Mauritania,MR,0,0,4525698,Africa,7,1
2020-04-26,Mauritania,MR,0,0,4525698,Africa,7,1
2020-04-27,Mauritania,MR,0,0,4525698,Africa,7,1
2020-04-28,Mauritania,MR,0,0,4525698,Africa,7,1
2020-04-29,Mauritania,MR,0,0,4525698,Africa,7,1
2020-04-30,Mauritania,MR,0,0,4525698,Africa,7,1
2020-05-01,Mauritania,MR,1,0,4525698,Africa,8,1
2020-05-02,Mauritania,MR,0,0,4525698,Africa,8,1
2020-05-03,Mauritania,MR,0,0,4525698,Africa,8,1
2020-05-04,Mauritania,MR,0,0,4525698,Africa,8,1
2020-05-05,Mauritania,MR,0,0,4525698,Africa,8,1
2020-05-06,Mauritania,MR,0,0,4525698,Africa,8,1
2020-05-07,Mauritania,MR,0,0,4525698,Africa,8,1
2020-05-08,Mauritania,MR,0,0,4525698,Africa,8,1
2020-05-09,Mauritania,MR,0,0,4525698,Africa,8,1
2020-05-10,Mauritania,MR,0,0,4525698,Africa,8,1
2020-05-11,Mauritania,MR,0,0,4525698,Africa,8,1
2020-05-12,Mauritania,MR,0,0,4525698,Africa,8,1
2020-05-13,Mauritania,MR,0,0,4525698,Africa,8,1
2020-05-14,Mauritania,MR,1,1,4525698,Africa,9,2
2020-05-15,Mauritania,MR,7,0,4525698,Africa,16,2
2020-05-16,Mauritania,MR,13,1,4525698,Africa,29,3
2020-05-17,Mauritania,MR,0,0,4525698,Africa,29,3
2020-05-18,Mauritania,MR,33,1,4525698,Africa,62,4
2020-05-19,Mauritania,MR,19,0,4525698,Africa,81,4
2020-05-20,Mauritania,MR,0,0,4525698,Africa,81,4
2020-05-21,Mauritania,MR,50,0,4525698,Africa,131,4
2020-05-22,Mauritania,MR,42,1,4525698,Africa,173,5
2020-05-23,Mauritania,MR,0,0,4525698,Africa,173,5
2020-05-24,Mauritania,MR,54,1,4525698,Africa,227,6
2020-05-25,Mauritania,MR,10,0,4525698,Africa,237,6
2020-05-26,Mauritania,MR,0,0,4525698,Africa,237,6
2020-05-27,Mauritania,MR,25,3,4525698,Africa,262,9
2020-05-28,Mauritania,MR,30,7,4525698,Africa,292,16
2020-05-29,Mauritania,MR,0,0,4525698,Africa,292,16
2020-05-30,Mauritania,MR,131,4,4525698,Africa,423,20
2020-05-31,Mauritania,MR,60,1,4525698,Africa,483,21
2020-06-01,Mauritania,MR,47,2,4525698,Africa,530,23
2020-06-02,Mauritania,MR,0,0,4525698,Africa,530,23
2020-06-03,Mauritania,MR,138,8,4525698,Africa,668,31
2020-06-04,Mauritania,MR,0,0,4525698,Africa,668,31
2020-06-05,Mauritania,MR,116,8,4525698,Africa,784,39
2020-06-06,Mauritania,MR,99,4,4525698,Africa,883,43
2020-06-07,Mauritania,MR,64,0,4525698,Africa,947,43
2020-06-08,Mauritania,MR,0,0,4525698,Africa,947,43
2020-06-09,Mauritania,MR,0,0,4525698,Africa,947,43
2020-06-10,Mauritania,MR,215,18,4525698,Africa,1162,61
2020-06-11,Mauritania,MR,0,0,4525698,Africa,1162,61
2020-06-12,Mauritania,MR,0,0,4525698,Africa,1162,61
2020-06-13,Mauritania,MR,277,13,4525698,Africa,1439,74
2020-06-14,Mauritania,MR,0,0,4525698,Africa,1439,74
2020-06-15,Mauritania,MR,344,13,4525698,Africa,1783,87
2020-06-16,Mauritania,MR,104,4,4525698,Africa,1887,91
2020-06-17,Mauritania,MR,170,2,4525698,Africa,2057,93
2020-06-18,Mauritania,MR,0,0,4525698,Africa,2057,93
2020-06-19,Mauritania,MR,166,2,4525698,Africa,2223,95
2020-06-20,Mauritania,MR,0,0,4525698,Africa,2223,95
2020-06-21,Mauritania,MR,590,13,4525698,Africa,2813,108
2020-06-22,Mauritania,MR,0,0,4525698,Africa,2813,108
2020-06-23,Mauritania,MR,171,3,4525698,Africa,2984,111
2020-06-24,Mauritania,MR,0,0,4525698,Africa,2984,111
2020-06-25,Mauritania,MR,308,3,4525698,Africa,3292,114
2020-06-26,Mauritania,MR,447,5,4525698,Africa,3739,119
2020-06-27,Mauritania,MR,0,0,4525698,Africa,3739,119
2020-06-28,Mauritania,MR,168,1,4525698,Africa,3907,120
2020-06-29,Mauritania,MR,0,0,4525698,Africa,3907,120
2020-06-30,Mauritania,MR,242,6,4525698,Africa,4149,126
2020-07-01,Mauritania,MR,0,0,4525698,Africa,4149,126
2020-07-02,Mauritania,MR,0,0,4525698,Africa,4149,126
2020-07-03,Mauritania,MR,323,3,4525698,Africa,4472,129
2020-07-04,Mauritania,MR,0,0,4525698,Africa,4472,129
2020-07-05,Mauritania,MR,355,0,4525698,Africa,4827,129
2020-07-06,Mauritania,MR,52,1,4525698,Africa,4879,130
2020-07-07,Mauritania,MR,0,0,4525698,Africa,4879,130
2020-07-08,Mauritania,MR,0,0,4525698,Africa,4879,130
2020-07-09,Mauritania,MR,145,5,4525698,Africa,5024,135
2020-07-10,Mauritania,MR,63,4,4525698,Africa,5087,139
2020-07-11,Mauritania,MR,39,5,4525698,Africa,5126,144
2020-07-12,Mauritania,MR,0,0,4525698,Africa,5126,144
2020-07-13,Mauritania,MR,0,0,4525698,Africa,5126,144
2020-07-14,Mauritania,MR,229,3,4525698,Africa,5355,147
2020-07-15,Mauritania,MR,91,2,4525698,Africa,5446,149
2020-07-16,Mauritania,MR,0,0,4525698,Africa,5446,149
2020-07-17,Mauritania,MR,0,0,4525698,Africa,5446,149
2020-07-18,Mauritania,MR,0,0,4525698,Africa,5446,149
2020-07-19,Mauritania,MR,0,0,4525698,Africa,5446,149
2020-07-20,Mauritania,MR,427,6,4525698,Africa,5873,155
2020-07-21,Mauritania,MR,50,0,4525698,Africa,5923,155
2020-07-22,Mauritania,MR,0,0,4525698,Africa,5923,155
2020-07-23,Mauritania,MR,0,0,4525698,Africa,5923,155
2020-07-24,Mauritania,MR,104,0,4525698,Africa,6027,155
2020-07-25,Mauritania,MR,40,1,4525698,Africa,6067,156
2020-07-26,Mauritania,MR,0,0,4525698,Africa,6067,156
2020-07-27,Mauritania,MR,104,0,4525698,Africa,6171,156
2020-07-28,Mauritania,MR,0,0,4525698,Africa,6171,156
2020-07-29,Mauritania,MR,0,0,4525698,Africa,6171,156
2020-07-30,Mauritania,MR,78,0,4525698,Africa,6249,156
2020-07-31,Mauritania,MR,21,0,4525698,Africa,6270,156
2020-08-01,Mauritania,MR,25,1,4525698,Africa,6295,157
2020-08-02,Mauritania,MR,15,0,4525698,Africa,6310,157
2020-08-03,Mauritania,MR,0,0,4525698,Africa,6310,157
2020-08-04,Mauritania,MR,13,0,4525698,Africa,6323,157
2020-08-05,Mauritania,MR,59,0,4525698,Africa,6382,157
2020-08-06,Mauritania,MR,0,0,4525698,Africa,6382,157
2020-08-07,Mauritania,MR,0,0,4525698,Africa,6382,157
2020-08-08,Mauritania,MR,0,0,4525698,Africa,6382,157
2020-08-09,Mauritania,MR,116,0,4525698,Africa,6498,157
2020-08-10,Mauritania,MR,0,0,4525698,Africa,6498,157
2020-08-11,Mauritania,MR,0,0,4525698,Africa,6498,157
2020-08-12,Mauritania,MR,52,0,4525698,Africa,6550,157
2020-08-13,Mauritania,MR,48,0,4525698,Africa,6598,157
2020-08-14,Mauritania,MR,24,0,4525698,Africa,6622,157
2020-08-15,Mauritania,MR,0,0,4525698,Africa,6622,157
2020-08-16,Mauritania,MR,0,0,4525698,Africa,6622,157
2020-08-17,Mauritania,MR,79,0,4525698,Africa,6701,157
2020-08-18,Mauritania,MR,0,0,4525698,Africa,6701,157
2020-08-19,Mauritania,MR,88,0,4525698,Africa,6789,157
2020-08-20,Mauritania,MR,40,1,4525698,Africa,6829,158
2020-08-21,Mauritania,MR,0,0,4525698,Africa,6829,158
2020-08-22,Mauritania,MR,56,0,4525698,Africa,6885,158
2020-08-23,Mauritania,MR,0,0,4525698,Africa,6885,158
2020-08-24,Mauritania,MR,0,0,4525698,Africa,6885,158
2020-08-25,Mauritania,MR,20,0,4525698,Africa,6905,158
2020-08-26,Mauritania,MR,23,0,4525698,Africa,6928,158
2020-08-27,Mauritania,MR,32,0,4525698,Africa,6960,158
2020-08-28,Mauritania,MR,17,0,4525698,Africa,6977,158
2020-08-29,Mauritania,MR,0,0,4525698,Africa,6977,158
2020-08-30,Mauritania,MR,35,0,4525698,Africa,7012,158
2020-08-31,Mauritania,MR,10,1,4525698,Africa,7022,159
2020-09-01,Mauritania,MR,26,0,4525698,Africa,7048,159
2020-09-02,Mauritania,MR,27,0,4525698,Africa,7075,159
2020-09-03,Mauritania,MR,14,1,4525698,Africa,7089,160
2020-09-04,Mauritania,MR,17,0,4525698,Africa,7106,160
2020-09-05,Mauritania,MR,20,0,4525698,Africa,7126,160
2020-09-06,Mauritania,MR,8,0,4525698,Africa,7134,160
2020-09-07,Mauritania,MR,0,0,4525698,Africa,7134,160
2020-09-08,Mauritania,MR,8,0,4525698,Africa,7142,160
2020-09-09,Mauritania,MR,7,0,4525698,Africa,7149,160
2020-09-10,Mauritania,MR,15,0,4525698,Africa,7164,160
2020-09-11,Mauritania,MR,38,1,4525698,Africa,7202,161
2020-09-12,Mauritania,MR,20,0,4525698,Africa,7222,161
2020-09-13,Mauritania,MR,44,0,4525698,Africa,7266,161
2020-09-14,Mauritania,MR,10,0,4525698,Africa,7276,161
2020-09-15,Mauritania,MR,19,0,4525698,Africa,7295,161
2020-09-16,Mauritania,MR,24,0,4525698,Africa,7319,161
2020-09-17,Mauritania,MR,0,0,4525698,Africa,7319,161
2020-09-18,Mauritania,MR,13,0,4525698,Africa,7332,161
2020-09-19,Mauritania,MR,29,0,4525698,Africa,7361,161
2020-09-20,Mauritania,MR,0,0,4525698,Africa,7361,161
2020-09-21,Mauritania,MR,7,0,4525698,Africa,7368,161
2020-09-22,Mauritania,MR,16,0,4525698,Africa,7384,161
2020-09-23,Mauritania,MR,0,0,4525698,Africa,7384,161
2020-09-24,Mauritania,MR,41,0,4525698,Africa,7425,161
2020-09-25,Mauritania,MR,8,0,4525698,Africa,7433,161
2020-09-26,Mauritania,MR,0,0,4525698,Africa,7433,161
2020-09-27,Mauritania,MR,24,0,4525698,Africa,7457,161
2020-09-28,Mauritania,MR,5,0,4525698,Africa,7462,161
2020-09-29,Mauritania,MR,2,0,4525698,Africa,7464,161
2020-09-30,Mauritania,MR,10,0,4525698,Africa,7474,161
2020-10-01,Mauritania,MR,14,0,4525698,Africa,7488,161
2020-10-02,Mauritania,MR,14,0,4525698,Africa,7502,161
2020-10-03,Mauritania,MR,3,0,4525698,Africa,7505,161
2020-10-04,Mauritania,MR,6,0,4525698,Africa,7511,161
2020-10-05,Mauritania,MR,9,0,4525698,Africa,7520,161
2020-10-06,Mauritania,MR,3,1,4525698,Africa,7523,162
2020-10-07,Mauritania,MR,0,0,4525698,Africa,7523,162
2020-10-08,Mauritania,MR,0,0,4525698,Africa,7523,162
2020-10-09,Mauritania,MR,0,0,4525698,Africa,7523,162
2020-10-10,Mauritania,MR,0,0,4525698,Africa,7523,162
2020-10-11,Mauritania,MR,0,0,4525698,Africa,7523,162
2020-10-12,Mauritania,MR,27,1,4525698,Africa,7550,163
2020-10-13,Mauritania,MR,0,0,4525698,Africa,7550,163
2020-10-14,Mauritania,MR,4,0,4525698,Africa,7554,163
2020-10-15,Mauritania,MR,11,0,4525698,Africa,7565,163
2020-10-16,Mauritania,MR,0,0,4525698,Africa,7565,163
2020-10-17,Mauritania,MR,20,0,4525698,Africa,7585,163
2020-10-18,Mauritania,MR,18,0,4525698,Africa,7603,163
2020-10-19,Mauritania,MR,0,0,4525698,Africa,7603,163
2020-10-20,Mauritania,MR,5,0,4525698,Africa,7608,163
2020-10-21,Mauritania,MR,13,0,4525698,Africa,7621,163
2020-10-22,Mauritania,MR,13,0,4525698,Africa,7634,163
2020-10-23,Mauritania,MR,4,0,4525698,Africa,7638,163
2020-10-24,Mauritania,MR,0,0,4525698,Africa,7638,163
2020-10-25,Mauritania,MR,24,0,4525698,Africa,7662,163
2020-10-26,Mauritania,MR,0,0,4525698,Africa,7662,163
2020-10-27,Mauritania,MR,1,0,4525698,Africa,7663,163
2020-10-28,Mauritania,MR,14,0,4525698,Africa,7677,163
2020-10-29,Mauritania,MR,0,0,4525698,Africa,7677,163
2020-10-30,Mauritania,MR,0,0,4525698,Africa,7677,163
2020-10-31,Mauritania,MR,0,0,4525698,Africa,7677,163
2020-11-01,Mauritania,MR,40,0,4525698,Africa,7717,163
2020-11-02,Mauritania,MR,0,0,4525698,Africa,7717,163
2020-11-03,Mauritania,MR,8,0,4525698,Africa,7725,163
2020-11-04,Mauritania,MR,0,0,4525698,Africa,7725,163
2020-11-05,Mauritania,MR,19,1,4525698,Africa,7744,164
2020-11-06,Mauritania,MR,19,1,4525698,Africa,7763,165
2020-11-07,Mauritania,MR,27,0,4525698,Africa,7790,165
2020-11-08,Mauritania,MR,10,0,4525698,Africa,7800,165
2020-11-09,Mauritania,MR,6,0,4525698,Africa,7806,165
2020-11-10,Mauritania,MR,14,0,4525698,Africa,7820,165
2020-11-11,Mauritania,MR,0,0,4525698,Africa,7820,165
2020-11-12,Mauritania,MR,28,0,4525698,Africa,7848,165
2020-11-13,Mauritania,MR,37,0,4525698,Africa,7885,165
2020-11-14,Mauritania,MR,0,0,4525698,Africa,7885,165
2020-11-15,Mauritania,MR,0,0,4525698,Africa,7885,165
2020-11-16,Mauritania,MR,0,0,4525698,Africa,7885,165
2020-11-17,Mauritania,MR,0,0,4525698,Africa,7885,165
2020-11-18,Mauritania,MR,67,0,4525698,Africa,7952,165
2020-11-19,Mauritania,MR,0,0,4525698,Africa,7952,165
2020-11-20,Mauritania,MR,82,3,4525698,Africa,8034,168
2020-11-21,Mauritania,MR,0,0,4525698,Africa,8034,168
2020-11-22,Mauritania,MR,62,1,4525698,Africa,8096,169
2020-11-23,Mauritania,MR,0,0,4525698,Africa,8096,169
2020-11-24,Mauritania,MR,34,0,4525698,Africa,8130,169
2020-11-25,Mauritania,MR,65,0,4525698,Africa,8195,169
2020-11-26,Mauritania,MR,0,0,4525698,Africa,8195,169
2020-11-27,Mauritania,MR,53,2,4525698,Africa,8248,171
2020-11-28,Mauritania,MR,178,1,4525698,Africa,8426,172
2020-11-29,Mauritania,MR,34,0,4525698,Africa,8460,172
2020-11-30,Mauritania,MR,89,3,4525698,Africa,8549,175
2020-12-01,Mauritania,MR,52,2,4525698,Africa,8601,177
2020-12-02,Mauritania,MR,109,0,4525698,Africa,8710,177
2020-12-03,Mauritania,MR,0,0,4525698,Africa,8710,177
2020-12-04,Mauritania,MR,0,0,4525698,Africa,8710,177
2020-12-05,Mauritania,MR,0,0,4525698,Africa,8710,177
2020-12-06,Mauritania,MR,0,0,4525698,Africa,8710,177
2020-12-07,Mauritania,MR,0,0,4525698,Africa,8710,177
2020-12-08,Mauritania,MR,806,11,4525698,Africa,9516,188
2020-12-09,Mauritania,MR,163,6,4525698,Africa,9679,194
2020-12-10,Mauritania,MR,197,3,4525698,Africa,9876,197
2020-12-11,Mauritania,MR,392,13,4525698,Africa,10268,210
2020-12-12,Mauritania,MR,0,0,4525698,Africa,10268,210
2020-12-13,Mauritania,MR,512,12,4525698,Africa,10780,222
2020-12-14,Mauritania,MR,0,0,4525698,Africa,10780,222
2020-03-21,Montserrat,MS,1,0,4991,America,1,0
2020-03-22,Montserrat,MS,0,0,4991,America,1,0
2020-03-23,Montserrat,MS,0,0,4991,America,1,0
2020-03-24,Montserrat,MS,0,0,4991,America,1,0
2020-03-25,Montserrat,MS,0,0,4991,America,1,0
2020-03-26,Montserrat,MS,0,0,4991,America,1,0
2020-03-27,Montserrat,MS,4,0,4991,America,5,0
2020-03-28,Montserrat,MS,0,0,4991,America,5,0
2020-03-29,Montserrat,MS,0,0,4991,America,5,0
2020-03-30,Montserrat,MS,0,0,4991,America,5,0
2020-03-31,Montserrat,MS,0,0,4991,America,5,0
2020-04-02,Montserrat,MS,0,0,4991,America,5,0
2020-04-03,Montserrat,MS,0,0,4991,America,5,0
2020-04-04,Montserrat,MS,0,0,4991,America,5,0
2020-04-05,Montserrat,MS,1,0,4991,America,6,0
2020-04-06,Montserrat,MS,0,0,4991,America,6,0
2020-04-07,Montserrat,MS,0,0,4991,America,6,0
2020-04-08,Montserrat,MS,0,0,4991,America,6,0
2020-04-09,Montserrat,MS,3,0,4991,America,9,0
2020-04-10,Montserrat,MS,0,0,4991,America,9,0
2020-04-11,Montserrat,MS,0,0,4991,America,9,0
2020-04-12,Montserrat,MS,0,0,4991,America,9,0
2020-04-13,Montserrat,MS,2,0,4991,America,11,0
2020-04-14,Montserrat,MS,0,0,4991,America,11,0
2020-04-15,Montserrat,MS,0,0,4991,America,11,0
2020-04-16,Montserrat,MS,0,0,4991,America,11,0
2020-04-17,Montserrat,MS,0,0,4991,America,11,0
2020-04-18,Montserrat,MS,0,0,4991,America,11,0
2020-04-19,Montserrat,MS,0,0,4991,America,11,0
2020-04-20,Montserrat,MS,0,0,4991,America,11,0
2020-04-21,Montserrat,MS,0,0,4991,America,11,0
2020-04-22,Montserrat,MS,0,0,4991,America,11,0
2020-04-23,Montserrat,MS,0,0,4991,America,11,0
2020-04-24,Montserrat,MS,0,0,4991,America,11,0
2020-04-25,Montserrat,MS,0,0,4991,America,11,0
2020-04-26,Montserrat,MS,0,1,4991,America,11,1
2020-04-27,Montserrat,MS,0,0,4991,America,11,1
2020-04-28,Montserrat,MS,0,0,4991,America,11,1
2020-04-29,Montserrat,MS,0,0,4991,America,11,1
2020-04-30,Montserrat,MS,0,0,4991,America,11,1
2020-05-01,Montserrat,MS,0,0,4991,America,11,1
2020-05-02,Montserrat,MS,0,0,4991,America,11,1
2020-05-03,Montserrat,MS,0,0,4991,America,11,1
2020-05-04,Montserrat,MS,0,0,4991,America,11,1
2020-05-05,Montserrat,MS,0,0,4991,America,11,1
2020-05-06,Montserrat,MS,0,0,4991,America,11,1
2020-05-07,Montserrat,MS,0,0,4991,America,11,1
2020-05-08,Montserrat,MS,0,0,4991,America,11,1
2020-05-09,Montserrat,MS,0,0,4991,America,11,1
2020-05-10,Montserrat,MS,0,0,4991,America,11,1
2020-05-11,Montserrat,MS,0,0,4991,America,11,1
2020-05-12,Montserrat,MS,0,0,4991,America,11,1
2020-05-13,Montserrat,MS,0,0,4991,America,11,1
2020-05-14,Montserrat,MS,0,0,4991,America,11,1
2020-05-15,Montserrat,MS,0,0,4991,America,11,1
2020-05-16,Montserrat,MS,0,0,4991,America,11,1
2020-05-17,Montserrat,MS,0,0,4991,America,11,1
2020-05-18,Montserrat,MS,0,0,4991,America,11,1
2020-05-19,Montserrat,MS,0,0,4991,America,11,1
2020-05-20,Montserrat,MS,0,0,4991,America,11,1
2020-05-21,Montserrat,MS,0,0,4991,America,11,1
2020-05-22,Montserrat,MS,0,0,4991,America,11,1
2020-05-23,Montserrat,MS,0,0,4991,America,11,1
2020-05-24,Montserrat,MS,0,0,4991,America,11,1
2020-05-25,Montserrat,MS,0,0,4991,America,11,1
2020-05-26,Montserrat,MS,0,0,4991,America,11,1
2020-05-27,Montserrat,MS,0,0,4991,America,11,1
2020-05-28,Montserrat,MS,0,0,4991,America,11,1
2020-05-29,Montserrat,MS,0,0,4991,America,11,1
2020-05-30,Montserrat,MS,0,0,4991,America,11,1
2020-05-31,Montserrat,MS,0,0,4991,America,11,1
2020-06-01,Montserrat,MS,0,0,4991,America,11,1
2020-06-02,Montserrat,MS,0,0,4991,America,11,1
2020-06-03,Montserrat,MS,0,0,4991,America,11,1
2020-06-04,Montserrat,MS,0,0,4991,America,11,1
2020-06-05,Montserrat,MS,0,0,4991,America,11,1
2020-06-06,Montserrat,MS,0,0,4991,America,11,1
2020-06-07,Montserrat,MS,0,0,4991,America,11,1
2020-06-08,Montserrat,MS,0,0,4991,America,11,1
2020-06-09,Montserrat,MS,0,0,4991,America,11,1
2020-06-10,Montserrat,MS,0,0,4991,America,11,1
2020-06-11,Montserrat,MS,0,0,4991,America,11,1
2020-06-12,Montserrat,MS,0,0,4991,America,11,1
2020-06-13,Montserrat,MS,0,0,4991,America,11,1
2020-06-14,Montserrat,MS,0,0,4991,America,11,1
2020-06-15,Montserrat,MS,0,0,4991,America,11,1
2020-06-16,Montserrat,MS,0,0,4991,America,11,1
2020-06-17,Montserrat,MS,0,0,4991,America,11,1
2020-06-18,Montserrat,MS,0,0,4991,America,11,1
2020-06-19,Montserrat,MS,0,0,4991,America,11,1
2020-06-20,Montserrat,MS,0,0,4991,America,11,1
2020-06-21,Montserrat,MS,0,0,4991,America,11,1
2020-06-22,Montserrat,MS,0,0,4991,America,11,1
2020-06-23,Montserrat,MS,0,0,4991,America,11,1
2020-06-24,Montserrat,MS,0,0,4991,America,11,1
2020-06-25,Montserrat,MS,0,0,4991,America,11,1
2020-06-26,Montserrat,MS,0,0,4991,America,11,1
2020-06-27,Montserrat,MS,0,0,4991,America,11,1
2020-06-28,Montserrat,MS,0,0,4991,America,11,1
2020-06-29,Montserrat,MS,0,0,4991,America,11,1
2020-06-30,Montserrat,MS,0,0,4991,America,11,1
2020-07-01,Montserrat,MS,0,0,4991,America,11,1
2020-07-02,Montserrat,MS,0,0,4991,America,11,1
2020-07-03,Montserrat,MS,0,0,4991,America,11,1
2020-07-04,Montserrat,MS,0,0,4991,America,11,1
2020-07-05,Montserrat,MS,0,0,4991,America,11,1
2020-07-06,Montserrat,MS,0,0,4991,America,11,1
2020-07-07,Montserrat,MS,0,0,4991,America,11,1
2020-07-08,Montserrat,MS,0,0,4991,America,11,1
2020-07-09,Montserrat,MS,0,0,4991,America,11,1
2020-07-10,Montserrat,MS,0,0,4991,America,11,1
2020-07-11,Montserrat,MS,1,0,4991,America,12,1
2020-07-12,Montserrat,MS,0,0,4991,America,12,1
2020-07-13,Montserrat,MS,0,0,4991,America,12,1
2020-07-14,Montserrat,MS,0,0,4991,America,12,1
2020-07-15,Montserrat,MS,0,0,4991,America,12,1
2020-07-16,Montserrat,MS,0,0,4991,America,12,1
2020-07-17,Montserrat,MS,0,0,4991,America,12,1
2020-07-18,Montserrat,MS,0,0,4991,America,12,1
2020-07-19,Montserrat,MS,0,0,4991,America,12,1
2020-07-20,Montserrat,MS,0,0,4991,America,12,1
2020-07-21,Montserrat,MS,0,0,4991,America,12,1
2020-07-22,Montserrat,MS,0,0,4991,America,12,1
2020-07-23,Montserrat,MS,0,0,4991,America,12,1
2020-07-24,Montserrat,MS,0,0,4991,America,12,1
2020-07-25,Montserrat,MS,0,0,4991,America,12,1
2020-07-26,Montserrat,MS,1,0,4991,America,13,1
2020-07-27,Montserrat,MS,0,0,4991,America,13,1
2020-07-28,Montserrat,MS,0,0,4991,America,13,1
2020-07-29,Montserrat,MS,0,0,4991,America,13,1
2020-07-30,Montserrat,MS,0,0,4991,America,13,1
2020-07-31,Montserrat,MS,0,0,4991,America,13,1
2020-08-01,Montserrat,MS,0,0,4991,America,13,1
2020-08-02,Montserrat,MS,0,0,4991,America,13,1
2020-08-03,Montserrat,MS,0,0,4991,America,13,1
2020-08-04,Montserrat,MS,0,0,4991,America,13,1
2020-08-05,Montserrat,MS,0,0,4991,America,13,1
2020-08-06,Montserrat,MS,0,0,4991,America,13,1
2020-08-07,Montserrat,MS,0,0,4991,America,13,1
2020-08-08,Montserrat,MS,0,0,4991,America,13,1
2020-08-09,Montserrat,MS,0,0,4991,America,13,1
2020-08-10,Montserrat,MS,0,0,4991,America,13,1
2020-08-11,Montserrat,MS,0,0,4991,America,13,1
2020-08-12,Montserrat,MS,0,0,4991,America,13,1
2020-08-13,Montserrat,MS,0,0,4991,America,13,1
2020-08-14,Montserrat,MS,0,0,4991,America,13,1
2020-08-15,Montserrat,MS,0,0,4991,America,13,1
2020-08-16,Montserrat,MS,0,0,4991,America,13,1
2020-08-17,Montserrat,MS,0,0,4991,America,13,1
2020-08-18,Montserrat,MS,0,0,4991,America,13,1
2020-08-19,Montserrat,MS,0,0,4991,America,13,1
2020-08-20,Montserrat,MS,0,0,4991,America,13,1
2020-08-21,Montserrat,MS,0,0,4991,America,13,1
2020-08-22,Montserrat,MS,0,0,4991,America,13,1
2020-08-23,Montserrat,MS,0,0,4991,America,13,1
2020-08-24,Montserrat,MS,0,0,4991,America,13,1
2020-08-25,Montserrat,MS,0,0,4991,America,13,1
2020-08-26,Montserrat,MS,0,0,4991,America,13,1
2020-08-27,Montserrat,MS,0,0,4991,America,13,1
2020-08-28,Montserrat,MS,0,0,4991,America,13,1
2020-08-29,Montserrat,MS,0,0,4991,America,13,1
2020-08-30,Montserrat,MS,0,0,4991,America,13,1
2020-08-31,Montserrat,MS,0,0,4991,America,13,1
2020-09-01,Montserrat,MS,0,0,4991,America,13,1
2020-09-02,Montserrat,MS,0,0,4991,America,13,1
2020-09-03,Montserrat,MS,0,0,4991,America,13,1
2020-09-04,Montserrat,MS,0,0,4991,America,13,1
2020-09-05,Montserrat,MS,0,0,4991,America,13,1
2020-09-06,Montserrat,MS,0,0,4991,America,13,1
2020-09-07,Montserrat,MS,0,0,4991,America,13,1
2020-09-08,Montserrat,MS,0,0,4991,America,13,1
2020-09-09,Montserrat,MS,0,0,4991,America,13,1
2020-09-10,Montserrat,MS,0,0,4991,America,13,1
2020-09-11,Montserrat,MS,0,0,4991,America,13,1
2020-09-12,Montserrat,MS,0,0,4991,America,13,1
2020-09-13,Montserrat,MS,0,0,4991,America,13,1
2020-09-14,Montserrat,MS,0,0,4991,America,13,1
2020-09-15,Montserrat,MS,0,0,4991,America,13,1
2020-09-16,Montserrat,MS,0,0,4991,America,13,1
2020-09-17,Montserrat,MS,0,0,4991,America,13,1
2020-09-18,Montserrat,MS,0,0,4991,America,13,1
2020-09-19,Montserrat,MS,0,0,4991,America,13,1
2020-09-20,Montserrat,MS,0,0,4991,America,13,1
2020-09-21,Montserrat,MS,0,0,4991,America,13,1
2020-09-22,Montserrat,MS,0,0,4991,America,13,1
2020-09-23,Montserrat,MS,0,0,4991,America,13,1
2020-09-24,Montserrat,MS,0,0,4991,America,13,1
2020-09-25,Montserrat,MS,0,0,4991,America,13,1
2020-09-26,Montserrat,MS,0,0,4991,America,13,1
2020-09-27,Montserrat,MS,0,0,4991,America,13,1
2020-09-28,Montserrat,MS,0,0,4991,America,13,1
2020-09-29,Montserrat,MS,0,0,4991,America,13,1
2020-09-30,Montserrat,MS,0,0,4991,America,13,1
2020-10-01,Montserrat,MS,0,0,4991,America,13,1
2020-10-02,Montserrat,MS,0,0,4991,America,13,1
2020-10-03,Montserrat,MS,0,0,4991,America,13,1
2020-10-04,Montserrat,MS,0,0,4991,America,13,1
2020-10-05,Montserrat,MS,0,0,4991,America,13,1
2020-10-06,Montserrat,MS,0,0,4991,America,13,1
2020-10-07,Montserrat,MS,0,0,4991,America,13,1
2020-10-08,Montserrat,MS,0,0,4991,America,13,1
2020-10-09,Montserrat,MS,0,0,4991,America,13,1
2020-10-10,Montserrat,MS,0,0,4991,America,13,1
2020-10-11,Montserrat,MS,0,0,4991,America,13,1
2020-10-12,Montserrat,MS,0,0,4991,America,13,1
2020-10-13,Montserrat,MS,0,0,4991,America,13,1
2020-10-14,Montserrat,MS,0,0,4991,America,13,1
2020-10-15,Montserrat,MS,0,0,4991,America,13,1
2020-10-16,Montserrat,MS,0,0,4991,America,13,1
2020-10-17,Montserrat,MS,0,0,4991,America,13,1
2020-10-18,Montserrat,MS,0,0,4991,America,13,1
2020-10-19,Montserrat,MS,0,0,4991,America,13,1
2020-10-20,Montserrat,MS,0,0,4991,America,13,1
2020-10-21,Montserrat,MS,0,0,4991,America,13,1
2020-10-22,Montserrat,MS,0,0,4991,America,13,1
2020-10-23,Montserrat,MS,0,0,4991,America,13,1
2020-10-24,Montserrat,MS,0,0,4991,America,13,1
2020-10-25,Montserrat,MS,0,0,4991,America,13,1
2020-10-26,Montserrat,MS,0,0,4991,America,13,1
2020-10-27,Montserrat,MS,0,0,4991,America,13,1
2020-10-28,Montserrat,MS,0,0,4991,America,13,1
2020-10-29,Montserrat,MS,0,0,4991,America,13,1
2020-10-30,Montserrat,MS,0,0,4991,America,13,1
2020-10-31,Montserrat,MS,0,0,4991,America,13,1
2020-11-01,Montserrat,MS,0,0,4991,America,13,1
2020-11-02,Montserrat,MS,0,0,4991,America,13,1
2020-11-03,Montserrat,MS,0,0,4991,America,13,1
2020-11-04,Montserrat,MS,0,0,4991,America,13,1
2020-11-05,Montserrat,MS,0,0,4991,America,13,1
2020-11-06,Montserrat,MS,0,0,4991,America,13,1
2020-11-07,Montserrat,MS,0,0,4991,America,13,1
2020-11-08,Montserrat,MS,0,0,4991,America,13,1
2020-11-09,Montserrat,MS,0,0,4991,America,13,1
2020-11-10,Montserrat,MS,0,0,4991,America,13,1
2020-11-11,Montserrat,MS,0,0,4991,America,13,1
2020-11-12,Montserrat,MS,0,0,4991,America,13,1
2020-11-13,Montserrat,MS,0,0,4991,America,13,1
2020-11-14,Montserrat,MS,0,0,4991,America,13,1
2020-11-15,Montserrat,MS,0,0,4991,America,13,1
2020-11-16,Montserrat,MS,0,0,4991,America,13,1
2020-11-17,Montserrat,MS,0,0,4991,America,13,1
2020-11-18,Montserrat,MS,0,0,4991,America,13,1
2020-11-19,Montserrat,MS,0,0,4991,America,13,1
2020-11-20,Montserrat,MS,0,0,4991,America,13,1
2020-11-21,Montserrat,MS,0,0,4991,America,13,1
2020-11-22,Montserrat,MS,0,0,4991,America,13,1
2020-11-23,Montserrat,MS,0,0,4991,America,13,1
2020-11-24,Montserrat,MS,0,0,4991,America,13,1
2020-11-25,Montserrat,MS,0,0,4991,America,13,1
2020-11-26,Montserrat,MS,0,0,4991,America,13,1
2020-11-27,Montserrat,MS,0,0,4991,America,13,1
2020-11-28,Montserrat,MS,0,0,4991,America,13,1
2020-11-29,Montserrat,MS,0,0,4991,America,13,1
2020-11-30,Montserrat,MS,0,0,4991,America,13,1
2020-12-01,Montserrat,MS,0,0,4991,America,13,1
2020-12-02,Montserrat,MS,0,0,4991,America,13,1
2020-12-03,Montserrat,MS,0,0,4991,America,13,1
2020-12-04,Montserrat,MS,0,0,4991,America,13,1
2020-12-05,Montserrat,MS,0,0,4991,America,13,1
2020-12-06,Montserrat,MS,0,0,4991,America,13,1
2020-12-07,Montserrat,MS,0,0,4991,America,13,1
2020-12-08,Montserrat,MS,0,0,4991,America,13,1
2020-12-09,Montserrat,MS,0,0,4991,America,13,1
2020-12-10,Montserrat,MS,0,0,4991,America,13,1
2020-12-11,Montserrat,MS,0,0,4991,America,13,1
2020-12-12,Montserrat,MS,0,0,4991,America,13,1
2020-12-13,Montserrat,MS,0,0,4991,America,13,1
2020-12-14,Montserrat,MS,0,0,4991,America,13,1
2020-03-07,Malta,MT,1,0,493559,Europe,1,0
2020-03-08,Malta,MT,2,0,493559,Europe,3,0
2020-03-09,Malta,MT,0,0,493559,Europe,3,0
2020-03-10,Malta,MT,2,0,493559,Europe,5,0
2020-03-11,Malta,MT,1,0,493559,Europe,6,0
2020-03-12,Malta,MT,1,0,493559,Europe,7,0
2020-03-13,Malta,MT,1,0,493559,Europe,8,0
2020-03-14,Malta,MT,10,0,493559,Europe,18,0
2020-03-15,Malta,MT,1,0,493559,Europe,19,0
2020-03-16,Malta,MT,11,0,493559,Europe,30,0
2020-03-17,Malta,MT,8,0,493559,Europe,38,0
2020-03-18,Malta,MT,10,0,493559,Europe,48,0
2020-03-19,Malta,MT,4,0,493559,Europe,52,0
2020-03-20,Malta,MT,12,0,493559,Europe,64,0
2020-03-21,Malta,MT,9,0,493559,Europe,73,0
2020-03-22,Malta,MT,17,0,493559,Europe,90,0
2020-03-23,Malta,MT,17,0,493559,Europe,107,0
2020-03-24,Malta,MT,7,0,493559,Europe,114,0
2020-03-25,Malta,MT,15,0,493559,Europe,129,0
2020-03-26,Malta,MT,5,0,493559,Europe,134,0
2020-03-27,Malta,MT,5,0,493559,Europe,139,0
2020-03-28,Malta,MT,10,0,493559,Europe,149,0
2020-03-29,Malta,MT,2,0,493559,Europe,151,0
2020-03-30,Malta,MT,5,0,493559,Europe,156,0
2020-03-31,Malta,MT,13,0,493559,Europe,169,0
2020-04-01,Malta,MT,19,0,493559,Europe,188,0
2020-04-02,Malta,MT,7,0,493559,Europe,195,0
2020-04-03,Malta,MT,7,0,493559,Europe,202,0
2020-04-04,Malta,MT,11,0,493559,Europe,213,0
2020-04-05,Malta,MT,14,0,493559,Europe,227,0
2020-04-06,Malta,MT,14,0,493559,Europe,241,0
2020-04-07,Malta,MT,52,0,493559,Europe,293,0
2020-04-08,Malta,MT,6,0,493559,Europe,299,0
2020-04-09,Malta,MT,38,1,493559,Europe,337,1
2020-04-10,Malta,MT,13,1,493559,Europe,350,2
2020-04-11,Malta,MT,20,0,493559,Europe,370,2
2020-04-12,Malta,MT,8,1,493559,Europe,378,3
2020-04-13,Malta,MT,6,0,493559,Europe,384,3
2020-04-14,Malta,MT,9,0,493559,Europe,393,3
2020-04-15,Malta,MT,6,0,493559,Europe,399,3
2020-04-16,Malta,MT,13,0,493559,Europe,412,3
2020-04-17,Malta,MT,10,0,493559,Europe,422,3
2020-04-18,Malta,MT,4,0,493559,Europe,426,3
2020-04-19,Malta,MT,1,0,493559,Europe,427,3
2020-04-20,Malta,MT,4,0,493559,Europe,431,3
2020-04-21,Malta,MT,12,0,493559,Europe,443,3
2020-04-22,Malta,MT,1,0,493559,Europe,444,3
2020-04-23,Malta,MT,0,0,493559,Europe,444,3
2020-04-24,Malta,MT,2,0,493559,Europe,446,3
2020-04-25,Malta,MT,1,0,493559,Europe,447,3
2020-04-26,Malta,MT,2,1,493559,Europe,449,4
2020-04-27,Malta,MT,0,0,493559,Europe,449,4
2020-04-28,Malta,MT,8,0,493559,Europe,457,4
2020-04-29,Malta,MT,5,0,493559,Europe,462,4
2020-04-30,Malta,MT,2,0,493559,Europe,464,4
2020-05-01,Malta,MT,2,0,493559,Europe,466,4
2020-05-02,Malta,MT,1,0,493559,Europe,467,4
2020-05-03,Malta,MT,9,0,493559,Europe,476,4
2020-05-04,Malta,MT,3,0,493559,Europe,479,4
2020-05-05,Malta,MT,1,0,493559,Europe,480,4
2020-05-06,Malta,MT,3,1,493559,Europe,483,5
2020-05-07,Malta,MT,2,0,493559,Europe,485,5
2020-05-08,Malta,MT,3,0,493559,Europe,488,5
2020-05-09,Malta,MT,1,0,493559,Europe,489,5
2020-05-10,Malta,MT,6,0,493559,Europe,495,5
2020-05-11,Malta,MT,7,0,493559,Europe,502,5
2020-05-12,Malta,MT,3,0,493559,Europe,505,5
2020-05-13,Malta,MT,2,1,493559,Europe,507,6
2020-05-14,Malta,MT,14,0,493559,Europe,521,6
2020-05-15,Malta,MT,10,0,493559,Europe,531,6
2020-05-16,Malta,MT,14,0,493559,Europe,545,6
2020-05-17,Malta,MT,7,0,493559,Europe,552,6
2020-05-18,Malta,MT,5,0,493559,Europe,557,6
2020-05-19,Malta,MT,11,0,493559,Europe,568,6
2020-05-20,Malta,MT,15,0,493559,Europe,583,6
2020-05-21,Malta,MT,15,0,493559,Europe,598,6
2020-05-22,Malta,MT,1,0,493559,Europe,599,6
2020-05-23,Malta,MT,9,0,493559,Europe,608,6
2020-05-24,Malta,MT,1,0,493559,Europe,609,6
2020-05-25,Malta,MT,1,0,493559,Europe,610,6
2020-05-26,Malta,MT,0,0,493559,Europe,610,6
2020-05-27,Malta,MT,1,0,493559,Europe,611,6
2020-05-28,Malta,MT,4,1,493559,Europe,615,7
2020-05-29,Malta,MT,0,0,493559,Europe,615,7
2020-05-30,Malta,MT,2,2,493559,Europe,617,9
2020-05-31,Malta,MT,0,0,493559,Europe,617,9
2020-06-01,Malta,MT,1,0,493559,Europe,618,9
2020-06-02,Malta,MT,1,0,493559,Europe,619,9
2020-06-03,Malta,MT,2,0,493559,Europe,621,9
2020-06-04,Malta,MT,0,0,493559,Europe,621,9
2020-06-05,Malta,MT,3,0,493559,Europe,624,9
2020-06-06,Malta,MT,2,0,493559,Europe,626,9
2020-06-07,Malta,MT,2,0,493559,Europe,628,9
2020-06-08,Malta,MT,1,0,493559,Europe,629,9
2020-06-09,Malta,MT,2,0,493559,Europe,631,9
2020-06-10,Malta,MT,3,0,493559,Europe,634,9
2020-06-11,Malta,MT,5,0,493559,Europe,639,9
2020-06-12,Malta,MT,5,0,493559,Europe,644,9
2020-06-13,Malta,MT,1,0,493559,Europe,645,9
2020-06-14,Malta,MT,2,0,493559,Europe,647,9
2020-06-15,Malta,MT,2,0,493559,Europe,649,9
2020-06-16,Malta,MT,6,0,493559,Europe,655,9
2020-06-17,Malta,MT,6,0,493559,Europe,661,9
2020-06-18,Malta,MT,1,0,493559,Europe,662,9
2020-06-19,Malta,MT,0,0,493559,Europe,662,9
2020-06-20,Malta,MT,1,0,493559,Europe,663,9
2020-06-21,Malta,MT,1,0,493559,Europe,664,9
2020-06-22,Malta,MT,0,0,493559,Europe,664,9
2020-06-23,Malta,MT,0,0,493559,Europe,664,9
2020-06-24,Malta,MT,0,0,493559,Europe,664,9
2020-06-25,Malta,MT,3,0,493559,Europe,667,9
2020-06-26,Malta,MT,2,0,493559,Europe,669,9
2020-06-27,Malta,MT,0,0,493559,Europe,669,9
2020-06-28,Malta,MT,0,0,493559,Europe,669,9
2020-06-29,Malta,MT,0,0,493559,Europe,669,9
2020-06-30,Malta,MT,0,0,493559,Europe,669,9
2020-07-01,Malta,MT,1,0,493559,Europe,670,9
2020-07-02,Malta,MT,0,0,493559,Europe,670,9
2020-07-03,Malta,MT,1,0,493559,Europe,671,9
2020-07-04,Malta,MT,0,0,493559,Europe,671,9
2020-07-05,Malta,MT,0,0,493559,Europe,671,9
2020-07-06,Malta,MT,0,0,493559,Europe,671,9
2020-07-07,Malta,MT,1,0,493559,Europe,672,9
2020-07-08,Malta,MT,0,0,493559,Europe,672,9
2020-07-09,Malta,MT,1,0,493559,Europe,673,9
2020-07-10,Malta,MT,0,0,493559,Europe,673,9
2020-07-11,Malta,MT,0,0,493559,Europe,673,9
2020-07-12,Malta,MT,0,0,493559,Europe,673,9
2020-07-13,Malta,MT,0,0,493559,Europe,673,9
2020-07-14,Malta,MT,0,0,493559,Europe,673,9
2020-07-15,Malta,MT,0,0,493559,Europe,673,9
2020-07-16,Malta,MT,0,0,493559,Europe,673,9
2020-07-17,Malta,MT,0,0,493559,Europe,673,9
2020-07-18,Malta,MT,1,0,493559,Europe,674,9
2020-07-19,Malta,MT,0,0,493559,Europe,674,9
2020-07-20,Malta,MT,1,0,493559,Europe,675,9
2020-07-21,Malta,MT,0,0,493559,Europe,675,9
2020-07-22,Malta,MT,2,0,493559,Europe,677,9
2020-07-23,Malta,MT,1,0,493559,Europe,678,9
2020-07-24,Malta,MT,2,0,493559,Europe,680,9
2020-07-25,Malta,MT,4,0,493559,Europe,684,9
2020-07-26,Malta,MT,14,0,493559,Europe,698,9
2020-07-27,Malta,MT,1,0,493559,Europe,699,9
2020-07-28,Malta,MT,6,0,493559,Europe,705,9
2020-07-29,Malta,MT,13,0,493559,Europe,718,9
2020-07-30,Malta,MT,9,0,493559,Europe,727,9
2020-07-31,Malta,MT,9,0,493559,Europe,736,9
2020-08-01,Malta,MT,18,0,493559,Europe,754,9
2020-08-02,Malta,MT,15,0,493559,Europe,769,9
2020-08-03,Malta,MT,14,0,493559,Europe,783,9
2020-08-04,Malta,MT,16,0,493559,Europe,799,9
2020-08-05,Malta,MT,21,0,493559,Europe,820,9
2020-08-06,Malta,MT,19,0,493559,Europe,839,9
2020-08-07,Malta,MT,50,0,493559,Europe,889,9
2020-08-08,Malta,MT,40,0,493559,Europe,929,9
2020-08-09,Malta,MT,54,0,493559,Europe,983,9
2020-08-10,Malta,MT,23,0,493559,Europe,1006,9
2020-08-11,Malta,MT,29,0,493559,Europe,1035,9
2020-08-12,Malta,MT,49,0,493559,Europe,1084,9
2020-08-13,Malta,MT,55,0,493559,Europe,1139,9
2020-08-14,Malta,MT,31,0,493559,Europe,1170,9
2020-08-15,Malta,MT,72,0,493559,Europe,1242,9
2020-08-16,Malta,MT,63,0,493559,Europe,1305,9
2020-08-17,Malta,MT,68,0,493559,Europe,1373,9
2020-08-18,Malta,MT,49,0,493559,Europe,1422,9
2020-08-19,Malta,MT,47,0,493559,Europe,1469,9
2020-08-20,Malta,MT,40,0,493559,Europe,1509,9
2020-08-21,Malta,MT,36,0,493559,Europe,1545,9
2020-08-22,Malta,MT,31,1,493559,Europe,1576,10
2020-08-23,Malta,MT,35,0,493559,Europe,1611,10
2020-08-24,Malta,MT,57,0,493559,Europe,1668,10
2020-08-25,Malta,MT,38,0,493559,Europe,1706,10
2020-08-26,Malta,MT,46,0,493559,Europe,1752,10
2020-08-27,Malta,MT,37,0,493559,Europe,1789,10
2020-08-28,Malta,MT,32,0,493559,Europe,1821,10
2020-08-29,Malta,MT,28,0,493559,Europe,1849,10
2020-08-30,Malta,MT,15,1,493559,Europe,1864,11
2020-08-31,Malta,MT,21,1,493559,Europe,1885,12
2020-09-01,Malta,MT,26,0,493559,Europe,1911,12
2020-09-02,Malta,MT,21,1,493559,Europe,1932,13
2020-09-03,Malta,MT,34,0,493559,Europe,1966,13
2020-09-04,Malta,MT,19,0,493559,Europe,1985,13
2020-09-05,Malta,MT,30,0,493559,Europe,2015,13
2020-09-06,Malta,MT,25,1,493559,Europe,2040,14
2020-09-07,Malta,MT,37,0,493559,Europe,2077,14
2020-09-08,Malta,MT,23,0,493559,Europe,2100,14
2020-09-09,Malta,MT,63,0,493559,Europe,2163,14
2020-09-10,Malta,MT,42,0,493559,Europe,2205,14
2020-09-11,Malta,MT,43,1,493559,Europe,2248,15
2020-09-12,Malta,MT,27,0,493559,Europe,2275,15
2020-09-13,Malta,MT,78,0,493559,Europe,2353,15
2020-09-14,Malta,MT,53,0,493559,Europe,2406,15
2020-09-15,Malta,MT,49,1,493559,Europe,2455,16
2020-09-16,Malta,MT,106,0,493559,Europe,2561,16
2020-09-17,Malta,MT,35,0,493559,Europe,2596,16
2020-09-18,Malta,MT,38,1,493559,Europe,2634,17
2020-09-19,Malta,MT,65,2,493559,Europe,2699,19
2020-09-20,Malta,MT,32,1,493559,Europe,2731,20
2020-09-21,Malta,MT,46,1,493559,Europe,2777,21
2020-09-22,Malta,MT,38,2,493559,Europe,2815,23
2020-09-23,Malta,MT,42,2,493559,Europe,2857,25
2020-09-24,Malta,MT,42,1,493559,Europe,2899,26
2020-09-25,Malta,MT,31,2,493559,Europe,2930,28
2020-09-26,Malta,MT,29,2,493559,Europe,2959,30
2020-09-27,Malta,MT,21,1,493559,Europe,2980,31
2020-09-28,Malta,MT,27,1,493559,Europe,3007,32
2020-09-29,Malta,MT,19,2,493559,Europe,3026,34
2020-09-30,Malta,MT,23,0,493559,Europe,3049,34
2020-10-01,Malta,MT,37,1,493559,Europe,3086,35
2020-10-02,Malta,MT,44,2,493559,Europe,3130,37
2020-10-03,Malta,MT,65,1,493559,Europe,3195,38
2020-10-04,Malta,MT,66,1,493559,Europe,3261,39
2020-10-05,Malta,MT,57,0,493559,Europe,3318,39
2020-10-06,Malta,MT,47,1,493559,Europe,3365,40
2020-10-07,Malta,MT,68,1,493559,Europe,3433,41
2020-10-08,Malta,MT,64,0,493559,Europe,3497,41
2020-10-09,Malta,MT,75,0,493559,Europe,3572,41
2020-10-10,Malta,MT,100,0,493559,Europe,3672,41
2020-10-11,Malta,MT,95,0,493559,Europe,3767,41
2020-10-12,Malta,MT,68,2,493559,Europe,3835,43
2020-10-13,Malta,MT,94,1,493559,Europe,3929,44
2020-10-14,Malta,MT,111,0,493559,Europe,4040,44
2020-10-15,Malta,MT,112,1,493559,Europe,4152,45
2020-10-16,Malta,MT,122,0,493559,Europe,4274,45
2020-10-17,Malta,MT,204,0,493559,Europe,4478,45
2020-10-18,Malta,MT,142,0,493559,Europe,4620,45
2020-10-19,Malta,MT,109,0,493559,Europe,4729,45
2020-10-20,Malta,MT,134,0,493559,Europe,4863,45
2020-10-21,Malta,MT,155,1,493559,Europe,5018,46
2020-10-22,Malta,MT,111,3,493559,Europe,5129,49
2020-10-23,Malta,MT,121,0,493559,Europe,5250,49
2020-10-24,Malta,MT,115,1,493559,Europe,5365,50
2020-10-25,Malta,MT,122,1,493559,Europe,5487,51
2020-10-26,Malta,MT,80,2,493559,Europe,5567,53
2020-10-27,Malta,MT,107,1,493559,Europe,5674,54
2020-10-28,Malta,MT,76,2,493559,Europe,5750,56
2020-10-29,Malta,MT,106,0,493559,Europe,5856,56
2020-10-30,Malta,MT,76,1,493559,Europe,5932,57
2020-10-31,Malta,MT,100,2,493559,Europe,6032,59
2020-11-01,Malta,MT,140,2,493559,Europe,6172,61
2020-11-02,Malta,MT,218,0,493559,Europe,6390,61
2020-11-03,Malta,MT,106,1,493559,Europe,6496,62
2020-11-04,Malta,MT,84,0,493559,Europe,6580,62
2020-11-05,Malta,MT,173,4,493559,Europe,6753,66
2020-11-06,Malta,MT,129,4,493559,Europe,6882,70
2020-11-07,Malta,MT,146,0,493559,Europe,7028,70
2020-11-08,Malta,MT,102,2,493559,Europe,7130,72
2020-11-09,Malta,MT,102,3,493559,Europe,7232,75
2020-11-10,Malta,MT,153,4,493559,Europe,7385,79
2020-11-11,Malta,MT,141,3,493559,Europe,7526,82
2020-11-12,Malta,MT,109,4,493559,Europe,7635,86
2020-11-13,Malta,MT,150,1,493559,Europe,7785,87
2020-11-14,Malta,MT,121,4,493559,Europe,7906,91
2020-11-15,Malta,MT,117,3,493559,Europe,8023,94
2020-11-16,Malta,MT,103,1,493559,Europe,8126,95
2020-11-17,Malta,MT,110,3,493559,Europe,8236,98
2020-11-18,Malta,MT,173,1,493559,Europe,8409,99
2020-11-19,Malta,MT,140,2,493559,Europe,8549,101
2020-11-20,Malta,MT,121,2,493559,Europe,8670,103
2020-11-21,Malta,MT,141,2,493559,Europe,8811,105
2020-11-22,Malta,MT,102,2,493559,Europe,8913,107
2020-11-23,Malta,MT,80,3,493559,Europe,8993,110
2020-11-24,Malta,MT,133,4,493559,Europe,9126,114
2020-11-25,Malta,MT,166,3,493559,Europe,9292,117
2020-11-26,Malta,MT,69,5,493559,Europe,9361,122
2020-11-27,Malta,MT,70,0,493559,Europe,9431,122
2020-11-28,Malta,MT,70,6,493559,Europe,9501,128
2020-11-29,Malta,MT,108,4,493559,Europe,9609,132
2020-11-30,Malta,MT,143,1,493559,Europe,9752,133
2020-12-01,Malta,MT,121,4,493559,Europe,9873,137
2020-12-02,Malta,MT,102,4,493559,Europe,9975,141
2020-12-03,Malta,MT,126,5,493559,Europe,10101,146
2020-12-04,Malta,MT,96,2,493559,Europe,10197,148
2020-12-05,Malta,MT,123,1,493559,Europe,10320,149
2020-12-06,Malta,MT,103,0,493559,Europe,10423,149
2020-12-07,Malta,MT,97,2,493559,Europe,10520,151
2020-12-08,Malta,MT,139,4,493559,Europe,10659,155
2020-12-09,Malta,MT,40,2,493559,Europe,10699,157
2020-12-10,Malta,MT,79,3,493559,Europe,10778,160
2020-12-11,Malta,MT,106,4,493559,Europe,10884,164
2020-12-12,Malta,MT,96,2,493559,Europe,10980,166
2020-12-13,Malta,MT,121,0,493559,Europe,11101,166
2020-12-14,Malta,MT,0,0,493559,Europe,11101,166
2020-03-20,Mauritius,MU,3,0,1269670,Africa,3,0
2020-03-21,Mauritius,MU,9,0,1269670,Africa,12,0
2020-03-22,Mauritius,MU,2,1,1269670,Africa,14,1
2020-03-23,Mauritius,MU,14,1,1269670,Africa,28,2
2020-03-24,Mauritius,MU,8,0,1269670,Africa,36,2
2020-03-25,Mauritius,MU,6,0,1269670,Africa,42,2
2020-03-26,Mauritius,MU,6,0,1269670,Africa,48,2
2020-03-27,Mauritius,MU,33,0,1269670,Africa,81,2
2020-03-28,Mauritius,MU,13,0,1269670,Africa,94,2
2020-03-29,Mauritius,MU,8,0,1269670,Africa,102,2
2020-03-30,Mauritius,MU,8,1,1269670,Africa,110,3
2020-03-31,Mauritius,MU,18,0,1269670,Africa,128,3
2020-04-01,Mauritius,MU,15,0,1269670,Africa,143,3
2020-04-02,Mauritius,MU,11,2,1269670,Africa,154,5
2020-04-03,Mauritius,MU,15,2,1269670,Africa,169,7
2020-04-04,Mauritius,MU,17,0,1269670,Africa,186,7
2020-04-05,Mauritius,MU,10,0,1269670,Africa,196,7
2020-04-06,Mauritius,MU,31,0,1269670,Africa,227,7
2020-04-07,Mauritius,MU,17,0,1269670,Africa,244,7
2020-04-08,Mauritius,MU,24,0,1269670,Africa,268,7
2020-04-09,Mauritius,MU,5,0,1269670,Africa,273,7
2020-04-10,Mauritius,MU,41,0,1269670,Africa,314,7
2020-04-11,Mauritius,MU,4,2,1269670,Africa,318,9
2020-04-12,Mauritius,MU,1,0,1269670,Africa,319,9
2020-04-13,Mauritius,MU,5,0,1269670,Africa,324,9
2020-04-14,Mauritius,MU,0,0,1269670,Africa,324,9
2020-04-15,Mauritius,MU,0,0,1269670,Africa,324,9
2020-04-16,Mauritius,MU,0,0,1269670,Africa,324,9
2020-04-17,Mauritius,MU,0,0,1269670,Africa,324,9
2020-04-18,Mauritius,MU,0,0,1269670,Africa,324,9
2020-04-19,Mauritius,MU,1,0,1269670,Africa,325,9
2020-04-20,Mauritius,MU,3,0,1269670,Africa,328,9
2020-04-21,Mauritius,MU,0,0,1269670,Africa,328,9
2020-04-22,Mauritius,MU,0,0,1269670,Africa,328,9
2020-04-23,Mauritius,MU,1,0,1269670,Africa,329,9
2020-04-24,Mauritius,MU,2,0,1269670,Africa,331,9
2020-04-25,Mauritius,MU,0,0,1269670,Africa,331,9
2020-04-26,Mauritius,MU,0,0,1269670,Africa,331,9
2020-04-27,Mauritius,MU,1,0,1269670,Africa,332,9
2020-04-28,Mauritius,MU,0,1,1269670,Africa,332,10
2020-04-29,Mauritius,MU,0,0,1269670,Africa,332,10
2020-04-30,Mauritius,MU,0,0,1269670,Africa,332,10
2020-05-01,Mauritius,MU,0,0,1269670,Africa,332,10
2020-05-02,Mauritius,MU,0,0,1269670,Africa,332,10
2020-05-03,Mauritius,MU,0,0,1269670,Africa,332,10
2020-05-04,Mauritius,MU,0,0,1269670,Africa,332,10
2020-05-05,Mauritius,MU,0,0,1269670,Africa,332,10
2020-05-06,Mauritius,MU,0,0,1269670,Africa,332,10
2020-05-07,Mauritius,MU,0,0,1269670,Africa,332,10
2020-05-08,Mauritius,MU,0,0,1269670,Africa,332,10
2020-05-09,Mauritius,MU,0,0,1269670,Africa,332,10
2020-05-10,Mauritius,MU,0,0,1269670,Africa,332,10
2020-05-11,Mauritius,MU,0,0,1269670,Africa,332,10
2020-05-12,Mauritius,MU,0,0,1269670,Africa,332,10
2020-05-13,Mauritius,MU,0,0,1269670,Africa,332,10
2020-05-14,Mauritius,MU,0,0,1269670,Africa,332,10
2020-05-15,Mauritius,MU,0,0,1269670,Africa,332,10
2020-05-16,Mauritius,MU,0,0,1269670,Africa,332,10
2020-05-17,Mauritius,MU,0,0,1269670,Africa,332,10
2020-05-18,Mauritius,MU,0,0,1269670,Africa,332,10
2020-05-19,Mauritius,MU,0,0,1269670,Africa,332,10
2020-05-20,Mauritius,MU,0,0,1269670,Africa,332,10
2020-05-21,Mauritius,MU,0,0,1269670,Africa,332,10
2020-05-22,Mauritius,MU,0,0,1269670,Africa,332,10
2020-05-23,Mauritius,MU,0,0,1269670,Africa,332,10
2020-05-24,Mauritius,MU,0,0,1269670,Africa,332,10
2020-05-25,Mauritius,MU,2,0,1269670,Africa,334,10
2020-05-26,Mauritius,MU,0,0,1269670,Africa,334,10
2020-05-27,Mauritius,MU,0,0,1269670,Africa,334,10
2020-05-28,Mauritius,MU,0,0,1269670,Africa,334,10
2020-05-29,Mauritius,MU,0,0,1269670,Africa,334,10
2020-05-30,Mauritius,MU,1,0,1269670,Africa,335,10
2020-05-31,Mauritius,MU,0,0,1269670,Africa,335,10
2020-06-01,Mauritius,MU,0,0,1269670,Africa,335,10
2020-06-02,Mauritius,MU,0,0,1269670,Africa,335,10
2020-06-03,Mauritius,MU,0,0,1269670,Africa,335,10
2020-06-04,Mauritius,MU,0,0,1269670,Africa,335,10
2020-06-05,Mauritius,MU,0,0,1269670,Africa,335,10
2020-06-06,Mauritius,MU,2,0,1269670,Africa,337,10
2020-06-07,Mauritius,MU,0,0,1269670,Africa,337,10
2020-06-08,Mauritius,MU,0,0,1269670,Africa,337,10
2020-06-09,Mauritius,MU,0,0,1269670,Africa,337,10
2020-06-10,Mauritius,MU,0,0,1269670,Africa,337,10
2020-06-11,Mauritius,MU,0,0,1269670,Africa,337,10
2020-06-12,Mauritius,MU,0,0,1269670,Africa,337,10
2020-06-13,Mauritius,MU,0,0,1269670,Africa,337,10
2020-06-14,Mauritius,MU,0,0,1269670,Africa,337,10
2020-06-15,Mauritius,MU,0,0,1269670,Africa,337,10
2020-06-16,Mauritius,MU,0,0,1269670,Africa,337,10
2020-06-17,Mauritius,MU,0,0,1269670,Africa,337,10
2020-06-18,Mauritius,MU,0,0,1269670,Africa,337,10
2020-06-19,Mauritius,MU,0,0,1269670,Africa,337,10
2020-06-20,Mauritius,MU,0,0,1269670,Africa,337,10
2020-06-21,Mauritius,MU,0,0,1269670,Africa,337,10
2020-06-22,Mauritius,MU,0,0,1269670,Africa,337,10
2020-06-23,Mauritius,MU,3,0,1269670,Africa,340,10
2020-06-24,Mauritius,MU,0,0,1269670,Africa,340,10
2020-06-25,Mauritius,MU,1,0,1269670,Africa,341,10
2020-06-26,Mauritius,MU,0,0,1269670,Africa,341,10
2020-06-27,Mauritius,MU,0,0,1269670,Africa,341,10
2020-06-28,Mauritius,MU,0,0,1269670,Africa,341,10
2020-06-29,Mauritius,MU,0,0,1269670,Africa,341,10
2020-06-30,Mauritius,MU,0,0,1269670,Africa,341,10
2020-07-01,Mauritius,MU,0,0,1269670,Africa,341,10
2020-07-02,Mauritius,MU,0,0,1269670,Africa,341,10
2020-07-03,Mauritius,MU,0,0,1269670,Africa,341,10
2020-07-04,Mauritius,MU,0,0,1269670,Africa,341,10
2020-07-05,Mauritius,MU,0,0,1269670,Africa,341,10
2020-07-06,Mauritius,MU,0,0,1269670,Africa,341,10
2020-07-07,Mauritius,MU,1,0,1269670,Africa,342,10
2020-07-08,Mauritius,MU,0,0,1269670,Africa,342,10
2020-07-09,Mauritius,MU,0,0,1269670,Africa,342,10
2020-07-10,Mauritius,MU,0,0,1269670,Africa,342,10
2020-07-11,Mauritius,MU,0,0,1269670,Africa,342,10
2020-07-12,Mauritius,MU,0,0,1269670,Africa,342,10
2020-07-13,Mauritius,MU,0,0,1269670,Africa,342,10
2020-07-14,Mauritius,MU,0,0,1269670,Africa,342,10
2020-07-15,Mauritius,MU,0,0,1269670,Africa,342,10
2020-07-16,Mauritius,MU,1,0,1269670,Africa,343,10
2020-07-17,Mauritius,MU,0,0,1269670,Africa,343,10
2020-07-18,Mauritius,MU,0,0,1269670,Africa,343,10
2020-07-19,Mauritius,MU,0,0,1269670,Africa,343,10
2020-07-20,Mauritius,MU,0,0,1269670,Africa,343,10
2020-07-21,Mauritius,MU,0,0,1269670,Africa,343,10
2020-07-22,Mauritius,MU,0,0,1269670,Africa,343,10
2020-07-23,Mauritius,MU,0,0,1269670,Africa,343,10
2020-07-24,Mauritius,MU,0,0,1269670,Africa,343,10
2020-07-25,Mauritius,MU,1,0,1269670,Africa,344,10
2020-07-26,Mauritius,MU,0,0,1269670,Africa,344,10
2020-07-27,Mauritius,MU,0,0,1269670,Africa,344,10
2020-07-28,Mauritius,MU,0,0,1269670,Africa,344,10
2020-07-29,Mauritius,MU,0,0,1269670,Africa,344,10
2020-07-30,Mauritius,MU,0,0,1269670,Africa,344,10
2020-07-31,Mauritius,MU,0,0,1269670,Africa,344,10
2020-08-01,Mauritius,MU,0,0,1269670,Africa,344,10
2020-08-02,Mauritius,MU,0,0,1269670,Africa,344,10
2020-08-03,Mauritius,MU,0,0,1269670,Africa,344,10
2020-08-04,Mauritius,MU,0,0,1269670,Africa,344,10
2020-08-05,Mauritius,MU,0,0,1269670,Africa,344,10
2020-08-06,Mauritius,MU,0,0,1269670,Africa,344,10
2020-08-07,Mauritius,MU,0,0,1269670,Africa,344,10
2020-08-08,Mauritius,MU,0,0,1269670,Africa,344,10
2020-08-09,Mauritius,MU,0,0,1269670,Africa,344,10
2020-08-10,Mauritius,MU,0,0,1269670,Africa,344,10
2020-08-11,Mauritius,MU,0,0,1269670,Africa,344,10
2020-08-12,Mauritius,MU,0,0,1269670,Africa,344,10
2020-08-13,Mauritius,MU,0,0,1269670,Africa,344,10
2020-08-14,Mauritius,MU,0,0,1269670,Africa,344,10
2020-08-15,Mauritius,MU,0,0,1269670,Africa,344,10
2020-08-16,Mauritius,MU,0,0,1269670,Africa,344,10
2020-08-17,Mauritius,MU,2,0,1269670,Africa,346,10
2020-08-18,Mauritius,MU,0,0,1269670,Africa,346,10
2020-08-19,Mauritius,MU,0,0,1269670,Africa,346,10
2020-08-20,Mauritius,MU,0,0,1269670,Africa,346,10
2020-08-21,Mauritius,MU,0,0,1269670,Africa,346,10
2020-08-22,Mauritius,MU,0,0,1269670,Africa,346,10
2020-08-23,Mauritius,MU,0,0,1269670,Africa,346,10
2020-08-24,Mauritius,MU,0,0,1269670,Africa,346,10
2020-08-25,Mauritius,MU,0,0,1269670,Africa,346,10
2020-08-26,Mauritius,MU,0,0,1269670,Africa,346,10
2020-08-27,Mauritius,MU,0,0,1269670,Africa,346,10
2020-08-28,Mauritius,MU,0,0,1269670,Africa,346,10
2020-08-29,Mauritius,MU,0,0,1269670,Africa,346,10
2020-08-30,Mauritius,MU,0,0,1269670,Africa,346,10
2020-08-31,Mauritius,MU,0,0,1269670,Africa,346,10
2020-09-01,Mauritius,MU,10,0,1269670,Africa,356,10
2020-09-02,Mauritius,MU,0,0,1269670,Africa,356,10
2020-09-03,Mauritius,MU,0,0,1269670,Africa,356,10
2020-09-04,Mauritius,MU,0,0,1269670,Africa,356,10
2020-09-05,Mauritius,MU,0,0,1269670,Africa,356,10
2020-09-06,Mauritius,MU,0,0,1269670,Africa,356,10
2020-09-07,Mauritius,MU,0,0,1269670,Africa,356,10
2020-09-08,Mauritius,MU,0,0,1269670,Africa,356,10
2020-09-09,Mauritius,MU,0,0,1269670,Africa,356,10
2020-09-10,Mauritius,MU,0,0,1269670,Africa,356,10
2020-09-11,Mauritius,MU,0,0,1269670,Africa,356,10
2020-09-12,Mauritius,MU,0,0,1269670,Africa,356,10
2020-09-13,Mauritius,MU,0,0,1269670,Africa,356,10
2020-09-14,Mauritius,MU,5,0,1269670,Africa,361,10
2020-09-15,Mauritius,MU,0,0,1269670,Africa,361,10
2020-09-16,Mauritius,MU,1,0,1269670,Africa,362,10
2020-09-17,Mauritius,MU,3,0,1269670,Africa,365,10
2020-09-18,Mauritius,MU,0,0,1269670,Africa,365,10
2020-09-19,Mauritius,MU,1,0,1269670,Africa,366,10
2020-09-20,Mauritius,MU,1,0,1269670,Africa,367,10
2020-09-21,Mauritius,MU,0,0,1269670,Africa,367,10
2020-09-22,Mauritius,MU,0,0,1269670,Africa,367,10
2020-09-23,Mauritius,MU,0,0,1269670,Africa,367,10
2020-09-24,Mauritius,MU,0,0,1269670,Africa,367,10
2020-09-25,Mauritius,MU,0,0,1269670,Africa,367,10
2020-09-26,Mauritius,MU,0,0,1269670,Africa,367,10
2020-09-27,Mauritius,MU,0,0,1269670,Africa,367,10
2020-09-28,Mauritius,MU,0,0,1269670,Africa,367,10
2020-09-29,Mauritius,MU,0,0,1269670,Africa,367,10
2020-09-30,Mauritius,MU,14,0,1269670,Africa,381,10
2020-10-01,Mauritius,MU,0,0,1269670,Africa,381,10
2020-10-02,Mauritius,MU,0,0,1269670,Africa,381,10
2020-10-03,Mauritius,MU,0,0,1269670,Africa,381,10
2020-10-04,Mauritius,MU,0,0,1269670,Africa,381,10
2020-10-05,Mauritius,MU,0,0,1269670,Africa,381,10
2020-10-06,Mauritius,MU,0,0,1269670,Africa,381,10
2020-10-07,Mauritius,MU,14,0,1269670,Africa,395,10
2020-10-08,Mauritius,MU,0,0,1269670,Africa,395,10
2020-10-09,Mauritius,MU,0,0,1269670,Africa,395,10
2020-10-10,Mauritius,MU,0,0,1269670,Africa,395,10
2020-10-11,Mauritius,MU,0,0,1269670,Africa,395,10
2020-10-12,Mauritius,MU,0,0,1269670,Africa,395,10
2020-10-13,Mauritius,MU,9,0,1269670,Africa,404,10
2020-10-14,Mauritius,MU,3,0,1269670,Africa,407,10
2020-10-15,Mauritius,MU,0,0,1269670,Africa,407,10
2020-10-16,Mauritius,MU,0,0,1269670,Africa,407,10
2020-10-17,Mauritius,MU,0,0,1269670,Africa,407,10
2020-10-18,Mauritius,MU,0,0,1269670,Africa,407,10
2020-10-19,Mauritius,MU,0,0,1269670,Africa,407,10
2020-10-20,Mauritius,MU,12,0,1269670,Africa,419,10
2020-10-21,Mauritius,MU,0,0,1269670,Africa,419,10
2020-10-22,Mauritius,MU,0,0,1269670,Africa,419,10
2020-10-23,Mauritius,MU,2,0,1269670,Africa,421,10
2020-10-24,Mauritius,MU,14,0,1269670,Africa,435,10
2020-10-25,Mauritius,MU,0,0,1269670,Africa,435,10
2020-10-26,Mauritius,MU,0,0,1269670,Africa,435,10
2020-10-27,Mauritius,MU,4,0,1269670,Africa,439,10
2020-10-28,Mauritius,MU,0,0,1269670,Africa,439,10
2020-10-29,Mauritius,MU,2,0,1269670,Africa,441,10
2020-10-30,Mauritius,MU,0,0,1269670,Africa,441,10
2020-10-31,Mauritius,MU,0,0,1269670,Africa,441,10
2020-11-01,Mauritius,MU,0,0,1269670,Africa,441,10
2020-11-02,Mauritius,MU,5,0,1269670,Africa,446,10
2020-11-03,Mauritius,MU,5,0,1269670,Africa,451,10
2020-11-04,Mauritius,MU,0,0,1269670,Africa,451,10
2020-11-05,Mauritius,MU,1,0,1269670,Africa,452,10
2020-11-06,Mauritius,MU,0,0,1269670,Africa,452,10
2020-11-07,Mauritius,MU,0,0,1269670,Africa,452,10
2020-11-08,Mauritius,MU,0,0,1269670,Africa,452,10
2020-11-09,Mauritius,MU,0,0,1269670,Africa,452,10
2020-11-10,Mauritius,MU,0,0,1269670,Africa,452,10
2020-11-11,Mauritius,MU,0,0,1269670,Africa,452,10
2020-11-12,Mauritius,MU,0,0,1269670,Africa,452,10
2020-11-13,Mauritius,MU,16,0,1269670,Africa,468,10
2020-11-14,Mauritius,MU,2,0,1269670,Africa,470,10
2020-11-15,Mauritius,MU,0,0,1269670,Africa,470,10
2020-11-16,Mauritius,MU,8,0,1269670,Africa,478,10
2020-11-17,Mauritius,MU,0,0,1269670,Africa,478,10
2020-11-18,Mauritius,MU,13,0,1269670,Africa,491,10
2020-11-19,Mauritius,MU,3,0,1269670,Africa,494,10
2020-11-20,Mauritius,MU,0,0,1269670,Africa,494,10
2020-11-21,Mauritius,MU,0,0,1269670,Africa,494,10
2020-11-22,Mauritius,MU,0,0,1269670,Africa,494,10
2020-11-23,Mauritius,MU,0,0,1269670,Africa,494,10
2020-11-24,Mauritius,MU,0,0,1269670,Africa,494,10
2020-11-25,Mauritius,MU,3,0,1269670,Africa,497,10
2020-11-26,Mauritius,MU,0,0,1269670,Africa,497,10
2020-11-27,Mauritius,MU,0,0,1269670,Africa,497,10
2020-11-28,Mauritius,MU,4,0,1269670,Africa,501,10
2020-11-29,Mauritius,MU,0,0,1269670,Africa,501,10
2020-11-30,Mauritius,MU,0,0,1269670,Africa,501,10
2020-12-01,Mauritius,MU,3,0,1269670,Africa,504,10
2020-12-02,Mauritius,MU,1,0,1269670,Africa,505,10
2020-12-03,Mauritius,MU,0,0,1269670,Africa,505,10
2020-12-04,Mauritius,MU,0,0,1269670,Africa,505,10
2020-12-05,Mauritius,MU,0,0,1269670,Africa,505,10
2020-12-06,Mauritius,MU,0,0,1269670,Africa,505,10
2020-12-07,Mauritius,MU,0,0,1269670,Africa,505,10
2020-12-08,Mauritius,MU,0,0,1269670,Africa,505,10
2020-12-09,Mauritius,MU,10,0,1269670,Africa,515,10
2020-12-10,Mauritius,MU,0,0,1269670,Africa,515,10
2020-12-11,Mauritius,MU,0,0,1269670,Africa,515,10
2020-12-12,Mauritius,MU,0,0,1269670,Africa,515,10
2020-12-13,Mauritius,MU,0,0,1269670,Africa,515,10
2020-12-14,Mauritius,MU,0,0,1269670,Africa,515,10
2020-03-08,Maldives,MV,2,0,530957,Asia,2,0
2020-03-09,Maldives,MV,2,0,530957,Asia,4,0
2020-03-11,Maldives,MV,2,0,530957,Asia,6,0
2020-03-12,Maldives,MV,2,0,530957,Asia,8,0
2020-03-14,Maldives,MV,1,0,530957,Asia,9,0
2020-03-15,Maldives,MV,0,0,530957,Asia,9,0
2020-03-16,Maldives,MV,4,0,530957,Asia,13,0
2020-03-17,Maldives,MV,0,0,530957,Asia,13,0
2020-03-18,Maldives,MV,0,0,530957,Asia,13,0
2020-03-19,Maldives,MV,0,0,530957,Asia,13,0
2020-03-20,Maldives,MV,0,0,530957,Asia,13,0
2020-03-21,Maldives,MV,0,0,530957,Asia,13,0
2020-03-22,Maldives,MV,0,0,530957,Asia,13,0
2020-03-23,Maldives,MV,0,0,530957,Asia,13,0
2020-03-24,Maldives,MV,0,0,530957,Asia,13,0
2020-03-25,Maldives,MV,0,0,530957,Asia,13,0
2020-03-26,Maldives,MV,0,0,530957,Asia,13,0
2020-03-27,Maldives,MV,0,0,530957,Asia,13,0
2020-03-28,Maldives,MV,1,0,530957,Asia,14,0
2020-03-29,Maldives,MV,2,0,530957,Asia,16,0
2020-03-30,Maldives,MV,1,0,530957,Asia,17,0
2020-03-31,Maldives,MV,0,0,530957,Asia,17,0
2020-04-01,Maldives,MV,1,0,530957,Asia,18,0
2020-04-02,Maldives,MV,1,0,530957,Asia,19,0
2020-04-03,Maldives,MV,0,0,530957,Asia,19,0
2020-04-04,Maldives,MV,0,0,530957,Asia,19,0
2020-04-05,Maldives,MV,0,0,530957,Asia,19,0
2020-04-06,Maldives,MV,0,0,530957,Asia,19,0
2020-04-07,Maldives,MV,0,0,530957,Asia,19,0
2020-04-08,Maldives,MV,0,0,530957,Asia,19,0
2020-04-09,Maldives,MV,0,0,530957,Asia,19,0
2020-04-10,Maldives,MV,0,0,530957,Asia,19,0
2020-04-11,Maldives,MV,0,0,530957,Asia,19,0
2020-04-12,Maldives,MV,0,0,530957,Asia,19,0
2020-04-13,Maldives,MV,1,0,530957,Asia,20,0
2020-04-14,Maldives,MV,0,0,530957,Asia,20,0
2020-04-15,Maldives,MV,1,0,530957,Asia,21,0
2020-04-16,Maldives,MV,0,0,530957,Asia,21,0
2020-04-17,Maldives,MV,4,0,530957,Asia,25,0
2020-04-18,Maldives,MV,4,0,530957,Asia,29,0
2020-04-19,Maldives,MV,6,0,530957,Asia,35,0
2020-04-20,Maldives,MV,17,0,530957,Asia,52,0
2020-04-21,Maldives,MV,17,0,530957,Asia,69,0
2020-04-22,Maldives,MV,16,0,530957,Asia,85,0
2020-04-23,Maldives,MV,0,0,530957,Asia,85,0
2020-04-24,Maldives,MV,25,0,530957,Asia,110,0
2020-04-25,Maldives,MV,18,0,530957,Asia,128,0
2020-04-26,Maldives,MV,9,0,530957,Asia,137,0
2020-04-27,Maldives,MV,77,0,530957,Asia,214,0
2020-04-28,Maldives,MV,0,0,530957,Asia,214,0
2020-04-29,Maldives,MV,31,0,530957,Asia,245,0
2020-04-30,Maldives,MV,32,0,530957,Asia,277,0
2020-05-01,Maldives,MV,191,1,530957,Asia,468,1
2020-05-02,Maldives,MV,23,0,530957,Asia,491,1
2020-05-03,Maldives,MV,28,0,530957,Asia,519,1
2020-05-04,Maldives,MV,8,0,530957,Asia,527,1
2020-05-05,Maldives,MV,24,0,530957,Asia,551,1
2020-05-06,Maldives,MV,22,0,530957,Asia,573,1
2020-05-07,Maldives,MV,44,1,530957,Asia,617,2
2020-05-08,Maldives,MV,25,1,530957,Asia,642,3
2020-05-09,Maldives,MV,2,0,530957,Asia,644,3
2020-05-10,Maldives,MV,146,0,530957,Asia,790,3
2020-05-11,Maldives,MV,45,0,530957,Asia,835,3
2020-05-12,Maldives,MV,62,0,530957,Asia,897,3
2020-05-13,Maldives,MV,7,0,530957,Asia,904,3
2020-05-14,Maldives,MV,51,1,530957,Asia,955,4
2020-05-15,Maldives,MV,27,0,530957,Asia,982,4
2020-05-16,Maldives,MV,49,0,530957,Asia,1031,4
2020-05-17,Maldives,MV,47,0,530957,Asia,1078,4
2020-05-18,Maldives,MV,16,0,530957,Asia,1094,4
2020-05-19,Maldives,MV,12,0,530957,Asia,1106,4
2020-05-20,Maldives,MV,37,0,530957,Asia,1143,4
2020-05-21,Maldives,MV,43,0,530957,Asia,1186,4
2020-05-22,Maldives,MV,30,0,530957,Asia,1216,4
2020-05-23,Maldives,MV,58,0,530957,Asia,1274,4
2020-05-24,Maldives,MV,29,0,530957,Asia,1303,4
2020-05-25,Maldives,MV,68,0,530957,Asia,1371,4
2020-05-26,Maldives,MV,24,0,530957,Asia,1395,4
2020-05-27,Maldives,MV,43,1,530957,Asia,1438,5
2020-05-28,Maldives,MV,19,0,530957,Asia,1457,5
2020-05-29,Maldives,MV,56,0,530957,Asia,1513,5
2020-05-30,Maldives,MV,78,0,530957,Asia,1591,5
2020-05-31,Maldives,MV,81,0,530957,Asia,1672,5
2020-06-01,Maldives,MV,101,0,530957,Asia,1773,5
2020-06-02,Maldives,MV,56,1,530957,Asia,1829,6
2020-06-03,Maldives,MV,12,1,530957,Asia,1841,7
2020-06-04,Maldives,MV,9,0,530957,Asia,1850,7
2020-06-05,Maldives,MV,22,0,530957,Asia,1872,7
2020-06-06,Maldives,MV,11,0,530957,Asia,1883,7
2020-06-07,Maldives,MV,18,0,530957,Asia,1901,7
2020-06-08,Maldives,MV,2,1,530957,Asia,1903,8
2020-06-09,Maldives,MV,13,0,530957,Asia,1916,8
2020-06-10,Maldives,MV,26,0,530957,Asia,1942,8
2020-06-11,Maldives,MV,20,0,530957,Asia,1962,8
2020-06-12,Maldives,MV,14,0,530957,Asia,1976,8
2020-06-13,Maldives,MV,27,0,530957,Asia,2003,8
2020-06-14,Maldives,MV,10,0,530957,Asia,2013,8
2020-06-15,Maldives,MV,22,0,530957,Asia,2035,8
2020-06-16,Maldives,MV,30,0,530957,Asia,2065,8
2020-06-17,Maldives,MV,29,0,530957,Asia,2094,8
2020-06-18,Maldives,MV,26,0,530957,Asia,2120,8
2020-06-19,Maldives,MV,17,0,530957,Asia,2137,8
2020-06-20,Maldives,MV,13,0,530957,Asia,2150,8
2020-06-21,Maldives,MV,37,0,530957,Asia,2187,8
2020-06-22,Maldives,MV,16,0,530957,Asia,2203,8
2020-06-23,Maldives,MV,14,0,530957,Asia,2217,8
2020-06-24,Maldives,MV,21,0,530957,Asia,2238,8
2020-06-25,Maldives,MV,23,0,530957,Asia,2261,8
2020-06-26,Maldives,MV,16,0,530957,Asia,2277,8
2020-06-27,Maldives,MV,6,0,530957,Asia,2283,8
2020-06-28,Maldives,MV,22,0,530957,Asia,2305,8
2020-06-29,Maldives,MV,18,0,530957,Asia,2323,8
2020-06-30,Maldives,MV,13,0,530957,Asia,2336,8
2020-07-01,Maldives,MV,25,1,530957,Asia,2361,9
2020-07-02,Maldives,MV,21,0,530957,Asia,2382,9
2020-07-03,Maldives,MV,18,1,530957,Asia,2400,10
2020-07-04,Maldives,MV,10,0,530957,Asia,2410,10
2020-07-05,Maldives,MV,25,0,530957,Asia,2435,10
2020-07-06,Maldives,MV,33,1,530957,Asia,2468,11
2020-07-07,Maldives,MV,23,1,530957,Asia,2491,12
2020-07-08,Maldives,MV,10,0,530957,Asia,2501,12
2020-07-09,Maldives,MV,16,1,530957,Asia,2517,13
2020-07-10,Maldives,MV,36,0,530957,Asia,2553,13
2020-07-11,Maldives,MV,64,0,530957,Asia,2617,13
2020-07-12,Maldives,MV,47,0,530957,Asia,2664,13
2020-07-13,Maldives,MV,67,0,530957,Asia,2731,13
2020-07-14,Maldives,MV,31,0,530957,Asia,2762,13
2020-07-15,Maldives,MV,39,1,530957,Asia,2801,14
2020-07-16,Maldives,MV,30,0,530957,Asia,2831,14
2020-07-17,Maldives,MV,68,1,530957,Asia,2899,15
2020-07-18,Maldives,MV,14,0,530957,Asia,2913,15
2020-07-19,Maldives,MV,17,0,530957,Asia,2930,15
2020-07-20,Maldives,MV,36,0,530957,Asia,2966,15
2020-07-21,Maldives,MV,0,0,530957,Asia,2966,15
2020-07-22,Maldives,MV,78,0,530957,Asia,3044,15
2020-07-23,Maldives,MV,59,0,530957,Asia,3103,15
2020-07-24,Maldives,MV,0,0,530957,Asia,3103,15
2020-07-25,Maldives,MV,17,0,530957,Asia,3120,15
2020-07-26,Maldives,MV,132,0,530957,Asia,3252,15
2020-07-27,Maldives,MV,50,0,530957,Asia,3302,15
2020-07-28,Maldives,MV,67,0,530957,Asia,3369,15
2020-07-29,Maldives,MV,137,0,530957,Asia,3506,15
2020-07-30,Maldives,MV,61,0,530957,Asia,3567,15
2020-07-31,Maldives,MV,152,1,530957,Asia,3719,16
2020-08-01,Maldives,MV,74,0,530957,Asia,3793,16
2020-08-02,Maldives,MV,156,1,530957,Asia,3949,17
2020-08-03,Maldives,MV,215,0,530957,Asia,4164,17
2020-08-04,Maldives,MV,129,1,530957,Asia,4293,18
2020-08-05,Maldives,MV,153,1,530957,Asia,4446,19
2020-08-06,Maldives,MV,148,0,530957,Asia,4594,19
2020-08-07,Maldives,MV,86,0,530957,Asia,4680,19
2020-08-08,Maldives,MV,89,0,530957,Asia,4769,19
2020-08-09,Maldives,MV,129,0,530957,Asia,4898,19
2020-08-10,Maldives,MV,143,0,530957,Asia,5041,19
2020-08-11,Maldives,MV,116,0,530957,Asia,5157,19
2020-08-12,Maldives,MV,66,1,530957,Asia,5223,20
2020-08-13,Maldives,MV,143,1,530957,Asia,5366,21
2020-08-14,Maldives,MV,128,0,530957,Asia,5494,21
2020-08-15,Maldives,MV,78,1,530957,Asia,5572,22
2020-08-16,Maldives,MV,107,0,530957,Asia,5679,22
2020-08-17,Maldives,MV,106,0,530957,Asia,5785,22
2020-08-18,Maldives,MV,124,1,530957,Asia,5909,23
2020-08-19,Maldives,MV,170,1,530957,Asia,6079,24
2020-08-20,Maldives,MV,146,0,530957,Asia,6225,24
2020-08-21,Maldives,MV,145,0,530957,Asia,6370,24
2020-08-22,Maldives,MV,194,1,530957,Asia,6564,25
2020-08-23,Maldives,MV,96,1,530957,Asia,6660,26
2020-08-24,Maldives,MV,119,0,530957,Asia,6779,26
2020-08-25,Maldives,MV,133,1,530957,Asia,6912,27
2020-08-26,Maldives,MV,135,1,530957,Asia,7047,28
2020-08-27,Maldives,MV,178,0,530957,Asia,7225,28
2020-08-28,Maldives,MV,104,0,530957,Asia,7329,28
2020-08-29,Maldives,MV,140,0,530957,Asia,7469,28
2020-08-30,Maldives,MV,109,0,530957,Asia,7578,28
2020-08-31,Maldives,MV,89,0,530957,Asia,7667,28
2020-09-01,Maldives,MV,141,0,530957,Asia,7808,28
2020-09-02,Maldives,MV,195,1,530957,Asia,8003,29
2020-09-03,Maldives,MV,137,0,530957,Asia,8140,29
2020-09-04,Maldives,MV,141,0,530957,Asia,8281,29
2020-09-05,Maldives,MV,80,0,530957,Asia,8361,29
2020-09-06,Maldives,MV,125,0,530957,Asia,8486,29
2020-09-07,Maldives,MV,98,0,530957,Asia,8584,29
2020-09-08,Maldives,MV,83,0,530957,Asia,8667,29
2020-09-09,Maldives,MV,74,0,530957,Asia,8741,29
2020-09-10,Maldives,MV,93,2,530957,Asia,8834,31
2020-09-11,Maldives,MV,66,0,530957,Asia,8900,31
2020-09-12,Maldives,MV,90,0,530957,Asia,8990,31
2020-09-13,Maldives,MV,62,0,530957,Asia,9052,31
2020-09-14,Maldives,MV,121,1,530957,Asia,9173,32
2020-09-15,Maldives,MV,70,1,530957,Asia,9243,33
2020-09-16,Maldives,MV,85,0,530957,Asia,9328,33
2020-09-17,Maldives,MV,99,0,530957,Asia,9427,33
2020-09-18,Maldives,MV,67,0,530957,Asia,9494,33
2020-09-19,Maldives,MV,74,0,530957,Asia,9568,33
2020-09-20,Maldives,MV,81,0,530957,Asia,9649,33
2020-09-21,Maldives,MV,75,0,530957,Asia,9724,33
2020-09-22,Maldives,MV,46,1,530957,Asia,9770,34
2020-09-23,Maldives,MV,48,0,530957,Asia,9818,34
2020-09-24,Maldives,MV,67,0,530957,Asia,9885,34
2020-09-25,Maldives,MV,54,0,530957,Asia,9939,34
2020-09-26,Maldives,MV,75,0,530957,Asia,10014,34
2020-09-27,Maldives,MV,31,0,530957,Asia,10045,34
2020-09-28,Maldives,MV,53,0,530957,Asia,10098,34
2020-09-29,Maldives,MV,59,0,530957,Asia,10157,34
2020-09-30,Maldives,MV,37,0,530957,Asia,10194,34
2020-10-01,Maldives,MV,97,0,530957,Asia,10291,34
2020-10-02,Maldives,MV,63,0,530957,Asia,10354,34
2020-10-03,Maldives,MV,44,0,530957,Asia,10398,34
2020-10-04,Maldives,MV,67,0,530957,Asia,10465,34
2020-10-05,Maldives,MV,65,0,530957,Asia,10530,34
2020-10-06,Maldives,MV,37,0,530957,Asia,10567,34
2020-10-07,Maldives,MV,54,0,530957,Asia,10621,34
2020-10-08,Maldives,MV,35,0,530957,Asia,10656,34
2020-10-09,Maldives,MV,86,0,530957,Asia,10742,34
2020-10-10,Maldives,MV,66,0,530957,Asia,10808,34
2020-10-11,Maldives,MV,51,0,530957,Asia,10859,34
2020-10-12,Maldives,MV,35,1,530957,Asia,10894,35
2020-10-13,Maldives,MV,49,0,530957,Asia,10943,35
2020-10-14,Maldives,MV,50,0,530957,Asia,10993,35
2020-10-15,Maldives,MV,69,0,530957,Asia,11062,35
2020-10-16,Maldives,MV,51,0,530957,Asia,11113,35
2020-10-17,Maldives,MV,41,0,530957,Asia,11154,35
2020-10-18,Maldives,MV,24,1,530957,Asia,11178,36
2020-10-19,Maldives,MV,32,1,530957,Asia,11210,37
2020-10-20,Maldives,MV,22,0,530957,Asia,11232,37
2020-10-21,Maldives,MV,39,0,530957,Asia,11271,37
2020-10-22,Maldives,MV,45,0,530957,Asia,11316,37
2020-10-23,Maldives,MV,42,0,530957,Asia,11358,37
2020-10-24,Maldives,MV,33,0,530957,Asia,11391,37
2020-10-25,Maldives,MV,30,0,530957,Asia,11421,37
2020-10-26,Maldives,MV,84,0,530957,Asia,11505,37
2020-10-27,Maldives,MV,27,0,530957,Asia,11532,37
2020-10-28,Maldives,MV,35,0,530957,Asia,11567,37
2020-10-29,Maldives,MV,24,0,530957,Asia,11591,37
2020-10-30,Maldives,MV,25,0,530957,Asia,11616,37
2020-10-31,Maldives,MV,27,0,530957,Asia,11643,37
2020-11-01,Maldives,MV,16,1,530957,Asia,11659,38
2020-11-02,Maldives,MV,42,0,530957,Asia,11701,38
2020-11-03,Maldives,MV,36,0,530957,Asia,11737,38
2020-11-04,Maldives,MV,59,0,530957,Asia,11796,38
2020-11-05,Maldives,MV,26,0,530957,Asia,11822,38
2020-11-06,Maldives,MV,71,0,530957,Asia,11893,38
2020-11-07,Maldives,MV,39,1,530957,Asia,11932,39
2020-11-08,Maldives,MV,30,0,530957,Asia,11962,39
2020-11-09,Maldives,MV,24,1,530957,Asia,11986,40
2020-11-10,Maldives,MV,23,0,530957,Asia,12009,40
2020-11-11,Maldives,MV,21,0,530957,Asia,12030,40
2020-11-12,Maldives,MV,29,1,530957,Asia,12059,41
2020-11-13,Maldives,MV,26,0,530957,Asia,12085,41
2020-11-14,Maldives,MV,27,0,530957,Asia,12112,41
2020-11-15,Maldives,MV,42,1,530957,Asia,12154,42
2020-11-16,Maldives,MV,50,1,530957,Asia,12204,43
2020-11-17,Maldives,MV,110,1,530957,Asia,12314,44
2020-11-18,Maldives,MV,41,1,530957,Asia,12355,45
2020-11-19,Maldives,MV,29,0,530957,Asia,12384,45
2020-11-20,Maldives,MV,68,0,530957,Asia,12452,45
2020-11-21,Maldives,MV,94,0,530957,Asia,12546,45
2020-11-22,Maldives,MV,32,0,530957,Asia,12578,45
2020-11-23,Maldives,MV,30,1,530957,Asia,12608,46
2020-11-24,Maldives,MV,150,0,530957,Asia,12758,46
2020-11-25,Maldives,MV,52,0,530957,Asia,12810,46
2020-11-26,Maldives,MV,44,0,530957,Asia,12854,46
2020-11-27,Maldives,MV,35,0,530957,Asia,12889,46
2020-11-28,Maldives,MV,44,0,530957,Asia,12933,46
2020-11-29,Maldives,MV,14,0,530957,Asia,12947,46
2020-11-30,Maldives,MV,47,0,530957,Asia,12994,46
2020-12-01,Maldives,MV,17,0,530957,Asia,13011,46
2020-12-02,Maldives,MV,38,1,530957,Asia,13049,47
2020-12-03,Maldives,MV,21,0,530957,Asia,13070,47
2020-12-04,Maldives,MV,36,0,530957,Asia,13106,47
2020-12-05,Maldives,MV,37,0,530957,Asia,13143,47
2020-12-06,Maldives,MV,16,0,530957,Asia,13159,47
2020-12-07,Maldives,MV,39,0,530957,Asia,13198,47
2020-12-08,Maldives,MV,15,0,530957,Asia,13213,47
2020-12-09,Maldives,MV,35,0,530957,Asia,13248,47
2020-12-10,Maldives,MV,26,0,530957,Asia,13274,47
2020-12-11,Maldives,MV,34,0,530957,Asia,13308,47
2020-12-12,Maldives,MV,18,1,530957,Asia,13326,48
2020-12-13,Maldives,MV,22,0,530957,Asia,13348,48
2020-12-14,Maldives,MV,20,0,530957,Asia,13368,48
2020-04-03,Malawi,MW,3,0,18628749,Africa,3,0
2020-04-04,Malawi,MW,0,0,18628749,Africa,3,0
2020-04-05,Malawi,MW,1,0,18628749,Africa,4,0
2020-04-06,Malawi,MW,0,0,18628749,Africa,4,0
2020-04-07,Malawi,MW,1,0,18628749,Africa,5,0
2020-04-08,Malawi,MW,3,1,18628749,Africa,8,1
2020-04-09,Malawi,MW,0,0,18628749,Africa,8,1
2020-04-10,Malawi,MW,0,0,18628749,Africa,8,1
2020-04-11,Malawi,MW,1,0,18628749,Africa,9,1
2020-04-12,Malawi,MW,3,1,18628749,Africa,12,2
2020-04-13,Malawi,MW,1,0,18628749,Africa,13,2
2020-04-14,Malawi,MW,3,0,18628749,Africa,16,2
2020-04-15,Malawi,MW,0,0,18628749,Africa,16,2
2020-04-16,Malawi,MW,0,0,18628749,Africa,16,2
2020-04-17,Malawi,MW,0,0,18628749,Africa,16,2
2020-04-18,Malawi,MW,1,0,18628749,Africa,17,2
2020-04-19,Malawi,MW,0,0,18628749,Africa,17,2
2020-04-20,Malawi,MW,0,0,18628749,Africa,17,2
2020-04-21,Malawi,MW,0,0,18628749,Africa,17,2
2020-04-22,Malawi,MW,1,0,18628749,Africa,18,2
2020-04-23,Malawi,MW,5,1,18628749,Africa,23,3
2020-04-24,Malawi,MW,10,0,18628749,Africa,33,3
2020-04-25,Malawi,MW,0,0,18628749,Africa,33,3
2020-04-26,Malawi,MW,0,0,18628749,Africa,33,3
2020-04-27,Malawi,MW,1,0,18628749,Africa,34,3
2020-04-28,Malawi,MW,2,0,18628749,Africa,36,3
2020-04-29,Malawi,MW,0,0,18628749,Africa,36,3
2020-04-30,Malawi,MW,0,0,18628749,Africa,36,3
2020-05-01,Malawi,MW,1,0,18628749,Africa,37,3
2020-05-02,Malawi,MW,0,0,18628749,Africa,37,3
2020-05-03,Malawi,MW,1,0,18628749,Africa,38,3
2020-05-04,Malawi,MW,1,0,18628749,Africa,39,3
2020-05-05,Malawi,MW,2,0,18628749,Africa,41,3
2020-05-06,Malawi,MW,0,0,18628749,Africa,41,3
2020-05-07,Malawi,MW,2,0,18628749,Africa,43,3
2020-05-08,Malawi,MW,0,0,18628749,Africa,43,3
2020-05-09,Malawi,MW,0,0,18628749,Africa,43,3
2020-05-10,Malawi,MW,13,0,18628749,Africa,56,3
2020-05-11,Malawi,MW,0,0,18628749,Africa,56,3
2020-05-12,Malawi,MW,1,0,18628749,Africa,57,3
2020-05-13,Malawi,MW,1,0,18628749,Africa,58,3
2020-05-14,Malawi,MW,5,0,18628749,Africa,63,3
2020-05-15,Malawi,MW,0,0,18628749,Africa,63,3
2020-05-16,Malawi,MW,0,0,18628749,Africa,63,3
2020-05-17,Malawi,MW,2,0,18628749,Africa,65,3
2020-05-18,Malawi,MW,5,0,18628749,Africa,70,3
2020-05-19,Malawi,MW,0,0,18628749,Africa,70,3
2020-05-20,Malawi,MW,1,0,18628749,Africa,71,3
2020-05-21,Malawi,MW,1,0,18628749,Africa,72,3
2020-05-22,Malawi,MW,0,0,18628749,Africa,72,3
2020-05-23,Malawi,MW,10,0,18628749,Africa,82,3
2020-05-24,Malawi,MW,1,1,18628749,Africa,83,4
2020-05-25,Malawi,MW,0,0,18628749,Africa,83,4
2020-05-26,Malawi,MW,18,0,18628749,Africa,101,4
2020-05-27,Malawi,MW,0,0,18628749,Africa,101,4
2020-05-28,Malawi,MW,0,0,18628749,Africa,101,4
2020-05-29,Malawi,MW,102,0,18628749,Africa,203,4
2020-05-30,Malawi,MW,70,0,18628749,Africa,273,4
2020-05-31,Malawi,MW,6,0,18628749,Africa,279,4
2020-06-01,Malawi,MW,5,0,18628749,Africa,284,4
2020-06-02,Malawi,MW,52,0,18628749,Africa,336,4
2020-06-03,Malawi,MW,22,0,18628749,Africa,358,4
2020-06-04,Malawi,MW,11,0,18628749,Africa,369,4
2020-06-05,Malawi,MW,24,0,18628749,Africa,393,4
2020-06-06,Malawi,MW,16,0,18628749,Africa,409,4
2020-06-07,Malawi,MW,0,0,18628749,Africa,409,4
2020-06-08,Malawi,MW,29,0,18628749,Africa,438,4
2020-06-09,Malawi,MW,5,0,18628749,Africa,443,4
2020-06-10,Malawi,MW,12,0,18628749,Africa,455,4
2020-06-11,Malawi,MW,0,0,18628749,Africa,455,4
2020-06-12,Malawi,MW,26,0,18628749,Africa,481,4
2020-06-13,Malawi,MW,0,0,18628749,Africa,481,4
2020-06-14,Malawi,MW,48,1,18628749,Africa,529,5
2020-06-15,Malawi,MW,18,1,18628749,Africa,547,6
2020-06-16,Malawi,MW,9,0,18628749,Africa,556,6
2020-06-17,Malawi,MW,8,0,18628749,Africa,564,6
2020-06-18,Malawi,MW,8,0,18628749,Africa,572,6
2020-06-19,Malawi,MW,20,2,18628749,Africa,592,8
2020-06-20,Malawi,MW,28,0,18628749,Africa,620,8
2020-06-21,Malawi,MW,0,0,18628749,Africa,620,8
2020-06-22,Malawi,MW,110,3,18628749,Africa,730,11
2020-06-23,Malawi,MW,73,0,18628749,Africa,803,11
2020-06-24,Malawi,MW,45,0,18628749,Africa,848,11
2020-06-25,Malawi,MW,93,0,18628749,Africa,941,11
2020-06-26,Malawi,MW,19,1,18628749,Africa,960,12
2020-06-27,Malawi,MW,45,1,18628749,Africa,1005,13
2020-06-28,Malawi,MW,33,0,18628749,Africa,1038,13
2020-06-29,Malawi,MW,108,0,18628749,Africa,1146,13
2020-06-30,Malawi,MW,78,1,18628749,Africa,1224,14
2020-07-01,Malawi,MW,41,2,18628749,Africa,1265,16
2020-07-02,Malawi,MW,77,0,18628749,Africa,1342,16
2020-07-03,Malawi,MW,60,0,18628749,Africa,1402,16
2020-07-04,Malawi,MW,96,0,18628749,Africa,1498,16
2020-07-05,Malawi,MW,115,1,18628749,Africa,1613,17
2020-07-06,Malawi,MW,129,2,18628749,Africa,1742,19
2020-07-07,Malawi,MW,76,0,18628749,Africa,1818,19
2020-07-08,Malawi,MW,59,5,18628749,Africa,1877,24
2020-07-09,Malawi,MW,52,1,18628749,Africa,1929,25
2020-07-10,Malawi,MW,55,4,18628749,Africa,1984,29
2020-07-11,Malawi,MW,85,2,18628749,Africa,2069,31
2020-07-12,Malawi,MW,192,2,18628749,Africa,2261,33
2020-07-13,Malawi,MW,103,5,18628749,Africa,2364,38
2020-07-14,Malawi,MW,66,1,18628749,Africa,2430,39
2020-07-15,Malawi,MW,67,1,18628749,Africa,2497,40
2020-07-16,Malawi,MW,117,3,18628749,Africa,2614,43
2020-07-17,Malawi,MW,98,8,18628749,Africa,2712,51
2020-07-18,Malawi,MW,98,4,18628749,Africa,2810,55
2020-07-19,Malawi,MW,97,4,18628749,Africa,2907,59
2020-07-20,Malawi,MW,85,3,18628749,Africa,2992,62
2020-07-21,Malawi,MW,53,2,18628749,Africa,3045,64
2020-07-22,Malawi,MW,104,7,18628749,Africa,3149,71
2020-07-23,Malawi,MW,153,5,18628749,Africa,3302,76
2020-07-24,Malawi,MW,84,3,18628749,Africa,3386,79
2020-07-25,Malawi,MW,67,8,18628749,Africa,3453,87
2020-07-26,Malawi,MW,0,0,18628749,Africa,3453,87
2020-07-27,Malawi,MW,187,12,18628749,Africa,3640,99
2020-07-28,Malawi,MW,69,4,18628749,Africa,3709,103
2020-07-29,Malawi,MW,0,0,18628749,Africa,3709,103
2020-07-30,Malawi,MW,149,4,18628749,Africa,3858,107
2020-07-31,Malawi,MW,123,2,18628749,Africa,3981,109
2020-08-01,Malawi,MW,97,5,18628749,Africa,4078,114
2020-08-02,Malawi,MW,108,6,18628749,Africa,4186,120
2020-08-03,Malawi,MW,45,3,18628749,Africa,4231,123
2020-08-04,Malawi,MW,42,0,18628749,Africa,4273,123
2020-08-05,Malawi,MW,74,5,18628749,Africa,4347,128
2020-08-06,Malawi,MW,79,8,18628749,Africa,4426,136
2020-08-07,Malawi,MW,65,1,18628749,Africa,4491,137
2020-08-08,Malawi,MW,84,0,18628749,Africa,4575,137
2020-08-09,Malawi,MW,49,6,18628749,Africa,4624,143
2020-08-10,Malawi,MW,34,3,18628749,Africa,4658,146
2020-08-11,Malawi,MW,15,0,18628749,Africa,4673,146
2020-08-12,Malawi,MW,39,6,18628749,Africa,4712,152
2020-08-13,Malawi,MW,40,0,18628749,Africa,4752,152
2020-08-14,Malawi,MW,160,1,18628749,Africa,4912,153
2020-08-15,Malawi,MW,76,3,18628749,Africa,4988,156
2020-08-16,Malawi,MW,38,1,18628749,Africa,5026,157
2020-08-17,Malawi,MW,46,4,18628749,Africa,5072,161
2020-08-18,Malawi,MW,0,0,18628749,Africa,5072,161
2020-08-19,Malawi,MW,121,2,18628749,Africa,5193,163
2020-08-20,Malawi,MW,47,1,18628749,Africa,5240,164
2020-08-21,Malawi,MW,0,0,18628749,Africa,5240,164
2020-08-22,Malawi,MW,42,1,18628749,Africa,5282,165
2020-08-23,Malawi,MW,40,1,18628749,Africa,5322,166
2020-08-24,Malawi,MW,0,0,18628749,Africa,5322,166
2020-08-25,Malawi,MW,97,3,18628749,Africa,5419,169
2020-08-26,Malawi,MW,4,1,18628749,Africa,5423,170
2020-08-27,Malawi,MW,51,3,18628749,Africa,5474,173
2020-08-28,Malawi,MW,22,0,18628749,Africa,5496,173
2020-08-29,Malawi,MW,27,1,18628749,Africa,5523,174
2020-08-30,Malawi,MW,5,0,18628749,Africa,5528,174
2020-08-31,Malawi,MW,8,0,18628749,Africa,5536,174
2020-09-01,Malawi,MW,30,1,18628749,Africa,5566,175
2020-09-02,Malawi,MW,10,0,18628749,Africa,5576,175
2020-09-03,Malawi,MW,3,0,18628749,Africa,5579,175
2020-09-04,Malawi,MW,14,0,18628749,Africa,5593,175
2020-09-05,Malawi,MW,15,0,18628749,Africa,5608,175
2020-09-06,Malawi,MW,3,0,18628749,Africa,5611,175
2020-09-07,Malawi,MW,3,0,18628749,Africa,5614,175
2020-09-08,Malawi,MW,7,1,18628749,Africa,5621,176
2020-09-09,Malawi,MW,9,0,18628749,Africa,5630,176
2020-09-10,Malawi,MW,23,0,18628749,Africa,5653,176
2020-09-11,Malawi,MW,2,0,18628749,Africa,5655,176
2020-09-12,Malawi,MW,14,1,18628749,Africa,5669,177
2020-09-13,Malawi,MW,9,0,18628749,Africa,5678,177
2020-09-14,Malawi,MW,12,0,18628749,Africa,5690,177
2020-09-15,Malawi,MW,7,1,18628749,Africa,5697,178
2020-09-16,Malawi,MW,4,0,18628749,Africa,5701,178
2020-09-17,Malawi,MW,0,0,18628749,Africa,5701,178
2020-09-18,Malawi,MW,10,1,18628749,Africa,5711,179
2020-09-19,Malawi,MW,5,0,18628749,Africa,5716,179
2020-09-20,Malawi,MW,0,0,18628749,Africa,5716,179
2020-09-21,Malawi,MW,15,0,18628749,Africa,5731,179
2020-09-22,Malawi,MW,2,0,18628749,Africa,5733,179
2020-09-23,Malawi,MW,4,0,18628749,Africa,5737,179
2020-09-24,Malawi,MW,9,0,18628749,Africa,5746,179
2020-09-25,Malawi,MW,1,0,18628749,Africa,5747,179
2020-09-26,Malawi,MW,14,0,18628749,Africa,5761,179
2020-09-27,Malawi,MW,2,0,18628749,Africa,5763,179
2020-09-28,Malawi,MW,5,0,18628749,Africa,5768,179
2020-09-29,Malawi,MW,2,0,18628749,Africa,5770,179
2020-09-30,Malawi,MW,2,0,18628749,Africa,5772,179
2020-10-01,Malawi,MW,1,0,18628749,Africa,5773,179
2020-10-02,Malawi,MW,6,0,18628749,Africa,5779,179
2020-10-03,Malawi,MW,4,0,18628749,Africa,5783,179
2020-10-04,Malawi,MW,0,0,18628749,Africa,5783,179
2020-10-05,Malawi,MW,3,0,18628749,Africa,5786,179
2020-10-06,Malawi,MW,8,1,18628749,Africa,5794,180
2020-10-07,Malawi,MW,2,0,18628749,Africa,5796,180
2020-10-08,Malawi,MW,7,0,18628749,Africa,5803,180
2020-10-09,Malawi,MW,6,0,18628749,Africa,5809,180
2020-10-10,Malawi,MW,4,0,18628749,Africa,5813,180
2020-10-11,Malawi,MW,8,0,18628749,Africa,5821,180
2020-10-12,Malawi,MW,0,0,18628749,Africa,5821,180
2020-10-13,Malawi,MW,3,0,18628749,Africa,5824,180
2020-10-14,Malawi,MW,3,1,18628749,Africa,5827,181
2020-10-15,Malawi,MW,2,0,18628749,Africa,5829,181
2020-10-16,Malawi,MW,7,0,18628749,Africa,5836,181
2020-10-17,Malawi,MW,6,0,18628749,Africa,5842,181
2020-10-18,Malawi,MW,10,0,18628749,Africa,5852,181
2020-10-19,Malawi,MW,5,0,18628749,Africa,5857,181
2020-10-20,Malawi,MW,3,0,18628749,Africa,5860,181
2020-10-21,Malawi,MW,1,1,18628749,Africa,5861,182
2020-10-22,Malawi,MW,3,1,18628749,Africa,5864,183
2020-10-23,Malawi,MW,10,0,18628749,Africa,5874,183
2020-10-24,Malawi,MW,11,0,18628749,Africa,5885,183
2020-10-25,Malawi,MW,2,0,18628749,Africa,5887,183
2020-10-26,Malawi,MW,3,0,18628749,Africa,5890,183
2020-10-27,Malawi,MW,4,0,18628749,Africa,5894,183
2020-10-28,Malawi,MW,3,0,18628749,Africa,5897,183
2020-10-29,Malawi,MW,7,1,18628749,Africa,5904,184
2020-10-30,Malawi,MW,12,0,18628749,Africa,5916,184
2020-10-31,Malawi,MW,7,0,18628749,Africa,5923,184
2020-11-01,Malawi,MW,7,0,18628749,Africa,5930,184
2020-11-02,Malawi,MW,2,0,18628749,Africa,5932,184
2020-11-03,Malawi,MW,1,0,18628749,Africa,5933,184
2020-11-04,Malawi,MW,1,0,18628749,Africa,5934,184
2020-11-05,Malawi,MW,0,0,18628749,Africa,5934,184
2020-11-06,Malawi,MW,6,0,18628749,Africa,5940,184
2020-11-07,Malawi,MW,2,0,18628749,Africa,5942,184
2020-11-08,Malawi,MW,6,0,18628749,Africa,5948,184
2020-11-09,Malawi,MW,3,0,18628749,Africa,5951,184
2020-11-10,Malawi,MW,2,1,18628749,Africa,5953,185
2020-11-11,Malawi,MW,0,0,18628749,Africa,5953,185
2020-11-12,Malawi,MW,2,0,18628749,Africa,5955,185
2020-11-13,Malawi,MW,3,0,18628749,Africa,5958,185
2020-11-14,Malawi,MW,4,0,18628749,Africa,5962,185
2020-11-15,Malawi,MW,2,0,18628749,Africa,5964,185
2020-11-16,Malawi,MW,1,0,18628749,Africa,5965,185
2020-11-17,Malawi,MW,6,0,18628749,Africa,5971,185
2020-11-18,Malawi,MW,24,0,18628749,Africa,5995,185
2020-11-19,Malawi,MW,4,0,18628749,Africa,5999,185
2020-11-20,Malawi,MW,3,0,18628749,Africa,6002,185
2020-11-21,Malawi,MW,1,0,18628749,Africa,6003,185
2020-11-22,Malawi,MW,0,0,18628749,Africa,6003,185
2020-11-23,Malawi,MW,0,0,18628749,Africa,6003,185
2020-11-24,Malawi,MW,6,0,18628749,Africa,6009,185
2020-11-25,Malawi,MW,8,0,18628749,Africa,6017,185
2020-11-26,Malawi,MW,1,0,18628749,Africa,6018,185
2020-11-27,Malawi,MW,2,0,18628749,Africa,6020,185
2020-11-28,Malawi,MW,4,0,18628749,Africa,6024,185
2020-11-29,Malawi,MW,1,0,18628749,Africa,6025,185
2020-11-30,Malawi,MW,0,0,18628749,Africa,6025,185
2020-12-01,Malawi,MW,3,0,18628749,Africa,6028,185
2020-12-02,Malawi,MW,0,0,18628749,Africa,6028,185
2020-12-03,Malawi,MW,12,0,18628749,Africa,6040,185
2020-12-04,Malawi,MW,3,0,18628749,Africa,6043,185
2020-12-05,Malawi,MW,4,0,18628749,Africa,6047,185
2020-12-06,Malawi,MW,2,0,18628749,Africa,6049,185
2020-12-07,Malawi,MW,2,0,18628749,Africa,6051,185
2020-12-08,Malawi,MW,0,0,18628749,Africa,6051,185
2020-12-09,Malawi,MW,0,1,18628749,Africa,6051,186
2020-12-10,Malawi,MW,0,0,18628749,Africa,6051,186
2020-12-11,Malawi,MW,2,0,18628749,Africa,6053,186
2020-12-12,Malawi,MW,2,0,18628749,Africa,6055,186
2020-12-13,Malawi,MW,8,0,18628749,Africa,6063,186
2020-12-14,Malawi,MW,3,1,18628749,Africa,6066,187
2019-12-31,Mexico,MX,0,0,127575529,America,0,0
2020-01-01,Mexico,MX,0,0,127575529,America,0,0
2020-01-02,Mexico,MX,0,0,127575529,America,0,0
2020-01-03,Mexico,MX,0,0,127575529,America,0,0
2020-01-04,Mexico,MX,0,0,127575529,America,0,0
2020-01-05,Mexico,MX,0,0,127575529,America,0,0
2020-01-06,Mexico,MX,0,0,127575529,America,0,0
2020-01-07,Mexico,MX,0,0,127575529,America,0,0
2020-01-08,Mexico,MX,0,0,127575529,America,0,0
2020-01-09,Mexico,MX,0,0,127575529,America,0,0
2020-01-10,Mexico,MX,0,0,127575529,America,0,0
2020-01-11,Mexico,MX,0,0,127575529,America,0,0
2020-01-12,Mexico,MX,0,0,127575529,America,0,0
2020-01-13,Mexico,MX,0,0,127575529,America,0,0
2020-01-14,Mexico,MX,1,0,127575529,America,1,0
2020-01-15,Mexico,MX,0,0,127575529,America,1,0
2020-01-16,Mexico,MX,0,0,127575529,America,1,0
2020-01-17,Mexico,MX,0,0,127575529,America,1,0
2020-01-18,Mexico,MX,0,0,127575529,America,1,0
2020-01-19,Mexico,MX,0,0,127575529,America,1,0
2020-01-20,Mexico,MX,0,0,127575529,America,1,0
2020-01-21,Mexico,MX,0,0,127575529,America,1,0
2020-01-22,Mexico,MX,0,0,127575529,America,1,0
2020-01-23,Mexico,MX,0,0,127575529,America,1,0
2020-01-24,Mexico,MX,0,0,127575529,America,1,0
2020-01-25,Mexico,MX,0,0,127575529,America,1,0
2020-01-26,Mexico,MX,0,0,127575529,America,1,0
2020-01-27,Mexico,MX,0,0,127575529,America,1,0
2020-01-28,Mexico,MX,0,0,127575529,America,1,0
2020-01-29,Mexico,MX,0,0,127575529,America,1,0
2020-01-30,Mexico,MX,1,0,127575529,America,2,0
2020-01-31,Mexico,MX,0,0,127575529,America,2,0
2020-02-01,Mexico,MX,0,0,127575529,America,2,0
2020-02-02,Mexico,MX,0,0,127575529,America,2,0
2020-02-03,Mexico,MX,0,0,127575529,America,2,0
2020-02-04,Mexico,MX,0,0,127575529,America,2,0
2020-02-05,Mexico,MX,0,0,127575529,America,2,0
2020-02-06,Mexico,MX,0,0,127575529,America,2,0
2020-02-07,Mexico,MX,0,0,127575529,America,2,0
2020-02-08,Mexico,MX,0,0,127575529,America,2,0
2020-02-09,Mexico,MX,0,0,127575529,America,2,0
2020-02-10,Mexico,MX,0,0,127575529,America,2,0
2020-02-11,Mexico,MX,1,0,127575529,America,3,0
2020-02-12,Mexico,MX,0,0,127575529,America,3,0
2020-02-13,Mexico,MX,0,0,127575529,America,3,0
2020-02-14,Mexico,MX,0,0,127575529,America,3,0
2020-02-15,Mexico,MX,0,0,127575529,America,3,0
2020-02-16,Mexico,MX,0,0,127575529,America,3,0
2020-02-17,Mexico,MX,0,0,127575529,America,3,0
2020-02-18,Mexico,MX,0,0,127575529,America,3,0
2020-02-19,Mexico,MX,0,0,127575529,America,3,0
2020-02-20,Mexico,MX,0,0,127575529,America,3,0
2020-02-21,Mexico,MX,0,0,127575529,America,3,0
2020-02-22,Mexico,MX,0,0,127575529,America,3,0
2020-02-23,Mexico,MX,1,0,127575529,America,4,0
2020-02-24,Mexico,MX,0,0,127575529,America,4,0
2020-02-25,Mexico,MX,2,0,127575529,America,6,0
2020-02-26,Mexico,MX,0,0,127575529,America,6,0
2020-02-27,Mexico,MX,0,0,127575529,America,6,0
2020-02-28,Mexico,MX,5,0,127575529,America,11,0
2020-02-29,Mexico,MX,3,0,127575529,America,14,0
2020-03-01,Mexico,MX,1,0,127575529,America,15,0
2020-03-02,Mexico,MX,0,0,127575529,America,15,0
2020-03-03,Mexico,MX,1,0,127575529,America,16,0
2020-03-04,Mexico,MX,3,0,127575529,America,19,0
2020-03-05,Mexico,MX,3,0,127575529,America,22,0
2020-03-06,Mexico,MX,2,0,127575529,America,24,0
2020-03-07,Mexico,MX,0,0,127575529,America,24,0
2020-03-08,Mexico,MX,1,0,127575529,America,25,0
2020-03-09,Mexico,MX,4,0,127575529,America,29,0
2020-03-10,Mexico,MX,2,0,127575529,America,31,0
2020-03-11,Mexico,MX,11,0,127575529,America,42,0
2020-03-12,Mexico,MX,28,0,127575529,America,70,0
2020-03-13,Mexico,MX,28,0,127575529,America,98,0
2020-03-14,Mexico,MX,61,0,127575529,America,159,0
2020-03-15,Mexico,MX,50,0,127575529,America,209,0
2020-03-16,Mexico,MX,36,0,127575529,America,245,0
2020-03-17,Mexico,MX,69,0,127575529,America,314,0
2020-03-18,Mexico,MX,97,0,127575529,America,411,0
2020-03-19,Mexico,MX,105,0,127575529,America,516,0
2020-03-20,Mexico,MX,148,0,127575529,America,664,0
2020-03-21,Mexico,MX,118,2,127575529,America,782,2
2020-03-22,Mexico,MX,68,0,127575529,America,850,2
2020-03-23,Mexico,MX,49,0,127575529,America,899,2
2020-03-24,Mexico,MX,135,2,127575529,America,1034,4
2020-03-25,Mexico,MX,188,1,127575529,America,1222,5
2020-03-26,Mexico,MX,155,0,127575529,America,1377,5
2020-03-27,Mexico,MX,203,3,127575529,America,1580,8
2020-03-28,Mexico,MX,223,4,127575529,America,1803,12
2020-03-29,Mexico,MX,171,4,127575529,America,1974,16
2020-03-30,Mexico,MX,146,4,127575529,America,2120,20
2020-03-31,Mexico,MX,326,8,127575529,America,2446,28
2020-04-01,Mexico,MX,286,1,127575529,America,2732,29
2020-04-02,Mexico,MX,337,8,127575529,America,3069,37
2020-04-03,Mexico,MX,321,13,127575529,America,3390,50
2020-04-04,Mexico,MX,347,10,127575529,America,3737,60
2020-04-05,Mexico,MX,229,19,127575529,America,3966,79
2020-04-06,Mexico,MX,237,15,127575529,America,4203,94
2020-04-07,Mexico,MX,573,31,127575529,America,4776,125
2020-04-08,Mexico,MX,473,16,127575529,America,5249,141
2020-04-09,Mexico,MX,534,33,127575529,America,5783,174
2020-04-10,Mexico,MX,429,20,127575529,America,6212,194
2020-04-11,Mexico,MX,514,39,127575529,America,6726,233
2020-04-12,Mexico,MX,426,40,127575529,America,7152,273
2020-04-13,Mexico,MX,437,23,127575529,America,7589,296
2020-04-14,Mexico,MX,888,36,127575529,America,8477,332
2020-04-15,Mexico,MX,866,74,127575529,America,9343,406
2020-04-16,Mexico,MX,912,43,127575529,America,10255,449
2020-04-17,Mexico,MX,939,37,127575529,America,11194,486
2020-04-18,Mexico,MX,1076,60,127575529,America,12270,546
2020-04-19,Mexico,MX,755,104,127575529,America,13025,650
2020-04-20,Mexico,MX,705,36,127575529,America,13730,686
2020-04-21,Mexico,MX,1432,26,127575529,America,15162,712
2020-04-22,Mexico,MX,1385,145,127575529,America,16547,857
2020-04-23,Mexico,MX,1303,113,127575529,America,17850,970
2020-04-24,Mexico,MX,1391,99,127575529,America,19241,1069
2020-04-25,Mexico,MX,1597,152,127575529,America,20838,1221
2020-04-26,Mexico,MX,1035,84,127575529,America,21873,1305
2020-04-27,Mexico,MX,992,46,127575529,America,22865,1351
2020-04-28,Mexico,MX,1805,83,127575529,America,24670,1434
2020-04-29,Mexico,MX,1797,135,127575529,America,26467,1569
2020-04-30,Mexico,MX,1755,163,127575529,America,28222,1732
2020-05-01,Mexico,MX,1765,127,127575529,America,29987,1859
2020-05-02,Mexico,MX,1379,113,127575529,America,31366,1972
2020-05-03,Mexico,MX,1352,89,127575529,America,32718,2061
2020-05-04,Mexico,MX,1241,93,127575529,America,33959,2154
2020-05-05,Mexico,MX,2507,117,127575529,America,36466,2271
2020-05-06,Mexico,MX,2082,236,127575529,America,38548,2507
2020-05-07,Mexico,MX,2265,197,127575529,America,40813,2704
2020-05-08,Mexico,MX,2374,257,127575529,America,43187,2961
2020-05-09,Mexico,MX,2393,199,127575529,America,45580,3160
2020-05-10,Mexico,MX,1513,193,127575529,America,47093,3353
2020-05-11,Mexico,MX,1402,112,127575529,America,48495,3465
2020-05-12,Mexico,MX,2942,108,127575529,America,51437,3573
2020-05-13,Mexico,MX,2903,353,127575529,America,54340,3926
2020-05-14,Mexico,MX,3095,294,127575529,America,57435,4220
2020-05-15,Mexico,MX,3050,257,127575529,America,60485,4477
2020-05-16,Mexico,MX,3449,290,127575529,America,63934,4767
2020-05-17,Mexico,MX,2151,278,127575529,America,66085,5045
2020-05-18,Mexico,MX,1623,132,127575529,America,67708,5177
2020-05-19,Mexico,MX,3998,155,127575529,America,71706,5332
2020-05-20,Mexico,MX,3547,334,127575529,America,75253,5666
2020-05-21,Mexico,MX,3894,424,127575529,America,79147,6090
2020-05-22,Mexico,MX,3978,420,127575529,America,83125,6510
2020-05-23,Mexico,MX,3963,479,127575529,America,87088,6989
2020-05-24,Mexico,MX,2256,190,127575529,America,89344,7179
2020-05-25,Mexico,MX,1861,215,127575529,America,91205,7394
2020-05-26,Mexico,MX,4593,239,127575529,America,95798,7633
2020-05-27,Mexico,MX,4314,501,127575529,America,100112,8134
2020-05-28,Mexico,MX,4457,463,127575529,America,104569,8597
2020-05-29,Mexico,MX,4203,447,127575529,America,108772,9044
2020-05-30,Mexico,MX,4344,371,127575529,America,113116,9415
2020-05-31,Mexico,MX,2713,364,127575529,America,115829,9779
2020-06-01,Mexico,MX,2061,151,127575529,America,117890,9930
2020-06-02,Mexico,MX,5249,237,127575529,America,123139,10167
2020-06-03,Mexico,MX,4716,470,127575529,America,127855,10637
2020-06-04,Mexico,MX,4916,1091,127575529,America,132771,11728
2020-06-05,Mexico,MX,4870,817,127575529,America,137641,12545
2020-06-06,Mexico,MX,5013,625,127575529,America,142654,13170
2020-06-07,Mexico,MX,2983,341,127575529,America,145637,13511
2020-06-08,Mexico,MX,2323,188,127575529,America,147960,13699
2020-06-09,Mexico,MX,6128,354,127575529,America,154088,14053
2020-06-10,Mexico,MX,5733,596,127575529,America,159821,14649
2020-06-11,Mexico,MX,5690,708,127575529,America,165511,15357
2020-06-12,Mexico,MX,5363,587,127575529,America,170874,15944
2020-06-13,Mexico,MX,5586,504,127575529,America,176460,16448
2020-06-14,Mexico,MX,3051,424,127575529,America,179511,16872
2020-06-15,Mexico,MX,2567,269,127575529,America,182078,17141
2020-06-16,Mexico,MX,6524,439,127575529,America,188602,17580
2020-06-17,Mexico,MX,6374,730,127575529,America,194976,18310
2020-06-18,Mexico,MX,6094,770,127575529,America,201070,19080
2020-06-19,Mexico,MX,6022,667,127575529,America,207092,19747
2020-06-20,Mexico,MX,6073,647,127575529,America,213165,20394
2020-06-21,Mexico,MX,3536,387,127575529,America,216701,20781
2020-06-22,Mexico,MX,2431,1044,127575529,America,219132,21825
2020-06-23,Mexico,MX,6832,759,127575529,America,225964,22584
2020-06-24,Mexico,MX,6574,793,127575529,America,232538,23377
2020-06-25,Mexico,MX,6264,965,127575529,America,238802,24342
2020-06-26,Mexico,MX,6231,718,127575529,America,245033,25060
2020-06-27,Mexico,MX,6469,719,127575529,America,251502,25779
2020-06-28,Mexico,MX,3629,602,127575529,America,255131,26381
2020-06-29,Mexico,MX,2917,267,127575529,America,258048,26648
2020-06-30,Mexico,MX,7462,473,127575529,America,265510,27121
2020-07-01,Mexico,MX,7143,648,127575529,America,272653,27769
2020-07-02,Mexico,MX,7543,741,127575529,America,280196,28510
2020-07-03,Mexico,MX,7000,679,127575529,America,287196,29189
2020-07-04,Mexico,MX,7016,654,127575529,America,294212,29843
2020-07-05,Mexico,MX,3623,523,127575529,America,297835,30366
2020-07-06,Mexico,MX,2953,273,127575529,America,300788,30639
2020-07-07,Mexico,MX,7786,480,127575529,America,308574,31119
2020-07-08,Mexico,MX,7827,895,127575529,America,316401,32014
2020-07-09,Mexico,MX,7401,782,127575529,America,323802,32796
2020-07-10,Mexico,MX,7094,730,127575529,America,330896,33526
2020-07-11,Mexico,MX,7150,665,127575529,America,338046,34191
2020-07-12,Mexico,MX,3819,539,127575529,America,341865,34730
2020-07-13,Mexico,MX,3176,276,127575529,America,345041,35006
2020-07-14,Mexico,MX,8792,443,127575529,America,353833,35449
2020-07-15,Mexico,MX,8412,878,127575529,America,362245,36327
2020-07-16,Mexico,MX,8738,579,127575529,America,370983,36906
2020-07-17,Mexico,MX,8179,668,127575529,America,379162,37574
2020-07-18,Mexico,MX,7891,736,127575529,America,387053,38310
2020-07-19,Mexico,MX,4344,578,127575529,America,391397,38888
2020-07-20,Mexico,MX,3389,296,127575529,America,394786,39184
2020-07-21,Mexico,MX,9044,301,127575529,America,403830,39485
2020-07-22,Mexico,MX,8610,915,127575529,America,412440,40400
2020-07-23,Mexico,MX,8276,790,127575529,America,420716,41190
2020-07-24,Mexico,MX,7988,718,127575529,America,428704,41908
2020-07-25,Mexico,MX,7949,737,127575529,America,436653,42645
2020-07-26,Mexico,MX,4113,729,127575529,America,440766,43374
2020-07-27,Mexico,MX,2965,306,127575529,America,443731,43680
2020-07-28,Mexico,MX,8413,342,127575529,America,452144,44022
2020-07-29,Mexico,MX,8110,854,127575529,America,460254,44876
2020-07-30,Mexico,MX,7617,485,127575529,America,467871,45361
2020-07-31,Mexico,MX,7524,639,127575529,America,475395,46000
2020-08-01,Mexico,MX,6660,688,127575529,America,482055,46688
2020-08-02,Mexico,MX,3721,784,127575529,America,485776,47472
2020-08-03,Mexico,MX,2474,274,127575529,America,488250,47746
2020-08-04,Mexico,MX,7430,266,127575529,America,495680,48012
2020-08-05,Mexico,MX,7286,857,127575529,America,502966,48869
2020-08-06,Mexico,MX,7071,829,127575529,America,510037,49698
2020-08-07,Mexico,MX,6617,819,127575529,America,516654,50517
2020-08-08,Mexico,MX,6539,794,127575529,America,523193,51311
2020-08-09,Mexico,MX,3616,695,127575529,America,526809,52006
2020-08-10,Mexico,MX,2377,292,127575529,America,529186,52298
2020-08-11,Mexico,MX,7086,705,127575529,America,536272,53003
2020-08-12,Mexico,MX,6783,926,127575529,America,543055,53929
2020-08-13,Mexico,MX,6306,737,127575529,America,549361,54666
2020-08-14,Mexico,MX,6249,627,127575529,America,555610,55293
2020-08-15,Mexico,MX,6049,615,127575529,America,561659,55908
2020-08-16,Mexico,MX,3144,635,127575529,America,564803,56543
2020-08-17,Mexico,MX,2263,214,127575529,America,567066,56757
2020-08-18,Mexico,MX,6709,266,127575529,America,573775,57023
2020-08-19,Mexico,MX,6561,751,127575529,America,580336,57774
2020-08-20,Mexico,MX,6148,707,127575529,America,586484,58481
2020-08-21,Mexico,MX,5839,625,127575529,America,592323,59106
2020-08-22,Mexico,MX,6118,504,127575529,America,598441,59610
2020-08-23,Mexico,MX,3028,644,127575529,America,601469,60254
2020-08-24,Mexico,MX,2270,226,127575529,America,603739,60480
2020-08-25,Mexico,MX,6851,320,127575529,America,610590,60800
2020-08-26,Mexico,MX,6403,650,127575529,America,616993,61450
2020-08-27,Mexico,MX,6854,626,127575529,America,623847,62076
2020-08-28,Mexico,MX,6248,518,127575529,America,630095,62594
2020-08-29,Mexico,MX,6206,552,127575529,America,636301,63146
2020-08-30,Mexico,MX,3017,673,127575529,America,639318,63819
2020-08-31,Mexico,MX,2124,339,127575529,America,641442,64158
2020-09-01,Mexico,MX,6729,256,127575529,America,648171,64414
2020-09-02,Mexico,MX,6936,827,127575529,America,655107,65241
2020-09-03,Mexico,MX,6758,575,127575529,America,661865,65816
2020-09-04,Mexico,MX,6148,513,127575529,America,668013,66329
2020-09-05,Mexico,MX,5893,522,127575529,America,673906,66851
2020-09-06,Mexico,MX,2749,703,127575529,America,676655,67554
2020-09-07,Mexico,MX,1980,4,127575529,America,678635,67558
2020-09-08,Mexico,MX,6188,223,127575529,America,684823,67781
2020-09-09,Mexico,MX,6403,703,127575529,America,691226,68484
2020-09-10,Mexico,MX,5882,611,127575529,America,697108,69095
2020-09-11,Mexico,MX,5482,554,127575529,America,702590,69649
2020-09-12,Mexico,MX,5308,534,127575529,America,707898,70183
2020-09-13,Mexico,MX,2669,421,127575529,America,710567,70604
2020-09-14,Mexico,MX,1803,217,127575529,America,712370,70821
2020-09-15,Mexico,MX,5985,228,127575529,America,718355,71049
2020-09-16,Mexico,MX,4098,629,127575529,America,722453,71678
2020-09-17,Mexico,MX,2082,300,127575529,America,724535,71978
2020-09-18,Mexico,MX,6000,201,127575529,America,730535,72179
2020-09-19,Mexico,MX,5551,624,127575529,America,736086,72803
2020-09-20,Mexico,MX,2658,455,127575529,America,738744,73258
2020-09-21,Mexico,MX,1701,235,127575529,America,740445,73493
2020-09-22,Mexico,MX,6031,204,127575529,America,746476,73697
2020-09-23,Mexico,MX,5939,651,127575529,America,752415,74348
2020-09-24,Mexico,MX,5495,601,127575529,America,757910,74949
2020-09-25,Mexico,MX,5156,490,127575529,America,763066,75439
2020-09-26,Mexico,MX,5079,405,127575529,America,768145,75844
2020-09-27,Mexico,MX,2535,399,127575529,America,770680,76243
2020-09-28,Mexico,MX,1701,187,127575529,America,772381,76430
2020-09-29,Mexico,MX,5952,173,127575529,America,778333,76603
2020-09-30,Mexico,MX,5741,560,127575529,America,784074,77163
2020-10-01,Mexico,MX,5212,483,127575529,America,789286,77646
2020-10-02,Mexico,MX,4955,432,127575529,America,794241,78078
2020-10-03,Mexico,MX,4699,414,127575529,America,798940,78492
2020-10-04,Mexico,MX,2266,388,127575529,America,801206,78880
2020-10-05,Mexico,MX,1580,208,127575529,America,802786,79088
2020-10-06,Mexico,MX,5247,180,127575529,America,808033,79268
2020-10-07,Mexico,MX,5405,446,127575529,America,813438,79714
2020-10-08,Mexico,MX,5175,369,127575529,America,818613,80083
2020-10-09,Mexico,MX,4936,3013,127575529,America,823549,83096
2020-10-10,Mexico,MX,5009,411,127575529,America,828558,83507
2020-10-11,Mexico,MX,2435,135,127575529,America,830993,83642
2020-10-12,Mexico,MX,1750,0,127575529,America,832743,83642
2020-10-13,Mexico,MX,5326,303,127575529,America,838069,83945
2020-10-14,Mexico,MX,4548,475,127575529,America,842617,84420
2020-10-15,Mexico,MX,2640,478,127575529,America,845257,84898
2020-10-16,Mexico,MX,1470,387,127575529,America,846727,85285
2020-10-17,Mexico,MX,380,419,127575529,America,847107,85704
2020-10-18,Mexico,MX,2800,355,127575529,America,849907,86059
2020-10-19,Mexico,MX,1320,108,127575529,America,851227,86167
2020-10-20,Mexico,MX,3699,171,127575529,America,854926,86338
2020-10-21,Mexico,MX,5788,555,127575529,America,860714,86893
2020-10-22,Mexico,MX,6845,522,127575529,America,867559,87415
2020-10-23,Mexico,MX,6612,479,127575529,America,874171,87894
2020-10-24,Mexico,MX,6604,418,127575529,America,880775,88312
2020-10-25,Mexico,MX,6025,431,127575529,America,886800,88743
2020-10-26,Mexico,MX,4360,181,127575529,America,891160,88924
2020-10-27,Mexico,MX,4166,247,127575529,America,895326,89171
2020-10-28,Mexico,MX,5942,643,127575529,America,901268,89814
2020-10-29,Mexico,MX,5595,495,127575529,America,906863,90309
2020-10-30,Mexico,MX,5948,464,127575529,America,912811,90773
2020-10-31,Mexico,MX,6000,516,127575529,America,918811,91289
2020-11-01,Mexico,MX,6151,464,127575529,America,924962,91753
2020-11-02,Mexico,MX,4430,142,127575529,America,929392,91895
2020-11-03,Mexico,MX,3763,205,127575529,America,933155,92100
2020-11-04,Mexico,MX,5250,493,127575529,America,938405,92593
2020-11-05,Mexico,MX,5225,635,127575529,America,943630,93228
2020-11-06,Mexico,MX,5567,544,127575529,America,949197,93772
2020-11-07,Mexico,MX,5931,551,127575529,America,955128,94323
2020-11-08,Mexico,MX,6810,485,127575529,America,961938,94808
2020-11-09,Mexico,MX,5887,219,127575529,America,967825,95027
2020-11-10,Mexico,MX,4960,198,127575529,America,972785,95225
2020-11-11,Mexico,MX,5746,617,127575529,America,978531,95842
2020-11-12,Mexico,MX,7646,588,127575529,America,986177,96430
2020-11-13,Mexico,MX,5658,626,127575529,America,991835,97056
2020-11-14,Mexico,MX,5558,568,127575529,America,997393,97624
2020-11-15,Mexico,MX,5860,635,127575529,America,1003253,98259
2020-11-16,Mexico,MX,3269,283,127575529,America,1006522,98542
2020-11-17,Mexico,MX,2874,319,127575529,America,1009396,98861
2020-11-18,Mexico,MX,1757,165,127575529,America,1011153,99026
2020-11-19,Mexico,MX,3918,502,127575529,America,1015071,99528
2020-11-20,Mexico,MX,4472,576,127575529,America,1019543,100104
2020-11-21,Mexico,MX,6426,719,127575529,America,1025969,100823
2020-11-22,Mexico,MX,6719,550,127575529,America,1032688,101373
2020-11-23,Mexico,MX,9187,303,127575529,America,1041875,101676
2020-11-24,Mexico,MX,7483,250,127575529,America,1049358,101926
2020-11-25,Mexico,MX,10794,813,127575529,America,1060152,102739
2020-11-26,Mexico,MX,10335,858,127575529,America,1070487,103597
2020-11-27,Mexico,MX,8107,645,127575529,America,1078594,104242
2020-11-28,Mexico,MX,0,0,127575529,America,1078594,104242
2020-11-29,Mexico,MX,22089,1217,127575529,America,1100683,105459
2020-11-30,Mexico,MX,6388,196,127575529,America,1107071,105655
2020-12-01,Mexico,MX,6472,285,127575529,America,1113543,105940
2020-12-02,Mexico,MX,8819,825,127575529,America,1122362,106765
2020-12-03,Mexico,MX,11251,800,127575529,America,1133613,107565
2020-12-04,Mexico,MX,11030,608,127575529,America,1144643,108173
2020-12-05,Mexico,MX,12127,690,127575529,America,1156770,108863
2020-12-06,Mexico,MX,11625,593,127575529,America,1168395,109456
2020-12-07,Mexico,MX,7455,261,127575529,America,1175850,109717
2020-12-08,Mexico,MX,6399,357,127575529,America,1182249,110074
2020-12-09,Mexico,MX,1006,800,127575529,America,1183255,110874
2020-12-10,Mexico,MX,21974,781,127575529,America,1205229,111655
2020-12-11,Mexico,MX,11897,671,127575529,America,1217126,112326
2020-12-12,Mexico,MX,12253,693,127575529,America,1229379,113019
2020-12-13,Mexico,MX,12057,685,127575529,America,1241436,113704
2020-12-14,Mexico,MX,8608,249,127575529,America,1250044,113953
2019-12-31,Malaysia,MY,0,0,31949789,Asia,0,0
2020-01-01,Malaysia,MY,0,0,31949789,Asia,0,0
2020-01-02,Malaysia,MY,0,0,31949789,Asia,0,0
2020-01-03,Malaysia,MY,0,0,31949789,Asia,0,0
2020-01-04,Malaysia,MY,0,0,31949789,Asia,0,0
2020-01-05,Malaysia,MY,0,0,31949789,Asia,0,0
2020-01-06,Malaysia,MY,0,0,31949789,Asia,0,0
2020-01-07,Malaysia,MY,0,0,31949789,Asia,0,0
2020-01-08,Malaysia,MY,0,0,31949789,Asia,0,0
2020-01-09,Malaysia,MY,0,0,31949789,Asia,0,0
2020-01-10,Malaysia,MY,0,0,31949789,Asia,0,0
2020-01-11,Malaysia,MY,0,0,31949789,Asia,0,0
2020-01-12,Malaysia,MY,0,0,31949789,Asia,0,0
2020-01-13,Malaysia,MY,0,0,31949789,Asia,0,0
2020-01-14,Malaysia,MY,0,0,31949789,Asia,0,0
2020-01-15,Malaysia,MY,0,0,31949789,Asia,0,0
2020-01-16,Malaysia,MY,0,0,31949789,Asia,0,0
2020-01-17,Malaysia,MY,0,0,31949789,Asia,0,0
2020-01-18,Malaysia,MY,0,0,31949789,Asia,0,0
2020-01-19,Malaysia,MY,0,0,31949789,Asia,0,0
2020-01-20,Malaysia,MY,0,0,31949789,Asia,0,0
2020-01-21,Malaysia,MY,0,0,31949789,Asia,0,0
2020-01-22,Malaysia,MY,0,0,31949789,Asia,0,0
2020-01-23,Malaysia,MY,0,0,31949789,Asia,0,0
2020-01-24,Malaysia,MY,0,0,31949789,Asia,0,0
2020-01-25,Malaysia,MY,3,0,31949789,Asia,3,0
2020-01-26,Malaysia,MY,1,0,31949789,Asia,4,0
2020-01-27,Malaysia,MY,0,0,31949789,Asia,4,0
2020-01-28,Malaysia,MY,0,0,31949789,Asia,4,0
2020-01-29,Malaysia,MY,3,0,31949789,Asia,7,0
2020-01-30,Malaysia,MY,0,0,31949789,Asia,7,0
2020-01-31,Malaysia,MY,1,0,31949789,Asia,8,0
2020-02-01,Malaysia,MY,0,0,31949789,Asia,8,0
2020-02-02,Malaysia,MY,0,0,31949789,Asia,8,0
2020-02-03,Malaysia,MY,0,0,31949789,Asia,8,0
2020-02-04,Malaysia,MY,0,0,31949789,Asia,8,0
2020-02-05,Malaysia,MY,2,0,31949789,Asia,10,0
2020-02-06,Malaysia,MY,2,0,31949789,Asia,12,0
2020-02-07,Malaysia,MY,2,0,31949789,Asia,14,0
2020-02-08,Malaysia,MY,1,0,31949789,Asia,15,0
2020-02-09,Malaysia,MY,1,0,31949789,Asia,16,0
2020-02-10,Malaysia,MY,2,0,31949789,Asia,18,0
2020-02-11,Malaysia,MY,0,0,31949789,Asia,18,0
2020-02-12,Malaysia,MY,0,0,31949789,Asia,18,0
2020-02-13,Malaysia,MY,0,0,31949789,Asia,18,0
2020-02-14,Malaysia,MY,1,0,31949789,Asia,19,0
2020-02-15,Malaysia,MY,2,0,31949789,Asia,21,0
2020-02-16,Malaysia,MY,1,0,31949789,Asia,22,0
2020-02-17,Malaysia,MY,0,0,31949789,Asia,22,0
2020-02-18,Malaysia,MY,0,0,31949789,Asia,22,0
2020-02-19,Malaysia,MY,0,0,31949789,Asia,22,0
2020-02-20,Malaysia,MY,0,0,31949789,Asia,22,0
2020-02-21,Malaysia,MY,0,0,31949789,Asia,22,0
2020-02-22,Malaysia,MY,0,0,31949789,Asia,22,0
2020-02-23,Malaysia,MY,0,0,31949789,Asia,22,0
2020-02-24,Malaysia,MY,0,0,31949789,Asia,22,0
2020-02-25,Malaysia,MY,0,0,31949789,Asia,22,0
2020-02-26,Malaysia,MY,0,0,31949789,Asia,22,0
2020-02-27,Malaysia,MY,0,0,31949789,Asia,22,0
2020-02-28,Malaysia,MY,1,0,31949789,Asia,23,0
2020-02-29,Malaysia,MY,2,0,31949789,Asia,25,0
2020-03-01,Malaysia,MY,0,0,31949789,Asia,25,0
2020-03-02,Malaysia,MY,4,0,31949789,Asia,29,0
2020-03-04,Malaysia,MY,7,0,31949789,Asia,36,0
2020-03-05,Malaysia,MY,14,0,31949789,Asia,50,0
2020-03-06,Malaysia,MY,0,0,31949789,Asia,50,0
2020-03-07,Malaysia,MY,33,0,31949789,Asia,83,0
2020-03-08,Malaysia,MY,10,0,31949789,Asia,93,0
2020-03-09,Malaysia,MY,6,0,31949789,Asia,99,0
2020-03-10,Malaysia,MY,18,0,31949789,Asia,117,0
2020-03-11,Malaysia,MY,12,0,31949789,Asia,129,0
2020-03-12,Malaysia,MY,20,0,31949789,Asia,149,0
2020-03-13,Malaysia,MY,9,0,31949789,Asia,158,0
2020-03-14,Malaysia,MY,39,0,31949789,Asia,197,0
2020-03-15,Malaysia,MY,41,0,31949789,Asia,238,0
2020-03-16,Malaysia,MY,190,0,31949789,Asia,428,0
2020-03-17,Malaysia,MY,125,0,31949789,Asia,553,0
2020-03-18,Malaysia,MY,120,2,31949789,Asia,673,2
2020-03-19,Malaysia,MY,117,0,31949789,Asia,790,2
2020-03-20,Malaysia,MY,110,0,31949789,Asia,900,2
2020-03-21,Malaysia,MY,130,0,31949789,Asia,1030,2
2020-03-22,Malaysia,MY,153,2,31949789,Asia,1183,4
2020-03-23,Malaysia,MY,123,6,31949789,Asia,1306,10
2020-03-24,Malaysia,MY,212,4,31949789,Asia,1518,14
2020-03-25,Malaysia,MY,106,1,31949789,Asia,1624,15
2020-03-26,Malaysia,MY,172,4,31949789,Asia,1796,19
2020-03-27,Malaysia,MY,235,4,31949789,Asia,2031,23
2020-03-28,Malaysia,MY,130,3,31949789,Asia,2161,26
2020-03-29,Malaysia,MY,159,1,31949789,Asia,2320,27
2020-03-30,Malaysia,MY,150,7,31949789,Asia,2470,34
2020-03-31,Malaysia,MY,156,3,31949789,Asia,2626,37
2020-04-01,Malaysia,MY,140,6,31949789,Asia,2766,43
2020-04-02,Malaysia,MY,142,2,31949789,Asia,2908,45
2020-04-03,Malaysia,MY,208,5,31949789,Asia,3116,50
2020-04-04,Malaysia,MY,217,3,31949789,Asia,3333,53
2020-04-05,Malaysia,MY,150,4,31949789,Asia,3483,57
2020-04-06,Malaysia,MY,179,4,31949789,Asia,3662,61
2020-04-07,Malaysia,MY,131,1,31949789,Asia,3793,62
2020-04-08,Malaysia,MY,170,1,31949789,Asia,3963,63
2020-04-09,Malaysia,MY,156,2,31949789,Asia,4119,65
2020-04-10,Malaysia,MY,109,2,31949789,Asia,4228,67
2020-04-11,Malaysia,MY,118,3,31949789,Asia,4346,70
2020-04-12,Malaysia,MY,184,3,31949789,Asia,4530,73
2020-04-13,Malaysia,MY,153,3,31949789,Asia,4683,76
2020-04-14,Malaysia,MY,134,1,31949789,Asia,4817,77
2020-04-15,Malaysia,MY,170,5,31949789,Asia,4987,82
2020-04-16,Malaysia,MY,85,1,31949789,Asia,5072,83
2020-04-17,Malaysia,MY,110,1,31949789,Asia,5182,84
2020-04-18,Malaysia,MY,69,2,31949789,Asia,5251,86
2020-04-19,Malaysia,MY,54,2,31949789,Asia,5305,88
2020-04-20,Malaysia,MY,84,1,31949789,Asia,5389,89
2020-04-21,Malaysia,MY,36,0,31949789,Asia,5425,89
2020-04-22,Malaysia,MY,57,3,31949789,Asia,5482,92
2020-04-23,Malaysia,MY,50,1,31949789,Asia,5532,93
2020-04-24,Malaysia,MY,71,2,31949789,Asia,5603,95
2020-04-25,Malaysia,MY,88,1,31949789,Asia,5691,96
2020-04-26,Malaysia,MY,51,2,31949789,Asia,5742,98
2020-04-27,Malaysia,MY,38,0,31949789,Asia,5780,98
2020-04-28,Malaysia,MY,40,1,31949789,Asia,5820,99
2020-04-29,Malaysia,MY,31,1,31949789,Asia,5851,100
2020-04-30,Malaysia,MY,94,0,31949789,Asia,5945,100
2020-05-01,Malaysia,MY,57,2,31949789,Asia,6002,102
2020-05-02,Malaysia,MY,69,1,31949789,Asia,6071,103
2020-05-03,Malaysia,MY,105,0,31949789,Asia,6176,103
2020-05-04,Malaysia,MY,122,2,31949789,Asia,6298,105
2020-05-05,Malaysia,MY,55,0,31949789,Asia,6353,105
2020-05-06,Malaysia,MY,30,1,31949789,Asia,6383,106
2020-05-07,Malaysia,MY,45,1,31949789,Asia,6428,107
2020-05-08,Malaysia,MY,39,0,31949789,Asia,6467,107
2020-05-09,Malaysia,MY,68,0,31949789,Asia,6535,107
2020-05-10,Malaysia,MY,54,1,31949789,Asia,6589,108
2020-05-11,Malaysia,MY,67,0,31949789,Asia,6656,108
2020-05-12,Malaysia,MY,70,1,31949789,Asia,6726,109
2020-05-13,Malaysia,MY,16,0,31949789,Asia,6742,109
2020-05-14,Malaysia,MY,37,2,31949789,Asia,6779,111
2020-05-15,Malaysia,MY,40,1,31949789,Asia,6819,112
2020-05-16,Malaysia,MY,36,0,31949789,Asia,6855,112
2020-05-17,Malaysia,MY,17,1,31949789,Asia,6872,113
2020-05-18,Malaysia,MY,22,0,31949789,Asia,6894,113
2020-05-19,Malaysia,MY,47,0,31949789,Asia,6941,113
2020-05-20,Malaysia,MY,37,1,31949789,Asia,6978,114
2020-05-21,Malaysia,MY,31,0,31949789,Asia,7009,114
2020-05-22,Malaysia,MY,50,0,31949789,Asia,7059,114
2020-05-23,Malaysia,MY,78,1,31949789,Asia,7137,115
2020-05-24,Malaysia,MY,48,0,31949789,Asia,7185,115
2020-05-25,Malaysia,MY,60,0,31949789,Asia,7245,115
2020-05-26,Malaysia,MY,172,0,31949789,Asia,7417,115
2020-05-27,Malaysia,MY,187,0,31949789,Asia,7604,115
2020-05-28,Malaysia,MY,15,0,31949789,Asia,7619,115
2020-05-29,Malaysia,MY,10,0,31949789,Asia,7629,115
2020-05-30,Malaysia,MY,103,0,31949789,Asia,7732,115
2020-05-31,Malaysia,MY,30,0,31949789,Asia,7762,115
2020-06-01,Malaysia,MY,57,0,31949789,Asia,7819,115
2020-06-02,Malaysia,MY,38,0,31949789,Asia,7857,115
2020-06-03,Malaysia,MY,20,0,31949789,Asia,7877,115
2020-06-04,Malaysia,MY,93,0,31949789,Asia,7970,115
2020-06-05,Malaysia,MY,0,0,31949789,Asia,7970,115
2020-06-06,Malaysia,MY,296,1,31949789,Asia,8266,116
2020-06-07,Malaysia,MY,37,1,31949789,Asia,8303,117
2020-06-08,Malaysia,MY,19,0,31949789,Asia,8322,117
2020-06-09,Malaysia,MY,7,0,31949789,Asia,8329,117
2020-06-10,Malaysia,MY,7,0,31949789,Asia,8336,117
2020-06-11,Malaysia,MY,2,1,31949789,Asia,8338,118
2020-06-12,Malaysia,MY,31,0,31949789,Asia,8369,118
2020-06-13,Malaysia,MY,33,1,31949789,Asia,8402,119
2020-06-14,Malaysia,MY,43,1,31949789,Asia,8445,120
2020-06-15,Malaysia,MY,8,1,31949789,Asia,8453,121
2020-06-16,Malaysia,MY,41,0,31949789,Asia,8494,121
2020-06-17,Malaysia,MY,11,0,31949789,Asia,8505,121
2020-06-18,Malaysia,MY,10,0,31949789,Asia,8515,121
2020-06-19,Malaysia,MY,14,0,31949789,Asia,8529,121
2020-06-20,Malaysia,MY,6,0,31949789,Asia,8535,121
2020-06-21,Malaysia,MY,21,0,31949789,Asia,8556,121
2020-06-22,Malaysia,MY,16,0,31949789,Asia,8572,121
2020-06-23,Malaysia,MY,15,0,31949789,Asia,8587,121
2020-06-24,Malaysia,MY,3,0,31949789,Asia,8590,121
2020-06-25,Malaysia,MY,6,0,31949789,Asia,8596,121
2020-06-26,Malaysia,MY,4,0,31949789,Asia,8600,121
2020-06-27,Malaysia,MY,6,0,31949789,Asia,8606,121
2020-06-28,Malaysia,MY,10,0,31949789,Asia,8616,121
2020-06-29,Malaysia,MY,18,0,31949789,Asia,8634,121
2020-06-30,Malaysia,MY,3,0,31949789,Asia,8637,121
2020-07-01,Malaysia,MY,2,0,31949789,Asia,8639,121
2020-07-02,Malaysia,MY,1,0,31949789,Asia,8640,121
2020-07-03,Malaysia,MY,3,0,31949789,Asia,8643,121
2020-07-04,Malaysia,MY,5,0,31949789,Asia,8648,121
2020-07-05,Malaysia,MY,10,0,31949789,Asia,8658,121
2020-07-06,Malaysia,MY,0,0,31949789,Asia,8658,121
2020-07-07,Malaysia,MY,10,0,31949789,Asia,8668,121
2020-07-08,Malaysia,MY,6,0,31949789,Asia,8674,121
2020-07-09,Malaysia,MY,3,0,31949789,Asia,8677,121
2020-07-10,Malaysia,MY,6,0,31949789,Asia,8683,121
2020-07-11,Malaysia,MY,13,0,31949789,Asia,8696,121
2020-07-12,Malaysia,MY,8,1,31949789,Asia,8704,122
2020-07-13,Malaysia,MY,14,0,31949789,Asia,8718,122
2020-07-14,Malaysia,MY,7,0,31949789,Asia,8725,122
2020-07-15,Malaysia,MY,4,0,31949789,Asia,8729,122
2020-07-16,Malaysia,MY,5,0,31949789,Asia,8734,122
2020-07-17,Malaysia,MY,3,0,31949789,Asia,8737,122
2020-07-18,Malaysia,MY,18,0,31949789,Asia,8755,122
2020-07-19,Malaysia,MY,9,0,31949789,Asia,8764,122
2020-07-20,Malaysia,MY,15,1,31949789,Asia,8779,123
2020-07-21,Malaysia,MY,21,0,31949789,Asia,8800,123
2020-07-22,Malaysia,MY,15,0,31949789,Asia,8815,123
2020-07-23,Malaysia,MY,16,0,31949789,Asia,8831,123
2020-07-24,Malaysia,MY,9,0,31949789,Asia,8840,123
2020-07-25,Malaysia,MY,21,0,31949789,Asia,8861,123
2020-07-26,Malaysia,MY,23,0,31949789,Asia,8884,123
2020-07-27,Malaysia,MY,13,1,31949789,Asia,8897,124
2020-07-28,Malaysia,MY,7,0,31949789,Asia,8904,124
2020-07-29,Malaysia,MY,39,0,31949789,Asia,8943,124
2020-07-30,Malaysia,MY,13,0,31949789,Asia,8956,124
2020-07-31,Malaysia,MY,8,0,31949789,Asia,8964,124
2020-08-01,Malaysia,MY,12,1,31949789,Asia,8976,125
2020-08-02,Malaysia,MY,9,0,31949789,Asia,8985,125
2020-08-03,Malaysia,MY,14,0,31949789,Asia,8999,125
2020-08-04,Malaysia,MY,2,0,31949789,Asia,9001,125
2020-08-05,Malaysia,MY,1,0,31949789,Asia,9002,125
2020-08-06,Malaysia,MY,21,0,31949789,Asia,9023,125
2020-08-07,Malaysia,MY,15,0,31949789,Asia,9038,125
2020-08-08,Malaysia,MY,25,0,31949789,Asia,9063,125
2020-08-09,Malaysia,MY,7,0,31949789,Asia,9070,125
2020-08-10,Malaysia,MY,13,0,31949789,Asia,9083,125
2020-08-11,Malaysia,MY,11,0,31949789,Asia,9094,125
2020-08-12,Malaysia,MY,9,0,31949789,Asia,9103,125
2020-08-13,Malaysia,MY,11,0,31949789,Asia,9114,125
2020-08-14,Malaysia,MY,15,0,31949789,Asia,9129,125
2020-08-15,Malaysia,MY,20,0,31949789,Asia,9149,125
2020-08-16,Malaysia,MY,26,0,31949789,Asia,9175,125
2020-08-17,Malaysia,MY,25,0,31949789,Asia,9200,125
2020-08-18,Malaysia,MY,12,0,31949789,Asia,9212,125
2020-08-19,Malaysia,MY,7,0,31949789,Asia,9219,125
2020-08-20,Malaysia,MY,16,0,31949789,Asia,9235,125
2020-08-21,Malaysia,MY,5,0,31949789,Asia,9240,125
2020-08-22,Malaysia,MY,9,0,31949789,Asia,9249,125
2020-08-23,Malaysia,MY,8,0,31949789,Asia,9257,125
2020-08-24,Malaysia,MY,10,0,31949789,Asia,9267,125
2020-08-25,Malaysia,MY,7,0,31949789,Asia,9274,125
2020-08-26,Malaysia,MY,11,0,31949789,Asia,9285,125
2020-08-27,Malaysia,MY,6,0,31949789,Asia,9291,125
2020-08-28,Malaysia,MY,5,0,31949789,Asia,9296,125
2020-08-29,Malaysia,MY,10,0,31949789,Asia,9306,125
2020-08-30,Malaysia,MY,11,0,31949789,Asia,9317,125
2020-08-31,Malaysia,MY,17,1,31949789,Asia,9334,126
2020-09-01,Malaysia,MY,6,1,31949789,Asia,9340,127
2020-09-02,Malaysia,MY,14,1,31949789,Asia,9354,128
2020-09-03,Malaysia,MY,6,0,31949789,Asia,9360,128
2020-09-04,Malaysia,MY,14,0,31949789,Asia,9374,128
2020-09-05,Malaysia,MY,0,0,31949789,Asia,9374,128
2020-09-06,Malaysia,MY,17,0,31949789,Asia,9391,128
2020-09-07,Malaysia,MY,6,0,31949789,Asia,9397,128
2020-09-08,Malaysia,MY,62,0,31949789,Asia,9459,128
2020-09-09,Malaysia,MY,100,0,31949789,Asia,9559,128
2020-09-10,Malaysia,MY,24,0,31949789,Asia,9583,128
2020-09-11,Malaysia,MY,45,0,31949789,Asia,9628,128
2020-09-12,Malaysia,MY,182,0,31949789,Asia,9810,128
2020-09-13,Malaysia,MY,58,0,31949789,Asia,9868,128
2020-09-14,Malaysia,MY,47,0,31949789,Asia,9915,128
2020-09-15,Malaysia,MY,31,0,31949789,Asia,9946,128
2020-09-16,Malaysia,MY,23,0,31949789,Asia,9969,128
2020-09-17,Malaysia,MY,62,0,31949789,Asia,10031,128
2020-09-18,Malaysia,MY,21,0,31949789,Asia,10052,128
2020-09-19,Malaysia,MY,95,1,31949789,Asia,10147,129
2020-09-20,Malaysia,MY,20,1,31949789,Asia,10167,130
2020-09-21,Malaysia,MY,52,0,31949789,Asia,10219,130
2020-09-22,Malaysia,MY,57,0,31949789,Asia,10276,130
2020-09-23,Malaysia,MY,82,0,31949789,Asia,10358,130
2020-09-24,Malaysia,MY,147,3,31949789,Asia,10505,133
2020-09-25,Malaysia,MY,71,0,31949789,Asia,10576,133
2020-09-26,Malaysia,MY,0,0,31949789,Asia,10576,133
2020-09-27,Malaysia,MY,193,0,31949789,Asia,10769,133
2020-09-28,Malaysia,MY,150,1,31949789,Asia,10919,134
2020-09-29,Malaysia,MY,115,0,31949789,Asia,11034,134
2020-09-30,Malaysia,MY,101,0,31949789,Asia,11135,134
2020-10-01,Malaysia,MY,0,0,31949789,Asia,11135,134
2020-10-02,Malaysia,MY,349,2,31949789,Asia,11484,136
2020-10-03,Malaysia,MY,287,0,31949789,Asia,11771,136
2020-10-04,Malaysia,MY,317,1,31949789,Asia,12088,137
2020-10-05,Malaysia,MY,293,0,31949789,Asia,12381,137
2020-10-06,Malaysia,MY,432,0,31949789,Asia,12813,137
2020-10-07,Malaysia,MY,691,4,31949789,Asia,13504,141
2020-10-08,Malaysia,MY,489,0,31949789,Asia,13993,141
2020-10-09,Malaysia,MY,375,5,31949789,Asia,14368,146
2020-10-10,Malaysia,MY,354,6,31949789,Asia,14722,152
2020-10-11,Malaysia,MY,374,3,31949789,Asia,15096,155
2020-10-12,Malaysia,MY,561,2,31949789,Asia,15657,157
2020-10-13,Malaysia,MY,563,2,31949789,Asia,16220,159
2020-10-14,Malaysia,MY,660,4,31949789,Asia,16880,163
2020-10-15,Malaysia,MY,660,4,31949789,Asia,17540,167
2020-10-16,Malaysia,MY,589,3,31949789,Asia,18129,170
2020-10-17,Malaysia,MY,629,6,31949789,Asia,18758,176
2020-10-18,Malaysia,MY,869,4,31949789,Asia,19627,180
2020-10-19,Malaysia,MY,871,7,31949789,Asia,20498,187
2020-10-20,Malaysia,MY,865,3,31949789,Asia,21363,190
2020-10-21,Malaysia,MY,862,3,31949789,Asia,22225,193
2020-10-22,Malaysia,MY,732,6,31949789,Asia,22957,199
2020-10-23,Malaysia,MY,847,5,31949789,Asia,23804,204
2020-10-24,Malaysia,MY,710,10,31949789,Asia,24514,214
2020-10-25,Malaysia,MY,1228,7,31949789,Asia,25742,221
2020-10-26,Malaysia,MY,823,8,31949789,Asia,26565,229
2020-10-27,Malaysia,MY,1240,7,31949789,Asia,27805,236
2020-10-28,Malaysia,MY,835,2,31949789,Asia,28640,238
2020-10-29,Malaysia,MY,771,8,31949789,Asia,29411,246
2020-10-30,Malaysia,MY,679,0,31949789,Asia,30090,246
2020-10-31,Malaysia,MY,809,3,31949789,Asia,30899,249
2020-11-01,Malaysia,MY,649,0,31949789,Asia,31548,249
2020-11-02,Malaysia,MY,957,0,31949789,Asia,32505,249
2020-11-03,Malaysia,MY,834,2,31949789,Asia,33339,251
2020-11-04,Malaysia,MY,1054,12,31949789,Asia,34393,263
2020-11-05,Malaysia,MY,1032,8,31949789,Asia,35425,271
2020-11-06,Malaysia,MY,1009,6,31949789,Asia,36434,277
2020-11-07,Malaysia,MY,1755,2,31949789,Asia,38189,279
2020-11-08,Malaysia,MY,1168,3,31949789,Asia,39357,282
2020-11-09,Malaysia,MY,852,4,31949789,Asia,40209,286
2020-11-10,Malaysia,MY,972,8,31949789,Asia,41181,294
2020-11-11,Malaysia,MY,869,6,31949789,Asia,42050,300
2020-11-12,Malaysia,MY,822,2,31949789,Asia,42872,302
2020-11-13,Malaysia,MY,919,1,31949789,Asia,43791,303
2020-11-14,Malaysia,MY,1304,1,31949789,Asia,45095,304
2020-11-15,Malaysia,MY,1114,2,31949789,Asia,46209,306
2020-11-16,Malaysia,MY,1208,3,31949789,Asia,47417,309
2020-11-17,Malaysia,MY,1103,4,31949789,Asia,48520,313
2020-11-18,Malaysia,MY,1210,5,31949789,Asia,49730,318
2020-11-19,Malaysia,MY,660,4,31949789,Asia,50390,322
2020-11-20,Malaysia,MY,1290,4,31949789,Asia,51680,326
2020-11-21,Malaysia,MY,958,3,31949789,Asia,52638,329
2020-11-22,Malaysia,MY,1041,3,31949789,Asia,53679,332
2020-11-23,Malaysia,MY,1096,3,31949789,Asia,54775,335
2020-11-24,Malaysia,MY,1884,2,31949789,Asia,56659,337
2020-11-25,Malaysia,MY,2188,4,31949789,Asia,58847,341
2020-11-26,Malaysia,MY,970,4,31949789,Asia,59817,345
2020-11-27,Malaysia,MY,935,3,31949789,Asia,60752,348
2020-11-28,Malaysia,MY,1109,2,31949789,Asia,61861,350
2020-11-29,Malaysia,MY,1315,0,31949789,Asia,63176,350
2020-11-30,Malaysia,MY,1309,7,31949789,Asia,64485,357
2020-12-01,Malaysia,MY,1212,3,31949789,Asia,65697,360
2020-12-02,Malaysia,MY,1472,3,31949789,Asia,67169,363
2020-12-03,Malaysia,MY,851,2,31949789,Asia,68020,365
2020-12-04,Malaysia,MY,1075,11,31949789,Asia,69095,376
2020-12-05,Malaysia,MY,1141,0,31949789,Asia,70236,376
2020-12-06,Malaysia,MY,1123,4,31949789,Asia,71359,380
2020-12-07,Malaysia,MY,1335,2,31949789,Asia,72694,382
2020-12-08,Malaysia,MY,1600,2,31949789,Asia,74294,384
2020-12-09,Malaysia,MY,1012,4,31949789,Asia,75306,388
2020-12-10,Malaysia,MY,959,5,31949789,Asia,76265,393
2020-12-11,Malaysia,MY,2234,3,31949789,Asia,78499,396
2020-12-12,Malaysia,MY,1810,6,31949789,Asia,80309,402
2020-12-13,Malaysia,MY,1937,9,31949789,Asia,82246,411
2020-12-14,Malaysia,MY,1229,4,31949789,Asia,83475,415
2020-03-23,Mozambique,MZ,1,0,30366043,Africa,1,0
2020-03-24,Mozambique,MZ,0,0,30366043,Africa,1,0
2020-03-25,Mozambique,MZ,0,0,30366043,Africa,1,0
2020-03-26,Mozambique,MZ,4,0,30366043,Africa,5,0
2020-03-27,Mozambique,MZ,2,0,30366043,Africa,7,0
2020-03-28,Mozambique,MZ,0,0,30366043,Africa,7,0
2020-03-29,Mozambique,MZ,1,0,30366043,Africa,8,0
2020-03-30,Mozambique,MZ,0,0,30366043,Africa,8,0
2020-03-31,Mozambique,MZ,0,0,30366043,Africa,8,0
2020-04-01,Mozambique,MZ,0,0,30366043,Africa,8,0
2020-04-02,Mozambique,MZ,2,0,30366043,Africa,10,0
2020-04-03,Mozambique,MZ,0,0,30366043,Africa,10,0
2020-04-04,Mozambique,MZ,0,0,30366043,Africa,10,0
2020-04-05,Mozambique,MZ,0,0,30366043,Africa,10,0
2020-04-06,Mozambique,MZ,0,0,30366043,Africa,10,0
2020-04-07,Mozambique,MZ,0,0,30366043,Africa,10,0
2020-04-08,Mozambique,MZ,0,0,30366043,Africa,10,0
2020-04-09,Mozambique,MZ,7,0,30366043,Africa,17,0
2020-04-10,Mozambique,MZ,0,0,30366043,Africa,17,0
2020-04-11,Mozambique,MZ,3,0,30366043,Africa,20,0
2020-04-12,Mozambique,MZ,0,0,30366043,Africa,20,0
2020-04-13,Mozambique,MZ,1,0,30366043,Africa,21,0
2020-04-14,Mozambique,MZ,6,0,30366043,Africa,27,0
2020-04-15,Mozambique,MZ,1,0,30366043,Africa,28,0
2020-04-16,Mozambique,MZ,1,0,30366043,Africa,29,0
2020-04-17,Mozambique,MZ,2,0,30366043,Africa,31,0
2020-04-18,Mozambique,MZ,3,0,30366043,Africa,34,0
2020-04-19,Mozambique,MZ,1,0,30366043,Africa,35,0
2020-04-20,Mozambique,MZ,4,0,30366043,Africa,39,0
2020-04-21,Mozambique,MZ,0,0,30366043,Africa,39,0
2020-04-22,Mozambique,MZ,0,0,30366043,Africa,39,0
2020-04-23,Mozambique,MZ,2,0,30366043,Africa,41,0
2020-04-24,Mozambique,MZ,5,0,30366043,Africa,46,0
2020-04-25,Mozambique,MZ,19,0,30366043,Africa,65,0
2020-04-26,Mozambique,MZ,5,0,30366043,Africa,70,0
2020-04-27,Mozambique,MZ,6,0,30366043,Africa,76,0
2020-04-28,Mozambique,MZ,0,0,30366043,Africa,76,0
2020-04-29,Mozambique,MZ,0,0,30366043,Africa,76,0
2020-04-30,Mozambique,MZ,0,0,30366043,Africa,76,0
2020-05-01,Mozambique,MZ,0,0,30366043,Africa,76,0
2020-05-02,Mozambique,MZ,3,0,30366043,Africa,79,0
2020-05-03,Mozambique,MZ,0,0,30366043,Africa,79,0
2020-05-04,Mozambique,MZ,1,0,30366043,Africa,80,0
2020-05-05,Mozambique,MZ,0,0,30366043,Africa,80,0
2020-05-06,Mozambique,MZ,1,0,30366043,Africa,81,0
2020-05-07,Mozambique,MZ,0,0,30366043,Africa,81,0
2020-05-08,Mozambique,MZ,0,0,30366043,Africa,81,0
2020-05-09,Mozambique,MZ,1,0,30366043,Africa,82,0
2020-05-10,Mozambique,MZ,5,0,30366043,Africa,87,0
2020-05-11,Mozambique,MZ,4,0,30366043,Africa,91,0
2020-05-12,Mozambique,MZ,12,0,30366043,Africa,103,0
2020-05-13,Mozambique,MZ,1,0,30366043,Africa,104,0
2020-05-14,Mozambique,MZ,3,0,30366043,Africa,107,0
2020-05-15,Mozambique,MZ,8,0,30366043,Africa,115,0
2020-05-16,Mozambique,MZ,4,0,30366043,Africa,119,0
2020-05-17,Mozambique,MZ,10,0,30366043,Africa,129,0
2020-05-18,Mozambique,MZ,8,0,30366043,Africa,137,0
2020-05-19,Mozambique,MZ,8,0,30366043,Africa,145,0
2020-05-20,Mozambique,MZ,1,0,30366043,Africa,146,0
2020-05-21,Mozambique,MZ,10,0,30366043,Africa,156,0
2020-05-22,Mozambique,MZ,6,0,30366043,Africa,162,0
2020-05-23,Mozambique,MZ,2,0,30366043,Africa,164,0
2020-05-24,Mozambique,MZ,4,0,30366043,Africa,168,0
2020-05-25,Mozambique,MZ,26,0,30366043,Africa,194,0
2020-05-26,Mozambique,MZ,15,1,30366043,Africa,209,1
2020-05-27,Mozambique,MZ,4,0,30366043,Africa,213,1
2020-05-28,Mozambique,MZ,14,0,30366043,Africa,227,1
2020-05-29,Mozambique,MZ,6,1,30366043,Africa,233,2
2020-05-30,Mozambique,MZ,1,0,30366043,Africa,234,2
2020-05-31,Mozambique,MZ,10,0,30366043,Africa,244,2
2020-06-01,Mozambique,MZ,10,0,30366043,Africa,254,2
2020-06-02,Mozambique,MZ,0,0,30366043,Africa,254,2
2020-06-03,Mozambique,MZ,53,0,30366043,Africa,307,2
2020-06-04,Mozambique,MZ,9,0,30366043,Africa,316,2
2020-06-05,Mozambique,MZ,36,0,30366043,Africa,352,2
2020-06-06,Mozambique,MZ,2,0,30366043,Africa,354,2
2020-06-07,Mozambique,MZ,57,0,30366043,Africa,411,2
2020-06-08,Mozambique,MZ,15,0,30366043,Africa,426,2
2020-06-09,Mozambique,MZ,7,0,30366043,Africa,433,2
2020-06-10,Mozambique,MZ,20,0,30366043,Africa,453,2
2020-06-11,Mozambique,MZ,19,0,30366043,Africa,472,2
2020-06-12,Mozambique,MZ,17,0,30366043,Africa,489,2
2020-06-13,Mozambique,MZ,20,0,30366043,Africa,509,2
2020-06-14,Mozambique,MZ,44,0,30366043,Africa,553,2
2020-06-15,Mozambique,MZ,30,1,30366043,Africa,583,3
2020-06-16,Mozambique,MZ,26,0,30366043,Africa,609,3
2020-06-17,Mozambique,MZ,29,1,30366043,Africa,638,4
2020-06-18,Mozambique,MZ,13,0,30366043,Africa,651,4
2020-06-19,Mozambique,MZ,11,0,30366043,Africa,662,4
2020-06-20,Mozambique,MZ,6,0,30366043,Africa,668,4
2020-06-21,Mozambique,MZ,20,0,30366043,Africa,688,4
2020-06-22,Mozambique,MZ,45,1,30366043,Africa,733,5
2020-06-23,Mozambique,MZ,4,0,30366043,Africa,737,5
2020-06-24,Mozambique,MZ,20,0,30366043,Africa,757,5
2020-06-25,Mozambique,MZ,5,0,30366043,Africa,762,5
2020-06-26,Mozambique,MZ,26,0,30366043,Africa,788,5
2020-06-27,Mozambique,MZ,28,0,30366043,Africa,816,5
2020-06-28,Mozambique,MZ,23,0,30366043,Africa,839,5
2020-06-29,Mozambique,MZ,20,0,30366043,Africa,859,5
2020-06-30,Mozambique,MZ,24,1,30366043,Africa,883,6
2020-07-01,Mozambique,MZ,6,0,30366043,Africa,889,6
2020-07-02,Mozambique,MZ,14,0,30366043,Africa,903,6
2020-07-03,Mozambique,MZ,15,0,30366043,Africa,918,6
2020-07-04,Mozambique,MZ,21,0,30366043,Africa,939,6
2020-07-05,Mozambique,MZ,30,1,30366043,Africa,969,7
2020-07-06,Mozambique,MZ,18,1,30366043,Africa,987,8
2020-07-07,Mozambique,MZ,25,0,30366043,Africa,1012,8
2020-07-08,Mozambique,MZ,28,0,30366043,Africa,1040,8
2020-07-09,Mozambique,MZ,31,0,30366043,Africa,1071,8
2020-07-10,Mozambique,MZ,21,1,30366043,Africa,1092,9
2020-07-11,Mozambique,MZ,19,0,30366043,Africa,1111,9
2020-07-12,Mozambique,MZ,24,0,30366043,Africa,1135,9
2020-07-13,Mozambique,MZ,22,0,30366043,Africa,1157,9
2020-07-14,Mozambique,MZ,62,0,30366043,Africa,1219,9
2020-07-15,Mozambique,MZ,49,0,30366043,Africa,1268,9
2020-07-16,Mozambique,MZ,62,0,30366043,Africa,1330,9
2020-07-17,Mozambique,MZ,53,0,30366043,Africa,1383,9
2020-07-18,Mozambique,MZ,19,0,30366043,Africa,1402,9
2020-07-19,Mozambique,MZ,33,1,30366043,Africa,1435,10
2020-07-20,Mozambique,MZ,56,0,30366043,Africa,1491,10
2020-07-21,Mozambique,MZ,16,1,30366043,Africa,1507,11
2020-07-22,Mozambique,MZ,29,0,30366043,Africa,1536,11
2020-07-23,Mozambique,MZ,21,0,30366043,Africa,1557,11
2020-07-24,Mozambique,MZ,25,0,30366043,Africa,1582,11
2020-07-25,Mozambique,MZ,8,0,30366043,Africa,1590,11
2020-07-26,Mozambique,MZ,26,0,30366043,Africa,1616,11
2020-07-27,Mozambique,MZ,53,0,30366043,Africa,1669,11
2020-07-28,Mozambique,MZ,32,0,30366043,Africa,1701,11
2020-07-29,Mozambique,MZ,19,0,30366043,Africa,1720,11
2020-07-30,Mozambique,MZ,28,0,30366043,Africa,1748,11
2020-07-31,Mozambique,MZ,60,0,30366043,Africa,1808,11
2020-08-01,Mozambique,MZ,56,0,30366043,Africa,1864,11
2020-08-02,Mozambique,MZ,43,0,30366043,Africa,1907,11
2020-08-03,Mozambique,MZ,39,2,30366043,Africa,1946,13
2020-08-04,Mozambique,MZ,27,1,30366043,Africa,1973,14
2020-08-05,Mozambique,MZ,56,1,30366043,Africa,2029,15
2020-08-06,Mozambique,MZ,50,0,30366043,Africa,2079,15
2020-08-07,Mozambique,MZ,41,0,30366043,Africa,2120,15
2020-08-08,Mozambique,MZ,93,0,30366043,Africa,2213,15
2020-08-09,Mozambique,MZ,28,1,30366043,Africa,2241,16
2020-08-10,Mozambique,MZ,28,0,30366043,Africa,2269,16
2020-08-11,Mozambique,MZ,142,0,30366043,Africa,2411,16
2020-08-12,Mozambique,MZ,70,1,30366043,Africa,2481,17
2020-08-13,Mozambique,MZ,78,2,30366043,Africa,2559,19
2020-08-14,Mozambique,MZ,79,0,30366043,Africa,2638,19
2020-08-15,Mozambique,MZ,70,0,30366043,Africa,2708,19
2020-08-16,Mozambique,MZ,83,0,30366043,Africa,2791,19
2020-08-17,Mozambique,MZ,64,0,30366043,Africa,2855,19
2020-08-18,Mozambique,MZ,59,0,30366043,Africa,2914,19
2020-08-19,Mozambique,MZ,0,0,30366043,Africa,2914,19
2020-08-20,Mozambique,MZ,131,0,30366043,Africa,3045,19
2020-08-21,Mozambique,MZ,70,1,30366043,Africa,3115,20
2020-08-22,Mozambique,MZ,80,0,30366043,Africa,3195,20
2020-08-23,Mozambique,MZ,109,0,30366043,Africa,3304,20
2020-08-24,Mozambique,MZ,91,0,30366043,Africa,3395,20
2020-08-25,Mozambique,MZ,45,1,30366043,Africa,3440,21
2020-08-26,Mozambique,MZ,68,0,30366043,Africa,3508,21
2020-08-27,Mozambique,MZ,82,0,30366043,Africa,3590,21
2020-08-28,Mozambique,MZ,61,0,30366043,Africa,3651,21
2020-08-29,Mozambique,MZ,46,0,30366043,Africa,3697,21
2020-08-30,Mozambique,MZ,63,1,30366043,Africa,3760,22
2020-08-31,Mozambique,MZ,61,1,30366043,Africa,3821,23
2020-09-01,Mozambique,MZ,95,0,30366043,Africa,3916,23
2020-09-02,Mozambique,MZ,123,0,30366043,Africa,4039,23
2020-09-03,Mozambique,MZ,78,2,30366043,Africa,4117,25
2020-09-04,Mozambique,MZ,90,1,30366043,Africa,4207,26
2020-09-05,Mozambique,MZ,58,0,30366043,Africa,4265,26
2020-09-06,Mozambique,MZ,76,0,30366043,Africa,4341,26
2020-09-07,Mozambique,MZ,103,1,30366043,Africa,4444,27
2020-09-08,Mozambique,MZ,113,0,30366043,Africa,4557,27
2020-09-09,Mozambique,MZ,90,1,30366043,Africa,4647,28
2020-09-10,Mozambique,MZ,117,0,30366043,Africa,4764,28
2020-09-11,Mozambique,MZ,68,3,30366043,Africa,4832,31
2020-09-12,Mozambique,MZ,86,0,30366043,Africa,4918,31
2020-09-13,Mozambique,MZ,122,4,30366043,Africa,5040,35
2020-09-14,Mozambique,MZ,229,0,30366043,Africa,5269,35
2020-09-15,Mozambique,MZ,213,0,30366043,Africa,5482,35
2020-09-16,Mozambique,MZ,231,2,30366043,Africa,5713,37
2020-09-17,Mozambique,MZ,281,2,30366043,Africa,5994,39
2020-09-18,Mozambique,MZ,167,0,30366043,Africa,6161,39
2020-09-19,Mozambique,MZ,103,1,30366043,Africa,6264,40
2020-09-20,Mozambique,MZ,273,1,30366043,Africa,6537,41
2020-09-21,Mozambique,MZ,234,2,30366043,Africa,6771,43
2020-09-22,Mozambique,MZ,141,1,30366043,Africa,6912,44
2020-09-23,Mozambique,MZ,202,1,30366043,Africa,7114,45
2020-09-24,Mozambique,MZ,148,4,30366043,Africa,7262,49
2020-09-25,Mozambique,MZ,137,2,30366043,Africa,7399,51
2020-09-26,Mozambique,MZ,190,2,30366043,Africa,7589,53
2020-09-27,Mozambique,MZ,168,1,30366043,Africa,7757,54
2020-09-28,Mozambique,MZ,226,4,30366043,Africa,7983,58
2020-09-29,Mozambique,MZ,305,1,30366043,Africa,8288,59
2020-09-30,Mozambique,MZ,268,0,30366043,Africa,8556,59
2020-10-01,Mozambique,MZ,172,2,30366043,Africa,8728,61
2020-10-02,Mozambique,MZ,160,1,30366043,Africa,8888,62
2020-10-03,Mozambique,MZ,91,2,30366043,Africa,8979,64
2020-10-04,Mozambique,MZ,70,0,30366043,Africa,9049,64
2020-10-05,Mozambique,MZ,147,2,30366043,Africa,9196,66
2020-10-06,Mozambique,MZ,100,0,30366043,Africa,9296,66
2020-10-07,Mozambique,MZ,102,1,30366043,Africa,9398,67
2020-10-08,Mozambique,MZ,96,1,30366043,Africa,9494,68
2020-10-09,Mozambique,MZ,145,0,30366043,Africa,9639,68
2020-10-10,Mozambique,MZ,103,1,30366043,Africa,9742,69
2020-10-11,Mozambique,MZ,102,1,30366043,Africa,9844,70
2020-10-12,Mozambique,MZ,157,1,30366043,Africa,10001,71
2020-10-13,Mozambique,MZ,87,1,30366043,Africa,10088,72
2020-10-14,Mozambique,MZ,170,1,30366043,Africa,10258,73
2020-10-15,Mozambique,MZ,134,0,30366043,Africa,10392,73
2020-10-16,Mozambique,MZ,145,0,30366043,Africa,10537,73
2020-10-17,Mozambique,MZ,75,0,30366043,Africa,10612,73
2020-10-18,Mozambique,MZ,95,1,30366043,Africa,10707,74
2020-10-19,Mozambique,MZ,159,1,30366043,Africa,10866,75
2020-10-20,Mozambique,MZ,214,0,30366043,Africa,11080,75
2020-10-21,Mozambique,MZ,110,3,30366043,Africa,11190,78
2020-10-22,Mozambique,MZ,141,1,30366043,Africa,11331,79
2020-10-23,Mozambique,MZ,228,2,30366043,Africa,11559,81
2020-10-24,Mozambique,MZ,189,1,30366043,Africa,11748,82
2020-10-25,Mozambique,MZ,147,3,30366043,Africa,11895,85
2020-10-26,Mozambique,MZ,91,1,30366043,Africa,11986,86
2020-10-27,Mozambique,MZ,175,2,30366043,Africa,12161,88
2020-10-28,Mozambique,MZ,112,1,30366043,Africa,12273,89
2020-10-29,Mozambique,MZ,142,2,30366043,Africa,12415,91
2020-10-30,Mozambique,MZ,110,0,30366043,Africa,12525,91
2020-10-31,Mozambique,MZ,252,0,30366043,Africa,12777,91
2020-11-01,Mozambique,MZ,92,1,30366043,Africa,12869,92
2020-11-02,Mozambique,MZ,119,1,30366043,Africa,12988,93
2020-11-03,Mozambique,MZ,142,1,30366043,Africa,13130,94
2020-11-04,Mozambique,MZ,72,1,30366043,Africa,13202,95
2020-11-05,Mozambique,MZ,81,0,30366043,Africa,13283,95
2020-11-06,Mozambique,MZ,108,2,30366043,Africa,13391,97
2020-11-07,Mozambique,MZ,94,2,30366043,Africa,13485,99
2020-11-08,Mozambique,MZ,92,0,30366043,Africa,13577,99
2020-11-09,Mozambique,MZ,191,0,30366043,Africa,13768,99
2020-11-10,Mozambique,MZ,55,0,30366043,Africa,13823,99
2020-11-11,Mozambique,MZ,0,0,30366043,Africa,13823,99
2020-11-12,Mozambique,MZ,88,5,30366043,Africa,13911,104
2020-11-13,Mozambique,MZ,183,0,30366043,Africa,14094,104
2020-11-14,Mozambique,MZ,133,6,30366043,Africa,14227,110
2020-11-15,Mozambique,MZ,113,0,30366043,Africa,14340,110
2020-11-16,Mozambique,MZ,108,3,30366043,Africa,14448,113
2020-11-17,Mozambique,MZ,66,3,30366043,Africa,14514,116
2020-11-18,Mozambique,MZ,52,2,30366043,Africa,14566,118
2020-11-19,Mozambique,MZ,0,0,30366043,Africa,14566,118
2020-11-20,Mozambique,MZ,157,2,30366043,Africa,14723,120
2020-11-21,Mozambique,MZ,154,1,30366043,Africa,14877,121
2020-11-22,Mozambique,MZ,104,2,30366043,Africa,14981,123
2020-11-23,Mozambique,MZ,56,1,30366043,Africa,15037,124
2020-11-24,Mozambique,MZ,72,2,30366043,Africa,15109,126
2020-11-25,Mozambique,MZ,122,1,30366043,Africa,15231,127
2020-11-26,Mozambique,MZ,71,1,30366043,Africa,15302,128
2020-11-27,Mozambique,MZ,165,0,30366043,Africa,15467,128
2020-11-28,Mozambique,MZ,39,0,30366043,Africa,15506,128
2020-11-29,Mozambique,MZ,80,1,30366043,Africa,15586,129
2020-11-30,Mozambique,MZ,27,1,30366043,Africa,15613,130
2020-12-01,Mozambique,MZ,88,1,30366043,Africa,15701,131
2020-12-02,Mozambique,MZ,69,0,30366043,Africa,15770,131
2020-12-03,Mozambique,MZ,96,1,30366043,Africa,15866,132
2020-12-04,Mozambique,MZ,52,0,30366043,Africa,15918,132
2020-12-05,Mozambique,MZ,120,1,30366043,Africa,16038,133
2020-12-06,Mozambique,MZ,95,0,30366043,Africa,16133,133
2020-12-07,Mozambique,MZ,111,0,30366043,Africa,16244,133
2020-12-08,Mozambique,MZ,82,3,30366043,Africa,16326,136
2020-12-09,Mozambique,MZ,47,0,30366043,Africa,16373,136
2020-12-10,Mozambique,MZ,67,2,30366043,Africa,16440,138
2020-12-11,Mozambique,MZ,81,1,30366043,Africa,16521,139
2020-12-12,Mozambique,MZ,159,0,30366043,Africa,16680,139
2020-12-13,Mozambique,MZ,132,1,30366043,Africa,16812,140
2020-12-14,Mozambique,MZ,142,2,30366043,Africa,16954,142
2020-03-15,Namibia,NA,2,0,2494524,Africa,2,0
2020-03-16,Namibia,NA,0,0,2494524,Africa,2,0
2020-03-17,Namibia,NA,0,0,2494524,Africa,2,0
2020-03-18,Namibia,NA,0,0,2494524,Africa,2,0
2020-03-19,Namibia,NA,0,0,2494524,Africa,2,0
2020-03-20,Namibia,NA,0,0,2494524,Africa,2,0
2020-03-21,Namibia,NA,1,0,2494524,Africa,3,0
2020-03-22,Namibia,NA,0,0,2494524,Africa,3,0
2020-03-23,Namibia,NA,0,0,2494524,Africa,3,0
2020-03-24,Namibia,NA,0,0,2494524,Africa,3,0
2020-03-25,Namibia,NA,0,0,2494524,Africa,3,0
2020-03-26,Namibia,NA,1,0,2494524,Africa,4,0
2020-03-27,Namibia,NA,4,0,2494524,Africa,8,0
2020-03-28,Namibia,NA,0,0,2494524,Africa,8,0
2020-03-29,Namibia,NA,0,0,2494524,Africa,8,0
2020-03-30,Namibia,NA,3,0,2494524,Africa,11,0
2020-03-31,Namibia,NA,0,0,2494524,Africa,11,0
2020-04-01,Namibia,NA,0,0,2494524,Africa,11,0
2020-04-02,Namibia,NA,2,0,2494524,Africa,13,0
2020-04-03,Namibia,NA,0,0,2494524,Africa,13,0
2020-04-04,Namibia,NA,1,0,2494524,Africa,14,0
2020-04-05,Namibia,NA,0,0,2494524,Africa,14,0
2020-04-06,Namibia,NA,2,0,2494524,Africa,16,0
2020-04-07,Namibia,NA,0,0,2494524,Africa,16,0
2020-04-08,Namibia,NA,0,0,2494524,Africa,16,0
2020-04-09,Namibia,NA,0,0,2494524,Africa,16,0
2020-04-10,Namibia,NA,0,0,2494524,Africa,16,0
2020-04-11,Namibia,NA,0,0,2494524,Africa,16,0
2020-04-12,Namibia,NA,0,0,2494524,Africa,16,0
2020-04-13,Namibia,NA,0,0,2494524,Africa,16,0
2020-04-14,Namibia,NA,0,0,2494524,Africa,16,0
2020-04-15,Namibia,NA,0,0,2494524,Africa,16,0
2020-04-16,Namibia,NA,0,0,2494524,Africa,16,0
2020-04-17,Namibia,NA,0,0,2494524,Africa,16,0
2020-04-18,Namibia,NA,0,0,2494524,Africa,16,0
2020-04-19,Namibia,NA,0,0,2494524,Africa,16,0
2020-04-20,Namibia,NA,0,0,2494524,Africa,16,0
2020-04-21,Namibia,NA,0,0,2494524,Africa,16,0
2020-04-22,Namibia,NA,0,0,2494524,Africa,16,0
2020-04-23,Namibia,NA,0,0,2494524,Africa,16,0
2020-04-24,Namibia,NA,0,0,2494524,Africa,16,0
2020-04-25,Namibia,NA,0,0,2494524,Africa,16,0
2020-04-26,Namibia,NA,0,0,2494524,Africa,16,0
2020-04-27,Namibia,NA,0,0,2494524,Africa,16,0
2020-04-28,Namibia,NA,0,0,2494524,Africa,16,0
2020-04-29,Namibia,NA,0,0,2494524,Africa,16,0
2020-04-30,Namibia,NA,0,0,2494524,Africa,16,0
2020-05-01,Namibia,NA,0,0,2494524,Africa,16,0
2020-05-02,Namibia,NA,0,0,2494524,Africa,16,0
2020-05-03,Namibia,NA,0,0,2494524,Africa,16,0
2020-05-04,Namibia,NA,0,0,2494524,Africa,16,0
2020-05-05,Namibia,NA,0,0,2494524,Africa,16,0
2020-05-06,Namibia,NA,0,0,2494524,Africa,16,0
2020-05-07,Namibia,NA,0,0,2494524,Africa,16,0
2020-05-08,Namibia,NA,0,0,2494524,Africa,16,0
2020-05-09,Namibia,NA,0,0,2494524,Africa,16,0
2020-05-10,Namibia,NA,0,0,2494524,Africa,16,0
2020-05-11,Namibia,NA,0,0,2494524,Africa,16,0
2020-05-12,Namibia,NA,0,0,2494524,Africa,16,0
2020-05-13,Namibia,NA,0,0,2494524,Africa,16,0
2020-05-14,Namibia,NA,0,0,2494524,Africa,16,0
2020-05-15,Namibia,NA,0,0,2494524,Africa,16,0
2020-05-16,Namibia,NA,0,0,2494524,Africa,16,0
2020-05-17,Namibia,NA,0,0,2494524,Africa,16,0
2020-05-18,Namibia,NA,0,0,2494524,Africa,16,0
2020-05-19,Namibia,NA,0,0,2494524,Africa,16,0
2020-05-20,Namibia,NA,0,0,2494524,Africa,16,0
2020-05-21,Namibia,NA,0,0,2494524,Africa,16,0
2020-05-22,Namibia,NA,2,0,2494524,Africa,18,0
2020-05-23,Namibia,NA,1,0,2494524,Africa,19,0
2020-05-24,Namibia,NA,1,0,2494524,Africa,20,0
2020-05-25,Namibia,NA,1,0,2494524,Africa,21,0
2020-05-26,Namibia,NA,0,0,2494524,Africa,21,0
2020-05-27,Namibia,NA,0,0,2494524,Africa,21,0
2020-05-28,Namibia,NA,1,0,2494524,Africa,22,0
2020-05-29,Namibia,NA,0,0,2494524,Africa,22,0
2020-05-30,Namibia,NA,1,0,2494524,Africa,23,0
2020-05-31,Namibia,NA,0,0,2494524,Africa,23,0
2020-06-01,Namibia,NA,1,0,2494524,Africa,24,0
2020-06-02,Namibia,NA,1,0,2494524,Africa,25,0
2020-06-03,Namibia,NA,0,0,2494524,Africa,25,0
2020-06-04,Namibia,NA,0,0,2494524,Africa,25,0
2020-06-05,Namibia,NA,0,0,2494524,Africa,25,0
2020-06-06,Namibia,NA,0,0,2494524,Africa,25,0
2020-06-07,Namibia,NA,4,0,2494524,Africa,29,0
2020-06-08,Namibia,NA,0,0,2494524,Africa,29,0
2020-06-09,Namibia,NA,2,0,2494524,Africa,31,0
2020-06-10,Namibia,NA,0,0,2494524,Africa,31,0
2020-06-11,Namibia,NA,0,0,2494524,Africa,31,0
2020-06-12,Namibia,NA,0,0,2494524,Africa,31,0
2020-06-13,Namibia,NA,0,0,2494524,Africa,31,0
2020-06-14,Namibia,NA,1,0,2494524,Africa,32,0
2020-06-15,Namibia,NA,0,0,2494524,Africa,32,0
2020-06-16,Namibia,NA,0,0,2494524,Africa,32,0
2020-06-17,Namibia,NA,2,0,2494524,Africa,34,0
2020-06-18,Namibia,NA,2,0,2494524,Africa,36,0
2020-06-19,Namibia,NA,3,0,2494524,Africa,39,0
2020-06-20,Namibia,NA,6,0,2494524,Africa,45,0
2020-06-21,Namibia,NA,1,0,2494524,Africa,46,0
2020-06-22,Namibia,NA,9,0,2494524,Africa,55,0
2020-06-23,Namibia,NA,8,0,2494524,Africa,63,0
2020-06-24,Namibia,NA,9,0,2494524,Africa,72,0
2020-06-25,Namibia,NA,4,0,2494524,Africa,76,0
2020-06-26,Namibia,NA,5,0,2494524,Africa,81,0
2020-06-27,Namibia,NA,40,0,2494524,Africa,121,0
2020-06-28,Namibia,NA,0,0,2494524,Africa,121,0
2020-06-29,Namibia,NA,62,0,2494524,Africa,183,0
2020-06-30,Namibia,NA,13,0,2494524,Africa,196,0
2020-07-01,Namibia,NA,7,0,2494524,Africa,203,0
2020-07-02,Namibia,NA,82,0,2494524,Africa,285,0
2020-07-03,Namibia,NA,8,0,2494524,Africa,293,0
2020-07-04,Namibia,NA,57,0,2494524,Africa,350,0
2020-07-05,Namibia,NA,25,0,2494524,Africa,375,0
2020-07-06,Namibia,NA,37,0,2494524,Africa,412,0
2020-07-07,Namibia,NA,73,0,2494524,Africa,485,0
2020-07-08,Namibia,NA,54,0,2494524,Africa,539,0
2020-07-09,Namibia,NA,54,0,2494524,Africa,593,0
2020-07-10,Namibia,NA,22,0,2494524,Africa,615,0
2020-07-11,Namibia,NA,53,1,2494524,Africa,668,1
2020-07-12,Namibia,NA,0,0,2494524,Africa,668,1
2020-07-13,Namibia,NA,117,0,2494524,Africa,785,1
2020-07-14,Namibia,NA,76,0,2494524,Africa,861,1
2020-07-15,Namibia,NA,3,1,2494524,Africa,864,2
2020-07-16,Namibia,NA,96,0,2494524,Africa,960,2
2020-07-17,Namibia,NA,72,0,2494524,Africa,1032,2
2020-07-18,Namibia,NA,46,0,2494524,Africa,1078,2
2020-07-19,Namibia,NA,125,0,2494524,Africa,1203,2
2020-07-20,Namibia,NA,44,1,2494524,Africa,1247,3
2020-07-21,Namibia,NA,97,1,2494524,Africa,1344,4
2020-07-22,Namibia,NA,22,3,2494524,Africa,1366,7
2020-07-23,Namibia,NA,36,0,2494524,Africa,1402,7
2020-07-24,Namibia,NA,120,0,2494524,Africa,1522,7
2020-07-25,Namibia,NA,96,0,2494524,Africa,1618,7
2020-07-26,Namibia,NA,69,0,2494524,Africa,1687,7
2020-07-27,Namibia,NA,88,1,2494524,Africa,1775,8
2020-07-28,Namibia,NA,68,0,2494524,Africa,1843,8
2020-07-29,Namibia,NA,74,0,2494524,Africa,1917,8
2020-07-30,Namibia,NA,69,1,2494524,Africa,1986,9
2020-07-31,Namibia,NA,66,1,2494524,Africa,2052,10
2020-08-01,Namibia,NA,77,0,2494524,Africa,2129,10
2020-08-02,Namibia,NA,95,1,2494524,Africa,2224,11
2020-08-03,Namibia,NA,70,0,2494524,Africa,2294,11
2020-08-04,Namibia,NA,112,1,2494524,Africa,2406,12
2020-08-05,Namibia,NA,64,0,2494524,Africa,2470,12
2020-08-06,Namibia,NA,70,0,2494524,Africa,2540,12
2020-08-07,Namibia,NA,112,3,2494524,Africa,2652,15
2020-08-08,Namibia,NA,150,1,2494524,Africa,2802,16
2020-08-09,Namibia,NA,0,0,2494524,Africa,2802,16
2020-08-10,Namibia,NA,147,3,2494524,Africa,2949,19
2020-08-11,Namibia,NA,152,0,2494524,Africa,3101,19
2020-08-12,Namibia,NA,128,0,2494524,Africa,3229,19
2020-08-13,Namibia,NA,177,3,2494524,Africa,3406,22
2020-08-14,Namibia,NA,138,5,2494524,Africa,3544,27
2020-08-15,Namibia,NA,182,4,2494524,Africa,3726,31
2020-08-16,Namibia,NA,181,4,2494524,Africa,3907,35
2020-08-17,Namibia,NA,247,0,2494524,Africa,4154,35
2020-08-18,Namibia,NA,190,1,2494524,Africa,4344,36
2020-08-19,Namibia,NA,120,1,2494524,Africa,4464,37
2020-08-20,Namibia,NA,201,2,2494524,Africa,4665,39
2020-08-21,Namibia,NA,247,2,2494524,Africa,4912,41
2020-08-22,Namibia,NA,315,1,2494524,Africa,5227,42
2020-08-23,Namibia,NA,311,4,2494524,Africa,5538,46
2020-08-24,Namibia,NA,316,6,2494524,Africa,5854,52
2020-08-25,Namibia,NA,176,4,2494524,Africa,6030,56
2020-08-26,Namibia,NA,130,1,2494524,Africa,6160,57
2020-08-27,Namibia,NA,271,2,2494524,Africa,6431,59
2020-08-28,Namibia,NA,281,1,2494524,Africa,6712,60
2020-08-29,Namibia,NA,194,5,2494524,Africa,6906,65
2020-08-30,Namibia,NA,210,4,2494524,Africa,7116,69
2020-08-31,Namibia,NA,249,3,2494524,Africa,7365,72
2020-09-01,Namibia,NA,185,3,2494524,Africa,7550,75
2020-09-02,Namibia,NA,142,6,2494524,Africa,7692,81
2020-09-03,Namibia,NA,152,1,2494524,Africa,7844,82
2020-09-04,Namibia,NA,238,4,2494524,Africa,8082,86
2020-09-05,Namibia,NA,241,0,2494524,Africa,8323,86
2020-09-06,Namibia,NA,191,1,2494524,Africa,8514,87
2020-09-07,Namibia,NA,171,2,2494524,Africa,8685,89
2020-09-08,Namibia,NA,125,2,2494524,Africa,8810,91
2020-09-09,Namibia,NA,118,0,2494524,Africa,8928,91
2020-09-10,Namibia,NA,180,2,2494524,Africa,9108,93
2020-09-11,Namibia,NA,148,3,2494524,Africa,9256,96
2020-09-12,Namibia,NA,181,2,2494524,Africa,9437,98
2020-09-13,Namibia,NA,167,0,2494524,Africa,9604,98
2020-09-14,Namibia,NA,115,3,2494524,Africa,9719,101
2020-09-15,Namibia,NA,99,2,2494524,Africa,9818,103
2020-09-16,Namibia,NA,83,3,2494524,Africa,9901,106
2020-09-17,Namibia,NA,63,2,2494524,Africa,9964,108
2020-09-18,Namibia,NA,114,0,2494524,Africa,10078,108
2020-09-19,Namibia,NA,129,0,2494524,Africa,10207,108
2020-09-20,Namibia,NA,85,3,2494524,Africa,10292,111
2020-09-21,Namibia,NA,85,1,2494524,Africa,10377,112
2020-09-22,Namibia,NA,149,1,2494524,Africa,10526,113
2020-09-23,Namibia,NA,81,3,2494524,Africa,10607,116
2020-09-24,Namibia,NA,56,1,2494524,Africa,10663,117
2020-09-25,Namibia,NA,77,2,2494524,Africa,10740,119
2020-09-26,Namibia,NA,95,0,2494524,Africa,10835,119
2020-09-27,Namibia,NA,83,0,2494524,Africa,10918,119
2020-09-28,Namibia,NA,115,0,2494524,Africa,11033,119
2020-09-29,Namibia,NA,88,0,2494524,Africa,11121,119
2020-09-30,Namibia,NA,19,2,2494524,Africa,11140,121
2020-10-01,Namibia,NA,125,0,2494524,Africa,11265,121
2020-10-02,Namibia,NA,108,2,2494524,Africa,11373,123
2020-10-03,Namibia,NA,107,0,2494524,Africa,11480,123
2020-10-04,Namibia,NA,92,0,2494524,Africa,11572,123
2020-10-05,Namibia,NA,54,0,2494524,Africa,11626,123
2020-10-06,Namibia,NA,28,2,2494524,Africa,11654,125
2020-10-07,Namibia,NA,19,0,2494524,Africa,11673,125
2020-10-08,Namibia,NA,41,1,2494524,Africa,11714,126
2020-10-09,Namibia,NA,67,1,2494524,Africa,11781,127
2020-10-10,Namibia,NA,48,0,2494524,Africa,11829,127
2020-10-11,Namibia,NA,62,1,2494524,Africa,11891,128
2020-10-12,Namibia,NA,45,0,2494524,Africa,11936,128
2020-10-13,Namibia,NA,53,1,2494524,Africa,11989,129
2020-10-14,Namibia,NA,11,0,2494524,Africa,12000,129
2020-10-15,Namibia,NA,69,1,2494524,Africa,12069,130
2020-10-16,Namibia,NA,34,0,2494524,Africa,12103,130
2020-10-17,Namibia,NA,112,1,2494524,Africa,12215,131
2020-10-18,Namibia,NA,48,0,2494524,Africa,12263,131
2020-10-19,Namibia,NA,30,0,2494524,Africa,12293,131
2020-10-20,Namibia,NA,33,0,2494524,Africa,12326,131
2020-10-21,Namibia,NA,41,1,2494524,Africa,12367,132
2020-10-22,Namibia,NA,39,1,2494524,Africa,12406,133
2020-10-23,Namibia,NA,54,0,2494524,Africa,12460,133
2020-10-24,Namibia,NA,41,0,2494524,Africa,12501,133
2020-10-25,Namibia,NA,78,0,2494524,Africa,12579,133
2020-10-26,Namibia,NA,81,0,2494524,Africa,12660,133
2020-10-27,Namibia,NA,15,0,2494524,Africa,12675,133
2020-10-28,Namibia,NA,54,0,2494524,Africa,12729,133
2020-10-29,Namibia,NA,77,0,2494524,Africa,12806,133
2020-10-30,Namibia,NA,52,0,2494524,Africa,12858,133
2020-10-31,Namibia,NA,49,0,2494524,Africa,12907,133
2020-11-01,Namibia,NA,28,0,2494524,Africa,12935,133
2020-11-02,Namibia,NA,53,0,2494524,Africa,12988,133
2020-11-03,Namibia,NA,24,0,2494524,Africa,13012,133
2020-11-04,Namibia,NA,18,0,2494524,Africa,13030,133
2020-11-05,Namibia,NA,16,0,2494524,Africa,13046,133
2020-11-06,Namibia,NA,44,0,2494524,Africa,13090,133
2020-11-07,Namibia,NA,53,0,2494524,Africa,13143,133
2020-11-08,Namibia,NA,27,1,2494524,Africa,13170,134
2020-11-09,Namibia,NA,41,0,2494524,Africa,13211,134
2020-11-10,Namibia,NA,29,0,2494524,Africa,13240,134
2020-11-11,Namibia,NA,13,0,2494524,Africa,13253,134
2020-11-12,Namibia,NA,39,0,2494524,Africa,13292,134
2020-11-13,Namibia,NA,53,1,2494524,Africa,13345,135
2020-11-14,Namibia,NA,27,3,2494524,Africa,13372,138
2020-11-15,Namibia,NA,77,0,2494524,Africa,13449,138
2020-11-16,Namibia,NA,59,0,2494524,Africa,13508,138
2020-11-17,Namibia,NA,47,0,2494524,Africa,13555,138
2020-11-18,Namibia,NA,11,2,2494524,Africa,13566,140
2020-11-19,Namibia,NA,44,0,2494524,Africa,13610,140
2020-11-20,Namibia,NA,52,1,2494524,Africa,13662,141
2020-11-21,Namibia,NA,50,2,2494524,Africa,13712,143
2020-11-22,Namibia,NA,99,2,2494524,Africa,13811,145
2020-11-23,Namibia,NA,54,0,2494524,Africa,13865,145
2020-11-24,Namibia,NA,32,0,2494524,Africa,13897,145
2020-11-25,Namibia,NA,41,0,2494524,Africa,13938,145
2020-11-26,Namibia,NA,68,0,2494524,Africa,14006,145
2020-11-27,Namibia,NA,149,2,2494524,Africa,14155,147
2020-11-28,Namibia,NA,52,2,2494524,Africa,14207,149
2020-11-29,Namibia,NA,78,1,2494524,Africa,14285,150
2020-11-30,Namibia,NA,60,1,2494524,Africa,14345,151
2020-12-01,Namibia,NA,35,0,2494524,Africa,14380,151
2020-12-02,Namibia,NA,36,0,2494524,Africa,14416,151
2020-12-03,Namibia,NA,61,0,2494524,Africa,14477,151
2020-12-04,Namibia,NA,122,0,2494524,Africa,14599,151
2020-12-05,Namibia,NA,205,1,2494524,Africa,14804,152
2020-12-06,Namibia,NA,146,0,2494524,Africa,14950,152
2020-12-07,Namibia,NA,128,0,2494524,Africa,15078,152
2020-12-08,Namibia,NA,141,0,2494524,Africa,15219,152
2020-12-09,Namibia,NA,79,1,2494524,Africa,15298,153
2020-12-10,Namibia,NA,174,2,2494524,Africa,15472,155
2020-12-11,Namibia,NA,301,3,2494524,Africa,15773,158
2020-12-12,Namibia,NA,324,2,2494524,Africa,16097,160
2020-12-13,Namibia,NA,172,0,2494524,Africa,16269,160
2020-12-14,Namibia,NA,267,0,2494524,Africa,16536,160
2020-03-21,New_Caledonia,NC,2,0,282757,Oceania,2,0
2020-03-22,New_Caledonia,NC,2,0,282757,Oceania,4,0
2020-03-23,New_Caledonia,NC,1,0,282757,Oceania,5,0
2020-03-24,New_Caledonia,NC,2,0,282757,Oceania,7,0
2020-03-25,New_Caledonia,NC,2,0,282757,Oceania,9,0
2020-03-26,New_Caledonia,NC,5,0,282757,Oceania,14,0
2020-03-27,New_Caledonia,NC,1,0,282757,Oceania,15,0
2020-03-28,New_Caledonia,NC,0,0,282757,Oceania,15,0
2020-03-29,New_Caledonia,NC,0,0,282757,Oceania,15,0
2020-03-30,New_Caledonia,NC,0,0,282757,Oceania,15,0
2020-03-31,New_Caledonia,NC,1,0,282757,Oceania,16,0
2020-04-01,New_Caledonia,NC,0,0,282757,Oceania,16,0
2020-04-02,New_Caledonia,NC,0,0,282757,Oceania,16,0
2020-04-03,New_Caledonia,NC,0,0,282757,Oceania,16,0
2020-04-04,New_Caledonia,NC,2,0,282757,Oceania,18,0
2020-04-05,New_Caledonia,NC,0,0,282757,Oceania,18,0
2020-04-06,New_Caledonia,NC,0,0,282757,Oceania,18,0
2020-04-07,New_Caledonia,NC,0,0,282757,Oceania,18,0
2020-04-08,New_Caledonia,NC,0,0,282757,Oceania,18,0
2020-04-09,New_Caledonia,NC,0,0,282757,Oceania,18,0
2020-04-10,New_Caledonia,NC,0,0,282757,Oceania,18,0
2020-04-11,New_Caledonia,NC,0,0,282757,Oceania,18,0
2020-04-12,New_Caledonia,NC,0,0,282757,Oceania,18,0
2020-04-13,New_Caledonia,NC,0,0,282757,Oceania,18,0
2020-04-14,New_Caledonia,NC,0,0,282757,Oceania,18,0
2020-04-15,New_Caledonia,NC,0,0,282757,Oceania,18,0
2020-04-16,New_Caledonia,NC,0,0,282757,Oceania,18,0
2020-04-17,New_Caledonia,NC,0,0,282757,Oceania,18,0
2020-04-18,New_Caledonia,NC,0,0,282757,Oceania,18,0
2020-04-19,New_Caledonia,NC,0,0,282757,Oceania,18,0
2020-04-20,New_Caledonia,NC,0,0,282757,Oceania,18,0
2020-04-21,New_Caledonia,NC,0,0,282757,Oceania,18,0
2020-04-22,New_Caledonia,NC,0,0,282757,Oceania,18,0
2020-04-23,New_Caledonia,NC,0,0,282757,Oceania,18,0
2020-04-24,New_Caledonia,NC,0,0,282757,Oceania,18,0
2020-04-25,New_Caledonia,NC,0,0,282757,Oceania,18,0
2020-04-26,New_Caledonia,NC,0,0,282757,Oceania,18,0
2020-04-27,New_Caledonia,NC,0,0,282757,Oceania,18,0
2020-04-28,New_Caledonia,NC,0,0,282757,Oceania,18,0
2020-04-29,New_Caledonia,NC,0,0,282757,Oceania,18,0
2020-04-30,New_Caledonia,NC,0,0,282757,Oceania,18,0
2020-05-01,New_Caledonia,NC,0,0,282757,Oceania,18,0
2020-05-02,New_Caledonia,NC,0,0,282757,Oceania,18,0
2020-05-03,New_Caledonia,NC,0,0,282757,Oceania,18,0
2020-05-04,New_Caledonia,NC,0,0,282757,Oceania,18,0
2020-05-05,New_Caledonia,NC,0,0,282757,Oceania,18,0
2020-05-06,New_Caledonia,NC,0,0,282757,Oceania,18,0
2020-05-07,New_Caledonia,NC,0,0,282757,Oceania,18,0
2020-05-08,New_Caledonia,NC,0,0,282757,Oceania,18,0
2020-05-09,New_Caledonia,NC,0,0,282757,Oceania,18,0
2020-05-10,New_Caledonia,NC,0,0,282757,Oceania,18,0
2020-05-11,New_Caledonia,NC,0,0,282757,Oceania,18,0
2020-05-12,New_Caledonia,NC,0,0,282757,Oceania,18,0
2020-05-13,New_Caledonia,NC,0,0,282757,Oceania,18,0
2020-05-14,New_Caledonia,NC,0,0,282757,Oceania,18,0
2020-05-15,New_Caledonia,NC,0,0,282757,Oceania,18,0
2020-05-16,New_Caledonia,NC,0,0,282757,Oceania,18,0
2020-05-17,New_Caledonia,NC,0,0,282757,Oceania,18,0
2020-05-18,New_Caledonia,NC,0,0,282757,Oceania,18,0
2020-05-19,New_Caledonia,NC,0,0,282757,Oceania,18,0
2020-05-20,New_Caledonia,NC,0,0,282757,Oceania,18,0
2020-05-21,New_Caledonia,NC,0,0,282757,Oceania,18,0
2020-05-22,New_Caledonia,NC,0,0,282757,Oceania,18,0
2020-05-23,New_Caledonia,NC,0,0,282757,Oceania,18,0
2020-05-24,New_Caledonia,NC,0,0,282757,Oceania,18,0
2020-05-25,New_Caledonia,NC,0,0,282757,Oceania,18,0
2020-05-26,New_Caledonia,NC,0,0,282757,Oceania,18,0
2020-05-27,New_Caledonia,NC,0,0,282757,Oceania,18,0
2020-05-28,New_Caledonia,NC,0,0,282757,Oceania,18,0
2020-05-29,New_Caledonia,NC,1,0,282757,Oceania,19,0
2020-05-30,New_Caledonia,NC,0,0,282757,Oceania,19,0
2020-05-31,New_Caledonia,NC,0,0,282757,Oceania,19,0
2020-06-01,New_Caledonia,NC,0,0,282757,Oceania,19,0
2020-06-02,New_Caledonia,NC,1,0,282757,Oceania,20,0
2020-06-03,New_Caledonia,NC,0,0,282757,Oceania,20,0
2020-06-04,New_Caledonia,NC,0,0,282757,Oceania,20,0
2020-06-05,New_Caledonia,NC,0,0,282757,Oceania,20,0
2020-06-06,New_Caledonia,NC,0,0,282757,Oceania,20,0
2020-06-07,New_Caledonia,NC,0,0,282757,Oceania,20,0
2020-06-08,New_Caledonia,NC,0,0,282757,Oceania,20,0
2020-06-09,New_Caledonia,NC,0,0,282757,Oceania,20,0
2020-06-10,New_Caledonia,NC,1,0,282757,Oceania,21,0
2020-06-11,New_Caledonia,NC,0,0,282757,Oceania,21,0
2020-06-12,New_Caledonia,NC,0,0,282757,Oceania,21,0
2020-06-13,New_Caledonia,NC,0,0,282757,Oceania,21,0
2020-06-14,New_Caledonia,NC,0,0,282757,Oceania,21,0
2020-06-15,New_Caledonia,NC,0,0,282757,Oceania,21,0
2020-06-16,New_Caledonia,NC,0,0,282757,Oceania,21,0
2020-06-17,New_Caledonia,NC,0,0,282757,Oceania,21,0
2020-06-18,New_Caledonia,NC,0,0,282757,Oceania,21,0
2020-06-19,New_Caledonia,NC,0,0,282757,Oceania,21,0
2020-06-20,New_Caledonia,NC,0,0,282757,Oceania,21,0
2020-06-21,New_Caledonia,NC,0,0,282757,Oceania,21,0
2020-06-22,New_Caledonia,NC,0,0,282757,Oceania,21,0
2020-06-23,New_Caledonia,NC,0,0,282757,Oceania,21,0
2020-06-24,New_Caledonia,NC,0,0,282757,Oceania,21,0
2020-06-25,New_Caledonia,NC,0,0,282757,Oceania,21,0
2020-06-26,New_Caledonia,NC,0,0,282757,Oceania,21,0
2020-06-27,New_Caledonia,NC,0,0,282757,Oceania,21,0
2020-06-28,New_Caledonia,NC,0,0,282757,Oceania,21,0
2020-06-29,New_Caledonia,NC,0,0,282757,Oceania,21,0
2020-06-30,New_Caledonia,NC,0,0,282757,Oceania,21,0
2020-07-01,New_Caledonia,NC,0,0,282757,Oceania,21,0
2020-07-02,New_Caledonia,NC,0,0,282757,Oceania,21,0
2020-07-03,New_Caledonia,NC,0,0,282757,Oceania,21,0
2020-07-04,New_Caledonia,NC,0,0,282757,Oceania,21,0
2020-07-05,New_Caledonia,NC,0,0,282757,Oceania,21,0
2020-07-06,New_Caledonia,NC,0,0,282757,Oceania,21,0
2020-07-07,New_Caledonia,NC,0,0,282757,Oceania,21,0
2020-07-08,New_Caledonia,NC,0,0,282757,Oceania,21,0
2020-07-09,New_Caledonia,NC,0,0,282757,Oceania,21,0
2020-07-10,New_Caledonia,NC,0,0,282757,Oceania,21,0
2020-07-11,New_Caledonia,NC,0,0,282757,Oceania,21,0
2020-07-12,New_Caledonia,NC,0,0,282757,Oceania,21,0
2020-07-13,New_Caledonia,NC,0,0,282757,Oceania,21,0
2020-07-14,New_Caledonia,NC,0,0,282757,Oceania,21,0
2020-07-15,New_Caledonia,NC,1,0,282757,Oceania,22,0
2020-07-16,New_Caledonia,NC,0,0,282757,Oceania,22,0
2020-07-17,New_Caledonia,NC,0,0,282757,Oceania,22,0
2020-07-18,New_Caledonia,NC,0,0,282757,Oceania,22,0
2020-07-19,New_Caledonia,NC,0,0,282757,Oceania,22,0
2020-07-20,New_Caledonia,NC,0,0,282757,Oceania,22,0
2020-07-21,New_Caledonia,NC,0,0,282757,Oceania,22,0
2020-07-22,New_Caledonia,NC,0,0,282757,Oceania,22,0
2020-07-23,New_Caledonia,NC,0,0,282757,Oceania,22,0
2020-07-24,New_Caledonia,NC,0,0,282757,Oceania,22,0
2020-07-25,New_Caledonia,NC,0,0,282757,Oceania,22,0
2020-07-26,New_Caledonia,NC,0,0,282757,Oceania,22,0
2020-07-27,New_Caledonia,NC,0,0,282757,Oceania,22,0
2020-07-28,New_Caledonia,NC,0,0,282757,Oceania,22,0
2020-07-29,New_Caledonia,NC,0,0,282757,Oceania,22,0
2020-07-30,New_Caledonia,NC,0,0,282757,Oceania,22,0
2020-07-31,New_Caledonia,NC,0,0,282757,Oceania,22,0
2020-08-01,New_Caledonia,NC,0,0,282757,Oceania,22,0
2020-08-02,New_Caledonia,NC,0,0,282757,Oceania,22,0
2020-08-03,New_Caledonia,NC,0,0,282757,Oceania,22,0
2020-08-04,New_Caledonia,NC,0,0,282757,Oceania,22,0
2020-08-05,New_Caledonia,NC,0,0,282757,Oceania,22,0
2020-08-06,New_Caledonia,NC,0,0,282757,Oceania,22,0
2020-08-07,New_Caledonia,NC,0,0,282757,Oceania,22,0
2020-08-08,New_Caledonia,NC,1,0,282757,Oceania,23,0
2020-08-09,New_Caledonia,NC,0,0,282757,Oceania,23,0
2020-08-10,New_Caledonia,NC,0,0,282757,Oceania,23,0
2020-08-11,New_Caledonia,NC,0,0,282757,Oceania,23,0
2020-08-12,New_Caledonia,NC,0,0,282757,Oceania,23,0
2020-08-13,New_Caledonia,NC,0,0,282757,Oceania,23,0
2020-08-14,New_Caledonia,NC,0,0,282757,Oceania,23,0
2020-08-15,New_Caledonia,NC,0,0,282757,Oceania,23,0
2020-08-16,New_Caledonia,NC,0,0,282757,Oceania,23,0
2020-08-17,New_Caledonia,NC,0,0,282757,Oceania,23,0
2020-08-18,New_Caledonia,NC,0,0,282757,Oceania,23,0
2020-08-19,New_Caledonia,NC,0,0,282757,Oceania,23,0
2020-08-20,New_Caledonia,NC,0,0,282757,Oceania,23,0
2020-08-21,New_Caledonia,NC,0,0,282757,Oceania,23,0
2020-08-22,New_Caledonia,NC,0,0,282757,Oceania,23,0
2020-08-23,New_Caledonia,NC,0,0,282757,Oceania,23,0
2020-08-24,New_Caledonia,NC,0,0,282757,Oceania,23,0
2020-08-25,New_Caledonia,NC,0,0,282757,Oceania,23,0
2020-08-26,New_Caledonia,NC,0,0,282757,Oceania,23,0
2020-08-27,New_Caledonia,NC,0,0,282757,Oceania,23,0
2020-08-28,New_Caledonia,NC,0,0,282757,Oceania,23,0
2020-08-29,New_Caledonia,NC,0,0,282757,Oceania,23,0
2020-08-30,New_Caledonia,NC,0,0,282757,Oceania,23,0
2020-08-31,New_Caledonia,NC,0,0,282757,Oceania,23,0
2020-09-01,New_Caledonia,NC,0,0,282757,Oceania,23,0
2020-09-02,New_Caledonia,NC,0,0,282757,Oceania,23,0
2020-09-03,New_Caledonia,NC,0,0,282757,Oceania,23,0
2020-09-04,New_Caledonia,NC,3,0,282757,Oceania,26,0
2020-09-05,New_Caledonia,NC,0,0,282757,Oceania,26,0
2020-09-06,New_Caledonia,NC,0,0,282757,Oceania,26,0
2020-09-07,New_Caledonia,NC,0,0,282757,Oceania,26,0
2020-09-08,New_Caledonia,NC,0,0,282757,Oceania,26,0
2020-09-09,New_Caledonia,NC,0,0,282757,Oceania,26,0
2020-09-10,New_Caledonia,NC,0,0,282757,Oceania,26,0
2020-09-11,New_Caledonia,NC,0,0,282757,Oceania,26,0
2020-09-12,New_Caledonia,NC,0,0,282757,Oceania,26,0
2020-09-13,New_Caledonia,NC,0,0,282757,Oceania,26,0
2020-09-14,New_Caledonia,NC,0,0,282757,Oceania,26,0
2020-09-15,New_Caledonia,NC,0,0,282757,Oceania,26,0
2020-09-16,New_Caledonia,NC,0,0,282757,Oceania,26,0
2020-09-17,New_Caledonia,NC,0,0,282757,Oceania,26,0
2020-09-18,New_Caledonia,NC,0,0,282757,Oceania,26,0
2020-09-19,New_Caledonia,NC,0,0,282757,Oceania,26,0
2020-09-20,New_Caledonia,NC,0,0,282757,Oceania,26,0
2020-09-21,New_Caledonia,NC,0,0,282757,Oceania,26,0
2020-09-22,New_Caledonia,NC,0,0,282757,Oceania,26,0
2020-09-23,New_Caledonia,NC,0,0,282757,Oceania,26,0
2020-09-24,New_Caledonia,NC,0,0,282757,Oceania,26,0
2020-09-25,New_Caledonia,NC,0,0,282757,Oceania,26,0
2020-09-26,New_Caledonia,NC,1,0,282757,Oceania,27,0
2020-09-27,New_Caledonia,NC,0,0,282757,Oceania,27,0
2020-09-28,New_Caledonia,NC,0,0,282757,Oceania,27,0
2020-09-29,New_Caledonia,NC,0,0,282757,Oceania,27,0
2020-09-30,New_Caledonia,NC,0,0,282757,Oceania,27,0
2020-10-01,New_Caledonia,NC,0,0,282757,Oceania,27,0
2020-10-02,New_Caledonia,NC,0,0,282757,Oceania,27,0
2020-10-03,New_Caledonia,NC,0,0,282757,Oceania,27,0
2020-10-04,New_Caledonia,NC,0,0,282757,Oceania,27,0
2020-10-05,New_Caledonia,NC,0,0,282757,Oceania,27,0
2020-10-06,New_Caledonia,NC,0,0,282757,Oceania,27,0
2020-10-07,New_Caledonia,NC,0,0,282757,Oceania,27,0
2020-10-08,New_Caledonia,NC,0,0,282757,Oceania,27,0
2020-10-09,New_Caledonia,NC,0,0,282757,Oceania,27,0
2020-10-10,New_Caledonia,NC,0,0,282757,Oceania,27,0
2020-10-11,New_Caledonia,NC,0,0,282757,Oceania,27,0
2020-10-12,New_Caledonia,NC,0,0,282757,Oceania,27,0
2020-10-13,New_Caledonia,NC,0,0,282757,Oceania,27,0
2020-10-14,New_Caledonia,NC,0,0,282757,Oceania,27,0
2020-10-15,New_Caledonia,NC,0,0,282757,Oceania,27,0
2020-10-16,New_Caledonia,NC,0,0,282757,Oceania,27,0
2020-10-17,New_Caledonia,NC,0,0,282757,Oceania,27,0
2020-10-18,New_Caledonia,NC,0,0,282757,Oceania,27,0
2020-10-19,New_Caledonia,NC,0,0,282757,Oceania,27,0
2020-10-20,New_Caledonia,NC,0,0,282757,Oceania,27,0
2020-10-21,New_Caledonia,NC,0,0,282757,Oceania,27,0
2020-10-22,New_Caledonia,NC,0,0,282757,Oceania,27,0
2020-10-23,New_Caledonia,NC,0,0,282757,Oceania,27,0
2020-10-24,New_Caledonia,NC,0,0,282757,Oceania,27,0
2020-10-25,New_Caledonia,NC,0,0,282757,Oceania,27,0
2020-10-26,New_Caledonia,NC,0,0,282757,Oceania,27,0
2020-10-27,New_Caledonia,NC,0,0,282757,Oceania,27,0
2020-10-28,New_Caledonia,NC,0,0,282757,Oceania,27,0
2020-10-29,New_Caledonia,NC,0,0,282757,Oceania,27,0
2020-10-30,New_Caledonia,NC,1,0,282757,Oceania,28,0
2020-10-31,New_Caledonia,NC,0,0,282757,Oceania,28,0
2020-11-01,New_Caledonia,NC,0,0,282757,Oceania,28,0
2020-11-02,New_Caledonia,NC,0,0,282757,Oceania,28,0
2020-11-03,New_Caledonia,NC,0,0,282757,Oceania,28,0
2020-11-04,New_Caledonia,NC,0,0,282757,Oceania,28,0
2020-11-05,New_Caledonia,NC,0,0,282757,Oceania,28,0
2020-11-06,New_Caledonia,NC,1,0,282757,Oceania,29,0
2020-11-07,New_Caledonia,NC,0,0,282757,Oceania,29,0
2020-11-08,New_Caledonia,NC,0,0,282757,Oceania,29,0
2020-11-09,New_Caledonia,NC,0,0,282757,Oceania,29,0
2020-11-10,New_Caledonia,NC,0,0,282757,Oceania,29,0
2020-11-11,New_Caledonia,NC,0,0,282757,Oceania,29,0
2020-11-12,New_Caledonia,NC,1,0,282757,Oceania,30,0
2020-11-13,New_Caledonia,NC,0,0,282757,Oceania,30,0
2020-11-14,New_Caledonia,NC,0,0,282757,Oceania,30,0
2020-11-15,New_Caledonia,NC,0,0,282757,Oceania,30,0
2020-11-16,New_Caledonia,NC,0,0,282757,Oceania,30,0
2020-11-17,New_Caledonia,NC,0,0,282757,Oceania,30,0
2020-11-18,New_Caledonia,NC,0,0,282757,Oceania,30,0
2020-11-19,New_Caledonia,NC,0,0,282757,Oceania,30,0
2020-11-20,New_Caledonia,NC,0,0,282757,Oceania,30,0
2020-11-21,New_Caledonia,NC,2,0,282757,Oceania,32,0
2020-11-22,New_Caledonia,NC,0,0,282757,Oceania,32,0
2020-11-23,New_Caledonia,NC,0,0,282757,Oceania,32,0
2020-11-24,New_Caledonia,NC,0,0,282757,Oceania,32,0
2020-11-25,New_Caledonia,NC,0,0,282757,Oceania,32,0
2020-11-26,New_Caledonia,NC,0,0,282757,Oceania,32,0
2020-11-27,New_Caledonia,NC,0,0,282757,Oceania,32,0
2020-11-28,New_Caledonia,NC,0,0,282757,Oceania,32,0
2020-11-29,New_Caledonia,NC,0,0,282757,Oceania,32,0
2020-11-30,New_Caledonia,NC,0,0,282757,Oceania,32,0
2020-12-01,New_Caledonia,NC,1,0,282757,Oceania,33,0
2020-12-02,New_Caledonia,NC,0,0,282757,Oceania,33,0
2020-12-03,New_Caledonia,NC,1,0,282757,Oceania,34,0
2020-12-04,New_Caledonia,NC,1,0,282757,Oceania,35,0
2020-12-05,New_Caledonia,NC,0,0,282757,Oceania,35,0
2020-12-06,New_Caledonia,NC,0,0,282757,Oceania,35,0
2020-12-07,New_Caledonia,NC,0,0,282757,Oceania,35,0
2020-12-08,New_Caledonia,NC,0,0,282757,Oceania,35,0
2020-12-09,New_Caledonia,NC,1,0,282757,Oceania,36,0
2020-12-10,New_Caledonia,NC,0,0,282757,Oceania,36,0
2020-12-11,New_Caledonia,NC,0,0,282757,Oceania,36,0
2020-12-12,New_Caledonia,NC,0,0,282757,Oceania,36,0
2020-12-13,New_Caledonia,NC,0,0,282757,Oceania,36,0
2020-12-14,New_Caledonia,NC,0,0,282757,Oceania,36,0
2020-03-21,Niger,NE,1,0,23310719,Africa,1,0
2020-03-22,Niger,NE,0,0,23310719,Africa,1,0
2020-03-23,Niger,NE,0,0,23310719,Africa,1,0
2020-03-24,Niger,NE,1,0,23310719,Africa,2,0
2020-03-25,Niger,NE,5,1,23310719,Africa,7,1
2020-03-26,Niger,NE,0,0,23310719,Africa,7,1
2020-03-27,Niger,NE,3,0,23310719,Africa,10,1
2020-03-28,Niger,NE,0,0,23310719,Africa,10,1
2020-03-29,Niger,NE,0,0,23310719,Africa,10,1
2020-03-30,Niger,NE,0,0,23310719,Africa,10,1
2020-03-31,Niger,NE,10,2,23310719,Africa,20,3
2020-04-01,Niger,NE,0,0,23310719,Africa,20,3
2020-04-02,Niger,NE,54,2,23310719,Africa,74,5
2020-04-03,Niger,NE,0,0,23310719,Africa,74,5
2020-04-04,Niger,NE,24,0,23310719,Africa,98,5
2020-04-05,Niger,NE,22,0,23310719,Africa,120,5
2020-04-06,Niger,NE,64,5,23310719,Africa,184,10
2020-04-07,Niger,NE,69,0,23310719,Africa,253,10
2020-04-08,Niger,NE,25,1,23310719,Africa,278,11
2020-04-09,Niger,NE,64,0,23310719,Africa,342,11
2020-04-10,Niger,NE,68,0,23310719,Africa,410,11
2020-04-11,Niger,NE,28,0,23310719,Africa,438,11
2020-04-12,Niger,NE,53,0,23310719,Africa,491,11
2020-04-13,Niger,NE,38,1,23310719,Africa,529,12
2020-04-14,Niger,NE,19,1,23310719,Africa,548,13
2020-04-15,Niger,NE,22,1,23310719,Africa,570,14
2020-04-16,Niger,NE,14,0,23310719,Africa,584,14
2020-04-17,Niger,NE,25,1,23310719,Africa,609,15
2020-04-18,Niger,NE,18,3,23310719,Africa,627,18
2020-04-19,Niger,NE,12,1,23310719,Africa,639,19
2020-04-20,Niger,NE,9,1,23310719,Africa,648,20
2020-04-21,Niger,NE,7,0,23310719,Africa,655,20
2020-04-22,Niger,NE,0,0,23310719,Africa,655,20
2020-04-23,Niger,NE,7,2,23310719,Africa,662,22
2020-04-24,Niger,NE,9,2,23310719,Africa,671,24
2020-04-25,Niger,NE,10,0,23310719,Africa,681,24
2020-04-26,Niger,NE,3,3,23310719,Africa,684,27
2020-04-27,Niger,NE,12,2,23310719,Africa,696,29
2020-04-28,Niger,NE,5,0,23310719,Africa,701,29
2020-04-29,Niger,NE,8,2,23310719,Africa,709,31
2020-04-30,Niger,NE,4,1,23310719,Africa,713,32
2020-05-01,Niger,NE,6,0,23310719,Africa,719,32
2020-05-02,Niger,NE,9,1,23310719,Africa,728,33
2020-05-03,Niger,NE,8,2,23310719,Africa,736,35
2020-05-04,Niger,NE,14,1,23310719,Africa,750,36
2020-05-05,Niger,NE,5,1,23310719,Africa,755,37
2020-05-06,Niger,NE,8,1,23310719,Africa,763,38
2020-05-07,Niger,NE,7,0,23310719,Africa,770,38
2020-05-08,Niger,NE,11,4,23310719,Africa,781,42
2020-05-09,Niger,NE,14,2,23310719,Africa,795,44
2020-05-10,Niger,NE,20,1,23310719,Africa,815,45
2020-05-11,Niger,NE,6,1,23310719,Africa,821,46
2020-05-12,Niger,NE,11,0,23310719,Africa,832,46
2020-05-13,Niger,NE,22,1,23310719,Africa,854,47
2020-05-14,Niger,NE,6,2,23310719,Africa,860,49
2020-05-15,Niger,NE,16,1,23310719,Africa,876,50
2020-05-16,Niger,NE,9,1,23310719,Africa,885,51
2020-05-17,Niger,NE,4,0,23310719,Africa,889,51
2020-05-18,Niger,NE,15,3,23310719,Africa,904,54
2020-05-19,Niger,NE,5,1,23310719,Africa,909,55
2020-05-20,Niger,NE,5,0,23310719,Africa,914,55
2020-05-21,Niger,NE,6,3,23310719,Africa,920,58
2020-05-22,Niger,NE,4,2,23310719,Africa,924,60
2020-05-23,Niger,NE,13,0,23310719,Africa,937,60
2020-05-24,Niger,NE,6,1,23310719,Africa,943,61
2020-05-25,Niger,NE,2,0,23310719,Africa,945,61
2020-05-26,Niger,NE,6,1,23310719,Africa,951,62
2020-05-27,Niger,NE,1,1,23310719,Africa,952,63
2020-05-28,Niger,NE,3,1,23310719,Africa,955,64
2020-05-29,Niger,NE,0,0,23310719,Africa,955,64
2020-05-30,Niger,NE,0,0,23310719,Africa,955,64
2020-05-31,Niger,NE,1,0,23310719,Africa,956,64
2020-06-01,Niger,NE,2,0,23310719,Africa,958,64
2020-06-02,Niger,NE,0,1,23310719,Africa,958,65
2020-06-03,Niger,NE,2,0,23310719,Africa,960,65
2020-06-04,Niger,NE,1,0,23310719,Africa,961,65
2020-06-05,Niger,NE,2,0,23310719,Africa,963,65
2020-06-06,Niger,NE,3,0,23310719,Africa,966,65
2020-06-07,Niger,NE,4,0,23310719,Africa,970,65
2020-06-08,Niger,NE,3,0,23310719,Africa,973,65
2020-06-09,Niger,NE,0,0,23310719,Africa,973,65
2020-06-10,Niger,NE,1,0,23310719,Africa,974,65
2020-06-11,Niger,NE,0,0,23310719,Africa,974,65
2020-06-12,Niger,NE,0,0,23310719,Africa,974,65
2020-06-13,Niger,NE,4,0,23310719,Africa,978,65
2020-06-14,Niger,NE,2,1,23310719,Africa,980,66
2020-06-15,Niger,NE,0,0,23310719,Africa,980,66
2020-06-16,Niger,NE,0,0,23310719,Africa,980,66
2020-06-17,Niger,NE,36,0,23310719,Africa,1016,66
2020-06-18,Niger,NE,4,1,23310719,Africa,1020,67
2020-06-19,Niger,NE,0,0,23310719,Africa,1020,67
2020-06-20,Niger,NE,0,0,23310719,Africa,1020,67
2020-06-21,Niger,NE,15,0,23310719,Africa,1035,67
2020-06-22,Niger,NE,1,0,23310719,Africa,1036,67
2020-06-23,Niger,NE,10,0,23310719,Africa,1046,67
2020-06-24,Niger,NE,5,0,23310719,Africa,1051,67
2020-06-25,Niger,NE,5,0,23310719,Africa,1056,67
2020-06-26,Niger,NE,3,0,23310719,Africa,1059,67
2020-06-27,Niger,NE,3,0,23310719,Africa,1062,67
2020-06-28,Niger,NE,6,0,23310719,Africa,1068,67
2020-06-29,Niger,NE,6,0,23310719,Africa,1074,67
2020-06-30,Niger,NE,1,0,23310719,Africa,1075,67
2020-07-01,Niger,NE,0,0,23310719,Africa,1075,67
2020-07-02,Niger,NE,0,0,23310719,Africa,1075,67
2020-07-03,Niger,NE,6,1,23310719,Africa,1081,68
2020-07-04,Niger,NE,1,0,23310719,Africa,1082,68
2020-07-05,Niger,NE,0,0,23310719,Africa,1082,68
2020-07-06,Niger,NE,11,0,23310719,Africa,1093,68
2020-07-07,Niger,NE,0,0,23310719,Africa,1093,68
2020-07-08,Niger,NE,1,0,23310719,Africa,1094,68
2020-07-09,Niger,NE,3,0,23310719,Africa,1097,68
2020-07-10,Niger,NE,0,0,23310719,Africa,1097,68
2020-07-11,Niger,NE,2,0,23310719,Africa,1099,68
2020-07-12,Niger,NE,0,0,23310719,Africa,1099,68
2020-07-13,Niger,NE,0,0,23310719,Africa,1099,68
2020-07-14,Niger,NE,0,0,23310719,Africa,1099,68
2020-07-15,Niger,NE,0,0,23310719,Africa,1099,68
2020-07-16,Niger,NE,1,1,23310719,Africa,1100,69
2020-07-17,Niger,NE,2,0,23310719,Africa,1102,69
2020-07-18,Niger,NE,0,0,23310719,Africa,1102,69
2020-07-19,Niger,NE,2,0,23310719,Africa,1104,69
2020-07-20,Niger,NE,0,0,23310719,Africa,1104,69
2020-07-21,Niger,NE,1,0,23310719,Africa,1105,69
2020-07-22,Niger,NE,8,0,23310719,Africa,1113,69
2020-07-23,Niger,NE,9,0,23310719,Africa,1122,69
2020-07-24,Niger,NE,2,0,23310719,Africa,1124,69
2020-07-25,Niger,NE,0,0,23310719,Africa,1124,69
2020-07-26,Niger,NE,0,0,23310719,Africa,1124,69
2020-07-27,Niger,NE,8,0,23310719,Africa,1132,69
2020-07-28,Niger,NE,0,0,23310719,Africa,1132,69
2020-07-29,Niger,NE,0,0,23310719,Africa,1132,69
2020-07-30,Niger,NE,2,0,23310719,Africa,1134,69
2020-07-31,Niger,NE,0,0,23310719,Africa,1134,69
2020-08-01,Niger,NE,0,0,23310719,Africa,1134,69
2020-08-02,Niger,NE,2,0,23310719,Africa,1136,69
2020-08-03,Niger,NE,11,0,23310719,Africa,1147,69
2020-08-04,Niger,NE,5,0,23310719,Africa,1152,69
2020-08-05,Niger,NE,0,0,23310719,Africa,1152,69
2020-08-06,Niger,NE,0,0,23310719,Africa,1152,69
2020-08-07,Niger,NE,1,0,23310719,Africa,1153,69
2020-08-08,Niger,NE,0,0,23310719,Africa,1153,69
2020-08-09,Niger,NE,4,0,23310719,Africa,1157,69
2020-08-10,Niger,NE,1,0,23310719,Africa,1158,69
2020-08-11,Niger,NE,0,0,23310719,Africa,1158,69
2020-08-12,Niger,NE,0,0,23310719,Africa,1158,69
2020-08-13,Niger,NE,3,0,23310719,Africa,1161,69
2020-08-14,Niger,NE,0,0,23310719,Africa,1161,69
2020-08-15,Niger,NE,4,0,23310719,Africa,1165,69
2020-08-16,Niger,NE,0,0,23310719,Africa,1165,69
2020-08-17,Niger,NE,2,0,23310719,Africa,1167,69
2020-08-18,Niger,NE,0,0,23310719,Africa,1167,69
2020-08-19,Niger,NE,0,0,23310719,Africa,1167,69
2020-08-20,Niger,NE,0,0,23310719,Africa,1167,69
2020-08-21,Niger,NE,2,0,23310719,Africa,1169,69
2020-08-22,Niger,NE,3,0,23310719,Africa,1172,69
2020-08-23,Niger,NE,0,0,23310719,Africa,1172,69
2020-08-24,Niger,NE,0,0,23310719,Africa,1172,69
2020-08-25,Niger,NE,0,0,23310719,Africa,1172,69
2020-08-26,Niger,NE,1,0,23310719,Africa,1173,69
2020-08-27,Niger,NE,0,0,23310719,Africa,1173,69
2020-08-28,Niger,NE,0,0,23310719,Africa,1173,69
2020-08-29,Niger,NE,2,0,23310719,Africa,1175,69
2020-08-30,Niger,NE,0,0,23310719,Africa,1175,69
2020-08-31,Niger,NE,1,0,23310719,Africa,1176,69
2020-09-01,Niger,NE,0,0,23310719,Africa,1176,69
2020-09-02,Niger,NE,0,0,23310719,Africa,1176,69
2020-09-03,Niger,NE,1,0,23310719,Africa,1177,69
2020-09-04,Niger,NE,0,0,23310719,Africa,1177,69
2020-09-05,Niger,NE,0,0,23310719,Africa,1177,69
2020-09-06,Niger,NE,0,0,23310719,Africa,1177,69
2020-09-07,Niger,NE,0,0,23310719,Africa,1177,69
2020-09-08,Niger,NE,1,0,23310719,Africa,1178,69
2020-09-09,Niger,NE,0,0,23310719,Africa,1178,69
2020-09-10,Niger,NE,0,0,23310719,Africa,1178,69
2020-09-11,Niger,NE,0,0,23310719,Africa,1178,69
2020-09-12,Niger,NE,0,0,23310719,Africa,1178,69
2020-09-13,Niger,NE,0,0,23310719,Africa,1178,69
2020-09-14,Niger,NE,2,0,23310719,Africa,1180,69
2020-09-15,Niger,NE,0,0,23310719,Africa,1180,69
2020-09-16,Niger,NE,0,0,23310719,Africa,1180,69
2020-09-17,Niger,NE,0,0,23310719,Africa,1180,69
2020-09-18,Niger,NE,0,0,23310719,Africa,1180,69
2020-09-19,Niger,NE,2,0,23310719,Africa,1182,69
2020-09-20,Niger,NE,0,0,23310719,Africa,1182,69
2020-09-21,Niger,NE,6,0,23310719,Africa,1188,69
2020-09-22,Niger,NE,1,0,23310719,Africa,1189,69
2020-09-23,Niger,NE,4,0,23310719,Africa,1193,69
2020-09-24,Niger,NE,0,0,23310719,Africa,1193,69
2020-09-25,Niger,NE,1,0,23310719,Africa,1194,69
2020-09-26,Niger,NE,0,0,23310719,Africa,1194,69
2020-09-27,Niger,NE,0,0,23310719,Africa,1194,69
2020-09-28,Niger,NE,2,0,23310719,Africa,1196,69
2020-09-29,Niger,NE,0,0,23310719,Africa,1196,69
2020-09-30,Niger,NE,0,0,23310719,Africa,1196,69
2020-10-01,Niger,NE,1,0,23310719,Africa,1197,69
2020-10-02,Niger,NE,0,0,23310719,Africa,1197,69
2020-10-03,Niger,NE,1,0,23310719,Africa,1198,69
2020-10-04,Niger,NE,2,0,23310719,Africa,1200,69
2020-10-05,Niger,NE,0,0,23310719,Africa,1200,69
2020-10-06,Niger,NE,0,0,23310719,Africa,1200,69
2020-10-07,Niger,NE,0,0,23310719,Africa,1200,69
2020-10-08,Niger,NE,0,0,23310719,Africa,1200,69
2020-10-09,Niger,NE,1,0,23310719,Africa,1201,69
2020-10-10,Niger,NE,0,0,23310719,Africa,1201,69
2020-10-11,Niger,NE,0,0,23310719,Africa,1201,69
2020-10-12,Niger,NE,0,0,23310719,Africa,1201,69
2020-10-13,Niger,NE,1,0,23310719,Africa,1202,69
2020-10-14,Niger,NE,1,0,23310719,Africa,1203,69
2020-10-15,Niger,NE,2,0,23310719,Africa,1205,69
2020-10-16,Niger,NE,2,0,23310719,Africa,1207,69
2020-10-17,Niger,NE,2,0,23310719,Africa,1209,69
2020-10-18,Niger,NE,0,0,23310719,Africa,1209,69
2020-10-19,Niger,NE,1,0,23310719,Africa,1210,69
2020-10-20,Niger,NE,1,0,23310719,Africa,1211,69
2020-10-21,Niger,NE,1,0,23310719,Africa,1212,69
2020-10-22,Niger,NE,2,0,23310719,Africa,1214,69
2020-10-23,Niger,NE,1,0,23310719,Africa,1215,69
2020-10-24,Niger,NE,0,0,23310719,Africa,1215,69
2020-10-25,Niger,NE,0,0,23310719,Africa,1215,69
2020-10-26,Niger,NE,0,0,23310719,Africa,1215,69
2020-10-27,Niger,NE,0,0,23310719,Africa,1215,69
2020-10-28,Niger,NE,3,0,23310719,Africa,1218,69
2020-10-29,Niger,NE,0,0,23310719,Africa,1218,69
2020-10-30,Niger,NE,1,0,23310719,Africa,1219,69
2020-10-31,Niger,NE,1,0,23310719,Africa,1220,69
2020-11-01,Niger,NE,0,0,23310719,Africa,1220,69
2020-11-02,Niger,NE,1,0,23310719,Africa,1221,69
2020-11-03,Niger,NE,1,0,23310719,Africa,1222,69
2020-11-04,Niger,NE,0,0,23310719,Africa,1222,69
2020-11-05,Niger,NE,3,0,23310719,Africa,1225,69
2020-11-06,Niger,NE,1,0,23310719,Africa,1226,69
2020-11-07,Niger,NE,4,0,23310719,Africa,1230,69
2020-11-08,Niger,NE,12,0,23310719,Africa,1242,69
2020-11-09,Niger,NE,1,0,23310719,Africa,1243,69
2020-11-10,Niger,NE,0,0,23310719,Africa,1243,69
2020-11-11,Niger,NE,13,0,23310719,Africa,1256,69
2020-11-12,Niger,NE,7,0,23310719,Africa,1263,69
2020-11-13,Niger,NE,19,0,23310719,Africa,1282,69
2020-11-14,Niger,NE,7,0,23310719,Africa,1289,69
2020-11-15,Niger,NE,12,1,23310719,Africa,1301,70
2020-11-16,Niger,NE,6,0,23310719,Africa,1307,70
2020-11-17,Niger,NE,9,0,23310719,Africa,1316,70
2020-11-18,Niger,NE,11,0,23310719,Africa,1327,70
2020-11-19,Niger,NE,4,0,23310719,Africa,1331,70
2020-11-20,Niger,NE,4,0,23310719,Africa,1335,70
2020-11-21,Niger,NE,5,0,23310719,Africa,1340,70
2020-11-22,Niger,NE,11,0,23310719,Africa,1351,70
2020-11-23,Niger,NE,17,0,23310719,Africa,1368,70
2020-11-24,Niger,NE,13,0,23310719,Africa,1381,70
2020-11-25,Niger,NE,25,0,23310719,Africa,1406,70
2020-11-26,Niger,NE,13,0,23310719,Africa,1419,70
2020-11-27,Niger,NE,24,0,23310719,Africa,1443,70
2020-11-28,Niger,NE,29,0,23310719,Africa,1472,70
2020-11-29,Niger,NE,12,0,23310719,Africa,1484,70
2020-11-30,Niger,NE,32,0,23310719,Africa,1516,70
2020-12-01,Niger,NE,32,2,23310719,Africa,1548,72
2020-12-02,Niger,NE,38,3,23310719,Africa,1586,75
2020-12-03,Niger,NE,54,1,23310719,Africa,1640,76
2020-12-04,Niger,NE,0,0,23310719,Africa,1640,76
2020-12-05,Niger,NE,86,1,23310719,Africa,1726,77
2020-12-06,Niger,NE,63,0,23310719,Africa,1789,77
2020-12-07,Niger,NE,67,0,23310719,Africa,1856,77
2020-12-08,Niger,NE,38,1,23310719,Africa,1894,78
2020-12-09,Niger,NE,93,1,23310719,Africa,1987,79
2020-12-10,Niger,NE,91,0,23310719,Africa,2078,79
2020-12-11,Niger,NE,48,1,23310719,Africa,2126,80
2020-12-12,Niger,NE,34,0,23310719,Africa,2160,80
2020-12-13,Niger,NE,39,0,23310719,Africa,2199,80
2020-12-14,Niger,NE,59,0,23310719,Africa,2258,80
2019-12-31,Nigeria,NG,0,0,200963603,Africa,0,0
2020-01-01,Nigeria,NG,0,0,200963603,Africa,0,0
2020-01-02,Nigeria,NG,0,0,200963603,Africa,0,0
2020-01-03,Nigeria,NG,0,0,200963603,Africa,0,0
2020-01-04,Nigeria,NG,0,0,200963603,Africa,0,0
2020-01-05,Nigeria,NG,0,0,200963603,Africa,0,0
2020-01-06,Nigeria,NG,0,0,200963603,Africa,0,0
2020-01-07,Nigeria,NG,0,0,200963603,Africa,0,0
2020-01-08,Nigeria,NG,0,0,200963603,Africa,0,0
2020-01-09,Nigeria,NG,0,0,200963603,Africa,0,0
2020-01-10,Nigeria,NG,0,0,200963603,Africa,0,0
2020-01-11,Nigeria,NG,0,0,200963603,Africa,0,0
2020-01-12,Nigeria,NG,0,0,200963603,Africa,0,0
2020-01-13,Nigeria,NG,0,0,200963603,Africa,0,0
2020-01-14,Nigeria,NG,0,0,200963603,Africa,0,0
2020-01-15,Nigeria,NG,0,0,200963603,Africa,0,0
2020-01-16,Nigeria,NG,0,0,200963603,Africa,0,0
2020-01-17,Nigeria,NG,0,0,200963603,Africa,0,0
2020-01-18,Nigeria,NG,0,0,200963603,Africa,0,0
2020-01-19,Nigeria,NG,0,0,200963603,Africa,0,0
2020-01-20,Nigeria,NG,0,0,200963603,Africa,0,0
2020-01-21,Nigeria,NG,0,0,200963603,Africa,0,0
2020-01-22,Nigeria,NG,0,0,200963603,Africa,0,0
2020-01-23,Nigeria,NG,0,0,200963603,Africa,0,0
2020-01-24,Nigeria,NG,0,0,200963603,Africa,0,0
2020-01-25,Nigeria,NG,0,0,200963603,Africa,0,0
2020-01-26,Nigeria,NG,0,0,200963603,Africa,0,0
2020-01-27,Nigeria,NG,0,0,200963603,Africa,0,0
2020-01-28,Nigeria,NG,0,0,200963603,Africa,0,0
2020-01-29,Nigeria,NG,0,0,200963603,Africa,0,0
2020-01-30,Nigeria,NG,0,0,200963603,Africa,0,0
2020-01-31,Nigeria,NG,0,0,200963603,Africa,0,0
2020-02-01,Nigeria,NG,0,0,200963603,Africa,0,0
2020-02-02,Nigeria,NG,0,0,200963603,Africa,0,0
2020-02-03,Nigeria,NG,0,0,200963603,Africa,0,0
2020-02-04,Nigeria,NG,0,0,200963603,Africa,0,0
2020-02-05,Nigeria,NG,0,0,200963603,Africa,0,0
2020-02-06,Nigeria,NG,0,0,200963603,Africa,0,0
2020-02-07,Nigeria,NG,0,0,200963603,Africa,0,0
2020-02-08,Nigeria,NG,0,0,200963603,Africa,0,0
2020-02-09,Nigeria,NG,0,0,200963603,Africa,0,0
2020-02-10,Nigeria,NG,0,0,200963603,Africa,0,0
2020-02-11,Nigeria,NG,0,0,200963603,Africa,0,0
2020-02-12,Nigeria,NG,0,0,200963603,Africa,0,0
2020-02-13,Nigeria,NG,0,0,200963603,Africa,0,0
2020-02-14,Nigeria,NG,0,0,200963603,Africa,0,0
2020-02-15,Nigeria,NG,0,0,200963603,Africa,0,0
2020-02-16,Nigeria,NG,0,0,200963603,Africa,0,0
2020-02-17,Nigeria,NG,0,0,200963603,Africa,0,0
2020-02-18,Nigeria,NG,0,0,200963603,Africa,0,0
2020-02-19,Nigeria,NG,0,0,200963603,Africa,0,0
2020-02-20,Nigeria,NG,0,0,200963603,Africa,0,0
2020-02-21,Nigeria,NG,0,0,200963603,Africa,0,0
2020-02-22,Nigeria,NG,0,0,200963603,Africa,0,0
2020-02-23,Nigeria,NG,0,0,200963603,Africa,0,0
2020-02-24,Nigeria,NG,0,0,200963603,Africa,0,0
2020-02-25,Nigeria,NG,0,0,200963603,Africa,0,0
2020-02-26,Nigeria,NG,0,0,200963603,Africa,0,0
2020-02-27,Nigeria,NG,0,0,200963603,Africa,0,0
2020-02-28,Nigeria,NG,1,0,200963603,Africa,1,0
2020-02-29,Nigeria,NG,0,0,200963603,Africa,1,0
2020-03-01,Nigeria,NG,0,0,200963603,Africa,1,0
2020-03-02,Nigeria,NG,0,0,200963603,Africa,1,0
2020-03-10,Nigeria,NG,1,0,200963603,Africa,2,0
2020-03-15,Nigeria,NG,0,0,200963603,Africa,2,0
2020-03-16,Nigeria,NG,0,0,200963603,Africa,2,0
2020-03-17,Nigeria,NG,0,0,200963603,Africa,2,0
2020-03-18,Nigeria,NG,1,0,200963603,Africa,3,0
2020-03-19,Nigeria,NG,5,0,200963603,Africa,8,0
2020-03-20,Nigeria,NG,0,0,200963603,Africa,8,0
2020-03-21,Nigeria,NG,4,0,200963603,Africa,12,0
2020-03-22,Nigeria,NG,10,0,200963603,Africa,22,0
2020-03-23,Nigeria,NG,8,0,200963603,Africa,30,0
2020-03-24,Nigeria,NG,10,1,200963603,Africa,40,1
2020-03-25,Nigeria,NG,4,0,200963603,Africa,44,1
2020-03-26,Nigeria,NG,7,0,200963603,Africa,51,1
2020-03-27,Nigeria,NG,14,0,200963603,Africa,65,1
2020-03-28,Nigeria,NG,16,0,200963603,Africa,81,1
2020-03-29,Nigeria,NG,16,0,200963603,Africa,97,1
2020-03-30,Nigeria,NG,0,0,200963603,Africa,97,1
2020-03-31,Nigeria,NG,34,1,200963603,Africa,131,2
2020-04-01,Nigeria,NG,0,0,200963603,Africa,131,2
2020-04-02,Nigeria,NG,20,0,200963603,Africa,151,2
2020-04-03,Nigeria,NG,23,0,200963603,Africa,174,2
2020-04-04,Nigeria,NG,16,0,200963603,Africa,190,2
2020-04-05,Nigeria,NG,20,2,200963603,Africa,210,4
2020-04-06,Nigeria,NG,22,1,200963603,Africa,232,5
2020-04-07,Nigeria,NG,6,0,200963603,Africa,238,5
2020-04-08,Nigeria,NG,16,1,200963603,Africa,254,6
2020-04-09,Nigeria,NG,22,0,200963603,Africa,276,6
2020-04-10,Nigeria,NG,12,1,200963603,Africa,288,7
2020-04-11,Nigeria,NG,17,0,200963603,Africa,305,7
2020-04-12,Nigeria,NG,13,3,200963603,Africa,318,10
2020-04-13,Nigeria,NG,5,0,200963603,Africa,323,10
2020-04-14,Nigeria,NG,20,0,200963603,Africa,343,10
2020-04-15,Nigeria,NG,30,1,200963603,Africa,373,11
2020-04-16,Nigeria,NG,34,1,200963603,Africa,407,12
2020-04-17,Nigeria,NG,35,1,200963603,Africa,442,13
2020-04-18,Nigeria,NG,51,4,200963603,Africa,493,17
2020-04-19,Nigeria,NG,49,2,200963603,Africa,542,19
2020-04-20,Nigeria,NG,85,2,200963603,Africa,627,21
2020-04-21,Nigeria,NG,38,1,200963603,Africa,665,22
2020-04-22,Nigeria,NG,117,3,200963603,Africa,782,25
2020-04-23,Nigeria,NG,91,3,200963603,Africa,873,28
2020-04-24,Nigeria,NG,108,3,200963603,Africa,981,31
2020-04-25,Nigeria,NG,114,1,200963603,Africa,1095,32
2020-04-26,Nigeria,NG,87,3,200963603,Africa,1182,35
2020-04-27,Nigeria,NG,91,5,200963603,Africa,1273,40
2020-04-28,Nigeria,NG,64,0,200963603,Africa,1337,40
2020-04-29,Nigeria,NG,195,4,200963603,Africa,1532,44
2020-04-30,Nigeria,NG,196,7,200963603,Africa,1728,51
2020-05-01,Nigeria,NG,204,7,200963603,Africa,1932,58
2020-05-02,Nigeria,NG,238,10,200963603,Africa,2170,68
2020-05-03,Nigeria,NG,218,17,200963603,Africa,2388,85
2020-05-04,Nigeria,NG,170,2,200963603,Africa,2558,87
2020-05-05,Nigeria,NG,244,6,200963603,Africa,2802,93
2020-05-06,Nigeria,NG,148,5,200963603,Africa,2950,98
2020-05-07,Nigeria,NG,195,5,200963603,Africa,3145,103
2020-05-08,Nigeria,NG,381,4,200963603,Africa,3526,107
2020-05-09,Nigeria,NG,386,10,200963603,Africa,3912,117
2020-05-10,Nigeria,NG,239,11,200963603,Africa,4151,128
2020-05-11,Nigeria,NG,248,15,200963603,Africa,4399,143
2020-05-12,Nigeria,NG,242,7,200963603,Africa,4641,150
2020-05-13,Nigeria,NG,146,8,200963603,Africa,4787,158
2020-05-14,Nigeria,NG,184,6,200963603,Africa,4971,164
2020-05-15,Nigeria,NG,191,3,200963603,Africa,5162,167
2020-05-16,Nigeria,NG,283,4,200963603,Africa,5445,171
2020-05-17,Nigeria,NG,176,5,200963603,Africa,5621,176
2020-05-18,Nigeria,NG,338,6,200963603,Africa,5959,182
2020-05-19,Nigeria,NG,216,9,200963603,Africa,6175,191
2020-05-20,Nigeria,NG,226,1,200963603,Africa,6401,192
2020-05-21,Nigeria,NG,276,8,200963603,Africa,6677,200
2020-05-22,Nigeria,NG,339,11,200963603,Africa,7016,211
2020-05-23,Nigeria,NG,245,10,200963603,Africa,7261,221
2020-05-24,Nigeria,NG,265,0,200963603,Africa,7526,221
2020-05-25,Nigeria,NG,313,5,200963603,Africa,7839,226
2020-05-26,Nigeria,NG,229,7,200963603,Africa,8068,233
2020-05-27,Nigeria,NG,276,16,200963603,Africa,8344,249
2020-05-28,Nigeria,NG,389,5,200963603,Africa,8733,254
2020-05-29,Nigeria,NG,182,5,200963603,Africa,8915,259
2020-05-30,Nigeria,NG,387,2,200963603,Africa,9302,261
2020-05-31,Nigeria,NG,553,12,200963603,Africa,9855,273
2020-06-01,Nigeria,NG,307,14,200963603,Africa,10162,287
2020-06-02,Nigeria,NG,416,12,200963603,Africa,10578,299
2020-06-03,Nigeria,NG,241,15,200963603,Africa,10819,314
2020-06-04,Nigeria,NG,347,1,200963603,Africa,11166,315
2020-06-05,Nigeria,NG,350,8,200963603,Africa,11516,323
2020-06-06,Nigeria,NG,328,10,200963603,Africa,11844,333
2020-06-07,Nigeria,NG,389,9,200963603,Africa,12233,342
2020-06-08,Nigeria,NG,253,12,200963603,Africa,12486,354
2020-06-09,Nigeria,NG,315,7,200963603,Africa,12801,361
2020-06-10,Nigeria,NG,663,4,200963603,Africa,13464,365
2020-06-11,Nigeria,NG,409,17,200963603,Africa,13873,382
2020-06-12,Nigeria,NG,681,5,200963603,Africa,14554,387
2020-06-13,Nigeria,NG,627,12,200963603,Africa,15181,399
2020-06-14,Nigeria,NG,501,8,200963603,Africa,15682,407
2020-06-15,Nigeria,NG,403,13,200963603,Africa,16085,420
2020-06-16,Nigeria,NG,573,4,200963603,Africa,16658,424
2020-06-17,Nigeria,NG,490,31,200963603,Africa,17148,455
2020-06-18,Nigeria,NG,587,14,200963603,Africa,17735,469
2020-06-19,Nigeria,NG,745,6,200963603,Africa,18480,475
2020-06-20,Nigeria,NG,667,12,200963603,Africa,19147,487
2020-06-21,Nigeria,NG,661,19,200963603,Africa,19808,506
2020-06-22,Nigeria,NG,436,12,200963603,Africa,20244,518
2020-06-23,Nigeria,NG,675,7,200963603,Africa,20919,525
2020-06-24,Nigeria,NG,452,8,200963603,Africa,21371,533
2020-06-25,Nigeria,NG,649,9,200963603,Africa,22020,542
2020-06-26,Nigeria,NG,594,7,200963603,Africa,22614,549
2020-06-27,Nigeria,NG,684,5,200963603,Africa,23298,554
2020-06-28,Nigeria,NG,779,4,200963603,Africa,24077,558
2020-06-29,Nigeria,NG,490,7,200963603,Africa,24567,565
2020-06-30,Nigeria,NG,566,8,200963603,Africa,25133,573
2020-07-01,Nigeria,NG,561,17,200963603,Africa,25694,590
2020-07-02,Nigeria,NG,790,13,200963603,Africa,26484,603
2020-07-03,Nigeria,NG,626,13,200963603,Africa,27110,616
2020-07-04,Nigeria,NG,454,12,200963603,Africa,27564,628
2020-07-05,Nigeria,NG,603,6,200963603,Africa,28167,634
2020-07-06,Nigeria,NG,544,11,200963603,Africa,28711,645
2020-07-07,Nigeria,NG,575,9,200963603,Africa,29286,654
2020-07-08,Nigeria,NG,503,15,200963603,Africa,29789,669
2020-07-09,Nigeria,NG,460,15,200963603,Africa,30249,684
2020-07-10,Nigeria,NG,499,5,200963603,Africa,30748,689
2020-07-11,Nigeria,NG,575,20,200963603,Africa,31323,709
2020-07-12,Nigeria,NG,664,15,200963603,Africa,31987,724
2020-07-13,Nigeria,NG,571,16,200963603,Africa,32558,740
2020-07-14,Nigeria,NG,595,4,200963603,Africa,33153,744
2020-07-15,Nigeria,NG,463,10,200963603,Africa,33616,754
2020-07-16,Nigeria,NG,643,6,200963603,Africa,34259,760
2020-07-17,Nigeria,NG,595,9,200963603,Africa,34854,769
2020-07-18,Nigeria,NG,600,3,200963603,Africa,35454,772
2020-07-19,Nigeria,NG,653,6,200963603,Africa,36107,778
2020-07-20,Nigeria,NG,556,11,200963603,Africa,36663,789
2020-07-21,Nigeria,NG,562,12,200963603,Africa,37225,801
2020-07-22,Nigeria,NG,576,4,200963603,Africa,37801,805
2020-07-23,Nigeria,NG,543,8,200963603,Africa,38344,813
2020-07-24,Nigeria,NG,604,20,200963603,Africa,38948,833
2020-07-25,Nigeria,NG,591,12,200963603,Africa,39539,845
2020-07-26,Nigeria,NG,438,11,200963603,Africa,39977,856
2020-07-27,Nigeria,NG,555,2,200963603,Africa,40532,858
2020-07-28,Nigeria,NG,648,2,200963603,Africa,41180,860
2020-07-29,Nigeria,NG,624,8,200963603,Africa,41804,868
2020-07-30,Nigeria,NG,404,5,200963603,Africa,42208,873
2020-07-31,Nigeria,NG,481,5,200963603,Africa,42689,878
2020-08-01,Nigeria,NG,462,1,200963603,Africa,43151,879
2020-08-02,Nigeria,NG,386,4,200963603,Africa,43537,883
2020-08-03,Nigeria,NG,304,5,200963603,Africa,43841,888
2020-08-04,Nigeria,NG,288,8,200963603,Africa,44129,896
2020-08-05,Nigeria,NG,304,14,200963603,Africa,44433,910
2020-08-06,Nigeria,NG,457,17,200963603,Africa,44890,927
2020-08-07,Nigeria,NG,354,3,200963603,Africa,45244,930
2020-08-08,Nigeria,NG,443,6,200963603,Africa,45687,936
2020-08-09,Nigeria,NG,453,6,200963603,Africa,46140,942
2020-08-10,Nigeria,NG,437,3,200963603,Africa,46577,945
2020-08-11,Nigeria,NG,290,5,200963603,Africa,46867,950
2020-08-12,Nigeria,NG,423,6,200963603,Africa,47290,956
2020-08-13,Nigeria,NG,453,0,200963603,Africa,47743,956
2020-08-14,Nigeria,NG,373,10,200963603,Africa,48116,966
2020-08-15,Nigeria,NG,329,7,200963603,Africa,48445,973
2020-08-16,Nigeria,NG,325,1,200963603,Africa,48770,974
2020-08-17,Nigeria,NG,298,1,200963603,Africa,49068,975
2020-08-18,Nigeria,NG,417,2,200963603,Africa,49485,977
2020-08-19,Nigeria,NG,410,4,200963603,Africa,49895,981
2020-08-20,Nigeria,NG,593,4,200963603,Africa,50488,985
2020-08-21,Nigeria,NG,476,7,200963603,Africa,50964,992
2020-08-22,Nigeria,NG,340,4,200963603,Africa,51304,996
2020-08-23,Nigeria,NG,601,1,200963603,Africa,51905,997
2020-08-24,Nigeria,NG,322,5,200963603,Africa,52227,1002
2020-08-25,Nigeria,NG,321,2,200963603,Africa,52548,1004
2020-08-26,Nigeria,NG,252,3,200963603,Africa,52800,1007
2020-08-27,Nigeria,NG,221,3,200963603,Africa,53021,1010
2020-08-28,Nigeria,NG,296,1,200963603,Africa,53317,1011
2020-08-29,Nigeria,NG,160,0,200963603,Africa,53477,1011
2020-08-30,Nigeria,NG,250,0,200963603,Africa,53727,1011
2020-08-31,Nigeria,NG,138,2,200963603,Africa,53865,1013
2020-09-01,Nigeria,NG,143,0,200963603,Africa,54008,1013
2020-09-02,Nigeria,NG,239,10,200963603,Africa,54247,1023
2020-09-03,Nigeria,NG,216,4,200963603,Africa,54463,1027
2020-09-04,Nigeria,NG,124,21,200963603,Africa,54587,1048
2020-09-05,Nigeria,NG,156,3,200963603,Africa,54743,1051
2020-09-06,Nigeria,NG,162,3,200963603,Africa,54905,1054
2020-09-07,Nigeria,NG,100,3,200963603,Africa,55005,1057
2020-09-08,Nigeria,NG,155,4,200963603,Africa,55160,1061
2020-09-09,Nigeria,NG,296,6,200963603,Africa,55456,1067
2020-09-10,Nigeria,NG,176,3,200963603,Africa,55632,1070
2020-09-11,Nigeria,NG,197,5,200963603,Africa,55829,1075
2020-09-12,Nigeria,NG,188,1,200963603,Africa,56017,1076
2020-09-13,Nigeria,NG,160,2,200963603,Africa,56177,1078
2020-09-14,Nigeria,NG,79,4,200963603,Africa,56256,1082
2020-09-15,Nigeria,NG,132,1,200963603,Africa,56388,1083
2020-09-16,Nigeria,NG,90,5,200963603,Africa,56478,1088
2020-09-17,Nigeria,NG,126,3,200963603,Africa,56604,1091
2020-09-18,Nigeria,NG,131,2,200963603,Africa,56735,1093
2020-09-19,Nigeria,NG,221,1,200963603,Africa,56956,1094
2020-09-20,Nigeria,NG,189,1,200963603,Africa,57145,1095
2020-09-21,Nigeria,NG,97,3,200963603,Africa,57242,1098
2020-09-22,Nigeria,NG,195,2,200963603,Africa,57437,1100
2020-09-23,Nigeria,NG,176,0,200963603,Africa,57613,1100
2020-09-24,Nigeria,NG,111,2,200963603,Africa,57724,1102
2020-09-25,Nigeria,NG,125,0,200963603,Africa,57849,1102
2020-09-26,Nigeria,NG,213,1,200963603,Africa,58062,1103
2020-09-27,Nigeria,NG,136,3,200963603,Africa,58198,1106
2020-09-28,Nigeria,NG,126,2,200963603,Africa,58324,1108
2020-09-29,Nigeria,NG,136,3,200963603,Africa,58460,1111
2020-09-30,Nigeria,NG,187,0,200963603,Africa,58647,1111
2020-10-01,Nigeria,NG,201,1,200963603,Africa,58848,1112
2020-10-02,Nigeria,NG,153,0,200963603,Africa,59001,1112
2020-10-03,Nigeria,NG,126,0,200963603,Africa,59127,1112
2020-10-04,Nigeria,NG,160,1,200963603,Africa,59287,1113
2020-10-05,Nigeria,NG,58,0,200963603,Africa,59345,1113
2020-10-06,Nigeria,NG,120,0,200963603,Africa,59465,1113
2020-10-07,Nigeria,NG,118,0,200963603,Africa,59583,1113
2020-10-08,Nigeria,NG,155,0,200963603,Africa,59738,1113
2020-10-09,Nigeria,NG,103,0,200963603,Africa,59841,1113
2020-10-10,Nigeria,NG,151,0,200963603,Africa,59992,1113
2020-10-11,Nigeria,NG,111,2,200963603,Africa,60103,1115
2020-10-12,Nigeria,NG,163,0,200963603,Africa,60266,1115
2020-10-13,Nigeria,NG,164,0,200963603,Africa,60430,1115
2020-10-14,Nigeria,NG,225,1,200963603,Africa,60655,1116
2020-10-15,Nigeria,NG,179,0,200963603,Africa,60834,1116
2020-10-16,Nigeria,NG,0,0,200963603,Africa,60834,1116
2020-10-17,Nigeria,NG,360,3,200963603,Africa,61194,1119
2020-10-18,Nigeria,NG,113,4,200963603,Africa,61307,1123
2020-10-19,Nigeria,NG,133,2,200963603,Africa,61440,1125
2020-10-20,Nigeria,NG,118,0,200963603,Africa,61558,1125
2020-10-21,Nigeria,NG,72,0,200963603,Africa,61630,1125
2020-10-22,Nigeria,NG,37,0,200963603,Africa,61667,1125
2020-10-23,Nigeria,NG,138,2,200963603,Africa,61805,1127
2020-10-24,Nigeria,NG,77,2,200963603,Africa,61882,1129
2020-10-25,Nigeria,NG,48,0,200963603,Africa,61930,1129
2020-10-26,Nigeria,NG,62,1,200963603,Africa,61992,1130
2020-10-27,Nigeria,NG,119,2,200963603,Africa,62111,1132
2020-10-28,Nigeria,NG,113,3,200963603,Africa,62224,1135
2020-10-29,Nigeria,NG,147,4,200963603,Africa,62371,1139
2020-10-30,Nigeria,NG,150,2,200963603,Africa,62521,1141
2020-10-31,Nigeria,NG,170,3,200963603,Africa,62691,1144
2020-11-01,Nigeria,NG,162,0,200963603,Africa,62853,1144
2020-11-02,Nigeria,NG,111,2,200963603,Africa,62964,1146
2020-11-03,Nigeria,NG,72,1,200963603,Africa,63036,1147
2020-11-04,Nigeria,NG,137,4,200963603,Africa,63173,1151
2020-11-05,Nigeria,NG,155,3,200963603,Africa,63328,1154
2020-11-06,Nigeria,NG,180,0,200963603,Africa,63508,1154
2020-11-07,Nigeria,NG,223,0,200963603,Africa,63731,1154
2020-11-08,Nigeria,NG,59,0,200963603,Africa,63790,1154
2020-11-09,Nigeria,NG,300,0,200963603,Africa,64090,1154
2020-11-10,Nigeria,NG,94,4,200963603,Africa,64184,1158
2020-11-11,Nigeria,NG,152,2,200963603,Africa,64336,1160
2020-11-12,Nigeria,NG,180,2,200963603,Africa,64516,1162
2020-11-13,Nigeria,NG,212,0,200963603,Africa,64728,1162
2020-11-14,Nigeria,NG,156,1,200963603,Africa,64884,1163
2020-11-15,Nigeria,NG,112,0,200963603,Africa,64996,1163
2020-11-16,Nigeria,NG,152,0,200963603,Africa,65148,1163
2020-11-17,Nigeria,NG,157,0,200963603,Africa,65305,1163
2020-11-18,Nigeria,NG,152,0,200963603,Africa,65457,1163
2020-11-19,Nigeria,NG,236,0,200963603,Africa,65693,1163
2020-11-20,Nigeria,NG,146,2,200963603,Africa,65839,1165
2020-11-21,Nigeria,NG,143,0,200963603,Africa,65982,1165
2020-11-22,Nigeria,NG,246,1,200963603,Africa,66228,1166
2020-11-23,Nigeria,NG,155,1,200963603,Africa,66383,1167
2020-11-24,Nigeria,NG,56,1,200963603,Africa,66439,1168
2020-11-25,Nigeria,NG,168,1,200963603,Africa,66607,1169
2020-11-26,Nigeria,NG,198,0,200963603,Africa,66805,1169
2020-11-27,Nigeria,NG,169,0,200963603,Africa,66974,1169
2020-11-28,Nigeria,NG,246,2,200963603,Africa,67220,1171
2020-11-29,Nigeria,NG,110,0,200963603,Africa,67330,1171
2020-11-30,Nigeria,NG,82,2,200963603,Africa,67412,1173
2020-12-01,Nigeria,NG,145,0,200963603,Africa,67557,1173
2020-12-02,Nigeria,NG,326,3,200963603,Africa,67883,1176
2020-12-03,Nigeria,NG,77,1,200963603,Africa,67960,1177
2020-12-04,Nigeria,NG,343,2,200963603,Africa,68303,1179
2020-12-05,Nigeria,NG,324,0,200963603,Africa,68627,1179
2020-12-06,Nigeria,NG,310,1,200963603,Africa,68937,1180
2020-12-07,Nigeria,NG,318,0,200963603,Africa,69255,1180
2020-12-08,Nigeria,NG,390,1,200963603,Africa,69645,1181
2020-12-09,Nigeria,NG,550,1,200963603,Africa,70195,1182
2020-12-10,Nigeria,NG,474,2,200963603,Africa,70669,1184
2020-12-11,Nigeria,NG,675,6,200963603,Africa,71344,1190
2020-12-12,Nigeria,NG,796,0,200963603,Africa,72140,1190
2020-12-13,Nigeria,NG,617,4,200963603,Africa,72757,1194
2020-12-14,Nigeria,NG,418,3,200963603,Africa,73175,1197
2020-03-19,Nicaragua,NI,1,0,6545503,America,1,0
2020-03-20,Nicaragua,NI,0,0,6545503,America,1,0
2020-03-21,Nicaragua,NI,1,0,6545503,America,2,0
2020-03-22,Nicaragua,NI,0,0,6545503,America,2,0
2020-03-23,Nicaragua,NI,0,0,6545503,America,2,0
2020-03-24,Nicaragua,NI,0,0,6545503,America,2,0
2020-03-25,Nicaragua,NI,0,0,6545503,America,2,0
2020-03-26,Nicaragua,NI,0,0,6545503,America,2,0
2020-03-27,Nicaragua,NI,0,0,6545503,America,2,0
2020-03-28,Nicaragua,NI,0,1,6545503,America,2,1
2020-03-29,Nicaragua,NI,2,0,6545503,America,4,1
2020-03-30,Nicaragua,NI,0,0,6545503,America,4,1
2020-03-31,Nicaragua,NI,0,0,6545503,America,4,1
2020-04-01,Nicaragua,NI,0,0,6545503,America,4,1
2020-04-02,Nicaragua,NI,1,0,6545503,America,5,1
2020-04-03,Nicaragua,NI,0,0,6545503,America,5,1
2020-04-04,Nicaragua,NI,0,0,6545503,America,5,1
2020-04-05,Nicaragua,NI,0,0,6545503,America,5,1
2020-04-06,Nicaragua,NI,0,0,6545503,America,5,1
2020-04-07,Nicaragua,NI,1,0,6545503,America,6,1
2020-04-08,Nicaragua,NI,0,0,6545503,America,6,1
2020-04-09,Nicaragua,NI,0,0,6545503,America,6,1
2020-04-10,Nicaragua,NI,0,0,6545503,America,6,1
2020-04-11,Nicaragua,NI,1,0,6545503,America,7,1
2020-04-12,Nicaragua,NI,0,0,6545503,America,7,1
2020-04-13,Nicaragua,NI,2,0,6545503,America,9,1
2020-04-14,Nicaragua,NI,0,0,6545503,America,9,1
2020-04-15,Nicaragua,NI,0,0,6545503,America,9,1
2020-04-16,Nicaragua,NI,0,0,6545503,America,9,1
2020-04-17,Nicaragua,NI,0,0,6545503,America,9,1
2020-04-18,Nicaragua,NI,0,0,6545503,America,9,1
2020-04-19,Nicaragua,NI,0,0,6545503,America,9,1
2020-04-20,Nicaragua,NI,0,0,6545503,America,9,1
2020-04-21,Nicaragua,NI,0,1,6545503,America,9,2
2020-04-22,Nicaragua,NI,1,0,6545503,America,10,2
2020-04-23,Nicaragua,NI,0,0,6545503,America,10,2
2020-04-24,Nicaragua,NI,0,0,6545503,America,10,2
2020-04-25,Nicaragua,NI,1,1,6545503,America,11,3
2020-04-26,Nicaragua,NI,1,0,6545503,America,12,3
2020-04-27,Nicaragua,NI,1,0,6545503,America,13,3
2020-04-28,Nicaragua,NI,0,0,6545503,America,13,3
2020-04-29,Nicaragua,NI,0,0,6545503,America,13,3
2020-04-30,Nicaragua,NI,1,1,6545503,America,14,4
2020-05-01,Nicaragua,NI,0,0,6545503,America,14,4
2020-05-02,Nicaragua,NI,0,0,6545503,America,14,4
2020-05-03,Nicaragua,NI,0,0,6545503,America,14,4
2020-05-04,Nicaragua,NI,0,1,6545503,America,14,5
2020-05-05,Nicaragua,NI,1,0,6545503,America,15,5
2020-05-06,Nicaragua,NI,1,0,6545503,America,16,5
2020-05-07,Nicaragua,NI,0,0,6545503,America,16,5
2020-05-08,Nicaragua,NI,0,0,6545503,America,16,5
2020-05-09,Nicaragua,NI,0,0,6545503,America,16,5
2020-05-10,Nicaragua,NI,0,0,6545503,America,16,5
2020-05-11,Nicaragua,NI,0,0,6545503,America,16,5
2020-05-12,Nicaragua,NI,0,0,6545503,America,16,5
2020-05-13,Nicaragua,NI,9,3,6545503,America,25,8
2020-05-14,Nicaragua,NI,0,0,6545503,America,25,8
2020-05-15,Nicaragua,NI,0,0,6545503,America,25,8
2020-05-16,Nicaragua,NI,0,0,6545503,America,25,8
2020-05-17,Nicaragua,NI,0,0,6545503,America,25,8
2020-05-18,Nicaragua,NI,0,0,6545503,America,25,8
2020-05-19,Nicaragua,NI,0,0,6545503,America,25,8
2020-05-20,Nicaragua,NI,0,0,6545503,America,25,8
2020-05-21,Nicaragua,NI,0,0,6545503,America,25,8
2020-05-22,Nicaragua,NI,0,0,6545503,America,25,8
2020-05-23,Nicaragua,NI,254,9,6545503,America,279,17
2020-05-24,Nicaragua,NI,0,0,6545503,America,279,17
2020-05-25,Nicaragua,NI,0,0,6545503,America,279,17
2020-05-26,Nicaragua,NI,0,0,6545503,America,279,17
2020-05-27,Nicaragua,NI,480,18,6545503,America,759,35
2020-05-28,Nicaragua,NI,0,0,6545503,America,759,35
2020-05-29,Nicaragua,NI,0,0,6545503,America,759,35
2020-05-30,Nicaragua,NI,0,0,6545503,America,759,35
2020-05-31,Nicaragua,NI,0,0,6545503,America,759,35
2020-06-01,Nicaragua,NI,0,0,6545503,America,759,35
2020-06-02,Nicaragua,NI,0,0,6545503,America,759,35
2020-06-03,Nicaragua,NI,359,11,6545503,America,1118,46
2020-06-04,Nicaragua,NI,0,0,6545503,America,1118,46
2020-06-05,Nicaragua,NI,0,0,6545503,America,1118,46
2020-06-06,Nicaragua,NI,0,0,6545503,America,1118,46
2020-06-07,Nicaragua,NI,191,0,6545503,America,1309,46
2020-06-08,Nicaragua,NI,0,0,6545503,America,1309,46
2020-06-09,Nicaragua,NI,0,0,6545503,America,1309,46
2020-06-10,Nicaragua,NI,0,0,6545503,America,1309,46
2020-06-11,Nicaragua,NI,155,9,6545503,America,1464,55
2020-06-12,Nicaragua,NI,0,0,6545503,America,1464,55
2020-06-13,Nicaragua,NI,191,0,6545503,America,1655,55
2020-06-14,Nicaragua,NI,0,0,6545503,America,1655,55
2020-06-15,Nicaragua,NI,0,0,6545503,America,1655,55
2020-06-16,Nicaragua,NI,0,0,6545503,America,1655,55
2020-06-17,Nicaragua,NI,168,9,6545503,America,1823,64
2020-06-18,Nicaragua,NI,191,0,6545503,America,2014,64
2020-06-19,Nicaragua,NI,0,0,6545503,America,2014,64
2020-06-20,Nicaragua,NI,0,0,6545503,America,2014,64
2020-06-21,Nicaragua,NI,0,0,6545503,America,2014,64
2020-06-22,Nicaragua,NI,0,0,6545503,America,2014,64
2020-06-23,Nicaragua,NI,0,0,6545503,America,2014,64
2020-06-24,Nicaragua,NI,156,10,6545503,America,2170,74
2020-06-25,Nicaragua,NI,0,0,6545503,America,2170,74
2020-06-26,Nicaragua,NI,0,0,6545503,America,2170,74
2020-06-27,Nicaragua,NI,0,0,6545503,America,2170,74
2020-06-28,Nicaragua,NI,0,0,6545503,America,2170,74
2020-06-29,Nicaragua,NI,0,0,6545503,America,2170,74
2020-06-30,Nicaragua,NI,0,0,6545503,America,2170,74
2020-07-01,Nicaragua,NI,349,9,6545503,America,2519,83
2020-07-02,Nicaragua,NI,0,0,6545503,America,2519,83
2020-07-03,Nicaragua,NI,0,0,6545503,America,2519,83
2020-07-04,Nicaragua,NI,0,0,6545503,America,2519,83
2020-07-05,Nicaragua,NI,0,0,6545503,America,2519,83
2020-07-06,Nicaragua,NI,0,0,6545503,America,2519,83
2020-07-07,Nicaragua,NI,0,0,6545503,America,2519,83
2020-07-08,Nicaragua,NI,327,8,6545503,America,2846,91
2020-07-09,Nicaragua,NI,0,0,6545503,America,2846,91
2020-07-10,Nicaragua,NI,0,0,6545503,America,2846,91
2020-07-11,Nicaragua,NI,0,0,6545503,America,2846,91
2020-07-12,Nicaragua,NI,0,0,6545503,America,2846,91
2020-07-13,Nicaragua,NI,0,0,6545503,America,2846,91
2020-07-14,Nicaragua,NI,0,0,6545503,America,2846,91
2020-07-15,Nicaragua,NI,301,8,6545503,America,3147,99
2020-07-16,Nicaragua,NI,0,0,6545503,America,3147,99
2020-07-17,Nicaragua,NI,0,0,6545503,America,3147,99
2020-07-18,Nicaragua,NI,0,0,6545503,America,3147,99
2020-07-19,Nicaragua,NI,0,0,6545503,America,3147,99
2020-07-20,Nicaragua,NI,0,0,6545503,America,3147,99
2020-07-21,Nicaragua,NI,0,0,6545503,America,3147,99
2020-07-22,Nicaragua,NI,292,9,6545503,America,3439,108
2020-07-23,Nicaragua,NI,0,0,6545503,America,3439,108
2020-07-24,Nicaragua,NI,0,0,6545503,America,3439,108
2020-07-25,Nicaragua,NI,0,0,6545503,America,3439,108
2020-07-26,Nicaragua,NI,0,0,6545503,America,3439,108
2020-07-27,Nicaragua,NI,0,0,6545503,America,3439,108
2020-07-28,Nicaragua,NI,0,0,6545503,America,3439,108
2020-07-29,Nicaragua,NI,233,8,6545503,America,3672,116
2020-07-30,Nicaragua,NI,0,0,6545503,America,3672,116
2020-07-31,Nicaragua,NI,0,0,6545503,America,3672,116
2020-08-01,Nicaragua,NI,0,0,6545503,America,3672,116
2020-08-02,Nicaragua,NI,0,0,6545503,America,3672,116
2020-08-03,Nicaragua,NI,0,0,6545503,America,3672,116
2020-08-04,Nicaragua,NI,0,0,6545503,America,3672,116
2020-08-05,Nicaragua,NI,230,7,6545503,America,3902,123
2020-08-06,Nicaragua,NI,0,0,6545503,America,3902,123
2020-08-07,Nicaragua,NI,0,0,6545503,America,3902,123
2020-08-08,Nicaragua,NI,0,0,6545503,America,3902,123
2020-08-09,Nicaragua,NI,0,0,6545503,America,3902,123
2020-08-10,Nicaragua,NI,0,0,6545503,America,3902,123
2020-08-11,Nicaragua,NI,0,0,6545503,America,3902,123
2020-08-12,Nicaragua,NI,213,5,6545503,America,4115,128
2020-08-13,Nicaragua,NI,0,0,6545503,America,4115,128
2020-08-14,Nicaragua,NI,0,0,6545503,America,4115,128
2020-08-15,Nicaragua,NI,0,0,6545503,America,4115,128
2020-08-16,Nicaragua,NI,0,0,6545503,America,4115,128
2020-08-17,Nicaragua,NI,0,0,6545503,America,4115,128
2020-08-18,Nicaragua,NI,0,0,6545503,America,4115,128
2020-08-19,Nicaragua,NI,196,5,6545503,America,4311,133
2020-08-20,Nicaragua,NI,0,0,6545503,America,4311,133
2020-08-21,Nicaragua,NI,0,0,6545503,America,4311,133
2020-08-22,Nicaragua,NI,0,0,6545503,America,4311,133
2020-08-23,Nicaragua,NI,0,0,6545503,America,4311,133
2020-08-24,Nicaragua,NI,0,0,6545503,America,4311,133
2020-08-25,Nicaragua,NI,0,0,6545503,America,4311,133
2020-08-26,Nicaragua,NI,183,4,6545503,America,4494,137
2020-08-27,Nicaragua,NI,0,0,6545503,America,4494,137
2020-08-28,Nicaragua,NI,0,0,6545503,America,4494,137
2020-08-29,Nicaragua,NI,0,0,6545503,America,4494,137
2020-08-30,Nicaragua,NI,0,0,6545503,America,4494,137
2020-08-31,Nicaragua,NI,0,0,6545503,America,4494,137
2020-09-01,Nicaragua,NI,0,0,6545503,America,4494,137
2020-09-02,Nicaragua,NI,174,4,6545503,America,4668,141
2020-09-03,Nicaragua,NI,0,0,6545503,America,4668,141
2020-09-04,Nicaragua,NI,0,0,6545503,America,4668,141
2020-09-05,Nicaragua,NI,0,0,6545503,America,4668,141
2020-09-06,Nicaragua,NI,0,0,6545503,America,4668,141
2020-09-07,Nicaragua,NI,0,0,6545503,America,4668,141
2020-09-08,Nicaragua,NI,0,0,6545503,America,4668,141
2020-09-09,Nicaragua,NI,150,3,6545503,America,4818,144
2020-09-10,Nicaragua,NI,0,0,6545503,America,4818,144
2020-09-11,Nicaragua,NI,0,0,6545503,America,4818,144
2020-09-12,Nicaragua,NI,0,0,6545503,America,4818,144
2020-09-13,Nicaragua,NI,0,0,6545503,America,4818,144
2020-09-14,Nicaragua,NI,0,0,6545503,America,4818,144
2020-09-15,Nicaragua,NI,0,0,6545503,America,4818,144
2020-09-16,Nicaragua,NI,143,3,6545503,America,4961,147
2020-09-17,Nicaragua,NI,0,0,6545503,America,4961,147
2020-09-18,Nicaragua,NI,0,0,6545503,America,4961,147
2020-09-19,Nicaragua,NI,0,0,6545503,America,4961,147
2020-09-20,Nicaragua,NI,0,0,6545503,America,4961,147
2020-09-21,Nicaragua,NI,0,0,6545503,America,4961,147
2020-09-22,Nicaragua,NI,0,0,6545503,America,4961,147
2020-09-23,Nicaragua,NI,112,2,6545503,America,5073,149
2020-09-24,Nicaragua,NI,0,0,6545503,America,5073,149
2020-09-25,Nicaragua,NI,0,0,6545503,America,5073,149
2020-09-26,Nicaragua,NI,0,0,6545503,America,5073,149
2020-09-27,Nicaragua,NI,0,0,6545503,America,5073,149
2020-09-28,Nicaragua,NI,0,0,6545503,America,5073,149
2020-09-29,Nicaragua,NI,0,0,6545503,America,5073,149
2020-09-30,Nicaragua,NI,97,2,6545503,America,5170,151
2020-10-01,Nicaragua,NI,0,0,6545503,America,5170,151
2020-10-02,Nicaragua,NI,0,0,6545503,America,5170,151
2020-10-03,Nicaragua,NI,0,0,6545503,America,5170,151
2020-10-04,Nicaragua,NI,0,0,6545503,America,5170,151
2020-10-05,Nicaragua,NI,0,0,6545503,America,5170,151
2020-10-06,Nicaragua,NI,0,0,6545503,America,5170,151
2020-10-07,Nicaragua,NI,94,2,6545503,America,5264,153
2020-10-08,Nicaragua,NI,0,0,6545503,America,5264,153
2020-10-09,Nicaragua,NI,0,0,6545503,America,5264,153
2020-10-10,Nicaragua,NI,0,0,6545503,America,5264,153
2020-10-11,Nicaragua,NI,0,0,6545503,America,5264,153
2020-10-12,Nicaragua,NI,0,0,6545503,America,5264,153
2020-10-13,Nicaragua,NI,0,0,6545503,America,5264,153
2020-10-14,Nicaragua,NI,89,1,6545503,America,5353,154
2020-10-15,Nicaragua,NI,0,0,6545503,America,5353,154
2020-10-16,Nicaragua,NI,0,0,6545503,America,5353,154
2020-10-17,Nicaragua,NI,0,0,6545503,America,5353,154
2020-10-18,Nicaragua,NI,0,0,6545503,America,5353,154
2020-10-19,Nicaragua,NI,0,0,6545503,America,5353,154
2020-10-20,Nicaragua,NI,0,0,6545503,America,5353,154
2020-10-21,Nicaragua,NI,81,1,6545503,America,5434,155
2020-10-22,Nicaragua,NI,0,0,6545503,America,5434,155
2020-10-23,Nicaragua,NI,0,0,6545503,America,5434,155
2020-10-24,Nicaragua,NI,0,0,6545503,America,5434,155
2020-10-25,Nicaragua,NI,0,0,6545503,America,5434,155
2020-10-26,Nicaragua,NI,0,0,6545503,America,5434,155
2020-10-27,Nicaragua,NI,0,0,6545503,America,5434,155
2020-10-28,Nicaragua,NI,80,1,6545503,America,5514,156
2020-10-29,Nicaragua,NI,0,0,6545503,America,5514,156
2020-10-30,Nicaragua,NI,0,0,6545503,America,5514,156
2020-10-31,Nicaragua,NI,0,0,6545503,America,5514,156
2020-11-01,Nicaragua,NI,0,0,6545503,America,5514,156
2020-11-02,Nicaragua,NI,0,0,6545503,America,5514,156
2020-11-03,Nicaragua,NI,0,0,6545503,America,5514,156
2020-11-04,Nicaragua,NI,0,0,6545503,America,5514,156
2020-11-05,Nicaragua,NI,0,0,6545503,America,5514,156
2020-11-06,Nicaragua,NI,77,1,6545503,America,5591,157
2020-11-07,Nicaragua,NI,0,0,6545503,America,5591,157
2020-11-08,Nicaragua,NI,0,0,6545503,America,5591,157
2020-11-09,Nicaragua,NI,0,0,6545503,America,5591,157
2020-11-10,Nicaragua,NI,0,0,6545503,America,5591,157
2020-11-11,Nicaragua,NI,0,0,6545503,America,5591,157
2020-11-12,Nicaragua,NI,70,1,6545503,America,5661,158
2020-11-13,Nicaragua,NI,0,0,6545503,America,5661,158
2020-11-14,Nicaragua,NI,0,0,6545503,America,5661,158
2020-11-15,Nicaragua,NI,0,0,6545503,America,5661,158
2020-11-16,Nicaragua,NI,0,0,6545503,America,5661,158
2020-11-17,Nicaragua,NI,0,0,6545503,America,5661,158
2020-11-18,Nicaragua,NI,0,1,6545503,America,5661,159
2020-11-19,Nicaragua,NI,0,0,6545503,America,5661,159
2020-11-20,Nicaragua,NI,0,0,6545503,America,5661,159
2020-11-21,Nicaragua,NI,0,0,6545503,America,5661,159
2020-11-22,Nicaragua,NI,64,0,6545503,America,5725,159
2020-11-23,Nicaragua,NI,0,0,6545503,America,5725,159
2020-11-24,Nicaragua,NI,0,0,6545503,America,5725,159
2020-11-25,Nicaragua,NI,59,1,6545503,America,5784,160
2020-11-26,Nicaragua,NI,0,0,6545503,America,5784,160
2020-11-27,Nicaragua,NI,0,0,6545503,America,5784,160
2020-11-28,Nicaragua,NI,0,0,6545503,America,5784,160
2020-11-29,Nicaragua,NI,0,0,6545503,America,5784,160
2020-11-30,Nicaragua,NI,0,0,6545503,America,5784,160
2020-12-01,Nicaragua,NI,0,0,6545503,America,5784,160
2020-12-02,Nicaragua,NI,54,1,6545503,America,5838,161
2020-12-03,Nicaragua,NI,0,0,6545503,America,5838,161
2020-12-04,Nicaragua,NI,0,0,6545503,America,5838,161
2020-12-05,Nicaragua,NI,0,0,6545503,America,5838,161
2020-12-06,Nicaragua,NI,0,0,6545503,America,5838,161
2020-12-07,Nicaragua,NI,0,0,6545503,America,5838,161
2020-12-08,Nicaragua,NI,0,0,6545503,America,5838,161
2020-12-09,Nicaragua,NI,49,1,6545503,America,5887,162
2020-12-10,Nicaragua,NI,0,0,6545503,America,5887,162
2020-12-11,Nicaragua,NI,0,0,6545503,America,5887,162
2020-12-12,Nicaragua,NI,0,0,6545503,America,5887,162
2020-12-13,Nicaragua,NI,0,0,6545503,America,5887,162
2020-12-14,Nicaragua,NI,0,0,6545503,America,5887,162
2019-12-31,Netherlands,NL,0,0,17282163,Europe,0,0
2020-01-01,Netherlands,NL,0,0,17282163,Europe,0,0
2020-01-02,Netherlands,NL,0,0,17282163,Europe,0,0
2020-01-03,Netherlands,NL,0,0,17282163,Europe,0,0
2020-01-04,Netherlands,NL,0,0,17282163,Europe,0,0
2020-01-05,Netherlands,NL,0,0,17282163,Europe,0,0
2020-01-06,Netherlands,NL,0,0,17282163,Europe,0,0
2020-01-07,Netherlands,NL,0,0,17282163,Europe,0,0
2020-01-08,Netherlands,NL,0,0,17282163,Europe,0,0
2020-01-09,Netherlands,NL,0,0,17282163,Europe,0,0
2020-01-10,Netherlands,NL,0,0,17282163,Europe,0,0
2020-01-11,Netherlands,NL,0,0,17282163,Europe,0,0
2020-01-12,Netherlands,NL,0,0,17282163,Europe,0,0
2020-01-13,Netherlands,NL,0,0,17282163,Europe,0,0
2020-01-14,Netherlands,NL,0,0,17282163,Europe,0,0
2020-01-15,Netherlands,NL,0,0,17282163,Europe,0,0
2020-01-16,Netherlands,NL,0,0,17282163,Europe,0,0
2020-01-17,Netherlands,NL,0,0,17282163,Europe,0,0
2020-01-18,Netherlands,NL,0,0,17282163,Europe,0,0
2020-01-19,Netherlands,NL,0,0,17282163,Europe,0,0
2020-01-20,Netherlands,NL,0,0,17282163,Europe,0,0
2020-01-21,Netherlands,NL,0,0,17282163,Europe,0,0
2020-01-22,Netherlands,NL,0,0,17282163,Europe,0,0
2020-01-23,Netherlands,NL,0,0,17282163,Europe,0,0
2020-01-24,Netherlands,NL,0,0,17282163,Europe,0,0
2020-01-25,Netherlands,NL,0,0,17282163,Europe,0,0
2020-01-26,Netherlands,NL,0,0,17282163,Europe,0,0
2020-01-27,Netherlands,NL,0,0,17282163,Europe,0,0
2020-01-28,Netherlands,NL,0,0,17282163,Europe,0,0
2020-01-29,Netherlands,NL,0,0,17282163,Europe,0,0
2020-01-30,Netherlands,NL,0,0,17282163,Europe,0,0
2020-01-31,Netherlands,NL,0,0,17282163,Europe,0,0
2020-02-01,Netherlands,NL,0,0,17282163,Europe,0,0
2020-02-02,Netherlands,NL,0,0,17282163,Europe,0,0
2020-02-03,Netherlands,NL,0,0,17282163,Europe,0,0
2020-02-04,Netherlands,NL,0,0,17282163,Europe,0,0
2020-02-05,Netherlands,NL,0,0,17282163,Europe,0,0
2020-02-06,Netherlands,NL,0,0,17282163,Europe,0,0
2020-02-07,Netherlands,NL,0,0,17282163,Europe,0,0
2020-02-08,Netherlands,NL,0,0,17282163,Europe,0,0
2020-02-09,Netherlands,NL,0,0,17282163,Europe,0,0
2020-02-10,Netherlands,NL,0,0,17282163,Europe,0,0
2020-02-11,Netherlands,NL,0,0,17282163,Europe,0,0
2020-02-12,Netherlands,NL,0,0,17282163,Europe,0,0
2020-02-13,Netherlands,NL,0,0,17282163,Europe,0,0
2020-02-14,Netherlands,NL,0,0,17282163,Europe,0,0
2020-02-15,Netherlands,NL,0,0,17282163,Europe,0,0
2020-02-16,Netherlands,NL,0,0,17282163,Europe,0,0
2020-02-17,Netherlands,NL,0,0,17282163,Europe,0,0
2020-02-18,Netherlands,NL,0,0,17282163,Europe,0,0
2020-02-19,Netherlands,NL,0,0,17282163,Europe,0,0
2020-02-20,Netherlands,NL,0,0,17282163,Europe,0,0
2020-02-21,Netherlands,NL,0,0,17282163,Europe,0,0
2020-02-22,Netherlands,NL,0,0,17282163,Europe,0,0
2020-02-23,Netherlands,NL,0,0,17282163,Europe,0,0
2020-02-24,Netherlands,NL,0,0,17282163,Europe,0,0
2020-02-25,Netherlands,NL,0,0,17282163,Europe,0,0
2020-02-26,Netherlands,NL,0,0,17282163,Europe,0,0
2020-02-27,Netherlands,NL,0,0,17282163,Europe,0,0
2020-02-28,Netherlands,NL,1,0,17282163,Europe,1,0
2020-02-29,Netherlands,NL,1,0,17282163,Europe,2,0
2020-03-01,Netherlands,NL,5,0,17282163,Europe,7,0
2020-03-02,Netherlands,NL,6,0,17282163,Europe,13,0
2020-03-03,Netherlands,NL,5,0,17282163,Europe,18,0
2020-03-04,Netherlands,NL,10,0,17282163,Europe,28,0
2020-03-05,Netherlands,NL,10,0,17282163,Europe,38,0
2020-03-06,Netherlands,NL,44,0,17282163,Europe,82,0
2020-03-07,Netherlands,NL,46,1,17282163,Europe,128,1
2020-03-08,Netherlands,NL,60,0,17282163,Europe,188,1
2020-03-09,Netherlands,NL,77,2,17282163,Europe,265,3
2020-03-10,Netherlands,NL,56,0,17282163,Europe,321,3
2020-03-11,Netherlands,NL,61,1,17282163,Europe,382,4
2020-03-12,Netherlands,NL,121,1,17282163,Europe,503,5
2020-03-13,Netherlands,NL,111,0,17282163,Europe,614,5
2020-03-14,Netherlands,NL,190,0,17282163,Europe,804,5
2020-03-15,Netherlands,NL,155,7,17282163,Europe,959,12
2020-03-16,Netherlands,NL,176,8,17282163,Europe,1135,20
2020-03-17,Netherlands,NL,278,4,17282163,Europe,1413,24
2020-03-18,Netherlands,NL,292,19,17282163,Europe,1705,43
2020-03-19,Netherlands,NL,346,15,17282163,Europe,2051,58
2020-03-20,Netherlands,NL,409,18,17282163,Europe,2460,76
2020-03-21,Netherlands,NL,534,30,17282163,Europe,2994,106
2020-03-22,Netherlands,NL,637,30,17282163,Europe,3631,136
2020-03-23,Netherlands,NL,573,43,17282163,Europe,4204,179
2020-03-24,Netherlands,NL,545,34,17282163,Europe,4749,213
2020-03-25,Netherlands,NL,811,63,17282163,Europe,5560,276
2020-03-26,Netherlands,NL,852,80,17282163,Europe,6412,356
2020-03-27,Netherlands,NL,1019,78,17282163,Europe,7431,434
2020-03-28,Netherlands,NL,1172,112,17282163,Europe,8603,546
2020-03-29,Netherlands,NL,1159,93,17282163,Europe,9762,639
2020-03-30,Netherlands,NL,1104,132,17282163,Europe,10866,771
2020-03-31,Netherlands,NL,884,93,17282163,Europe,11750,864
2020-04-01,Netherlands,NL,845,175,17282163,Europe,12595,1039
2020-04-02,Netherlands,NL,1019,134,17282163,Europe,13614,1173
2020-04-03,Netherlands,NL,1083,166,17282163,Europe,14697,1339
2020-04-04,Netherlands,NL,1026,148,17282163,Europe,15723,1487
2020-04-05,Netherlands,NL,904,164,17282163,Europe,16627,1651
2020-04-06,Netherlands,NL,1224,115,17282163,Europe,17851,1766
2020-04-07,Netherlands,NL,952,101,17282163,Europe,18803,1867
2020-04-08,Netherlands,NL,777,234,17282163,Europe,19580,2101
2020-04-09,Netherlands,NL,969,147,17282163,Europe,20549,2248
2020-04-10,Netherlands,NL,1213,148,17282163,Europe,21762,2396
2020-04-11,Netherlands,NL,1335,115,17282163,Europe,23097,2511
2020-04-12,Netherlands,NL,1316,132,17282163,Europe,24413,2643
2020-04-13,Netherlands,NL,1174,94,17282163,Europe,25587,2737
2020-04-14,Netherlands,NL,964,86,17282163,Europe,26551,2823
2020-04-15,Netherlands,NL,868,122,17282163,Europe,27419,2945
2020-04-16,Netherlands,NL,734,189,17282163,Europe,28153,3134
2020-04-17,Netherlands,NL,1061,181,17282163,Europe,29214,3315
2020-04-18,Netherlands,NL,1235,144,17282163,Europe,30449,3459
2020-04-19,Netherlands,NL,1140,142,17282163,Europe,31589,3601
2020-04-20,Netherlands,NL,1066,83,17282163,Europe,32655,3684
2020-04-21,Netherlands,NL,750,67,17282163,Europe,33405,3751
2020-04-22,Netherlands,NL,729,165,17282163,Europe,34134,3916
2020-04-23,Netherlands,NL,708,138,17282163,Europe,34842,4054
2020-04-24,Netherlands,NL,887,123,17282163,Europe,35729,4177
2020-04-25,Netherlands,NL,806,112,17282163,Europe,36535,4289
2020-04-26,Netherlands,NL,655,120,17282163,Europe,37190,4409
2020-04-27,Netherlands,NL,655,66,17282163,Europe,37845,4475
2020-04-28,Netherlands,NL,400,43,17282163,Europe,38245,4518
2020-04-29,Netherlands,NL,171,48,17282163,Europe,38416,4566
2020-04-30,Netherlands,NL,386,145,17282163,Europe,38802,4711
2020-05-01,Netherlands,NL,514,84,17282163,Europe,39316,4795
2020-05-02,Netherlands,NL,475,98,17282163,Europe,39791,4893
2020-05-03,Netherlands,NL,445,94,17282163,Europe,40236,4987
2020-05-04,Netherlands,NL,335,69,17282163,Europe,40571,5056
2020-05-05,Netherlands,NL,199,26,17282163,Europe,40770,5082
2020-05-06,Netherlands,NL,317,86,17282163,Europe,41087,5168
2020-05-07,Netherlands,NL,232,36,17282163,Europe,41319,5204
2020-05-08,Netherlands,NL,455,84,17282163,Europe,41774,5288
2020-05-09,Netherlands,NL,319,71,17282163,Europe,42093,5359
2020-05-10,Netherlands,NL,289,63,17282163,Europe,42382,5422
2020-05-11,Netherlands,NL,245,18,17282163,Europe,42627,5440
2020-05-12,Netherlands,NL,161,16,17282163,Europe,42788,5456
2020-05-13,Netherlands,NL,196,54,17282163,Europe,42984,5510
2020-05-14,Netherlands,NL,227,52,17282163,Europe,43211,5562
2020-05-15,Netherlands,NL,270,28,17282163,Europe,43481,5590
2020-05-16,Netherlands,NL,200,53,17282163,Europe,43681,5643
2020-05-17,Netherlands,NL,189,27,17282163,Europe,43870,5670
2020-05-18,Netherlands,NL,125,10,17282163,Europe,43995,5680
2020-05-19,Netherlands,NL,146,14,17282163,Europe,44141,5694
2020-05-20,Netherlands,NL,108,21,17282163,Europe,44249,5715
2020-05-21,Netherlands,NL,198,33,17282163,Europe,44447,5748
2020-05-22,Netherlands,NL,253,27,17282163,Europe,44700,5775
2020-05-23,Netherlands,NL,188,13,17282163,Europe,44888,5788
2020-05-24,Netherlands,NL,176,23,17282163,Europe,45064,5811
2020-05-25,Netherlands,NL,172,11,17282163,Europe,45236,5822
2020-05-26,Netherlands,NL,209,8,17282163,Europe,45445,5830
2020-05-27,Netherlands,NL,133,26,17282163,Europe,45578,5856
2020-05-28,Netherlands,NL,190,15,17282163,Europe,45768,5871
2020-05-29,Netherlands,NL,182,32,17282163,Europe,45950,5903
2020-05-30,Netherlands,NL,176,28,17282163,Europe,46126,5931
2020-05-31,Netherlands,NL,131,20,17282163,Europe,46257,5951
2020-06-01,Netherlands,NL,185,5,17282163,Europe,46442,5956
2020-06-02,Netherlands,NL,103,6,17282163,Europe,46545,5962
2020-06-03,Netherlands,NL,102,5,17282163,Europe,46647,5967
2020-06-04,Netherlands,NL,86,10,17282163,Europe,46733,5977
2020-06-05,Netherlands,NL,209,13,17282163,Europe,46942,5990
2020-06-06,Netherlands,NL,210,15,17282163,Europe,47152,6005
2020-06-07,Netherlands,NL,183,6,17282163,Europe,47335,6011
2020-06-08,Netherlands,NL,239,2,17282163,Europe,47574,6013
2020-06-09,Netherlands,NL,165,3,17282163,Europe,47739,6016
2020-06-10,Netherlands,NL,164,15,17282163,Europe,47903,6031
2020-06-11,Netherlands,NL,184,11,17282163,Europe,48087,6042
2020-06-12,Netherlands,NL,164,2,17282163,Europe,48251,6044
2020-06-13,Netherlands,NL,210,9,17282163,Europe,48461,6053
2020-06-14,Netherlands,NL,179,4,17282163,Europe,48640,6057
2020-06-15,Netherlands,NL,143,2,17282163,Europe,48783,6059
2020-06-16,Netherlands,NL,165,6,17282163,Europe,48948,6065
2020-06-17,Netherlands,NL,139,5,17282163,Europe,49087,6070
2020-06-18,Netherlands,NL,117,4,17282163,Europe,49204,6074
2020-06-19,Netherlands,NL,115,4,17282163,Europe,49319,6078
2020-06-20,Netherlands,NL,107,3,17282163,Europe,49426,6081
2020-06-21,Netherlands,NL,76,8,17282163,Europe,49502,6089
2020-06-22,Netherlands,NL,91,1,17282163,Europe,49593,6090
2020-06-23,Netherlands,NL,65,0,17282163,Europe,49658,6090
2020-06-24,Netherlands,NL,64,5,17282163,Europe,49722,6095
2020-06-25,Netherlands,NL,82,2,17282163,Europe,49804,6097
2020-06-26,Netherlands,NL,110,3,17282163,Europe,49914,6100
2020-06-27,Netherlands,NL,91,3,17282163,Europe,50005,6103
2020-06-28,Netherlands,NL,69,2,17282163,Europe,50074,6105
2020-06-29,Netherlands,NL,73,0,17282163,Europe,50147,6105
2020-06-30,Netherlands,NL,76,2,17282163,Europe,50223,6107
2020-07-01,Netherlands,NL,50,6,17282163,Europe,50273,6113
2020-07-02,Netherlands,NL,62,2,17282163,Europe,50335,6115
2020-07-03,Netherlands,NL,77,3,17282163,Europe,50412,6118
2020-07-04,Netherlands,NL,75,2,17282163,Europe,50487,6120
2020-07-05,Netherlands,NL,61,6,17282163,Europe,50548,6126
2020-07-06,Netherlands,NL,73,1,17282163,Europe,50621,6127
2020-07-07,Netherlands,NL,36,1,17282163,Europe,50657,6128
2020-07-08,Netherlands,NL,37,4,17282163,Europe,50694,6132
2020-07-09,Netherlands,NL,52,3,17282163,Europe,50746,6135
2020-07-10,Netherlands,NL,52,0,17282163,Europe,50798,6135
2020-07-11,Netherlands,NL,42,0,17282163,Europe,50840,6135
2020-07-12,Netherlands,NL,81,0,17282163,Europe,50921,6135
2020-07-13,Netherlands,NL,101,0,17282163,Europe,51022,6135
2020-07-14,Netherlands,NL,71,0,17282163,Europe,51093,6135
2020-07-15,Netherlands,NL,53,0,17282163,Europe,51146,6135
2020-07-16,Netherlands,NL,106,1,17282163,Europe,51252,6136
2020-07-17,Netherlands,NL,99,0,17282163,Europe,51351,6136
2020-07-18,Netherlands,NL,103,0,17282163,Europe,51454,6136
2020-07-19,Netherlands,NL,127,0,17282163,Europe,51581,6136
2020-07-20,Netherlands,NL,144,0,17282163,Europe,51725,6136
2020-07-21,Netherlands,NL,185,0,17282163,Europe,51910,6136
2020-07-22,Netherlands,NL,163,0,17282163,Europe,52073,6136
2020-07-23,Netherlands,NL,168,3,17282163,Europe,52241,6139
2020-07-24,Netherlands,NL,163,0,17282163,Europe,52404,6139
2020-07-25,Netherlands,NL,191,0,17282163,Europe,52595,6139
2020-07-26,Netherlands,NL,137,1,17282163,Europe,52732,6140
2020-07-27,Netherlands,NL,214,0,17282163,Europe,52946,6140
2020-07-28,Netherlands,NL,205,0,17282163,Europe,53151,6140
2020-07-29,Netherlands,NL,223,0,17282163,Europe,53374,6140
2020-07-30,Netherlands,NL,247,0,17282163,Europe,53621,6140
2020-07-31,Netherlands,NL,342,0,17282163,Europe,53963,6140
2020-08-01,Netherlands,NL,338,0,17282163,Europe,54301,6140
2020-08-02,Netherlands,NL,431,0,17282163,Europe,54732,6140
2020-08-03,Netherlands,NL,311,0,17282163,Europe,55043,6140
2020-08-04,Netherlands,NL,372,0,17282163,Europe,55415,6140
2020-08-05,Netherlands,NL,540,1,17282163,Europe,55955,6141
2020-08-06,Netherlands,NL,426,4,17282163,Europe,56381,6145
2020-08-07,Netherlands,NL,601,0,17282163,Europe,56982,6145
2020-08-08,Netherlands,NL,519,0,17282163,Europe,57501,6145
2020-08-09,Netherlands,NL,486,3,17282163,Europe,57987,6148
2020-08-10,Netherlands,NL,577,0,17282163,Europe,58564,6148
2020-08-11,Netherlands,NL,575,0,17282163,Europe,59139,6148
2020-08-12,Netherlands,NL,779,2,17282163,Europe,59918,6150
2020-08-13,Netherlands,NL,654,2,17282163,Europe,60572,6152
2020-08-14,Netherlands,NL,577,4,17282163,Europe,61149,6156
2020-08-15,Netherlands,NL,636,2,17282163,Europe,61785,6158
2020-08-16,Netherlands,NL,652,2,17282163,Europe,62437,6160
2020-08-17,Netherlands,NL,506,3,17282163,Europe,62943,6163
2020-08-18,Netherlands,NL,481,0,17282163,Europe,63424,6163
2020-08-19,Netherlands,NL,487,3,17282163,Europe,63911,6166
2020-08-20,Netherlands,NL,552,6,17282163,Europe,64463,6172
2020-08-21,Netherlands,NL,529,10,17282163,Europe,64992,6182
2020-08-22,Netherlands,NL,534,4,17282163,Europe,65526,6186
2020-08-23,Netherlands,NL,508,5,17282163,Europe,66034,6191
2020-08-24,Netherlands,NL,456,0,17282163,Europe,66490,6191
2020-08-25,Netherlands,NL,572,2,17282163,Europe,67062,6193
2020-08-26,Netherlands,NL,414,5,17282163,Europe,67476,6198
2020-08-27,Netherlands,NL,570,8,17282163,Europe,68046,6206
2020-08-28,Netherlands,NL,510,3,17282163,Europe,68556,6209
2020-08-29,Netherlands,NL,507,2,17282163,Europe,69063,6211
2020-08-30,Netherlands,NL,500,4,17282163,Europe,69563,6215
2020-08-31,Netherlands,NL,508,0,17282163,Europe,70071,6215
2020-09-01,Netherlands,NL,525,0,17282163,Europe,70596,6215
2020-09-02,Netherlands,NL,461,6,17282163,Europe,71057,6221
2020-09-03,Netherlands,NL,914,5,17282163,Europe,71971,6226
2020-09-04,Netherlands,NL,421,0,17282163,Europe,72392,6226
2020-09-05,Netherlands,NL,744,2,17282163,Europe,73136,6228
2020-09-06,Netherlands,NL,654,4,17282163,Europe,73790,6232
2020-09-07,Netherlands,NL,925,2,17282163,Europe,74715,6234
2020-09-08,Netherlands,NL,797,0,17282163,Europe,75512,6234
2020-09-09,Netherlands,NL,963,1,17282163,Europe,76475,6235
2020-09-10,Netherlands,NL,1140,2,17282163,Europe,77615,6237
2020-09-11,Netherlands,NL,823,3,17282163,Europe,78438,6240
2020-09-12,Netherlands,NL,1268,3,17282163,Europe,79706,6243
2020-09-13,Netherlands,NL,1231,1,17282163,Europe,80937,6244
2020-09-14,Netherlands,NL,1086,1,17282163,Europe,82023,6245
2020-09-15,Netherlands,NL,1298,2,17282163,Europe,83321,6247
2020-09-16,Netherlands,NL,1376,2,17282163,Europe,84697,6249
2020-09-17,Netherlands,NL,1540,2,17282163,Europe,86237,6251
2020-09-18,Netherlands,NL,1750,6,17282163,Europe,87987,6257
2020-09-19,Netherlands,NL,1972,7,17282163,Europe,89959,6264
2020-09-20,Netherlands,NL,1882,2,17282163,Europe,91841,6266
2020-09-21,Netherlands,NL,1843,4,17282163,Europe,93684,6270
2020-09-22,Netherlands,NL,2215,2,17282163,Europe,95899,6272
2020-09-23,Netherlands,NL,2243,10,17282163,Europe,98142,6282
2020-09-24,Netherlands,NL,2351,5,17282163,Europe,100493,6287
2020-09-25,Netherlands,NL,2541,16,17282163,Europe,103034,6303
2020-09-26,Netherlands,NL,2776,16,17282163,Europe,105810,6319
2020-09-27,Netherlands,NL,2711,38,17282163,Europe,108521,6357
2020-09-28,Netherlands,NL,2989,8,17282163,Europe,111510,6365
2020-09-29,Netherlands,NL,2909,6,17282163,Europe,114419,6371
2020-09-30,Netherlands,NL,3001,13,17282163,Europe,117420,6384
2020-10-01,Netherlands,NL,3293,13,17282163,Europe,120713,6397
2020-10-02,Netherlands,NL,3253,13,17282163,Europe,123966,6410
2020-10-03,Netherlands,NL,3820,9,17282163,Europe,127786,6419
2020-10-04,Netherlands,NL,3963,21,17282163,Europe,131749,6440
2020-10-05,Netherlands,NL,4000,5,17282163,Europe,135749,6445
2020-10-06,Netherlands,NL,4572,7,17282163,Europe,140321,6452
2020-10-07,Netherlands,NL,4517,21,17282163,Europe,144838,6473
2020-10-08,Netherlands,NL,4979,36,17282163,Europe,149817,6509
2020-10-09,Netherlands,NL,5813,13,17282163,Europe,155630,6522
2020-10-10,Netherlands,NL,5959,13,17282163,Europe,161589,6535
2020-10-11,Netherlands,NL,6493,23,17282163,Europe,168082,6558
2020-10-12,Netherlands,NL,6368,17,17282163,Europe,174450,6575
2020-10-13,Netherlands,NL,6844,12,17282163,Europe,181294,6587
2020-10-14,Netherlands,NL,7368,35,17282163,Europe,188662,6622
2020-10-15,Netherlands,NL,7271,32,17282163,Europe,195933,6654
2020-10-16,Netherlands,NL,7779,29,17282163,Europe,203712,6683
2020-10-17,Netherlands,NL,7978,16,17282163,Europe,211690,6699
2020-10-18,Netherlands,NL,8105,29,17282163,Europe,219795,6728
2020-10-19,Netherlands,NL,8439,23,17282163,Europe,228234,6751
2020-10-20,Netherlands,NL,7720,8,17282163,Europe,235954,6759
2020-10-21,Netherlands,NL,8149,45,17282163,Europe,244103,6804
2020-10-22,Netherlands,NL,8738,59,17282163,Europe,252841,6863
2020-10-23,Netherlands,NL,9268,46,17282163,Europe,262109,6909
2020-10-24,Netherlands,NL,9983,45,17282163,Europe,272092,6954
2020-10-25,Netherlands,NL,8639,55,17282163,Europe,280731,7009
2020-10-26,Netherlands,NL,10194,27,17282163,Europe,290925,7036
2020-10-27,Netherlands,NL,10324,26,17282163,Europe,301249,7062
2020-10-28,Netherlands,NL,10283,70,17282163,Europe,311532,7132
2020-10-29,Netherlands,NL,8092,60,17282163,Europe,319624,7192
2020-10-30,Netherlands,NL,10248,56,17282163,Europe,329872,7248
2020-10-31,Netherlands,NL,11102,87,17282163,Europe,340974,7335
2020-11-01,Netherlands,NL,9790,50,17282163,Europe,350764,7385
2020-11-02,Netherlands,NL,8673,39,17282163,Europe,359437,7424
2020-11-03,Netherlands,NL,8278,29,17282163,Europe,367715,7453
2020-11-04,Netherlands,NL,7729,113,17282163,Europe,375444,7566
2020-11-05,Netherlands,NL,7622,106,17282163,Europe,383066,7672
2020-11-06,Netherlands,NL,6957,87,17282163,Europe,390023,7759
2020-11-07,Netherlands,NL,7232,118,17282163,Europe,397255,7877
2020-11-08,Netherlands,NL,6659,73,17282163,Europe,403914,7950
2020-11-09,Netherlands,NL,5659,44,17282163,Europe,409573,7994
2020-11-10,Netherlands,NL,4674,39,17282163,Europe,414247,8033
2020-11-11,Netherlands,NL,4664,98,17282163,Europe,418911,8131
2020-11-12,Netherlands,NL,5400,74,17282163,Europe,424311,8205
2020-11-13,Netherlands,NL,5627,89,17282163,Europe,429938,8294
2020-11-14,Netherlands,NL,6086,53,17282163,Europe,436024,8347
2020-11-15,Netherlands,NL,5903,85,17282163,Europe,441927,8432
2020-11-16,Netherlands,NL,5408,43,17282163,Europe,447335,8475
2020-11-17,Netherlands,NL,4822,44,17282163,Europe,452157,8519
2020-11-18,Netherlands,NL,4296,85,17282163,Europe,456453,8604
2020-11-19,Netherlands,NL,4606,82,17282163,Europe,461059,8686
2020-11-20,Netherlands,NL,5638,73,17282163,Europe,466697,8759
2020-11-21,Netherlands,NL,5919,51,17282163,Europe,472616,8810
2020-11-22,Netherlands,NL,6062,48,17282163,Europe,478678,8858
2020-11-23,Netherlands,NL,5382,21,17282163,Europe,484060,8879
2020-11-24,Netherlands,NL,5163,54,17282163,Europe,489223,8933
2020-11-25,Netherlands,NL,3919,90,17282163,Europe,493142,9023
2020-11-26,Netherlands,NL,4901,73,17282163,Europe,498043,9096
2020-11-27,Netherlands,NL,4467,75,17282163,Europe,502510,9171
2020-11-28,Netherlands,NL,5733,83,17282163,Europe,508243,9254
2020-11-29,Netherlands,NL,4452,59,17282163,Europe,512695,9313
2020-11-30,Netherlands,NL,5578,23,17282163,Europe,518273,9336
2020-12-01,Netherlands,NL,4562,27,17282163,Europe,522835,9363
2020-12-02,Netherlands,NL,4042,62,17282163,Europe,526877,9425
2020-12-03,Netherlands,NL,4917,66,17282163,Europe,531794,9491
2020-12-04,Netherlands,NL,5603,61,17282163,Europe,537397,9552
2020-12-05,Netherlands,NL,5867,58,17282163,Europe,543264,9610
2020-12-06,Netherlands,NL,6520,39,17282163,Europe,549784,9649
2020-12-07,Netherlands,NL,6769,25,17282163,Europe,556553,9674
2020-12-08,Netherlands,NL,7055,17,17282163,Europe,563608,9691
2020-12-09,Netherlands,NL,6139,71,17282163,Europe,569747,9762
2020-12-10,Netherlands,NL,6524,66,17282163,Europe,576271,9828
2020-12-11,Netherlands,NL,8709,61,17282163,Europe,584980,9889
2020-12-12,Netherlands,NL,8827,63,17282163,Europe,593807,9952
2020-12-13,Netherlands,NL,9071,53,17282163,Europe,602878,10005
2020-12-14,Netherlands,NL,9868,29,17282163,Europe,612746,10034
2019-12-31,Norway,NO,0,0,5328212,Europe,0,0
2020-01-01,Norway,NO,0,0,5328212,Europe,0,0
2020-01-02,Norway,NO,0,0,5328212,Europe,0,0
2020-01-03,Norway,NO,0,0,5328212,Europe,0,0
2020-01-04,Norway,NO,0,0,5328212,Europe,0,0
2020-01-05,Norway,NO,0,0,5328212,Europe,0,0
2020-01-06,Norway,NO,0,0,5328212,Europe,0,0
2020-01-07,Norway,NO,0,0,5328212,Europe,0,0
2020-01-08,Norway,NO,0,0,5328212,Europe,0,0
2020-01-09,Norway,NO,0,0,5328212,Europe,0,0
2020-01-10,Norway,NO,0,0,5328212,Europe,0,0
2020-01-11,Norway,NO,0,0,5328212,Europe,0,0
2020-01-12,Norway,NO,0,0,5328212,Europe,0,0
2020-01-13,Norway,NO,0,0,5328212,Europe,0,0
2020-01-14,Norway,NO,0,0,5328212,Europe,0,0
2020-01-15,Norway,NO,0,0,5328212,Europe,0,0
2020-01-16,Norway,NO,0,0,5328212,Europe,0,0
2020-01-17,Norway,NO,0,0,5328212,Europe,0,0
2020-01-18,Norway,NO,0,0,5328212,Europe,0,0
2020-01-19,Norway,NO,0,0,5328212,Europe,0,0
2020-01-20,Norway,NO,0,0,5328212,Europe,0,0
2020-01-21,Norway,NO,0,0,5328212,Europe,0,0
2020-01-22,Norway,NO,0,0,5328212,Europe,0,0
2020-01-23,Norway,NO,0,0,5328212,Europe,0,0
2020-01-24,Norway,NO,0,0,5328212,Europe,0,0
2020-01-25,Norway,NO,0,0,5328212,Europe,0,0
2020-01-26,Norway,NO,0,0,5328212,Europe,0,0
2020-01-27,Norway,NO,0,0,5328212,Europe,0,0
2020-01-28,Norway,NO,0,0,5328212,Europe,0,0
2020-01-29,Norway,NO,0,0,5328212,Europe,0,0
2020-01-30,Norway,NO,0,0,5328212,Europe,0,0
2020-01-31,Norway,NO,0,0,5328212,Europe,0,0
2020-02-01,Norway,NO,0,0,5328212,Europe,0,0
2020-02-02,Norway,NO,0,0,5328212,Europe,0,0
2020-02-03,Norway,NO,0,0,5328212,Europe,0,0
2020-02-04,Norway,NO,0,0,5328212,Europe,0,0
2020-02-05,Norway,NO,0,0,5328212,Europe,0,0
2020-02-06,Norway,NO,0,0,5328212,Europe,0,0
2020-02-07,Norway,NO,0,0,5328212,Europe,0,0
2020-02-08,Norway,NO,0,0,5328212,Europe,0,0
2020-02-09,Norway,NO,0,0,5328212,Europe,0,0
2020-02-10,Norway,NO,0,0,5328212,Europe,0,0
2020-02-11,Norway,NO,0,0,5328212,Europe,0,0
2020-02-12,Norway,NO,0,0,5328212,Europe,0,0
2020-02-13,Norway,NO,0,0,5328212,Europe,0,0
2020-02-14,Norway,NO,0,0,5328212,Europe,0,0
2020-02-15,Norway,NO,0,0,5328212,Europe,0,0
2020-02-16,Norway,NO,0,0,5328212,Europe,0,0
2020-02-17,Norway,NO,0,0,5328212,Europe,0,0
2020-02-18,Norway,NO,0,0,5328212,Europe,0,0
2020-02-19,Norway,NO,0,0,5328212,Europe,0,0
2020-02-20,Norway,NO,0,0,5328212,Europe,0,0
2020-02-21,Norway,NO,0,0,5328212,Europe,0,0
2020-02-22,Norway,NO,0,0,5328212,Europe,0,0
2020-02-23,Norway,NO,0,0,5328212,Europe,0,0
2020-02-24,Norway,NO,0,0,5328212,Europe,0,0
2020-02-25,Norway,NO,0,0,5328212,Europe,0,0
2020-02-26,Norway,NO,0,0,5328212,Europe,0,0
2020-02-27,Norway,NO,1,0,5328212,Europe,1,0
2020-02-28,Norway,NO,3,0,5328212,Europe,4,0
2020-02-29,Norway,NO,2,0,5328212,Europe,6,0
2020-03-01,Norway,NO,9,0,5328212,Europe,15,0
2020-03-02,Norway,NO,4,0,5328212,Europe,19,0
2020-03-03,Norway,NO,6,0,5328212,Europe,25,0
2020-03-04,Norway,NO,8,0,5328212,Europe,33,0
2020-03-05,Norway,NO,23,0,5328212,Europe,56,0
2020-03-06,Norway,NO,30,0,5328212,Europe,86,0
2020-03-07,Norway,NO,27,0,5328212,Europe,113,0
2020-03-08,Norway,NO,34,0,5328212,Europe,147,0
2020-03-09,Norway,NO,22,0,5328212,Europe,169,0
2020-03-10,Norway,NO,23,0,5328212,Europe,192,0
2020-03-11,Norway,NO,85,0,5328212,Europe,277,0
2020-03-12,Norway,NO,212,0,5328212,Europe,489,0
2020-03-13,Norway,NO,132,1,5328212,Europe,621,1
2020-03-14,Norway,NO,0,0,5328212,Europe,621,1
2020-03-15,Norway,NO,286,0,5328212,Europe,907,1
2020-03-16,Norway,NO,170,0,5328212,Europe,1077,1
2020-03-17,Norway,NO,92,2,5328212,Europe,1169,3
2020-03-18,Norway,NO,139,0,5328212,Europe,1308,3
2020-03-19,Norway,NO,115,0,5328212,Europe,1423,3
2020-03-20,Norway,NO,129,3,5328212,Europe,1552,6
2020-03-21,Norway,NO,190,1,5328212,Europe,1742,7
2020-03-22,Norway,NO,184,0,5328212,Europe,1926,7
2020-03-23,Norway,NO,206,0,5328212,Europe,2132,7
2020-03-24,Norway,NO,239,1,5328212,Europe,2371,8
2020-03-25,Norway,NO,195,2,5328212,Europe,2566,10
2020-03-26,Norway,NO,350,2,5328212,Europe,2916,12
2020-03-27,Norway,NO,240,2,5328212,Europe,3156,14
2020-03-28,Norway,NO,425,2,5328212,Europe,3581,16
2020-03-29,Norway,NO,264,4,5328212,Europe,3845,20
2020-03-30,Norway,NO,257,2,5328212,Europe,4102,22
2020-03-31,Norway,NO,124,4,5328212,Europe,4226,26
2020-04-01,Norway,NO,221,2,5328212,Europe,4447,28
2020-04-02,Norway,NO,218,4,5328212,Europe,4665,32
2020-04-03,Norway,NO,270,10,5328212,Europe,4935,42
2020-04-04,Norway,NO,273,2,5328212,Europe,5208,44
2020-04-05,Norway,NO,302,6,5328212,Europe,5510,50
2020-04-06,Norway,NO,130,8,5328212,Europe,5640,58
2020-04-07,Norway,NO,115,1,5328212,Europe,5755,59
2020-04-08,Norway,NO,108,10,5328212,Europe,5863,69
2020-04-09,Norway,NO,147,11,5328212,Europe,6010,80
2020-04-10,Norway,NO,150,8,5328212,Europe,6160,88
2020-04-11,Norway,NO,84,4,5328212,Europe,6244,92
2020-04-12,Norway,NO,76,6,5328212,Europe,6320,98
2020-04-13,Norway,NO,95,5,5328212,Europe,6415,103
2020-04-14,Norway,NO,73,11,5328212,Europe,6488,114
2020-04-15,Norway,NO,78,13,5328212,Europe,6566,127
2020-04-16,Norway,NO,111,3,5328212,Europe,6677,130
2020-04-17,Norway,NO,114,6,5328212,Europe,6791,136
2020-04-18,Norway,NO,0,0,5328212,Europe,6791,136
2020-04-19,Norway,NO,193,12,5328212,Europe,6984,148
2020-04-20,Norway,NO,84,6,5328212,Europe,7068,154
2020-04-21,Norway,NO,45,0,5328212,Europe,7113,154
2020-04-22,Norway,NO,53,9,5328212,Europe,7166,163
2020-04-23,Norway,NO,84,6,5328212,Europe,7250,169
2020-04-24,Norway,NO,95,11,5328212,Europe,7345,180
2020-04-25,Norway,NO,63,11,5328212,Europe,7408,191
2020-04-26,Norway,NO,59,2,5328212,Europe,7467,193
2020-04-27,Norway,NO,38,0,5328212,Europe,7505,193
2020-04-28,Norway,NO,28,0,5328212,Europe,7533,193
2020-04-29,Norway,NO,72,2,5328212,Europe,7605,195
2020-04-30,Norway,NO,62,7,5328212,Europe,7667,202
2020-05-01,Norway,NO,43,2,5328212,Europe,7710,204
2020-05-02,Norway,NO,49,0,5328212,Europe,7759,204
2020-05-03,Norway,NO,0,0,5328212,Europe,7759,204
2020-05-04,Norway,NO,50,4,5328212,Europe,7809,208
2020-05-05,Norway,NO,38,0,5328212,Europe,7847,208
2020-05-06,Norway,NO,56,1,5328212,Europe,7903,209
2020-05-07,Norway,NO,50,0,5328212,Europe,7953,209
2020-05-08,Norway,NO,42,0,5328212,Europe,7995,209
2020-05-09,Norway,NO,39,4,5328212,Europe,8034,213
2020-05-10,Norway,NO,35,0,5328212,Europe,8069,213
2020-05-11,Norway,NO,30,4,5328212,Europe,8099,217
2020-05-12,Norway,NO,7,7,5328212,Europe,8106,224
2020-05-13,Norway,NO,29,4,5328212,Europe,8135,228
2020-05-14,Norway,NO,23,1,5328212,Europe,8158,229
2020-05-15,Norway,NO,17,3,5328212,Europe,8175,232
2020-05-16,Norway,NO,22,0,5328212,Europe,8197,232
2020-05-17,Norway,NO,0,0,5328212,Europe,8197,232
2020-05-18,Norway,NO,0,0,5328212,Europe,8197,232
2020-05-19,Norway,NO,52,1,5328212,Europe,8249,233
2020-05-20,Norway,NO,8,0,5328212,Europe,8257,233
2020-05-21,Norway,NO,11,1,5328212,Europe,8268,234
2020-05-22,Norway,NO,0,0,5328212,Europe,8268,234
2020-05-23,Norway,NO,41,1,5328212,Europe,8309,235
2020-05-24,Norway,NO,0,0,5328212,Europe,8309,235
2020-05-25,Norway,NO,0,0,5328212,Europe,8309,235
2020-05-26,Norway,NO,43,0,5328212,Europe,8352,235
2020-05-27,Norway,NO,12,0,5328212,Europe,8364,235
2020-05-28,Norway,NO,19,0,5328212,Europe,8383,235
2020-05-29,Norway,NO,18,1,5328212,Europe,8401,236
2020-05-30,Norway,NO,10,0,5328212,Europe,8411,236
2020-05-31,Norway,NO,0,0,5328212,Europe,8411,236
2020-06-01,Norway,NO,0,0,5328212,Europe,8411,236
2020-06-02,Norway,NO,0,0,5328212,Europe,8411,236
2020-06-03,Norway,NO,35,1,5328212,Europe,8446,237
2020-06-04,Norway,NO,0,0,5328212,Europe,8446,237
2020-06-05,Norway,NO,31,1,5328212,Europe,8477,238
2020-06-06,Norway,NO,27,0,5328212,Europe,8504,238
2020-06-07,Norway,NO,0,0,5328212,Europe,8504,238
2020-06-08,Norway,NO,0,0,5328212,Europe,8504,238
2020-06-09,Norway,NO,43,1,5328212,Europe,8547,239
2020-06-10,Norway,NO,16,0,5328212,Europe,8563,239
2020-06-11,Norway,NO,13,0,5328212,Europe,8576,239
2020-06-12,Norway,NO,18,3,5328212,Europe,8594,242
2020-06-13,Norway,NO,12,0,5328212,Europe,8606,242
2020-06-14,Norway,NO,0,0,5328212,Europe,8606,242
2020-06-15,Norway,NO,0,0,5328212,Europe,8606,242
2020-06-16,Norway,NO,25,0,5328212,Europe,8631,242
2020-06-17,Norway,NO,0,0,5328212,Europe,8631,242
2020-06-18,Norway,NO,29,1,5328212,Europe,8660,243
2020-06-19,Norway,NO,32,1,5328212,Europe,8692,244
2020-06-20,Norway,NO,0,0,5328212,Europe,8692,244
2020-06-21,Norway,NO,16,0,5328212,Europe,8708,244
2020-06-22,Norway,NO,0,0,5328212,Europe,8708,244
2020-06-23,Norway,NO,37,4,5328212,Europe,8745,248
2020-06-24,Norway,NO,6,0,5328212,Europe,8751,248
2020-06-25,Norway,NO,26,1,5328212,Europe,8777,249
2020-06-26,Norway,NO,16,0,5328212,Europe,8793,249
2020-06-27,Norway,NO,22,0,5328212,Europe,8815,249
2020-06-28,Norway,NO,0,0,5328212,Europe,8815,249
2020-06-29,Norway,NO,0,0,5328212,Europe,8815,249
2020-06-30,Norway,NO,40,0,5328212,Europe,8855,249
2020-07-01,Norway,NO,10,1,5328212,Europe,8865,250
2020-07-02,Norway,NO,22,1,5328212,Europe,8887,251
2020-07-03,Norway,NO,8,0,5328212,Europe,8895,251
2020-07-04,Norway,NO,0,0,5328212,Europe,8895,251
2020-07-05,Norway,NO,0,0,5328212,Europe,8895,251
2020-07-06,Norway,NO,0,0,5328212,Europe,8895,251
2020-07-07,Norway,NO,35,0,5328212,Europe,8930,251
2020-07-08,Norway,NO,6,0,5328212,Europe,8936,251
2020-07-09,Norway,NO,11,0,5328212,Europe,8947,251
2020-07-10,Norway,NO,7,1,5328212,Europe,8954,252
2020-07-11,Norway,NO,11,0,5328212,Europe,8965,252
2020-07-12,Norway,NO,0,0,5328212,Europe,8965,252
2020-07-13,Norway,NO,0,0,5328212,Europe,8965,252
2020-07-14,Norway,NO,16,1,5328212,Europe,8981,253
2020-07-15,Norway,NO,3,0,5328212,Europe,8984,253
2020-07-16,Norway,NO,17,0,5328212,Europe,9001,253
2020-07-17,Norway,NO,10,1,5328212,Europe,9011,254
2020-07-18,Norway,NO,4,1,5328212,Europe,9015,255
2020-07-19,Norway,NO,0,0,5328212,Europe,9015,255
2020-07-20,Norway,NO,0,0,5328212,Europe,9015,255
2020-07-21,Norway,NO,13,0,5328212,Europe,9028,255
2020-07-22,Norway,NO,10,0,5328212,Europe,9038,255
2020-07-23,Norway,NO,15,0,5328212,Europe,9053,255
2020-07-24,Norway,NO,9,0,5328212,Europe,9062,255
2020-07-25,Norway,NO,23,0,5328212,Europe,9085,255
2020-07-26,Norway,NO,0,0,5328212,Europe,9085,255
2020-07-27,Norway,NO,0,0,5328212,Europe,9085,255
2020-07-28,Norway,NO,32,0,5328212,Europe,9117,255
2020-07-29,Norway,NO,15,0,5328212,Europe,9132,255
2020-07-30,Norway,NO,18,0,5328212,Europe,9150,255
2020-07-31,Norway,NO,22,0,5328212,Europe,9172,255
2020-08-01,Norway,NO,36,0,5328212,Europe,9208,255
2020-08-02,Norway,NO,0,0,5328212,Europe,9208,255
2020-08-03,Norway,NO,0,0,5328212,Europe,9208,255
2020-08-04,Norway,NO,60,1,5328212,Europe,9268,256
2020-08-05,Norway,NO,65,0,5328212,Europe,9333,256
2020-08-06,Norway,NO,29,0,5328212,Europe,9362,256
2020-08-07,Norway,NO,47,0,5328212,Europe,9409,256
2020-08-08,Norway,NO,59,0,5328212,Europe,9468,256
2020-08-09,Norway,NO,0,0,5328212,Europe,9468,256
2020-08-10,Norway,NO,0,0,5328212,Europe,9468,256
2020-08-11,Norway,NO,170,0,5328212,Europe,9638,256
2020-08-12,Norway,NO,46,0,5328212,Europe,9684,256
2020-08-13,Norway,NO,66,0,5328212,Europe,9750,256
2020-08-14,Norway,NO,33,1,5328212,Europe,9783,257
2020-08-15,Norway,NO,67,4,5328212,Europe,9850,261
2020-08-16,Norway,NO,0,0,5328212,Europe,9850,261
2020-08-17,Norway,NO,0,0,5328212,Europe,9850,261
2020-08-18,Norway,NO,154,0,5328212,Europe,10004,261
2020-08-19,Norway,NO,56,1,5328212,Europe,10060,262
2020-08-20,Norway,NO,51,0,5328212,Europe,10111,262
2020-08-21,Norway,NO,51,2,5328212,Europe,10162,264
2020-08-22,Norway,NO,35,0,5328212,Europe,10197,264
2020-08-23,Norway,NO,0,0,5328212,Europe,10197,264
2020-08-24,Norway,NO,0,0,5328212,Europe,10197,264
2020-08-25,Norway,NO,126,0,5328212,Europe,10323,264
2020-08-26,Norway,NO,72,0,5328212,Europe,10395,264
2020-08-27,Norway,NO,59,0,5328212,Europe,10454,264
2020-08-28,Norway,NO,51,0,5328212,Europe,10505,264
2020-08-29,Norway,NO,38,0,5328212,Europe,10543,264
2020-08-30,Norway,NO,0,0,5328212,Europe,10543,264
2020-08-31,Norway,NO,0,0,5328212,Europe,10543,264
2020-09-01,Norway,NO,101,0,5328212,Europe,10644,264
2020-09-02,Norway,NO,139,0,5328212,Europe,10783,264
2020-09-03,Norway,NO,88,0,5328212,Europe,10871,264
2020-09-04,Norway,NO,164,0,5328212,Europe,11035,264
2020-09-05,Norway,NO,85,0,5328212,Europe,11120,264
2020-09-06,Norway,NO,0,0,5328212,Europe,11120,264
2020-09-07,Norway,NO,0,0,5328212,Europe,11120,264
2020-09-08,Norway,NO,267,0,5328212,Europe,11387,264
2020-09-09,Norway,NO,132,0,5328212,Europe,11519,264
2020-09-10,Norway,NO,105,0,5328212,Europe,11624,264
2020-09-11,Norway,NO,122,1,5328212,Europe,11746,265
2020-09-12,Norway,NO,120,0,5328212,Europe,11866,265
2020-09-13,Norway,NO,0,0,5328212,Europe,11866,265
2020-09-14,Norway,NO,0,0,5328212,Europe,11866,265
2020-09-15,Norway,NO,289,0,5328212,Europe,12155,265
2020-09-16,Norway,NO,122,0,5328212,Europe,12277,265
2020-09-17,Norway,NO,116,0,5328212,Europe,12393,265
2020-09-18,Norway,NO,106,1,5328212,Europe,12499,266
2020-09-19,Norway,NO,146,1,5328212,Europe,12645,267
2020-09-20,Norway,NO,0,0,5328212,Europe,12645,267
2020-09-21,Norway,NO,0,0,5328212,Europe,12645,267
2020-09-22,Norway,NO,251,0,5328212,Europe,12896,267
2020-09-23,Norway,NO,104,0,5328212,Europe,13000,267
2020-09-24,Norway,NO,152,0,5328212,Europe,13152,267
2020-09-25,Norway,NO,123,3,5328212,Europe,13275,270
2020-09-26,Norway,NO,131,0,5328212,Europe,13406,270
2020-09-27,Norway,NO,0,0,5328212,Europe,13406,270
2020-09-28,Norway,NO,0,0,5328212,Europe,13406,270
2020-09-29,Norway,NO,292,4,5328212,Europe,13698,274
2020-09-30,Norway,NO,90,0,5328212,Europe,13788,274
2020-10-01,Norway,NO,126,0,5328212,Europe,13914,274
2020-10-02,Norway,NO,113,0,5328212,Europe,14027,274
2020-10-03,Norway,NO,122,1,5328212,Europe,14149,275
2020-10-04,Norway,NO,0,0,5328212,Europe,14149,275
2020-10-05,Norway,NO,0,0,5328212,Europe,14149,275
2020-10-06,Norway,NO,308,0,5328212,Europe,14457,275
2020-10-07,Norway,NO,147,0,5328212,Europe,14604,275
2020-10-08,Norway,NO,180,0,5328212,Europe,14784,275
2020-10-09,Norway,NO,228,0,5328212,Europe,15012,275
2020-10-10,Norway,NO,209,0,5328212,Europe,15221,275
2020-10-11,Norway,NO,0,0,5328212,Europe,15221,275
2020-10-12,Norway,NO,0,0,5328212,Europe,15221,275
2020-10-13,Norway,NO,303,1,5328212,Europe,15524,276
2020-10-14,Norway,NO,115,1,5328212,Europe,15639,277
2020-10-15,Norway,NO,152,0,5328212,Europe,15791,277
2020-10-16,Norway,NO,162,1,5328212,Europe,15953,278
2020-10-17,Norway,NO,183,0,5328212,Europe,16136,278
2020-10-18,Norway,NO,0,0,5328212,Europe,16136,278
2020-10-19,Norway,NO,0,0,5328212,Europe,16136,278
2020-10-20,Norway,NO,320,0,5328212,Europe,16456,278
2020-10-21,Norway,NO,147,0,5328212,Europe,16603,278
2020-10-22,Norway,NO,168,1,5328212,Europe,16771,279
2020-10-23,Norway,NO,193,0,5328212,Europe,16964,279
2020-10-24,Norway,NO,268,0,5328212,Europe,17232,279
2020-10-25,Norway,NO,0,0,5328212,Europe,17232,279
2020-10-26,Norway,NO,0,0,5328212,Europe,17232,279
2020-10-27,Norway,NO,676,0,5328212,Europe,17908,279
2020-10-28,Norway,NO,433,1,5328212,Europe,18341,280
2020-10-29,Norway,NO,322,0,5328212,Europe,18663,280
2020-10-30,Norway,NO,403,1,5328212,Europe,19066,281
2020-10-31,Norway,NO,497,1,5328212,Europe,19563,282
2020-11-01,Norway,NO,0,0,5328212,Europe,19563,282
2020-11-02,Norway,NO,0,0,5328212,Europe,19563,282
2020-11-03,Norway,NO,1071,0,5328212,Europe,20634,282
2020-11-04,Norway,NO,700,0,5328212,Europe,21334,282
2020-11-05,Norway,NO,620,0,5328212,Europe,21954,282
2020-11-06,Norway,NO,621,2,5328212,Europe,22575,284
2020-11-07,Norway,NO,650,1,5328212,Europe,23225,285
2020-11-08,Norway,NO,0,0,5328212,Europe,23225,285
2020-11-09,Norway,NO,0,0,5328212,Europe,23225,285
2020-11-10,Norway,NO,1502,0,5328212,Europe,24727,285
2020-11-11,Norway,NO,594,0,5328212,Europe,25321,285
2020-11-12,Norway,NO,564,0,5328212,Europe,25885,285
2020-11-13,Norway,NO,618,6,5328212,Europe,26503,291
2020-11-14,Norway,NO,723,3,5328212,Europe,27226,294
2020-11-15,Norway,NO,0,0,5328212,Europe,27226,294
2020-11-16,Norway,NO,0,0,5328212,Europe,27226,294
2020-11-17,Norway,NO,1737,0,5328212,Europe,28963,294
2020-11-18,Norway,NO,547,4,5328212,Europe,29510,298
2020-11-19,Norway,NO,603,1,5328212,Europe,30113,299
2020-11-20,Norway,NO,655,6,5328212,Europe,30768,305
2020-11-21,Norway,NO,670,1,5328212,Europe,31438,306
2020-11-22,Norway,NO,0,0,5328212,Europe,31438,306
2020-11-23,Norway,NO,0,0,5328212,Europe,31438,306
2020-11-24,Norway,NO,1329,5,5328212,Europe,32767,311
2020-11-25,Norway,NO,416,3,5328212,Europe,33183,314
2020-11-26,Norway,NO,531,2,5328212,Europe,33714,316
2020-11-27,Norway,NO,553,0,5328212,Europe,34267,316
2020-11-28,Norway,NO,480,12,5328212,Europe,34747,328
2020-11-29,Norway,NO,0,0,5328212,Europe,34747,328
2020-11-30,Norway,NO,0,0,5328212,Europe,34747,328
2020-12-01,Norway,NO,1079,4,5328212,Europe,35826,332
2020-12-02,Norway,NO,324,2,5328212,Europe,36150,334
2020-12-03,Norway,NO,441,17,5328212,Europe,36591,351
2020-12-04,Norway,NO,377,2,5328212,Europe,36968,353
2020-12-05,Norway,NO,403,1,5328212,Europe,37371,354
2020-12-06,Norway,NO,0,0,5328212,Europe,37371,354
2020-12-07,Norway,NO,0,0,5328212,Europe,37371,354
2020-12-08,Norway,NO,951,5,5328212,Europe,38322,359
2020-12-09,Norway,NO,381,2,5328212,Europe,38703,361
2020-12-10,Norway,NO,459,0,5328212,Europe,39162,361
2020-12-11,Norway,NO,362,21,5328212,Europe,39524,382
2020-12-12,Norway,NO,498,5,5328212,Europe,40022,387
2020-12-13,Norway,NO,0,0,5328212,Europe,40022,387
2020-12-14,Norway,NO,0,0,5328212,Europe,40022,387
2019-12-31,Nepal,NP,0,0,28608715,Asia,0,0
2020-01-01,Nepal,NP,0,0,28608715,Asia,0,0
2020-01-02,Nepal,NP,0,0,28608715,Asia,0,0
2020-01-03,Nepal,NP,0,0,28608715,Asia,0,0
2020-01-04,Nepal,NP,0,0,28608715,Asia,0,0
2020-01-05,Nepal,NP,0,0,28608715,Asia,0,0
2020-01-06,Nepal,NP,0,0,28608715,Asia,0,0
2020-01-07,Nepal,NP,0,0,28608715,Asia,0,0
2020-01-08,Nepal,NP,0,0,28608715,Asia,0,0
2020-01-09,Nepal,NP,0,0,28608715,Asia,0,0
2020-01-10,Nepal,NP,0,0,28608715,Asia,0,0
2020-01-11,Nepal,NP,0,0,28608715,Asia,0,0
2020-01-12,Nepal,NP,0,0,28608715,Asia,0,0
2020-01-13,Nepal,NP,0,0,28608715,Asia,0,0
2020-01-14,Nepal,NP,0,0,28608715,Asia,0,0
2020-01-15,Nepal,NP,0,0,28608715,Asia,0,0
2020-01-16,Nepal,NP,0,0,28608715,Asia,0,0
2020-01-17,Nepal,NP,0,0,28608715,Asia,0,0
2020-01-18,Nepal,NP,0,0,28608715,Asia,0,0
2020-01-19,Nepal,NP,0,0,28608715,Asia,0,0
2020-01-20,Nepal,NP,0,0,28608715,Asia,0,0
2020-01-21,Nepal,NP,0,0,28608715,Asia,0,0
2020-01-22,Nepal,NP,0,0,28608715,Asia,0,0
2020-01-23,Nepal,NP,0,0,28608715,Asia,0,0
2020-01-24,Nepal,NP,0,0,28608715,Asia,0,0
2020-01-25,Nepal,NP,1,0,28608715,Asia,1,0
2020-01-26,Nepal,NP,0,0,28608715,Asia,1,0
2020-01-27,Nepal,NP,0,0,28608715,Asia,1,0
2020-01-28,Nepal,NP,0,0,28608715,Asia,1,0
2020-01-29,Nepal,NP,0,0,28608715,Asia,1,0
2020-01-30,Nepal,NP,0,0,28608715,Asia,1,0
2020-01-31,Nepal,NP,0,0,28608715,Asia,1,0
2020-02-01,Nepal,NP,0,0,28608715,Asia,1,0
2020-02-02,Nepal,NP,0,0,28608715,Asia,1,0
2020-02-03,Nepal,NP,0,0,28608715,Asia,1,0
2020-02-04,Nepal,NP,0,0,28608715,Asia,1,0
2020-02-05,Nepal,NP,0,0,28608715,Asia,1,0
2020-02-06,Nepal,NP,0,0,28608715,Asia,1,0
2020-02-07,Nepal,NP,0,0,28608715,Asia,1,0
2020-02-08,Nepal,NP,0,0,28608715,Asia,1,0
2020-02-09,Nepal,NP,0,0,28608715,Asia,1,0
2020-02-10,Nepal,NP,0,0,28608715,Asia,1,0
2020-02-11,Nepal,NP,0,0,28608715,Asia,1,0
2020-02-12,Nepal,NP,0,0,28608715,Asia,1,0
2020-02-13,Nepal,NP,0,0,28608715,Asia,1,0
2020-02-14,Nepal,NP,0,0,28608715,Asia,1,0
2020-02-15,Nepal,NP,0,0,28608715,Asia,1,0
2020-02-16,Nepal,NP,0,0,28608715,Asia,1,0
2020-02-17,Nepal,NP,0,0,28608715,Asia,1,0
2020-02-18,Nepal,NP,0,0,28608715,Asia,1,0
2020-02-19,Nepal,NP,0,0,28608715,Asia,1,0
2020-02-20,Nepal,NP,0,0,28608715,Asia,1,0
2020-02-21,Nepal,NP,0,0,28608715,Asia,1,0
2020-02-22,Nepal,NP,0,0,28608715,Asia,1,0
2020-02-23,Nepal,NP,0,0,28608715,Asia,1,0
2020-02-24,Nepal,NP,0,0,28608715,Asia,1,0
2020-02-25,Nepal,NP,0,0,28608715,Asia,1,0
2020-02-26,Nepal,NP,0,0,28608715,Asia,1,0
2020-02-27,Nepal,NP,0,0,28608715,Asia,1,0
2020-02-28,Nepal,NP,0,0,28608715,Asia,1,0
2020-02-29,Nepal,NP,0,0,28608715,Asia,1,0
2020-03-01,Nepal,NP,0,0,28608715,Asia,1,0
2020-03-02,Nepal,NP,0,0,28608715,Asia,1,0
2020-03-15,Nepal,NP,0,0,28608715,Asia,1,0
2020-03-17,Nepal,NP,0,0,28608715,Asia,1,0
2020-03-18,Nepal,NP,0,0,28608715,Asia,1,0
2020-03-19,Nepal,NP,0,0,28608715,Asia,1,0
2020-03-20,Nepal,NP,0,0,28608715,Asia,1,0
2020-03-21,Nepal,NP,0,0,28608715,Asia,1,0
2020-03-22,Nepal,NP,0,0,28608715,Asia,1,0
2020-03-23,Nepal,NP,0,0,28608715,Asia,1,0
2020-03-24,Nepal,NP,1,0,28608715,Asia,2,0
2020-03-25,Nepal,NP,1,0,28608715,Asia,3,0
2020-03-26,Nepal,NP,0,0,28608715,Asia,3,0
2020-03-27,Nepal,NP,0,0,28608715,Asia,3,0
2020-03-28,Nepal,NP,0,0,28608715,Asia,3,0
2020-03-29,Nepal,NP,2,0,28608715,Asia,5,0
2020-03-30,Nepal,NP,0,0,28608715,Asia,5,0
2020-03-31,Nepal,NP,0,0,28608715,Asia,5,0
2020-04-01,Nepal,NP,0,0,28608715,Asia,5,0
2020-04-02,Nepal,NP,0,0,28608715,Asia,5,0
2020-04-03,Nepal,NP,0,0,28608715,Asia,5,0
2020-04-04,Nepal,NP,1,0,28608715,Asia,6,0
2020-04-05,Nepal,NP,0,0,28608715,Asia,6,0
2020-04-06,Nepal,NP,3,0,28608715,Asia,9,0
2020-04-07,Nepal,NP,0,0,28608715,Asia,9,0
2020-04-08,Nepal,NP,0,0,28608715,Asia,9,0
2020-04-09,Nepal,NP,0,0,28608715,Asia,9,0
2020-04-10,Nepal,NP,0,0,28608715,Asia,9,0
2020-04-11,Nepal,NP,0,0,28608715,Asia,9,0
2020-04-12,Nepal,NP,0,0,28608715,Asia,9,0
2020-04-13,Nepal,NP,3,0,28608715,Asia,12,0
2020-04-14,Nepal,NP,2,0,28608715,Asia,14,0
2020-04-15,Nepal,NP,2,0,28608715,Asia,16,0
2020-04-16,Nepal,NP,0,0,28608715,Asia,16,0
2020-04-17,Nepal,NP,0,0,28608715,Asia,16,0
2020-04-18,Nepal,NP,14,0,28608715,Asia,30,0
2020-04-19,Nepal,NP,1,0,28608715,Asia,31,0
2020-04-20,Nepal,NP,0,0,28608715,Asia,31,0
2020-04-21,Nepal,NP,0,0,28608715,Asia,31,0
2020-04-22,Nepal,NP,11,0,28608715,Asia,42,0
2020-04-23,Nepal,NP,3,0,28608715,Asia,45,0
2020-04-24,Nepal,NP,3,0,28608715,Asia,48,0
2020-04-25,Nepal,NP,1,0,28608715,Asia,49,0
2020-04-26,Nepal,NP,0,0,28608715,Asia,49,0
2020-04-27,Nepal,NP,3,0,28608715,Asia,52,0
2020-04-28,Nepal,NP,0,0,28608715,Asia,52,0
2020-04-29,Nepal,NP,2,0,28608715,Asia,54,0
2020-04-30,Nepal,NP,3,0,28608715,Asia,57,0
2020-05-01,Nepal,NP,0,0,28608715,Asia,57,0
2020-05-02,Nepal,NP,2,0,28608715,Asia,59,0
2020-05-03,Nepal,NP,0,0,28608715,Asia,59,0
2020-05-04,Nepal,NP,16,0,28608715,Asia,75,0
2020-05-05,Nepal,NP,7,0,28608715,Asia,82,0
2020-05-06,Nepal,NP,0,0,28608715,Asia,82,0
2020-05-07,Nepal,NP,17,0,28608715,Asia,99,0
2020-05-08,Nepal,NP,2,0,28608715,Asia,101,0
2020-05-09,Nepal,NP,0,0,28608715,Asia,101,0
2020-05-10,Nepal,NP,8,0,28608715,Asia,109,0
2020-05-11,Nepal,NP,11,0,28608715,Asia,120,0
2020-05-12,Nepal,NP,14,0,28608715,Asia,134,0
2020-05-13,Nepal,NP,83,0,28608715,Asia,217,0
2020-05-14,Nepal,NP,2,0,28608715,Asia,219,0
2020-05-15,Nepal,NP,39,0,28608715,Asia,258,0
2020-05-16,Nepal,NP,18,0,28608715,Asia,276,0
2020-05-17,Nepal,NP,15,1,28608715,Asia,291,1
2020-05-18,Nepal,NP,13,1,28608715,Asia,304,2
2020-05-19,Nepal,NP,71,0,28608715,Asia,375,2
2020-05-20,Nepal,NP,27,0,28608715,Asia,402,2
2020-05-21,Nepal,NP,42,0,28608715,Asia,444,2
2020-05-22,Nepal,NP,43,1,28608715,Asia,487,3
2020-05-23,Nepal,NP,61,0,28608715,Asia,548,3
2020-05-24,Nepal,NP,36,0,28608715,Asia,584,3
2020-05-25,Nepal,NP,19,0,28608715,Asia,603,3
2020-05-26,Nepal,NP,79,1,28608715,Asia,682,4
2020-05-27,Nepal,NP,90,0,28608715,Asia,772,4
2020-05-28,Nepal,NP,114,0,28608715,Asia,886,4
2020-05-29,Nepal,NP,156,1,28608715,Asia,1042,5
2020-05-30,Nepal,NP,170,1,28608715,Asia,1212,6
2020-05-31,Nepal,NP,189,0,28608715,Asia,1401,6
2020-06-01,Nepal,NP,171,2,28608715,Asia,1572,8
2020-06-02,Nepal,NP,226,0,28608715,Asia,1798,8
2020-06-03,Nepal,NP,301,0,28608715,Asia,2099,8
2020-06-04,Nepal,NP,201,1,28608715,Asia,2300,9
2020-06-05,Nepal,NP,334,1,28608715,Asia,2634,10
2020-06-06,Nepal,NP,278,1,28608715,Asia,2912,11
2020-06-07,Nepal,NP,0,0,28608715,Asia,2912,11
2020-06-08,Nepal,NP,536,2,28608715,Asia,3448,13
2020-06-09,Nepal,NP,314,1,28608715,Asia,3762,14
2020-06-10,Nepal,NP,323,1,28608715,Asia,4085,15
2020-06-11,Nepal,NP,279,0,28608715,Asia,4364,15
2020-06-12,Nepal,NP,250,0,28608715,Asia,4614,15
2020-06-13,Nepal,NP,448,1,28608715,Asia,5062,16
2020-06-14,Nepal,NP,273,2,28608715,Asia,5335,18
2020-06-15,Nepal,NP,425,1,28608715,Asia,5760,19
2020-06-16,Nepal,NP,451,0,28608715,Asia,6211,19
2020-06-17,Nepal,NP,380,0,28608715,Asia,6591,19
2020-06-18,Nepal,NP,586,1,28608715,Asia,7177,20
2020-06-19,Nepal,NP,671,2,28608715,Asia,7848,22
2020-06-20,Nepal,NP,426,0,28608715,Asia,8274,22
2020-06-21,Nepal,NP,331,0,28608715,Asia,8605,22
2020-06-22,Nepal,NP,421,1,28608715,Asia,9026,23
2020-06-23,Nepal,NP,0,0,28608715,Asia,9026,23
2020-06-24,Nepal,NP,0,0,28608715,Asia,9026,23
2020-06-25,Nepal,NP,1702,0,28608715,Asia,10728,23
2020-06-26,Nepal,NP,434,3,28608715,Asia,11162,26
2020-06-27,Nepal,NP,593,1,28608715,Asia,11755,27
2020-06-28,Nepal,NP,0,0,28608715,Asia,11755,27
2020-06-29,Nepal,NP,1017,1,28608715,Asia,12772,28
2020-06-30,Nepal,NP,476,1,28608715,Asia,13248,29
2020-07-01,Nepal,NP,316,0,28608715,Asia,13564,29
2020-07-02,Nepal,NP,482,1,28608715,Asia,14046,30
2020-07-03,Nepal,NP,473,1,28608715,Asia,14519,31
2020-07-04,Nepal,NP,740,1,28608715,Asia,15259,32
2020-07-05,Nepal,NP,232,2,28608715,Asia,15491,34
2020-07-06,Nepal,NP,293,0,28608715,Asia,15784,34
2020-07-07,Nepal,NP,180,1,28608715,Asia,15964,35
2020-07-08,Nepal,NP,0,0,28608715,Asia,15964,35
2020-07-09,Nepal,NP,459,0,28608715,Asia,16423,35
2020-07-10,Nepal,NP,108,0,28608715,Asia,16531,35
2020-07-11,Nepal,NP,118,0,28608715,Asia,16649,35
2020-07-12,Nepal,NP,70,3,28608715,Asia,16719,38
2020-07-13,Nepal,NP,82,0,28608715,Asia,16801,38
2020-07-14,Nepal,NP,144,0,28608715,Asia,16945,38
2020-07-15,Nepal,NP,116,0,28608715,Asia,17061,38
2020-07-16,Nepal,NP,116,1,28608715,Asia,17177,39
2020-07-17,Nepal,NP,167,0,28608715,Asia,17344,39
2020-07-18,Nepal,NP,101,1,28608715,Asia,17445,40
2020-07-19,Nepal,NP,57,0,28608715,Asia,17502,40
2020-07-20,Nepal,NP,156,0,28608715,Asia,17658,40
2020-07-21,Nepal,NP,186,0,28608715,Asia,17844,40
2020-07-22,Nepal,NP,100,0,28608715,Asia,17944,40
2020-07-23,Nepal,NP,150,2,28608715,Asia,18094,42
2020-07-24,Nepal,NP,147,1,28608715,Asia,18241,43
2020-07-25,Nepal,NP,133,1,28608715,Asia,18374,44
2020-07-26,Nepal,NP,109,1,28608715,Asia,18483,45
2020-07-27,Nepal,NP,130,0,28608715,Asia,18613,45
2020-07-28,Nepal,NP,139,3,28608715,Asia,18752,48
2020-07-29,Nepal,NP,311,1,28608715,Asia,19063,49
2020-07-30,Nepal,NP,210,0,28608715,Asia,19273,49
2020-07-31,Nepal,NP,274,3,28608715,Asia,19547,52
2020-08-01,Nepal,NP,224,4,28608715,Asia,19771,56
2020-08-02,Nepal,NP,315,0,28608715,Asia,20086,56
2020-08-03,Nepal,NP,246,1,28608715,Asia,20332,57
2020-08-04,Nepal,NP,418,0,28608715,Asia,20750,57
2020-08-05,Nepal,NP,259,1,28608715,Asia,21009,58
2020-08-06,Nepal,NP,381,2,28608715,Asia,21390,60
2020-08-07,Nepal,NP,360,5,28608715,Asia,21750,65
2020-08-08,Nepal,NP,464,5,28608715,Asia,22214,70
2020-08-09,Nepal,NP,378,3,28608715,Asia,22592,73
2020-08-10,Nepal,NP,380,2,28608715,Asia,22972,75
2020-08-11,Nepal,NP,338,4,28608715,Asia,23310,79
2020-08-12,Nepal,NP,638,4,28608715,Asia,23948,83
2020-08-13,Nepal,NP,484,8,28608715,Asia,24432,91
2020-08-14,Nepal,NP,525,4,28608715,Asia,24957,95
2020-08-15,Nepal,NP,594,4,28608715,Asia,25551,99
2020-08-16,Nepal,NP,468,3,28608715,Asia,26019,102
2020-08-17,Nepal,NP,641,2,28608715,Asia,26660,104
2020-08-18,Nepal,NP,581,3,28608715,Asia,27241,107
2020-08-19,Nepal,NP,1016,7,28608715,Asia,28257,114
2020-08-20,Nepal,NP,681,6,28608715,Asia,28938,120
2020-08-21,Nepal,NP,707,6,28608715,Asia,29645,126
2020-08-22,Nepal,NP,838,11,28608715,Asia,30483,137
2020-08-23,Nepal,NP,634,9,28608715,Asia,31117,146
2020-08-24,Nepal,NP,818,3,28608715,Asia,31935,149
2020-08-25,Nepal,NP,743,8,28608715,Asia,32678,157
2020-08-26,Nepal,NP,855,7,28608715,Asia,33533,164
2020-08-27,Nepal,NP,885,11,28608715,Asia,34418,175
2020-08-28,Nepal,NP,1111,8,28608715,Asia,35529,183
2020-08-29,Nepal,NP,927,12,28608715,Asia,36456,195
2020-08-30,Nepal,NP,884,12,28608715,Asia,37340,207
2020-08-31,Nepal,NP,1221,14,28608715,Asia,38561,221
2020-09-01,Nepal,NP,899,7,28608715,Asia,39460,228
2020-09-02,Nepal,NP,1069,11,28608715,Asia,40529,239
2020-09-03,Nepal,NP,1120,12,28608715,Asia,41649,251
2020-09-04,Nepal,NP,1228,6,28608715,Asia,42877,257
2020-09-05,Nepal,NP,1359,14,28608715,Asia,44236,271
2020-09-06,Nepal,NP,1041,9,28608715,Asia,45277,280
2020-09-07,Nepal,NP,980,9,28608715,Asia,46257,289
2020-09-08,Nepal,NP,979,11,28608715,Asia,47236,300
2020-09-09,Nepal,NP,902,6,28608715,Asia,48138,306
2020-09-10,Nepal,NP,1081,6,28608715,Asia,49219,312
2020-09-11,Nepal,NP,1246,5,28608715,Asia,50465,317
2020-09-12,Nepal,NP,1454,5,28608715,Asia,51919,322
2020-09-13,Nepal,NP,1201,14,28608715,Asia,53120,336
2020-09-14,Nepal,NP,1039,9,28608715,Asia,54159,345
2020-09-15,Nepal,NP,1170,15,28608715,Asia,55329,360
2020-09-16,Nepal,NP,1459,11,28608715,Asia,56788,371
2020-09-17,Nepal,NP,1539,8,28608715,Asia,58327,379
2020-09-18,Nepal,NP,1246,4,28608715,Asia,59573,383
2020-09-19,Nepal,NP,2020,7,28608715,Asia,61593,390
2020-09-20,Nepal,NP,1204,11,28608715,Asia,62797,401
2020-09-21,Nepal,NP,1325,10,28608715,Asia,64122,411
2020-09-22,Nepal,NP,1154,16,28608715,Asia,65276,427
2020-09-23,Nepal,NP,1356,2,28608715,Asia,66632,429
2020-09-24,Nepal,NP,1172,7,28608715,Asia,67804,436
2020-09-25,Nepal,NP,1497,17,28608715,Asia,69301,453
2020-09-26,Nepal,NP,1313,6,28608715,Asia,70614,459
2020-09-27,Nepal,NP,1207,8,28608715,Asia,71821,467
2020-09-28,Nepal,NP,1573,10,28608715,Asia,73394,477
2020-09-29,Nepal,NP,1351,4,28608715,Asia,74745,481
2020-09-30,Nepal,NP,1513,10,28608715,Asia,76258,491
2020-10-01,Nepal,NP,1559,7,28608715,Asia,77817,498
2020-10-02,Nepal,NP,1911,11,28608715,Asia,79728,509
2020-10-03,Nepal,NP,2722,11,28608715,Asia,82450,520
2020-10-04,Nepal,NP,2120,8,28608715,Asia,84570,528
2020-10-05,Nepal,NP,2253,7,28608715,Asia,86823,535
2020-10-06,Nepal,NP,2440,19,28608715,Asia,89263,554
2020-10-07,Nepal,NP,1551,9,28608715,Asia,90814,563
2020-10-08,Nepal,NP,3439,15,28608715,Asia,94253,578
2020-10-09,Nepal,NP,4364,12,28608715,Asia,98617,590
2020-10-10,Nepal,NP,2059,10,28608715,Asia,100676,600
2020-10-11,Nepal,NP,5008,14,28608715,Asia,105684,614
2020-10-12,Nepal,NP,2071,22,28608715,Asia,107755,636
2020-10-13,Nepal,NP,4047,9,28608715,Asia,111802,645
2020-10-14,Nepal,NP,3556,18,28608715,Asia,115358,663
2020-10-15,Nepal,NP,2638,12,28608715,Asia,117996,675
2020-10-16,Nepal,NP,3749,19,28608715,Asia,121745,694
2020-10-17,Nepal,NP,4392,21,28608715,Asia,126137,715
2020-10-18,Nepal,NP,3167,12,28608715,Asia,129304,727
2020-10-19,Nepal,NP,2942,12,28608715,Asia,132246,739
2020-10-20,Nepal,NP,3790,18,28608715,Asia,136036,757
2020-10-21,Nepal,NP,3093,8,28608715,Asia,139129,765
2020-10-22,Nepal,NP,5743,26,28608715,Asia,144872,791
2020-10-23,Nepal,NP,3637,21,28608715,Asia,148509,812
2020-10-24,Nepal,NP,4499,17,28608715,Asia,153008,829
2020-10-25,Nepal,NP,2225,13,28608715,Asia,155233,842
2020-10-26,Nepal,NP,2856,5,28608715,Asia,158089,847
2020-10-27,Nepal,NP,1741,15,28608715,Asia,159830,862
2020-10-28,Nepal,NP,570,14,28608715,Asia,160400,876
2020-10-29,Nepal,NP,1954,11,28608715,Asia,162354,887
2020-10-30,Nepal,NP,2364,17,28608715,Asia,164718,904
2020-10-31,Nepal,NP,3517,16,28608715,Asia,168235,920
2020-11-01,Nepal,NP,2508,17,28608715,Asia,170743,937
2020-11-02,Nepal,NP,2824,23,28608715,Asia,173567,960
2020-11-03,Nepal,NP,2933,24,28608715,Asia,176500,984
2020-11-04,Nepal,NP,3114,20,28608715,Asia,179614,1004
2020-11-05,Nepal,NP,3309,30,28608715,Asia,182923,1034
2020-11-06,Nepal,NP,3051,18,28608715,Asia,185974,1052
2020-11-07,Nepal,NP,2909,18,28608715,Asia,188883,1070
2020-11-08,Nepal,NP,2753,17,28608715,Asia,191636,1087
2020-11-09,Nepal,NP,2817,21,28608715,Asia,194453,1108
2020-11-10,Nepal,NP,2571,18,28608715,Asia,197024,1126
2020-11-11,Nepal,NP,2736,22,28608715,Asia,199760,1148
2020-11-12,Nepal,NP,2569,26,28608715,Asia,202329,1174
2020-11-13,Nepal,NP,1913,15,28608715,Asia,204242,1189
2020-11-14,Nepal,NP,2111,13,28608715,Asia,206353,1202
2020-11-15,Nepal,NP,1946,13,28608715,Asia,208299,1215
2020-11-16,Nepal,NP,1477,6,28608715,Asia,209776,1221
2020-11-17,Nepal,NP,1197,9,28608715,Asia,210973,1230
2020-11-18,Nepal,NP,502,17,28608715,Asia,211475,1247
2020-11-19,Nepal,NP,1442,12,28608715,Asia,212917,1259
2020-11-20,Nepal,NP,2103,17,28608715,Asia,215020,1276
2020-11-21,Nepal,NP,1945,22,28608715,Asia,216965,1298
2020-11-22,Nepal,NP,1674,7,28608715,Asia,218639,1305
2020-11-23,Nepal,NP,1669,16,28608715,Asia,220308,1321
2020-11-24,Nepal,NP,1980,16,28608715,Asia,222288,1337
2020-11-25,Nepal,NP,1790,24,28608715,Asia,224078,1361
2020-11-26,Nepal,NP,1948,28,28608715,Asia,226026,1389
2020-11-27,Nepal,NP,1614,23,28608715,Asia,227640,1412
2020-11-28,Nepal,NP,1703,23,28608715,Asia,229343,1435
2020-11-29,Nepal,NP,1380,19,28608715,Asia,230723,1454
2020-11-30,Nepal,NP,1255,25,28608715,Asia,231978,1479
2020-12-01,Nepal,NP,1474,29,28608715,Asia,233452,1508
2020-12-02,Nepal,NP,0,21,28608715,Asia,233452,1529
2020-12-03,Nepal,NP,2794,9,28608715,Asia,236246,1538
2020-12-04,Nepal,NP,1343,13,28608715,Asia,237589,1551
2020-12-05,Nepal,NP,1272,16,28608715,Asia,238861,1567
2020-12-06,Nepal,NP,1024,10,28608715,Asia,239885,1577
2020-12-07,Nepal,NP,1096,17,28608715,Asia,240981,1594
2020-12-08,Nepal,NP,1014,20,28608715,Asia,241995,1614
2020-12-09,Nepal,NP,1382,23,28608715,Asia,243377,1637
2020-12-10,Nepal,NP,1056,14,28608715,Asia,244433,1651
2020-12-11,Nepal,NP,1217,12,28608715,Asia,245650,1663
2020-12-12,Nepal,NP,1044,11,28608715,Asia,246694,1674
2020-12-13,Nepal,NP,899,15,28608715,Asia,247593,1689
2020-12-14,Nepal,NP,830,9,28608715,Asia,248423,1698
2019-12-31,New_Zealand,NZ,0,0,4783062,Oceania,0,0
2020-01-01,New_Zealand,NZ,0,0,4783062,Oceania,0,0
2020-01-02,New_Zealand,NZ,0,0,4783062,Oceania,0,0
2020-01-03,New_Zealand,NZ,0,0,4783062,Oceania,0,0
2020-01-04,New_Zealand,NZ,0,0,4783062,Oceania,0,0
2020-01-05,New_Zealand,NZ,0,0,4783062,Oceania,0,0
2020-01-06,New_Zealand,NZ,0,0,4783062,Oceania,0,0
2020-01-07,New_Zealand,NZ,0,0,4783062,Oceania,0,0
2020-01-08,New_Zealand,NZ,0,0,4783062,Oceania,0,0
2020-01-09,New_Zealand,NZ,0,0,4783062,Oceania,0,0
2020-01-10,New_Zealand,NZ,0,0,4783062,Oceania,0,0
2020-01-11,New_Zealand,NZ,0,0,4783062,Oceania,0,0
2020-01-12,New_Zealand,NZ,0,0,4783062,Oceania,0,0
2020-01-13,New_Zealand,NZ,0,0,4783062,Oceania,0,0
2020-01-14,New_Zealand,NZ,0,0,4783062,Oceania,0,0
2020-01-15,New_Zealand,NZ,0,0,4783062,Oceania,0,0
2020-01-16,New_Zealand,NZ,0,0,4783062,Oceania,0,0
2020-01-17,New_Zealand,NZ,0,0,4783062,Oceania,0,0
2020-01-18,New_Zealand,NZ,0,0,4783062,Oceania,0,0
2020-01-19,New_Zealand,NZ,0,0,4783062,Oceania,0,0
2020-01-20,New_Zealand,NZ,0,0,4783062,Oceania,0,0
2020-01-21,New_Zealand,NZ,0,0,4783062,Oceania,0,0
2020-01-22,New_Zealand,NZ,0,0,4783062,Oceania,0,0
2020-01-23,New_Zealand,NZ,0,0,4783062,Oceania,0,0
2020-01-24,New_Zealand,NZ,0,0,4783062,Oceania,0,0
2020-01-25,New_Zealand,NZ,0,0,4783062,Oceania,0,0
2020-01-26,New_Zealand,NZ,0,0,4783062,Oceania,0,0
2020-01-27,New_Zealand,NZ,0,0,4783062,Oceania,0,0
2020-01-28,New_Zealand,NZ,0,0,4783062,Oceania,0,0
2020-01-29,New_Zealand,NZ,0,0,4783062,Oceania,0,0
2020-01-30,New_Zealand,NZ,0,0,4783062,Oceania,0,0
2020-01-31,New_Zealand,NZ,0,0,4783062,Oceania,0,0
2020-02-01,New_Zealand,NZ,0,0,4783062,Oceania,0,0
2020-02-02,New_Zealand,NZ,0,0,4783062,Oceania,0,0
2020-02-03,New_Zealand,NZ,0,0,4783062,Oceania,0,0
2020-02-04,New_Zealand,NZ,0,0,4783062,Oceania,0,0
2020-02-05,New_Zealand,NZ,0,0,4783062,Oceania,0,0
2020-02-06,New_Zealand,NZ,0,0,4783062,Oceania,0,0
2020-02-07,New_Zealand,NZ,0,0,4783062,Oceania,0,0
2020-02-08,New_Zealand,NZ,0,0,4783062,Oceania,0,0
2020-02-09,New_Zealand,NZ,0,0,4783062,Oceania,0,0
2020-02-10,New_Zealand,NZ,0,0,4783062,Oceania,0,0
2020-02-11,New_Zealand,NZ,0,0,4783062,Oceania,0,0
2020-02-12,New_Zealand,NZ,0,0,4783062,Oceania,0,0
2020-02-13,New_Zealand,NZ,0,0,4783062,Oceania,0,0
2020-02-14,New_Zealand,NZ,0,0,4783062,Oceania,0,0
2020-02-15,New_Zealand,NZ,0,0,4783062,Oceania,0,0
2020-02-16,New_Zealand,NZ,0,0,4783062,Oceania,0,0
2020-02-17,New_Zealand,NZ,0,0,4783062,Oceania,0,0
2020-02-18,New_Zealand,NZ,0,0,4783062,Oceania,0,0
2020-02-19,New_Zealand,NZ,0,0,4783062,Oceania,0,0
2020-02-20,New_Zealand,NZ,0,0,4783062,Oceania,0,0
2020-02-21,New_Zealand,NZ,0,0,4783062,Oceania,0,0
2020-02-22,New_Zealand,NZ,0,0,4783062,Oceania,0,0
2020-02-23,New_Zealand,NZ,0,0,4783062,Oceania,0,0
2020-02-24,New_Zealand,NZ,0,0,4783062,Oceania,0,0
2020-02-25,New_Zealand,NZ,0,0,4783062,Oceania,0,0
2020-02-26,New_Zealand,NZ,0,0,4783062,Oceania,0,0
2020-02-27,New_Zealand,NZ,0,0,4783062,Oceania,0,0
2020-02-28,New_Zealand,NZ,1,0,4783062,Oceania,1,0
2020-02-29,New_Zealand,NZ,0,0,4783062,Oceania,1,0
2020-03-01,New_Zealand,NZ,0,0,4783062,Oceania,1,0
2020-03-02,New_Zealand,NZ,0,0,4783062,Oceania,1,0
2020-03-04,New_Zealand,NZ,1,0,4783062,Oceania,2,0
2020-03-05,New_Zealand,NZ,1,0,4783062,Oceania,3,0
2020-03-06,New_Zealand,NZ,1,0,4783062,Oceania,4,0
2020-03-07,New_Zealand,NZ,1,0,4783062,Oceania,5,0
2020-03-14,New_Zealand,NZ,1,0,4783062,Oceania,6,0
2020-03-15,New_Zealand,NZ,2,0,4783062,Oceania,8,0
2020-03-18,New_Zealand,NZ,12,0,4783062,Oceania,20,0
2020-03-19,New_Zealand,NZ,8,0,4783062,Oceania,28,0
2020-03-20,New_Zealand,NZ,11,0,4783062,Oceania,39,0
2020-03-21,New_Zealand,NZ,14,0,4783062,Oceania,53,0
2020-03-22,New_Zealand,NZ,13,0,4783062,Oceania,66,0
2020-03-23,New_Zealand,NZ,36,0,4783062,Oceania,102,0
2020-03-24,New_Zealand,NZ,40,0,4783062,Oceania,142,0
2020-03-25,New_Zealand,NZ,47,0,4783062,Oceania,189,0
2020-03-26,New_Zealand,NZ,73,0,4783062,Oceania,262,0
2020-03-27,New_Zealand,NZ,76,0,4783062,Oceania,338,0
2020-03-28,New_Zealand,NZ,78,0,4783062,Oceania,416,0
2020-03-29,New_Zealand,NZ,60,1,4783062,Oceania,476,1
2020-03-30,New_Zealand,NZ,76,0,4783062,Oceania,552,1
2020-03-31,New_Zealand,NZ,95,0,4783062,Oceania,647,1
2020-04-01,New_Zealand,NZ,0,0,4783062,Oceania,647,1
2020-04-02,New_Zealand,NZ,76,0,4783062,Oceania,723,1
2020-04-03,New_Zealand,NZ,49,0,4783062,Oceania,772,1
2020-04-04,New_Zealand,NZ,52,0,4783062,Oceania,824,1
2020-04-05,New_Zealand,NZ,48,0,4783062,Oceania,872,1
2020-04-06,New_Zealand,NZ,39,0,4783062,Oceania,911,1
2020-04-07,New_Zealand,NZ,32,0,4783062,Oceania,943,1
2020-04-08,New_Zealand,NZ,26,0,4783062,Oceania,969,1
2020-04-09,New_Zealand,NZ,23,0,4783062,Oceania,992,1
2020-04-10,New_Zealand,NZ,23,1,4783062,Oceania,1015,2
2020-04-11,New_Zealand,NZ,20,2,4783062,Oceania,1035,4
2020-04-12,New_Zealand,NZ,14,0,4783062,Oceania,1049,4
2020-04-13,New_Zealand,NZ,15,1,4783062,Oceania,1064,5
2020-04-14,New_Zealand,NZ,8,4,4783062,Oceania,1072,9
2020-04-15,New_Zealand,NZ,6,0,4783062,Oceania,1078,9
2020-04-16,New_Zealand,NZ,6,0,4783062,Oceania,1084,9
2020-04-17,New_Zealand,NZ,2,2,4783062,Oceania,1086,11
2020-04-18,New_Zealand,NZ,8,0,4783062,Oceania,1094,11
2020-04-19,New_Zealand,NZ,4,1,4783062,Oceania,1098,12
2020-04-20,New_Zealand,NZ,7,0,4783062,Oceania,1105,12
2020-04-21,New_Zealand,NZ,2,1,4783062,Oceania,1107,13
2020-04-22,New_Zealand,NZ,5,1,4783062,Oceania,1112,14
2020-04-23,New_Zealand,NZ,0,2,4783062,Oceania,1112,16
2020-04-24,New_Zealand,NZ,2,1,4783062,Oceania,1114,17
2020-04-25,New_Zealand,NZ,3,1,4783062,Oceania,1117,18
2020-04-26,New_Zealand,NZ,4,0,4783062,Oceania,1121,18
2020-04-27,New_Zealand,NZ,1,1,4783062,Oceania,1122,19
2020-04-28,New_Zealand,NZ,2,0,4783062,Oceania,1124,19
2020-04-29,New_Zealand,NZ,2,0,4783062,Oceania,1126,19
2020-04-30,New_Zealand,NZ,3,0,4783062,Oceania,1129,19
2020-05-01,New_Zealand,NZ,3,0,4783062,Oceania,1132,19
2020-05-02,New_Zealand,NZ,2,1,4783062,Oceania,1134,20
2020-05-03,New_Zealand,NZ,2,0,4783062,Oceania,1136,20
2020-05-04,New_Zealand,NZ,1,0,4783062,Oceania,1137,20
2020-05-05,New_Zealand,NZ,0,0,4783062,Oceania,1137,20
2020-05-06,New_Zealand,NZ,1,1,4783062,Oceania,1138,21
2020-05-07,New_Zealand,NZ,1,0,4783062,Oceania,1139,21
2020-05-08,New_Zealand,NZ,2,0,4783062,Oceania,1141,21
2020-05-09,New_Zealand,NZ,1,0,4783062,Oceania,1142,21
2020-05-10,New_Zealand,NZ,2,0,4783062,Oceania,1144,21
2020-05-11,New_Zealand,NZ,3,0,4783062,Oceania,1147,21
2020-05-12,New_Zealand,NZ,0,0,4783062,Oceania,1147,21
2020-05-13,New_Zealand,NZ,0,0,4783062,Oceania,1147,21
2020-05-14,New_Zealand,NZ,0,0,4783062,Oceania,1147,21
2020-05-15,New_Zealand,NZ,1,0,4783062,Oceania,1148,21
2020-05-16,New_Zealand,NZ,0,0,4783062,Oceania,1148,21
2020-05-17,New_Zealand,NZ,1,0,4783062,Oceania,1149,21
2020-05-18,New_Zealand,NZ,0,0,4783062,Oceania,1149,21
2020-05-19,New_Zealand,NZ,4,0,4783062,Oceania,1153,21
2020-05-20,New_Zealand,NZ,0,0,4783062,Oceania,1153,21
2020-05-21,New_Zealand,NZ,0,0,4783062,Oceania,1153,21
2020-05-22,New_Zealand,NZ,1,0,4783062,Oceania,1154,21
2020-05-23,New_Zealand,NZ,0,0,4783062,Oceania,1154,21
2020-05-24,New_Zealand,NZ,0,0,4783062,Oceania,1154,21
2020-05-25,New_Zealand,NZ,0,0,4783062,Oceania,1154,21
2020-05-26,New_Zealand,NZ,0,0,4783062,Oceania,1154,21
2020-05-27,New_Zealand,NZ,0,0,4783062,Oceania,1154,21
2020-05-28,New_Zealand,NZ,0,1,4783062,Oceania,1154,22
2020-05-29,New_Zealand,NZ,0,0,4783062,Oceania,1154,22
2020-05-30,New_Zealand,NZ,0,0,4783062,Oceania,1154,22
2020-05-31,New_Zealand,NZ,0,0,4783062,Oceania,1154,22
2020-06-01,New_Zealand,NZ,0,0,4783062,Oceania,1154,22
2020-06-02,New_Zealand,NZ,0,0,4783062,Oceania,1154,22
2020-06-03,New_Zealand,NZ,0,0,4783062,Oceania,1154,22
2020-06-04,New_Zealand,NZ,0,0,4783062,Oceania,1154,22
2020-06-05,New_Zealand,NZ,0,0,4783062,Oceania,1154,22
2020-06-06,New_Zealand,NZ,0,0,4783062,Oceania,1154,22
2020-06-07,New_Zealand,NZ,0,0,4783062,Oceania,1154,22
2020-06-08,New_Zealand,NZ,0,0,4783062,Oceania,1154,22
2020-06-09,New_Zealand,NZ,0,0,4783062,Oceania,1154,22
2020-06-10,New_Zealand,NZ,0,0,4783062,Oceania,1154,22
2020-06-11,New_Zealand,NZ,0,0,4783062,Oceania,1154,22
2020-06-12,New_Zealand,NZ,0,0,4783062,Oceania,1154,22
2020-06-13,New_Zealand,NZ,0,0,4783062,Oceania,1154,22
2020-06-14,New_Zealand,NZ,0,0,4783062,Oceania,1154,22
2020-06-15,New_Zealand,NZ,0,0,4783062,Oceania,1154,22
2020-06-16,New_Zealand,NZ,2,0,4783062,Oceania,1156,22
2020-06-17,New_Zealand,NZ,0,0,4783062,Oceania,1156,22
2020-06-18,New_Zealand,NZ,1,0,4783062,Oceania,1157,22
2020-06-19,New_Zealand,NZ,0,0,4783062,Oceania,1157,22
2020-06-20,New_Zealand,NZ,2,0,4783062,Oceania,1159,22
2020-06-21,New_Zealand,NZ,2,0,4783062,Oceania,1161,22
2020-06-22,New_Zealand,NZ,2,0,4783062,Oceania,1163,22
2020-06-23,New_Zealand,NZ,2,0,4783062,Oceania,1165,22
2020-06-24,New_Zealand,NZ,1,0,4783062,Oceania,1166,22
2020-06-25,New_Zealand,NZ,3,0,4783062,Oceania,1169,22
2020-06-26,New_Zealand,NZ,1,0,4783062,Oceania,1170,22
2020-06-27,New_Zealand,NZ,2,0,4783062,Oceania,1172,22
2020-06-28,New_Zealand,NZ,4,0,4783062,Oceania,1176,22
2020-06-29,New_Zealand,NZ,2,0,4783062,Oceania,1178,22
2020-06-30,New_Zealand,NZ,0,0,4783062,Oceania,1178,22
2020-07-01,New_Zealand,NZ,0,0,4783062,Oceania,1178,22
2020-07-02,New_Zealand,NZ,2,0,4783062,Oceania,1180,22
2020-07-03,New_Zealand,NZ,0,0,4783062,Oceania,1180,22
2020-07-04,New_Zealand,NZ,0,0,4783062,Oceania,1180,22
2020-07-05,New_Zealand,NZ,3,0,4783062,Oceania,1183,22
2020-07-06,New_Zealand,NZ,0,0,4783062,Oceania,1183,22
2020-07-07,New_Zealand,NZ,3,0,4783062,Oceania,1186,22
2020-07-08,New_Zealand,NZ,1,0,4783062,Oceania,1187,22
2020-07-09,New_Zealand,NZ,3,0,4783062,Oceania,1190,22
2020-07-10,New_Zealand,NZ,2,0,4783062,Oceania,1192,22
2020-07-11,New_Zealand,NZ,1,0,4783062,Oceania,1193,22
2020-07-12,New_Zealand,NZ,1,0,4783062,Oceania,1194,22
2020-07-13,New_Zealand,NZ,0,0,4783062,Oceania,1194,22
2020-07-14,New_Zealand,NZ,1,0,4783062,Oceania,1195,22
2020-07-15,New_Zealand,NZ,2,0,4783062,Oceania,1197,22
2020-07-16,New_Zealand,NZ,1,0,4783062,Oceania,1198,22
2020-07-17,New_Zealand,NZ,1,0,4783062,Oceania,1199,22
2020-07-18,New_Zealand,NZ,1,0,4783062,Oceania,1200,22
2020-07-19,New_Zealand,NZ,3,0,4783062,Oceania,1203,22
2020-07-20,New_Zealand,NZ,1,0,4783062,Oceania,1204,22
2020-07-21,New_Zealand,NZ,1,0,4783062,Oceania,1205,22
2020-07-22,New_Zealand,NZ,0,0,4783062,Oceania,1205,22
2020-07-23,New_Zealand,NZ,0,0,4783062,Oceania,1205,22
2020-07-24,New_Zealand,NZ,1,0,4783062,Oceania,1206,22
2020-07-25,New_Zealand,NZ,0,0,4783062,Oceania,1206,22
2020-07-26,New_Zealand,NZ,0,0,4783062,Oceania,1206,22
2020-07-27,New_Zealand,NZ,0,0,4783062,Oceania,1206,22
2020-07-28,New_Zealand,NZ,1,0,4783062,Oceania,1207,22
2020-07-29,New_Zealand,NZ,2,0,4783062,Oceania,1209,22
2020-07-30,New_Zealand,NZ,1,0,4783062,Oceania,1210,22
2020-07-31,New_Zealand,NZ,0,0,4783062,Oceania,1210,22
2020-08-01,New_Zealand,NZ,2,0,4783062,Oceania,1212,22
2020-08-02,New_Zealand,NZ,3,0,4783062,Oceania,1215,22
2020-08-03,New_Zealand,NZ,2,0,4783062,Oceania,1217,22
2020-08-04,New_Zealand,NZ,0,0,4783062,Oceania,1217,22
2020-08-05,New_Zealand,NZ,2,0,4783062,Oceania,1219,22
2020-08-06,New_Zealand,NZ,0,0,4783062,Oceania,1219,22
2020-08-07,New_Zealand,NZ,0,0,4783062,Oceania,1219,22
2020-08-08,New_Zealand,NZ,0,0,4783062,Oceania,1219,22
2020-08-09,New_Zealand,NZ,0,0,4783062,Oceania,1219,22
2020-08-10,New_Zealand,NZ,0,0,4783062,Oceania,1219,22
2020-08-11,New_Zealand,NZ,1,0,4783062,Oceania,1220,22
2020-08-12,New_Zealand,NZ,0,0,4783062,Oceania,1220,22
2020-08-13,New_Zealand,NZ,18,0,4783062,Oceania,1238,22
2020-08-14,New_Zealand,NZ,13,0,4783062,Oceania,1251,22
2020-08-15,New_Zealand,NZ,7,0,4783062,Oceania,1258,22
2020-08-16,New_Zealand,NZ,13,0,4783062,Oceania,1271,22
2020-08-17,New_Zealand,NZ,9,0,4783062,Oceania,1280,22
2020-08-18,New_Zealand,NZ,13,0,4783062,Oceania,1293,22
2020-08-19,New_Zealand,NZ,6,0,4783062,Oceania,1299,22
2020-08-20,New_Zealand,NZ,5,0,4783062,Oceania,1304,22
2020-08-21,New_Zealand,NZ,11,0,4783062,Oceania,1315,22
2020-08-22,New_Zealand,NZ,6,0,4783062,Oceania,1321,22
2020-08-23,New_Zealand,NZ,3,0,4783062,Oceania,1324,22
2020-08-24,New_Zealand,NZ,8,0,4783062,Oceania,1332,22
2020-08-25,New_Zealand,NZ,7,0,4783062,Oceania,1339,22
2020-08-26,New_Zealand,NZ,5,0,4783062,Oceania,1344,22
2020-08-27,New_Zealand,NZ,7,0,4783062,Oceania,1351,22
2020-08-28,New_Zealand,NZ,12,0,4783062,Oceania,1363,22
2020-08-29,New_Zealand,NZ,13,0,4783062,Oceania,1376,22
2020-08-30,New_Zealand,NZ,2,0,4783062,Oceania,1378,22
2020-08-31,New_Zealand,NZ,9,0,4783062,Oceania,1387,22
2020-09-01,New_Zealand,NZ,14,0,4783062,Oceania,1401,22
2020-09-02,New_Zealand,NZ,5,0,4783062,Oceania,1406,22
2020-09-03,New_Zealand,NZ,2,0,4783062,Oceania,1408,22
2020-09-04,New_Zealand,NZ,5,0,4783062,Oceania,1413,22
2020-09-05,New_Zealand,NZ,0,0,4783062,Oceania,1413,22
2020-09-06,New_Zealand,NZ,8,2,4783062,Oceania,1421,24
2020-09-07,New_Zealand,NZ,4,0,4783062,Oceania,1425,24
2020-09-08,New_Zealand,NZ,6,0,4783062,Oceania,1431,24
2020-09-09,New_Zealand,NZ,6,0,4783062,Oceania,1437,24
2020-09-10,New_Zealand,NZ,4,0,4783062,Oceania,1441,24
2020-09-11,New_Zealand,NZ,1,0,4783062,Oceania,1442,24
2020-09-12,New_Zealand,NZ,2,0,4783062,Oceania,1444,24
2020-09-13,New_Zealand,NZ,2,0,4783062,Oceania,1446,24
2020-09-14,New_Zealand,NZ,1,0,4783062,Oceania,1447,24
2020-09-15,New_Zealand,NZ,3,0,4783062,Oceania,1450,24
2020-09-16,New_Zealand,NZ,1,1,4783062,Oceania,1451,25
2020-09-17,New_Zealand,NZ,7,0,4783062,Oceania,1458,25
2020-09-18,New_Zealand,NZ,0,0,4783062,Oceania,1458,25
2020-09-19,New_Zealand,NZ,2,0,4783062,Oceania,1460,25
2020-09-20,New_Zealand,NZ,4,0,4783062,Oceania,1464,25
2020-09-21,New_Zealand,NZ,0,0,4783062,Oceania,1464,25
2020-09-22,New_Zealand,NZ,0,0,4783062,Oceania,1464,25
2020-09-23,New_Zealand,NZ,4,0,4783062,Oceania,1468,25
2020-09-24,New_Zealand,NZ,3,0,4783062,Oceania,1471,25
2020-09-25,New_Zealand,NZ,2,0,4783062,Oceania,1473,25
2020-09-26,New_Zealand,NZ,2,0,4783062,Oceania,1475,25
2020-09-27,New_Zealand,NZ,2,0,4783062,Oceania,1477,25
2020-09-28,New_Zealand,NZ,0,0,4783062,Oceania,1477,25
2020-09-29,New_Zealand,NZ,2,0,4783062,Oceania,1479,25
2020-09-30,New_Zealand,NZ,1,0,4783062,Oceania,1480,25
2020-10-01,New_Zealand,NZ,0,0,4783062,Oceania,1480,25
2020-10-02,New_Zealand,NZ,12,0,4783062,Oceania,1492,25
2020-10-03,New_Zealand,NZ,1,0,4783062,Oceania,1493,25
2020-10-04,New_Zealand,NZ,5,0,4783062,Oceania,1498,25
2020-10-05,New_Zealand,NZ,1,0,4783062,Oceania,1499,25
2020-10-06,New_Zealand,NZ,3,0,4783062,Oceania,1502,25
2020-10-07,New_Zealand,NZ,3,0,4783062,Oceania,1505,25
2020-10-08,New_Zealand,NZ,3,0,4783062,Oceania,1508,25
2020-10-09,New_Zealand,NZ,2,0,4783062,Oceania,1510,25
2020-10-10,New_Zealand,NZ,4,0,4783062,Oceania,1514,25
2020-10-11,New_Zealand,NZ,1,0,4783062,Oceania,1515,25
2020-10-12,New_Zealand,NZ,0,0,4783062,Oceania,1515,25
2020-10-13,New_Zealand,NZ,1,0,4783062,Oceania,1516,25
2020-10-14,New_Zealand,NZ,2,0,4783062,Oceania,1518,25
2020-10-15,New_Zealand,NZ,2,0,4783062,Oceania,1520,25
2020-10-16,New_Zealand,NZ,4,0,4783062,Oceania,1524,25
2020-10-17,New_Zealand,NZ,3,0,4783062,Oceania,1527,25
2020-10-18,New_Zealand,NZ,3,0,4783062,Oceania,1530,25
2020-10-19,New_Zealand,NZ,0,0,4783062,Oceania,1530,25
2020-10-20,New_Zealand,NZ,1,0,4783062,Oceania,1531,25
2020-10-21,New_Zealand,NZ,25,0,4783062,Oceania,1556,25
2020-10-22,New_Zealand,NZ,2,0,4783062,Oceania,1558,25
2020-10-23,New_Zealand,NZ,9,0,4783062,Oceania,1567,25
2020-10-24,New_Zealand,NZ,11,0,4783062,Oceania,1578,25
2020-10-25,New_Zealand,NZ,1,0,4783062,Oceania,1579,25
2020-10-26,New_Zealand,NZ,5,0,4783062,Oceania,1584,25
2020-10-27,New_Zealand,NZ,1,0,4783062,Oceania,1585,25
2020-10-28,New_Zealand,NZ,2,0,4783062,Oceania,1587,25
2020-10-29,New_Zealand,NZ,6,0,4783062,Oceania,1593,25
2020-10-30,New_Zealand,NZ,1,0,4783062,Oceania,1594,25
2020-10-31,New_Zealand,NZ,7,0,4783062,Oceania,1601,25
2020-11-01,New_Zealand,NZ,2,0,4783062,Oceania,1603,25
2020-11-02,New_Zealand,NZ,4,0,4783062,Oceania,1607,25
2020-11-03,New_Zealand,NZ,5,0,4783062,Oceania,1612,25
2020-11-04,New_Zealand,NZ,3,0,4783062,Oceania,1615,25
2020-11-05,New_Zealand,NZ,2,0,4783062,Oceania,1617,25
2020-11-06,New_Zealand,NZ,1,0,4783062,Oceania,1618,25
2020-11-07,New_Zealand,NZ,2,0,4783062,Oceania,1620,25
2020-11-08,New_Zealand,NZ,6,0,4783062,Oceania,1626,25
2020-11-09,New_Zealand,NZ,4,0,4783062,Oceania,1630,25
2020-11-10,New_Zealand,NZ,1,0,4783062,Oceania,1631,25
2020-11-11,New_Zealand,NZ,1,0,4783062,Oceania,1632,25
2020-11-12,New_Zealand,NZ,3,0,4783062,Oceania,1635,25
2020-11-13,New_Zealand,NZ,4,0,4783062,Oceania,1639,25
2020-11-14,New_Zealand,NZ,3,0,4783062,Oceania,1642,25
2020-11-15,New_Zealand,NZ,3,0,4783062,Oceania,1645,25
2020-11-16,New_Zealand,NZ,0,0,4783062,Oceania,1645,25
2020-11-17,New_Zealand,NZ,4,0,4783062,Oceania,1649,25
2020-11-18,New_Zealand,NZ,3,0,4783062,Oceania,1652,25
2020-11-19,New_Zealand,NZ,2,0,4783062,Oceania,1654,25
2020-11-20,New_Zealand,NZ,3,0,4783062,Oceania,1657,25
2020-11-21,New_Zealand,NZ,6,0,4783062,Oceania,1663,25
2020-11-22,New_Zealand,NZ,9,0,4783062,Oceania,1672,25
2020-11-23,New_Zealand,NZ,2,0,4783062,Oceania,1674,25
2020-11-24,New_Zealand,NZ,1,0,4783062,Oceania,1675,25
2020-11-25,New_Zealand,NZ,8,0,4783062,Oceania,1683,25
2020-11-26,New_Zealand,NZ,1,0,4783062,Oceania,1684,25
2020-11-27,New_Zealand,NZ,7,0,4783062,Oceania,1691,25
2020-11-28,New_Zealand,NZ,3,0,4783062,Oceania,1694,25
2020-11-29,New_Zealand,NZ,0,0,4783062,Oceania,1694,25
2020-11-30,New_Zealand,NZ,6,0,4783062,Oceania,1700,25
2020-12-01,New_Zealand,NZ,3,0,4783062,Oceania,1703,25
2020-12-02,New_Zealand,NZ,1,0,4783062,Oceania,1704,25
2020-12-03,New_Zealand,NZ,9,0,4783062,Oceania,1713,25
2020-12-04,New_Zealand,NZ,0,0,4783062,Oceania,1713,25
2020-12-05,New_Zealand,NZ,9,0,4783062,Oceania,1722,25
2020-12-06,New_Zealand,NZ,0,0,4783062,Oceania,1722,25
2020-12-07,New_Zealand,NZ,1,0,4783062,Oceania,1723,25
2020-12-08,New_Zealand,NZ,6,0,4783062,Oceania,1729,25
2020-12-09,New_Zealand,NZ,3,0,4783062,Oceania,1732,25
2020-12-10,New_Zealand,NZ,0,0,4783062,Oceania,1732,25
2020-12-11,New_Zealand,NZ,4,0,4783062,Oceania,1736,25
2020-12-12,New_Zealand,NZ,0,0,4783062,Oceania,1736,25
2020-12-13,New_Zealand,NZ,4,0,4783062,Oceania,1740,25
2020-12-14,New_Zealand,NZ,0,0,4783062,Oceania,1740,25
2019-12-31,Oman,OM,0,0,4974992,Asia,0,0
2020-01-01,Oman,OM,0,0,4974992,Asia,0,0
2020-01-02,Oman,OM,0,0,4974992,Asia,0,0
2020-01-03,Oman,OM,0,0,4974992,Asia,0,0
2020-01-04,Oman,OM,0,0,4974992,Asia,0,0
2020-01-05,Oman,OM,0,0,4974992,Asia,0,0
2020-01-06,Oman,OM,0,0,4974992,Asia,0,0
2020-01-07,Oman,OM,0,0,4974992,Asia,0,0
2020-01-08,Oman,OM,0,0,4974992,Asia,0,0
2020-01-09,Oman,OM,0,0,4974992,Asia,0,0
2020-01-10,Oman,OM,0,0,4974992,Asia,0,0
2020-01-11,Oman,OM,0,0,4974992,Asia,0,0
2020-01-12,Oman,OM,0,0,4974992,Asia,0,0
2020-01-13,Oman,OM,0,0,4974992,Asia,0,0
2020-01-14,Oman,OM,0,0,4974992,Asia,0,0
2020-01-15,Oman,OM,0,0,4974992,Asia,0,0
2020-01-16,Oman,OM,0,0,4974992,Asia,0,0
2020-01-17,Oman,OM,0,0,4974992,Asia,0,0
2020-01-18,Oman,OM,0,0,4974992,Asia,0,0
2020-01-19,Oman,OM,0,0,4974992,Asia,0,0
2020-01-20,Oman,OM,0,0,4974992,Asia,0,0
2020-01-21,Oman,OM,0,0,4974992,Asia,0,0
2020-01-22,Oman,OM,0,0,4974992,Asia,0,0
2020-01-23,Oman,OM,0,0,4974992,Asia,0,0
2020-01-24,Oman,OM,0,0,4974992,Asia,0,0
2020-01-25,Oman,OM,0,0,4974992,Asia,0,0
2020-01-26,Oman,OM,0,0,4974992,Asia,0,0
2020-01-27,Oman,OM,0,0,4974992,Asia,0,0
2020-01-28,Oman,OM,0,0,4974992,Asia,0,0
2020-01-29,Oman,OM,0,0,4974992,Asia,0,0
2020-01-30,Oman,OM,0,0,4974992,Asia,0,0
2020-01-31,Oman,OM,0,0,4974992,Asia,0,0
2020-02-01,Oman,OM,0,0,4974992,Asia,0,0
2020-02-02,Oman,OM,0,0,4974992,Asia,0,0
2020-02-03,Oman,OM,0,0,4974992,Asia,0,0
2020-02-04,Oman,OM,0,0,4974992,Asia,0,0
2020-02-05,Oman,OM,0,0,4974992,Asia,0,0
2020-02-06,Oman,OM,0,0,4974992,Asia,0,0
2020-02-07,Oman,OM,0,0,4974992,Asia,0,0
2020-02-08,Oman,OM,0,0,4974992,Asia,0,0
2020-02-09,Oman,OM,0,0,4974992,Asia,0,0
2020-02-10,Oman,OM,0,0,4974992,Asia,0,0
2020-02-11,Oman,OM,0,0,4974992,Asia,0,0
2020-02-12,Oman,OM,0,0,4974992,Asia,0,0
2020-02-13,Oman,OM,0,0,4974992,Asia,0,0
2020-02-14,Oman,OM,0,0,4974992,Asia,0,0
2020-02-15,Oman,OM,0,0,4974992,Asia,0,0
2020-02-16,Oman,OM,0,0,4974992,Asia,0,0
2020-02-17,Oman,OM,0,0,4974992,Asia,0,0
2020-02-18,Oman,OM,0,0,4974992,Asia,0,0
2020-02-19,Oman,OM,0,0,4974992,Asia,0,0
2020-02-20,Oman,OM,0,0,4974992,Asia,0,0
2020-02-21,Oman,OM,0,0,4974992,Asia,0,0
2020-02-22,Oman,OM,0,0,4974992,Asia,0,0
2020-02-23,Oman,OM,0,0,4974992,Asia,0,0
2020-02-24,Oman,OM,0,0,4974992,Asia,0,0
2020-02-25,Oman,OM,2,0,4974992,Asia,2,0
2020-02-26,Oman,OM,2,0,4974992,Asia,4,0
2020-02-27,Oman,OM,0,0,4974992,Asia,4,0
2020-02-28,Oman,OM,2,0,4974992,Asia,6,0
2020-02-29,Oman,OM,0,0,4974992,Asia,6,0
2020-03-01,Oman,OM,0,0,4974992,Asia,6,0
2020-03-02,Oman,OM,0,0,4974992,Asia,6,0
2020-03-03,Oman,OM,1,0,4974992,Asia,7,0
2020-03-05,Oman,OM,8,0,4974992,Asia,15,0
2020-03-06,Oman,OM,1,0,4974992,Asia,16,0
2020-03-10,Oman,OM,2,0,4974992,Asia,18,0
2020-03-11,Oman,OM,0,0,4974992,Asia,18,0
2020-03-14,Oman,OM,2,0,4974992,Asia,20,0
2020-03-15,Oman,OM,0,0,4974992,Asia,20,0
2020-03-16,Oman,OM,2,0,4974992,Asia,22,0
2020-03-17,Oman,OM,2,0,4974992,Asia,24,0
2020-03-18,Oman,OM,0,0,4974992,Asia,24,0
2020-03-19,Oman,OM,15,0,4974992,Asia,39,0
2020-03-20,Oman,OM,0,0,4974992,Asia,39,0
2020-03-21,Oman,OM,9,0,4974992,Asia,48,0
2020-03-22,Oman,OM,4,0,4974992,Asia,52,0
2020-03-23,Oman,OM,3,0,4974992,Asia,55,0
2020-03-24,Oman,OM,11,0,4974992,Asia,66,0
2020-03-25,Oman,OM,18,0,4974992,Asia,84,0
2020-03-26,Oman,OM,15,0,4974992,Asia,99,0
2020-03-27,Oman,OM,10,0,4974992,Asia,109,0
2020-03-28,Oman,OM,22,0,4974992,Asia,131,0
2020-03-29,Oman,OM,21,0,4974992,Asia,152,0
2020-03-30,Oman,OM,15,0,4974992,Asia,167,0
2020-03-31,Oman,OM,12,0,4974992,Asia,179,0
2020-04-01,Oman,OM,13,1,4974992,Asia,192,1
2020-04-02,Oman,OM,18,0,4974992,Asia,210,1
2020-04-03,Oman,OM,21,0,4974992,Asia,231,1
2020-04-04,Oman,OM,0,0,4974992,Asia,231,1
2020-04-05,Oman,OM,46,1,4974992,Asia,277,2
2020-04-06,Oman,OM,21,0,4974992,Asia,298,2
2020-04-07,Oman,OM,73,0,4974992,Asia,371,2
2020-04-08,Oman,OM,48,0,4974992,Asia,419,2
2020-04-09,Oman,OM,0,0,4974992,Asia,419,2
2020-04-10,Oman,OM,38,1,4974992,Asia,457,3
2020-04-11,Oman,OM,27,0,4974992,Asia,484,3
2020-04-12,Oman,OM,62,0,4974992,Asia,546,3
2020-04-13,Oman,OM,53,1,4974992,Asia,599,4
2020-04-14,Oman,OM,214,0,4974992,Asia,813,4
2020-04-15,Oman,OM,97,0,4974992,Asia,910,4
2020-04-16,Oman,OM,0,0,4974992,Asia,910,4
2020-04-17,Oman,OM,109,0,4974992,Asia,1019,4
2020-04-18,Oman,OM,50,2,4974992,Asia,1069,6
2020-04-19,Oman,OM,111,0,4974992,Asia,1180,6
2020-04-20,Oman,OM,86,1,4974992,Asia,1266,7
2020-04-21,Oman,OM,242,1,4974992,Asia,1508,8
2020-04-22,Oman,OM,0,0,4974992,Asia,1508,8
2020-04-23,Oman,OM,106,0,4974992,Asia,1614,8
2020-04-24,Oman,OM,102,1,4974992,Asia,1716,9
2020-04-25,Oman,OM,74,1,4974992,Asia,1790,10
2020-04-26,Oman,OM,115,0,4974992,Asia,1905,10
2020-04-27,Oman,OM,93,0,4974992,Asia,1998,10
2020-04-28,Oman,OM,51,0,4974992,Asia,2049,10
2020-04-29,Oman,OM,82,0,4974992,Asia,2131,10
2020-04-30,Oman,OM,143,0,4974992,Asia,2274,10
2020-05-01,Oman,OM,74,1,4974992,Asia,2348,11
2020-05-02,Oman,OM,99,0,4974992,Asia,2447,11
2020-05-03,Oman,OM,36,1,4974992,Asia,2483,12
2020-05-04,Oman,OM,85,0,4974992,Asia,2568,12
2020-05-05,Oman,OM,69,0,4974992,Asia,2637,12
2020-05-06,Oman,OM,98,0,4974992,Asia,2735,12
2020-05-07,Oman,OM,168,1,4974992,Asia,2903,13
2020-05-08,Oman,OM,55,1,4974992,Asia,2958,14
2020-05-09,Oman,OM,154,1,4974992,Asia,3112,15
2020-05-10,Oman,OM,112,2,4974992,Asia,3224,17
2020-05-11,Oman,OM,175,0,4974992,Asia,3399,17
2020-05-12,Oman,OM,175,0,4974992,Asia,3574,17
2020-05-13,Oman,OM,147,0,4974992,Asia,3721,17
2020-05-14,Oman,OM,298,0,4974992,Asia,4019,17
2020-05-15,Oman,OM,322,2,4974992,Asia,4341,19
2020-05-16,Oman,OM,284,0,4974992,Asia,4625,19
2020-05-17,Oman,OM,404,2,4974992,Asia,5029,21
2020-05-18,Oman,OM,157,1,4974992,Asia,5186,22
2020-05-19,Oman,OM,193,4,4974992,Asia,5379,26
2020-05-20,Oman,OM,292,1,4974992,Asia,5671,27
2020-05-21,Oman,OM,372,3,4974992,Asia,6043,30
2020-05-22,Oman,OM,327,1,4974992,Asia,6370,31
2020-05-23,Oman,OM,424,1,4974992,Asia,6794,32
2020-05-24,Oman,OM,463,4,4974992,Asia,7257,36
2020-05-25,Oman,OM,513,1,4974992,Asia,7770,37
2020-05-26,Oman,OM,0,0,4974992,Asia,7770,37
2020-05-27,Oman,OM,348,0,4974992,Asia,8118,37
2020-05-28,Oman,OM,255,1,4974992,Asia,8373,38
2020-05-29,Oman,OM,636,2,4974992,Asia,9009,40
2020-05-30,Oman,OM,811,0,4974992,Asia,9820,40
2020-05-31,Oman,OM,603,2,4974992,Asia,10423,42
2020-06-01,Oman,OM,1014,5,4974992,Asia,11437,47
2020-06-02,Oman,OM,786,3,4974992,Asia,12223,50
2020-06-03,Oman,OM,576,9,4974992,Asia,12799,59
2020-06-04,Oman,OM,738,8,4974992,Asia,13537,67
2020-06-05,Oman,OM,779,0,4974992,Asia,14316,67
2020-06-06,Oman,OM,770,5,4974992,Asia,15086,72
2020-06-07,Oman,OM,930,0,4974992,Asia,16016,72
2020-06-08,Oman,OM,866,3,4974992,Asia,16882,75
2020-06-09,Oman,OM,604,6,4974992,Asia,17486,81
2020-06-10,Oman,OM,712,2,4974992,Asia,18198,83
2020-06-11,Oman,OM,689,1,4974992,Asia,18887,84
2020-06-12,Oman,OM,1067,5,4974992,Asia,19954,89
2020-06-13,Oman,OM,1117,7,4974992,Asia,21071,96
2020-06-14,Oman,OM,1006,3,4974992,Asia,22077,99
2020-06-15,Oman,OM,1404,5,4974992,Asia,23481,104
2020-06-16,Oman,OM,1043,4,4974992,Asia,24524,108
2020-06-17,Oman,OM,745,6,4974992,Asia,25269,114
2020-06-18,Oman,OM,810,2,4974992,Asia,26079,116
2020-06-19,Oman,OM,739,3,4974992,Asia,26818,119
2020-06-20,Oman,OM,852,6,4974992,Asia,27670,125
2020-06-21,Oman,OM,896,3,4974992,Asia,28566,128
2020-06-22,Oman,OM,905,3,4974992,Asia,29471,131
2020-06-23,Oman,OM,1605,6,4974992,Asia,31076,137
2020-06-24,Oman,OM,1318,3,4974992,Asia,32394,140
2020-06-25,Oman,OM,1142,2,4974992,Asia,33536,142
2020-06-26,Oman,OM,1366,2,4974992,Asia,34902,144
2020-06-27,Oman,OM,1132,9,4974992,Asia,36034,153
2020-06-28,Oman,OM,919,6,4974992,Asia,36953,159
2020-06-29,Oman,OM,1197,4,4974992,Asia,38150,163
2020-06-30,Oman,OM,910,6,4974992,Asia,39060,169
2020-07-01,Oman,OM,1010,7,4974992,Asia,40070,176
2020-07-02,Oman,OM,1124,9,4974992,Asia,41194,185
2020-07-03,Oman,OM,1361,3,4974992,Asia,42555,188
2020-07-04,Oman,OM,1374,5,4974992,Asia,43929,193
2020-07-05,Oman,OM,1177,10,4974992,Asia,45106,203
2020-07-06,Oman,OM,1072,10,4974992,Asia,46178,213
2020-07-07,Oman,OM,1557,5,4974992,Asia,47735,218
2020-07-08,Oman,OM,1262,6,4974992,Asia,48997,224
2020-07-09,Oman,OM,1210,9,4974992,Asia,50207,233
2020-07-10,Oman,OM,1518,3,4974992,Asia,51725,236
2020-07-11,Oman,OM,1889,8,4974992,Asia,53614,244
2020-07-12,Oman,OM,1083,4,4974992,Asia,54697,248
2020-07-13,Oman,OM,1318,9,4974992,Asia,56015,257
2020-07-14,Oman,OM,2164,2,4974992,Asia,58179,259
2020-07-15,Oman,OM,1389,14,4974992,Asia,59568,273
2020-07-16,Oman,OM,1679,8,4974992,Asia,61247,281
2020-07-17,Oman,OM,1327,9,4974992,Asia,62574,290
2020-07-18,Oman,OM,1619,8,4974992,Asia,64193,298
2020-07-19,Oman,OM,1311,10,4974992,Asia,65504,308
2020-07-20,Oman,OM,1157,10,4974992,Asia,66661,318
2020-07-21,Oman,OM,1739,8,4974992,Asia,68400,326
2020-07-22,Oman,OM,1487,11,4974992,Asia,69887,337
2020-07-23,Oman,OM,1660,12,4974992,Asia,71547,349
2020-07-24,Oman,OM,1099,6,4974992,Asia,72646,355
2020-07-25,Oman,OM,1145,4,4974992,Asia,73791,359
2020-07-26,Oman,OM,1067,12,4974992,Asia,74858,371
2020-07-27,Oman,OM,1147,13,4974992,Asia,76005,384
2020-07-28,Oman,OM,1053,9,4974992,Asia,77058,393
2020-07-29,Oman,OM,846,9,4974992,Asia,77904,402
2020-07-30,Oman,OM,665,10,4974992,Asia,78569,412
2020-07-31,Oman,OM,590,9,4974992,Asia,79159,421
2020-08-01,Oman,OM,0,0,4974992,Asia,79159,421
2020-08-02,Oman,OM,0,0,4974992,Asia,79159,421
2020-08-03,Oman,OM,0,0,4974992,Asia,79159,421
2020-08-04,Oman,OM,0,0,4974992,Asia,79159,421
2020-08-05,Oman,OM,0,0,4974992,Asia,79159,421
2020-08-06,Oman,OM,1127,67,4974992,Asia,80286,488
2020-08-07,Oman,OM,427,4,4974992,Asia,80713,492
2020-08-08,Oman,OM,354,10,4974992,Asia,81067,502
2020-08-09,Oman,OM,290,7,4974992,Asia,81357,509
2020-08-10,Oman,OM,223,4,4974992,Asia,81580,513
2020-08-11,Oman,OM,207,8,4974992,Asia,81787,521
2020-08-12,Oman,OM,263,12,4974992,Asia,82050,533
2020-08-13,Oman,OM,249,6,4974992,Asia,82299,539
2020-08-14,Oman,OM,232,12,4974992,Asia,82531,551
2020-08-15,Oman,OM,212,6,4974992,Asia,82743,557
2020-08-16,Oman,OM,181,5,4974992,Asia,82924,562
2020-08-17,Oman,OM,162,10,4974992,Asia,83086,572
2020-08-18,Oman,OM,140,16,4974992,Asia,83226,588
2020-08-19,Oman,OM,192,9,4974992,Asia,83418,597
2020-08-20,Oman,OM,188,6,4974992,Asia,83606,603
2020-08-21,Oman,OM,163,6,4974992,Asia,83769,609
2020-08-22,Oman,OM,0,0,4974992,Asia,83769,609
2020-08-23,Oman,OM,0,0,4974992,Asia,83769,609
2020-08-24,Oman,OM,0,0,4974992,Asia,83769,609
2020-08-25,Oman,OM,740,28,4974992,Asia,84509,637
2020-08-26,Oman,OM,143,5,4974992,Asia,84652,642
2020-08-27,Oman,OM,166,4,4974992,Asia,84818,646
2020-08-28,Oman,OM,187,4,4974992,Asia,85005,650
2020-08-29,Oman,OM,0,0,4974992,Asia,85005,650
2020-08-30,Oman,OM,0,0,4974992,Asia,85005,650
2020-08-31,Oman,OM,539,27,4974992,Asia,85544,677
2020-09-01,Oman,OM,178,8,4974992,Asia,85722,685
2020-09-02,Oman,OM,206,4,4974992,Asia,85928,689
2020-09-03,Oman,OM,0,0,4974992,Asia,85928,689
2020-09-04,Oman,OM,452,16,4974992,Asia,86380,705
2020-09-05,Oman,OM,0,0,4974992,Asia,86380,705
2020-09-06,Oman,OM,0,0,4974992,Asia,86380,705
2020-09-07,Oman,OM,692,23,4974992,Asia,87072,728
2020-09-08,Oman,OM,256,6,4974992,Asia,87328,734
2020-09-09,Oman,OM,262,8,4974992,Asia,87590,742
2020-09-10,Oman,OM,349,9,4974992,Asia,87939,751
2020-09-11,Oman,OM,398,11,4974992,Asia,88337,762
2020-09-12,Oman,OM,0,0,4974992,Asia,88337,762
2020-09-13,Oman,OM,0,0,4974992,Asia,88337,762
2020-09-14,Oman,OM,1409,18,4974992,Asia,89746,780
2020-09-15,Oman,OM,476,10,4974992,Asia,90222,790
2020-09-16,Oman,OM,438,7,4974992,Asia,90660,797
2020-09-17,Oman,OM,536,8,4974992,Asia,91196,805
2020-09-18,Oman,OM,557,13,4974992,Asia,91753,818
2020-09-19,Oman,OM,0,0,4974992,Asia,91753,818
2020-09-20,Oman,OM,0,0,4974992,Asia,91753,818
2020-09-21,Oman,OM,1722,28,4974992,Asia,93475,846
2020-09-22,Oman,OM,576,7,4974992,Asia,94051,853
2020-09-23,Oman,OM,660,12,4974992,Asia,94711,865
2020-09-24,Oman,OM,628,10,4974992,Asia,95339,875
2020-09-25,Oman,OM,568,10,4974992,Asia,95907,885
2020-09-26,Oman,OM,0,0,4974992,Asia,95907,885
2020-09-27,Oman,OM,0,0,4974992,Asia,95907,885
2020-09-28,Oman,OM,1543,24,4974992,Asia,97450,909
2020-09-29,Oman,OM,607,15,4974992,Asia,98057,924
2020-09-30,Oman,OM,528,11,4974992,Asia,98585,935
2020-10-01,Oman,OM,0,0,4974992,Asia,98585,935
2020-10-02,Oman,OM,0,0,4974992,Asia,98585,935
2020-10-03,Oman,OM,0,0,4974992,Asia,98585,935
2020-10-04,Oman,OM,0,0,4974992,Asia,98585,935
2020-10-05,Oman,OM,2685,42,4974992,Asia,101270,977
2020-10-06,Oman,OM,544,8,4974992,Asia,101814,985
2020-10-07,Oman,OM,834,5,4974992,Asia,102648,990
2020-10-08,Oman,OM,817,10,4974992,Asia,103465,1000
2020-10-09,Oman,OM,664,9,4974992,Asia,104129,1009
2020-10-10,Oman,OM,0,0,4974992,Asia,104129,1009
2020-10-11,Oman,OM,0,0,4974992,Asia,104129,1009
2020-10-12,Oman,OM,1761,29,4974992,Asia,105890,1038
2020-10-13,Oman,OM,685,8,4974992,Asia,106575,1046
2020-10-14,Oman,OM,638,7,4974992,Asia,107213,1053
2020-10-15,Oman,OM,563,8,4974992,Asia,107776,1061
2020-10-16,Oman,OM,520,10,4974992,Asia,108296,1071
2020-10-17,Oman,OM,0,0,4974992,Asia,108296,1071
2020-10-18,Oman,OM,0,0,4974992,Asia,108296,1071
2020-10-19,Oman,OM,1657,30,4974992,Asia,109953,1101
2020-10-20,Oman,OM,641,13,4974992,Asia,110594,1114
2020-10-21,Oman,OM,439,8,4974992,Asia,111033,1122
2020-10-22,Oman,OM,451,15,4974992,Asia,111484,1137
2020-10-23,Oman,OM,353,10,4974992,Asia,111837,1147
2020-10-24,Oman,OM,0,0,4974992,Asia,111837,1147
2020-10-25,Oman,OM,0,0,4974992,Asia,111837,1147
2020-10-26,Oman,OM,1095,27,4974992,Asia,112932,1174
2020-10-27,Oman,OM,422,16,4974992,Asia,113354,1190
2020-10-28,Oman,OM,466,13,4974992,Asia,113820,1203
2020-10-29,Oman,OM,614,5,4974992,Asia,114434,1208
2020-10-30,Oman,OM,0,0,4974992,Asia,114434,1208
2020-10-31,Oman,OM,0,0,4974992,Asia,114434,1208
2020-11-01,Oman,OM,0,0,4974992,Asia,114434,1208
2020-11-02,Oman,OM,1300,38,4974992,Asia,115734,1246
2020-11-03,Oman,OM,418,10,4974992,Asia,116152,1256
2020-11-04,Oman,OM,376,8,4974992,Asia,116528,1264
2020-11-05,Oman,OM,319,11,4974992,Asia,116847,1275
2020-11-06,Oman,OM,320,11,4974992,Asia,117167,1286
2020-11-07,Oman,OM,0,0,4974992,Asia,117167,1286
2020-11-08,Oman,OM,0,0,4974992,Asia,117167,1286
2020-11-09,Oman,OM,973,15,4974992,Asia,118140,1301
2020-11-10,Oman,OM,363,9,4974992,Asia,118503,1310
2020-11-11,Oman,OM,381,6,4974992,Asia,118884,1316
2020-11-12,Oman,OM,302,5,4974992,Asia,119186,1321
2020-11-13,Oman,OM,256,5,4974992,Asia,119442,1326
2020-11-14,Oman,OM,0,0,4974992,Asia,119442,1326
2020-11-15,Oman,OM,0,0,4974992,Asia,119442,1326
2020-11-16,Oman,OM,947,12,4974992,Asia,120389,1338
2020-11-17,Oman,OM,329,12,4974992,Asia,120718,1350
2020-11-18,Oman,OM,0,0,4974992,Asia,120718,1350
2020-11-19,Oman,OM,411,10,4974992,Asia,121129,1360
2020-11-20,Oman,OM,231,5,4974992,Asia,121360,1365
2020-11-21,Oman,OM,0,0,4974992,Asia,121360,1365
2020-11-22,Oman,OM,0,0,4974992,Asia,121360,1365
2020-11-23,Oman,OM,721,15,4974992,Asia,122081,1380
2020-11-24,Oman,OM,275,6,4974992,Asia,122356,1386
2020-11-25,Oman,OM,223,5,4974992,Asia,122579,1391
2020-11-26,Oman,OM,0,0,4974992,Asia,122579,1391
2020-11-27,Oman,OM,0,0,4974992,Asia,122579,1391
2020-11-28,Oman,OM,0,0,4974992,Asia,122579,1391
2020-11-29,Oman,OM,0,0,4974992,Asia,122579,1391
2020-11-30,Oman,OM,905,27,4974992,Asia,123484,1418
2020-12-01,Oman,OM,215,5,4974992,Asia,123699,1423
2020-12-02,Oman,OM,209,7,4974992,Asia,123908,1430
2020-12-03,Oman,OM,237,0,4974992,Asia,124145,1430
2020-12-04,Oman,OM,184,5,4974992,Asia,124329,1435
2020-12-05,Oman,OM,0,0,4974992,Asia,124329,1435
2020-12-06,Oman,OM,0,0,4974992,Asia,124329,1435
2020-12-07,Oman,OM,557,9,4974992,Asia,124886,1444
2020-12-08,Oman,OM,229,8,4974992,Asia,125115,1452
2020-12-09,Oman,OM,210,2,4974992,Asia,125325,1454
2020-12-10,Oman,OM,165,7,4974992,Asia,125490,1461
2020-12-11,Oman,OM,179,2,4974992,Asia,125669,1463
2020-12-12,Oman,OM,0,0,4974992,Asia,125669,1463
2020-12-13,Oman,OM,0,0,4974992,Asia,125669,1463
2020-12-14,Oman,OM,571,8,4974992,Asia,126240,1471
2020-03-10,Panama,PA,1,0,4246440,America,1,0
2020-03-11,Panama,PA,6,1,4246440,America,7,1
2020-03-12,Panama,PA,7,0,4246440,America,14,1
2020-03-13,Panama,PA,13,0,4246440,America,27,1
2020-03-14,Panama,PA,9,0,4246440,America,36,1
2020-03-15,Panama,PA,7,0,4246440,America,43,1
2020-03-16,Panama,PA,0,0,4246440,America,43,1
2020-03-17,Panama,PA,26,0,4246440,America,69,1
2020-03-18,Panama,PA,17,0,4246440,America,86,1
2020-03-19,Panama,PA,23,0,4246440,America,109,1
2020-03-20,Panama,PA,28,0,4246440,America,137,1
2020-03-21,Panama,PA,63,0,4246440,America,200,1
2020-03-22,Panama,PA,45,2,4246440,America,245,3
2020-03-23,Panama,PA,68,0,4246440,America,313,3
2020-03-24,Panama,PA,32,3,4246440,America,345,6
2020-03-25,Panama,PA,98,0,4246440,America,443,6
2020-03-26,Panama,PA,145,0,4246440,America,588,6
2020-03-27,Panama,PA,86,3,4246440,America,674,9
2020-03-28,Panama,PA,112,5,4246440,America,786,14
2020-03-29,Panama,PA,115,3,4246440,America,901,17
2020-03-30,Panama,PA,88,7,4246440,America,989,24
2020-03-31,Panama,PA,86,2,4246440,America,1075,26
2020-04-01,Panama,PA,106,4,4246440,America,1181,30
2020-04-02,Panama,PA,136,2,4246440,America,1317,32
2020-04-03,Panama,PA,158,5,4246440,America,1475,37
2020-04-04,Panama,PA,198,4,4246440,America,1673,41
2020-04-05,Panama,PA,128,5,4246440,America,1801,46
2020-04-06,Panama,PA,187,8,4246440,America,1988,54
2020-04-07,Panama,PA,112,1,4246440,America,2100,55
2020-04-08,Panama,PA,149,4,4246440,America,2249,59
2020-04-09,Panama,PA,279,4,4246440,America,2528,63
2020-04-10,Panama,PA,224,3,4246440,America,2752,66
2020-04-11,Panama,PA,222,8,4246440,America,2974,74
2020-04-12,Panama,PA,260,5,4246440,America,3234,79
2020-04-13,Panama,PA,166,8,4246440,America,3400,87
2020-04-14,Panama,PA,72,7,4246440,America,3472,94
2020-04-15,Panama,PA,102,1,4246440,America,3574,95
2020-04-16,Panama,PA,177,8,4246440,America,3751,103
2020-04-17,Panama,PA,265,6,4246440,America,4016,109
2020-04-18,Panama,PA,194,7,4246440,America,4210,116
2020-04-19,Panama,PA,63,4,4246440,America,4273,120
2020-04-20,Panama,PA,194,6,4246440,America,4467,126
2020-04-21,Panama,PA,191,10,4246440,America,4658,136
2020-04-22,Panama,PA,163,5,4246440,America,4821,141
2020-04-23,Panama,PA,171,3,4246440,America,4992,144
2020-04-24,Panama,PA,174,2,4246440,America,5166,146
2020-04-25,Panama,PA,172,8,4246440,America,5338,154
2020-04-26,Panama,PA,200,5,4246440,America,5538,159
2020-04-27,Panama,PA,241,6,4246440,America,5779,165
2020-04-28,Panama,PA,242,2,4246440,America,6021,167
2020-04-29,Panama,PA,179,9,4246440,America,6200,176
2020-04-30,Panama,PA,178,2,4246440,America,6378,178
2020-05-01,Panama,PA,154,10,4246440,America,6532,188
2020-05-02,Panama,PA,188,4,4246440,America,6720,192
2020-05-03,Panama,PA,370,5,4246440,America,7090,197
2020-05-04,Panama,PA,107,3,4246440,America,7197,200
2020-05-05,Panama,PA,190,3,4246440,America,7387,203
2020-05-06,Panama,PA,136,7,4246440,America,7523,210
2020-05-07,Panama,PA,208,8,4246440,America,7731,218
2020-05-08,Panama,PA,137,7,4246440,America,7868,225
2020-05-09,Panama,PA,202,6,4246440,America,8070,231
2020-05-10,Panama,PA,212,6,4246440,America,8282,237
2020-05-11,Panama,PA,166,7,4246440,America,8448,244
2020-05-12,Panama,PA,168,5,4246440,America,8616,249
2020-05-13,Panama,PA,167,3,4246440,America,8783,252
2020-05-14,Panama,PA,161,4,4246440,America,8944,256
2020-05-15,Panama,PA,174,4,4246440,America,9118,260
2020-05-16,Panama,PA,150,6,4246440,America,9268,266
2020-05-17,Panama,PA,181,3,4246440,America,9449,269
2020-05-18,Panama,PA,157,6,4246440,America,9606,275
2020-05-19,Panama,PA,120,4,4246440,America,9726,279
2020-05-20,Panama,PA,141,2,4246440,America,9867,281
2020-05-21,Panama,PA,110,6,4246440,America,9977,287
2020-05-22,Panama,PA,139,4,4246440,America,10116,291
2020-05-23,Panama,PA,151,4,4246440,America,10267,295
2020-05-24,Panama,PA,310,4,4246440,America,10577,299
2020-05-25,Panama,PA,349,7,4246440,America,10926,306
2020-05-26,Panama,PA,257,4,4246440,America,11183,310
2020-05-27,Panama,PA,264,3,4246440,America,11447,313
2020-05-28,Panama,PA,281,2,4246440,America,11728,315
2020-05-29,Panama,PA,403,5,4246440,America,12131,320
2020-05-30,Panama,PA,400,6,4246440,America,12531,326
2020-05-31,Panama,PA,487,4,4246440,America,13018,330
2020-06-01,Panama,PA,445,6,4246440,America,13463,336
2020-06-02,Panama,PA,374,8,4246440,America,13837,344
2020-06-03,Panama,PA,258,8,4246440,America,14095,352
2020-06-04,Panama,PA,514,5,4246440,America,14609,357
2020-06-05,Panama,PA,435,6,4246440,America,15044,363
2020-06-06,Panama,PA,419,7,4246440,America,15463,370
2020-06-07,Panama,PA,541,16,4246440,America,16004,386
2020-06-08,Panama,PA,421,7,4246440,America,16425,393
2020-06-09,Panama,PA,429,5,4246440,America,16854,398
2020-06-10,Panama,PA,379,5,4246440,America,17233,403
2020-06-11,Panama,PA,656,10,4246440,America,17889,413
2020-06-12,Panama,PA,697,5,4246440,America,18586,418
2020-06-13,Panama,PA,625,3,4246440,America,19211,421
2020-06-14,Panama,PA,848,8,4246440,America,20059,429
2020-06-15,Panama,PA,627,8,4246440,America,20686,437
2020-06-16,Panama,PA,736,11,4246440,America,21422,448
2020-06-17,Panama,PA,540,9,4246440,America,21962,457
2020-06-18,Panama,PA,635,13,4246440,America,22597,470
2020-06-19,Panama,PA,754,5,4246440,America,23351,475
2020-06-20,Panama,PA,923,10,4246440,America,24274,485
2020-06-21,Panama,PA,948,8,4246440,America,25222,493
2020-06-22,Panama,PA,808,8,4246440,America,26030,501
2020-06-23,Panama,PA,722,20,4246440,America,26752,521
2020-06-24,Panama,PA,562,15,4246440,America,27314,536
2020-06-25,Panama,PA,716,11,4246440,America,28030,547
2020-06-26,Panama,PA,1007,17,4246440,America,29037,564
2020-06-27,Panama,PA,868,11,4246440,America,29905,575
2020-06-28,Panama,PA,753,17,4246440,America,30658,592
2020-06-29,Panama,PA,1028,12,4246440,America,31686,604
2020-06-30,Panama,PA,1099,16,4246440,America,32785,620
2020-07-01,Panama,PA,765,11,4246440,America,33550,631
2020-07-02,Panama,PA,913,14,4246440,America,34463,645
2020-07-03,Panama,PA,774,22,4246440,America,35237,667
2020-07-04,Panama,PA,758,31,4246440,America,35995,698
2020-07-05,Panama,PA,988,22,4246440,America,36983,720
2020-07-06,Panama,PA,1166,27,4246440,America,38149,747
2020-07-07,Panama,PA,1185,23,4246440,America,39334,770
2020-07-08,Panama,PA,957,29,4246440,America,40291,799
2020-07-09,Panama,PA,960,20,4246440,America,41251,819
2020-07-10,Panama,PA,965,20,4246440,America,42216,839
2020-07-11,Panama,PA,1041,24,4246440,America,43257,863
2020-07-12,Panama,PA,1075,30,4246440,America,44332,893
2020-07-13,Panama,PA,1301,16,4246440,America,45633,909
2020-07-14,Panama,PA,1540,23,4246440,America,47173,932
2020-07-15,Panama,PA,923,28,4246440,America,48096,960
2020-07-16,Panama,PA,1147,22,4246440,America,49243,982
2020-07-17,Panama,PA,1130,18,4246440,America,50373,1000
2020-07-18,Panama,PA,1035,38,4246440,America,51408,1038
2020-07-19,Panama,PA,853,33,4246440,America,52261,1071
2020-07-20,Panama,PA,1207,25,4246440,America,53468,1096
2020-07-21,Panama,PA,958,31,4246440,America,54426,1127
2020-07-22,Panama,PA,727,32,4246440,America,55153,1159
2020-07-23,Panama,PA,753,21,4246440,America,55906,1180
2020-07-24,Panama,PA,911,29,4246440,America,56817,1209
2020-07-25,Panama,PA,1176,41,4246440,America,57993,1250
2020-07-26,Panama,PA,871,25,4246440,America,58864,1275
2020-07-27,Panama,PA,1432,19,4246440,America,60296,1294
2020-07-28,Panama,PA,1146,28,4246440,America,61442,1322
2020-07-29,Panama,PA,781,27,4246440,America,62223,1349
2020-07-30,Panama,PA,1046,25,4246440,America,63269,1374
2020-07-31,Panama,PA,922,23,4246440,America,64191,1397
2020-08-01,Panama,PA,1065,24,4246440,America,65256,1421
2020-08-02,Panama,PA,1127,28,4246440,America,66383,1449
2020-08-03,Panama,PA,1070,22,4246440,America,67453,1471
2020-08-04,Panama,PA,1003,26,4246440,America,68456,1497
2020-08-05,Panama,PA,968,25,4246440,America,69424,1522
2020-08-06,Panama,PA,807,31,4246440,America,70231,1553
2020-08-07,Panama,PA,1187,21,4246440,America,71418,1574
2020-08-08,Panama,PA,1142,17,4246440,America,72560,1591
2020-08-09,Panama,PA,1091,18,4246440,America,73651,1609
2020-08-10,Panama,PA,841,30,4246440,America,74492,1639
2020-08-11,Panama,PA,902,25,4246440,America,75394,1664
2020-08-12,Panama,PA,1070,16,4246440,America,76464,1680
2020-08-13,Panama,PA,913,23,4246440,America,77377,1703
2020-08-14,Panama,PA,1069,19,4246440,America,78446,1722
2020-08-15,Panama,PA,956,12,4246440,America,79402,1734
2020-08-16,Panama,PA,1263,12,4246440,America,80665,1746
2020-08-17,Panama,PA,1275,21,4246440,America,81940,1767
2020-08-18,Panama,PA,603,21,4246440,America,82543,1788
2020-08-19,Panama,PA,247,21,4246440,America,82790,1809
2020-08-20,Panama,PA,964,18,4246440,America,83754,1827
2020-08-21,Panama,PA,101,17,4246440,America,83855,1844
2020-08-22,Panama,PA,537,15,4246440,America,84392,1859
2020-08-23,Panama,PA,1088,19,4246440,America,85480,1878
2020-08-24,Panama,PA,1420,14,4246440,America,86900,1892
2020-08-25,Panama,PA,585,14,4246440,America,87485,1906
2020-08-26,Panama,PA,896,13,4246440,America,88381,1919
2020-08-27,Panama,PA,701,13,4246440,America,89082,1932
2020-08-28,Panama,PA,900,16,4246440,America,89982,1948
2020-08-29,Panama,PA,642,18,4246440,America,90624,1966
2020-08-30,Panama,PA,713,17,4246440,America,91337,1983
2020-08-31,Panama,PA,728,12,4246440,America,92065,1995
2020-09-01,Panama,PA,917,7,4246440,America,92982,2002
2020-09-02,Panama,PA,570,16,4246440,America,93552,2018
2020-09-03,Panama,PA,532,12,4246440,America,94084,2030
2020-09-04,Panama,PA,830,16,4246440,America,94914,2046
2020-09-05,Panama,PA,682,17,4246440,America,95596,2063
2020-09-06,Panama,PA,709,12,4246440,America,96305,2075
2020-09-07,Panama,PA,738,11,4246440,America,97043,2086
2020-09-08,Panama,PA,535,13,4246440,America,97578,2099
2020-09-09,Panama,PA,829,8,4246440,America,98407,2107
2020-09-10,Panama,PA,635,9,4246440,America,99042,2116
2020-09-11,Panama,PA,673,11,4246440,America,99715,2127
2020-09-12,Panama,PA,615,13,4246440,America,100330,2140
2020-09-13,Panama,PA,711,15,4246440,America,101041,2155
2020-09-14,Panama,PA,704,11,4246440,America,101745,2166
2020-09-15,Panama,PA,459,7,4246440,America,102204,2173
2020-09-16,Panama,PA,628,14,4246440,America,102832,2187
2020-09-17,Panama,PA,634,11,4246440,America,103466,2198
2020-09-18,Panama,PA,672,15,4246440,America,104138,2213
2020-09-19,Panama,PA,741,16,4246440,America,104879,2229
2020-09-20,Panama,PA,722,18,4246440,America,105601,2247
2020-09-21,Panama,PA,602,10,4246440,America,106203,2257
2020-09-22,Panama,PA,607,15,4246440,America,106810,2272
2020-09-23,Panama,PA,474,13,4246440,America,107284,2285
2020-09-24,Panama,PA,706,6,4246440,America,107990,2291
2020-09-25,Panama,PA,736,6,4246440,America,108726,2297
2020-09-26,Panama,PA,705,14,4246440,America,109431,2311
2020-09-27,Panama,PA,677,12,4246440,America,110108,2323
2020-09-28,Panama,PA,447,17,4246440,America,110555,2340
2020-09-29,Panama,PA,722,8,4246440,America,111277,2348
2020-09-30,Panama,PA,576,16,4246440,America,111853,2364
2020-10-01,Panama,PA,742,8,4246440,America,112595,2372
2020-10-02,Panama,PA,747,15,4246440,America,113342,2387
2020-10-03,Panama,PA,620,19,4246440,America,113962,2406
2020-10-04,Panama,PA,691,8,4246440,America,114653,2414
2020-10-05,Panama,PA,633,9,4246440,America,115286,2423
2020-10-06,Panama,PA,633,7,4246440,America,115919,2430
2020-10-07,Panama,PA,683,10,4246440,America,116602,2440
2020-10-08,Panama,PA,698,8,4246440,America,117300,2448
2020-10-09,Panama,PA,754,15,4246440,America,118054,2463
2020-10-10,Panama,PA,787,11,4246440,America,118841,2474
2020-10-11,Panama,PA,825,8,4246440,America,119666,2482
2020-10-12,Panama,PA,647,9,4246440,America,120313,2491
2020-10-13,Panama,PA,489,11,4246440,America,120802,2502
2020-10-14,Panama,PA,494,9,4246440,America,121296,2511
2020-10-15,Panama,PA,832,8,4246440,America,122128,2519
2020-10-16,Panama,PA,755,10,4246440,America,122883,2529
2020-10-17,Panama,PA,615,17,4246440,America,123498,2546
2020-10-18,Panama,PA,609,11,4246440,America,124107,2557
2020-10-19,Panama,PA,638,7,4246440,America,124745,2564
2020-10-20,Panama,PA,436,10,4246440,America,125181,2574
2020-10-21,Panama,PA,558,11,4246440,America,125739,2585
2020-10-22,Panama,PA,696,12,4246440,America,126435,2597
2020-10-23,Panama,PA,792,15,4246440,America,127227,2612
2020-10-24,Panama,PA,639,10,4246440,America,127866,2622
2020-10-25,Panama,PA,649,6,4246440,America,128515,2628
2020-10-26,Panama,PA,685,5,4246440,America,129200,2633
2020-10-27,Panama,PA,551,5,4246440,America,129751,2638
2020-10-28,Panama,PA,671,12,4246440,America,130422,2650
2020-10-29,Panama,PA,825,13,4246440,America,131247,2663
2020-10-30,Panama,PA,798,15,4246440,America,132045,2678
2020-10-31,Panama,PA,822,10,4246440,America,132867,2688
2020-11-01,Panama,PA,731,12,4246440,America,133598,2700
2020-11-02,Panama,PA,738,6,4246440,America,134336,2706
2020-11-03,Panama,PA,579,14,4246440,America,134915,2720
2020-11-04,Panama,PA,677,11,4246440,America,135592,2731
2020-11-05,Panama,PA,432,13,4246440,America,136024,2744
2020-11-06,Panama,PA,543,12,4246440,America,136567,2756
2020-11-07,Panama,PA,1193,14,4246440,America,137760,2770
2020-11-08,Panama,PA,746,11,4246440,America,138506,2781
2020-11-09,Panama,PA,1021,17,4246440,America,139527,2798
2020-11-10,Panama,PA,804,10,4246440,America,140331,2808
2020-11-11,Panama,PA,971,9,4246440,America,141302,2817
2020-11-12,Panama,PA,1163,6,4246440,America,142465,2823
2020-11-13,Panama,PA,887,7,4246440,America,143352,2830
2020-11-14,Panama,PA,1125,26,4246440,America,144477,2856
2020-11-15,Panama,PA,832,11,4246440,America,145309,2867
2020-11-16,Panama,PA,1344,6,4246440,America,146653,2873
2020-11-17,Panama,PA,1014,8,4246440,America,147667,2881
2020-11-18,Panama,PA,1054,12,4246440,America,148721,2893
2020-11-19,Panama,PA,1112,14,4246440,America,149833,2907
2020-11-20,Panama,PA,1256,15,4246440,America,151089,2922
2020-11-21,Panama,PA,1200,10,4246440,America,152289,2932
2020-11-22,Panama,PA,1288,14,4246440,America,153577,2946
2020-11-23,Panama,PA,1206,11,4246440,America,154783,2957
2020-11-24,Panama,PA,875,16,4246440,America,155658,2973
2020-11-25,Panama,PA,1272,13,4246440,America,156930,2986
2020-11-26,Panama,PA,1602,16,4246440,America,158532,3002
2020-11-27,Panama,PA,1755,16,4246440,America,160287,3018
2020-11-28,Panama,PA,1457,12,4246440,America,161744,3030
2020-11-29,Panama,PA,1709,9,4246440,America,163453,3039
2020-11-30,Panama,PA,1276,21,4246440,America,164729,3060
2020-12-01,Panama,PA,1077,19,4246440,America,165806,3079
2020-12-02,Panama,PA,1505,19,4246440,America,167311,3098
2020-12-03,Panama,PA,2028,16,4246440,America,169339,3114
2020-12-04,Panama,PA,1880,27,4246440,America,171219,3141
2020-12-05,Panama,PA,2388,13,4246440,America,173607,3154
2020-12-06,Panama,PA,2300,19,4246440,America,175907,3173
2020-12-07,Panama,PA,1812,20,4246440,America,177719,3193
2020-12-08,Panama,PA,1511,19,4246440,America,179230,3212
2020-12-09,Panama,PA,1936,29,4246440,America,181166,3241
2020-12-10,Panama,PA,1811,23,4246440,America,182977,3264
2020-12-11,Panama,PA,2447,23,4246440,America,185424,3287
2020-12-12,Panama,PA,2355,22,4246440,America,187779,3309
2020-12-13,Panama,PA,2806,22,4246440,America,190585,3331
2020-12-14,Panama,PA,2422,25,4246440,America,193007,3356
2020-03-07,Peru,PE,1,0,32510462,America,1,0
2020-03-09,Peru,PE,6,0,32510462,America,7,0
2020-03-10,Peru,PE,2,0,32510462,America,9,0
2020-03-11,Peru,PE,2,0,32510462,America,11,0
2020-03-12,Peru,PE,6,0,32510462,America,17,0
2020-03-13,Peru,PE,5,0,32510462,America,22,0
2020-03-14,Peru,PE,16,0,32510462,America,38,0
2020-03-15,Peru,PE,5,0,32510462,America,43,0
2020-03-16,Peru,PE,28,0,32510462,America,71,0
2020-03-17,Peru,PE,15,0,32510462,America,86,0
2020-03-18,Peru,PE,31,0,32510462,America,117,0
2020-03-19,Peru,PE,28,0,32510462,America,145,0
2020-03-20,Peru,PE,89,2,32510462,America,234,2
2020-03-21,Peru,PE,29,1,32510462,America,263,3
2020-03-22,Peru,PE,55,2,32510462,America,318,5
2020-03-23,Peru,PE,45,0,32510462,America,363,5
2020-03-24,Peru,PE,32,0,32510462,America,395,5
2020-03-25,Peru,PE,21,2,32510462,America,416,7
2020-03-26,Peru,PE,142,1,32510462,America,558,8
2020-03-27,Peru,PE,22,1,32510462,America,580,9
2020-03-28,Peru,PE,55,2,32510462,America,635,11
2020-03-29,Peru,PE,36,5,32510462,America,671,16
2020-03-30,Peru,PE,181,2,32510462,America,852,18
2020-03-31,Peru,PE,98,6,32510462,America,950,24
2020-04-01,Peru,PE,115,6,32510462,America,1065,30
2020-04-02,Peru,PE,258,17,32510462,America,1323,47
2020-04-03,Peru,PE,91,8,32510462,America,1414,55
2020-04-04,Peru,PE,181,6,32510462,America,1595,61
2020-04-05,Peru,PE,151,12,32510462,America,1746,73
2020-04-06,Peru,PE,535,10,32510462,America,2281,83
2020-04-07,Peru,PE,280,9,32510462,America,2561,92
2020-04-08,Peru,PE,393,15,32510462,America,2954,107
2020-04-09,Peru,PE,1388,14,32510462,America,4342,121
2020-04-10,Peru,PE,914,17,32510462,America,5256,138
2020-04-11,Peru,PE,641,31,32510462,America,5897,169
2020-04-12,Peru,PE,951,12,32510462,America,6848,181
2020-04-13,Peru,PE,671,12,32510462,America,7519,193
2020-04-14,Peru,PE,0,0,32510462,America,7519,193
2020-04-15,Peru,PE,2784,37,32510462,America,10303,230
2020-04-16,Peru,PE,1172,24,32510462,America,11475,254
2020-04-17,Peru,PE,1016,20,32510462,America,12491,274
2020-04-18,Peru,PE,998,26,32510462,America,13489,300
2020-04-19,Peru,PE,931,48,32510462,America,14420,348
2020-04-20,Peru,PE,1208,52,32510462,America,15628,400
2020-04-21,Peru,PE,697,45,32510462,America,16325,445
2020-04-22,Peru,PE,1512,39,32510462,America,17837,484
2020-04-23,Peru,PE,1413,46,32510462,America,19250,530
2020-04-24,Peru,PE,1664,42,32510462,America,20914,572
2020-04-25,Peru,PE,734,62,32510462,America,21648,634
2020-04-26,Peru,PE,3683,66,32510462,America,25331,700
2020-04-27,Peru,PE,2186,28,32510462,America,27517,728
2020-04-28,Peru,PE,1182,54,32510462,America,28699,782
2020-04-29,Peru,PE,2491,72,32510462,America,31190,854
2020-04-30,Peru,PE,2741,89,32510462,America,33931,943
2020-05-01,Peru,PE,3045,108,32510462,America,36976,1051
2020-05-02,Peru,PE,3483,73,32510462,America,40459,1124
2020-05-03,Peru,PE,2075,76,32510462,America,42534,1200
2020-05-04,Peru,PE,3394,86,32510462,America,45928,1286
2020-05-05,Peru,PE,1444,58,32510462,America,47372,1344
2020-05-06,Peru,PE,3817,100,32510462,America,51189,1444
2020-05-07,Peru,PE,3628,89,32510462,America,54817,1533
2020-05-08,Peru,PE,3709,94,32510462,America,58526,1627
2020-05-09,Peru,PE,3321,87,32510462,America,61847,1714
2020-05-10,Peru,PE,3168,100,32510462,America,65015,1814
2020-05-11,Peru,PE,2292,75,32510462,America,67307,1889
2020-05-12,Peru,PE,1515,72,32510462,America,68822,1961
2020-05-13,Peru,PE,3237,96,32510462,America,72059,2057
2020-05-14,Peru,PE,4247,112,32510462,America,76306,2169
2020-05-15,Peru,PE,4298,98,32510462,America,80604,2267
2020-05-16,Peru,PE,3891,126,32510462,America,84495,2393
2020-05-17,Peru,PE,4046,130,32510462,America,88541,2523
2020-05-18,Peru,PE,3732,125,32510462,America,92273,2648
2020-05-19,Peru,PE,2660,141,32510462,America,94933,2789
2020-05-20,Peru,PE,4550,125,32510462,America,99483,2914
2020-05-21,Peru,PE,4537,110,32510462,America,104020,3024
2020-05-22,Peru,PE,4749,124,32510462,America,108769,3148
2020-05-23,Peru,PE,2929,96,32510462,America,111698,3244
2020-05-24,Peru,PE,4056,129,32510462,America,115754,3373
2020-05-25,Peru,PE,4205,83,32510462,America,119959,3456
2020-05-26,Peru,PE,4020,173,32510462,America,123979,3629
2020-05-27,Peru,PE,5772,159,32510462,America,129751,3788
2020-05-28,Peru,PE,6154,195,32510462,America,135905,3983
2020-05-29,Peru,PE,5874,116,32510462,America,141779,4099
2020-05-30,Peru,PE,6506,131,32510462,America,148285,4230
2020-05-31,Peru,PE,7386,141,32510462,America,155671,4371
2020-06-01,Peru,PE,8805,135,32510462,America,164476,4506
2020-06-02,Peru,PE,5563,128,32510462,America,170039,4634
2020-06-03,Peru,PE,0,0,32510462,America,170039,4634
2020-06-04,Peru,PE,8875,260,32510462,America,178914,4894
2020-06-05,Peru,PE,4284,137,32510462,America,183198,5031
2020-06-06,Peru,PE,4202,131,32510462,America,187400,5162
2020-06-07,Peru,PE,4358,139,32510462,America,191758,5301
2020-06-08,Peru,PE,4757,164,32510462,America,196515,5465
2020-06-09,Peru,PE,3181,106,32510462,America,199696,5571
2020-06-10,Peru,PE,4040,167,32510462,America,203736,5738
2020-06-11,Peru,PE,5087,165,32510462,America,208823,5903
2020-06-12,Peru,PE,5965,206,32510462,America,214788,6109
2020-06-13,Peru,PE,5961,199,32510462,America,220749,6308
2020-06-14,Peru,PE,4383,190,32510462,America,225132,6498
2020-06-15,Peru,PE,4604,190,32510462,America,229736,6688
2020-06-16,Peru,PE,3256,172,32510462,America,232992,6860
2020-06-17,Peru,PE,4164,196,32510462,America,237156,7056
2020-06-18,Peru,PE,3752,201,32510462,America,240908,7257
2020-06-19,Peru,PE,3480,204,32510462,America,244388,7461
2020-06-20,Peru,PE,3537,199,32510462,America,247925,7660
2020-06-21,Peru,PE,3413,201,32510462,America,251338,7861
2020-06-22,Peru,PE,3598,184,32510462,America,254936,8045
2020-06-23,Peru,PE,0,0,32510462,America,254936,8045
2020-06-24,Peru,PE,5874,359,32510462,America,260810,8404
2020-06-25,Peru,PE,3879,182,32510462,America,264689,8586
2020-06-26,Peru,PE,3913,175,32510462,America,268602,8761
2020-06-27,Peru,PE,3762,178,32510462,America,272364,8939
2020-06-28,Peru,PE,3625,196,32510462,America,275989,9135
2020-06-29,Peru,PE,3430,182,32510462,America,279419,9317
2020-06-30,Peru,PE,2946,187,32510462,America,282365,9504
2020-07-01,Peru,PE,2848,173,32510462,America,285213,9677
2020-07-02,Peru,PE,3264,183,32510462,America,288477,9860
2020-07-03,Peru,PE,3527,185,32510462,America,292004,10045
2020-07-04,Peru,PE,3595,181,32510462,America,295599,10226
2020-07-05,Peru,PE,3481,186,32510462,America,299080,10412
2020-07-06,Peru,PE,3638,177,32510462,America,302718,10589
2020-07-07,Peru,PE,2985,183,32510462,America,305703,10772
2020-07-08,Peru,PE,3575,180,32510462,America,309278,10952
2020-07-09,Peru,PE,3633,181,32510462,America,312911,11133
2020-07-10,Peru,PE,3537,181,32510462,America,316448,11314
2020-07-11,Peru,PE,3198,186,32510462,America,319646,11500
2020-07-12,Peru,PE,3064,182,32510462,America,322710,11682
2020-07-13,Peru,PE,3616,188,32510462,America,326326,11870
2020-07-14,Peru,PE,3797,184,32510462,America,330123,12054
2020-07-15,Peru,PE,3744,175,32510462,America,333867,12229
2020-07-16,Peru,PE,3857,188,32510462,America,337724,12417
2020-07-17,Peru,PE,3862,198,32510462,America,341586,12615
2020-07-18,Peru,PE,3951,184,32510462,America,345537,12799
2020-07-19,Peru,PE,3963,199,32510462,America,349500,12998
2020-07-20,Peru,PE,4090,189,32510462,America,353590,13187
2020-07-21,Peru,PE,4091,197,32510462,America,357681,13384
2020-07-22,Peru,PE,4406,195,32510462,America,362087,13579
2020-07-23,Peru,PE,4463,188,32510462,America,366550,13767
2020-07-24,Peru,PE,4546,3887,32510462,America,371096,17654
2020-07-25,Peru,PE,4865,189,32510462,America,375961,17843
2020-07-26,Peru,PE,3923,187,32510462,America,379884,18030
2020-07-27,Peru,PE,4913,199,32510462,America,384797,18229
2020-07-28,Peru,PE,4920,189,32510462,America,389717,18418
2020-07-29,Peru,PE,5288,194,32510462,America,395005,18612
2020-07-30,Peru,PE,5678,204,32510462,America,400683,18816
2020-07-31,Peru,PE,6809,205,32510462,America,407492,19021
2020-08-01,Peru,PE,7243,196,32510462,America,414735,19217
2020-08-02,Peru,PE,7448,191,32510462,America,422183,19408
2020-08-03,Peru,PE,6667,206,32510462,America,428850,19614
2020-08-04,Peru,PE,4250,197,32510462,America,433100,19811
2020-08-05,Peru,PE,6790,196,32510462,America,439890,20007
2020-08-06,Peru,PE,7734,221,32510462,America,447624,20228
2020-08-07,Peru,PE,7785,196,32510462,America,455409,20424
2020-08-08,Peru,PE,8466,225,32510462,America,463875,20649
2020-08-09,Peru,PE,7137,195,32510462,America,471012,20844
2020-08-10,Peru,PE,7012,228,32510462,America,478024,21072
2020-08-11,Peru,PE,5109,204,32510462,America,483133,21276
2020-08-12,Peru,PE,6547,225,32510462,America,489680,21501
2020-08-13,Peru,PE,8875,212,32510462,America,498555,21713
2020-08-14,Peru,PE,9441,3935,32510462,America,507996,25648
2020-08-15,Peru,PE,8300,208,32510462,America,516296,25856
2020-08-16,Peru,PE,9507,219,32510462,America,525803,26075
2020-08-17,Peru,PE,10143,206,32510462,America,535946,26281
2020-08-18,Peru,PE,5547,200,32510462,America,541493,26481
2020-08-19,Peru,PE,7828,177,32510462,America,549321,26658
2020-08-20,Peru,PE,9099,176,32510462,America,558420,26834
2020-08-21,Peru,PE,8639,200,32510462,America,567059,27034
2020-08-22,Peru,PE,9008,211,32510462,America,576067,27245
2020-08-23,Peru,PE,9169,208,32510462,America,585236,27453
2020-08-24,Peru,PE,9090,210,32510462,America,594326,27663
2020-08-25,Peru,PE,6112,150,32510462,America,600438,27813
2020-08-26,Peru,PE,6944,188,32510462,America,607382,28001
2020-08-27,Peru,PE,5996,123,32510462,America,613378,28124
2020-08-28,Peru,PE,8619,153,32510462,America,621997,28277
2020-08-29,Peru,PE,7964,194,32510462,America,629961,28471
2020-08-30,Peru,PE,9474,136,32510462,America,639435,28607
2020-08-31,Peru,PE,7731,181,32510462,America,647166,28788
2020-09-01,Peru,PE,4871,156,32510462,America,652037,28944
2020-09-02,Peru,PE,5092,124,32510462,America,657129,29068
2020-09-03,Peru,PE,6308,191,32510462,America,663437,29259
2020-09-04,Peru,PE,6708,146,32510462,America,670145,29405
2020-09-05,Peru,PE,6703,149,32510462,America,676848,29554
2020-09-06,Peru,PE,6854,133,32510462,America,683702,29687
2020-09-07,Peru,PE,6275,151,32510462,America,689977,29838
2020-09-08,Peru,PE,1598,138,32510462,America,691575,29976
2020-09-09,Peru,PE,4615,147,32510462,America,696190,30123
2020-09-10,Peru,PE,6586,113,32510462,America,702776,30236
2020-09-11,Peru,PE,7291,108,32510462,America,710067,30344
2020-09-12,Peru,PE,6603,126,32510462,America,716670,30470
2020-09-13,Peru,PE,6162,123,32510462,America,722832,30593
2020-09-14,Peru,PE,6787,117,32510462,America,729619,30710
2020-09-15,Peru,PE,4241,102,32510462,America,733860,30812
2020-09-16,Peru,PE,4160,115,32510462,America,738020,30927
2020-09-17,Peru,PE,6380,124,32510462,America,744400,31051
2020-09-18,Peru,PE,5698,95,32510462,America,750098,31146
2020-09-19,Peru,PE,6314,137,32510462,America,756412,31283
2020-09-20,Peru,PE,6453,86,32510462,America,762865,31369
2020-09-21,Peru,PE,6030,0,32510462,America,768895,31369
2020-09-22,Peru,PE,4001,105,32510462,America,772896,31474
2020-09-23,Peru,PE,3650,112,32510462,America,776546,31586
2020-09-24,Peru,PE,6149,284,32510462,America,782695,31870
2020-09-25,Peru,PE,6235,68,32510462,America,788930,31938
2020-09-26,Peru,PE,5654,99,32510462,America,794584,32037
2020-09-27,Peru,PE,5558,105,32510462,America,800142,32142
2020-09-28,Peru,PE,5160,120,32510462,America,805302,32262
2020-09-29,Peru,PE,3412,62,32510462,America,808714,32324
2020-09-30,Peru,PE,3054,72,32510462,America,811768,32396
2020-10-01,Peru,PE,3061,67,32510462,America,814829,32463
2020-10-02,Peru,PE,3468,72,32510462,America,818297,32535
2020-10-03,Peru,PE,3267,74,32510462,America,821564,32609
2020-10-04,Peru,PE,3421,56,32510462,America,824985,32665
2020-10-05,Peru,PE,3184,77,32510462,America,828169,32742
2020-10-06,Peru,PE,1830,92,32510462,America,829999,32834
2020-10-07,Peru,PE,2930,80,32510462,America,832929,32914
2020-10-08,Peru,PE,2733,95,32510462,America,835662,33009
2020-10-09,Peru,PE,2952,89,32510462,America,838614,33098
2020-10-10,Peru,PE,4741,60,32510462,America,843355,33158
2020-10-11,Peru,PE,2733,65,32510462,America,846088,33223
2020-10-12,Peru,PE,3283,82,32510462,America,849371,33305
2020-10-13,Peru,PE,1800,52,32510462,America,851171,33357
2020-10-14,Peru,PE,2803,62,32510462,America,853974,33419
2020-10-15,Peru,PE,2977,93,32510462,America,856951,33512
2020-10-16,Peru,PE,2789,65,32510462,America,859740,33577
2020-10-17,Peru,PE,2677,71,32510462,America,862417,33648
2020-10-18,Peru,PE,3132,54,32510462,America,865549,33702
2020-10-19,Peru,PE,3126,57,32510462,America,868675,33759
2020-10-20,Peru,PE,2201,61,32510462,America,870876,33820
2020-10-21,Peru,PE,3242,55,32510462,America,874118,33875
2020-10-22,Peru,PE,2767,62,32510462,America,876885,33937
2020-10-23,Peru,PE,2991,47,32510462,America,879876,33984
2020-10-24,Peru,PE,3240,49,32510462,America,883116,34033
2020-10-25,Peru,PE,3098,62,32510462,America,886214,34095
2020-10-26,Peru,PE,2501,54,32510462,America,888715,34149
2020-10-27,Peru,PE,1859,48,32510462,America,890574,34197
2020-10-28,Peru,PE,1923,60,32510462,America,892497,34257
2020-10-29,Peru,PE,2431,58,32510462,America,894928,34315
2020-10-30,Peru,PE,2666,47,32510462,America,897594,34362
2020-10-31,Peru,PE,2586,49,32510462,America,900180,34411
2020-11-01,Peru,PE,2323,65,32510462,America,902503,34476
2020-11-02,Peru,PE,2408,53,32510462,America,904911,34529
2020-11-03,Peru,PE,1634,56,32510462,America,906545,34585
2020-11-04,Peru,PE,2357,38,32510462,America,908902,34623
2020-11-05,Peru,PE,2885,48,32510462,America,911787,34671
2020-11-06,Peru,PE,2935,59,32510462,America,914722,34730
2020-11-07,Peru,PE,2781,53,32510462,America,917503,34783
2020-11-08,Peru,PE,2507,57,32510462,America,920010,34840
2020-11-09,Peru,PE,2323,39,32510462,America,922333,34879
2020-11-10,Peru,PE,1194,64,32510462,America,923527,34943
2020-11-11,Peru,PE,1904,49,32510462,America,925431,34992
2020-11-12,Peru,PE,2575,39,32510462,America,928006,35031
2020-11-13,Peru,PE,2231,36,32510462,America,930237,35067
2020-11-14,Peru,PE,2413,39,32510462,America,932650,35106
2020-11-15,Peru,PE,2249,71,32510462,America,934899,35177
2020-11-16,Peru,PE,2112,54,32510462,America,937011,35231
2020-11-17,Peru,PE,1257,40,32510462,America,938268,35271
2020-11-18,Peru,PE,1663,46,32510462,America,939931,35317
2020-11-19,Peru,PE,2020,85,32510462,America,941951,35402
2020-11-20,Peru,PE,1966,44,32510462,America,943917,35446
2020-11-21,Peru,PE,2170,38,32510462,America,946087,35484
2020-11-22,Peru,PE,1994,65,32510462,America,948081,35549
2020-11-23,Peru,PE,1589,46,32510462,America,949670,35595
2020-11-24,Peru,PE,887,46,32510462,America,950557,35641
2020-11-25,Peru,PE,1882,44,32510462,America,952439,35685
2020-11-26,Peru,PE,2020,42,32510462,America,954459,35727
2020-11-27,Peru,PE,1888,58,32510462,America,956347,35785
2020-11-28,Peru,PE,1977,54,32510462,America,958324,35839
2020-11-29,Peru,PE,2044,40,32510462,America,960368,35879
2020-11-30,Peru,PE,2162,44,32510462,America,962530,35923
2020-12-01,Peru,PE,1075,43,32510462,America,963605,35966
2020-12-02,Peru,PE,1623,65,32510462,America,965228,36031
2020-12-03,Peru,PE,1847,45,32510462,America,967075,36076
2020-12-04,Peru,PE,1771,28,32510462,America,968846,36104
2020-12-05,Peru,PE,2014,91,32510462,America,970860,36195
2020-12-06,Peru,PE,1828,36,32510462,America,972688,36231
2020-12-07,Peru,PE,1224,43,32510462,America,973912,36274
2020-12-08,Peru,PE,1204,50,32510462,America,975116,36324
2020-12-09,Peru,PE,1505,77,32510462,America,976621,36401
2020-12-10,Peru,PE,691,54,32510462,America,977312,36455
2020-12-11,Peru,PE,1799,44,32510462,America,979111,36499
2020-12-12,Peru,PE,1832,45,32510462,America,980943,36544
2020-12-13,Peru,PE,2102,65,32510462,America,983045,36609
2020-12-14,Peru,PE,1928,68,32510462,America,984973,36677
2020-03-19,French_Polynesia,PF,3,0,279285,Oceania,3,0
2020-03-20,French_Polynesia,PF,0,0,279285,Oceania,3,0
2020-03-21,French_Polynesia,PF,12,0,279285,Oceania,15,0
2020-03-22,French_Polynesia,PF,2,0,279285,Oceania,17,0
2020-03-23,French_Polynesia,PF,1,0,279285,Oceania,18,0
2020-03-24,French_Polynesia,PF,5,0,279285,Oceania,23,0
2020-03-25,French_Polynesia,PF,2,0,279285,Oceania,25,0
2020-03-26,French_Polynesia,PF,0,0,279285,Oceania,25,0
2020-03-27,French_Polynesia,PF,5,0,279285,Oceania,30,0
2020-03-28,French_Polynesia,PF,0,0,279285,Oceania,30,0
2020-03-29,French_Polynesia,PF,4,0,279285,Oceania,34,0
2020-03-30,French_Polynesia,PF,1,0,279285,Oceania,35,0
2020-03-31,French_Polynesia,PF,1,0,279285,Oceania,36,0
2020-04-01,French_Polynesia,PF,1,0,279285,Oceania,37,0
2020-04-02,French_Polynesia,PF,0,0,279285,Oceania,37,0
2020-04-03,French_Polynesia,PF,0,0,279285,Oceania,37,0
2020-04-04,French_Polynesia,PF,2,0,279285,Oceania,39,0
2020-04-05,French_Polynesia,PF,1,0,279285,Oceania,40,0
2020-04-06,French_Polynesia,PF,1,0,279285,Oceania,41,0
2020-04-07,French_Polynesia,PF,0,0,279285,Oceania,41,0
2020-04-08,French_Polynesia,PF,6,0,279285,Oceania,47,0
2020-04-09,French_Polynesia,PF,4,0,279285,Oceania,51,0
2020-04-10,French_Polynesia,PF,0,0,279285,Oceania,51,0
2020-04-11,French_Polynesia,PF,0,0,279285,Oceania,51,0
2020-04-12,French_Polynesia,PF,0,0,279285,Oceania,51,0
2020-04-13,French_Polynesia,PF,2,0,279285,Oceania,53,0
2020-04-14,French_Polynesia,PF,2,0,279285,Oceania,55,0
2020-04-15,French_Polynesia,PF,0,0,279285,Oceania,55,0
2020-04-16,French_Polynesia,PF,0,0,279285,Oceania,55,0
2020-04-17,French_Polynesia,PF,0,0,279285,Oceania,55,0
2020-04-18,French_Polynesia,PF,0,0,279285,Oceania,55,0
2020-04-19,French_Polynesia,PF,0,0,279285,Oceania,55,0
2020-04-20,French_Polynesia,PF,0,0,279285,Oceania,55,0
2020-04-21,French_Polynesia,PF,1,0,279285,Oceania,56,0
2020-04-22,French_Polynesia,PF,1,0,279285,Oceania,57,0
2020-04-23,French_Polynesia,PF,0,0,279285,Oceania,57,0
2020-04-24,French_Polynesia,PF,0,0,279285,Oceania,57,0
2020-04-25,French_Polynesia,PF,0,0,279285,Oceania,57,0
2020-04-26,French_Polynesia,PF,0,0,279285,Oceania,57,0
2020-04-27,French_Polynesia,PF,0,0,279285,Oceania,57,0
2020-04-28,French_Polynesia,PF,1,0,279285,Oceania,58,0
2020-04-29,French_Polynesia,PF,0,0,279285,Oceania,58,0
2020-04-30,French_Polynesia,PF,0,0,279285,Oceania,58,0
2020-05-01,French_Polynesia,PF,0,0,279285,Oceania,58,0
2020-05-02,French_Polynesia,PF,0,0,279285,Oceania,58,0
2020-05-03,French_Polynesia,PF,0,0,279285,Oceania,58,0
2020-05-04,French_Polynesia,PF,0,0,279285,Oceania,58,0
2020-05-05,French_Polynesia,PF,0,0,279285,Oceania,58,0
2020-05-06,French_Polynesia,PF,2,0,279285,Oceania,60,0
2020-05-07,French_Polynesia,PF,0,0,279285,Oceania,60,0
2020-05-08,French_Polynesia,PF,0,0,279285,Oceania,60,0
2020-05-09,French_Polynesia,PF,0,0,279285,Oceania,60,0
2020-05-10,French_Polynesia,PF,0,0,279285,Oceania,60,0
2020-05-11,French_Polynesia,PF,0,0,279285,Oceania,60,0
2020-05-12,French_Polynesia,PF,0,0,279285,Oceania,60,0
2020-05-13,French_Polynesia,PF,0,0,279285,Oceania,60,0
2020-05-14,French_Polynesia,PF,0,0,279285,Oceania,60,0
2020-05-15,French_Polynesia,PF,0,0,279285,Oceania,60,0
2020-05-16,French_Polynesia,PF,0,0,279285,Oceania,60,0
2020-05-17,French_Polynesia,PF,0,0,279285,Oceania,60,0
2020-05-18,French_Polynesia,PF,0,0,279285,Oceania,60,0
2020-05-19,French_Polynesia,PF,0,0,279285,Oceania,60,0
2020-05-20,French_Polynesia,PF,0,0,279285,Oceania,60,0
2020-05-21,French_Polynesia,PF,0,0,279285,Oceania,60,0
2020-05-22,French_Polynesia,PF,0,0,279285,Oceania,60,0
2020-05-23,French_Polynesia,PF,0,0,279285,Oceania,60,0
2020-05-24,French_Polynesia,PF,0,0,279285,Oceania,60,0
2020-05-25,French_Polynesia,PF,0,0,279285,Oceania,60,0
2020-05-26,French_Polynesia,PF,0,0,279285,Oceania,60,0
2020-05-27,French_Polynesia,PF,0,0,279285,Oceania,60,0
2020-05-28,French_Polynesia,PF,0,0,279285,Oceania,60,0
2020-05-29,French_Polynesia,PF,0,0,279285,Oceania,60,0
2020-05-30,French_Polynesia,PF,0,0,279285,Oceania,60,0
2020-05-31,French_Polynesia,PF,0,0,279285,Oceania,60,0
2020-06-01,French_Polynesia,PF,0,0,279285,Oceania,60,0
2020-06-02,French_Polynesia,PF,0,0,279285,Oceania,60,0
2020-06-03,French_Polynesia,PF,0,0,279285,Oceania,60,0
2020-06-04,French_Polynesia,PF,0,0,279285,Oceania,60,0
2020-06-05,French_Polynesia,PF,0,0,279285,Oceania,60,0
2020-06-06,French_Polynesia,PF,0,0,279285,Oceania,60,0
2020-06-07,French_Polynesia,PF,0,0,279285,Oceania,60,0
2020-06-08,French_Polynesia,PF,0,0,279285,Oceania,60,0
2020-06-09,French_Polynesia,PF,0,0,279285,Oceania,60,0
2020-06-10,French_Polynesia,PF,0,0,279285,Oceania,60,0
2020-06-11,French_Polynesia,PF,0,0,279285,Oceania,60,0
2020-06-12,French_Polynesia,PF,0,0,279285,Oceania,60,0
2020-06-13,French_Polynesia,PF,0,0,279285,Oceania,60,0
2020-06-14,French_Polynesia,PF,0,0,279285,Oceania,60,0
2020-06-15,French_Polynesia,PF,0,0,279285,Oceania,60,0
2020-06-16,French_Polynesia,PF,0,0,279285,Oceania,60,0
2020-06-17,French_Polynesia,PF,0,0,279285,Oceania,60,0
2020-06-18,French_Polynesia,PF,0,0,279285,Oceania,60,0
2020-06-19,French_Polynesia,PF,0,0,279285,Oceania,60,0
2020-06-20,French_Polynesia,PF,0,0,279285,Oceania,60,0
2020-06-21,French_Polynesia,PF,0,0,279285,Oceania,60,0
2020-06-22,French_Polynesia,PF,0,0,279285,Oceania,60,0
2020-06-23,French_Polynesia,PF,0,0,279285,Oceania,60,0
2020-06-24,French_Polynesia,PF,0,0,279285,Oceania,60,0
2020-06-25,French_Polynesia,PF,0,0,279285,Oceania,60,0
2020-06-26,French_Polynesia,PF,0,0,279285,Oceania,60,0
2020-06-27,French_Polynesia,PF,2,0,279285,Oceania,62,0
2020-06-28,French_Polynesia,PF,0,0,279285,Oceania,62,0
2020-06-29,French_Polynesia,PF,0,0,279285,Oceania,62,0
2020-06-30,French_Polynesia,PF,0,0,279285,Oceania,62,0
2020-07-01,French_Polynesia,PF,0,0,279285,Oceania,62,0
2020-07-02,French_Polynesia,PF,0,0,279285,Oceania,62,0
2020-07-03,French_Polynesia,PF,0,0,279285,Oceania,62,0
2020-07-04,French_Polynesia,PF,0,0,279285,Oceania,62,0
2020-07-05,French_Polynesia,PF,0,0,279285,Oceania,62,0
2020-07-06,French_Polynesia,PF,0,0,279285,Oceania,62,0
2020-07-07,French_Polynesia,PF,0,0,279285,Oceania,62,0
2020-07-08,French_Polynesia,PF,0,0,279285,Oceania,62,0
2020-07-09,French_Polynesia,PF,0,0,279285,Oceania,62,0
2020-07-10,French_Polynesia,PF,0,0,279285,Oceania,62,0
2020-07-11,French_Polynesia,PF,0,0,279285,Oceania,62,0
2020-07-12,French_Polynesia,PF,0,0,279285,Oceania,62,0
2020-07-13,French_Polynesia,PF,0,0,279285,Oceania,62,0
2020-07-14,French_Polynesia,PF,0,0,279285,Oceania,62,0
2020-07-15,French_Polynesia,PF,0,0,279285,Oceania,62,0
2020-07-16,French_Polynesia,PF,0,0,279285,Oceania,62,0
2020-07-17,French_Polynesia,PF,0,0,279285,Oceania,62,0
2020-07-18,French_Polynesia,PF,0,0,279285,Oceania,62,0
2020-07-19,French_Polynesia,PF,0,0,279285,Oceania,62,0
2020-07-20,French_Polynesia,PF,0,0,279285,Oceania,62,0
2020-07-21,French_Polynesia,PF,0,0,279285,Oceania,62,0
2020-07-22,French_Polynesia,PF,0,0,279285,Oceania,62,0
2020-07-23,French_Polynesia,PF,0,0,279285,Oceania,62,0
2020-07-24,French_Polynesia,PF,0,0,279285,Oceania,62,0
2020-07-25,French_Polynesia,PF,0,0,279285,Oceania,62,0
2020-07-26,French_Polynesia,PF,0,0,279285,Oceania,62,0
2020-07-27,French_Polynesia,PF,0,0,279285,Oceania,62,0
2020-07-28,French_Polynesia,PF,0,0,279285,Oceania,62,0
2020-07-29,French_Polynesia,PF,0,0,279285,Oceania,62,0
2020-07-30,French_Polynesia,PF,0,0,279285,Oceania,62,0
2020-07-31,French_Polynesia,PF,0,0,279285,Oceania,62,0
2020-08-01,French_Polynesia,PF,0,0,279285,Oceania,62,0
2020-08-02,French_Polynesia,PF,0,0,279285,Oceania,62,0
2020-08-03,French_Polynesia,PF,0,0,279285,Oceania,62,0
2020-08-04,French_Polynesia,PF,0,0,279285,Oceania,62,0
2020-08-05,French_Polynesia,PF,0,0,279285,Oceania,62,0
2020-08-06,French_Polynesia,PF,0,0,279285,Oceania,62,0
2020-08-07,French_Polynesia,PF,0,0,279285,Oceania,62,0
2020-08-08,French_Polynesia,PF,0,0,279285,Oceania,62,0
2020-08-09,French_Polynesia,PF,0,0,279285,Oceania,62,0
2020-08-10,French_Polynesia,PF,0,0,279285,Oceania,62,0
2020-08-11,French_Polynesia,PF,0,0,279285,Oceania,62,0
2020-08-12,French_Polynesia,PF,71,0,279285,Oceania,133,0
2020-08-13,French_Polynesia,PF,6,0,279285,Oceania,139,0
2020-08-14,French_Polynesia,PF,11,0,279285,Oceania,150,0
2020-08-15,French_Polynesia,PF,16,0,279285,Oceania,166,0
2020-08-16,French_Polynesia,PF,0,0,279285,Oceania,166,0
2020-08-17,French_Polynesia,PF,26,0,279285,Oceania,192,0
2020-08-18,French_Polynesia,PF,19,0,279285,Oceania,211,0
2020-08-19,French_Polynesia,PF,0,0,279285,Oceania,211,0
2020-08-20,French_Polynesia,PF,21,0,279285,Oceania,232,0
2020-08-21,French_Polynesia,PF,0,0,279285,Oceania,232,0
2020-08-22,French_Polynesia,PF,4,0,279285,Oceania,236,0
2020-08-23,French_Polynesia,PF,0,0,279285,Oceania,236,0
2020-08-24,French_Polynesia,PF,0,0,279285,Oceania,236,0
2020-08-25,French_Polynesia,PF,74,0,279285,Oceania,310,0
2020-08-26,French_Polynesia,PF,0,0,279285,Oceania,310,0
2020-08-27,French_Polynesia,PF,43,0,279285,Oceania,353,0
2020-08-28,French_Polynesia,PF,0,0,279285,Oceania,353,0
2020-08-29,French_Polynesia,PF,67,0,279285,Oceania,420,0
2020-08-30,French_Polynesia,PF,0,0,279285,Oceania,420,0
2020-08-31,French_Polynesia,PF,0,0,279285,Oceania,420,0
2020-09-01,French_Polynesia,PF,107,0,279285,Oceania,527,0
2020-09-02,French_Polynesia,PF,46,0,279285,Oceania,573,0
2020-09-03,French_Polynesia,PF,23,0,279285,Oceania,596,0
2020-09-04,French_Polynesia,PF,0,0,279285,Oceania,596,0
2020-09-05,French_Polynesia,PF,36,0,279285,Oceania,632,0
2020-09-06,French_Polynesia,PF,62,0,279285,Oceania,694,0
2020-09-07,French_Polynesia,PF,0,0,279285,Oceania,694,0
2020-09-08,French_Polynesia,PF,17,0,279285,Oceania,711,0
2020-09-09,French_Polynesia,PF,0,0,279285,Oceania,711,0
2020-09-10,French_Polynesia,PF,84,0,279285,Oceania,795,0
2020-09-11,French_Polynesia,PF,0,0,279285,Oceania,795,0
2020-09-12,French_Polynesia,PF,96,2,279285,Oceania,891,2
2020-09-13,French_Polynesia,PF,0,0,279285,Oceania,891,2
2020-09-14,French_Polynesia,PF,0,0,279285,Oceania,891,2
2020-09-15,French_Polynesia,PF,146,0,279285,Oceania,1037,2
2020-09-16,French_Polynesia,PF,72,0,279285,Oceania,1109,2
2020-09-17,French_Polynesia,PF,26,0,279285,Oceania,1135,2
2020-09-18,French_Polynesia,PF,55,0,279285,Oceania,1190,2
2020-09-19,French_Polynesia,PF,19,0,279285,Oceania,1209,2
2020-09-20,French_Polynesia,PF,62,0,279285,Oceania,1271,2
2020-09-21,French_Polynesia,PF,47,0,279285,Oceania,1318,2
2020-09-22,French_Polynesia,PF,14,0,279285,Oceania,1332,2
2020-09-23,French_Polynesia,PF,0,3,279285,Oceania,1332,5
2020-09-24,French_Polynesia,PF,0,0,279285,Oceania,1332,5
2020-09-25,French_Polynesia,PF,0,0,279285,Oceania,1332,5
2020-09-26,French_Polynesia,PF,0,0,279285,Oceania,1332,5
2020-09-27,French_Polynesia,PF,0,0,279285,Oceania,1332,5
2020-09-28,French_Polynesia,PF,0,0,279285,Oceania,1332,5
2020-09-29,French_Polynesia,PF,334,2,279285,Oceania,1666,7
2020-09-30,French_Polynesia,PF,0,0,279285,Oceania,1666,7
2020-10-01,French_Polynesia,PF,0,0,279285,Oceania,1666,7
2020-10-02,French_Polynesia,PF,124,0,279285,Oceania,1790,7
2020-10-03,French_Polynesia,PF,174,1,279285,Oceania,1964,8
2020-10-04,French_Polynesia,PF,0,0,279285,Oceania,1964,8
2020-10-05,French_Polynesia,PF,0,0,279285,Oceania,1964,8
2020-10-06,French_Polynesia,PF,264,1,279285,Oceania,2228,9
2020-10-07,French_Polynesia,PF,0,0,279285,Oceania,2228,9
2020-10-08,French_Polynesia,PF,62,0,279285,Oceania,2290,9
2020-10-09,French_Polynesia,PF,0,0,279285,Oceania,2290,9
2020-10-10,French_Polynesia,PF,402,1,279285,Oceania,2692,10
2020-10-11,French_Polynesia,PF,0,0,279285,Oceania,2692,10
2020-10-12,French_Polynesia,PF,0,0,279285,Oceania,2692,10
2020-10-13,French_Polynesia,PF,497,1,279285,Oceania,3189,11
2020-10-14,French_Polynesia,PF,0,0,279285,Oceania,3189,11
2020-10-15,French_Polynesia,PF,322,2,279285,Oceania,3511,13
2020-10-16,French_Polynesia,PF,62,0,279285,Oceania,3573,13
2020-10-17,French_Polynesia,PF,162,1,279285,Oceania,3735,14
2020-10-18,French_Polynesia,PF,62,0,279285,Oceania,3797,14
2020-10-19,French_Polynesia,PF,0,0,279285,Oceania,3797,14
2020-10-20,French_Polynesia,PF,0,0,279285,Oceania,3797,14
2020-10-21,French_Polynesia,PF,751,2,279285,Oceania,4548,16
2020-10-22,French_Polynesia,PF,62,0,279285,Oceania,4610,16
2020-10-23,French_Polynesia,PF,489,3,279285,Oceania,5099,19
2020-10-24,French_Polynesia,PF,698,1,279285,Oceania,5797,20
2020-10-25,French_Polynesia,PF,0,0,279285,Oceania,5797,20
2020-10-26,French_Polynesia,PF,0,0,279285,Oceania,5797,20
2020-10-27,French_Polynesia,PF,62,0,279285,Oceania,5859,20
2020-10-28,French_Polynesia,PF,634,6,279285,Oceania,6493,26
2020-10-29,French_Polynesia,PF,0,0,279285,Oceania,6493,26
2020-10-30,French_Polynesia,PF,769,3,279285,Oceania,7262,29
2020-10-31,French_Polynesia,PF,0,0,279285,Oceania,7262,29
2020-11-01,French_Polynesia,PF,0,0,279285,Oceania,7262,29
2020-11-02,French_Polynesia,PF,0,0,279285,Oceania,7262,29
2020-11-03,French_Polynesia,PF,0,0,279285,Oceania,7262,29
2020-11-04,French_Polynesia,PF,1384,9,279285,Oceania,8646,38
2020-11-05,French_Polynesia,PF,303,0,279285,Oceania,8949,38
2020-11-06,French_Polynesia,PF,338,1,279285,Oceania,9287,39
2020-11-07,French_Polynesia,PF,467,0,279285,Oceania,9754,39
2020-11-08,French_Polynesia,PF,241,0,279285,Oceania,9995,39
2020-11-09,French_Polynesia,PF,0,0,279285,Oceania,9995,39
2020-11-10,French_Polynesia,PF,0,0,279285,Oceania,9995,39
2020-11-11,French_Polynesia,PF,685,10,279285,Oceania,10680,49
2020-11-12,French_Polynesia,PF,291,3,279285,Oceania,10971,52
2020-11-13,French_Polynesia,PF,345,0,279285,Oceania,11316,52
2020-11-14,French_Polynesia,PF,169,0,279285,Oceania,11485,52
2020-11-15,French_Polynesia,PF,221,1,279285,Oceania,11706,53
2020-11-16,French_Polynesia,PF,0,0,279285,Oceania,11706,53
2020-11-17,French_Polynesia,PF,0,0,279285,Oceania,11706,53
2020-11-18,French_Polynesia,PF,415,3,279285,Oceania,12121,56
2020-11-19,French_Polynesia,PF,466,6,279285,Oceania,12587,62
2020-11-20,French_Polynesia,PF,0,0,279285,Oceania,12587,62
2020-11-21,French_Polynesia,PF,229,0,279285,Oceania,12816,62
2020-11-22,French_Polynesia,PF,162,1,279285,Oceania,12978,63
2020-11-23,French_Polynesia,PF,0,0,279285,Oceania,12978,63
2020-11-24,French_Polynesia,PF,0,0,279285,Oceania,12978,63
2020-11-25,French_Polynesia,PF,308,5,279285,Oceania,13286,68
2020-11-26,French_Polynesia,PF,231,2,279285,Oceania,13517,70
2020-11-27,French_Polynesia,PF,266,0,279285,Oceania,13783,70
2020-11-28,French_Polynesia,PF,100,2,279285,Oceania,13883,72
2020-11-29,French_Polynesia,PF,213,1,279285,Oceania,14096,73
2020-11-30,French_Polynesia,PF,0,0,279285,Oceania,14096,73
2020-12-01,French_Polynesia,PF,0,0,279285,Oceania,14096,73
2020-12-02,French_Polynesia,PF,276,2,279285,Oceania,14372,75
2020-12-03,French_Polynesia,PF,187,1,279285,Oceania,14559,76
2020-12-04,French_Polynesia,PF,157,1,279285,Oceania,14716,77
2020-12-05,French_Polynesia,PF,181,1,279285,Oceania,14897,78
2020-12-06,French_Polynesia,PF,210,1,279285,Oceania,15107,79
2020-12-07,French_Polynesia,PF,0,0,279285,Oceania,15107,79
2020-12-08,French_Polynesia,PF,0,0,279285,Oceania,15107,79
2020-12-09,French_Polynesia,PF,225,7,279285,Oceania,15332,86
2020-12-10,French_Polynesia,PF,0,0,279285,Oceania,15332,86
2020-12-11,French_Polynesia,PF,203,5,279285,Oceania,15535,91
2020-12-12,French_Polynesia,PF,83,0,279285,Oceania,15618,91
2020-12-13,French_Polynesia,PF,0,0,279285,Oceania,15618,91
2020-12-14,French_Polynesia,PF,0,0,279285,Oceania,15618,91
2020-03-21,Papua_New_Guinea,PG,1,0,8776119,Oceania,1,0
2020-03-22,Papua_New_Guinea,PG,0,0,8776119,Oceania,1,0
2020-03-23,Papua_New_Guinea,PG,0,0,8776119,Oceania,1,0
2020-03-24,Papua_New_Guinea,PG,0,0,8776119,Oceania,1,0
2020-03-25,Papua_New_Guinea,PG,0,0,8776119,Oceania,1,0
2020-03-26,Papua_New_Guinea,PG,0,0,8776119,Oceania,1,0
2020-03-27,Papua_New_Guinea,PG,0,0,8776119,Oceania,1,0
2020-03-28,Papua_New_Guinea,PG,0,0,8776119,Oceania,1,0
2020-03-29,Papua_New_Guinea,PG,0,0,8776119,Oceania,1,0
2020-03-30,Papua_New_Guinea,PG,0,0,8776119,Oceania,1,0
2020-03-31,Papua_New_Guinea,PG,0,0,8776119,Oceania,1,0
2020-04-01,Papua_New_Guinea,PG,0,0,8776119,Oceania,1,0
2020-04-02,Papua_New_Guinea,PG,0,0,8776119,Oceania,1,0
2020-04-03,Papua_New_Guinea,PG,0,0,8776119,Oceania,1,0
2020-04-04,Papua_New_Guinea,PG,0,0,8776119,Oceania,1,0
2020-04-05,Papua_New_Guinea,PG,0,0,8776119,Oceania,1,0
2020-04-06,Papua_New_Guinea,PG,0,0,8776119,Oceania,1,0
2020-04-07,Papua_New_Guinea,PG,0,0,8776119,Oceania,1,0
2020-04-08,Papua_New_Guinea,PG,1,0,8776119,Oceania,2,0
2020-04-09,Papua_New_Guinea,PG,0,0,8776119,Oceania,2,0
2020-04-10,Papua_New_Guinea,PG,0,0,8776119,Oceania,2,0
2020-04-11,Papua_New_Guinea,PG,0,0,8776119,Oceania,2,0
2020-04-12,Papua_New_Guinea,PG,0,0,8776119,Oceania,2,0
2020-04-13,Papua_New_Guinea,PG,0,0,8776119,Oceania,2,0
2020-04-14,Papua_New_Guinea,PG,0,0,8776119,Oceania,2,0
2020-04-15,Papua_New_Guinea,PG,0,0,8776119,Oceania,2,0
2020-04-16,Papua_New_Guinea,PG,0,0,8776119,Oceania,2,0
2020-04-17,Papua_New_Guinea,PG,5,0,8776119,Oceania,7,0
2020-04-18,Papua_New_Guinea,PG,0,0,8776119,Oceania,7,0
2020-04-19,Papua_New_Guinea,PG,0,0,8776119,Oceania,7,0
2020-04-20,Papua_New_Guinea,PG,0,0,8776119,Oceania,7,0
2020-04-21,Papua_New_Guinea,PG,0,0,8776119,Oceania,7,0
2020-04-22,Papua_New_Guinea,PG,0,0,8776119,Oceania,7,0
2020-04-23,Papua_New_Guinea,PG,1,0,8776119,Oceania,8,0
2020-04-24,Papua_New_Guinea,PG,0,0,8776119,Oceania,8,0
2020-04-25,Papua_New_Guinea,PG,0,0,8776119,Oceania,8,0
2020-04-26,Papua_New_Guinea,PG,0,0,8776119,Oceania,8,0
2020-04-27,Papua_New_Guinea,PG,0,0,8776119,Oceania,8,0
2020-04-28,Papua_New_Guinea,PG,0,0,8776119,Oceania,8,0
2020-04-29,Papua_New_Guinea,PG,0,0,8776119,Oceania,8,0
2020-04-30,Papua_New_Guinea,PG,0,0,8776119,Oceania,8,0
2020-05-01,Papua_New_Guinea,PG,0,0,8776119,Oceania,8,0
2020-05-02,Papua_New_Guinea,PG,0,0,8776119,Oceania,8,0
2020-05-03,Papua_New_Guinea,PG,0,0,8776119,Oceania,8,0
2020-05-04,Papua_New_Guinea,PG,0,0,8776119,Oceania,8,0
2020-05-05,Papua_New_Guinea,PG,0,0,8776119,Oceania,8,0
2020-05-06,Papua_New_Guinea,PG,0,0,8776119,Oceania,8,0
2020-05-07,Papua_New_Guinea,PG,0,0,8776119,Oceania,8,0
2020-05-08,Papua_New_Guinea,PG,0,0,8776119,Oceania,8,0
2020-05-09,Papua_New_Guinea,PG,0,0,8776119,Oceania,8,0
2020-05-10,Papua_New_Guinea,PG,0,0,8776119,Oceania,8,0
2020-05-11,Papua_New_Guinea,PG,0,0,8776119,Oceania,8,0
2020-05-12,Papua_New_Guinea,PG,0,0,8776119,Oceania,8,0
2020-05-13,Papua_New_Guinea,PG,0,0,8776119,Oceania,8,0
2020-05-14,Papua_New_Guinea,PG,0,0,8776119,Oceania,8,0
2020-05-15,Papua_New_Guinea,PG,0,0,8776119,Oceania,8,0
2020-05-16,Papua_New_Guinea,PG,0,0,8776119,Oceania,8,0
2020-05-17,Papua_New_Guinea,PG,0,0,8776119,Oceania,8,0
2020-05-18,Papua_New_Guinea,PG,0,0,8776119,Oceania,8,0
2020-05-19,Papua_New_Guinea,PG,0,0,8776119,Oceania,8,0
2020-05-20,Papua_New_Guinea,PG,0,0,8776119,Oceania,8,0
2020-05-21,Papua_New_Guinea,PG,0,0,8776119,Oceania,8,0
2020-05-22,Papua_New_Guinea,PG,0,0,8776119,Oceania,8,0
2020-05-23,Papua_New_Guinea,PG,0,0,8776119,Oceania,8,0
2020-05-24,Papua_New_Guinea,PG,0,0,8776119,Oceania,8,0
2020-05-25,Papua_New_Guinea,PG,0,0,8776119,Oceania,8,0
2020-05-26,Papua_New_Guinea,PG,0,0,8776119,Oceania,8,0
2020-05-27,Papua_New_Guinea,PG,0,0,8776119,Oceania,8,0
2020-05-28,Papua_New_Guinea,PG,0,0,8776119,Oceania,8,0
2020-05-29,Papua_New_Guinea,PG,0,0,8776119,Oceania,8,0
2020-05-30,Papua_New_Guinea,PG,0,0,8776119,Oceania,8,0
2020-05-31,Papua_New_Guinea,PG,0,0,8776119,Oceania,8,0
2020-06-01,Papua_New_Guinea,PG,0,0,8776119,Oceania,8,0
2020-06-02,Papua_New_Guinea,PG,0,0,8776119,Oceania,8,0
2020-06-03,Papua_New_Guinea,PG,0,0,8776119,Oceania,8,0
2020-06-04,Papua_New_Guinea,PG,0,0,8776119,Oceania,8,0
2020-06-05,Papua_New_Guinea,PG,0,0,8776119,Oceania,8,0
2020-06-06,Papua_New_Guinea,PG,0,0,8776119,Oceania,8,0
2020-06-07,Papua_New_Guinea,PG,0,0,8776119,Oceania,8,0
2020-06-08,Papua_New_Guinea,PG,0,0,8776119,Oceania,8,0
2020-06-09,Papua_New_Guinea,PG,0,0,8776119,Oceania,8,0
2020-06-10,Papua_New_Guinea,PG,0,0,8776119,Oceania,8,0
2020-06-11,Papua_New_Guinea,PG,0,0,8776119,Oceania,8,0
2020-06-12,Papua_New_Guinea,PG,0,0,8776119,Oceania,8,0
2020-06-13,Papua_New_Guinea,PG,0,0,8776119,Oceania,8,0
2020-06-14,Papua_New_Guinea,PG,0,0,8776119,Oceania,8,0
2020-06-15,Papua_New_Guinea,PG,0,0,8776119,Oceania,8,0
2020-06-16,Papua_New_Guinea,PG,0,0,8776119,Oceania,8,0
2020-06-17,Papua_New_Guinea,PG,0,0,8776119,Oceania,8,0
2020-06-18,Papua_New_Guinea,PG,0,0,8776119,Oceania,8,0
2020-06-19,Papua_New_Guinea,PG,0,0,8776119,Oceania,8,0
2020-06-20,Papua_New_Guinea,PG,0,0,8776119,Oceania,8,0
2020-06-21,Papua_New_Guinea,PG,0,0,8776119,Oceania,8,0
2020-06-22,Papua_New_Guinea,PG,1,0,8776119,Oceania,9,0
2020-06-23,Papua_New_Guinea,PG,0,0,8776119,Oceania,9,0
2020-06-24,Papua_New_Guinea,PG,0,0,8776119,Oceania,9,0
2020-06-25,Papua_New_Guinea,PG,1,0,8776119,Oceania,10,0
2020-06-26,Papua_New_Guinea,PG,1,0,8776119,Oceania,11,0
2020-06-27,Papua_New_Guinea,PG,0,0,8776119,Oceania,11,0
2020-06-28,Papua_New_Guinea,PG,0,0,8776119,Oceania,11,0
2020-06-29,Papua_New_Guinea,PG,0,0,8776119,Oceania,11,0
2020-06-30,Papua_New_Guinea,PG,0,0,8776119,Oceania,11,0
2020-07-01,Papua_New_Guinea,PG,0,0,8776119,Oceania,11,0
2020-07-02,Papua_New_Guinea,PG,0,0,8776119,Oceania,11,0
2020-07-03,Papua_New_Guinea,PG,0,0,8776119,Oceania,11,0
2020-07-04,Papua_New_Guinea,PG,0,0,8776119,Oceania,11,0
2020-07-05,Papua_New_Guinea,PG,0,0,8776119,Oceania,11,0
2020-07-06,Papua_New_Guinea,PG,0,0,8776119,Oceania,11,0
2020-07-07,Papua_New_Guinea,PG,0,0,8776119,Oceania,11,0
2020-07-08,Papua_New_Guinea,PG,0,0,8776119,Oceania,11,0
2020-07-09,Papua_New_Guinea,PG,0,0,8776119,Oceania,11,0
2020-07-10,Papua_New_Guinea,PG,0,0,8776119,Oceania,11,0
2020-07-11,Papua_New_Guinea,PG,0,0,8776119,Oceania,11,0
2020-07-12,Papua_New_Guinea,PG,0,0,8776119,Oceania,11,0
2020-07-13,Papua_New_Guinea,PG,0,0,8776119,Oceania,11,0
2020-07-14,Papua_New_Guinea,PG,0,0,8776119,Oceania,11,0
2020-07-15,Papua_New_Guinea,PG,0,0,8776119,Oceania,11,0
2020-07-16,Papua_New_Guinea,PG,0,0,8776119,Oceania,11,0
2020-07-17,Papua_New_Guinea,PG,0,0,8776119,Oceania,11,0
2020-07-18,Papua_New_Guinea,PG,4,0,8776119,Oceania,15,0
2020-07-19,Papua_New_Guinea,PG,0,0,8776119,Oceania,15,0
2020-07-20,Papua_New_Guinea,PG,2,0,8776119,Oceania,17,0
2020-07-21,Papua_New_Guinea,PG,2,0,8776119,Oceania,19,0
2020-07-22,Papua_New_Guinea,PG,8,0,8776119,Oceania,27,0
2020-07-23,Papua_New_Guinea,PG,3,0,8776119,Oceania,30,0
2020-07-24,Papua_New_Guinea,PG,1,0,8776119,Oceania,31,0
2020-07-25,Papua_New_Guinea,PG,1,0,8776119,Oceania,32,0
2020-07-26,Papua_New_Guinea,PG,7,0,8776119,Oceania,39,0
2020-07-27,Papua_New_Guinea,PG,23,0,8776119,Oceania,62,0
2020-07-28,Papua_New_Guinea,PG,0,0,8776119,Oceania,62,0
2020-07-29,Papua_New_Guinea,PG,1,1,8776119,Oceania,63,1
2020-07-30,Papua_New_Guinea,PG,0,1,8776119,Oceania,63,2
2020-07-31,Papua_New_Guinea,PG,9,0,8776119,Oceania,72,2
2020-08-01,Papua_New_Guinea,PG,0,0,8776119,Oceania,72,2
2020-08-02,Papua_New_Guinea,PG,19,0,8776119,Oceania,91,2
2020-08-03,Papua_New_Guinea,PG,19,0,8776119,Oceania,110,2
2020-08-04,Papua_New_Guinea,PG,1,0,8776119,Oceania,111,2
2020-08-05,Papua_New_Guinea,PG,3,0,8776119,Oceania,114,2
2020-08-06,Papua_New_Guinea,PG,39,0,8776119,Oceania,153,2
2020-08-07,Papua_New_Guinea,PG,10,1,8776119,Oceania,163,3
2020-08-08,Papua_New_Guinea,PG,25,0,8776119,Oceania,188,3
2020-08-09,Papua_New_Guinea,PG,0,0,8776119,Oceania,188,3
2020-08-10,Papua_New_Guinea,PG,26,0,8776119,Oceania,214,3
2020-08-11,Papua_New_Guinea,PG,0,0,8776119,Oceania,214,3
2020-08-12,Papua_New_Guinea,PG,0,0,8776119,Oceania,214,3
2020-08-13,Papua_New_Guinea,PG,55,0,8776119,Oceania,269,3
2020-08-14,Papua_New_Guinea,PG,2,0,8776119,Oceania,271,3
2020-08-15,Papua_New_Guinea,PG,0,0,8776119,Oceania,271,3
2020-08-16,Papua_New_Guinea,PG,0,0,8776119,Oceania,271,3
2020-08-17,Papua_New_Guinea,PG,52,0,8776119,Oceania,323,3
2020-08-18,Papua_New_Guinea,PG,10,0,8776119,Oceania,333,3
2020-08-19,Papua_New_Guinea,PG,14,0,8776119,Oceania,347,3
2020-08-20,Papua_New_Guinea,PG,12,0,8776119,Oceania,359,3
2020-08-21,Papua_New_Guinea,PG,2,1,8776119,Oceania,361,4
2020-08-22,Papua_New_Guinea,PG,0,0,8776119,Oceania,361,4
2020-08-23,Papua_New_Guinea,PG,0,0,8776119,Oceania,361,4
2020-08-24,Papua_New_Guinea,PG,40,0,8776119,Oceania,401,4
2020-08-25,Papua_New_Guinea,PG,0,0,8776119,Oceania,401,4
2020-08-26,Papua_New_Guinea,PG,18,0,8776119,Oceania,419,4
2020-08-27,Papua_New_Guinea,PG,0,0,8776119,Oceania,419,4
2020-08-28,Papua_New_Guinea,PG,5,0,8776119,Oceania,424,4
2020-08-29,Papua_New_Guinea,PG,29,1,8776119,Oceania,453,5
2020-08-30,Papua_New_Guinea,PG,6,0,8776119,Oceania,459,5
2020-08-31,Papua_New_Guinea,PG,0,0,8776119,Oceania,459,5
2020-09-01,Papua_New_Guinea,PG,0,0,8776119,Oceania,459,5
2020-09-02,Papua_New_Guinea,PG,1,0,8776119,Oceania,460,5
2020-09-03,Papua_New_Guinea,PG,11,0,8776119,Oceania,471,5
2020-09-04,Papua_New_Guinea,PG,0,0,8776119,Oceania,471,5
2020-09-05,Papua_New_Guinea,PG,0,0,8776119,Oceania,471,5
2020-09-06,Papua_New_Guinea,PG,17,0,8776119,Oceania,488,5
2020-09-07,Papua_New_Guinea,PG,9,0,8776119,Oceania,497,5
2020-09-08,Papua_New_Guinea,PG,0,0,8776119,Oceania,497,5
2020-09-09,Papua_New_Guinea,PG,6,0,8776119,Oceania,503,5
2020-09-10,Papua_New_Guinea,PG,1,0,8776119,Oceania,504,5
2020-09-11,Papua_New_Guinea,PG,3,0,8776119,Oceania,507,5
2020-09-12,Papua_New_Guinea,PG,0,0,8776119,Oceania,507,5
2020-09-13,Papua_New_Guinea,PG,3,1,8776119,Oceania,510,6
2020-09-14,Papua_New_Guinea,PG,1,0,8776119,Oceania,511,6
2020-09-15,Papua_New_Guinea,PG,0,0,8776119,Oceania,511,6
2020-09-16,Papua_New_Guinea,PG,0,0,8776119,Oceania,511,6
2020-09-17,Papua_New_Guinea,PG,5,0,8776119,Oceania,516,6
2020-09-18,Papua_New_Guinea,PG,0,0,8776119,Oceania,516,6
2020-09-19,Papua_New_Guinea,PG,0,0,8776119,Oceania,516,6
2020-09-20,Papua_New_Guinea,PG,0,0,8776119,Oceania,516,6
2020-09-21,Papua_New_Guinea,PG,1,1,8776119,Oceania,517,7
2020-09-22,Papua_New_Guinea,PG,9,0,8776119,Oceania,526,7
2020-09-23,Papua_New_Guinea,PG,1,0,8776119,Oceania,527,7
2020-09-24,Papua_New_Guinea,PG,4,0,8776119,Oceania,531,7
2020-09-25,Papua_New_Guinea,PG,0,0,8776119,Oceania,531,7
2020-09-26,Papua_New_Guinea,PG,1,0,8776119,Oceania,532,7
2020-09-27,Papua_New_Guinea,PG,0,0,8776119,Oceania,532,7
2020-09-28,Papua_New_Guinea,PG,0,0,8776119,Oceania,532,7
2020-09-29,Papua_New_Guinea,PG,0,0,8776119,Oceania,532,7
2020-09-30,Papua_New_Guinea,PG,2,0,8776119,Oceania,534,7
2020-10-01,Papua_New_Guinea,PG,0,0,8776119,Oceania,534,7
2020-10-02,Papua_New_Guinea,PG,5,0,8776119,Oceania,539,7
2020-10-03,Papua_New_Guinea,PG,0,0,8776119,Oceania,539,7
2020-10-04,Papua_New_Guinea,PG,1,0,8776119,Oceania,540,7
2020-10-05,Papua_New_Guinea,PG,0,0,8776119,Oceania,540,7
2020-10-06,Papua_New_Guinea,PG,1,0,8776119,Oceania,541,7
2020-10-07,Papua_New_Guinea,PG,0,0,8776119,Oceania,541,7
2020-10-08,Papua_New_Guinea,PG,0,0,8776119,Oceania,541,7
2020-10-09,Papua_New_Guinea,PG,8,0,8776119,Oceania,549,7
2020-10-10,Papua_New_Guinea,PG,0,0,8776119,Oceania,549,7
2020-10-11,Papua_New_Guinea,PG,0,0,8776119,Oceania,549,7
2020-10-12,Papua_New_Guinea,PG,5,0,8776119,Oceania,554,7
2020-10-13,Papua_New_Guinea,PG,11,0,8776119,Oceania,565,7
2020-10-14,Papua_New_Guinea,PG,10,0,8776119,Oceania,575,7
2020-10-15,Papua_New_Guinea,PG,3,0,8776119,Oceania,578,7
2020-10-16,Papua_New_Guinea,PG,0,0,8776119,Oceania,578,7
2020-10-17,Papua_New_Guinea,PG,0,0,8776119,Oceania,578,7
2020-10-18,Papua_New_Guinea,PG,3,0,8776119,Oceania,581,7
2020-10-19,Papua_New_Guinea,PG,0,0,8776119,Oceania,581,7
2020-10-20,Papua_New_Guinea,PG,0,0,8776119,Oceania,581,7
2020-10-21,Papua_New_Guinea,PG,0,0,8776119,Oceania,581,7
2020-10-22,Papua_New_Guinea,PG,2,0,8776119,Oceania,583,7
2020-10-23,Papua_New_Guinea,PG,0,0,8776119,Oceania,583,7
2020-10-24,Papua_New_Guinea,PG,0,0,8776119,Oceania,583,7
2020-10-25,Papua_New_Guinea,PG,0,0,8776119,Oceania,583,7
2020-10-26,Papua_New_Guinea,PG,5,0,8776119,Oceania,588,7
2020-10-27,Papua_New_Guinea,PG,0,0,8776119,Oceania,588,7
2020-10-28,Papua_New_Guinea,PG,0,0,8776119,Oceania,588,7
2020-10-29,Papua_New_Guinea,PG,0,0,8776119,Oceania,588,7
2020-10-30,Papua_New_Guinea,PG,1,0,8776119,Oceania,589,7
2020-10-31,Papua_New_Guinea,PG,0,0,8776119,Oceania,589,7
2020-11-01,Papua_New_Guinea,PG,0,0,8776119,Oceania,589,7
2020-11-02,Papua_New_Guinea,PG,1,0,8776119,Oceania,590,7
2020-11-03,Papua_New_Guinea,PG,0,0,8776119,Oceania,590,7
2020-11-04,Papua_New_Guinea,PG,7,0,8776119,Oceania,597,7
2020-11-05,Papua_New_Guinea,PG,0,0,8776119,Oceania,597,7
2020-11-06,Papua_New_Guinea,PG,0,0,8776119,Oceania,597,7
2020-11-07,Papua_New_Guinea,PG,0,0,8776119,Oceania,597,7
2020-11-08,Papua_New_Guinea,PG,0,0,8776119,Oceania,597,7
2020-11-09,Papua_New_Guinea,PG,0,0,8776119,Oceania,597,7
2020-11-10,Papua_New_Guinea,PG,2,0,8776119,Oceania,599,7
2020-11-11,Papua_New_Guinea,PG,0,0,8776119,Oceania,599,7
2020-11-12,Papua_New_Guinea,PG,0,0,8776119,Oceania,599,7
2020-11-13,Papua_New_Guinea,PG,0,0,8776119,Oceania,599,7
2020-11-14,Papua_New_Guinea,PG,1,0,8776119,Oceania,600,7
2020-11-15,Papua_New_Guinea,PG,0,0,8776119,Oceania,600,7
2020-11-16,Papua_New_Guinea,PG,0,0,8776119,Oceania,600,7
2020-11-17,Papua_New_Guinea,PG,2,0,8776119,Oceania,602,7
2020-11-18,Papua_New_Guinea,PG,0,0,8776119,Oceania,602,7
2020-11-19,Papua_New_Guinea,PG,2,0,8776119,Oceania,604,7
2020-11-20,Papua_New_Guinea,PG,0,0,8776119,Oceania,604,7
2020-11-21,Papua_New_Guinea,PG,0,0,8776119,Oceania,604,7
2020-11-22,Papua_New_Guinea,PG,0,0,8776119,Oceania,604,7
2020-11-23,Papua_New_Guinea,PG,0,0,8776119,Oceania,604,7
2020-11-24,Papua_New_Guinea,PG,0,0,8776119,Oceania,604,7
2020-11-25,Papua_New_Guinea,PG,8,0,8776119,Oceania,612,7
2020-11-26,Papua_New_Guinea,PG,18,0,8776119,Oceania,630,7
2020-11-27,Papua_New_Guinea,PG,15,0,8776119,Oceania,645,7
2020-11-28,Papua_New_Guinea,PG,0,0,8776119,Oceania,645,7
2020-11-29,Papua_New_Guinea,PG,0,0,8776119,Oceania,645,7
2020-11-30,Papua_New_Guinea,PG,10,0,8776119,Oceania,655,7
2020-12-01,Papua_New_Guinea,PG,0,0,8776119,Oceania,655,7
2020-12-02,Papua_New_Guinea,PG,14,0,8776119,Oceania,669,7
2020-12-03,Papua_New_Guinea,PG,0,0,8776119,Oceania,669,7
2020-12-04,Papua_New_Guinea,PG,0,0,8776119,Oceania,669,7
2020-12-05,Papua_New_Guinea,PG,2,0,8776119,Oceania,671,7
2020-12-06,Papua_New_Guinea,PG,0,0,8776119,Oceania,671,7
2020-12-07,Papua_New_Guinea,PG,0,0,8776119,Oceania,671,7
2020-12-08,Papua_New_Guinea,PG,0,0,8776119,Oceania,671,7
2020-12-09,Papua_New_Guinea,PG,13,0,8776119,Oceania,684,7
2020-12-10,Papua_New_Guinea,PG,0,0,8776119,Oceania,684,7
2020-12-11,Papua_New_Guinea,PG,0,0,8776119,Oceania,684,7
2020-12-12,Papua_New_Guinea,PG,36,1,8776119,Oceania,720,8
2020-12-13,Papua_New_Guinea,PG,0,0,8776119,Oceania,720,8
2020-12-14,Papua_New_Guinea,PG,5,0,8776119,Oceania,725,8
2019-12-31,Philippines,PH,0,0,108116622,Asia,0,0
2020-01-01,Philippines,PH,0,0,108116622,Asia,0,0
2020-01-02,Philippines,PH,0,0,108116622,Asia,0,0
2020-01-03,Philippines,PH,0,0,108116622,Asia,0,0
2020-01-04,Philippines,PH,0,0,108116622,Asia,0,0
2020-01-05,Philippines,PH,0,0,108116622,Asia,0,0
2020-01-06,Philippines,PH,0,0,108116622,Asia,0,0
2020-01-07,Philippines,PH,0,0,108116622,Asia,0,0
2020-01-08,Philippines,PH,0,0,108116622,Asia,0,0
2020-01-09,Philippines,PH,0,0,108116622,Asia,0,0
2020-01-10,Philippines,PH,0,0,108116622,Asia,0,0
2020-01-11,Philippines,PH,0,0,108116622,Asia,0,0
2020-01-12,Philippines,PH,0,0,108116622,Asia,0,0
2020-01-13,Philippines,PH,0,0,108116622,Asia,0,0
2020-01-14,Philippines,PH,0,0,108116622,Asia,0,0
2020-01-15,Philippines,PH,0,0,108116622,Asia,0,0
2020-01-16,Philippines,PH,0,0,108116622,Asia,0,0
2020-01-17,Philippines,PH,0,0,108116622,Asia,0,0
2020-01-18,Philippines,PH,0,0,108116622,Asia,0,0
2020-01-19,Philippines,PH,0,0,108116622,Asia,0,0
2020-01-20,Philippines,PH,0,0,108116622,Asia,0,0
2020-01-21,Philippines,PH,0,0,108116622,Asia,0,0
2020-01-22,Philippines,PH,0,0,108116622,Asia,0,0
2020-01-23,Philippines,PH,0,0,108116622,Asia,0,0
2020-01-24,Philippines,PH,0,0,108116622,Asia,0,0
2020-01-25,Philippines,PH,0,0,108116622,Asia,0,0
2020-01-26,Philippines,PH,0,0,108116622,Asia,0,0
2020-01-27,Philippines,PH,0,0,108116622,Asia,0,0
2020-01-28,Philippines,PH,0,0,108116622,Asia,0,0
2020-01-29,Philippines,PH,0,0,108116622,Asia,0,0
2020-01-30,Philippines,PH,1,0,108116622,Asia,1,0
2020-01-31,Philippines,PH,0,0,108116622,Asia,1,0
2020-02-01,Philippines,PH,0,0,108116622,Asia,1,0
2020-02-02,Philippines,PH,1,1,108116622,Asia,2,1
2020-02-03,Philippines,PH,0,0,108116622,Asia,2,1
2020-02-04,Philippines,PH,0,0,108116622,Asia,2,1
2020-02-05,Philippines,PH,0,0,108116622,Asia,2,1
2020-02-06,Philippines,PH,1,0,108116622,Asia,3,1
2020-02-07,Philippines,PH,0,0,108116622,Asia,3,1
2020-02-08,Philippines,PH,0,0,108116622,Asia,3,1
2020-02-09,Philippines,PH,0,0,108116622,Asia,3,1
2020-02-10,Philippines,PH,0,0,108116622,Asia,3,1
2020-02-11,Philippines,PH,0,0,108116622,Asia,3,1
2020-02-12,Philippines,PH,0,0,108116622,Asia,3,1
2020-02-13,Philippines,PH,0,0,108116622,Asia,3,1
2020-02-14,Philippines,PH,0,0,108116622,Asia,3,1
2020-02-15,Philippines,PH,0,0,108116622,Asia,3,1
2020-02-16,Philippines,PH,0,0,108116622,Asia,3,1
2020-02-17,Philippines,PH,0,0,108116622,Asia,3,1
2020-02-18,Philippines,PH,0,0,108116622,Asia,3,1
2020-02-19,Philippines,PH,0,0,108116622,Asia,3,1
2020-02-20,Philippines,PH,0,0,108116622,Asia,3,1
2020-02-21,Philippines,PH,0,0,108116622,Asia,3,1
2020-02-22,Philippines,PH,0,0,108116622,Asia,3,1
2020-02-23,Philippines,PH,0,0,108116622,Asia,3,1
2020-02-24,Philippines,PH,0,0,108116622,Asia,3,1
2020-02-25,Philippines,PH,0,0,108116622,Asia,3,1
2020-02-26,Philippines,PH,0,0,108116622,Asia,3,1
2020-02-27,Philippines,PH,0,0,108116622,Asia,3,1
2020-02-28,Philippines,PH,0,0,108116622,Asia,3,1
2020-02-29,Philippines,PH,0,0,108116622,Asia,3,1
2020-03-01,Philippines,PH,0,0,108116622,Asia,3,1
2020-03-02,Philippines,PH,0,0,108116622,Asia,3,1
2020-03-07,Philippines,PH,2,0,108116622,Asia,5,1
2020-03-08,Philippines,PH,1,0,108116622,Asia,6,1
2020-03-09,Philippines,PH,4,0,108116622,Asia,10,1
2020-03-10,Philippines,PH,23,0,108116622,Asia,33,1
2020-03-11,Philippines,PH,0,0,108116622,Asia,33,1
2020-03-12,Philippines,PH,16,1,108116622,Asia,49,2
2020-03-13,Philippines,PH,3,0,108116622,Asia,52,2
2020-03-14,Philippines,PH,12,4,108116622,Asia,64,6
2020-03-15,Philippines,PH,47,0,108116622,Asia,111,6
2020-03-16,Philippines,PH,29,6,108116622,Asia,140,12
2020-03-17,Philippines,PH,2,0,108116622,Asia,142,12
2020-03-18,Philippines,PH,45,2,108116622,Asia,187,14
2020-03-19,Philippines,PH,15,3,108116622,Asia,202,17
2020-03-20,Philippines,PH,28,1,108116622,Asia,230,18
2020-03-21,Philippines,PH,0,0,108116622,Asia,230,18
2020-03-22,Philippines,PH,150,7,108116622,Asia,380,25
2020-03-23,Philippines,PH,0,0,108116622,Asia,380,25
2020-03-24,Philippines,PH,82,8,108116622,Asia,462,33
2020-03-25,Philippines,PH,90,2,108116622,Asia,552,35
2020-03-26,Philippines,PH,84,3,108116622,Asia,636,38
2020-03-27,Philippines,PH,71,7,108116622,Asia,707,45
2020-03-28,Philippines,PH,96,9,108116622,Asia,803,54
2020-03-29,Philippines,PH,272,14,108116622,Asia,1075,68
2020-03-30,Philippines,PH,343,3,108116622,Asia,1418,71
2020-03-31,Philippines,PH,666,17,108116622,Asia,2084,88
2020-04-01,Philippines,PH,0,0,108116622,Asia,2084,88
2020-04-02,Philippines,PH,227,8,108116622,Asia,2311,96
2020-04-03,Philippines,PH,322,11,108116622,Asia,2633,107
2020-04-04,Philippines,PH,385,29,108116622,Asia,3018,136
2020-04-05,Philippines,PH,76,8,108116622,Asia,3094,144
2020-04-06,Philippines,PH,152,8,108116622,Asia,3246,152
2020-04-07,Philippines,PH,414,11,108116622,Asia,3660,163
2020-04-08,Philippines,PH,104,14,108116622,Asia,3764,177
2020-04-09,Philippines,PH,106,5,108116622,Asia,3870,182
2020-04-10,Philippines,PH,206,21,108116622,Asia,4076,203
2020-04-11,Philippines,PH,0,0,108116622,Asia,4076,203
2020-04-12,Philippines,PH,352,44,108116622,Asia,4428,247
2020-04-13,Philippines,PH,220,50,108116622,Asia,4648,297
2020-04-14,Philippines,PH,284,18,108116622,Asia,4932,315
2020-04-15,Philippines,PH,291,20,108116622,Asia,5223,335
2020-04-16,Philippines,PH,230,14,108116622,Asia,5453,349
2020-04-17,Philippines,PH,207,13,108116622,Asia,5660,362
2020-04-18,Philippines,PH,218,25,108116622,Asia,5878,387
2020-04-19,Philippines,PH,209,10,108116622,Asia,6087,397
2020-04-20,Philippines,PH,172,12,108116622,Asia,6259,409
2020-04-21,Philippines,PH,200,19,108116622,Asia,6459,428
2020-04-22,Philippines,PH,140,9,108116622,Asia,6599,437
2020-04-23,Philippines,PH,111,9,108116622,Asia,6710,446
2020-04-24,Philippines,PH,271,16,108116622,Asia,6981,462
2020-04-25,Philippines,PH,211,15,108116622,Asia,7192,477
2020-04-26,Philippines,PH,102,17,108116622,Asia,7294,494
2020-04-27,Philippines,PH,285,7,108116622,Asia,7579,501
2020-04-28,Philippines,PH,198,10,108116622,Asia,7777,511
2020-04-29,Philippines,PH,181,19,108116622,Asia,7958,530
2020-04-30,Philippines,PH,254,28,108116622,Asia,8212,558
2020-05-01,Philippines,PH,276,10,108116622,Asia,8488,568
2020-05-02,Philippines,PH,284,11,108116622,Asia,8772,579
2020-05-03,Philippines,PH,156,24,108116622,Asia,8928,603
2020-05-04,Philippines,PH,295,4,108116622,Asia,9223,607
2020-05-05,Philippines,PH,262,16,108116622,Asia,9485,623
2020-05-06,Philippines,PH,199,14,108116622,Asia,9684,637
2020-05-07,Philippines,PH,320,21,108116622,Asia,10004,658
2020-05-08,Philippines,PH,339,27,108116622,Asia,10343,685
2020-05-09,Philippines,PH,120,11,108116622,Asia,10463,696
2020-05-10,Philippines,PH,147,8,108116622,Asia,10610,704
2020-05-11,Philippines,PH,184,15,108116622,Asia,10794,719
2020-05-12,Philippines,PH,292,7,108116622,Asia,11086,726
2020-05-13,Philippines,PH,264,25,108116622,Asia,11350,751
2020-05-14,Philippines,PH,268,21,108116622,Asia,11618,772
2020-05-15,Philippines,PH,258,18,108116622,Asia,11876,790
2020-05-16,Philippines,PH,215,16,108116622,Asia,12091,806
2020-05-17,Philippines,PH,214,11,108116622,Asia,12305,817
2020-05-18,Philippines,PH,208,7,108116622,Asia,12513,824
2020-05-19,Philippines,PH,205,7,108116622,Asia,12718,831
2020-05-20,Philippines,PH,224,6,108116622,Asia,12942,837
2020-05-21,Philippines,PH,279,5,108116622,Asia,13221,842
2020-05-22,Philippines,PH,213,4,108116622,Asia,13434,846
2020-05-23,Philippines,PH,163,11,108116622,Asia,13597,857
2020-05-24,Philippines,PH,180,6,108116622,Asia,13777,863
2020-05-25,Philippines,PH,258,5,108116622,Asia,14035,868
2020-05-26,Philippines,PH,284,5,108116622,Asia,14319,873
2020-05-27,Philippines,PH,350,13,108116622,Asia,14669,886
2020-05-28,Philippines,PH,380,18,108116622,Asia,15049,904
2020-05-29,Philippines,PH,539,17,108116622,Asia,15588,921
2020-05-30,Philippines,PH,1046,21,108116622,Asia,16634,942
2020-05-31,Philippines,PH,590,8,108116622,Asia,17224,950
2020-06-01,Philippines,PH,862,7,108116622,Asia,18086,957
2020-06-02,Philippines,PH,552,3,108116622,Asia,18638,960
2020-06-03,Philippines,PH,359,6,108116622,Asia,18997,966
2020-06-04,Philippines,PH,751,8,108116622,Asia,19748,974
2020-06-05,Philippines,PH,634,10,108116622,Asia,20382,984
2020-06-06,Philippines,PH,244,3,108116622,Asia,20626,987
2020-06-07,Philippines,PH,714,7,108116622,Asia,21340,994
2020-06-08,Philippines,PH,555,9,108116622,Asia,21895,1003
2020-06-09,Philippines,PH,579,8,108116622,Asia,22474,1011
2020-06-10,Philippines,PH,518,6,108116622,Asia,22992,1017
2020-06-11,Philippines,PH,740,10,108116622,Asia,23732,1027
2020-06-12,Philippines,PH,443,9,108116622,Asia,24175,1036
2020-06-13,Philippines,PH,612,16,108116622,Asia,24787,1052
2020-06-14,Philippines,PH,605,22,108116622,Asia,25392,1074
2020-06-15,Philippines,PH,538,14,108116622,Asia,25930,1088
2020-06-16,Philippines,PH,490,10,108116622,Asia,26420,1098
2020-06-17,Philippines,PH,361,5,108116622,Asia,26781,1103
2020-06-18,Philippines,PH,457,5,108116622,Asia,27238,1108
2020-06-19,Philippines,PH,561,8,108116622,Asia,27799,1116
2020-06-20,Philippines,PH,660,14,108116622,Asia,28459,1130
2020-06-21,Philippines,PH,941,20,108116622,Asia,29400,1150
2020-06-22,Philippines,PH,652,19,108116622,Asia,30052,1169
2020-06-23,Philippines,PH,630,8,108116622,Asia,30682,1177
2020-06-24,Philippines,PH,1143,9,108116622,Asia,31825,1186
2020-06-25,Philippines,PH,470,18,108116622,Asia,32295,1204
2020-06-26,Philippines,PH,774,8,108116622,Asia,33069,1212
2020-06-27,Philippines,PH,1004,12,108116622,Asia,34073,1224
2020-06-28,Philippines,PH,730,12,108116622,Asia,34803,1236
2020-06-29,Philippines,PH,652,8,108116622,Asia,35455,1244
2020-06-30,Philippines,PH,983,11,108116622,Asia,36438,1255
2020-07-01,Philippines,PH,1076,11,108116622,Asia,37514,1266
2020-07-02,Philippines,PH,997,4,108116622,Asia,38511,1270
2020-07-03,Philippines,PH,294,4,108116622,Asia,38805,1274
2020-07-04,Philippines,PH,1531,6,108116622,Asia,40336,1280
2020-07-05,Philippines,PH,1494,10,108116622,Asia,41830,1290
2020-07-06,Philippines,PH,0,0,108116622,Asia,41830,1290
2020-07-07,Philippines,PH,4503,13,108116622,Asia,46333,1303
2020-07-08,Philippines,PH,1540,6,108116622,Asia,47873,1309
2020-07-09,Philippines,PH,2486,5,108116622,Asia,50359,1314
2020-07-10,Philippines,PH,1395,4,108116622,Asia,51754,1318
2020-07-11,Philippines,PH,1160,42,108116622,Asia,52914,1360
2020-07-12,Philippines,PH,1308,12,108116622,Asia,54222,1372
2020-07-13,Philippines,PH,2037,162,108116622,Asia,56259,1534
2020-07-14,Philippines,PH,747,65,108116622,Asia,57006,1599
2020-07-15,Philippines,PH,539,4,108116622,Asia,57545,1603
2020-07-16,Philippines,PH,1305,11,108116622,Asia,58850,1614
2020-07-17,Philippines,PH,2416,29,108116622,Asia,61266,1643
2020-07-18,Philippines,PH,1735,17,108116622,Asia,63001,1660
2020-07-19,Philippines,PH,2303,113,108116622,Asia,65304,1773
2020-07-20,Philippines,PH,2152,58,108116622,Asia,67456,1831
2020-07-21,Philippines,PH,1442,4,108116622,Asia,68898,1835
2020-07-22,Philippines,PH,1866,2,108116622,Asia,70764,1837
2020-07-23,Philippines,PH,1505,6,108116622,Asia,72269,1843
2020-07-24,Philippines,PH,2121,28,108116622,Asia,74390,1871
2020-07-25,Philippines,PH,2054,8,108116622,Asia,76444,1879
2020-07-26,Philippines,PH,1968,18,108116622,Asia,78412,1897
2020-07-27,Philippines,PH,2036,35,108116622,Asia,80448,1932
2020-07-28,Philippines,PH,1592,13,108116622,Asia,82040,1945
2020-07-29,Philippines,PH,1633,2,108116622,Asia,83673,1947
2020-07-30,Philippines,PH,1813,15,108116622,Asia,85486,1962
2020-07-31,Philippines,PH,3888,21,108116622,Asia,89374,1983
2020-08-01,Philippines,PH,3980,40,108116622,Asia,93354,2023
2020-08-02,Philippines,PH,4878,16,108116622,Asia,98232,2039
2020-08-03,Philippines,PH,4953,20,108116622,Asia,103185,2059
2020-08-04,Philippines,PH,3145,45,108116622,Asia,106330,2104
2020-08-05,Philippines,PH,6263,11,108116622,Asia,112593,2115
2020-08-06,Philippines,PH,3387,8,108116622,Asia,115980,2123
2020-08-07,Philippines,PH,3480,27,108116622,Asia,119460,2150
2020-08-08,Philippines,PH,3294,18,108116622,Asia,122754,2168
2020-08-09,Philippines,PH,4131,41,108116622,Asia,126885,2209
2020-08-10,Philippines,PH,3028,61,108116622,Asia,129913,2270
2020-08-11,Philippines,PH,6725,23,108116622,Asia,136638,2293
2020-08-12,Philippines,PH,2900,19,108116622,Asia,139538,2312
2020-08-13,Philippines,PH,4211,92,108116622,Asia,143749,2404
2020-08-14,Philippines,PH,3777,22,108116622,Asia,147526,2426
2020-08-15,Philippines,PH,6134,16,108116622,Asia,153660,2442
2020-08-16,Philippines,PH,4258,158,108116622,Asia,157918,2600
2020-08-17,Philippines,PH,3335,65,108116622,Asia,161253,2665
2020-08-18,Philippines,PH,3221,16,108116622,Asia,164474,2681
2020-08-19,Philippines,PH,4739,6,108116622,Asia,169213,2687
2020-08-20,Philippines,PH,4561,108,108116622,Asia,173774,2795
2020-08-21,Philippines,PH,4248,88,108116622,Asia,178022,2883
2020-08-22,Philippines,PH,4343,57,108116622,Asia,182365,2940
2020-08-23,Philippines,PH,4884,26,108116622,Asia,187249,2966
2020-08-24,Philippines,PH,2352,32,108116622,Asia,189601,2998
2020-08-25,Philippines,PH,4651,12,108116622,Asia,194252,3010
2020-08-26,Philippines,PH,2912,28,108116622,Asia,197164,3038
2020-08-27,Philippines,PH,5197,99,108116622,Asia,202361,3137
2020-08-28,Philippines,PH,3220,97,108116622,Asia,205581,3234
2020-08-29,Philippines,PH,3963,91,108116622,Asia,209544,3325
2020-08-30,Philippines,PH,3587,94,108116622,Asia,213131,3419
2020-08-31,Philippines,PH,4265,101,108116622,Asia,217396,3520
2020-09-01,Philippines,PH,3423,43,108116622,Asia,220819,3563
2020-09-02,Philippines,PH,3445,34,108116622,Asia,224264,3597
2020-09-03,Philippines,PH,2176,26,108116622,Asia,226440,3623
2020-09-04,Philippines,PH,1963,65,108116622,Asia,228403,3688
2020-09-05,Philippines,PH,0,0,108116622,Asia,228403,3688
2020-09-06,Philippines,PH,6167,102,108116622,Asia,234570,3790
2020-09-07,Philippines,PH,2795,85,108116622,Asia,237365,3875
2020-09-08,Philippines,PH,1362,15,108116622,Asia,238727,3890
2020-09-09,Philippines,PH,3260,26,108116622,Asia,241987,3916
2020-09-10,Philippines,PH,3156,70,108116622,Asia,245143,3986
2020-09-11,Philippines,PH,3804,80,108116622,Asia,248947,4066
2020-09-12,Philippines,PH,4017,42,108116622,Asia,252964,4108
2020-09-13,Philippines,PH,4899,184,108116622,Asia,257863,4292
2020-09-14,Philippines,PH,3353,79,108116622,Asia,261216,4371
2020-09-15,Philippines,PH,4672,259,108116622,Asia,265888,4630
2020-09-16,Philippines,PH,3519,33,108116622,Asia,269407,4663
2020-09-17,Philippines,PH,3527,69,108116622,Asia,272934,4732
2020-09-18,Philippines,PH,3355,53,108116622,Asia,276289,4785
2020-09-19,Philippines,PH,3237,45,108116622,Asia,279526,4830
2020-09-20,Philippines,PH,3934,100,108116622,Asia,283460,4930
2020-09-21,Philippines,PH,3283,54,108116622,Asia,286743,4984
2020-09-22,Philippines,PH,3447,15,108116622,Asia,290190,4999
2020-09-23,Philippines,PH,1599,50,108116622,Asia,291789,5049
2020-09-24,Philippines,PH,2802,42,108116622,Asia,294591,5091
2020-09-25,Philippines,PH,2164,36,108116622,Asia,296755,5127
2020-09-26,Philippines,PH,2606,69,108116622,Asia,299361,5196
2020-09-27,Philippines,PH,1895,88,108116622,Asia,301256,5284
2020-09-28,Philippines,PH,2970,60,108116622,Asia,304226,5344
2020-09-29,Philippines,PH,3062,37,108116622,Asia,307288,5381
2020-09-30,Philippines,PH,2015,67,108116622,Asia,309303,5448
2020-10-01,Philippines,PH,0,0,108116622,Asia,309303,5448
2020-10-02,Philippines,PH,4776,114,108116622,Asia,314079,5562
2020-10-03,Philippines,PH,2599,54,108116622,Asia,316678,5616
2020-10-04,Philippines,PH,2652,62,108116622,Asia,319330,5678
2020-10-05,Philippines,PH,3167,98,108116622,Asia,322497,5776
2020-10-06,Philippines,PH,2265,64,108116622,Asia,324762,5840
2020-10-07,Philippines,PH,2071,25,108116622,Asia,326833,5865
2020-10-08,Philippines,PH,2804,60,108116622,Asia,329637,5925
2020-10-09,Philippines,PH,2232,144,108116622,Asia,331869,6069
2020-10-10,Philippines,PH,2901,83,108116622,Asia,334770,6152
2020-10-11,Philippines,PH,2156,86,108116622,Asia,336926,6238
2020-10-12,Philippines,PH,2415,83,108116622,Asia,339341,6321
2020-10-13,Philippines,PH,3475,11,108116622,Asia,342816,6332
2020-10-14,Philippines,PH,1897,40,108116622,Asia,344713,6372
2020-10-15,Philippines,PH,1823,77,108116622,Asia,346536,6449
2020-10-16,Philippines,PH,2162,48,108116622,Asia,348698,6497
2020-10-17,Philippines,PH,3052,34,108116622,Asia,351750,6531
2020-10-18,Philippines,PH,2588,72,108116622,Asia,354338,6603
2020-10-19,Philippines,PH,2280,49,108116622,Asia,356618,6652
2020-10-20,Philippines,PH,2551,23,108116622,Asia,359169,6675
2020-10-21,Philippines,PH,1606,15,108116622,Asia,360775,6690
2020-10-22,Philippines,PH,1468,57,108116622,Asia,362243,6747
2020-10-23,Philippines,PH,1645,36,108116622,Asia,363888,6783
2020-10-24,Philippines,PH,1911,132,108116622,Asia,365799,6915
2020-10-25,Philippines,PH,2020,19,108116622,Asia,367819,6934
2020-10-26,Philippines,PH,2209,43,108116622,Asia,370028,6977
2020-10-27,Philippines,PH,1602,62,108116622,Asia,371630,7039
2020-10-28,Philippines,PH,1514,14,108116622,Asia,373144,7053
2020-10-29,Philippines,PH,2036,61,108116622,Asia,375180,7114
2020-10-30,Philippines,PH,1755,33,108116622,Asia,376935,7147
2020-10-31,Philippines,PH,1998,38,108116622,Asia,378933,7185
2020-11-01,Philippines,PH,1796,36,108116622,Asia,380729,7221
2020-11-02,Philippines,PH,2384,17,108116622,Asia,383113,7238
2020-11-03,Philippines,PH,2287,31,108116622,Asia,385400,7269
2020-11-04,Philippines,PH,1761,49,108116622,Asia,387161,7318
2020-11-05,Philippines,PH,976,49,108116622,Asia,388137,7367
2020-11-06,Philippines,PH,1588,42,108116622,Asia,389725,7409
2020-11-07,Philippines,PH,2084,52,108116622,Asia,391809,7461
2020-11-08,Philippines,PH,2152,24,108116622,Asia,393961,7485
2020-11-09,Philippines,PH,2434,54,108116622,Asia,396395,7539
2020-11-10,Philippines,PH,2054,108,108116622,Asia,398449,7647
2020-11-11,Philippines,PH,1300,14,108116622,Asia,399749,7661
2020-11-12,Philippines,PH,1667,49,108116622,Asia,401416,7710
2020-11-13,Philippines,PH,1404,11,108116622,Asia,402820,7721
2020-11-14,Philippines,PH,1893,31,108116622,Asia,404713,7752
2020-11-15,Philippines,PH,1624,39,108116622,Asia,406337,7791
2020-11-16,Philippines,PH,1501,41,108116622,Asia,407838,7832
2020-11-17,Philippines,PH,1736,7,108116622,Asia,409574,7839
2020-11-18,Philippines,PH,1144,23,108116622,Asia,410718,7862
2020-11-19,Philippines,PH,1379,95,108116622,Asia,412097,7957
2020-11-20,Philippines,PH,1333,41,108116622,Asia,413430,7998
2020-11-21,Philippines,PH,1637,27,108116622,Asia,415067,8025
2020-11-22,Philippines,PH,1785,55,108116622,Asia,416852,8080
2020-11-23,Philippines,PH,1966,43,108116622,Asia,418818,8123
2020-11-24,Philippines,PH,1796,50,108116622,Asia,420614,8173
2020-11-25,Philippines,PH,1108,12,108116622,Asia,421722,8185
2020-11-26,Philippines,PH,1193,30,108116622,Asia,422915,8215
2020-11-27,Philippines,PH,1382,27,108116622,Asia,424297,8242
2020-11-28,Philippines,PH,1621,13,108116622,Asia,425918,8255
2020-11-29,Philippines,PH,1879,78,108116622,Asia,427797,8333
2020-11-30,Philippines,PH,2067,40,108116622,Asia,429864,8373
2020-12-01,Philippines,PH,1766,19,108116622,Asia,431630,8392
2020-12-02,Philippines,PH,1295,26,108116622,Asia,432925,8418
2020-12-03,Philippines,PH,1432,18,108116622,Asia,434357,8436
2020-12-04,Philippines,PH,1056,10,108116622,Asia,435413,8446
2020-12-05,Philippines,PH,932,63,108116622,Asia,436345,8509
2020-12-06,Philippines,PH,1724,17,108116622,Asia,438069,8526
2020-12-07,Philippines,PH,1765,28,108116622,Asia,439834,8554
2020-12-08,Philippines,PH,1565,18,108116622,Asia,441399,8572
2020-12-09,Philippines,PH,1386,98,108116622,Asia,442785,8670
2020-12-10,Philippines,PH,1379,7,108116622,Asia,444164,8677
2020-12-11,Philippines,PH,1376,24,108116622,Asia,445540,8701
2020-12-12,Philippines,PH,1499,8,108116622,Asia,447039,8709
2020-12-13,Philippines,PH,1292,21,108116622,Asia,448331,8730
2020-12-14,Philippines,PH,1069,3,108116622,Asia,449400,8733
2019-12-31,Pakistan,PK,0,0,216565317,Asia,0,0
2020-01-01,Pakistan,PK,0,0,216565317,Asia,0,0
2020-01-02,Pakistan,PK,0,0,216565317,Asia,0,0
2020-01-03,Pakistan,PK,0,0,216565317,Asia,0,0
2020-01-04,Pakistan,PK,0,0,216565317,Asia,0,0
2020-01-05,Pakistan,PK,0,0,216565317,Asia,0,0
2020-01-06,Pakistan,PK,0,0,216565317,Asia,0,0
2020-01-07,Pakistan,PK,0,0,216565317,Asia,0,0
2020-01-08,Pakistan,PK,0,0,216565317,Asia,0,0
2020-01-09,Pakistan,PK,0,0,216565317,Asia,0,0
2020-01-10,Pakistan,PK,0,0,216565317,Asia,0,0
2020-01-11,Pakistan,PK,0,0,216565317,Asia,0,0
2020-01-12,Pakistan,PK,0,0,216565317,Asia,0,0
2020-01-13,Pakistan,PK,0,0,216565317,Asia,0,0
2020-01-14,Pakistan,PK,0,0,216565317,Asia,0,0
2020-01-15,Pakistan,PK,0,0,216565317,Asia,0,0
2020-01-16,Pakistan,PK,0,0,216565317,Asia,0,0
2020-01-17,Pakistan,PK,0,0,216565317,Asia,0,0
2020-01-18,Pakistan,PK,0,0,216565317,Asia,0,0
2020-01-19,Pakistan,PK,0,0,216565317,Asia,0,0
2020-01-20,Pakistan,PK,0,0,216565317,Asia,0,0
2020-01-21,Pakistan,PK,0,0,216565317,Asia,0,0
2020-01-22,Pakistan,PK,0,0,216565317,Asia,0,0
2020-01-23,Pakistan,PK,0,0,216565317,Asia,0,0
2020-01-24,Pakistan,PK,0,0,216565317,Asia,0,0
2020-01-25,Pakistan,PK,0,0,216565317,Asia,0,0
2020-01-26,Pakistan,PK,0,0,216565317,Asia,0,0
2020-01-27,Pakistan,PK,0,0,216565317,Asia,0,0
2020-01-28,Pakistan,PK,0,0,216565317,Asia,0,0
2020-01-29,Pakistan,PK,0,0,216565317,Asia,0,0
2020-01-30,Pakistan,PK,0,0,216565317,Asia,0,0
2020-01-31,Pakistan,PK,0,0,216565317,Asia,0,0
2020-02-01,Pakistan,PK,0,0,216565317,Asia,0,0
2020-02-02,Pakistan,PK,0,0,216565317,Asia,0,0
2020-02-03,Pakistan,PK,0,0,216565317,Asia,0,0
2020-02-04,Pakistan,PK,0,0,216565317,Asia,0,0
2020-02-05,Pakistan,PK,0,0,216565317,Asia,0,0
2020-02-06,Pakistan,PK,0,0,216565317,Asia,0,0
2020-02-07,Pakistan,PK,0,0,216565317,Asia,0,0
2020-02-08,Pakistan,PK,0,0,216565317,Asia,0,0
2020-02-09,Pakistan,PK,0,0,216565317,Asia,0,0
2020-02-10,Pakistan,PK,0,0,216565317,Asia,0,0
2020-02-11,Pakistan,PK,0,0,216565317,Asia,0,0
2020-02-12,Pakistan,PK,0,0,216565317,Asia,0,0
2020-02-13,Pakistan,PK,0,0,216565317,Asia,0,0
2020-02-14,Pakistan,PK,0,0,216565317,Asia,0,0
2020-02-15,Pakistan,PK,0,0,216565317,Asia,0,0
2020-02-16,Pakistan,PK,0,0,216565317,Asia,0,0
2020-02-17,Pakistan,PK,0,0,216565317,Asia,0,0
2020-02-18,Pakistan,PK,0,0,216565317,Asia,0,0
2020-02-19,Pakistan,PK,0,0,216565317,Asia,0,0
2020-02-20,Pakistan,PK,0,0,216565317,Asia,0,0
2020-02-21,Pakistan,PK,0,0,216565317,Asia,0,0
2020-02-22,Pakistan,PK,0,0,216565317,Asia,0,0
2020-02-23,Pakistan,PK,0,0,216565317,Asia,0,0
2020-02-24,Pakistan,PK,0,0,216565317,Asia,0,0
2020-02-25,Pakistan,PK,0,0,216565317,Asia,0,0
2020-02-26,Pakistan,PK,0,0,216565317,Asia,0,0
2020-02-27,Pakistan,PK,2,0,216565317,Asia,2,0
2020-02-28,Pakistan,PK,0,0,216565317,Asia,2,0
2020-02-29,Pakistan,PK,0,0,216565317,Asia,2,0
2020-03-01,Pakistan,PK,2,0,216565317,Asia,4,0
2020-03-02,Pakistan,PK,0,0,216565317,Asia,4,0
2020-03-04,Pakistan,PK,1,0,216565317,Asia,5,0
2020-03-07,Pakistan,PK,1,0,216565317,Asia,6,0
2020-03-10,Pakistan,PK,10,0,216565317,Asia,16,0
2020-03-11,Pakistan,PK,0,0,216565317,Asia,16,0
2020-03-12,Pakistan,PK,4,0,216565317,Asia,20,0
2020-03-13,Pakistan,PK,1,0,216565317,Asia,21,0
2020-03-14,Pakistan,PK,0,0,216565317,Asia,21,0
2020-03-15,Pakistan,PK,9,0,216565317,Asia,30,0
2020-03-16,Pakistan,PK,1,0,216565317,Asia,31,0
2020-03-17,Pakistan,PK,156,0,216565317,Asia,187,0
2020-03-18,Pakistan,PK,0,0,216565317,Asia,187,0
2020-03-19,Pakistan,PK,115,0,216565317,Asia,302,0
2020-03-20,Pakistan,PK,176,2,216565317,Asia,478,2
2020-03-21,Pakistan,PK,17,1,216565317,Asia,495,3
2020-03-22,Pakistan,PK,151,0,216565317,Asia,646,3
2020-03-23,Pakistan,PK,138,2,216565317,Asia,784,5
2020-03-24,Pakistan,PK,103,1,216565317,Asia,887,6
2020-03-25,Pakistan,PK,104,1,216565317,Asia,991,7
2020-03-26,Pakistan,PK,66,1,216565317,Asia,1057,8
2020-03-27,Pakistan,PK,140,1,216565317,Asia,1197,9
2020-03-28,Pakistan,PK,0,0,216565317,Asia,1197,9
2020-03-29,Pakistan,PK,211,2,216565317,Asia,1408,11
2020-03-30,Pakistan,PK,118,2,216565317,Asia,1526,13
2020-03-31,Pakistan,PK,99,5,216565317,Asia,1625,18
2020-04-01,Pakistan,PK,414,8,216565317,Asia,2039,26
2020-04-02,Pakistan,PK,252,5,216565317,Asia,2291,31
2020-04-03,Pakistan,PK,0,0,216565317,Asia,2291,31
2020-04-04,Pakistan,PK,0,0,216565317,Asia,2291,31
2020-04-05,Pakistan,PK,159,4,216565317,Asia,2450,35
2020-04-06,Pakistan,PK,827,15,216565317,Asia,3277,50
2020-04-07,Pakistan,PK,587,4,216565317,Asia,3864,54
2020-04-08,Pakistan,PK,208,4,216565317,Asia,4072,58
2020-04-09,Pakistan,PK,250,5,216565317,Asia,4322,63
2020-04-10,Pakistan,PK,279,3,216565317,Asia,4601,66
2020-04-11,Pakistan,PK,187,5,216565317,Asia,4788,71
2020-04-12,Pakistan,PK,250,15,216565317,Asia,5038,86
2020-04-13,Pakistan,PK,336,7,216565317,Asia,5374,93
2020-04-14,Pakistan,PK,342,3,216565317,Asia,5716,96
2020-04-15,Pakistan,PK,272,11,216565317,Asia,5988,107
2020-04-16,Pakistan,PK,517,17,216565317,Asia,6505,124
2020-04-17,Pakistan,PK,520,11,216565317,Asia,7025,135
2020-04-18,Pakistan,PK,456,8,216565317,Asia,7481,143
2020-04-19,Pakistan,PK,512,16,216565317,Asia,7993,159
2020-04-20,Pakistan,PK,425,17,216565317,Asia,8418,176
2020-04-21,Pakistan,PK,798,16,216565317,Asia,9216,192
2020-04-22,Pakistan,PK,533,17,216565317,Asia,9749,209
2020-04-23,Pakistan,PK,0,0,216565317,Asia,9749,209
2020-04-24,Pakistan,PK,1406,28,216565317,Asia,11155,237
2020-04-25,Pakistan,PK,785,16,216565317,Asia,11940,253
2020-04-26,Pakistan,PK,783,16,216565317,Asia,12723,269
2020-04-27,Pakistan,PK,605,12,216565317,Asia,13328,281
2020-04-28,Pakistan,PK,751,20,216565317,Asia,14079,301
2020-04-29,Pakistan,PK,806,26,216565317,Asia,14885,327
2020-04-30,Pakistan,PK,874,19,216565317,Asia,15759,346
2020-05-01,Pakistan,PK,1058,39,216565317,Asia,16817,385
2020-05-02,Pakistan,PK,1297,32,216565317,Asia,18114,417
2020-05-03,Pakistan,PK,989,23,216565317,Asia,19103,440
2020-05-04,Pakistan,PK,1083,22,216565317,Asia,20186,462
2020-05-05,Pakistan,PK,1315,24,216565317,Asia,21501,486
2020-05-06,Pakistan,PK,1049,40,216565317,Asia,22550,526
2020-05-07,Pakistan,PK,1523,38,216565317,Asia,24073,564
2020-05-08,Pakistan,PK,1764,30,216565317,Asia,25837,594
2020-05-09,Pakistan,PK,1637,24,216565317,Asia,27474,618
2020-05-10,Pakistan,PK,1991,21,216565317,Asia,29465,639
2020-05-11,Pakistan,PK,1476,28,216565317,Asia,30941,667
2020-05-12,Pakistan,PK,1140,39,216565317,Asia,32081,706
2020-05-13,Pakistan,PK,2255,31,216565317,Asia,34336,737
2020-05-14,Pakistan,PK,1452,33,216565317,Asia,35788,770
2020-05-15,Pakistan,PK,1430,33,216565317,Asia,37218,803
2020-05-16,Pakistan,PK,1581,31,216565317,Asia,38799,834
2020-05-17,Pakistan,PK,1352,39,216565317,Asia,40151,873
2020-05-18,Pakistan,PK,1974,30,216565317,Asia,42125,903
2020-05-19,Pakistan,PK,1841,36,216565317,Asia,43966,939
2020-05-20,Pakistan,PK,1932,46,216565317,Asia,45898,985
2020-05-21,Pakistan,PK,2193,32,216565317,Asia,48091,1017
2020-05-22,Pakistan,PK,2603,50,216565317,Asia,50694,1067
2020-05-23,Pakistan,PK,1743,34,216565317,Asia,52437,1101
2020-05-24,Pakistan,PK,2164,32,216565317,Asia,54601,1133
2020-05-25,Pakistan,PK,1748,34,216565317,Asia,56349,1167
2020-05-26,Pakistan,PK,1356,30,216565317,Asia,57705,1197
2020-05-27,Pakistan,PK,1446,28,216565317,Asia,59151,1225
2020-05-28,Pakistan,PK,2076,35,216565317,Asia,61227,1260
2020-05-29,Pakistan,PK,2801,57,216565317,Asia,64028,1317
2020-05-30,Pakistan,PK,2429,78,216565317,Asia,66457,1395
2020-05-31,Pakistan,PK,3039,88,216565317,Asia,69496,1483
2020-06-01,Pakistan,PK,2964,60,216565317,Asia,72460,1543
2020-06-02,Pakistan,PK,3938,78,216565317,Asia,76398,1621
2020-06-03,Pakistan,PK,4065,67,216565317,Asia,80463,1688
2020-06-04,Pakistan,PK,4801,82,216565317,Asia,85264,1770
2020-06-05,Pakistan,PK,3985,68,216565317,Asia,89249,1838
2020-06-06,Pakistan,PK,4734,97,216565317,Asia,93983,1935
2020-06-07,Pakistan,PK,4960,67,216565317,Asia,98943,2002
2020-06-08,Pakistan,PK,4728,65,216565317,Asia,103671,2067
2020-06-09,Pakistan,PK,4646,105,216565317,Asia,108317,2172
2020-06-10,Pakistan,PK,5385,83,216565317,Asia,113702,2255
2020-06-11,Pakistan,PK,5834,101,216565317,Asia,119536,2356
2020-06-12,Pakistan,PK,6397,107,216565317,Asia,125933,2463
2020-06-13,Pakistan,PK,6472,88,216565317,Asia,132405,2551
2020-06-14,Pakistan,PK,6825,81,216565317,Asia,139230,2632
2020-06-15,Pakistan,PK,5248,97,216565317,Asia,144478,2729
2020-06-16,Pakistan,PK,4443,110,216565317,Asia,148921,2839
2020-06-17,Pakistan,PK,5839,136,216565317,Asia,154760,2975
2020-06-18,Pakistan,PK,5358,118,216565317,Asia,160118,3093
2020-06-19,Pakistan,PK,4944,136,216565317,Asia,165062,3229
2020-06-20,Pakistan,PK,6604,153,216565317,Asia,171666,3382
2020-06-21,Pakistan,PK,4951,119,216565317,Asia,176617,3501
2020-06-22,Pakistan,PK,4471,89,216565317,Asia,181088,3590
2020-06-23,Pakistan,PK,3946,105,216565317,Asia,185034,3695
2020-06-24,Pakistan,PK,3892,60,216565317,Asia,188926,3755
2020-06-25,Pakistan,PK,4044,148,216565317,Asia,192970,3903
2020-06-26,Pakistan,PK,2775,59,216565317,Asia,195745,3962
2020-06-27,Pakistan,PK,3138,73,216565317,Asia,198883,4035
2020-06-28,Pakistan,PK,4072,83,216565317,Asia,202955,4118
2020-06-29,Pakistan,PK,3557,49,216565317,Asia,206512,4167
2020-06-30,Pakistan,PK,2825,137,216565317,Asia,209337,4304
2020-07-01,Pakistan,PK,4133,91,216565317,Asia,213470,4395
2020-07-02,Pakistan,PK,4339,78,216565317,Asia,217809,4473
2020-07-03,Pakistan,PK,4087,78,216565317,Asia,221896,4551
2020-07-04,Pakistan,PK,3387,68,216565317,Asia,225283,4619
2020-07-05,Pakistan,PK,3191,93,216565317,Asia,228474,4712
2020-07-06,Pakistan,PK,3344,50,216565317,Asia,231818,4762
2020-07-07,Pakistan,PK,2691,77,216565317,Asia,234509,4839
2020-07-08,Pakistan,PK,2980,83,216565317,Asia,237489,4922
2020-07-09,Pakistan,PK,3359,61,216565317,Asia,240848,4983
2020-07-10,Pakistan,PK,2751,75,216565317,Asia,243599,5058
2020-07-11,Pakistan,PK,2752,65,216565317,Asia,246351,5123
2020-07-12,Pakistan,PK,2521,74,216565317,Asia,248872,5197
2020-07-13,Pakistan,PK,2753,69,216565317,Asia,251625,5266
2020-07-14,Pakistan,PK,1979,54,216565317,Asia,253604,5320
2020-07-15,Pakistan,PK,2165,66,216565317,Asia,255769,5386
2020-07-16,Pakistan,PK,2145,40,216565317,Asia,257914,5426
2020-07-17,Pakistan,PK,2085,49,216565317,Asia,259999,5475
2020-07-18,Pakistan,PK,1918,47,216565317,Asia,261917,5522
2020-07-19,Pakistan,PK,1579,46,216565317,Asia,263496,5568
2020-07-20,Pakistan,PK,1587,31,216565317,Asia,265083,5599
2020-07-21,Pakistan,PK,1013,40,216565317,Asia,266096,5639
2020-07-22,Pakistan,PK,1332,38,216565317,Asia,267428,5677
2020-07-23,Pakistan,PK,1763,32,216565317,Asia,269191,5709
2020-07-24,Pakistan,PK,1209,54,216565317,Asia,270400,5763
2020-07-25,Pakistan,PK,1487,24,216565317,Asia,271887,5787
2020-07-26,Pakistan,PK,1226,35,216565317,Asia,273113,5822
2020-07-27,Pakistan,PK,1176,20,216565317,Asia,274289,5842
2020-07-28,Pakistan,PK,936,23,216565317,Asia,275225,5865
2020-07-29,Pakistan,PK,1063,27,216565317,Asia,276288,5892
2020-07-30,Pakistan,PK,1114,32,216565317,Asia,277402,5924
2020-07-31,Pakistan,PK,903,27,216565317,Asia,278305,5951
2020-08-01,Pakistan,PK,0,0,216565317,Asia,278305,5951
2020-08-02,Pakistan,PK,0,0,216565317,Asia,278305,5951
2020-08-03,Pakistan,PK,1724,33,216565317,Asia,280029,5984
2020-08-04,Pakistan,PK,432,15,216565317,Asia,280461,5999
2020-08-05,Pakistan,PK,675,15,216565317,Asia,281136,6014
2020-08-06,Pakistan,PK,727,21,216565317,Asia,281863,6035
2020-08-07,Pakistan,PK,782,17,216565317,Asia,282645,6052
2020-08-08,Pakistan,PK,842,16,216565317,Asia,283487,6068
2020-08-09,Pakistan,PK,634,14,216565317,Asia,284121,6082
2020-08-10,Pakistan,PK,539,15,216565317,Asia,284660,6097
2020-08-11,Pakistan,PK,531,15,216565317,Asia,285191,6112
2020-08-12,Pakistan,PK,730,17,216565317,Asia,285921,6129
2020-08-13,Pakistan,PK,753,10,216565317,Asia,286674,6139
2020-08-14,Pakistan,PK,626,14,216565317,Asia,287300,6153
2020-08-15,Pakistan,PK,747,9,216565317,Asia,288047,6162
2020-08-16,Pakistan,PK,670,6,216565317,Asia,288717,6168
2020-08-17,Pakistan,PK,498,7,216565317,Asia,289215,6175
2020-08-18,Pakistan,PK,617,15,216565317,Asia,289832,6190
2020-08-19,Pakistan,PK,0,0,216565317,Asia,289832,6190
2020-08-20,Pakistan,PK,1126,19,216565317,Asia,290958,6209
2020-08-21,Pakistan,PK,630,10,216565317,Asia,291588,6219
2020-08-22,Pakistan,PK,586,12,216565317,Asia,292174,6231
2020-08-23,Pakistan,PK,591,4,216565317,Asia,292765,6235
2020-08-24,Pakistan,PK,0,0,216565317,Asia,292765,6235
2020-08-25,Pakistan,PK,946,20,216565317,Asia,293711,6255
2020-08-26,Pakistan,PK,482,12,216565317,Asia,294193,6267
2020-08-27,Pakistan,PK,445,7,216565317,Asia,294638,6274
2020-08-28,Pakistan,PK,415,9,216565317,Asia,295053,6283
2020-08-29,Pakistan,PK,319,1,216565317,Asia,295372,6284
2020-08-30,Pakistan,PK,264,4,216565317,Asia,295636,6288
2020-08-31,Pakistan,PK,213,6,216565317,Asia,295849,6294
2020-09-01,Pakistan,PK,300,4,216565317,Asia,296149,6298
2020-09-02,Pakistan,PK,441,20,216565317,Asia,296590,6318
2020-09-03,Pakistan,PK,424,10,216565317,Asia,297014,6328
2020-09-04,Pakistan,PK,498,7,216565317,Asia,297512,6335
2020-09-05,Pakistan,PK,513,5,216565317,Asia,298025,6340
2020-09-06,Pakistan,PK,484,2,216565317,Asia,298509,6342
2020-09-07,Pakistan,PK,394,3,216565317,Asia,298903,6345
2020-09-08,Pakistan,PK,330,5,216565317,Asia,299233,6350
2020-09-09,Pakistan,PK,426,9,216565317,Asia,299659,6359
2020-09-10,Pakistan,PK,196,6,216565317,Asia,299855,6365
2020-09-11,Pakistan,PK,516,5,216565317,Asia,300371,6370
2020-09-12,Pakistan,PK,584,3,216565317,Asia,300955,6373
2020-09-13,Pakistan,PK,526,6,216565317,Asia,301481,6379
2020-09-14,Pakistan,PK,539,4,216565317,Asia,302020,6383
2020-09-15,Pakistan,PK,404,6,216565317,Asia,302424,6389
2020-09-16,Pakistan,PK,665,4,216565317,Asia,303089,6393
2020-09-17,Pakistan,PK,545,6,216565317,Asia,303634,6399
2020-09-18,Pakistan,PK,752,9,216565317,Asia,304386,6408
2020-09-19,Pakistan,PK,645,7,216565317,Asia,305031,6415
2020-09-20,Pakistan,PK,640,1,216565317,Asia,305671,6416
2020-09-21,Pakistan,PK,633,4,216565317,Asia,306304,6420
2020-09-22,Pakistan,PK,582,4,216565317,Asia,306886,6424
2020-09-23,Pakistan,PK,532,8,216565317,Asia,307418,6432
2020-09-24,Pakistan,PK,799,5,216565317,Asia,308217,6437
2020-09-25,Pakistan,PK,798,7,216565317,Asia,309015,6444
2020-09-26,Pakistan,PK,566,7,216565317,Asia,309581,6451
2020-09-27,Pakistan,PK,694,6,216565317,Asia,310275,6457
2020-09-28,Pakistan,PK,566,9,216565317,Asia,310841,6466
2020-09-29,Pakistan,PK,675,8,216565317,Asia,311516,6474
2020-09-30,Pakistan,PK,747,5,216565317,Asia,312263,6479
2020-10-01,Pakistan,PK,543,5,216565317,Asia,312806,6484
2020-10-02,Pakistan,PK,625,15,216565317,Asia,313431,6499
2020-10-03,Pakistan,PK,553,8,216565317,Asia,313984,6507
2020-10-04,Pakistan,PK,632,6,216565317,Asia,314616,6513
2020-10-05,Pakistan,PK,0,0,216565317,Asia,314616,6513
2020-10-06,Pakistan,PK,1111,10,216565317,Asia,315727,6523
2020-10-07,Pakistan,PK,624,12,216565317,Asia,316351,6535
2020-10-08,Pakistan,PK,583,9,216565317,Asia,316934,6544
2020-10-09,Pakistan,PK,661,8,216565317,Asia,317595,6552
2020-10-10,Pakistan,PK,671,6,216565317,Asia,318266,6558
2020-10-11,Pakistan,PK,666,12,216565317,Asia,318932,6570
2020-10-12,Pakistan,PK,0,0,216565317,Asia,318932,6570
2020-10-13,Pakistan,PK,916,18,216565317,Asia,319848,6588
2020-10-14,Pakistan,PK,615,13,216565317,Asia,320463,6601
2020-10-15,Pakistan,PK,755,13,216565317,Asia,321218,6614
2020-10-16,Pakistan,PK,659,7,216565317,Asia,321877,6621
2020-10-17,Pakistan,PK,575,17,216565317,Asia,322452,6638
2020-10-18,Pakistan,PK,567,16,216565317,Asia,323019,6654
2020-10-19,Pakistan,PK,433,5,216565317,Asia,323452,6659
2020-10-20,Pakistan,PK,0,0,216565317,Asia,323452,6659
2020-10-21,Pakistan,PK,1292,33,216565317,Asia,324744,6692
2020-10-22,Pakistan,PK,736,10,216565317,Asia,325480,6702
2020-10-23,Pakistan,PK,736,13,216565317,Asia,326216,6715
2020-10-24,Pakistan,PK,847,12,216565317,Asia,327063,6727
2020-10-25,Pakistan,PK,832,9,216565317,Asia,327895,6736
2020-10-26,Pakistan,PK,707,3,216565317,Asia,328602,6739
2020-10-27,Pakistan,PK,773,6,216565317,Asia,329375,6745
2020-10-28,Pakistan,PK,825,14,216565317,Asia,330200,6759
2020-10-29,Pakistan,PK,908,16,216565317,Asia,331108,6775
2020-10-30,Pakistan,PK,1078,20,216565317,Asia,332186,6795
2020-10-31,Pakistan,PK,807,11,216565317,Asia,332993,6806
2020-11-01,Pakistan,PK,977,17,216565317,Asia,333970,6823
2020-11-02,Pakistan,PK,1123,12,216565317,Asia,335093,6835
2020-11-03,Pakistan,PK,1167,14,216565317,Asia,336260,6849
2020-11-04,Pakistan,PK,1313,18,216565317,Asia,337573,6867
2020-11-05,Pakistan,PK,1302,26,216565317,Asia,338875,6893
2020-11-06,Pakistan,PK,1376,30,216565317,Asia,340251,6923
2020-11-07,Pakistan,PK,1502,20,216565317,Asia,341753,6943
2020-11-08,Pakistan,PK,1436,25,216565317,Asia,343189,6968
2020-11-09,Pakistan,PK,1650,9,216565317,Asia,344839,6977
2020-11-10,Pakistan,PK,1637,23,216565317,Asia,346476,7000
2020-11-11,Pakistan,PK,1708,21,216565317,Asia,348184,7021
2020-11-12,Pakistan,PK,1808,34,216565317,Asia,349992,7055
2020-11-13,Pakistan,PK,2304,37,216565317,Asia,352296,7092
2020-11-14,Pakistan,PK,2165,17,216565317,Asia,354461,7109
2020-11-15,Pakistan,PK,2443,32,216565317,Asia,356904,7141
2020-11-16,Pakistan,PK,2128,19,216565317,Asia,359032,7160
2020-11-17,Pakistan,PK,2050,33,216565317,Asia,361082,7193
2020-11-18,Pakistan,PK,2298,37,216565317,Asia,363380,7230
2020-11-19,Pakistan,PK,2547,18,216565317,Asia,365927,7248
2020-11-20,Pakistan,PK,2738,313,216565317,Asia,368665,7561
2020-11-21,Pakistan,PK,2843,42,216565317,Asia,371508,7603
2020-11-22,Pakistan,PK,2665,59,216565317,Asia,374173,7662
2020-11-23,Pakistan,PK,2756,34,216565317,Asia,376929,7696
2020-11-24,Pakistan,PK,2954,48,216565317,Asia,379883,7744
2020-11-25,Pakistan,PK,3009,59,216565317,Asia,382892,7803
2020-11-26,Pakistan,PK,3306,40,216565317,Asia,386198,7843
2020-11-27,Pakistan,PK,3113,54,216565317,Asia,389311,7897
2020-11-28,Pakistan,PK,3045,45,216565317,Asia,392356,7942
2020-11-29,Pakistan,PK,2829,43,216565317,Asia,395185,7985
2020-11-30,Pakistan,PK,2839,40,216565317,Asia,398024,8025
2020-12-01,Pakistan,PK,2458,66,216565317,Asia,400482,8091
2020-12-02,Pakistan,PK,2829,75,216565317,Asia,403311,8166
2020-12-03,Pakistan,PK,3499,39,216565317,Asia,406810,8205
2020-12-04,Pakistan,PK,3262,55,216565317,Asia,410072,8260
2020-12-05,Pakistan,PK,3119,43,216565317,Asia,413191,8303
2020-12-06,Pakistan,PK,3308,58,216565317,Asia,416499,8361
2020-12-07,Pakistan,PK,3795,37,216565317,Asia,420294,8398
2020-12-08,Pakistan,PK,2885,89,216565317,Asia,423179,8487
2020-12-09,Pakistan,PK,2963,60,216565317,Asia,426142,8547
2020-12-10,Pakistan,PK,3138,56,216565317,Asia,429280,8603
2020-12-11,Pakistan,PK,3047,50,216565317,Asia,432327,8653
2020-12-12,Pakistan,PK,2729,71,216565317,Asia,435056,8724
2020-12-13,Pakistan,PK,3369,72,216565317,Asia,438425,8796
2020-12-14,Pakistan,PK,2362,36,216565317,Asia,440787,8832
2020-03-04,Poland,PL,1,0,37972812,Europe,1,0
2020-03-07,Poland,PL,4,0,37972812,Europe,5,0
2020-03-08,Poland,PL,1,0,37972812,Europe,6,0
2020-03-09,Poland,PL,5,0,37972812,Europe,11,0
2020-03-10,Poland,PL,6,0,37972812,Europe,17,0
2020-03-11,Poland,PL,5,0,37972812,Europe,22,0
2020-03-12,Poland,PL,9,0,37972812,Europe,31,0
2020-03-13,Poland,PL,18,1,37972812,Europe,49,1
2020-03-14,Poland,PL,19,1,37972812,Europe,68,2
2020-03-15,Poland,PL,36,1,37972812,Europe,104,3
2020-03-16,Poland,PL,21,0,37972812,Europe,125,3
2020-03-17,Poland,PL,52,1,37972812,Europe,177,4
2020-03-18,Poland,PL,61,1,37972812,Europe,238,5
2020-03-19,Poland,PL,49,0,37972812,Europe,287,5
2020-03-20,Poland,PL,68,0,37972812,Europe,355,5
2020-03-21,Poland,PL,70,0,37972812,Europe,425,5
2020-03-22,Poland,PL,111,0,37972812,Europe,536,5
2020-03-23,Poland,PL,98,2,37972812,Europe,634,7
2020-03-24,Poland,PL,115,1,37972812,Europe,749,8
2020-03-25,Poland,PL,152,2,37972812,Europe,901,10
2020-03-26,Poland,PL,150,4,37972812,Europe,1051,14
2020-03-27,Poland,PL,170,2,37972812,Europe,1221,16
2020-03-28,Poland,PL,168,0,37972812,Europe,1389,16
2020-03-29,Poland,PL,249,2,37972812,Europe,1638,18
2020-03-30,Poland,PL,224,4,37972812,Europe,1862,22
2020-03-31,Poland,PL,193,9,37972812,Europe,2055,31
2020-04-01,Poland,PL,256,2,37972812,Europe,2311,33
2020-04-02,Poland,PL,243,10,37972812,Europe,2554,43
2020-04-03,Poland,PL,392,14,37972812,Europe,2946,57
2020-04-04,Poland,PL,437,14,37972812,Europe,3383,71
2020-04-05,Poland,PL,244,8,37972812,Europe,3627,79
2020-04-06,Poland,PL,475,15,37972812,Europe,4102,94
2020-04-07,Poland,PL,311,13,37972812,Europe,4413,107
2020-04-08,Poland,PL,435,22,37972812,Europe,4848,129
2020-04-09,Poland,PL,357,30,37972812,Europe,5205,159
2020-04-10,Poland,PL,370,15,37972812,Europe,5575,174
2020-04-11,Poland,PL,380,7,37972812,Europe,5955,181
2020-04-12,Poland,PL,401,27,37972812,Europe,6356,208
2020-04-13,Poland,PL,318,24,37972812,Europe,6674,232
2020-04-14,Poland,PL,260,13,37972812,Europe,6934,245
2020-04-15,Poland,PL,268,18,37972812,Europe,7202,263
2020-04-16,Poland,PL,380,23,37972812,Europe,7582,286
2020-04-17,Poland,PL,336,28,37972812,Europe,7918,314
2020-04-18,Poland,PL,461,18,37972812,Europe,8379,332
2020-04-19,Poland,PL,363,15,37972812,Europe,8742,347
2020-04-20,Poland,PL,545,13,37972812,Europe,9287,360
2020-04-21,Poland,PL,306,20,37972812,Europe,9593,380
2020-04-22,Poland,PL,263,21,37972812,Europe,9856,401
2020-04-23,Poland,PL,313,25,37972812,Europe,10169,426
2020-04-24,Poland,PL,342,28,37972812,Europe,10511,454
2020-04-25,Poland,PL,381,40,37972812,Europe,10892,494
2020-04-26,Poland,PL,381,30,37972812,Europe,11273,524
2020-04-27,Poland,PL,344,11,37972812,Europe,11617,535
2020-04-28,Poland,PL,285,27,37972812,Europe,11902,562
2020-04-29,Poland,PL,316,34,37972812,Europe,12218,596
2020-04-30,Poland,PL,422,28,37972812,Europe,12640,624
2020-05-01,Poland,PL,237,20,37972812,Europe,12877,644
2020-05-02,Poland,PL,228,7,37972812,Europe,13105,651
2020-05-03,Poland,PL,270,13,37972812,Europe,13375,664
2020-05-04,Poland,PL,318,14,37972812,Europe,13693,678
2020-05-05,Poland,PL,313,20,37972812,Europe,14006,698
2020-05-06,Poland,PL,425,18,37972812,Europe,14431,716
2020-05-07,Poland,PL,309,17,37972812,Europe,14740,733
2020-05-08,Poland,PL,307,22,37972812,Europe,15047,755
2020-05-09,Poland,PL,319,21,37972812,Europe,15366,776
2020-05-10,Poland,PL,285,9,37972812,Europe,15651,785
2020-05-11,Poland,PL,345,15,37972812,Europe,15996,800
2020-05-12,Poland,PL,330,11,37972812,Europe,16326,811
2020-05-13,Poland,PL,595,28,37972812,Europe,16921,839
2020-05-14,Poland,PL,283,22,37972812,Europe,17204,861
2020-05-15,Poland,PL,411,22,37972812,Europe,17615,883
2020-05-16,Poland,PL,401,24,37972812,Europe,18016,907
2020-05-17,Poland,PL,241,8,37972812,Europe,18257,915
2020-05-18,Poland,PL,272,10,37972812,Europe,18529,925
2020-05-19,Poland,PL,356,11,37972812,Europe,18885,936
2020-05-20,Poland,PL,383,12,37972812,Europe,19268,948
2020-05-21,Poland,PL,471,14,37972812,Europe,19739,962
2020-05-22,Poland,PL,404,10,37972812,Europe,20143,972
2020-05-23,Poland,PL,476,10,37972812,Europe,20619,982
2020-05-24,Poland,PL,312,11,37972812,Europe,20931,993
2020-05-25,Poland,PL,395,3,37972812,Europe,21326,996
2020-05-26,Poland,PL,305,11,37972812,Europe,21631,1007
2020-05-27,Poland,PL,443,17,37972812,Europe,22074,1024
2020-05-28,Poland,PL,399,4,37972812,Europe,22473,1028
2020-05-29,Poland,PL,352,10,37972812,Europe,22825,1038
2020-05-30,Poland,PL,330,13,37972812,Europe,23155,1051
2020-05-31,Poland,PL,416,10,37972812,Europe,23571,1061
2020-06-01,Poland,PL,215,3,37972812,Europe,23786,1064
2020-06-02,Poland,PL,379,10,37972812,Europe,24165,1074
2020-06-03,Poland,PL,230,18,37972812,Europe,24395,1092
2020-06-04,Poland,PL,292,23,37972812,Europe,24687,1115
2020-06-05,Poland,PL,361,2,37972812,Europe,25048,1117
2020-06-06,Poland,PL,371,20,37972812,Europe,25419,1137
2020-06-07,Poland,PL,567,16,37972812,Europe,25986,1153
2020-06-08,Poland,PL,575,4,37972812,Europe,26561,1157
2020-06-09,Poland,PL,599,9,37972812,Europe,27160,1166
2020-06-10,Poland,PL,400,17,37972812,Europe,27560,1183
2020-06-11,Poland,PL,197,23,37972812,Europe,27757,1206
2020-06-12,Poland,PL,444,9,37972812,Europe,28201,1215
2020-06-13,Poland,PL,376,7,37972812,Europe,28577,1222
2020-06-14,Poland,PL,440,15,37972812,Europe,29017,1237
2020-06-15,Poland,PL,375,10,37972812,Europe,29392,1247
2020-06-16,Poland,PL,396,9,37972812,Europe,29788,1256
2020-06-17,Poland,PL,407,16,37972812,Europe,30195,1272
2020-06-18,Poland,PL,506,14,37972812,Europe,30701,1286
2020-06-19,Poland,PL,314,30,37972812,Europe,31015,1316
2020-06-20,Poland,PL,301,18,37972812,Europe,31316,1334
2020-06-21,Poland,PL,304,12,37972812,Europe,31620,1346
2020-06-22,Poland,PL,311,10,37972812,Europe,31931,1356
2020-06-23,Poland,PL,296,3,37972812,Europe,32227,1359
2020-06-24,Poland,PL,300,16,37972812,Europe,32527,1375
2020-06-25,Poland,PL,294,21,37972812,Europe,32821,1396
2020-06-26,Poland,PL,298,16,37972812,Europe,33119,1412
2020-06-27,Poland,PL,276,17,37972812,Europe,33395,1429
2020-06-28,Poland,PL,319,6,37972812,Europe,33714,1435
2020-06-29,Poland,PL,193,3,37972812,Europe,33907,1438
2020-06-30,Poland,PL,247,6,37972812,Europe,34154,1444
2020-07-01,Poland,PL,239,19,37972812,Europe,34393,1463
2020-07-02,Poland,PL,382,14,37972812,Europe,34775,1477
2020-07-03,Poland,PL,371,15,37972812,Europe,35146,1492
2020-07-04,Poland,PL,259,15,37972812,Europe,35405,1507
2020-07-05,Poland,PL,314,5,37972812,Europe,35719,1512
2020-07-06,Poland,PL,231,5,37972812,Europe,35950,1517
2020-07-07,Poland,PL,205,4,37972812,Europe,36155,1521
2020-07-08,Poland,PL,257,7,37972812,Europe,36412,1528
2020-07-09,Poland,PL,277,14,37972812,Europe,36689,1542
2020-07-10,Poland,PL,262,9,37972812,Europe,36951,1551
2020-07-11,Poland,PL,265,11,37972812,Europe,37216,1562
2020-07-12,Poland,PL,305,6,37972812,Europe,37521,1568
2020-07-13,Poland,PL,370,3,37972812,Europe,37891,1571
2020-07-14,Poland,PL,299,5,37972812,Europe,38190,1576
2020-07-15,Poland,PL,267,12,37972812,Europe,38457,1588
2020-07-16,Poland,PL,323,6,37972812,Europe,38780,1594
2020-07-17,Poland,PL,274,11,37972812,Europe,39054,1605
2020-07-18,Poland,PL,353,7,37972812,Europe,39407,1612
2020-07-19,Poland,PL,339,6,37972812,Europe,39746,1618
2020-07-20,Poland,PL,358,6,37972812,Europe,40104,1624
2020-07-21,Poland,PL,279,3,37972812,Europe,40383,1627
2020-07-22,Poland,PL,399,9,37972812,Europe,40782,1636
2020-07-23,Poland,PL,380,6,37972812,Europe,41162,1642
2020-07-24,Poland,PL,418,9,37972812,Europe,41580,1651
2020-07-25,Poland,PL,458,4,37972812,Europe,42038,1655
2020-07-26,Poland,PL,584,9,37972812,Europe,42622,1664
2020-07-27,Poland,PL,443,7,37972812,Europe,43065,1671
2020-07-28,Poland,PL,337,5,37972812,Europe,43402,1676
2020-07-29,Poland,PL,502,6,37972812,Europe,43904,1682
2020-07-30,Poland,PL,512,12,37972812,Europe,44416,1694
2020-07-31,Poland,PL,615,15,37972812,Europe,45031,1709
2020-08-01,Poland,PL,657,7,37972812,Europe,45688,1716
2020-08-02,Poland,PL,658,5,37972812,Europe,46346,1721
2020-08-03,Poland,PL,548,10,37972812,Europe,46894,1731
2020-08-04,Poland,PL,575,1,37972812,Europe,47469,1732
2020-08-05,Poland,PL,680,6,37972812,Europe,48149,1738
2020-08-06,Poland,PL,640,18,37972812,Europe,48789,1756
2020-08-07,Poland,PL,726,18,37972812,Europe,49515,1774
2020-08-08,Poland,PL,809,13,37972812,Europe,50324,1787
2020-08-09,Poland,PL,843,13,37972812,Europe,51167,1800
2020-08-10,Poland,PL,624,7,37972812,Europe,51791,1807
2020-08-11,Poland,PL,619,2,37972812,Europe,52410,1809
2020-08-12,Poland,PL,551,12,37972812,Europe,52961,1821
2020-08-13,Poland,PL,715,9,37972812,Europe,53676,1830
2020-08-14,Poland,PL,811,14,37972812,Europe,54487,1844
2020-08-15,Poland,PL,832,14,37972812,Europe,55319,1858
2020-08-16,Poland,PL,771,11,37972812,Europe,56090,1869
2020-08-17,Poland,PL,594,8,37972812,Europe,56684,1877
2020-08-18,Poland,PL,595,8,37972812,Europe,57279,1885
2020-08-19,Poland,PL,597,11,37972812,Europe,57876,1896
2020-08-20,Poland,PL,735,17,37972812,Europe,58611,1913
2020-08-21,Poland,PL,767,12,37972812,Europe,59378,1925
2020-08-22,Poland,PL,903,13,37972812,Europe,60281,1938
2020-08-23,Poland,PL,900,13,37972812,Europe,61181,1951
2020-08-24,Poland,PL,581,4,37972812,Europe,61762,1955
2020-08-25,Poland,PL,548,5,37972812,Europe,62310,1960
2020-08-26,Poland,PL,763,17,37972812,Europe,63073,1977
2020-08-27,Poland,PL,729,17,37972812,Europe,63802,1994
2020-08-28,Poland,PL,887,16,37972812,Europe,64689,2010
2020-08-29,Poland,PL,791,8,37972812,Europe,65480,2018
2020-08-30,Poland,PL,759,14,37972812,Europe,66239,2032
2020-08-31,Poland,PL,631,1,37972812,Europe,66870,2033
2020-09-01,Poland,PL,502,6,37972812,Europe,67372,2039
2020-09-02,Poland,PL,550,19,37972812,Europe,67922,2058
2020-09-03,Poland,PL,595,20,37972812,Europe,68517,2078
2020-09-04,Poland,PL,612,14,37972812,Europe,69129,2092
2020-09-05,Poland,PL,691,8,37972812,Europe,69820,2100
2020-09-06,Poland,PL,567,13,37972812,Europe,70387,2113
2020-09-07,Poland,PL,437,7,37972812,Europe,70824,2120
2020-09-08,Poland,PL,302,4,37972812,Europe,71126,2124
2020-09-09,Poland,PL,400,12,37972812,Europe,71526,2136
2020-09-10,Poland,PL,421,11,37972812,Europe,71947,2147
2020-09-11,Poland,PL,506,12,37972812,Europe,72453,2159
2020-09-12,Poland,PL,594,10,37972812,Europe,73047,2169
2020-09-13,Poland,PL,603,13,37972812,Europe,73650,2182
2020-09-14,Poland,PL,502,6,37972812,Europe,74152,2188
2020-09-15,Poland,PL,377,15,37972812,Europe,74529,2203
2020-09-16,Poland,PL,605,24,37972812,Europe,75134,2227
2020-09-17,Poland,PL,600,10,37972812,Europe,75734,2237
2020-09-18,Poland,PL,837,16,37972812,Europe,76571,2253
2020-09-19,Poland,PL,757,17,37972812,Europe,77328,2270
2020-09-20,Poland,PL,1002,12,37972812,Europe,78330,2282
2020-09-21,Poland,PL,910,11,37972812,Europe,79240,2293
2020-09-22,Poland,PL,748,5,37972812,Europe,79988,2298
2020-09-23,Poland,PL,711,18,37972812,Europe,80699,2316
2020-09-24,Poland,PL,974,28,37972812,Europe,81673,2344
2020-09-25,Poland,PL,1136,25,37972812,Europe,82809,2369
2020-09-26,Poland,PL,1587,23,37972812,Europe,84396,2392
2020-09-27,Poland,PL,1584,32,37972812,Europe,85980,2424
2020-09-28,Poland,PL,1350,8,37972812,Europe,87330,2432
2020-09-29,Poland,PL,1306,15,37972812,Europe,88636,2447
2020-09-30,Poland,PL,1326,36,37972812,Europe,89962,2483
2020-10-01,Poland,PL,1552,30,37972812,Europe,91514,2513
2020-10-02,Poland,PL,1967,30,37972812,Europe,93481,2543
2020-10-03,Poland,PL,2292,27,37972812,Europe,95773,2570
2020-10-04,Poland,PL,2367,34,37972812,Europe,98140,2604
2020-10-05,Poland,PL,0,0,37972812,Europe,98140,2604
2020-10-06,Poland,PL,3940,55,37972812,Europe,102080,2659
2020-10-07,Poland,PL,2236,58,37972812,Europe,104316,2717
2020-10-08,Poland,PL,3003,75,37972812,Europe,107319,2792
2020-10-09,Poland,PL,4280,75,37972812,Europe,111599,2867
2020-10-10,Poland,PL,4739,52,37972812,Europe,116338,2919
2020-10-11,Poland,PL,5300,53,37972812,Europe,121638,2972
2020-10-12,Poland,PL,4178,32,37972812,Europe,125816,3004
2020-10-13,Poland,PL,4394,35,37972812,Europe,130210,3039
2020-10-14,Poland,PL,5068,62,37972812,Europe,135278,3101
2020-10-15,Poland,PL,6526,116,37972812,Europe,141804,3217
2020-10-16,Poland,PL,8099,91,37972812,Europe,149903,3308
2020-10-17,Poland,PL,7705,132,37972812,Europe,157608,3440
2020-10-18,Poland,PL,9622,84,37972812,Europe,167230,3524
2020-10-19,Poland,PL,8536,49,37972812,Europe,175766,3573
2020-10-20,Poland,PL,7482,41,37972812,Europe,183248,3614
2020-10-21,Poland,PL,9291,107,37972812,Europe,192539,3721
2020-10-22,Poland,PL,10040,130,37972812,Europe,202579,3851
2020-10-23,Poland,PL,12107,168,37972812,Europe,214686,4019
2020-10-24,Poland,PL,13632,153,37972812,Europe,228318,4172
2020-10-25,Poland,PL,13628,179,37972812,Europe,241946,4351
2020-10-26,Poland,PL,11742,87,37972812,Europe,253688,4438
2020-10-27,Poland,PL,10241,45,37972812,Europe,263929,4483
2020-10-28,Poland,PL,16300,132,37972812,Europe,280229,4615
2020-10-29,Poland,PL,18820,236,37972812,Europe,299049,4851
2020-10-30,Poland,PL,20156,298,37972812,Europe,319205,5149
2020-10-31,Poland,PL,21629,202,37972812,Europe,340834,5351
2020-11-01,Poland,PL,21897,280,37972812,Europe,362731,5631
2020-11-02,Poland,PL,17171,152,37972812,Europe,379902,5783
2020-11-03,Poland,PL,15578,92,37972812,Europe,395480,5875
2020-11-04,Poland,PL,19364,227,37972812,Europe,414844,6102
2020-11-05,Poland,PL,24692,373,37972812,Europe,439536,6475
2020-11-06,Poland,PL,27143,367,37972812,Europe,466679,6842
2020-11-07,Poland,PL,27086,445,37972812,Europe,493765,7287
2020-11-08,Poland,PL,27875,349,37972812,Europe,521640,7636
2020-11-09,Poland,PL,24785,236,37972812,Europe,546425,7872
2020-11-10,Poland,PL,21713,173,37972812,Europe,568138,8045
2020-11-11,Poland,PL,25454,330,37972812,Europe,593592,8375
2020-11-12,Poland,PL,25221,430,37972812,Europe,618813,8805
2020-11-13,Poland,PL,22683,275,37972812,Europe,641496,9080
2020-11-14,Poland,PL,24051,419,37972812,Europe,665547,9499
2020-11-15,Poland,PL,25571,546,37972812,Europe,691118,10045
2020-11-16,Poland,PL,21854,303,37972812,Europe,712972,10348
2020-11-17,Poland,PL,20816,143,37972812,Europe,733788,10491
2020-11-18,Poland,PL,19152,357,37972812,Europe,752940,10848
2020-11-19,Poland,PL,19883,603,37972812,Europe,772823,11451
2020-11-20,Poland,PL,23975,637,37972812,Europe,796798,12088
2020-11-21,Poland,PL,22464,626,37972812,Europe,819262,12714
2020-11-22,Poland,PL,24213,574,37972812,Europe,843475,13288
2020-11-23,Poland,PL,17856,330,37972812,Europe,861331,13618
2020-11-24,Poland,PL,15002,156,37972812,Europe,876333,13774
2020-11-25,Poland,PL,32733,540,37972812,Europe,909066,14314
2020-11-26,Poland,PL,15356,674,37972812,Europe,924422,14988
2020-11-27,Poland,PL,16690,580,37972812,Europe,941112,15568
2020-11-28,Poland,PL,17304,579,37972812,Europe,958416,16147
2020-11-29,Poland,PL,15177,599,37972812,Europe,973593,16746
2020-11-30,Poland,PL,11482,283,37972812,Europe,985075,17029
2020-12-01,Poland,PL,5736,121,37972812,Europe,990811,17150
2020-12-02,Poland,PL,9113,449,37972812,Europe,999924,17599
2020-12-03,Poland,PL,13823,609,37972812,Europe,1013747,18208
2020-12-04,Poland,PL,14863,620,37972812,Europe,1028610,18828
2020-12-05,Poland,PL,13236,531,37972812,Europe,1041846,19359
2020-12-06,Poland,PL,12427,502,37972812,Europe,1054273,19861
2020-12-07,Poland,PL,9176,228,37972812,Europe,1063449,20089
2020-12-08,Poland,PL,4421,92,37972812,Europe,1067870,20181
2020-12-09,Poland,PL,8310,411,37972812,Europe,1076180,20592
2020-12-10,Poland,PL,12166,568,37972812,Europe,1088346,21160
2020-12-11,Poland,PL,13750,470,37972812,Europe,1102096,21630
2020-12-12,Poland,PL,13105,544,37972812,Europe,1115201,22174
2020-12-13,Poland,PL,11499,502,37972812,Europe,1126700,22676
2020-12-14,Poland,PL,8976,188,37972812,Europe,1135676,22864
2020-03-28,Puerto_Rico,PR,64,2,2933404,America,64,2
2020-03-29,Puerto_Rico,PR,36,1,2933404,America,100,3
2020-03-30,Puerto_Rico,PR,27,2,2933404,America,127,5
2020-03-31,Puerto_Rico,PR,47,1,2933404,America,174,6
2020-04-01,Puerto_Rico,PR,65,2,2933404,America,239,8
2020-04-02,Puerto_Rico,PR,47,3,2933404,America,286,11
2020-04-03,Puerto_Rico,PR,30,1,2933404,America,316,12
2020-04-04,Puerto_Rico,PR,62,3,2933404,America,378,15
2020-04-05,Puerto_Rico,PR,74,3,2933404,America,452,18
2020-04-06,Puerto_Rico,PR,23,2,2933404,America,475,20
2020-04-07,Puerto_Rico,PR,38,1,2933404,America,513,21
2020-04-08,Puerto_Rico,PR,60,2,2933404,America,573,23
2020-04-09,Puerto_Rico,PR,47,1,2933404,America,620,24
2020-04-10,Puerto_Rico,PR,63,9,2933404,America,683,33
2020-04-11,Puerto_Rico,PR,42,6,2933404,America,725,39
2020-04-12,Puerto_Rico,PR,63,3,2933404,America,788,42
2020-04-13,Puerto_Rico,PR,109,2,2933404,America,897,44
2020-04-14,Puerto_Rico,PR,6,1,2933404,America,903,45
2020-04-15,Puerto_Rico,PR,20,0,2933404,America,923,45
2020-04-16,Puerto_Rico,PR,51,6,2933404,America,974,51
2020-04-17,Puerto_Rico,PR,69,5,2933404,America,1043,56
2020-04-18,Puerto_Rico,PR,25,2,2933404,America,1068,58
2020-04-19,Puerto_Rico,PR,50,2,2933404,America,1118,60
2020-04-20,Puerto_Rico,PR,95,2,2933404,America,1213,62
2020-04-21,Puerto_Rico,PR,39,1,2933404,America,1252,63
2020-04-22,Puerto_Rico,PR,0,0,2933404,America,1252,63
2020-04-23,Puerto_Rico,PR,0,1,2933404,America,1252,64
2020-04-24,Puerto_Rico,PR,0,5,2933404,America,1252,69
2020-04-25,Puerto_Rico,PR,24,8,2933404,America,1276,77
2020-04-26,Puerto_Rico,PR,31,6,2933404,America,1307,83
2020-04-27,Puerto_Rico,PR,64,1,2933404,America,1371,84
2020-04-28,Puerto_Rico,PR,18,0,2933404,America,1389,84
2020-04-29,Puerto_Rico,PR,11,2,2933404,America,1400,86
2020-04-30,Puerto_Rico,PR,33,0,2933404,America,1433,86
2020-05-01,Puerto_Rico,PR,106,6,2933404,America,1539,92
2020-05-02,Puerto_Rico,PR,36,2,2933404,America,1575,94
2020-05-03,Puerto_Rico,PR,182,1,2933404,America,1757,95
2020-05-04,Puerto_Rico,PR,51,2,2933404,America,1808,97
2020-05-05,Puerto_Rico,PR,35,0,2933404,America,1843,97
2020-05-06,Puerto_Rico,PR,81,2,2933404,America,1924,99
2020-05-07,Puerto_Rico,PR,44,0,2933404,America,1968,99
2020-05-08,Puerto_Rico,PR,63,3,2933404,America,2031,102
2020-05-09,Puerto_Rico,PR,125,5,2933404,America,2156,107
2020-05-10,Puerto_Rico,PR,17,1,2933404,America,2173,108
2020-05-11,Puerto_Rico,PR,25,3,2933404,America,2198,111
2020-05-12,Puerto_Rico,PR,58,2,2933404,America,2256,113
2020-05-13,Puerto_Rico,PR,43,1,2933404,America,2299,114
2020-05-14,Puerto_Rico,PR,30,1,2933404,America,2329,115
2020-05-15,Puerto_Rico,PR,98,2,2933404,America,2427,117
2020-05-16,Puerto_Rico,PR,115,5,2933404,America,2542,122
2020-05-17,Puerto_Rico,PR,47,0,2933404,America,2589,122
2020-05-18,Puerto_Rico,PR,57,1,2933404,America,2646,123
2020-05-19,Puerto_Rico,PR,64,1,2933404,America,2710,124
2020-05-20,Puerto_Rico,PR,95,0,2933404,America,2805,124
2020-05-21,Puerto_Rico,PR,61,1,2933404,America,2866,125
2020-05-22,Puerto_Rico,PR,47,1,2933404,America,2913,126
2020-05-23,Puerto_Rico,PR,117,0,2933404,America,3030,126
2020-05-24,Puerto_Rico,PR,70,1,2933404,America,3100,127
2020-05-25,Puerto_Rico,PR,89,0,2933404,America,3189,127
2020-05-26,Puerto_Rico,PR,71,2,2933404,America,3260,129
2020-05-27,Puerto_Rico,PR,64,0,2933404,America,3324,129
2020-05-28,Puerto_Rico,PR,73,0,2933404,America,3397,129
2020-05-29,Puerto_Rico,PR,89,2,2933404,America,3486,131
2020-05-30,Puerto_Rico,PR,161,1,2933404,America,3647,132
2020-05-31,Puerto_Rico,PR,71,1,2933404,America,3718,133
2020-06-01,Puerto_Rico,PR,58,3,2933404,America,3776,136
2020-06-02,Puerto_Rico,PR,97,0,2933404,America,3873,136
2020-06-03,Puerto_Rico,PR,62,2,2933404,America,3935,138
2020-06-04,Puerto_Rico,PR,88,2,2933404,America,4023,140
2020-06-05,Puerto_Rico,PR,485,0,2933404,America,4508,140
2020-06-06,Puerto_Rico,PR,112,1,2933404,America,4620,141
2020-06-07,Puerto_Rico,PR,295,1,2933404,America,4915,142
2020-06-08,Puerto_Rico,PR,70,0,2933404,America,4985,142
2020-06-09,Puerto_Rico,PR,61,0,2933404,America,5046,142
2020-06-10,Puerto_Rico,PR,139,0,2933404,America,5185,142
2020-06-11,Puerto_Rico,PR,144,1,2933404,America,5329,143
2020-06-12,Puerto_Rico,PR,23,1,2933404,America,5352,144
2020-06-13,Puerto_Rico,PR,184,2,2933404,America,5536,146
2020-06-14,Puerto_Rico,PR,154,0,2933404,America,5690,146
2020-06-15,Puerto_Rico,PR,121,1,2933404,America,5811,147
2020-06-16,Puerto_Rico,PR,79,0,2933404,America,5890,147
2020-06-17,Puerto_Rico,PR,61,0,2933404,America,5951,147
2020-06-18,Puerto_Rico,PR,52,0,2933404,America,6003,147
2020-06-19,Puerto_Rico,PR,108,0,2933404,America,6111,147
2020-06-20,Puerto_Rico,PR,0,0,2933404,America,6111,147
2020-06-21,Puerto_Rico,PR,352,0,2933404,America,6463,147
2020-06-22,Puerto_Rico,PR,62,2,2933404,America,6525,149
2020-06-23,Puerto_Rico,PR,39,0,2933404,America,6564,149
2020-06-24,Puerto_Rico,PR,121,0,2933404,America,6685,149
2020-06-25,Puerto_Rico,PR,135,0,2933404,America,6820,149
2020-06-26,Puerto_Rico,PR,57,2,2933404,America,6877,151
2020-06-27,Puerto_Rico,PR,45,0,2933404,America,6922,151
2020-06-28,Puerto_Rico,PR,144,1,2933404,America,7066,152
2020-06-29,Puerto_Rico,PR,123,1,2933404,America,7189,153
2020-06-30,Puerto_Rico,PR,61,0,2933404,America,7250,153
2020-07-01,Puerto_Rico,PR,215,0,2933404,America,7465,153
2020-07-02,Puerto_Rico,PR,72,0,2933404,America,7537,153
2020-07-03,Puerto_Rico,PR,71,0,2933404,America,7608,153
2020-07-04,Puerto_Rico,PR,75,1,2933404,America,7683,154
2020-07-05,Puerto_Rico,PR,4,1,2933404,America,7687,155
2020-07-06,Puerto_Rico,PR,229,0,2933404,America,7916,155
2020-07-07,Puerto_Rico,PR,669,0,2933404,America,8585,155
2020-07-08,Puerto_Rico,PR,129,2,2933404,America,8714,157
2020-07-09,Puerto_Rico,PR,190,2,2933404,America,8904,159
2020-07-10,Puerto_Rico,PR,0,0,2933404,America,8904,159
2020-07-11,Puerto_Rico,PR,392,0,2933404,America,9296,159
2020-07-12,Puerto_Rico,PR,237,8,2933404,America,9533,167
2020-07-13,Puerto_Rico,PR,288,0,2933404,America,9821,167
2020-07-14,Puerto_Rico,PR,189,0,2933404,America,10010,167
2020-07-15,Puerto_Rico,PR,113,2,2933404,America,10123,169
2020-07-16,Puerto_Rico,PR,256,2,2933404,America,10379,171
2020-07-17,Puerto_Rico,PR,195,1,2933404,America,10574,172
2020-07-18,Puerto_Rico,PR,546,5,2933404,America,11120,177
2020-07-19,Puerto_Rico,PR,333,1,2933404,America,11453,178
2020-07-20,Puerto_Rico,PR,610,0,2933404,America,12063,178
2020-07-21,Puerto_Rico,PR,398,2,2933404,America,12461,180
2020-07-22,Puerto_Rico,PR,479,0,2933404,America,12940,180
2020-07-23,Puerto_Rico,PR,98,5,2933404,America,13038,185
2020-07-24,Puerto_Rico,PR,435,3,2933404,America,13473,188
2020-07-25,Puerto_Rico,PR,494,3,2933404,America,13967,191
2020-07-26,Puerto_Rico,PR,573,10,2933404,America,14540,201
2020-07-27,Puerto_Rico,PR,603,0,2933404,America,15143,201
2020-07-28,Puerto_Rico,PR,298,0,2933404,America,15441,201
2020-07-29,Puerto_Rico,PR,399,8,2933404,America,15840,209
2020-07-30,Puerto_Rico,PR,221,2,2933404,America,16061,211
2020-07-31,Puerto_Rico,PR,511,3,2933404,America,16572,214
2020-08-01,Puerto_Rico,PR,209,5,2933404,America,16781,219
2020-08-02,Puerto_Rico,PR,1091,6,2933404,America,17872,225
2020-08-03,Puerto_Rico,PR,539,5,2933404,America,18411,230
2020-08-04,Puerto_Rico,PR,380,0,2933404,America,18791,230
2020-08-05,Puerto_Rico,PR,533,7,2933404,America,19324,237
2020-08-06,Puerto_Rico,PR,327,9,2933404,America,19651,246
2020-08-07,Puerto_Rico,PR,283,12,2933404,America,19934,258
2020-08-08,Puerto_Rico,PR,752,7,2933404,America,20686,265
2020-08-09,Puerto_Rico,PR,738,9,2933404,America,21424,274
2020-08-10,Puerto_Rico,PR,697,5,2933404,America,22121,279
2020-08-11,Puerto_Rico,PR,697,0,2933404,America,22818,279
2020-08-12,Puerto_Rico,PR,585,8,2933404,America,23403,287
2020-08-13,Puerto_Rico,PR,671,8,2933404,America,24074,295
2020-08-14,Puerto_Rico,PR,372,11,2933404,America,24446,306
2020-08-15,Puerto_Rico,PR,682,5,2933404,America,25128,311
2020-08-16,Puerto_Rico,PR,567,18,2933404,America,25695,329
2020-08-17,Puerto_Rico,PR,311,6,2933404,America,26006,335
2020-08-18,Puerto_Rico,PR,754,0,2933404,America,26760,335
2020-08-19,Puerto_Rico,PR,953,11,2933404,America,27713,346
2020-08-20,Puerto_Rico,PR,221,10,2933404,America,27934,356
2020-08-21,Puerto_Rico,PR,209,11,2933404,America,28143,367
2020-08-22,Puerto_Rico,PR,706,7,2933404,America,28849,374
2020-08-23,Puerto_Rico,PR,728,7,2933404,America,29577,381
2020-08-24,Puerto_Rico,PR,319,9,2933404,America,29896,390
2020-08-25,Puerto_Rico,PR,722,0,2933404,America,30618,390
2020-08-26,Puerto_Rico,PR,102,5,2933404,America,30720,395
2020-08-27,Puerto_Rico,PR,24,9,2933404,America,30744,404
2020-08-28,Puerto_Rico,PR,639,8,2933404,America,31383,412
2020-08-29,Puerto_Rico,PR,605,12,2933404,America,31988,424
2020-08-30,Puerto_Rico,PR,562,4,2933404,America,32550,428
2020-08-31,Puerto_Rico,PR,298,6,2933404,America,32848,434
2020-09-01,Puerto_Rico,PR,351,0,2933404,America,33199,434
2020-09-02,Puerto_Rico,PR,222,1,2933404,America,33421,435
2020-09-03,Puerto_Rico,PR,582,8,2933404,America,34003,443
2020-09-04,Puerto_Rico,PR,195,5,2933404,America,34198,448
2020-09-05,Puerto_Rico,PR,43,7,2933404,America,34241,455
2020-09-06,Puerto_Rico,PR,251,9,2933404,America,34492,464
2020-09-07,Puerto_Rico,PR,41,13,2933404,America,34533,477
2020-09-08,Puerto_Rico,PR,842,0,2933404,America,35375,477
2020-09-09,Puerto_Rico,PR,129,5,2933404,America,35504,482
2020-09-10,Puerto_Rico,PR,3,18,2933404,America,35507,500
2020-09-11,Puerto_Rico,PR,772,12,2933404,America,36279,512
2020-09-12,Puerto_Rico,PR,302,11,2933404,America,36581,523
2020-09-13,Puerto_Rico,PR,511,12,2933404,America,37092,535
2020-09-14,Puerto_Rico,PR,288,4,2933404,America,37380,539
2020-09-15,Puerto_Rico,PR,370,3,2933404,America,37750,542
2020-09-16,Puerto_Rico,PR,422,9,2933404,America,38172,551
2020-09-17,Puerto_Rico,PR,682,19,2933404,America,38854,570
2020-09-18,Puerto_Rico,PR,13,18,2933404,America,38867,588
2020-09-19,Puerto_Rico,PR,817,11,2933404,America,39684,599
2020-09-20,Puerto_Rico,PR,1309,6,2933404,America,40993,605
2020-09-21,Puerto_Rico,PR,845,3,2933404,America,41838,608
2020-09-22,Puerto_Rico,PR,638,1,2933404,America,42476,609
2020-09-23,Puerto_Rico,PR,120,4,2933404,America,42596,613
2020-09-24,Puerto_Rico,PR,55,4,2933404,America,42651,617
2020-09-25,Puerto_Rico,PR,1191,10,2933404,America,43842,627
2020-09-26,Puerto_Rico,PR,1063,8,2933404,America,44905,635
2020-09-27,Puerto_Rico,PR,508,7,2933404,America,45413,642
2020-09-28,Puerto_Rico,PR,891,2,2933404,America,46304,644
2020-09-29,Puerto_Rico,PR,1118,4,2933404,America,47422,648
2020-09-30,Puerto_Rico,PR,1045,6,2933404,America,48467,654
2020-10-01,Puerto_Rico,PR,288,7,2933404,America,48755,661
2020-10-02,Puerto_Rico,PR,312,4,2933404,America,49067,665
2020-10-03,Puerto_Rico,PR,0,0,2933404,America,49067,665
2020-10-04,Puerto_Rico,PR,541,16,2933404,America,49608,681
2020-10-05,Puerto_Rico,PR,1067,5,2933404,America,50675,686
2020-10-06,Puerto_Rico,PR,630,9,2933404,America,51305,695
2020-10-07,Puerto_Rico,PR,432,1,2933404,America,51737,696
2020-10-08,Puerto_Rico,PR,31,9,2933404,America,51768,705
2020-10-09,Puerto_Rico,PR,526,10,2933404,America,52294,715
2020-10-10,Puerto_Rico,PR,598,5,2933404,America,52892,720
2020-10-11,Puerto_Rico,PR,472,8,2933404,America,53364,728
2020-10-12,Puerto_Rico,PR,307,2,2933404,America,53671,730
2020-10-13,Puerto_Rico,PR,563,5,2933404,America,54234,735
2020-10-14,Puerto_Rico,PR,306,3,2933404,America,54540,738
2020-10-15,Puerto_Rico,PR,976,4,2933404,America,55516,742
2020-10-16,Puerto_Rico,PR,569,1,2933404,America,56085,743
2020-10-17,Puerto_Rico,PR,327,15,2933404,America,56412,758
2020-10-18,Puerto_Rico,PR,238,3,2933404,America,56650,761
2020-10-19,Puerto_Rico,PR,643,5,2933404,America,57293,766
2020-10-20,Puerto_Rico,PR,657,2,2933404,America,57950,768
2020-10-21,Puerto_Rico,PR,693,1,2933404,America,58643,769
2020-10-22,Puerto_Rico,PR,187,5,2933404,America,58830,774
2020-10-23,Puerto_Rico,PR,207,9,2933404,America,59037,783
2020-10-24,Puerto_Rico,PR,1947,8,2933404,America,60984,791
2020-10-25,Puerto_Rico,PR,296,3,2933404,America,61280,794
2020-10-26,Puerto_Rico,PR,1223,7,2933404,America,62503,801
2020-10-27,Puerto_Rico,PR,619,3,2933404,America,63122,804
2020-10-28,Puerto_Rico,PR,375,4,2933404,America,63497,808
2020-10-29,Puerto_Rico,PR,90,5,2933404,America,63587,813
2020-10-30,Puerto_Rico,PR,1211,1,2933404,America,64798,814
2020-10-31,Puerto_Rico,PR,945,6,2933404,America,65743,820
2020-11-01,Puerto_Rico,PR,385,2,2933404,America,66128,822
2020-11-02,Puerto_Rico,PR,533,10,2933404,America,66661,832
2020-11-03,Puerto_Rico,PR,1511,7,2933404,America,68172,839
2020-11-04,Puerto_Rico,PR,771,3,2933404,America,68943,842
2020-11-05,Puerto_Rico,PR,77,8,2933404,America,69020,850
2020-11-06,Puerto_Rico,PR,396,5,2933404,America,69416,855
2020-11-07,Puerto_Rico,PR,1103,7,2933404,America,70519,862
2020-11-08,Puerto_Rico,PR,936,0,2933404,America,71455,862
2020-11-09,Puerto_Rico,PR,610,10,2933404,America,72065,872
2020-11-10,Puerto_Rico,PR,688,10,2933404,America,72753,882
2020-11-11,Puerto_Rico,PR,316,7,2933404,America,73069,889
2020-11-12,Puerto_Rico,PR,154,12,2933404,America,73223,901
2020-11-13,Puerto_Rico,PR,1955,8,2933404,America,75178,909
2020-11-14,Puerto_Rico,PR,812,5,2933404,America,75990,914
2020-11-15,Puerto_Rico,PR,917,7,2933404,America,76907,921
2020-11-16,Puerto_Rico,PR,1117,14,2933404,America,78024,935
2020-11-17,Puerto_Rico,PR,873,7,2933404,America,78897,942
2020-11-18,Puerto_Rico,PR,703,9,2933404,America,79600,951
2020-11-19,Puerto_Rico,PR,571,20,2933404,America,80171,971
2020-11-20,Puerto_Rico,PR,472,11,2933404,America,80643,982
2020-11-21,Puerto_Rico,PR,1203,9,2933404,America,81846,991
2020-11-22,Puerto_Rico,PR,1295,21,2933404,America,83141,1012
2020-11-23,Puerto_Rico,PR,1783,5,2933404,America,84924,1017
2020-11-24,Puerto_Rico,PR,1129,15,2933404,America,86053,1032
2020-11-25,Puerto_Rico,PR,397,6,2933404,America,86450,1038
2020-11-26,Puerto_Rico,PR,161,14,2933404,America,86611,1052
2020-11-27,Puerto_Rico,PR,652,17,2933404,America,87263,1069
2020-11-28,Puerto_Rico,PR,1990,7,2933404,America,89253,1076
2020-11-29,Puerto_Rico,PR,1195,7,2933404,America,90448,1083
2020-11-30,Puerto_Rico,PR,147,11,2933404,America,90595,1094
2020-12-01,Puerto_Rico,PR,1290,12,2933404,America,91885,1106
2020-12-02,Puerto_Rico,PR,1041,16,2933404,America,92926,1122
2020-12-03,Puerto_Rico,PR,588,22,2933404,America,93514,1144
2020-12-04,Puerto_Rico,PR,437,11,2933404,America,93951,1155
2020-12-05,Puerto_Rico,PR,618,18,2933404,America,94569,1173
2020-12-06,Puerto_Rico,PR,1055,12,2933404,America,95624,1185
2020-12-07,Puerto_Rico,PR,2480,7,2933404,America,98104,1192
2020-12-08,Puerto_Rico,PR,1382,11,2933404,America,99486,1203
2020-12-09,Puerto_Rico,PR,1062,3,2933404,America,100548,1206
2020-12-10,Puerto_Rico,PR,721,13,2933404,America,101269,1219
2020-12-11,Puerto_Rico,PR,494,19,2933404,America,101763,1238
2020-12-12,Puerto_Rico,PR,2730,11,2933404,America,104493,1249
2020-12-13,Puerto_Rico,PR,1561,17,2933404,America,106054,1266
2020-12-14,Puerto_Rico,PR,1104,6,2933404,America,107158,1272
2020-03-06,Palestine,PS,7,0,4981422,Asia,7,0
2020-03-07,Palestine,PS,9,0,4981422,Asia,16,0
2020-03-08,Palestine,PS,3,0,4981422,Asia,19,0
2020-03-10,Palestine,PS,1,0,4981422,Asia,20,0
2020-03-11,Palestine,PS,9,0,4981422,Asia,29,0
2020-03-12,Palestine,PS,1,0,4981422,Asia,30,0
2020-03-14,Palestine,PS,5,0,4981422,Asia,35,0
2020-03-15,Palestine,PS,3,0,4981422,Asia,38,0
2020-03-16,Palestine,PS,0,0,4981422,Asia,38,0
2020-03-17,Palestine,PS,1,0,4981422,Asia,39,0
2020-03-18,Palestine,PS,2,0,4981422,Asia,41,0
2020-03-19,Palestine,PS,3,0,4981422,Asia,44,0
2020-03-20,Palestine,PS,3,0,4981422,Asia,47,0
2020-03-21,Palestine,PS,1,0,4981422,Asia,48,0
2020-03-22,Palestine,PS,4,0,4981422,Asia,52,0
2020-03-23,Palestine,PS,7,0,4981422,Asia,59,0
2020-03-24,Palestine,PS,0,0,4981422,Asia,59,0
2020-03-25,Palestine,PS,1,0,4981422,Asia,60,0
2020-03-26,Palestine,PS,2,0,4981422,Asia,62,0
2020-03-27,Palestine,PS,22,1,4981422,Asia,84,1
2020-03-28,Palestine,PS,7,0,4981422,Asia,91,1
2020-03-29,Palestine,PS,6,0,4981422,Asia,97,1
2020-03-30,Palestine,PS,9,0,4981422,Asia,106,1
2020-03-31,Palestine,PS,9,0,4981422,Asia,115,1
2020-04-01,Palestine,PS,2,0,4981422,Asia,117,1
2020-04-02,Palestine,PS,17,0,4981422,Asia,134,1
2020-04-03,Palestine,PS,21,0,4981422,Asia,155,1
2020-04-04,Palestine,PS,0,0,4981422,Asia,155,1
2020-04-06,Palestine,PS,62,0,4981422,Asia,217,1
2020-04-07,Palestine,PS,36,0,4981422,Asia,253,1
2020-04-08,Palestine,PS,7,0,4981422,Asia,260,1
2020-04-09,Palestine,PS,3,0,4981422,Asia,263,1
2020-04-10,Palestine,PS,0,0,4981422,Asia,263,1
2020-04-11,Palestine,PS,3,1,4981422,Asia,266,2
2020-04-12,Palestine,PS,2,0,4981422,Asia,268,2
2020-04-13,Palestine,PS,0,0,4981422,Asia,268,2
2020-04-14,Palestine,PS,0,0,4981422,Asia,268,2
2020-04-15,Palestine,PS,19,0,4981422,Asia,287,2
2020-04-16,Palestine,PS,4,0,4981422,Asia,291,2
2020-04-17,Palestine,PS,3,0,4981422,Asia,294,2
2020-04-18,Palestine,PS,13,0,4981422,Asia,307,2
2020-04-19,Palestine,PS,6,0,4981422,Asia,313,2
2020-04-20,Palestine,PS,9,0,4981422,Asia,322,2
2020-04-21,Palestine,PS,7,0,4981422,Asia,329,2
2020-04-22,Palestine,PS,0,0,4981422,Asia,329,2
2020-04-23,Palestine,PS,6,0,4981422,Asia,335,2
2020-04-24,Palestine,PS,1,0,4981422,Asia,336,2
2020-04-25,Palestine,PS,4,0,4981422,Asia,340,2
2020-04-26,Palestine,PS,2,0,4981422,Asia,342,2
2020-04-27,Palestine,PS,153,0,4981422,Asia,495,2
2020-04-28,Palestine,PS,0,0,4981422,Asia,495,2
2020-04-29,Palestine,PS,0,0,4981422,Asia,495,2
2020-04-30,Palestine,PS,12,0,4981422,Asia,507,2
2020-05-01,Palestine,PS,0,2,4981422,Asia,507,4
2020-05-02,Palestine,PS,10,0,4981422,Asia,517,4
2020-05-03,Palestine,PS,0,0,4981422,Asia,517,4
2020-05-04,Palestine,PS,5,0,4981422,Asia,522,4
2020-05-05,Palestine,PS,2,0,4981422,Asia,524,4
2020-05-06,Palestine,PS,14,0,4981422,Asia,538,4
2020-05-07,Palestine,PS,8,0,4981422,Asia,546,4
2020-05-08,Palestine,PS,1,0,4981422,Asia,547,4
2020-05-09,Palestine,PS,0,0,4981422,Asia,547,4
2020-05-10,Palestine,PS,0,0,4981422,Asia,547,4
2020-05-11,Palestine,PS,0,0,4981422,Asia,547,4
2020-05-12,Palestine,PS,0,0,4981422,Asia,547,4
2020-05-13,Palestine,PS,0,0,4981422,Asia,547,4
2020-05-14,Palestine,PS,1,0,4981422,Asia,548,4
2020-05-15,Palestine,PS,0,0,4981422,Asia,548,4
2020-05-16,Palestine,PS,6,0,4981422,Asia,554,4
2020-05-17,Palestine,PS,0,0,4981422,Asia,554,4
2020-05-18,Palestine,PS,6,0,4981422,Asia,560,4
2020-05-19,Palestine,PS,7,0,4981422,Asia,567,4
2020-05-20,Palestine,PS,3,0,4981422,Asia,570,4
2020-05-21,Palestine,PS,7,0,4981422,Asia,577,4
2020-05-22,Palestine,PS,25,0,4981422,Asia,602,4
2020-05-23,Palestine,PS,0,0,4981422,Asia,602,4
2020-05-24,Palestine,PS,0,1,4981422,Asia,602,5
2020-05-25,Palestine,PS,0,0,4981422,Asia,602,5
2020-05-26,Palestine,PS,0,0,4981422,Asia,602,5
2020-05-27,Palestine,PS,3,0,4981422,Asia,605,5
2020-05-28,Palestine,PS,8,0,4981422,Asia,613,5
2020-05-29,Palestine,PS,12,0,4981422,Asia,625,5
2020-05-30,Palestine,PS,0,0,4981422,Asia,625,5
2020-05-31,Palestine,PS,1,0,4981422,Asia,626,5
2020-06-01,Palestine,PS,1,0,4981422,Asia,627,5
2020-06-02,Palestine,PS,1,0,4981422,Asia,628,5
2020-06-03,Palestine,PS,2,0,4981422,Asia,630,5
2020-06-04,Palestine,PS,5,0,4981422,Asia,635,5
2020-06-05,Palestine,PS,8,0,4981422,Asia,643,5
2020-06-06,Palestine,PS,0,0,4981422,Asia,643,5
2020-06-07,Palestine,PS,0,0,4981422,Asia,643,5
2020-06-08,Palestine,PS,8,0,4981422,Asia,651,5
2020-06-09,Palestine,PS,1,0,4981422,Asia,652,5
2020-06-10,Palestine,PS,9,0,4981422,Asia,661,5
2020-06-11,Palestine,PS,4,0,4981422,Asia,665,5
2020-06-12,Palestine,PS,2,0,4981422,Asia,667,5
2020-06-13,Palestine,PS,2,0,4981422,Asia,669,5
2020-06-14,Palestine,PS,4,0,4981422,Asia,673,5
2020-06-15,Palestine,PS,0,0,4981422,Asia,673,5
2020-06-16,Palestine,PS,13,0,4981422,Asia,686,5
2020-06-17,Palestine,PS,4,0,4981422,Asia,690,5
2020-06-18,Palestine,PS,11,0,4981422,Asia,701,5
2020-06-19,Palestine,PS,94,0,4981422,Asia,795,5
2020-06-20,Palestine,PS,63,0,4981422,Asia,858,5
2020-06-21,Palestine,PS,121,0,4981422,Asia,979,5
2020-06-22,Palestine,PS,43,0,4981422,Asia,1022,5
2020-06-23,Palestine,PS,174,0,4981422,Asia,1196,5
2020-06-24,Palestine,PS,179,0,4981422,Asia,1375,5
2020-06-25,Palestine,PS,159,0,4981422,Asia,1534,5
2020-06-26,Palestine,PS,54,0,4981422,Asia,1588,5
2020-06-27,Palestine,PS,207,0,4981422,Asia,1795,5
2020-06-28,Palestine,PS,258,1,4981422,Asia,2053,6
2020-06-29,Palestine,PS,195,1,4981422,Asia,2248,7
2020-06-30,Palestine,PS,195,1,4981422,Asia,2443,8
2020-07-01,Palestine,PS,322,1,4981422,Asia,2765,9
2020-07-02,Palestine,PS,330,2,4981422,Asia,3095,11
2020-07-03,Palestine,PS,322,0,4981422,Asia,3417,11
2020-07-04,Palestine,PS,272,4,4981422,Asia,3689,15
2020-07-05,Palestine,PS,561,1,4981422,Asia,4250,16
2020-07-06,Palestine,PS,208,4,4981422,Asia,4458,20
2020-07-07,Palestine,PS,328,1,4981422,Asia,4786,21
2020-07-08,Palestine,PS,306,1,4981422,Asia,5092,22
2020-07-09,Palestine,PS,475,3,4981422,Asia,5567,25
2020-07-10,Palestine,PS,262,2,4981422,Asia,5829,27
2020-07-11,Palestine,PS,396,3,4981422,Asia,6225,30
2020-07-12,Palestine,PS,472,2,4981422,Asia,6697,32
2020-07-13,Palestine,PS,341,5,4981422,Asia,7038,37
2020-07-14,Palestine,PS,403,4,4981422,Asia,7441,41
2020-07-15,Palestine,PS,293,6,4981422,Asia,7734,47
2020-07-16,Palestine,PS,420,0,4981422,Asia,8154,47
2020-07-17,Palestine,PS,463,2,4981422,Asia,8617,49
2020-07-18,Palestine,PS,439,6,4981422,Asia,9056,55
2020-07-19,Palestine,PS,531,3,4981422,Asia,9587,58
2020-07-20,Palestine,PS,465,4,4981422,Asia,10052,62
2020-07-21,Palestine,PS,468,4,4981422,Asia,10520,66
2020-07-22,Palestine,PS,403,1,4981422,Asia,10923,67
2020-07-23,Palestine,PS,357,0,4981422,Asia,11280,67
2020-07-24,Palestine,PS,602,3,4981422,Asia,11882,70
2020-07-25,Palestine,PS,545,1,4981422,Asia,12427,71
2020-07-26,Palestine,PS,382,3,4981422,Asia,12809,74
2020-07-27,Palestine,PS,320,4,4981422,Asia,13129,78
2020-07-28,Palestine,PS,328,1,4981422,Asia,13457,79
2020-07-29,Palestine,PS,481,2,4981422,Asia,13938,81
2020-07-30,Palestine,PS,520,1,4981422,Asia,14458,82
2020-07-31,Palestine,PS,380,2,4981422,Asia,14838,84
2020-08-01,Palestine,PS,394,1,4981422,Asia,15232,85
2020-08-02,Palestine,PS,323,0,4981422,Asia,15555,85
2020-08-03,Palestine,PS,225,2,4981422,Asia,15780,87
2020-08-04,Palestine,PS,244,0,4981422,Asia,16024,87
2020-08-05,Palestine,PS,604,0,4981422,Asia,16628,87
2020-08-06,Palestine,PS,353,4,4981422,Asia,16981,91
2020-08-07,Palestine,PS,453,1,4981422,Asia,17434,92
2020-08-08,Palestine,PS,514,5,4981422,Asia,17948,97
2020-08-09,Palestine,PS,426,6,4981422,Asia,18374,103
2020-08-10,Palestine,PS,277,0,4981422,Asia,18651,103
2020-08-11,Palestine,PS,470,7,4981422,Asia,19121,110
2020-08-12,Palestine,PS,473,3,4981422,Asia,19594,113
2020-08-13,Palestine,PS,499,1,4981422,Asia,20093,114
2020-08-14,Palestine,PS,432,1,4981422,Asia,20525,115
2020-08-15,Palestine,PS,531,1,4981422,Asia,21056,116
2020-08-16,Palestine,PS,498,3,4981422,Asia,21554,119
2020-08-17,Palestine,PS,381,2,4981422,Asia,21935,121
2020-08-18,Palestine,PS,456,0,4981422,Asia,22391,121
2020-08-19,Palestine,PS,612,3,4981422,Asia,23003,124
2020-08-20,Palestine,PS,424,3,4981422,Asia,23427,127
2020-08-21,Palestine,PS,514,4,4981422,Asia,23941,131
2020-08-22,Palestine,PS,457,4,4981422,Asia,24398,135
2020-08-23,Palestine,PS,309,3,4981422,Asia,24707,138
2020-08-24,Palestine,PS,317,5,4981422,Asia,25024,143
2020-08-25,Palestine,PS,564,4,4981422,Asia,25588,147
2020-08-26,Palestine,PS,574,3,4981422,Asia,26162,150
2020-08-27,Palestine,PS,602,1,4981422,Asia,26764,151
2020-08-28,Palestine,PS,622,7,4981422,Asia,27386,158
2020-08-29,Palestine,PS,724,2,4981422,Asia,28110,160
2020-08-30,Palestine,PS,417,4,4981422,Asia,28527,164
2020-08-31,Palestine,PS,536,2,4981422,Asia,29063,166
2020-09-01,Palestine,PS,806,7,4981422,Asia,29869,173
2020-09-02,Palestine,PS,621,7,4981422,Asia,30490,180
2020-09-03,Palestine,PS,843,4,4981422,Asia,31333,184
2020-09-04,Palestine,PS,755,5,4981422,Asia,32088,189
2020-09-05,Palestine,PS,729,3,4981422,Asia,32817,192
2020-09-06,Palestine,PS,592,7,4981422,Asia,33409,199
2020-09-07,Palestine,PS,603,4,4981422,Asia,34012,203
2020-09-08,Palestine,PS,789,4,4981422,Asia,34801,207
2020-09-09,Palestine,PS,717,8,4981422,Asia,35518,215
2020-09-10,Palestine,PS,696,2,4981422,Asia,36214,217
2020-09-11,Palestine,PS,1000,7,4981422,Asia,37214,224
2020-09-12,Palestine,PS,652,10,4981422,Asia,37866,234
2020-09-13,Palestine,PS,650,4,4981422,Asia,38516,238
2020-09-14,Palestine,PS,994,12,4981422,Asia,39510,250
2020-09-15,Palestine,PS,788,5,4981422,Asia,40298,255
2020-09-16,Palestine,PS,1115,6,4981422,Asia,41413,261
2020-09-17,Palestine,PS,966,15,4981422,Asia,42379,276
2020-09-18,Palestine,PS,966,2,4981422,Asia,43345,278
2020-09-19,Palestine,PS,692,8,4981422,Asia,44037,286
2020-09-20,Palestine,PS,726,5,4981422,Asia,44763,291
2020-09-21,Palestine,PS,683,9,4981422,Asia,45446,300
2020-09-22,Palestine,PS,611,9,4981422,Asia,46057,309
2020-09-23,Palestine,PS,557,5,4981422,Asia,46614,314
2020-09-24,Palestine,PS,503,3,4981422,Asia,47117,317
2020-09-25,Palestine,PS,713,5,4981422,Asia,47830,322
2020-09-26,Palestine,PS,452,5,4981422,Asia,48282,327
2020-09-27,Palestine,PS,290,7,4981422,Asia,48572,334
2020-09-28,Palestine,PS,621,9,4981422,Asia,49193,343
2020-09-29,Palestine,PS,502,10,4981422,Asia,49695,353
2020-09-30,Palestine,PS,420,7,4981422,Asia,50115,360
2020-10-01,Palestine,PS,426,8,4981422,Asia,50541,368
2020-10-02,Palestine,PS,521,8,4981422,Asia,51062,376
2020-10-03,Palestine,PS,545,3,4981422,Asia,51607,379
2020-10-04,Palestine,PS,406,11,4981422,Asia,52013,390
2020-10-05,Palestine,PS,420,1,4981422,Asia,52433,391
2020-10-06,Palestine,PS,521,11,4981422,Asia,52954,402
2020-10-07,Palestine,PS,475,10,4981422,Asia,53429,412
2020-10-08,Palestine,PS,510,6,4981422,Asia,53939,418
2020-10-09,Palestine,PS,416,4,4981422,Asia,54355,422
2020-10-10,Palestine,PS,498,9,4981422,Asia,54853,431
2020-10-11,Palestine,PS,281,11,4981422,Asia,55134,442
2020-10-12,Palestine,PS,422,3,4981422,Asia,55556,445
2020-10-13,Palestine,PS,395,10,4981422,Asia,55951,455
2020-10-14,Palestine,PS,516,4,4981422,Asia,56467,459
2020-10-15,Palestine,PS,532,6,4981422,Asia,56999,465
2020-10-16,Palestine,PS,442,8,4981422,Asia,57441,473
2020-10-17,Palestine,PS,397,1,4981422,Asia,57838,474
2020-10-18,Palestine,PS,312,0,4981422,Asia,58150,474
2020-10-19,Palestine,PS,389,5,4981422,Asia,58539,479
2020-10-20,Palestine,PS,543,2,4981422,Asia,59082,481
2020-10-21,Palestine,PS,513,13,4981422,Asia,59595,494
2020-10-22,Palestine,PS,569,4,4981422,Asia,60164,498
2020-10-23,Palestine,PS,506,7,4981422,Asia,60670,505
2020-10-24,Palestine,PS,513,4,4981422,Asia,61183,509
2020-10-25,Palestine,PS,410,4,4981422,Asia,61593,513
2020-10-26,Palestine,PS,453,5,4981422,Asia,62046,518
2020-10-27,Palestine,PS,0,0,4981422,Asia,62046,518
2020-10-28,Palestine,PS,1118,10,4981422,Asia,63164,528
2020-10-29,Palestine,PS,450,8,4981422,Asia,63614,536
2020-10-30,Palestine,PS,623,8,4981422,Asia,64237,544
2020-10-31,Palestine,PS,505,8,4981422,Asia,64742,552
2020-11-01,Palestine,PS,566,2,4981422,Asia,65308,554
2020-11-02,Palestine,PS,494,7,4981422,Asia,65802,561
2020-11-03,Palestine,PS,749,4,4981422,Asia,66551,565
2020-11-04,Palestine,PS,633,8,4981422,Asia,67184,573
2020-11-05,Palestine,PS,734,3,4981422,Asia,67918,576
2020-11-06,Palestine,PS,582,4,4981422,Asia,68500,580
2020-11-07,Palestine,PS,681,3,4981422,Asia,69181,583
2020-11-08,Palestine,PS,431,1,4981422,Asia,69612,584
2020-11-09,Palestine,PS,549,3,4981422,Asia,70161,587
2020-11-10,Palestine,PS,680,6,4981422,Asia,70841,593
2020-11-11,Palestine,PS,660,14,4981422,Asia,71501,607
2020-11-12,Palestine,PS,643,5,4981422,Asia,72144,612
2020-11-13,Palestine,PS,823,5,4981422,Asia,72967,617
2020-11-14,Palestine,PS,730,6,4981422,Asia,73697,623
2020-11-15,Palestine,PS,653,10,4981422,Asia,74350,633
2020-11-16,Palestine,PS,976,7,4981422,Asia,75326,640
2020-11-17,Palestine,PS,836,7,4981422,Asia,76162,647
2020-11-18,Palestine,PS,1158,11,4981422,Asia,77320,658
2020-11-19,Palestine,PS,1251,9,4981422,Asia,78571,667
2020-11-20,Palestine,PS,1251,9,4981422,Asia,79822,676
2020-11-21,Palestine,PS,1472,8,4981422,Asia,81294,684
2020-11-22,Palestine,PS,1486,14,4981422,Asia,82780,698
2020-11-23,Palestine,PS,1560,16,4981422,Asia,84340,714
2020-11-24,Palestine,PS,1552,9,4981422,Asia,85892,723
2020-11-25,Palestine,PS,1946,17,4981422,Asia,87838,740
2020-11-26,Palestine,PS,1721,9,4981422,Asia,89559,749
2020-11-27,Palestine,PS,1173,14,4981422,Asia,90732,763
2020-11-28,Palestine,PS,0,0,4981422,Asia,90732,763
2020-11-29,Palestine,PS,0,0,4981422,Asia,90732,763
2020-11-30,Palestine,PS,6056,44,4981422,Asia,96788,807
2020-12-01,Palestine,PS,2752,18,4981422,Asia,99540,825
2020-12-02,Palestine,PS,1854,13,4981422,Asia,101394,838
2020-12-03,Palestine,PS,2180,16,4981422,Asia,103574,854
2020-12-04,Palestine,PS,2738,19,4981422,Asia,106312,873
2020-12-05,Palestine,PS,1968,17,4981422,Asia,108280,890
2020-12-06,Palestine,PS,1422,15,4981422,Asia,109702,905
2020-12-07,Palestine,PS,2333,17,4981422,Asia,112035,922
2020-12-08,Palestine,PS,1720,20,4981422,Asia,113755,942
2020-12-09,Palestine,PS,1599,19,4981422,Asia,115354,961
2020-12-10,Palestine,PS,1879,23,4981422,Asia,117233,984
2020-12-11,Palestine,PS,2187,24,4981422,Asia,119420,1008
2020-12-12,Palestine,PS,1743,21,4981422,Asia,121163,1029
2020-12-13,Palestine,PS,1855,33,4981422,Asia,123018,1062
2020-12-14,Palestine,PS,1639,17,4981422,Asia,124657,1079
2020-03-03,Portugal,PT,2,0,10276617,Europe,2,0
2020-03-04,Portugal,PT,2,0,10276617,Europe,4,0
2020-03-05,Portugal,PT,1,0,10276617,Europe,5,0
2020-03-06,Portugal,PT,4,0,10276617,Europe,9,0
2020-03-07,Portugal,PT,4,0,10276617,Europe,13,0
2020-03-08,Portugal,PT,8,0,10276617,Europe,21,0
2020-03-09,Portugal,PT,9,0,10276617,Europe,30,0
2020-03-10,Portugal,PT,9,0,10276617,Europe,39,0
2020-03-11,Portugal,PT,2,0,10276617,Europe,41,0
2020-03-12,Portugal,PT,18,0,10276617,Europe,59,0
2020-03-13,Portugal,PT,19,0,10276617,Europe,78,0
2020-03-14,Portugal,PT,34,0,10276617,Europe,112,0
2020-03-15,Portugal,PT,57,0,10276617,Europe,169,0
2020-03-16,Portugal,PT,76,0,10276617,Europe,245,0
2020-03-17,Portugal,PT,86,0,10276617,Europe,331,0
2020-03-18,Portugal,PT,117,1,10276617,Europe,448,1
2020-03-19,Portugal,PT,194,1,10276617,Europe,642,2
2020-03-20,Portugal,PT,143,1,10276617,Europe,785,3
2020-03-21,Portugal,PT,235,3,10276617,Europe,1020,6
2020-03-22,Portugal,PT,260,6,10276617,Europe,1280,12
2020-03-23,Portugal,PT,320,2,10276617,Europe,1600,14
2020-03-24,Portugal,PT,460,9,10276617,Europe,2060,23
2020-03-25,Portugal,PT,302,10,10276617,Europe,2362,33
2020-03-26,Portugal,PT,633,10,10276617,Europe,2995,43
2020-03-27,Portugal,PT,549,17,10276617,Europe,3544,60
2020-03-28,Portugal,PT,724,16,10276617,Europe,4268,76
2020-03-29,Portugal,PT,902,24,10276617,Europe,5170,100
2020-03-30,Portugal,PT,792,19,10276617,Europe,5962,119
2020-03-31,Portugal,PT,446,21,10276617,Europe,6408,140
2020-04-01,Portugal,PT,1035,20,10276617,Europe,7443,160
2020-04-02,Portugal,PT,808,27,10276617,Europe,8251,187
2020-04-03,Portugal,PT,783,22,10276617,Europe,9034,209
2020-04-04,Portugal,PT,852,37,10276617,Europe,9886,246
2020-04-05,Portugal,PT,638,20,10276617,Europe,10524,266
2020-04-06,Portugal,PT,754,29,10276617,Europe,11278,295
2020-04-07,Portugal,PT,452,16,10276617,Europe,11730,311
2020-04-08,Portugal,PT,712,34,10276617,Europe,12442,345
2020-04-09,Portugal,PT,699,35,10276617,Europe,13141,380
2020-04-10,Portugal,PT,815,29,10276617,Europe,13956,409
2020-04-11,Portugal,PT,1516,26,10276617,Europe,15472,435
2020-04-12,Portugal,PT,515,35,10276617,Europe,15987,470
2020-04-13,Portugal,PT,598,34,10276617,Europe,16585,504
2020-04-14,Portugal,PT,349,31,10276617,Europe,16934,535
2020-04-15,Portugal,PT,514,32,10276617,Europe,17448,567
2020-04-16,Portugal,PT,643,32,10276617,Europe,18091,599
2020-04-17,Portugal,PT,750,30,10276617,Europe,18841,629
2020-04-18,Portugal,PT,181,28,10276617,Europe,19022,657
2020-04-19,Portugal,PT,663,30,10276617,Europe,19685,687
2020-04-20,Portugal,PT,521,27,10276617,Europe,20206,714
2020-04-21,Portugal,PT,657,21,10276617,Europe,20863,735
2020-04-22,Portugal,PT,516,27,10276617,Europe,21379,762
2020-04-23,Portugal,PT,603,23,10276617,Europe,21982,785
2020-04-24,Portugal,PT,371,35,10276617,Europe,22353,820
2020-04-25,Portugal,PT,918,60,10276617,Europe,23271,880
2020-04-26,Portugal,PT,412,23,10276617,Europe,23683,903
2020-04-27,Portugal,PT,163,25,10276617,Europe,23846,928
2020-04-28,Portugal,PT,298,20,10276617,Europe,24144,948
2020-04-29,Portugal,PT,180,25,10276617,Europe,24324,973
2020-04-30,Portugal,PT,368,16,10276617,Europe,24692,989
2020-05-01,Portugal,PT,295,18,10276617,Europe,24987,1007
2020-05-02,Portugal,PT,364,0,10276617,Europe,25351,1007
2020-05-03,Portugal,PT,-161,16,10276617,Europe,25190,1023
2020-05-04,Portugal,PT,334,40,10276617,Europe,25524,1063
2020-05-05,Portugal,PT,0,0,10276617,Europe,25524,1063
2020-05-06,Portugal,PT,178,11,10276617,Europe,25702,1074
2020-05-07,Portugal,PT,480,15,10276617,Europe,26182,1089
2020-05-08,Portugal,PT,533,16,10276617,Europe,26715,1105
2020-05-09,Portugal,PT,553,9,10276617,Europe,27268,1114
2020-05-10,Portugal,PT,138,12,10276617,Europe,27406,1126
2020-05-11,Portugal,PT,175,9,10276617,Europe,27581,1135
2020-05-12,Portugal,PT,98,9,10276617,Europe,27679,1144
2020-05-13,Portugal,PT,234,19,10276617,Europe,27913,1163
2020-05-14,Portugal,PT,219,12,10276617,Europe,28132,1175
2020-05-15,Portugal,PT,187,9,10276617,Europe,28319,1184
2020-05-16,Portugal,PT,264,6,10276617,Europe,28583,1190
2020-05-17,Portugal,PT,227,13,10276617,Europe,28810,1203
2020-05-18,Portugal,PT,226,15,10276617,Europe,29036,1218
2020-05-19,Portugal,PT,173,13,10276617,Europe,29209,1231
2020-05-20,Portugal,PT,223,16,10276617,Europe,29432,1247
2020-05-21,Portugal,PT,228,16,10276617,Europe,29660,1263
2020-05-22,Portugal,PT,252,14,10276617,Europe,29912,1277
2020-05-23,Portugal,PT,288,12,10276617,Europe,30200,1289
2020-05-24,Portugal,PT,271,13,10276617,Europe,30471,1302
2020-05-25,Portugal,PT,152,14,10276617,Europe,30623,1316
2020-05-26,Portugal,PT,165,14,10276617,Europe,30788,1330
2020-05-27,Portugal,PT,219,12,10276617,Europe,31007,1342
2020-05-28,Portugal,PT,285,14,10276617,Europe,31292,1356
2020-05-29,Portugal,PT,304,13,10276617,Europe,31596,1369
2020-05-30,Portugal,PT,350,14,10276617,Europe,31946,1383
2020-05-31,Portugal,PT,257,13,10276617,Europe,32203,1396
2020-06-01,Portugal,PT,297,14,10276617,Europe,32500,1410
2020-06-02,Portugal,PT,200,14,10276617,Europe,32700,1424
2020-06-03,Portugal,PT,195,12,10276617,Europe,32895,1436
2020-06-04,Portugal,PT,366,11,10276617,Europe,33261,1447
2020-06-05,Portugal,PT,331,8,10276617,Europe,33592,1455
2020-06-06,Portugal,PT,377,10,10276617,Europe,33969,1465
2020-06-07,Portugal,PT,382,9,10276617,Europe,34351,1474
2020-06-08,Portugal,PT,142,5,10276617,Europe,34493,1479
2020-06-09,Portugal,PT,392,6,10276617,Europe,34885,1485
2020-06-10,Portugal,PT,421,7,10276617,Europe,35306,1492
2020-06-11,Portugal,PT,294,3,10276617,Europe,35600,1495
2020-06-12,Portugal,PT,310,9,10276617,Europe,35910,1504
2020-06-13,Portugal,PT,270,1,10276617,Europe,36180,1505
2020-06-14,Portugal,PT,283,7,10276617,Europe,36463,1512
2020-06-15,Portugal,PT,227,5,10276617,Europe,36690,1517
2020-06-16,Portugal,PT,346,3,10276617,Europe,37036,1520
2020-06-17,Portugal,PT,300,2,10276617,Europe,37336,1522
2020-06-18,Portugal,PT,336,1,10276617,Europe,37672,1523
2020-06-19,Portugal,PT,417,1,10276617,Europe,38089,1524
2020-06-20,Portugal,PT,375,3,10276617,Europe,38464,1527
2020-06-21,Portugal,PT,377,1,10276617,Europe,38841,1528
2020-06-22,Portugal,PT,292,2,10276617,Europe,39133,1530
2020-06-23,Portugal,PT,259,4,10276617,Europe,39392,1534
2020-06-24,Portugal,PT,345,6,10276617,Europe,39737,1540
2020-06-25,Portugal,PT,367,3,10276617,Europe,40104,1543
2020-06-26,Portugal,PT,311,6,10276617,Europe,40415,1549
2020-06-27,Portugal,PT,451,6,10276617,Europe,40866,1555
2020-06-28,Portugal,PT,323,6,10276617,Europe,41189,1561
2020-06-29,Portugal,PT,457,3,10276617,Europe,41646,1564
2020-06-30,Portugal,PT,266,4,10276617,Europe,41912,1568
2020-07-01,Portugal,PT,229,8,10276617,Europe,42141,1576
2020-07-02,Portugal,PT,313,3,10276617,Europe,42454,1579
2020-07-03,Portugal,PT,328,8,10276617,Europe,42782,1587
2020-07-04,Portugal,PT,374,11,10276617,Europe,43156,1598
2020-07-05,Portugal,PT,413,7,10276617,Europe,43569,1605
2020-07-06,Portugal,PT,328,9,10276617,Europe,43897,1614
2020-07-07,Portugal,PT,232,6,10276617,Europe,44129,1620
2020-07-08,Portugal,PT,287,9,10276617,Europe,44416,1629
2020-07-09,Portugal,PT,443,2,10276617,Europe,44859,1631
2020-07-10,Portugal,PT,418,13,10276617,Europe,45277,1644
2020-07-11,Portugal,PT,402,2,10276617,Europe,45679,1646
2020-07-12,Portugal,PT,542,8,10276617,Europe,46221,1654
2020-07-13,Portugal,PT,291,6,10276617,Europe,46512,1660
2020-07-14,Portugal,PT,306,2,10276617,Europe,46818,1662
2020-07-15,Portugal,PT,233,6,10276617,Europe,47051,1668
2020-07-16,Portugal,PT,375,8,10276617,Europe,47426,1676
2020-07-17,Portugal,PT,339,3,10276617,Europe,47765,1679
2020-07-18,Portugal,PT,312,3,10276617,Europe,48077,1682
2020-07-19,Portugal,PT,313,2,10276617,Europe,48390,1684
2020-07-20,Portugal,PT,246,5,10276617,Europe,48636,1689
2020-07-21,Portugal,PT,135,2,10276617,Europe,48771,1691
2020-07-22,Portugal,PT,127,6,10276617,Europe,48898,1697
2020-07-23,Portugal,PT,252,5,10276617,Europe,49150,1702
2020-07-24,Portugal,PT,229,3,10276617,Europe,49379,1705
2020-07-25,Portugal,PT,313,7,10276617,Europe,49692,1712
2020-07-26,Portugal,PT,263,4,10276617,Europe,49955,1716
2020-07-27,Portugal,PT,209,1,10276617,Europe,50164,1717
2020-07-28,Portugal,PT,135,2,10276617,Europe,50299,1719
2020-07-29,Portugal,PT,111,3,10276617,Europe,50410,1722
2020-07-30,Portugal,PT,203,3,10276617,Europe,50613,1725
2020-07-31,Portugal,PT,255,2,10276617,Europe,50868,1727
2020-08-01,Portugal,PT,204,8,10276617,Europe,51072,1735
2020-08-02,Portugal,PT,238,2,10276617,Europe,51310,1737
2020-08-03,Portugal,PT,153,1,10276617,Europe,51463,1738
2020-08-04,Portugal,PT,106,0,10276617,Europe,51569,1738
2020-08-05,Portugal,PT,112,1,10276617,Europe,51681,1739
2020-08-06,Portugal,PT,167,1,10276617,Europe,51848,1740
2020-08-07,Portugal,PT,213,3,10276617,Europe,52061,1743
2020-08-08,Portugal,PT,290,3,10276617,Europe,52351,1746
2020-08-09,Portugal,PT,186,4,10276617,Europe,52537,1750
2020-08-10,Portugal,PT,131,6,10276617,Europe,52668,1756
2020-08-11,Portugal,PT,157,3,10276617,Europe,52825,1759
2020-08-12,Portugal,PT,120,2,10276617,Europe,52945,1761
2020-08-13,Portugal,PT,278,3,10276617,Europe,53223,1764
2020-08-14,Portugal,PT,325,6,10276617,Europe,53548,1770
2020-08-15,Portugal,PT,235,2,10276617,Europe,53783,1772
2020-08-16,Portugal,PT,198,3,10276617,Europe,53981,1775
2020-08-17,Portugal,PT,121,3,10276617,Europe,54102,1778
2020-08-18,Portugal,PT,132,1,10276617,Europe,54234,1779
2020-08-19,Portugal,PT,214,5,10276617,Europe,54448,1784
2020-08-20,Portugal,PT,253,2,10276617,Europe,54701,1786
2020-08-21,Portugal,PT,291,2,10276617,Europe,54992,1788
2020-08-22,Portugal,PT,219,4,10276617,Europe,55211,1792
2020-08-23,Portugal,PT,241,2,10276617,Europe,55452,1794
2020-08-24,Portugal,PT,145,2,10276617,Europe,55597,1796
2020-08-25,Portugal,PT,123,5,10276617,Europe,55720,1801
2020-08-26,Portugal,PT,192,4,10276617,Europe,55912,1805
2020-08-27,Portugal,PT,362,2,10276617,Europe,56274,1807
2020-08-28,Portugal,PT,399,2,10276617,Europe,56673,1809
2020-08-29,Portugal,PT,401,6,10276617,Europe,57074,1815
2020-08-30,Portugal,PT,374,3,10276617,Europe,57448,1818
2020-08-31,Portugal,PT,320,1,10276617,Europe,57768,1819
2020-09-01,Portugal,PT,244,3,10276617,Europe,58012,1822
2020-09-02,Portugal,PT,231,2,10276617,Europe,58243,1824
2020-09-03,Portugal,PT,390,3,10276617,Europe,58633,1827
2020-09-04,Portugal,PT,418,2,10276617,Europe,59051,1829
2020-09-05,Portugal,PT,406,4,10276617,Europe,59457,1833
2020-09-06,Portugal,PT,486,5,10276617,Europe,59943,1838
2020-09-07,Portugal,PT,315,2,10276617,Europe,60258,1840
2020-09-08,Portugal,PT,249,3,10276617,Europe,60507,1843
2020-09-09,Portugal,PT,388,3,10276617,Europe,60895,1846
2020-09-10,Portugal,PT,646,3,10276617,Europe,61541,1849
2020-09-11,Portugal,PT,585,3,10276617,Europe,62126,1852
2020-09-12,Portugal,PT,687,3,10276617,Europe,62813,1855
2020-09-13,Portugal,PT,497,5,10276617,Europe,63310,1860
2020-09-14,Portugal,PT,673,7,10276617,Europe,63983,1867
2020-09-15,Portugal,PT,613,4,10276617,Europe,64596,1871
2020-09-16,Portugal,PT,425,4,10276617,Europe,65021,1875
2020-09-17,Portugal,PT,605,3,10276617,Europe,65626,1878
2020-09-18,Portugal,PT,770,10,10276617,Europe,66396,1888
2020-09-19,Portugal,PT,780,6,10276617,Europe,67176,1894
2020-09-20,Portugal,PT,849,5,10276617,Europe,68025,1899
2020-09-21,Portugal,PT,552,13,10276617,Europe,68577,1912
2020-09-22,Portugal,PT,623,8,10276617,Europe,69200,1920
2020-09-23,Portugal,PT,463,5,10276617,Europe,69663,1925
2020-09-24,Portugal,PT,802,3,10276617,Europe,70465,1928
2020-09-25,Portugal,PT,691,3,10276617,Europe,71156,1931
2020-09-26,Portugal,PT,899,5,10276617,Europe,72055,1936
2020-09-27,Portugal,PT,884,8,10276617,Europe,72939,1944
2020-09-28,Portugal,PT,665,9,10276617,Europe,73604,1953
2020-09-29,Portugal,PT,425,4,10276617,Europe,74029,1957
2020-09-30,Portugal,PT,688,6,10276617,Europe,74717,1963
2020-10-01,Portugal,PT,825,8,10276617,Europe,75542,1971
2020-10-02,Portugal,PT,854,6,10276617,Europe,76396,1977
2020-10-03,Portugal,PT,888,6,10276617,Europe,77284,1983
2020-10-04,Portugal,PT,963,12,10276617,Europe,78247,1995
2020-10-05,Portugal,PT,0,0,10276617,Europe,78247,1995
2020-10-06,Portugal,PT,1638,23,10276617,Europe,79885,2018
2020-10-07,Portugal,PT,427,14,10276617,Europe,80312,2032
2020-10-08,Portugal,PT,944,8,10276617,Europe,81256,2040
2020-10-09,Portugal,PT,1278,10,10276617,Europe,82534,2050
2020-10-10,Portugal,PT,1394,12,10276617,Europe,83928,2062
2020-10-11,Portugal,PT,1646,5,10276617,Europe,85574,2067
2020-10-12,Portugal,PT,1090,13,10276617,Europe,86664,2080
2020-10-13,Portugal,PT,1249,14,10276617,Europe,87913,2094
2020-10-14,Portugal,PT,1208,16,10276617,Europe,89121,2110
2020-10-15,Portugal,PT,2072,7,10276617,Europe,91193,2117
2020-10-16,Portugal,PT,2101,11,10276617,Europe,93294,2128
2020-10-17,Portugal,PT,2608,21,10276617,Europe,95902,2149
2020-10-18,Portugal,PT,2153,13,10276617,Europe,98055,2162
2020-10-19,Portugal,PT,1856,19,10276617,Europe,99911,2181
2020-10-20,Portugal,PT,1949,17,10276617,Europe,101860,2198
2020-10-21,Portugal,PT,1876,15,10276617,Europe,103736,2213
2020-10-22,Portugal,PT,2535,16,10276617,Europe,106271,2229
2020-10-23,Portugal,PT,3270,16,10276617,Europe,109541,2245
2020-10-24,Portugal,PT,2899,31,10276617,Europe,112440,2276
2020-10-25,Portugal,PT,3669,21,10276617,Europe,116109,2297
2020-10-26,Portugal,PT,2577,19,10276617,Europe,118686,2316
2020-10-27,Portugal,PT,2447,27,10276617,Europe,121133,2343
2020-10-28,Portugal,PT,3299,28,10276617,Europe,124432,2371
2020-10-29,Portugal,PT,3960,24,10276617,Europe,128392,2395
2020-10-30,Portugal,PT,4224,33,10276617,Europe,132616,2428
2020-10-31,Portugal,PT,4656,40,10276617,Europe,137272,2468
2020-11-01,Portugal,PT,4007,39,10276617,Europe,141279,2507
2020-11-02,Portugal,PT,3062,37,10276617,Europe,144341,2544
2020-11-03,Portugal,PT,2506,46,10276617,Europe,146847,2590
2020-11-04,Portugal,PT,2596,45,10276617,Europe,149443,2635
2020-11-05,Portugal,PT,7497,59,10276617,Europe,156940,2694
2020-11-06,Portugal,PT,4410,46,10276617,Europe,161350,2740
2020-11-07,Portugal,PT,5550,52,10276617,Europe,166900,2792
2020-11-08,Portugal,PT,6640,56,10276617,Europe,173540,2848
2020-11-09,Portugal,PT,5784,48,10276617,Europe,179324,2896
2020-11-10,Portugal,PT,4096,63,10276617,Europe,183420,2959
2020-11-11,Portugal,PT,3817,62,10276617,Europe,187237,3021
2020-11-12,Portugal,PT,4935,82,10276617,Europe,192172,3103
2020-11-13,Portugal,PT,5839,78,10276617,Europe,198011,3181
2020-11-14,Portugal,PT,6653,69,10276617,Europe,204664,3250
2020-11-15,Portugal,PT,6602,55,10276617,Europe,211266,3305
2020-11-16,Portugal,PT,6035,76,10276617,Europe,217301,3381
2020-11-17,Portugal,PT,8371,91,10276617,Europe,225672,3472
2020-11-18,Portugal,PT,4452,81,10276617,Europe,230124,3553
2020-11-19,Portugal,PT,5891,79,10276617,Europe,236015,3632
2020-11-20,Portugal,PT,6994,69,10276617,Europe,243009,3701
2020-11-21,Portugal,PT,6489,61,10276617,Europe,249498,3762
2020-11-22,Portugal,PT,6472,62,10276617,Europe,255970,3824
2020-11-23,Portugal,PT,4788,73,10276617,Europe,260758,3897
2020-11-24,Portugal,PT,4044,74,10276617,Europe,264802,3971
2020-11-25,Portugal,PT,3919,85,10276617,Europe,268721,4056
2020-11-26,Portugal,PT,5290,71,10276617,Europe,274011,4127
2020-11-27,Portugal,PT,6383,82,10276617,Europe,280394,4209
2020-11-28,Portugal,PT,5444,67,10276617,Europe,285838,4276
2020-11-29,Portugal,PT,4868,87,10276617,Europe,290706,4363
2020-11-30,Portugal,PT,4093,64,10276617,Europe,294799,4427
2020-12-01,Portugal,PT,3262,78,10276617,Europe,298061,4505
2020-12-02,Portugal,PT,2401,72,10276617,Europe,300462,4577
2020-12-03,Portugal,PT,3384,68,10276617,Europe,303846,4645
2020-12-04,Portugal,PT,3772,79,10276617,Europe,307618,4724
2020-12-05,Portugal,PT,4935,79,10276617,Europe,312553,4803
2020-12-06,Portugal,PT,6087,73,10276617,Europe,318640,4876
2020-12-07,Portugal,PT,3834,87,10276617,Europe,322474,4963
2020-12-08,Portugal,PT,2597,78,10276617,Europe,325071,5041
2020-12-09,Portugal,PT,2905,81,10276617,Europe,327976,5122
2020-12-10,Portugal,PT,4097,70,10276617,Europe,332073,5192
2020-12-11,Portugal,PT,3134,86,10276617,Europe,335207,5278
2020-12-12,Portugal,PT,5080,95,10276617,Europe,340287,5373
2020-12-13,Portugal,PT,4413,88,10276617,Europe,344700,5461
2020-12-14,Portugal,PT,4044,98,10276617,Europe,348744,5559
2020-03-08,Paraguay,PY,1,0,7044639,America,1,0
2020-03-11,Paraguay,PY,4,0,7044639,America,5,0
2020-03-13,Paraguay,PY,1,0,7044639,America,6,0
2020-03-14,Paraguay,PY,1,0,7044639,America,7,0
2020-03-16,Paraguay,PY,1,0,7044639,America,8,0
2020-03-17,Paraguay,PY,1,0,7044639,America,9,0
2020-03-18,Paraguay,PY,2,0,7044639,America,11,0
2020-03-19,Paraguay,PY,0,0,7044639,America,11,0
2020-03-20,Paraguay,PY,2,0,7044639,America,13,0
2020-03-21,Paraguay,PY,5,1,7044639,America,18,1
2020-03-22,Paraguay,PY,4,0,7044639,America,22,1
2020-03-23,Paraguay,PY,0,0,7044639,America,22,1
2020-03-24,Paraguay,PY,5,0,7044639,America,27,1
2020-03-25,Paraguay,PY,10,2,7044639,America,37,3
2020-03-26,Paraguay,PY,4,0,7044639,America,41,3
2020-03-27,Paraguay,PY,11,0,7044639,America,52,3
2020-03-28,Paraguay,PY,4,0,7044639,America,56,3
2020-03-29,Paraguay,PY,3,0,7044639,America,59,3
2020-03-30,Paraguay,PY,5,0,7044639,America,64,3
2020-03-31,Paraguay,PY,1,0,7044639,America,65,3
2020-04-01,Paraguay,PY,4,0,7044639,America,69,3
2020-04-02,Paraguay,PY,0,0,7044639,America,69,3
2020-04-03,Paraguay,PY,8,0,7044639,America,77,3
2020-04-04,Paraguay,PY,19,0,7044639,America,96,3
2020-04-05,Paraguay,PY,8,0,7044639,America,104,3
2020-04-06,Paraguay,PY,9,2,7044639,America,113,5
2020-04-07,Paraguay,PY,0,0,7044639,America,113,5
2020-04-08,Paraguay,PY,2,0,7044639,America,115,5
2020-04-09,Paraguay,PY,9,0,7044639,America,124,5
2020-04-10,Paraguay,PY,5,1,7044639,America,129,6
2020-04-11,Paraguay,PY,4,0,7044639,America,133,6
2020-04-12,Paraguay,PY,1,0,7044639,America,134,6
2020-04-13,Paraguay,PY,13,0,7044639,America,147,6
2020-04-14,Paraguay,PY,12,1,7044639,America,159,7
2020-04-15,Paraguay,PY,2,1,7044639,America,161,8
2020-04-16,Paraguay,PY,13,0,7044639,America,174,8
2020-04-17,Paraguay,PY,0,0,7044639,America,174,8
2020-04-18,Paraguay,PY,28,0,7044639,America,202,8
2020-04-19,Paraguay,PY,0,0,7044639,America,202,8
2020-04-20,Paraguay,PY,4,0,7044639,America,206,8
2020-04-21,Paraguay,PY,2,0,7044639,America,208,8
2020-04-22,Paraguay,PY,5,1,7044639,America,213,9
2020-04-23,Paraguay,PY,0,0,7044639,America,213,9
2020-04-24,Paraguay,PY,7,0,7044639,America,220,9
2020-04-25,Paraguay,PY,3,0,7044639,America,223,9
2020-04-26,Paraguay,PY,5,0,7044639,America,228,9
2020-04-27,Paraguay,PY,0,0,7044639,America,228,9
2020-04-28,Paraguay,PY,2,0,7044639,America,230,9
2020-04-29,Paraguay,PY,9,0,7044639,America,239,9
2020-04-30,Paraguay,PY,10,0,7044639,America,249,9
2020-05-01,Paraguay,PY,17,1,7044639,America,266,10
2020-05-02,Paraguay,PY,67,0,7044639,America,333,10
2020-05-03,Paraguay,PY,37,0,7044639,America,370,10
2020-05-04,Paraguay,PY,26,0,7044639,America,396,10
2020-05-05,Paraguay,PY,19,0,7044639,America,415,10
2020-05-06,Paraguay,PY,16,0,7044639,America,431,10
2020-05-07,Paraguay,PY,9,0,7044639,America,440,10
2020-05-08,Paraguay,PY,22,0,7044639,America,462,10
2020-05-09,Paraguay,PY,101,0,7044639,America,563,10
2020-05-10,Paraguay,PY,126,0,7044639,America,689,10
2020-05-11,Paraguay,PY,24,0,7044639,America,713,10
2020-05-12,Paraguay,PY,11,0,7044639,America,724,10
2020-05-13,Paraguay,PY,13,0,7044639,America,737,10
2020-05-14,Paraguay,PY,3,1,7044639,America,740,11
2020-05-15,Paraguay,PY,14,0,7044639,America,754,11
2020-05-16,Paraguay,PY,5,0,7044639,America,759,11
2020-05-17,Paraguay,PY,19,0,7044639,America,778,11
2020-05-18,Paraguay,PY,8,0,7044639,America,786,11
2020-05-19,Paraguay,PY,2,0,7044639,America,788,11
2020-05-20,Paraguay,PY,41,0,7044639,America,829,11
2020-05-21,Paraguay,PY,4,0,7044639,America,833,11
2020-05-22,Paraguay,PY,3,0,7044639,America,836,11
2020-05-23,Paraguay,PY,2,0,7044639,America,838,11
2020-05-24,Paraguay,PY,12,0,7044639,America,850,11
2020-05-25,Paraguay,PY,12,0,7044639,America,862,11
2020-05-26,Paraguay,PY,3,0,7044639,America,865,11
2020-05-27,Paraguay,PY,12,0,7044639,America,877,11
2020-05-28,Paraguay,PY,7,0,7044639,America,884,11
2020-05-29,Paraguay,PY,16,0,7044639,America,900,11
2020-05-30,Paraguay,PY,17,0,7044639,America,917,11
2020-05-31,Paraguay,PY,47,0,7044639,America,964,11
2020-06-01,Paraguay,PY,22,0,7044639,America,986,11
2020-06-02,Paraguay,PY,9,0,7044639,America,995,11
2020-06-03,Paraguay,PY,18,0,7044639,America,1013,11
2020-06-04,Paraguay,PY,57,0,7044639,America,1070,11
2020-06-05,Paraguay,PY,16,0,7044639,America,1086,11
2020-06-06,Paraguay,PY,1,0,7044639,America,1087,11
2020-06-07,Paraguay,PY,3,0,7044639,America,1090,11
2020-06-08,Paraguay,PY,45,0,7044639,America,1135,11
2020-06-09,Paraguay,PY,10,0,7044639,America,1145,11
2020-06-10,Paraguay,PY,42,0,7044639,America,1187,11
2020-06-11,Paraguay,PY,15,0,7044639,America,1202,11
2020-06-12,Paraguay,PY,28,0,7044639,America,1230,11
2020-06-13,Paraguay,PY,24,0,7044639,America,1254,11
2020-06-14,Paraguay,PY,7,0,7044639,America,1261,11
2020-06-15,Paraguay,PY,28,0,7044639,America,1289,11
2020-06-16,Paraguay,PY,0,1,7044639,America,1289,12
2020-06-17,Paraguay,PY,14,1,7044639,America,1303,13
2020-06-18,Paraguay,PY,5,0,7044639,America,1308,13
2020-06-19,Paraguay,PY,22,0,7044639,America,1330,13
2020-06-20,Paraguay,PY,6,0,7044639,America,1336,13
2020-06-21,Paraguay,PY,26,0,7044639,America,1362,13
2020-06-22,Paraguay,PY,17,0,7044639,America,1379,13
2020-06-23,Paraguay,PY,13,0,7044639,America,1392,13
2020-06-24,Paraguay,PY,30,0,7044639,America,1422,13
2020-06-25,Paraguay,PY,106,0,7044639,America,1528,13
2020-06-26,Paraguay,PY,41,0,7044639,America,1569,13
2020-06-27,Paraguay,PY,142,0,7044639,America,1711,13
2020-06-28,Paraguay,PY,231,2,7044639,America,1942,15
2020-06-29,Paraguay,PY,185,0,7044639,America,2127,15
2020-06-30,Paraguay,PY,64,1,7044639,America,2191,16
2020-07-01,Paraguay,PY,30,1,7044639,America,2221,17
2020-07-02,Paraguay,PY,39,2,7044639,America,2260,19
2020-07-03,Paraguay,PY,43,0,7044639,America,2303,19
2020-07-04,Paraguay,PY,46,0,7044639,America,2349,19
2020-07-05,Paraguay,PY,36,1,7044639,America,2385,20
2020-07-06,Paraguay,PY,42,0,7044639,America,2427,20
2020-07-07,Paraguay,PY,29,0,7044639,America,2456,20
2020-07-08,Paraguay,PY,46,0,7044639,America,2502,20
2020-07-09,Paraguay,PY,52,0,7044639,America,2554,20
2020-07-10,Paraguay,PY,84,0,7044639,America,2638,20
2020-07-11,Paraguay,PY,98,0,7044639,America,2736,20
2020-07-12,Paraguay,PY,84,1,7044639,America,2820,21
2020-07-13,Paraguay,PY,128,1,7044639,America,2948,22
2020-07-14,Paraguay,PY,32,3,7044639,America,2980,25
2020-07-15,Paraguay,PY,94,0,7044639,America,3074,25
2020-07-16,Paraguay,PY,124,0,7044639,America,3198,25
2020-07-17,Paraguay,PY,144,2,7044639,America,3342,27
2020-07-18,Paraguay,PY,115,1,7044639,America,3457,28
2020-07-19,Paraguay,PY,172,1,7044639,America,3629,29
2020-07-20,Paraguay,PY,92,2,7044639,America,3721,31
2020-07-21,Paraguay,PY,27,2,7044639,America,3748,33
2020-07-22,Paraguay,PY,69,2,7044639,America,3817,35
2020-07-23,Paraguay,PY,183,1,7044639,America,4000,36
2020-07-24,Paraguay,PY,113,0,7044639,America,4113,36
2020-07-25,Paraguay,PY,111,2,7044639,America,4224,38
2020-07-26,Paraguay,PY,104,2,7044639,America,4328,40
2020-07-27,Paraguay,PY,116,1,7044639,America,4444,41
2020-07-28,Paraguay,PY,104,2,7044639,America,4548,43
2020-07-29,Paraguay,PY,126,2,7044639,America,4674,45
2020-07-30,Paraguay,PY,192,1,7044639,America,4866,46
2020-07-31,Paraguay,PY,341,1,7044639,America,5207,47
2020-08-01,Paraguay,PY,131,2,7044639,America,5338,49
2020-08-02,Paraguay,PY,147,3,7044639,America,5485,52
2020-08-03,Paraguay,PY,159,0,7044639,America,5644,52
2020-08-04,Paraguay,PY,80,3,7044639,America,5724,55
2020-08-05,Paraguay,PY,128,4,7044639,America,5852,59
2020-08-06,Paraguay,PY,208,2,7044639,America,6060,61
2020-08-07,Paraguay,PY,315,5,7044639,America,6375,66
2020-08-08,Paraguay,PY,133,3,7044639,America,6508,69
2020-08-09,Paraguay,PY,197,3,7044639,America,6705,72
2020-08-10,Paraguay,PY,202,3,7044639,America,6907,75
2020-08-11,Paraguay,PY,327,7,7044639,America,7234,82
2020-08-12,Paraguay,PY,285,4,7044639,America,7519,86
2020-08-13,Paraguay,PY,499,7,7044639,America,8018,93
2020-08-14,Paraguay,PY,371,4,7044639,America,8389,97
2020-08-15,Paraguay,PY,688,11,7044639,America,9077,108
2020-08-16,Paraguay,PY,304,19,7044639,America,9381,127
2020-08-17,Paraguay,PY,410,11,7044639,America,9791,138
2020-08-18,Paraguay,PY,344,7,7044639,America,10135,145
2020-08-19,Paraguay,PY,471,16,7044639,America,10606,161
2020-08-20,Paraguay,PY,527,4,7044639,America,11133,165
2020-08-21,Paraguay,PY,684,5,7044639,America,11817,170
2020-08-22,Paraguay,PY,719,12,7044639,America,12536,182
2020-08-23,Paraguay,PY,438,10,7044639,America,12974,192
2020-08-24,Paraguay,PY,259,13,7044639,America,13233,205
2020-08-25,Paraguay,PY,369,14,7044639,America,13602,219
2020-08-26,Paraguay,PY,626,12,7044639,America,14228,231
2020-08-27,Paraguay,PY,644,16,7044639,America,14872,247
2020-08-28,Paraguay,PY,418,18,7044639,America,15290,265
2020-08-29,Paraguay,PY,584,15,7044639,America,15874,280
2020-08-30,Paraguay,PY,600,14,7044639,America,16474,294
2020-08-31,Paraguay,PY,721,14,7044639,America,17195,308
2020-09-01,Paraguay,PY,467,18,7044639,America,17662,326
2020-09-02,Paraguay,PY,676,22,7044639,America,18338,348
2020-09-03,Paraguay,PY,800,10,7044639,America,19138,358
2020-09-04,Paraguay,PY,821,15,7044639,America,19959,373
2020-09-05,Paraguay,PY,695,25,7044639,America,20654,398
2020-09-06,Paraguay,PY,1217,14,7044639,America,21871,412
2020-09-07,Paraguay,PY,615,23,7044639,America,22486,435
2020-09-08,Paraguay,PY,867,14,7044639,America,23353,449
2020-09-09,Paraguay,PY,861,14,7044639,America,24214,463
2020-09-10,Paraguay,PY,812,11,7044639,America,25026,474
2020-09-11,Paraguay,PY,605,11,7044639,America,25631,485
2020-09-12,Paraguay,PY,881,11,7044639,America,26512,496
2020-09-13,Paraguay,PY,812,18,7044639,America,27324,514
2020-09-14,Paraguay,PY,493,11,7044639,America,27817,525
2020-09-15,Paraguay,PY,550,14,7044639,America,28367,539
2020-09-16,Paraguay,PY,931,13,7044639,America,29298,552
2020-09-17,Paraguay,PY,1121,14,7044639,America,30419,566
2020-09-18,Paraguay,PY,694,18,7044639,America,31113,584
2020-09-19,Paraguay,PY,1014,27,7044639,America,32127,611
2020-09-20,Paraguay,PY,888,25,7044639,America,33015,636
2020-09-21,Paraguay,PY,505,23,7044639,America,33520,659
2020-09-22,Paraguay,PY,740,17,7044639,America,34260,676
2020-09-23,Paraguay,PY,568,29,7044639,America,34828,705
2020-09-24,Paraguay,PY,743,22,7044639,America,35571,727
2020-09-25,Paraguay,PY,833,16,7044639,America,36404,743
2020-09-26,Paraguay,PY,822,18,7044639,America,37226,761
2020-09-27,Paraguay,PY,696,21,7044639,America,37922,782
2020-09-28,Paraguay,PY,762,21,7044639,America,38684,803
2020-09-29,Paraguay,PY,748,15,7044639,America,39432,818
2020-09-30,Paraguay,PY,669,23,7044639,America,40101,841
2020-10-01,Paraguay,PY,657,16,7044639,America,40758,857
2020-10-02,Paraguay,PY,1041,12,7044639,America,41799,869
2020-10-03,Paraguay,PY,885,21,7044639,America,42684,890
2020-10-04,Paraguay,PY,768,23,7044639,America,43452,913
2020-10-05,Paraguay,PY,730,16,7044639,America,44182,929
2020-10-06,Paraguay,PY,533,18,7044639,America,44715,947
2020-10-07,Paraguay,PY,932,19,7044639,America,45647,966
2020-10-08,Paraguay,PY,788,23,7044639,America,46435,989
2020-10-09,Paraguay,PY,881,23,7044639,America,47316,1012
2020-10-10,Paraguay,PY,959,33,7044639,America,48275,1045
2020-10-11,Paraguay,PY,703,20,7044639,America,48978,1065
2020-10-12,Paraguay,PY,697,12,7044639,America,49675,1077
2020-10-13,Paraguay,PY,669,19,7044639,America,50344,1096
2020-10-14,Paraguay,PY,853,12,7044639,America,51197,1108
2020-10-15,Paraguay,PY,648,23,7044639,America,51845,1131
2020-10-16,Paraguay,PY,751,19,7044639,America,52596,1150
2020-10-17,Paraguay,PY,886,16,7044639,America,53482,1166
2020-10-18,Paraguay,PY,533,13,7044639,America,54015,1179
2020-10-19,Paraguay,PY,709,9,7044639,America,54724,1188
2020-10-20,Paraguay,PY,728,19,7044639,America,55452,1207
2020-10-21,Paraguay,PY,621,24,7044639,America,56073,1231
2020-10-22,Paraguay,PY,746,19,7044639,America,56819,1250
2020-10-23,Paraguay,PY,707,17,7044639,America,57526,1267
2020-10-24,Paraguay,PY,733,11,7044639,America,58259,1278
2020-10-25,Paraguay,PY,784,15,7044639,America,59043,1293
2020-10-26,Paraguay,PY,551,16,7044639,America,59594,1309
2020-10-27,Paraguay,PY,0,0,7044639,America,59594,1309
2020-10-28,Paraguay,PY,963,18,7044639,America,60557,1327
2020-10-29,Paraguay,PY,733,32,7044639,America,61290,1359
2020-10-30,Paraguay,PY,0,0,7044639,America,61290,1359
2020-10-31,Paraguay,PY,1306,28,7044639,America,62596,1387
2020-11-01,Paraguay,PY,589,17,7044639,America,63185,1404
2020-11-02,Paraguay,PY,546,14,7044639,America,63731,1418
2020-11-03,Paraguay,PY,425,11,7044639,America,64156,1429
2020-11-04,Paraguay,PY,472,12,7044639,America,64628,1441
2020-11-05,Paraguay,PY,630,13,7044639,America,65258,1454
2020-11-06,Paraguay,PY,520,8,7044639,America,65778,1462
2020-11-07,Paraguay,PY,703,10,7044639,America,66481,1472
2020-11-08,Paraguay,PY,460,7,7044639,America,66941,1479
2020-11-09,Paraguay,PY,648,11,7044639,America,67589,1490
2020-11-10,Paraguay,PY,359,12,7044639,America,67948,1502
2020-11-11,Paraguay,PY,549,14,7044639,America,68497,1516
2020-11-12,Paraguay,PY,609,16,7044639,America,69106,1532
2020-11-13,Paraguay,PY,547,11,7044639,America,69653,1543
2020-11-14,Paraguay,PY,739,13,7044639,America,70392,1556
2020-11-15,Paraguay,PY,673,13,7044639,America,71065,1569
2020-11-16,Paraguay,PY,509,18,7044639,America,71574,1587
2020-11-17,Paraguay,PY,525,15,7044639,America,72099,1602
2020-11-18,Paraguay,PY,758,11,7044639,America,72857,1613
2020-11-19,Paraguay,PY,782,11,7044639,America,73639,1624
2020-11-20,Paraguay,PY,856,12,7044639,America,74495,1636
2020-11-21,Paraguay,PY,563,11,7044639,America,75058,1647
2020-11-22,Paraguay,PY,799,5,7044639,America,75857,1652
2020-11-23,Paraguay,PY,619,5,7044639,America,76476,1657
2020-11-24,Paraguay,PY,596,8,7044639,America,77072,1665
2020-11-25,Paraguay,PY,819,12,7044639,America,77891,1677
2020-11-26,Paraguay,PY,987,14,7044639,America,78878,1691
2020-11-27,Paraguay,PY,639,13,7044639,America,79517,1704
2020-11-28,Paraguay,PY,919,16,7044639,America,80436,1720
2020-11-29,Paraguay,PY,695,11,7044639,America,81131,1731
2020-11-30,Paraguay,PY,775,12,7044639,America,81906,1743
2020-12-01,Paraguay,PY,518,13,7044639,America,82424,1756
2020-12-02,Paraguay,PY,1055,15,7044639,America,83479,1771
2020-12-03,Paraguay,PY,1003,12,7044639,America,84482,1783
2020-12-04,Paraguay,PY,995,13,7044639,America,85477,1796
2020-12-05,Paraguay,PY,0,0,7044639,America,85477,1796
2020-12-06,Paraguay,PY,1736,37,7044639,America,87213,1833
2020-12-07,Paraguay,PY,707,20,7044639,America,87920,1853
2020-12-08,Paraguay,PY,803,19,7044639,America,88723,1872
2020-12-09,Paraguay,PY,698,15,7044639,America,89421,1887
2020-12-10,Paraguay,PY,725,14,7044639,America,90146,1901
2020-12-11,Paraguay,PY,812,13,7044639,America,90958,1914
2020-12-12,Paraguay,PY,1155,13,7044639,America,92113,1927
2020-12-13,Paraguay,PY,800,10,7044639,America,92913,1937
2020-12-14,Paraguay,PY,669,16,7044639,America,93582,1953
2019-12-31,Qatar,QA,0,0,2832071,Asia,0,0
2020-01-01,Qatar,QA,0,0,2832071,Asia,0,0
2020-01-02,Qatar,QA,0,0,2832071,Asia,0,0
2020-01-03,Qatar,QA,0,0,2832071,Asia,0,0
2020-01-04,Qatar,QA,0,0,2832071,Asia,0,0
2020-01-05,Qatar,QA,0,0,2832071,Asia,0,0
2020-01-06,Qatar,QA,0,0,2832071,Asia,0,0
2020-01-07,Qatar,QA,0,0,2832071,Asia,0,0
2020-01-08,Qatar,QA,0,0,2832071,Asia,0,0
2020-01-09,Qatar,QA,0,0,2832071,Asia,0,0
2020-01-10,Qatar,QA,0,0,2832071,Asia,0,0
2020-01-11,Qatar,QA,0,0,2832071,Asia,0,0
2020-01-12,Qatar,QA,0,0,2832071,Asia,0,0
2020-01-13,Qatar,QA,0,0,2832071,Asia,0,0
2020-01-14,Qatar,QA,0,0,2832071,Asia,0,0
2020-01-15,Qatar,QA,0,0,2832071,Asia,0,0
2020-01-16,Qatar,QA,0,0,2832071,Asia,0,0
2020-01-17,Qatar,QA,0,0,2832071,Asia,0,0
2020-01-18,Qatar,QA,0,0,2832071,Asia,0,0
2020-01-19,Qatar,QA,0,0,2832071,Asia,0,0
2020-01-20,Qatar,QA,0,0,2832071,Asia,0,0
2020-01-21,Qatar,QA,0,0,2832071,Asia,0,0
2020-01-22,Qatar,QA,0,0,2832071,Asia,0,0
2020-01-23,Qatar,QA,0,0,2832071,Asia,0,0
2020-01-24,Qatar,QA,0,0,2832071,Asia,0,0
2020-01-25,Qatar,QA,0,0,2832071,Asia,0,0
2020-01-26,Qatar,QA,0,0,2832071,Asia,0,0
2020-01-27,Qatar,QA,0,0,2832071,Asia,0,0
2020-01-28,Qatar,QA,0,0,2832071,Asia,0,0
2020-01-29,Qatar,QA,0,0,2832071,Asia,0,0
2020-01-30,Qatar,QA,0,0,2832071,Asia,0,0
2020-01-31,Qatar,QA,0,0,2832071,Asia,0,0
2020-02-01,Qatar,QA,0,0,2832071,Asia,0,0
2020-02-02,Qatar,QA,0,0,2832071,Asia,0,0
2020-02-03,Qatar,QA,0,0,2832071,Asia,0,0
2020-02-04,Qatar,QA,0,0,2832071,Asia,0,0
2020-02-05,Qatar,QA,0,0,2832071,Asia,0,0
2020-02-06,Qatar,QA,0,0,2832071,Asia,0,0
2020-02-07,Qatar,QA,0,0,2832071,Asia,0,0
2020-02-08,Qatar,QA,0,0,2832071,Asia,0,0
2020-02-09,Qatar,QA,0,0,2832071,Asia,0,0
2020-02-10,Qatar,QA,0,0,2832071,Asia,0,0
2020-02-11,Qatar,QA,0,0,2832071,Asia,0,0
2020-02-12,Qatar,QA,0,0,2832071,Asia,0,0
2020-02-13,Qatar,QA,0,0,2832071,Asia,0,0
2020-02-14,Qatar,QA,0,0,2832071,Asia,0,0
2020-02-15,Qatar,QA,0,0,2832071,Asia,0,0
2020-02-16,Qatar,QA,0,0,2832071,Asia,0,0
2020-02-17,Qatar,QA,0,0,2832071,Asia,0,0
2020-02-18,Qatar,QA,0,0,2832071,Asia,0,0
2020-02-19,Qatar,QA,0,0,2832071,Asia,0,0
2020-02-20,Qatar,QA,0,0,2832071,Asia,0,0
2020-02-21,Qatar,QA,0,0,2832071,Asia,0,0
2020-02-22,Qatar,QA,0,0,2832071,Asia,0,0
2020-02-23,Qatar,QA,0,0,2832071,Asia,0,0
2020-02-24,Qatar,QA,0,0,2832071,Asia,0,0
2020-02-25,Qatar,QA,0,0,2832071,Asia,0,0
2020-02-26,Qatar,QA,0,0,2832071,Asia,0,0
2020-02-27,Qatar,QA,0,0,2832071,Asia,0,0
2020-02-28,Qatar,QA,0,0,2832071,Asia,0,0
2020-02-29,Qatar,QA,0,0,2832071,Asia,0,0
2020-03-01,Qatar,QA,1,0,2832071,Asia,1,0
2020-03-02,Qatar,QA,2,0,2832071,Asia,3,0
2020-03-04,Qatar,QA,5,0,2832071,Asia,8,0
2020-03-07,Qatar,QA,3,0,2832071,Asia,11,0
2020-03-08,Qatar,QA,1,0,2832071,Asia,12,0
2020-03-09,Qatar,QA,3,0,2832071,Asia,15,0
2020-03-10,Qatar,QA,3,0,2832071,Asia,18,0
2020-03-11,Qatar,QA,6,0,2832071,Asia,24,0
2020-03-12,Qatar,QA,238,0,2832071,Asia,262,0
2020-03-14,Qatar,QA,58,0,2832071,Asia,320,0
2020-03-15,Qatar,QA,17,0,2832071,Asia,337,0
2020-03-16,Qatar,QA,64,0,2832071,Asia,401,0
2020-03-17,Qatar,QA,38,0,2832071,Asia,439,0
2020-03-18,Qatar,QA,3,0,2832071,Asia,442,0
2020-03-19,Qatar,QA,10,0,2832071,Asia,452,0
2020-03-20,Qatar,QA,8,0,2832071,Asia,460,0
2020-03-21,Qatar,QA,10,0,2832071,Asia,470,0
2020-03-22,Qatar,QA,11,0,2832071,Asia,481,0
2020-03-23,Qatar,QA,13,0,2832071,Asia,494,0
2020-03-24,Qatar,QA,7,0,2832071,Asia,501,0
2020-03-25,Qatar,QA,25,0,2832071,Asia,526,0
2020-03-26,Qatar,QA,11,0,2832071,Asia,537,0
2020-03-27,Qatar,QA,12,0,2832071,Asia,549,0
2020-03-28,Qatar,QA,13,0,2832071,Asia,562,0
2020-03-29,Qatar,QA,28,1,2832071,Asia,590,1
2020-03-30,Qatar,QA,44,0,2832071,Asia,634,1
2020-03-31,Qatar,QA,59,0,2832071,Asia,693,1
2020-04-01,Qatar,QA,88,1,2832071,Asia,781,2
2020-04-02,Qatar,QA,54,0,2832071,Asia,835,2
2020-04-03,Qatar,QA,114,1,2832071,Asia,949,3
2020-04-04,Qatar,QA,0,0,2832071,Asia,949,3
2020-04-05,Qatar,QA,376,0,2832071,Asia,1325,3
2020-04-06,Qatar,QA,279,1,2832071,Asia,1604,4
2020-04-07,Qatar,QA,228,0,2832071,Asia,1832,4
2020-04-08,Qatar,QA,225,2,2832071,Asia,2057,6
2020-04-09,Qatar,QA,153,0,2832071,Asia,2210,6
2020-04-10,Qatar,QA,166,0,2832071,Asia,2376,6
2020-04-11,Qatar,QA,136,0,2832071,Asia,2512,6
2020-04-12,Qatar,QA,216,0,2832071,Asia,2728,6
2020-04-13,Qatar,QA,251,1,2832071,Asia,2979,7
2020-04-14,Qatar,QA,252,0,2832071,Asia,3231,7
2020-04-15,Qatar,QA,197,0,2832071,Asia,3428,7
2020-04-16,Qatar,QA,283,0,2832071,Asia,3711,7
2020-04-17,Qatar,QA,392,0,2832071,Asia,4103,7
2020-04-18,Qatar,QA,560,0,2832071,Asia,4663,7
2020-04-19,Qatar,QA,345,1,2832071,Asia,5008,8
2020-04-20,Qatar,QA,440,0,2832071,Asia,5448,8
2020-04-21,Qatar,QA,567,1,2832071,Asia,6015,9
2020-04-22,Qatar,QA,518,0,2832071,Asia,6533,9
2020-04-23,Qatar,QA,608,1,2832071,Asia,7141,10
2020-04-24,Qatar,QA,623,0,2832071,Asia,7764,10
2020-04-25,Qatar,QA,761,0,2832071,Asia,8525,10
2020-04-26,Qatar,QA,833,0,2832071,Asia,9358,10
2020-04-27,Qatar,QA,929,0,2832071,Asia,10287,10
2020-04-28,Qatar,QA,957,0,2832071,Asia,11244,10
2020-04-29,Qatar,QA,677,0,2832071,Asia,11921,10
2020-04-30,Qatar,QA,643,0,2832071,Asia,12564,10
2020-05-01,Qatar,QA,845,0,2832071,Asia,13409,10
2020-05-02,Qatar,QA,687,2,2832071,Asia,14096,12
2020-05-03,Qatar,QA,776,0,2832071,Asia,14872,12
2020-05-04,Qatar,QA,679,0,2832071,Asia,15551,12
2020-05-05,Qatar,QA,640,0,2832071,Asia,16191,12
2020-05-06,Qatar,QA,951,0,2832071,Asia,17142,12
2020-05-07,Qatar,QA,830,0,2832071,Asia,17972,12
2020-05-08,Qatar,QA,918,0,2832071,Asia,18890,12
2020-05-09,Qatar,QA,1311,0,2832071,Asia,20201,12
2020-05-10,Qatar,QA,1130,1,2832071,Asia,21331,13
2020-05-11,Qatar,QA,1189,1,2832071,Asia,22520,14
2020-05-12,Qatar,QA,1103,0,2832071,Asia,23623,14
2020-05-13,Qatar,QA,1526,0,2832071,Asia,25149,14
2020-05-14,Qatar,QA,1390,0,2832071,Asia,26539,14
2020-05-15,Qatar,QA,1733,0,2832071,Asia,28272,14
2020-05-16,Qatar,QA,1153,0,2832071,Asia,29425,14
2020-05-17,Qatar,QA,1547,1,2832071,Asia,30972,15
2020-05-18,Qatar,QA,1632,0,2832071,Asia,32604,15
2020-05-19,Qatar,QA,1365,0,2832071,Asia,33969,15
2020-05-20,Qatar,QA,1637,0,2832071,Asia,35606,15
2020-05-21,Qatar,QA,1491,1,2832071,Asia,37097,16
2020-05-22,Qatar,QA,1554,1,2832071,Asia,38651,17
2020-05-23,Qatar,QA,1830,2,2832071,Asia,40481,19
2020-05-24,Qatar,QA,1732,2,2832071,Asia,42213,21
2020-05-25,Qatar,QA,1501,2,2832071,Asia,43714,23
2020-05-26,Qatar,QA,1751,3,2832071,Asia,45465,26
2020-05-27,Qatar,QA,1742,2,2832071,Asia,47207,28
2020-05-28,Qatar,QA,1740,2,2832071,Asia,48947,30
2020-05-29,Qatar,QA,1967,3,2832071,Asia,50914,33
2020-05-30,Qatar,QA,1993,3,2832071,Asia,52907,36
2020-05-31,Qatar,QA,2355,0,2832071,Asia,55262,36
2020-06-01,Qatar,QA,1648,2,2832071,Asia,56910,38
2020-06-02,Qatar,QA,1523,2,2832071,Asia,58433,40
2020-06-03,Qatar,QA,1826,3,2832071,Asia,60259,43
2020-06-04,Qatar,QA,1901,2,2832071,Asia,62160,45
2020-06-05,Qatar,QA,1581,0,2832071,Asia,63741,45
2020-06-06,Qatar,QA,1754,4,2832071,Asia,65495,49
2020-06-07,Qatar,QA,1700,2,2832071,Asia,67195,51
2020-06-08,Qatar,QA,1595,3,2832071,Asia,68790,54
2020-06-09,Qatar,QA,1368,3,2832071,Asia,70158,57
2020-06-10,Qatar,QA,1721,5,2832071,Asia,71879,62
2020-06-11,Qatar,QA,1716,4,2832071,Asia,73595,66
2020-06-12,Qatar,QA,1476,3,2832071,Asia,75071,69
2020-06-13,Qatar,QA,1517,1,2832071,Asia,76588,70
2020-06-14,Qatar,QA,1828,0,2832071,Asia,78416,70
2020-06-15,Qatar,QA,1186,3,2832071,Asia,79602,73
2020-06-16,Qatar,QA,1274,3,2832071,Asia,80876,76
2020-06-17,Qatar,QA,1201,4,2832071,Asia,82077,80
2020-06-18,Qatar,QA,1097,2,2832071,Asia,83174,82
2020-06-19,Qatar,QA,1267,4,2832071,Asia,84441,86
2020-06-20,Qatar,QA,1021,7,2832071,Asia,85462,93
2020-06-21,Qatar,QA,1026,1,2832071,Asia,86488,94
2020-06-22,Qatar,QA,881,4,2832071,Asia,87369,98
2020-06-23,Qatar,QA,1034,1,2832071,Asia,88403,99
2020-06-24,Qatar,QA,1176,0,2832071,Asia,89579,99
2020-06-25,Qatar,QA,1199,5,2832071,Asia,90778,104
2020-06-26,Qatar,QA,1060,2,2832071,Asia,91838,106
2020-06-27,Qatar,QA,946,3,2832071,Asia,92784,109
2020-06-28,Qatar,QA,879,1,2832071,Asia,93663,110
2020-06-29,Qatar,QA,750,0,2832071,Asia,94413,110
2020-06-30,Qatar,QA,693,3,2832071,Asia,95106,113
2020-07-01,Qatar,QA,982,0,2832071,Asia,96088,113
2020-07-02,Qatar,QA,915,2,2832071,Asia,97003,115
2020-07-03,Qatar,QA,894,3,2832071,Asia,97897,118
2020-07-04,Qatar,QA,756,3,2832071,Asia,98653,121
2020-07-05,Qatar,QA,530,2,2832071,Asia,99183,123
2020-07-06,Qatar,QA,616,5,2832071,Asia,99799,128
2020-07-07,Qatar,QA,546,5,2832071,Asia,100345,133
2020-07-08,Qatar,QA,600,1,2832071,Asia,100945,134
2020-07-09,Qatar,QA,608,4,2832071,Asia,101553,138
2020-07-10,Qatar,QA,557,4,2832071,Asia,102110,142
2020-07-11,Qatar,QA,520,4,2832071,Asia,102630,146
2020-07-12,Qatar,QA,498,0,2832071,Asia,103128,146
2020-07-13,Qatar,QA,470,1,2832071,Asia,103598,147
2020-07-14,Qatar,QA,418,2,2832071,Asia,104016,149
2020-07-15,Qatar,QA,517,1,2832071,Asia,104533,150
2020-07-16,Qatar,QA,450,1,2832071,Asia,104983,151
2020-07-17,Qatar,QA,464,1,2832071,Asia,105447,152
2020-07-18,Qatar,QA,451,1,2832071,Asia,105898,153
2020-07-19,Qatar,QA,410,1,2832071,Asia,106308,154
2020-07-20,Qatar,QA,340,3,2832071,Asia,106648,157
2020-07-21,Qatar,QA,389,2,2832071,Asia,107037,159
2020-07-22,Qatar,QA,393,1,2832071,Asia,107430,160
2020-07-23,Qatar,QA,441,3,2832071,Asia,107871,163
2020-07-24,Qatar,QA,373,1,2832071,Asia,108244,164
2020-07-25,Qatar,QA,394,0,2832071,Asia,108638,164
2020-07-26,Qatar,QA,398,0,2832071,Asia,109036,164
2020-07-27,Qatar,QA,269,1,2832071,Asia,109305,165
2020-07-28,Qatar,QA,292,0,2832071,Asia,109597,165
2020-07-29,Qatar,QA,283,2,2832071,Asia,109880,167
2020-07-30,Qatar,QA,273,2,2832071,Asia,110153,169
2020-07-31,Qatar,QA,307,2,2832071,Asia,110460,171
2020-08-01,Qatar,QA,235,3,2832071,Asia,110695,174
2020-08-02,Qatar,QA,216,0,2832071,Asia,110911,174
2020-08-03,Qatar,QA,196,3,2832071,Asia,111107,177
2020-08-04,Qatar,QA,215,0,2832071,Asia,111322,177
2020-08-05,Qatar,QA,216,0,2832071,Asia,111538,177
2020-08-06,Qatar,QA,267,1,2832071,Asia,111805,178
2020-08-07,Qatar,QA,287,0,2832071,Asia,112092,178
2020-08-08,Qatar,QA,291,2,2832071,Asia,112383,180
2020-08-09,Qatar,QA,267,2,2832071,Asia,112650,182
2020-08-10,Qatar,QA,297,2,2832071,Asia,112947,184
2020-08-11,Qatar,QA,315,4,2832071,Asia,113262,188
2020-08-12,Qatar,QA,384,0,2832071,Asia,113646,188
2020-08-13,Qatar,QA,292,2,2832071,Asia,113938,190
2020-08-14,Qatar,QA,343,0,2832071,Asia,114281,190
2020-08-15,Qatar,QA,251,0,2832071,Asia,114532,190
2020-08-16,Qatar,QA,277,2,2832071,Asia,114809,192
2020-08-17,Qatar,QA,271,1,2832071,Asia,115080,193
2020-08-18,Qatar,QA,288,0,2832071,Asia,115368,193
2020-08-19,Qatar,QA,293,0,2832071,Asia,115661,193
2020-08-20,Qatar,QA,295,0,2832071,Asia,115956,193
2020-08-21,Qatar,QA,268,0,2832071,Asia,116224,193
2020-08-22,Qatar,QA,257,0,2832071,Asia,116481,193
2020-08-23,Qatar,QA,284,0,2832071,Asia,116765,193
2020-08-24,Qatar,QA,243,0,2832071,Asia,117008,193
2020-08-25,Qatar,QA,258,1,2832071,Asia,117266,194
2020-08-26,Qatar,QA,232,0,2832071,Asia,117498,194
2020-08-27,Qatar,QA,244,0,2832071,Asia,117742,194
2020-08-28,Qatar,QA,246,1,2832071,Asia,117988,195
2020-08-29,Qatar,QA,208,1,2832071,Asia,118196,196
2020-08-30,Qatar,QA,211,0,2832071,Asia,118407,196
2020-08-31,Qatar,QA,168,1,2832071,Asia,118575,197
2020-09-01,Qatar,QA,203,0,2832071,Asia,118778,197
2020-09-02,Qatar,QA,216,1,2832071,Asia,118994,198
2020-09-03,Qatar,QA,212,1,2832071,Asia,119206,199
2020-09-04,Qatar,QA,214,2,2832071,Asia,119420,201
2020-09-05,Qatar,QA,217,0,2832071,Asia,119637,201
2020-09-06,Qatar,QA,227,1,2832071,Asia,119864,202
2020-09-07,Qatar,QA,231,1,2832071,Asia,120095,203
2020-09-08,Qatar,QA,253,2,2832071,Asia,120348,205
2020-09-09,Qatar,QA,231,0,2832071,Asia,120579,205
2020-09-10,Qatar,QA,267,0,2832071,Asia,120846,205
2020-09-11,Qatar,QA,206,0,2832071,Asia,121052,205
2020-09-12,Qatar,QA,235,0,2832071,Asia,121287,205
2020-09-13,Qatar,QA,236,0,2832071,Asia,121523,205
2020-09-14,Qatar,QA,217,0,2832071,Asia,121740,205
2020-09-15,Qatar,QA,235,2,2832071,Asia,121975,207
2020-09-16,Qatar,QA,239,1,2832071,Asia,122214,208
2020-09-17,Qatar,QA,235,0,2832071,Asia,122449,208
2020-09-18,Qatar,QA,244,0,2832071,Asia,122693,208
2020-09-19,Qatar,QA,224,1,2832071,Asia,122917,209
2020-09-20,Qatar,QA,229,0,2832071,Asia,123146,209
2020-09-21,Qatar,QA,230,1,2832071,Asia,123376,210
2020-09-22,Qatar,QA,228,1,2832071,Asia,123604,211
2020-09-23,Qatar,QA,313,0,2832071,Asia,123917,211
2020-09-24,Qatar,QA,258,1,2832071,Asia,124175,212
2020-09-25,Qatar,QA,250,0,2832071,Asia,124425,212
2020-09-26,Qatar,QA,225,0,2832071,Asia,124650,212
2020-09-27,Qatar,QA,200,2,2832071,Asia,124850,214
2020-09-28,Qatar,QA,234,0,2832071,Asia,125084,214
2020-09-29,Qatar,QA,227,0,2832071,Asia,125311,214
2020-09-30,Qatar,QA,222,0,2832071,Asia,125533,214
2020-10-01,Qatar,QA,227,0,2832071,Asia,125760,214
2020-10-02,Qatar,QA,199,0,2832071,Asia,125959,214
2020-10-03,Qatar,QA,205,1,2832071,Asia,126164,215
2020-10-04,Qatar,QA,175,1,2832071,Asia,126339,216
2020-10-05,Qatar,QA,159,0,2832071,Asia,126498,216
2020-10-06,Qatar,QA,194,0,2832071,Asia,126692,216
2020-10-07,Qatar,QA,251,0,2832071,Asia,126943,216
2020-10-08,Qatar,QA,238,2,2832071,Asia,127181,218
2020-10-09,Qatar,QA,213,0,2832071,Asia,127394,218
2020-10-10,Qatar,QA,206,1,2832071,Asia,127600,219
2020-10-11,Qatar,QA,178,0,2832071,Asia,127778,219
2020-10-12,Qatar,QA,207,1,2832071,Asia,127985,220
2020-10-13,Qatar,QA,206,0,2832071,Asia,128191,220
2020-10-14,Qatar,QA,214,0,2832071,Asia,128405,220
2020-10-15,Qatar,QA,198,0,2832071,Asia,128603,220
2020-10-16,Qatar,QA,200,2,2832071,Asia,128803,222
2020-10-17,Qatar,QA,189,0,2832071,Asia,128992,222
2020-10-18,Qatar,QA,235,1,2832071,Asia,129227,223
2020-10-19,Qatar,QA,204,1,2832071,Asia,129431,224
2020-10-20,Qatar,QA,240,0,2832071,Asia,129671,224
2020-10-21,Qatar,QA,273,0,2832071,Asia,129944,224
2020-10-22,Qatar,QA,266,1,2832071,Asia,130210,225
2020-10-23,Qatar,QA,252,3,2832071,Asia,130462,228
2020-10-24,Qatar,QA,249,1,2832071,Asia,130711,229
2020-10-25,Qatar,QA,254,0,2832071,Asia,130965,229
2020-10-26,Qatar,QA,205,1,2832071,Asia,131170,230
2020-10-27,Qatar,QA,262,0,2832071,Asia,131432,230
2020-10-28,Qatar,QA,257,0,2832071,Asia,131689,230
2020-10-29,Qatar,QA,250,0,2832071,Asia,131939,230
2020-10-30,Qatar,QA,211,1,2832071,Asia,132150,231
2020-10-31,Qatar,QA,193,1,2832071,Asia,132343,232
2020-11-01,Qatar,QA,213,0,2832071,Asia,132556,232
2020-11-02,Qatar,QA,164,0,2832071,Asia,132720,232
2020-11-03,Qatar,QA,197,0,2832071,Asia,132917,232
2020-11-04,Qatar,QA,226,0,2832071,Asia,133143,232
2020-11-05,Qatar,QA,227,0,2832071,Asia,133370,232
2020-11-06,Qatar,QA,249,0,2832071,Asia,133619,232
2020-11-07,Qatar,QA,192,0,2832071,Asia,133811,232
2020-11-08,Qatar,QA,202,0,2832071,Asia,134013,232
2020-11-09,Qatar,QA,190,0,2832071,Asia,134203,232
2020-11-10,Qatar,QA,230,0,2832071,Asia,134433,232
2020-11-11,Qatar,QA,230,1,2832071,Asia,134663,233
2020-11-12,Qatar,QA,224,0,2832071,Asia,134887,233
2020-11-13,Qatar,QA,245,1,2832071,Asia,135132,234
2020-11-14,Qatar,QA,235,0,2832071,Asia,135367,234
2020-11-15,Qatar,QA,418,0,2832071,Asia,135785,234
2020-11-16,Qatar,QA,0,0,2832071,Asia,135785,234
2020-11-17,Qatar,QA,243,1,2832071,Asia,136028,235
2020-11-18,Qatar,QA,194,0,2832071,Asia,136222,235
2020-11-19,Qatar,QA,219,0,2832071,Asia,136441,235
2020-11-20,Qatar,QA,208,0,2832071,Asia,136649,235
2020-11-21,Qatar,QA,239,0,2832071,Asia,136888,235
2020-11-22,Qatar,QA,174,0,2832071,Asia,137062,235
2020-11-23,Qatar,QA,167,1,2832071,Asia,137229,236
2020-11-24,Qatar,QA,186,0,2832071,Asia,137415,236
2020-11-25,Qatar,QA,227,0,2832071,Asia,137642,236
2020-11-26,Qatar,QA,209,1,2832071,Asia,137851,237
2020-11-27,Qatar,QA,215,0,2832071,Asia,138066,237
2020-11-28,Qatar,QA,184,0,2832071,Asia,138250,237
2020-11-29,Qatar,QA,227,0,2832071,Asia,138477,237
2020-11-30,Qatar,QA,171,0,2832071,Asia,138648,237
2020-12-01,Qatar,QA,185,0,2832071,Asia,138833,237
2020-12-02,Qatar,QA,168,1,2832071,Asia,139001,238
2020-12-03,Qatar,QA,255,1,2832071,Asia,139256,239
2020-12-04,Qatar,QA,221,0,2832071,Asia,139477,239
2020-12-05,Qatar,QA,166,0,2832071,Asia,139643,239
2020-12-06,Qatar,QA,140,0,2832071,Asia,139783,239
2020-12-07,Qatar,QA,125,0,2832071,Asia,139908,239
2020-12-08,Qatar,QA,178,0,2832071,Asia,140086,239
2020-12-09,Qatar,QA,117,0,2832071,Asia,140203,239
2020-12-10,Qatar,QA,150,1,2832071,Asia,140353,240
2020-12-11,Qatar,QA,163,0,2832071,Asia,140516,240
2020-12-12,Qatar,QA,164,0,2832071,Asia,140680,240
2020-12-13,Qatar,QA,281,0,2832071,Asia,140961,240
2020-12-14,Qatar,QA,0,0,2832071,Asia,140961,240
2019-12-31,Romania,RO,0,0,19414458,Europe,0,0
2020-01-01,Romania,RO,0,0,19414458,Europe,0,0
2020-01-02,Romania,RO,0,0,19414458,Europe,0,0
2020-01-03,Romania,RO,0,0,19414458,Europe,0,0
2020-01-04,Romania,RO,0,0,19414458,Europe,0,0
2020-01-05,Romania,RO,0,0,19414458,Europe,0,0
2020-01-06,Romania,RO,0,0,19414458,Europe,0,0
2020-01-07,Romania,RO,0,0,19414458,Europe,0,0
2020-01-08,Romania,RO,0,0,19414458,Europe,0,0
2020-01-09,Romania,RO,0,0,19414458,Europe,0,0
2020-01-10,Romania,RO,0,0,19414458,Europe,0,0
2020-01-11,Romania,RO,0,0,19414458,Europe,0,0
2020-01-12,Romania,RO,0,0,19414458,Europe,0,0
2020-01-13,Romania,RO,0,0,19414458,Europe,0,0
2020-01-14,Romania,RO,0,0,19414458,Europe,0,0
2020-01-15,Romania,RO,0,0,19414458,Europe,0,0
2020-01-16,Romania,RO,0,0,19414458,Europe,0,0
2020-01-17,Romania,RO,0,0,19414458,Europe,0,0
2020-01-18,Romania,RO,0,0,19414458,Europe,0,0
2020-01-19,Romania,RO,0,0,19414458,Europe,0,0
2020-01-20,Romania,RO,0,0,19414458,Europe,0,0
2020-01-21,Romania,RO,0,0,19414458,Europe,0,0
2020-01-22,Romania,RO,0,0,19414458,Europe,0,0
2020-01-23,Romania,RO,0,0,19414458,Europe,0,0
2020-01-24,Romania,RO,0,0,19414458,Europe,0,0
2020-01-25,Romania,RO,0,0,19414458,Europe,0,0
2020-01-26,Romania,RO,0,0,19414458,Europe,0,0
2020-01-27,Romania,RO,0,0,19414458,Europe,0,0
2020-01-28,Romania,RO,0,0,19414458,Europe,0,0
2020-01-29,Romania,RO,0,0,19414458,Europe,0,0
2020-01-30,Romania,RO,0,0,19414458,Europe,0,0
2020-01-31,Romania,RO,0,0,19414458,Europe,0,0
2020-02-01,Romania,RO,0,0,19414458,Europe,0,0
2020-02-02,Romania,RO,0,0,19414458,Europe,0,0
2020-02-03,Romania,RO,0,0,19414458,Europe,0,0
2020-02-04,Romania,RO,0,0,19414458,Europe,0,0
2020-02-05,Romania,RO,0,0,19414458,Europe,0,0
2020-02-06,Romania,RO,0,0,19414458,Europe,0,0
2020-02-07,Romania,RO,0,0,19414458,Europe,0,0
2020-02-08,Romania,RO,0,0,19414458,Europe,0,0
2020-02-09,Romania,RO,0,0,19414458,Europe,0,0
2020-02-10,Romania,RO,0,0,19414458,Europe,0,0
2020-02-11,Romania,RO,0,0,19414458,Europe,0,0
2020-02-12,Romania,RO,0,0,19414458,Europe,0,0
2020-02-13,Romania,RO,0,0,19414458,Europe,0,0
2020-02-14,Romania,RO,0,0,19414458,Europe,0,0
2020-02-15,Romania,RO,0,0,19414458,Europe,0,0
2020-02-16,Romania,RO,0,0,19414458,Europe,0,0
2020-02-17,Romania,RO,0,0,19414458,Europe,0,0
2020-02-18,Romania,RO,0,0,19414458,Europe,0,0
2020-02-19,Romania,RO,0,0,19414458,Europe,0,0
2020-02-20,Romania,RO,0,0,19414458,Europe,0,0
2020-02-21,Romania,RO,0,0,19414458,Europe,0,0
2020-02-22,Romania,RO,0,0,19414458,Europe,0,0
2020-02-23,Romania,RO,0,0,19414458,Europe,0,0
2020-02-24,Romania,RO,0,0,19414458,Europe,0,0
2020-02-25,Romania,RO,0,0,19414458,Europe,0,0
2020-02-26,Romania,RO,0,0,19414458,Europe,0,0
2020-02-27,Romania,RO,1,0,19414458,Europe,1,0
2020-02-28,Romania,RO,0,0,19414458,Europe,1,0
2020-02-29,Romania,RO,2,0,19414458,Europe,3,0
2020-03-01,Romania,RO,0,0,19414458,Europe,3,0
2020-03-02,Romania,RO,0,0,19414458,Europe,3,0
2020-03-04,Romania,RO,1,0,19414458,Europe,4,0
2020-03-06,Romania,RO,2,0,19414458,Europe,6,0
2020-03-07,Romania,RO,1,0,19414458,Europe,7,0
2020-03-08,Romania,RO,6,0,19414458,Europe,13,0
2020-03-09,Romania,RO,2,0,19414458,Europe,15,0
2020-03-10,Romania,RO,2,0,19414458,Europe,17,0
2020-03-11,Romania,RO,8,0,19414458,Europe,25,0
2020-03-12,Romania,RO,20,0,19414458,Europe,45,0
2020-03-13,Romania,RO,19,0,19414458,Europe,64,0
2020-03-14,Romania,RO,25,0,19414458,Europe,89,0
2020-03-15,Romania,RO,24,0,19414458,Europe,113,0
2020-03-16,Romania,RO,26,0,19414458,Europe,139,0
2020-03-17,Romania,RO,45,0,19414458,Europe,184,0
2020-03-18,Romania,RO,33,0,19414458,Europe,217,0
2020-03-19,Romania,RO,43,0,19414458,Europe,260,0
2020-03-20,Romania,RO,17,0,19414458,Europe,277,0
2020-03-21,Romania,RO,31,0,19414458,Europe,308,0
2020-03-22,Romania,RO,59,0,19414458,Europe,367,0
2020-03-23,Romania,RO,66,2,19414458,Europe,433,2
2020-03-24,Romania,RO,143,5,19414458,Europe,576,7
2020-03-25,Romania,RO,186,4,19414458,Europe,762,11
2020-03-26,Romania,RO,144,2,19414458,Europe,906,13
2020-03-27,Romania,RO,123,4,19414458,Europe,1029,17
2020-03-28,Romania,RO,263,7,19414458,Europe,1292,24
2020-03-29,Romania,RO,160,5,19414458,Europe,1452,29
2020-03-30,Romania,RO,308,11,19414458,Europe,1760,40
2020-03-31,Romania,RO,192,4,19414458,Europe,1952,44
2020-04-01,Romania,RO,293,25,19414458,Europe,2245,69
2020-04-02,Romania,RO,215,16,19414458,Europe,2460,85
2020-04-03,Romania,RO,278,9,19414458,Europe,2738,94
2020-04-04,Romania,RO,445,39,19414458,Europe,3183,133
2020-04-05,Romania,RO,430,8,19414458,Europe,3613,141
2020-04-06,Romania,RO,251,7,19414458,Europe,3864,148
2020-04-07,Romania,RO,193,9,19414458,Europe,4057,157
2020-04-08,Romania,RO,360,25,19414458,Europe,4417,182
2020-04-09,Romania,RO,344,27,19414458,Europe,4761,209
2020-04-10,Romania,RO,441,20,19414458,Europe,5202,229
2020-04-11,Romania,RO,265,28,19414458,Europe,5467,257
2020-04-12,Romania,RO,523,25,19414458,Europe,5990,282
2020-04-13,Romania,RO,310,24,19414458,Europe,6300,306
2020-04-14,Romania,RO,333,12,19414458,Europe,6633,318
2020-04-15,Romania,RO,246,26,19414458,Europe,6879,344
2020-04-16,Romania,RO,337,28,19414458,Europe,7216,372
2020-04-17,Romania,RO,491,15,19414458,Europe,7707,387
2020-04-18,Romania,RO,360,13,19414458,Europe,8067,400
2020-04-19,Romania,RO,351,17,19414458,Europe,8418,417
2020-04-20,Romania,RO,328,17,19414458,Europe,8746,434
2020-04-21,Romania,RO,190,17,19414458,Europe,8936,451
2020-04-22,Romania,RO,306,32,19414458,Europe,9242,483
2020-04-23,Romania,RO,468,25,19414458,Europe,9710,508
2020-04-24,Romania,RO,386,19,19414458,Europe,10096,527
2020-04-25,Romania,RO,321,25,19414458,Europe,10417,552
2020-04-26,Romania,RO,218,23,19414458,Europe,10635,575
2020-04-27,Romania,RO,401,33,19414458,Europe,11036,608
2020-04-28,Romania,RO,303,23,19414458,Europe,11339,631
2020-04-29,Romania,RO,277,19,19414458,Europe,11616,650
2020-04-30,Romania,RO,362,25,19414458,Europe,11978,675
2020-05-01,Romania,RO,262,42,19414458,Europe,12240,717
2020-05-02,Romania,RO,327,27,19414458,Europe,12567,744
2020-05-03,Romania,RO,165,27,19414458,Europe,12732,771
2020-05-04,Romania,RO,431,9,19414458,Europe,13163,780
2020-05-05,Romania,RO,349,23,19414458,Europe,13512,803
2020-05-06,Romania,RO,325,24,19414458,Europe,13837,827
2020-05-07,Romania,RO,270,31,19414458,Europe,14107,858
2020-05-08,Romania,RO,392,18,19414458,Europe,14499,876
2020-05-09,Romania,RO,312,22,19414458,Europe,14811,898
2020-05-10,Romania,RO,320,28,19414458,Europe,15131,926
2020-05-11,Romania,RO,231,26,19414458,Europe,15362,952
2020-05-12,Romania,RO,226,20,19414458,Europe,15588,972
2020-05-13,Romania,RO,190,30,19414458,Europe,15778,1002
2020-05-14,Romania,RO,224,14,19414458,Europe,16002,1016
2020-05-15,Romania,RO,245,30,19414458,Europe,16247,1046
2020-05-16,Romania,RO,190,10,19414458,Europe,16437,1056
2020-05-17,Romania,RO,267,25,19414458,Europe,16704,1081
2020-05-18,Romania,RO,167,16,19414458,Europe,16871,1097
2020-05-19,Romania,RO,165,10,19414458,Europe,17036,1107
2020-05-20,Romania,RO,155,19,19414458,Europe,17191,1126
2020-05-21,Romania,RO,196,15,19414458,Europe,17387,1141
2020-05-22,Romania,RO,198,10,19414458,Europe,17585,1151
2020-05-23,Romania,RO,127,8,19414458,Europe,17712,1159
2020-05-24,Romania,RO,145,11,19414458,Europe,17857,1170
2020-05-25,Romania,RO,213,9,19414458,Europe,18070,1179
2020-05-26,Romania,RO,213,18,19414458,Europe,18283,1197
2020-05-27,Romania,RO,146,13,19414458,Europe,18429,1210
2020-05-28,Romania,RO,165,9,19414458,Europe,18594,1219
2020-05-29,Romania,RO,197,10,19414458,Europe,18791,1229
2020-05-30,Romania,RO,191,11,19414458,Europe,18982,1240
2020-05-31,Romania,RO,151,13,19414458,Europe,19133,1253
2020-06-01,Romania,RO,124,9,19414458,Europe,19257,1262
2020-06-02,Romania,RO,141,17,19414458,Europe,19398,1279
2020-06-03,Romania,RO,119,0,19414458,Europe,19517,1279
2020-06-04,Romania,RO,152,9,19414458,Europe,19669,1288
2020-06-05,Romania,RO,238,11,19414458,Europe,19907,1299
2020-06-06,Romania,RO,196,9,19414458,Europe,20103,1308
2020-06-07,Romania,RO,187,10,19414458,Europe,20290,1318
2020-06-08,Romania,RO,189,8,19414458,Europe,20479,1326
2020-06-09,Romania,RO,125,8,19414458,Europe,20604,1334
2020-06-10,Romania,RO,145,11,19414458,Europe,20749,1345
2020-06-11,Romania,RO,196,15,19414458,Europe,20945,1360
2020-06-12,Romania,RO,237,9,19414458,Europe,21182,1369
2020-06-13,Romania,RO,222,11,19414458,Europe,21404,1380
2020-06-14,Romania,RO,275,11,19414458,Europe,21679,1391
2020-06-15,Romania,RO,320,19,19414458,Europe,21999,1410
2020-06-16,Romania,RO,166,17,19414458,Europe,22165,1427
2020-06-17,Romania,RO,250,10,19414458,Europe,22415,1437
2020-06-18,Romania,RO,345,14,19414458,Europe,22760,1451
2020-06-19,Romania,RO,320,22,19414458,Europe,23080,1473
2020-06-20,Romania,RO,320,11,19414458,Europe,23400,1484
2020-06-21,Romania,RO,330,16,19414458,Europe,23730,1500
2020-06-22,Romania,RO,315,12,19414458,Europe,24045,1512
2020-06-23,Romania,RO,246,11,19414458,Europe,24291,1523
2020-06-24,Romania,RO,214,16,19414458,Europe,24505,1539
2020-06-25,Romania,RO,321,16,19414458,Europe,24826,1555
2020-06-26,Romania,RO,460,10,19414458,Europe,25286,1565
2020-06-27,Romania,RO,411,14,19414458,Europe,25697,1579
2020-06-28,Romania,RO,325,10,19414458,Europe,26022,1589
2020-06-29,Romania,RO,291,23,19414458,Europe,26313,1612
2020-06-30,Romania,RO,269,22,19414458,Europe,26582,1634
2020-07-01,Romania,RO,388,17,19414458,Europe,26970,1651
2020-07-02,Romania,RO,326,16,19414458,Europe,27296,1667
2020-07-03,Romania,RO,450,20,19414458,Europe,27746,1687
2020-07-04,Romania,RO,420,21,19414458,Europe,28166,1708
2020-07-05,Romania,RO,416,23,19414458,Europe,28582,1731
2020-07-06,Romania,RO,391,19,19414458,Europe,28973,1750
2020-07-07,Romania,RO,250,18,19414458,Europe,29223,1768
2020-07-08,Romania,RO,397,31,19414458,Europe,29620,1799
2020-07-09,Romania,RO,555,18,19414458,Europe,30175,1817
2020-07-10,Romania,RO,614,17,19414458,Europe,30789,1834
2020-07-11,Romania,RO,592,13,19414458,Europe,31381,1847
2020-07-12,Romania,RO,698,24,19414458,Europe,32079,1871
2020-07-13,Romania,RO,456,13,19414458,Europe,32535,1884
2020-07-14,Romania,RO,413,17,19414458,Europe,32948,1901
2020-07-15,Romania,RO,637,30,19414458,Europe,33585,1931
2020-07-16,Romania,RO,641,21,19414458,Europe,34226,1952
2020-07-17,Romania,RO,777,19,19414458,Europe,35003,1971
2020-07-18,Romania,RO,799,17,19414458,Europe,35802,1988
2020-07-19,Romania,RO,889,21,19414458,Europe,36691,2009
2020-07-20,Romania,RO,767,17,19414458,Europe,37458,2026
2020-07-21,Romania,RO,681,12,19414458,Europe,38139,2038
2020-07-22,Romania,RO,994,36,19414458,Europe,39133,2074
2020-07-23,Romania,RO,1030,27,19414458,Europe,40163,2101
2020-07-24,Romania,RO,1112,25,19414458,Europe,41275,2126
2020-07-25,Romania,RO,1119,24,19414458,Europe,42394,2150
2020-07-26,Romania,RO,1284,15,19414458,Europe,43678,2165
2020-07-27,Romania,RO,1120,22,19414458,Europe,44798,2187
2020-07-28,Romania,RO,1104,19,19414458,Europe,45902,2206
2020-07-29,Romania,RO,1151,33,19414458,Europe,47053,2239
2020-07-30,Romania,RO,1182,30,19414458,Europe,48235,2269
2020-07-31,Romania,RO,1356,35,19414458,Europe,49591,2304
2020-08-01,Romania,RO,1295,39,19414458,Europe,50886,2343
2020-08-02,Romania,RO,1225,36,19414458,Europe,52111,2379
2020-08-03,Romania,RO,1075,34,19414458,Europe,53186,2413
2020-08-04,Romania,RO,823,19,19414458,Europe,54009,2432
2020-08-05,Romania,RO,1232,48,19414458,Europe,55241,2480
2020-08-06,Romania,RO,1309,41,19414458,Europe,56550,2521
2020-08-07,Romania,RO,1345,45,19414458,Europe,57895,2566
2020-08-08,Romania,RO,1378,50,19414458,Europe,59273,2616
2020-08-09,Romania,RO,1350,43,19414458,Europe,60623,2659
2020-08-10,Romania,RO,1145,41,19414458,Europe,61768,2700
2020-08-11,Romania,RO,779,29,19414458,Europe,62547,2729
2020-08-12,Romania,RO,1215,35,19414458,Europe,63762,2764
2020-08-13,Romania,RO,1415,43,19414458,Europe,65177,2807
2020-08-14,Romania,RO,1454,53,19414458,Europe,66631,2860
2020-08-15,Romania,RO,1415,44,19414458,Europe,68046,2904
2020-08-16,Romania,RO,1328,50,19414458,Europe,69374,2954
2020-08-17,Romania,RO,1087,37,19414458,Europe,70461,2991
2020-08-18,Romania,RO,733,38,19414458,Europe,71194,3029
2020-08-19,Romania,RO,1014,45,19414458,Europe,72208,3074
2020-08-20,Romania,RO,1409,32,19414458,Europe,73617,3106
2020-08-21,Romania,RO,1346,48,19414458,Europe,74963,3154
2020-08-22,Romania,RO,1392,42,19414458,Europe,76355,3196
2020-08-23,Romania,RO,1189,37,19414458,Europe,77544,3233
2020-08-24,Romania,RO,981,39,19414458,Europe,78525,3272
2020-08-25,Romania,RO,805,37,19414458,Europe,79330,3309
2020-08-26,Romania,RO,1060,58,19414458,Europe,80390,3367
2020-08-27,Romania,RO,1256,54,19414458,Europe,81646,3421
2020-08-28,Romania,RO,1504,38,19414458,Europe,83150,3459
2020-08-29,Romania,RO,1318,48,19414458,Europe,84468,3507
2020-08-30,Romania,RO,1365,32,19414458,Europe,85833,3539
2020-08-31,Romania,RO,952,39,19414458,Europe,86785,3578
2020-09-01,Romania,RO,755,43,19414458,Europe,87540,3621
2020-09-02,Romania,RO,1053,60,19414458,Europe,88593,3681
2020-09-03,Romania,RO,1298,40,19414458,Europe,89891,3721
2020-09-04,Romania,RO,1365,44,19414458,Europe,91256,3765
2020-09-05,Romania,RO,1339,47,19414458,Europe,92595,3812
2020-09-06,Romania,RO,1269,38,19414458,Europe,93864,3850
2020-09-07,Romania,RO,1150,43,19414458,Europe,95014,3893
2020-09-08,Romania,RO,883,33,19414458,Europe,95897,3926
2020-09-09,Romania,RO,1136,41,19414458,Europe,97033,3967
2020-09-10,Romania,RO,1271,51,19414458,Europe,98304,4018
2020-09-11,Romania,RO,1380,47,19414458,Europe,99684,4065
2020-09-12,Romania,RO,1391,35,19414458,Europe,101075,4100
2020-09-13,Romania,RO,1311,27,19414458,Europe,102386,4127
2020-09-14,Romania,RO,1109,36,19414458,Europe,103495,4163
2020-09-15,Romania,RO,692,22,19414458,Europe,104187,4185
2020-09-16,Romania,RO,1111,51,19414458,Europe,105298,4236
2020-09-17,Romania,RO,1713,49,19414458,Europe,107011,4285
2020-09-18,Romania,RO,1679,27,19414458,Europe,108690,4312
2020-09-19,Romania,RO,1527,48,19414458,Europe,110217,4360
2020-09-20,Romania,RO,1333,42,19414458,Europe,111550,4402
2020-09-21,Romania,RO,1231,33,19414458,Europe,112781,4435
2020-09-22,Romania,RO,808,23,19414458,Europe,113589,4458
2020-09-23,Romania,RO,1059,45,19414458,Europe,114648,4503
2020-09-24,Romania,RO,1767,47,19414458,Europe,116415,4550
2020-09-25,Romania,RO,1639,41,19414458,Europe,118054,4591
2020-09-26,Romania,RO,1629,42,19414458,Europe,119683,4633
2020-09-27,Romania,RO,1552,54,19414458,Europe,121235,4687
2020-09-28,Romania,RO,1438,31,19414458,Europe,122673,4718
2020-09-29,Romania,RO,1271,30,19414458,Europe,123944,4748
2020-09-30,Romania,RO,1470,44,19414458,Europe,125414,4792
2020-10-01,Romania,RO,2158,33,19414458,Europe,127572,4825
2020-10-02,Romania,RO,2086,37,19414458,Europe,129658,4862
2020-10-03,Romania,RO,2343,53,19414458,Europe,132001,4915
2020-10-04,Romania,RO,2064,32,19414458,Europe,134065,4947
2020-10-05,Romania,RO,0,0,19414458,Europe,134065,4947
2020-10-06,Romania,RO,3426,101,19414458,Europe,137491,5048
2020-10-07,Romania,RO,2121,73,19414458,Europe,139612,5121
2020-10-08,Romania,RO,2958,82,19414458,Europe,142570,5203
2020-10-09,Romania,RO,3130,44,19414458,Europe,145700,5247
2020-10-10,Romania,RO,3186,52,19414458,Europe,148886,5299
2020-10-11,Romania,RO,3517,59,19414458,Europe,152403,5358
2020-10-12,Romania,RO,2880,53,19414458,Europe,155283,5411
2020-10-13,Romania,RO,2069,56,19414458,Europe,157352,5467
2020-10-14,Romania,RO,3109,68,19414458,Europe,160461,5535
2020-10-15,Romania,RO,4016,66,19414458,Europe,164477,5601
2020-10-16,Romania,RO,4013,73,19414458,Europe,168490,5674
2020-10-17,Romania,RO,4026,75,19414458,Europe,172516,5749
2020-10-18,Romania,RO,3952,63,19414458,Europe,176468,5812
2020-10-19,Romania,RO,3920,60,19414458,Europe,180388,5872
2020-10-20,Romania,RO,2466,59,19414458,Europe,182854,5931
2020-10-21,Romania,RO,3400,65,19414458,Europe,186254,5996
2020-10-22,Romania,RO,4848,69,19414458,Europe,191102,6065
2020-10-23,Romania,RO,4902,98,19414458,Europe,196004,6163
2020-10-24,Romania,RO,5028,82,19414458,Europe,201032,6245
2020-10-25,Romania,RO,4761,73,19414458,Europe,205793,6318
2020-10-26,Romania,RO,3855,73,19414458,Europe,209648,6391
2020-10-27,Romania,RO,2844,79,19414458,Europe,212492,6470
2020-10-28,Romania,RO,4724,104,19414458,Europe,217216,6574
2020-10-29,Romania,RO,5343,107,19414458,Europe,222559,6681
2020-10-30,Romania,RO,6481,83,19414458,Europe,229040,6764
2020-10-31,Romania,RO,6546,103,19414458,Europe,235586,6867
2020-11-01,Romania,RO,5753,101,19414458,Europe,241339,6968
2020-11-02,Romania,RO,5324,99,19414458,Europe,246663,7067
2020-11-03,Romania,RO,4041,86,19414458,Europe,250704,7153
2020-11-04,Romania,RO,7733,120,19414458,Europe,258437,7273
2020-11-05,Romania,RO,8651,146,19414458,Europe,267088,7419
2020-11-06,Romania,RO,9714,121,19414458,Europe,276802,7540
2020-11-07,Romania,RO,10260,123,19414458,Europe,287062,7663
2020-11-08,Romania,RO,9937,130,19414458,Europe,296999,7793
2020-11-09,Romania,RO,6752,86,19414458,Europe,303751,7879
2020-11-10,Romania,RO,3240,130,19414458,Europe,306991,8009
2020-11-11,Romania,RO,7304,177,19414458,Europe,314295,8186
2020-11-12,Romania,RO,9799,203,19414458,Europe,324094,8389
2020-11-13,Romania,RO,10142,121,19414458,Europe,334236,8510
2020-11-14,Romania,RO,9489,174,19414458,Europe,343725,8684
2020-11-15,Romania,RO,9460,129,19414458,Europe,353185,8813
2020-11-16,Romania,RO,7096,113,19414458,Europe,360281,8926
2020-11-17,Romania,RO,4931,149,19414458,Europe,365212,9075
2020-11-18,Romania,RO,8262,186,19414458,Europe,373474,9261
2020-11-19,Romania,RO,10269,168,19414458,Europe,383743,9429
2020-11-20,Romania,RO,10108,167,19414458,Europe,393851,9596
2020-11-21,Romania,RO,9272,160,19414458,Europe,403123,9756
2020-11-22,Romania,RO,9685,160,19414458,Europe,412808,9916
2020-11-23,Romania,RO,5837,131,19414458,Europe,418645,10047
2020-11-24,Romania,RO,4207,130,19414458,Europe,422852,10177
2020-11-25,Romania,RO,7753,196,19414458,Europe,430605,10373
2020-11-26,Romania,RO,9739,168,19414458,Europe,440344,10541
2020-11-27,Romania,RO,9005,171,19414458,Europe,449349,10712
2020-11-28,Romania,RO,8499,172,19414458,Europe,457848,10884
2020-11-29,Romania,RO,8134,161,19414458,Europe,465982,11045
2020-11-30,Romania,RO,5554,148,19414458,Europe,471536,11193
2020-12-01,Romania,RO,3826,138,19414458,Europe,475362,11331
2020-12-02,Romania,RO,4272,199,19414458,Europe,479634,11530
2020-12-03,Romania,RO,4916,135,19414458,Europe,484550,11665
2020-12-04,Romania,RO,7661,211,19414458,Europe,492211,11876
2020-12-05,Romania,RO,8062,176,19414458,Europe,500273,12052
2020-12-06,Romania,RO,8072,134,19414458,Europe,508345,12186
2020-12-07,Romania,RO,5231,134,19414458,Europe,513576,12320
2020-12-08,Romania,RO,3660,127,19414458,Europe,517236,12447
2020-12-09,Romania,RO,7439,213,19414458,Europe,524675,12660
2020-12-10,Romania,RO,7365,161,19414458,Europe,532040,12821
2020-12-11,Romania,RO,7067,127,19414458,Europe,539107,12948
2020-12-12,Romania,RO,6460,168,19414458,Europe,545567,13116
2020-12-13,Romania,RO,6333,148,19414458,Europe,551900,13264
2020-12-14,Romania,RO,4435,121,19414458,Europe,556335,13385
2020-03-07,Serbia,RS,1,0,6963764,Europe,1,0
2020-03-11,Serbia,RS,4,0,6963764,Europe,5,0
2020-03-12,Serbia,RS,13,0,6963764,Europe,18,0
2020-03-13,Serbia,RS,6,0,6963764,Europe,24,0
2020-03-14,Serbia,RS,17,0,6963764,Europe,41,0
2020-03-15,Serbia,RS,5,0,6963764,Europe,46,0
2020-03-16,Serbia,RS,9,0,6963764,Europe,55,0
2020-03-17,Serbia,RS,2,0,6963764,Europe,57,0
2020-03-18,Serbia,RS,15,0,6963764,Europe,72,0
2020-03-19,Serbia,RS,22,0,6963764,Europe,94,0
2020-03-20,Serbia,RS,32,0,6963764,Europe,126,0
2020-03-21,Serbia,RS,9,1,6963764,Europe,135,1
2020-03-22,Serbia,RS,14,0,6963764,Europe,149,1
2020-03-23,Serbia,RS,39,0,6963764,Europe,188,1
2020-03-24,Serbia,RS,34,0,6963764,Europe,222,1
2020-03-25,Serbia,RS,27,0,6963764,Europe,249,1
2020-03-26,Serbia,RS,54,1,6963764,Europe,303,2
2020-03-27,Serbia,RS,81,1,6963764,Europe,384,3
2020-03-28,Serbia,RS,73,3,6963764,Europe,457,6
2020-03-29,Serbia,RS,202,4,6963764,Europe,659,10
2020-03-30,Serbia,RS,82,3,6963764,Europe,741,13
2020-03-31,Serbia,RS,44,3,6963764,Europe,785,16
2020-04-01,Serbia,RS,115,7,6963764,Europe,900,23
2020-04-02,Serbia,RS,160,0,6963764,Europe,1060,23
2020-04-03,Serbia,RS,111,8,6963764,Europe,1171,31
2020-04-04,Serbia,RS,305,8,6963764,Europe,1476,39
2020-04-05,Serbia,RS,148,5,6963764,Europe,1624,44
2020-04-06,Serbia,RS,284,7,6963764,Europe,1908,51
2020-04-07,Serbia,RS,292,7,6963764,Europe,2200,58
2020-04-08,Serbia,RS,247,3,6963764,Europe,2447,61
2020-04-09,Serbia,RS,219,4,6963764,Europe,2666,65
2020-04-10,Serbia,RS,201,1,6963764,Europe,2867,66
2020-04-11,Serbia,RS,238,5,6963764,Europe,3105,71
2020-04-12,Serbia,RS,275,3,6963764,Europe,3380,74
2020-04-13,Serbia,RS,250,6,6963764,Europe,3630,80
2020-04-14,Serbia,RS,424,5,6963764,Europe,4054,85
2020-04-15,Serbia,RS,411,9,6963764,Europe,4465,94
2020-04-16,Serbia,RS,408,5,6963764,Europe,4873,99
2020-04-17,Serbia,RS,445,4,6963764,Europe,5318,103
2020-04-18,Serbia,RS,372,7,6963764,Europe,5690,110
2020-04-19,Serbia,RS,304,7,6963764,Europe,5994,117
2020-04-20,Serbia,RS,324,5,6963764,Europe,6318,122
2020-04-21,Serbia,RS,312,3,6963764,Europe,6630,125
2020-04-22,Serbia,RS,260,0,6963764,Europe,6890,125
2020-04-23,Serbia,RS,224,9,6963764,Europe,7114,134
2020-04-24,Serbia,RS,162,5,6963764,Europe,7276,139
2020-04-25,Serbia,RS,207,5,6963764,Europe,7483,144
2020-04-26,Serbia,RS,296,7,6963764,Europe,7779,151
2020-04-27,Serbia,RS,263,5,6963764,Europe,8042,156
2020-04-28,Serbia,RS,233,6,6963764,Europe,8275,162
2020-04-29,Serbia,RS,222,6,6963764,Europe,8497,168
2020-04-30,Serbia,RS,227,5,6963764,Europe,8724,173
2020-05-01,Serbia,RS,285,6,6963764,Europe,9009,179
2020-05-02,Serbia,RS,196,6,6963764,Europe,9205,185
2020-05-03,Serbia,RS,157,4,6963764,Europe,9362,189
2020-05-04,Serbia,RS,102,4,6963764,Europe,9464,193
2020-05-05,Serbia,RS,93,4,6963764,Europe,9557,197
2020-05-06,Serbia,RS,120,3,6963764,Europe,9677,200
2020-05-07,Serbia,RS,114,3,6963764,Europe,9791,203
2020-05-08,Serbia,RS,57,3,6963764,Europe,9848,206
2020-05-09,Serbia,RS,95,3,6963764,Europe,9943,209
2020-05-10,Serbia,RS,89,4,6963764,Europe,10032,213
2020-05-11,Serbia,RS,82,2,6963764,Europe,10114,215
2020-05-12,Serbia,RS,62,3,6963764,Europe,10176,218
2020-05-13,Serbia,RS,67,2,6963764,Europe,10243,220
2020-05-14,Serbia,RS,52,2,6963764,Europe,10295,222
2020-05-15,Serbia,RS,79,2,6963764,Europe,10374,224
2020-05-16,Serbia,RS,64,1,6963764,Europe,10438,225
2020-05-17,Serbia,RS,58,3,6963764,Europe,10496,228
2020-05-18,Serbia,RS,114,2,6963764,Europe,10610,230
2020-05-19,Serbia,RS,89,1,6963764,Europe,10699,231
2020-05-20,Serbia,RS,34,3,6963764,Europe,10733,234
2020-05-21,Serbia,RS,100,1,6963764,Europe,10833,235
2020-05-22,Serbia,RS,86,2,6963764,Europe,10919,237
2020-05-23,Serbia,RS,105,0,6963764,Europe,11024,237
2020-05-24,Serbia,RS,68,1,6963764,Europe,11092,238
2020-05-25,Serbia,RS,67,0,6963764,Europe,11159,238
2020-05-26,Serbia,RS,34,1,6963764,Europe,11193,239
2020-05-27,Serbia,RS,34,0,6963764,Europe,11227,239
2020-05-28,Serbia,RS,48,1,6963764,Europe,11275,240
2020-05-29,Serbia,RS,25,1,6963764,Europe,11300,241
2020-05-30,Serbia,RS,54,1,6963764,Europe,11354,242
2020-05-31,Serbia,RS,27,0,6963764,Europe,11381,242
2020-06-01,Serbia,RS,31,1,6963764,Europe,11412,243
2020-06-02,Serbia,RS,18,1,6963764,Europe,11430,244
2020-06-03,Serbia,RS,24,1,6963764,Europe,11454,245
2020-06-04,Serbia,RS,69,0,6963764,Europe,11523,245
2020-06-05,Serbia,RS,48,1,6963764,Europe,11571,246
2020-06-06,Serbia,RS,96,1,6963764,Europe,11667,247
2020-06-07,Serbia,RS,74,1,6963764,Europe,11741,248
2020-06-08,Serbia,RS,82,1,6963764,Europe,11823,249
2020-06-09,Serbia,RS,73,1,6963764,Europe,11896,250
2020-06-10,Serbia,RS,69,0,6963764,Europe,11965,250
2020-06-11,Serbia,RS,66,1,6963764,Europe,12031,251
2020-06-12,Serbia,RS,71,1,6963764,Europe,12102,252
2020-06-13,Serbia,RS,73,0,6963764,Europe,12175,252
2020-06-14,Serbia,RS,76,1,6963764,Europe,12251,253
2020-06-15,Serbia,RS,59,1,6963764,Europe,12310,254
2020-06-16,Serbia,RS,57,1,6963764,Europe,12367,255
2020-06-17,Serbia,RS,59,1,6963764,Europe,12426,256
2020-06-18,Serbia,RS,96,1,6963764,Europe,12522,257
2020-06-19,Serbia,RS,94,1,6963764,Europe,12616,258
2020-06-20,Serbia,RS,93,1,6963764,Europe,12709,259
2020-06-21,Serbia,RS,94,1,6963764,Europe,12803,260
2020-06-22,Serbia,RS,91,1,6963764,Europe,12894,261
2020-06-23,Serbia,RS,96,1,6963764,Europe,12990,262
2020-06-24,Serbia,RS,102,1,6963764,Europe,13092,263
2020-06-25,Serbia,RS,143,0,6963764,Europe,13235,263
2020-06-26,Serbia,RS,137,1,6963764,Europe,13372,264
2020-06-27,Serbia,RS,193,1,6963764,Europe,13565,265
2020-06-28,Serbia,RS,227,2,6963764,Europe,13792,267
2020-06-29,Serbia,RS,254,3,6963764,Europe,14046,270
2020-06-30,Serbia,RS,242,4,6963764,Europe,14288,274
2020-07-01,Serbia,RS,276,3,6963764,Europe,14564,277
2020-07-02,Serbia,RS,272,4,6963764,Europe,14836,281
2020-07-03,Serbia,RS,359,6,6963764,Europe,15195,287
2020-07-04,Serbia,RS,309,11,6963764,Europe,15504,298
2020-07-05,Serbia,RS,325,8,6963764,Europe,15829,306
2020-07-06,Serbia,RS,302,5,6963764,Europe,16131,311
2020-07-07,Serbia,RS,289,6,6963764,Europe,16420,317
2020-07-08,Serbia,RS,299,13,6963764,Europe,16719,330
2020-07-09,Serbia,RS,357,11,6963764,Europe,17076,341
2020-07-10,Serbia,RS,266,11,6963764,Europe,17342,352
2020-07-11,Serbia,RS,386,18,6963764,Europe,17728,370
2020-07-12,Serbia,RS,345,12,6963764,Europe,18073,382
2020-07-13,Serbia,RS,287,11,6963764,Europe,18360,393
2020-07-14,Serbia,RS,279,12,6963764,Europe,18639,405
2020-07-15,Serbia,RS,344,13,6963764,Europe,18983,418
2020-07-16,Serbia,RS,351,11,6963764,Europe,19334,429
2020-07-17,Serbia,RS,383,13,6963764,Europe,19717,442
2020-07-18,Serbia,RS,392,10,6963764,Europe,20109,452
2020-07-19,Serbia,RS,389,9,6963764,Europe,20498,461
2020-07-20,Serbia,RS,396,11,6963764,Europe,20894,472
2020-07-21,Serbia,RS,359,10,6963764,Europe,21253,482
2020-07-22,Serbia,RS,352,9,6963764,Europe,21605,491
2020-07-23,Serbia,RS,426,8,6963764,Europe,22031,499
2020-07-24,Serbia,RS,412,9,6963764,Europe,22443,508
2020-07-25,Serbia,RS,409,10,6963764,Europe,22852,518
2020-07-26,Serbia,RS,411,8,6963764,Europe,23263,526
2020-07-27,Serbia,RS,467,8,6963764,Europe,23730,534
2020-07-28,Serbia,RS,411,9,6963764,Europe,24141,543
2020-07-29,Serbia,RS,379,8,6963764,Europe,24520,551
2020-07-30,Serbia,RS,372,7,6963764,Europe,24892,558
2020-07-31,Serbia,RS,321,7,6963764,Europe,25213,565
2020-08-01,Serbia,RS,339,8,6963764,Europe,25552,573
2020-08-02,Serbia,RS,330,9,6963764,Europe,25882,582
2020-08-03,Serbia,RS,311,8,6963764,Europe,26193,590
2020-08-04,Serbia,RS,258,8,6963764,Europe,26451,598
2020-08-05,Serbia,RS,287,7,6963764,Europe,26738,605
2020-08-06,Serbia,RS,295,9,6963764,Europe,27033,614
2020-08-07,Serbia,RS,299,7,6963764,Europe,27332,621
2020-08-08,Serbia,RS,276,5,6963764,Europe,27608,626
2020-08-09,Serbia,RS,255,6,6963764,Europe,27863,632
2020-08-10,Serbia,RS,236,9,6963764,Europe,28099,641
2020-08-11,Serbia,RS,163,5,6963764,Europe,28262,646
2020-08-12,Serbia,RS,235,6,6963764,Europe,28497,652
2020-08-13,Serbia,RS,254,6,6963764,Europe,28751,658
2020-08-14,Serbia,RS,247,3,6963764,Europe,28998,661
2020-08-15,Serbia,RS,235,4,6963764,Europe,29233,665
2020-08-16,Serbia,RS,238,5,6963764,Europe,29471,670
2020-08-17,Serbia,RS,211,4,6963764,Europe,29682,674
2020-08-18,Serbia,RS,100,3,6963764,Europe,29782,677
2020-08-19,Serbia,RS,108,4,6963764,Europe,29890,681
2020-08-20,Serbia,RS,158,3,6963764,Europe,30048,684
2020-08-21,Serbia,RS,161,5,6963764,Europe,30209,689
2020-08-22,Serbia,RS,169,3,6963764,Europe,30378,692
2020-08-23,Serbia,RS,170,3,6963764,Europe,30548,695
2020-08-24,Serbia,RS,109,3,6963764,Europe,30657,698
2020-08-25,Serbia,RS,57,3,6963764,Europe,30714,701
2020-08-26,Serbia,RS,106,4,6963764,Europe,30820,705
2020-08-27,Serbia,RS,154,2,6963764,Europe,30974,707
2020-08-28,Serbia,RS,125,0,6963764,Europe,31099,707
2020-08-29,Serbia,RS,108,2,6963764,Europe,31207,709
2020-08-30,Serbia,RS,75,1,6963764,Europe,31282,710
2020-08-31,Serbia,RS,83,1,6963764,Europe,31365,711
2020-09-01,Serbia,RS,41,2,6963764,Europe,31406,713
2020-09-02,Serbia,RS,76,2,6963764,Europe,31482,715
2020-09-03,Serbia,RS,99,1,6963764,Europe,31581,716
2020-09-04,Serbia,RS,95,2,6963764,Europe,31676,718
2020-09-05,Serbia,RS,96,3,6963764,Europe,31772,721
2020-09-06,Serbia,RS,77,2,6963764,Europe,31849,723
2020-09-07,Serbia,RS,56,1,6963764,Europe,31905,724
2020-09-08,Serbia,RS,36,1,6963764,Europe,31941,725
2020-09-09,Serbia,RS,53,2,6963764,Europe,31994,727
2020-09-10,Serbia,RS,84,1,6963764,Europe,32078,728
2020-09-11,Serbia,RS,58,1,6963764,Europe,32136,729
2020-09-12,Serbia,RS,92,1,6963764,Europe,32228,730
2020-09-13,Serbia,RS,72,1,6963764,Europe,32300,731
2020-09-14,Serbia,RS,108,2,6963764,Europe,32408,733
2020-09-15,Serbia,RS,29,0,6963764,Europe,32437,733
2020-09-16,Serbia,RS,74,2,6963764,Europe,32511,735
2020-09-17,Serbia,RS,102,1,6963764,Europe,32613,736
2020-09-18,Serbia,RS,82,2,6963764,Europe,32695,738
2020-09-19,Serbia,RS,62,1,6963764,Europe,32757,739
2020-09-20,Serbia,RS,83,1,6963764,Europe,32840,740
2020-09-21,Serbia,RS,68,1,6963764,Europe,32908,741
2020-09-22,Serbia,RS,30,2,6963764,Europe,32938,743
2020-09-23,Serbia,RS,61,0,6963764,Europe,32999,743
2020-09-24,Serbia,RS,81,1,6963764,Europe,33080,744
2020-09-25,Serbia,RS,83,1,6963764,Europe,33163,745
2020-09-26,Serbia,RS,75,1,6963764,Europe,33238,746
2020-09-27,Serbia,RS,74,0,6963764,Europe,33312,746
2020-09-28,Serbia,RS,72,1,6963764,Europe,33384,747
2020-09-29,Serbia,RS,30,1,6963764,Europe,33414,748
2020-09-30,Serbia,RS,65,1,6963764,Europe,33479,749
2020-10-01,Serbia,RS,72,0,6963764,Europe,33551,749
2020-10-02,Serbia,RS,111,1,6963764,Europe,33662,750
2020-10-03,Serbia,RS,73,1,6963764,Europe,33735,751
2020-10-04,Serbia,RS,107,2,6963764,Europe,33842,753
2020-10-05,Serbia,RS,59,1,6963764,Europe,33901,754
2020-10-06,Serbia,RS,0,0,6963764,Europe,33901,754
2020-10-07,Serbia,RS,171,3,6963764,Europe,34072,757
2020-10-08,Serbia,RS,121,1,6963764,Europe,34193,758
2020-10-09,Serbia,RS,151,2,6963764,Europe,34344,760
2020-10-10,Serbia,RS,173,1,6963764,Europe,34517,761
2020-10-11,Serbia,RS,168,1,6963764,Europe,34685,762
2020-10-12,Serbia,RS,102,1,6963764,Europe,34787,763
2020-10-13,Serbia,RS,67,2,6963764,Europe,34854,765
2020-10-14,Serbia,RS,152,2,6963764,Europe,35006,767
2020-10-15,Serbia,RS,245,1,6963764,Europe,35251,768
2020-10-16,Serbia,RS,203,2,6963764,Europe,35454,770
2020-10-17,Serbia,RS,265,2,6963764,Europe,35719,772
2020-10-18,Serbia,RS,227,2,6963764,Europe,35946,774
2020-10-19,Serbia,RS,214,2,6963764,Europe,36160,776
2020-10-20,Serbia,RS,122,2,6963764,Europe,36282,778
2020-10-21,Serbia,RS,326,2,6963764,Europe,36608,780
2020-10-22,Serbia,RS,512,0,6963764,Europe,37120,780
2020-10-23,Serbia,RS,416,3,6963764,Europe,37536,783
2020-10-24,Serbia,RS,579,3,6963764,Europe,38115,786
2020-10-25,Serbia,RS,757,3,6963764,Europe,38872,789
2020-10-26,Serbia,RS,614,3,6963764,Europe,39486,792
2020-10-27,Serbia,RS,341,1,6963764,Europe,39827,793
2020-10-28,Serbia,RS,1053,5,6963764,Europe,40880,798
2020-10-29,Serbia,RS,1328,5,6963764,Europe,42208,803
2020-10-30,Serbia,RS,1384,6,6963764,Europe,43592,809
2020-10-31,Serbia,RS,1545,5,6963764,Europe,45137,814
2020-11-01,Serbia,RS,1817,6,6963764,Europe,46954,820
2020-11-02,Serbia,RS,1449,6,6963764,Europe,48403,826
2020-11-03,Serbia,RS,802,7,6963764,Europe,49205,833
2020-11-04,Serbia,RS,1878,11,6963764,Europe,51083,844
2020-11-05,Serbia,RS,2412,6,6963764,Europe,53495,850
2020-11-06,Serbia,RS,2181,11,6963764,Europe,55676,861
2020-11-07,Serbia,RS,2282,10,6963764,Europe,57958,871
2020-11-08,Serbia,RS,2677,9,6963764,Europe,60635,880
2020-11-09,Serbia,RS,2112,10,6963764,Europe,62747,890
2020-11-10,Serbia,RS,1318,11,6963764,Europe,64065,901
2020-11-11,Serbia,RS,2823,14,6963764,Europe,66888,915
2020-11-12,Serbia,RS,3536,21,6963764,Europe,70424,936
2020-11-13,Serbia,RS,3341,19,6963764,Europe,73765,955
2020-11-14,Serbia,RS,3499,17,6963764,Europe,77264,972
2020-11-15,Serbia,RS,3822,17,6963764,Europe,81086,989
2020-11-16,Serbia,RS,3482,20,6963764,Europe,84568,1009
2020-11-17,Serbia,RS,2813,21,6963764,Europe,87381,1030
2020-11-18,Serbia,RS,4994,24,6963764,Europe,92375,1054
2020-11-19,Serbia,RS,5613,27,6963764,Europe,97988,1081
2020-11-20,Serbia,RS,6109,29,6963764,Europe,104097,1110
2020-11-21,Serbia,RS,6254,30,6963764,Europe,110351,1140
2020-11-22,Serbia,RS,5774,28,6963764,Europe,116125,1168
2020-11-23,Serbia,RS,4995,31,6963764,Europe,121120,1199
2020-11-24,Serbia,RS,5067,38,6963764,Europe,126187,1237
2020-11-25,Serbia,RS,6842,37,6963764,Europe,133029,1274
2020-11-26,Serbia,RS,7579,41,6963764,Europe,140608,1315
2020-11-27,Serbia,RS,7606,51,6963764,Europe,148214,1366
2020-11-28,Serbia,RS,7780,57,6963764,Europe,155994,1423
2020-11-29,Serbia,RS,7041,61,6963764,Europe,163035,1484
2020-11-30,Serbia,RS,6179,65,6963764,Europe,169214,1549
2020-12-01,Serbia,RS,6224,55,6963764,Europe,175438,1604
2020-12-02,Serbia,RS,7999,48,6963764,Europe,183437,1652
2020-12-03,Serbia,RS,7919,52,6963764,Europe,191356,1704
2020-12-04,Serbia,RS,7802,61,6963764,Europe,199158,1765
2020-12-05,Serbia,RS,7782,69,6963764,Europe,206940,1834
2020-12-06,Serbia,RS,6903,57,6963764,Europe,213843,1891
2020-12-07,Serbia,RS,5809,58,6963764,Europe,219652,1949
2020-12-08,Serbia,RS,6557,56,6963764,Europe,226209,2005
2020-12-09,Serbia,RS,7818,57,6963764,Europe,234027,2062
2020-12-10,Serbia,RS,7804,54,6963764,Europe,241831,2116
2020-12-11,Serbia,RS,7393,56,6963764,Europe,249224,2172
2020-12-12,Serbia,RS,6534,55,6963764,Europe,255758,2227
2020-12-13,Serbia,RS,5679,48,6963764,Europe,261437,2275
2020-12-14,Serbia,RS,4995,56,6963764,Europe,266432,2331
2019-12-31,Russia,RU,0,0,145872260,Europe,0,0
2020-01-01,Russia,RU,0,0,145872260,Europe,0,0
2020-01-02,Russia,RU,0,0,145872260,Europe,0,0
2020-01-03,Russia,RU,0,0,145872260,Europe,0,0
2020-01-04,Russia,RU,0,0,145872260,Europe,0,0
2020-01-05,Russia,RU,0,0,145872260,Europe,0,0
2020-01-06,Russia,RU,0,0,145872260,Europe,0,0
2020-01-07,Russia,RU,0,0,145872260,Europe,0,0
2020-01-08,Russia,RU,0,0,145872260,Europe,0,0
2020-01-09,Russia,RU,0,0,145872260,Europe,0,0
2020-01-10,Russia,RU,0,0,145872260,Europe,0,0
2020-01-11,Russia,RU,0,0,145872260,Europe,0,0
2020-01-12,Russia,RU,0,0,145872260,Europe,0,0
2020-01-13,Russia,RU,0,0,145872260,Europe,0,0
2020-01-14,Russia,RU,0,0,145872260,Europe,0,0
2020-01-15,Russia,RU,0,0,145872260,Europe,0,0
2020-01-16,Russia,RU,0,0,145872260,Europe,0,0
2020-01-17,Russia,RU,0,0,145872260,Europe,0,0
2020-01-18,Russia,RU,0,0,145872260,Europe,0,0
2020-01-19,Russia,RU,0,0,145872260,Europe,0,0
2020-01-20,Russia,RU,0,0,145872260,Europe,0,0
2020-01-21,Russia,RU,0,0,145872260,Europe,0,0
2020-01-22,Russia,RU,0,0,145872260,Europe,0,0
2020-01-23,Russia,RU,0,0,145872260,Europe,0,0
2020-01-24,Russia,RU,0,0,145872260,Europe,0,0
2020-01-25,Russia,RU,0,0,145872260,Europe,0,0
2020-01-26,Russia,RU,0,0,145872260,Europe,0,0
2020-01-27,Russia,RU,0,0,145872260,Europe,0,0
2020-01-28,Russia,RU,0,0,145872260,Europe,0,0
2020-01-29,Russia,RU,0,0,145872260,Europe,0,0
2020-01-30,Russia,RU,0,0,145872260,Europe,0,0
2020-01-31,Russia,RU,0,0,145872260,Europe,0,0
2020-02-01,Russia,RU,2,0,145872260,Europe,2,0
2020-02-02,Russia,RU,0,0,145872260,Europe,2,0
2020-02-03,Russia,RU,0,0,145872260,Europe,2,0
2020-02-04,Russia,RU,0,0,145872260,Europe,2,0
2020-02-05,Russia,RU,0,0,145872260,Europe,2,0
2020-02-06,Russia,RU,0,0,145872260,Europe,2,0
2020-02-07,Russia,RU,0,0,145872260,Europe,2,0
2020-02-08,Russia,RU,0,0,145872260,Europe,2,0
2020-02-09,Russia,RU,0,0,145872260,Europe,2,0
2020-02-10,Russia,RU,0,0,145872260,Europe,2,0
2020-02-11,Russia,RU,0,0,145872260,Europe,2,0
2020-02-12,Russia,RU,0,0,145872260,Europe,2,0
2020-02-13,Russia,RU,0,0,145872260,Europe,2,0
2020-02-14,Russia,RU,0,0,145872260,Europe,2,0
2020-02-15,Russia,RU,0,0,145872260,Europe,2,0
2020-02-16,Russia,RU,0,0,145872260,Europe,2,0
2020-02-17,Russia,RU,0,0,145872260,Europe,2,0
2020-02-18,Russia,RU,0,0,145872260,Europe,2,0
2020-02-19,Russia,RU,0,0,145872260,Europe,2,0
2020-02-20,Russia,RU,0,0,145872260,Europe,2,0
2020-02-21,Russia,RU,0,0,145872260,Europe,2,0
2020-02-22,Russia,RU,0,0,145872260,Europe,2,0
2020-02-23,Russia,RU,0,0,145872260,Europe,2,0
2020-02-24,Russia,RU,0,0,145872260,Europe,2,0
2020-02-25,Russia,RU,0,0,145872260,Europe,2,0
2020-02-26,Russia,RU,0,0,145872260,Europe,2,0
2020-02-27,Russia,RU,0,0,145872260,Europe,2,0
2020-02-28,Russia,RU,0,0,145872260,Europe,2,0
2020-02-29,Russia,RU,0,0,145872260,Europe,2,0
2020-03-01,Russia,RU,0,0,145872260,Europe,2,0
2020-03-02,Russia,RU,0,0,145872260,Europe,2,0
2020-03-03,Russia,RU,1,0,145872260,Europe,3,0
2020-03-04,Russia,RU,1,0,145872260,Europe,4,0
2020-03-05,Russia,RU,0,0,145872260,Europe,4,0
2020-03-06,Russia,RU,0,0,145872260,Europe,4,0
2020-03-07,Russia,RU,6,0,145872260,Europe,10,0
2020-03-08,Russia,RU,0,0,145872260,Europe,10,0
2020-03-09,Russia,RU,0,0,145872260,Europe,10,0
2020-03-10,Russia,RU,0,0,145872260,Europe,10,0
2020-03-11,Russia,RU,0,0,145872260,Europe,10,0
2020-03-12,Russia,RU,15,0,145872260,Europe,25,0
2020-03-13,Russia,RU,5,0,145872260,Europe,30,0
2020-03-14,Russia,RU,15,0,145872260,Europe,45,0
2020-03-15,Russia,RU,14,0,145872260,Europe,59,0
2020-03-16,Russia,RU,4,0,145872260,Europe,63,0
2020-03-17,Russia,RU,30,0,145872260,Europe,93,0
2020-03-18,Russia,RU,21,0,145872260,Europe,114,0
2020-03-19,Russia,RU,33,0,145872260,Europe,147,0
2020-03-20,Russia,RU,52,0,145872260,Europe,199,0
2020-03-21,Russia,RU,54,0,145872260,Europe,253,0
2020-03-22,Russia,RU,53,0,145872260,Europe,306,0
2020-03-23,Russia,RU,61,0,145872260,Europe,367,0
2020-03-24,Russia,RU,71,0,145872260,Europe,438,0
2020-03-25,Russia,RU,57,0,145872260,Europe,495,0
2020-03-26,Russia,RU,163,0,145872260,Europe,658,0
2020-03-27,Russia,RU,182,2,145872260,Europe,840,2
2020-03-28,Russia,RU,196,2,145872260,Europe,1036,4
2020-03-29,Russia,RU,228,1,145872260,Europe,1264,5
2020-03-30,Russia,RU,270,3,145872260,Europe,1534,8
2020-03-31,Russia,RU,302,2,145872260,Europe,1836,10
2020-04-01,Russia,RU,501,7,145872260,Europe,2337,17
2020-04-02,Russia,RU,440,7,145872260,Europe,2777,24
2020-04-03,Russia,RU,771,6,145872260,Europe,3548,30
2020-04-04,Russia,RU,601,4,145872260,Europe,4149,34
2020-04-05,Russia,RU,582,9,145872260,Europe,4731,43
2020-04-06,Russia,RU,658,2,145872260,Europe,5389,45
2020-04-07,Russia,RU,954,2,145872260,Europe,6343,47
2020-04-08,Russia,RU,1154,11,145872260,Europe,7497,58
2020-04-09,Russia,RU,1175,5,145872260,Europe,8672,63
2020-04-10,Russia,RU,1459,13,145872260,Europe,10131,76
2020-04-11,Russia,RU,1786,18,145872260,Europe,11917,94
2020-04-12,Russia,RU,1667,12,145872260,Europe,13584,106
2020-04-13,Russia,RU,2186,24,145872260,Europe,15770,130
2020-04-14,Russia,RU,2558,18,145872260,Europe,18328,148
2020-04-15,Russia,RU,2774,22,145872260,Europe,21102,170
2020-04-16,Russia,RU,3388,28,145872260,Europe,24490,198
2020-04-17,Russia,RU,3448,34,145872260,Europe,27938,232
2020-04-18,Russia,RU,4070,41,145872260,Europe,32008,273
2020-04-19,Russia,RU,4785,40,145872260,Europe,36793,313
2020-04-20,Russia,RU,6060,48,145872260,Europe,42853,361
2020-04-21,Russia,RU,4268,44,145872260,Europe,47121,405
2020-04-22,Russia,RU,5642,51,145872260,Europe,52763,456
2020-04-23,Russia,RU,5236,57,145872260,Europe,57999,513
2020-04-24,Russia,RU,4774,42,145872260,Europe,62773,555
2020-04-25,Russia,RU,5849,60,145872260,Europe,68622,615
2020-04-26,Russia,RU,5966,66,145872260,Europe,74588,681
2020-04-27,Russia,RU,6361,66,145872260,Europe,80949,747
2020-04-28,Russia,RU,6198,48,145872260,Europe,87147,795
2020-04-29,Russia,RU,6411,72,145872260,Europe,93558,867
2020-04-30,Russia,RU,5841,105,145872260,Europe,99399,972
2020-05-01,Russia,RU,7099,101,145872260,Europe,106498,1073
2020-05-02,Russia,RU,7933,96,145872260,Europe,114431,1169
2020-05-03,Russia,RU,9623,53,145872260,Europe,124054,1222
2020-05-04,Russia,RU,10633,58,145872260,Europe,134687,1280
2020-05-05,Russia,RU,10581,76,145872260,Europe,145268,1356
2020-05-06,Russia,RU,10102,95,145872260,Europe,155370,1451
2020-05-07,Russia,RU,10559,86,145872260,Europe,165929,1537
2020-05-08,Russia,RU,11231,88,145872260,Europe,177160,1625
2020-05-09,Russia,RU,10699,98,145872260,Europe,187859,1723
2020-05-10,Russia,RU,10817,104,145872260,Europe,198676,1827
2020-05-11,Russia,RU,11012,88,145872260,Europe,209688,1915
2020-05-12,Russia,RU,11656,94,145872260,Europe,221344,2009
2020-05-13,Russia,RU,10899,107,145872260,Europe,232243,2116
2020-05-14,Russia,RU,10028,96,145872260,Europe,242271,2212
2020-05-15,Russia,RU,9974,93,145872260,Europe,252245,2305
2020-05-16,Russia,RU,10598,113,145872260,Europe,262843,2418
2020-05-17,Russia,RU,9200,119,145872260,Europe,272043,2537
2020-05-18,Russia,RU,9709,94,145872260,Europe,281752,2631
2020-05-19,Russia,RU,8926,91,145872260,Europe,290678,2722
2020-05-20,Russia,RU,9263,115,145872260,Europe,299941,2837
2020-05-21,Russia,RU,8764,135,145872260,Europe,308705,2972
2020-05-22,Russia,RU,8849,127,145872260,Europe,317554,3099
2020-05-23,Russia,RU,8894,150,145872260,Europe,326448,3249
2020-05-24,Russia,RU,9434,139,145872260,Europe,335882,3388
2020-05-25,Russia,RU,8599,153,145872260,Europe,344481,3541
2020-05-26,Russia,RU,8946,92,145872260,Europe,353427,3633
2020-05-27,Russia,RU,8915,174,145872260,Europe,362342,3807
2020-05-28,Russia,RU,8338,161,145872260,Europe,370680,3968
2020-05-29,Russia,RU,8371,174,145872260,Europe,379051,4142
2020-05-30,Russia,RU,8572,232,145872260,Europe,387623,4374
2020-05-31,Russia,RU,8952,181,145872260,Europe,396575,4555
2020-06-01,Russia,RU,9268,138,145872260,Europe,405843,4693
2020-06-02,Russia,RU,9035,162,145872260,Europe,414878,4855
2020-06-03,Russia,RU,8863,182,145872260,Europe,423741,5037
2020-06-04,Russia,RU,8536,178,145872260,Europe,432277,5215
2020-06-05,Russia,RU,8831,169,145872260,Europe,441108,5384
2020-06-06,Russia,RU,8726,144,145872260,Europe,449834,5528
2020-06-07,Russia,RU,8855,197,145872260,Europe,458689,5725
2020-06-08,Russia,RU,8984,134,145872260,Europe,467673,5859
2020-06-09,Russia,RU,8985,112,145872260,Europe,476658,5971
2020-06-10,Russia,RU,8595,170,145872260,Europe,485253,6141
2020-06-11,Russia,RU,8404,217,145872260,Europe,493657,6358
2020-06-12,Russia,RU,8779,174,145872260,Europe,502436,6532
2020-06-13,Russia,RU,8987,183,145872260,Europe,511423,6715
2020-06-14,Russia,RU,8706,114,145872260,Europe,520129,6829
2020-06-15,Russia,RU,8835,119,145872260,Europe,528964,6948
2020-06-16,Russia,RU,8246,143,145872260,Europe,537210,7091
2020-06-17,Russia,RU,8248,193,145872260,Europe,545458,7284
2020-06-18,Russia,RU,7843,194,145872260,Europe,553301,7478
2020-06-19,Russia,RU,7790,312,145872260,Europe,561091,7790
2020-06-20,Russia,RU,7972,182,145872260,Europe,569063,7972
2020-06-21,Russia,RU,7889,30,145872260,Europe,576952,8002
2020-06-22,Russia,RU,7728,109,145872260,Europe,584680,8111
2020-06-23,Russia,RU,7600,95,145872260,Europe,592280,8206
2020-06-24,Russia,RU,7425,153,145872260,Europe,599705,8359
2020-06-25,Russia,RU,7176,154,145872260,Europe,606881,8513
2020-06-26,Russia,RU,7113,92,145872260,Europe,613994,8605
2020-06-27,Russia,RU,6800,176,145872260,Europe,620794,8781
2020-06-28,Russia,RU,6852,188,145872260,Europe,627646,8969
2020-06-29,Russia,RU,6791,104,145872260,Europe,634437,9073
2020-06-30,Russia,RU,6719,93,145872260,Europe,641156,9166
2020-07-01,Russia,RU,6693,154,145872260,Europe,647849,9320
2020-07-02,Russia,RU,6556,216,145872260,Europe,654405,9536
2020-07-03,Russia,RU,6760,147,145872260,Europe,661165,9683
2020-07-04,Russia,RU,6718,176,145872260,Europe,667883,9859
2020-07-05,Russia,RU,6632,168,145872260,Europe,674515,10027
2020-07-06,Russia,RU,6736,134,145872260,Europe,681251,10161
2020-07-07,Russia,RU,6611,135,145872260,Europe,687862,10296
2020-07-08,Russia,RU,6368,198,145872260,Europe,694230,10494
2020-07-09,Russia,RU,6562,173,145872260,Europe,700792,10667
2020-07-10,Russia,RU,6509,176,145872260,Europe,707301,10843
2020-07-11,Russia,RU,6635,174,145872260,Europe,713936,11017
2020-07-12,Russia,RU,6611,188,145872260,Europe,720547,11205
2020-07-13,Russia,RU,6615,130,145872260,Europe,727162,11335
2020-07-14,Russia,RU,6537,104,145872260,Europe,733699,11439
2020-07-15,Russia,RU,6248,175,145872260,Europe,739947,11614
2020-07-16,Russia,RU,6422,156,145872260,Europe,746369,11770
2020-07-17,Russia,RU,6428,167,145872260,Europe,752797,11937
2020-07-18,Russia,RU,6406,186,145872260,Europe,759203,12123
2020-07-19,Russia,RU,6234,124,145872260,Europe,765437,12247
2020-07-20,Russia,RU,6109,95,145872260,Europe,771546,12342
2020-07-21,Russia,RU,5940,85,145872260,Europe,777486,12427
2020-07-22,Russia,RU,5842,153,145872260,Europe,783328,12580
2020-07-23,Russia,RU,5862,165,145872260,Europe,789190,12745
2020-07-24,Russia,RU,5848,147,145872260,Europe,795038,12892
2020-07-25,Russia,RU,5811,154,145872260,Europe,800849,13046
2020-07-26,Russia,RU,5871,146,145872260,Europe,806720,13192
2020-07-27,Russia,RU,5765,77,145872260,Europe,812485,13269
2020-07-28,Russia,RU,5635,85,145872260,Europe,818120,13354
2020-07-29,Russia,RU,5395,150,145872260,Europe,823515,13504
2020-07-30,Russia,RU,5475,169,145872260,Europe,828990,13673
2020-07-31,Russia,RU,5509,129,145872260,Europe,834499,13802
2020-08-01,Russia,RU,5482,161,145872260,Europe,839981,13963
2020-08-02,Russia,RU,5462,95,145872260,Europe,845443,14058
2020-08-03,Russia,RU,5427,70,145872260,Europe,850870,14128
2020-08-04,Russia,RU,5394,79,145872260,Europe,856264,14207
2020-08-05,Russia,RU,5159,144,145872260,Europe,861423,14351
2020-08-06,Russia,RU,5920,181,145872260,Europe,867343,14532
2020-08-07,Russia,RU,4551,74,145872260,Europe,871894,14606
2020-08-08,Russia,RU,5241,119,145872260,Europe,877135,14725
2020-08-09,Russia,RU,5212,129,145872260,Europe,882347,14854
2020-08-10,Russia,RU,5189,77,145872260,Europe,887536,14931
2020-08-11,Russia,RU,5118,130,145872260,Europe,892654,15061
2020-08-12,Russia,RU,4945,70,145872260,Europe,897599,15131
2020-08-13,Russia,RU,5102,129,145872260,Europe,902701,15260
2020-08-14,Russia,RU,5057,124,145872260,Europe,907758,15384
2020-08-15,Russia,RU,5065,114,145872260,Europe,912823,15498
2020-08-16,Russia,RU,5061,119,145872260,Europe,917884,15617
2020-08-17,Russia,RU,4969,68,145872260,Europe,922853,15685
2020-08-18,Russia,RU,4892,55,145872260,Europe,927745,15740
2020-08-19,Russia,RU,4748,132,145872260,Europe,932493,15872
2020-08-20,Russia,RU,4828,117,145872260,Europe,937321,15989
2020-08-21,Russia,RU,4785,110,145872260,Europe,942106,16099
2020-08-22,Russia,RU,4870,90,145872260,Europe,946976,16189
2020-08-23,Russia,RU,4921,121,145872260,Europe,951897,16310
2020-08-24,Russia,RU,4852,73,145872260,Europe,956749,16383
2020-08-25,Russia,RU,4744,65,145872260,Europe,961493,16448
2020-08-26,Russia,RU,4696,120,145872260,Europe,966189,16568
2020-08-27,Russia,RU,4676,115,145872260,Europe,970865,16683
2020-08-28,Russia,RU,4711,121,145872260,Europe,975576,16804
2020-08-29,Russia,RU,4829,110,145872260,Europe,980405,16914
2020-08-30,Russia,RU,4941,111,145872260,Europe,985346,17025
2020-08-31,Russia,RU,4980,68,145872260,Europe,990326,17093
2020-09-01,Russia,RU,4993,83,145872260,Europe,995319,17176
2020-09-02,Russia,RU,4729,123,145872260,Europe,1000048,17299
2020-09-03,Russia,RU,4952,115,145872260,Europe,1005000,17414
2020-09-04,Russia,RU,4995,114,145872260,Europe,1009995,17528
2020-09-05,Russia,RU,5110,121,145872260,Europe,1015105,17649
2020-09-06,Russia,RU,5205,110,145872260,Europe,1020310,17759
2020-09-07,Russia,RU,5195,61,145872260,Europe,1025505,17820
2020-09-08,Russia,RU,5185,51,145872260,Europe,1030690,17871
2020-09-09,Russia,RU,5099,122,145872260,Europe,1035789,17993
2020-09-10,Russia,RU,5218,160,145872260,Europe,1041007,18153
2020-09-11,Russia,RU,5363,110,145872260,Europe,1046370,18263
2020-09-12,Russia,RU,5504,102,145872260,Europe,1051874,18365
2020-09-13,Russia,RU,5488,119,145872260,Europe,1057362,18484
2020-09-14,Russia,RU,5449,94,145872260,Europe,1062811,18578
2020-09-15,Russia,RU,5509,57,145872260,Europe,1068320,18635
2020-09-16,Russia,RU,5529,150,145872260,Europe,1073849,18785
2020-09-17,Russia,RU,5670,132,145872260,Europe,1079519,18917
2020-09-18,Russia,RU,5762,144,145872260,Europe,1085281,19061
2020-09-19,Russia,RU,5905,134,145872260,Europe,1091186,19195
2020-09-20,Russia,RU,6065,144,145872260,Europe,1097251,19339
2020-09-21,Russia,RU,6148,79,145872260,Europe,1103399,19418
2020-09-22,Russia,RU,6196,71,145872260,Europe,1109595,19489
2020-09-23,Russia,RU,6215,160,145872260,Europe,1115810,19649
2020-09-24,Russia,RU,6431,150,145872260,Europe,1122241,19799
2020-09-25,Russia,RU,6595,149,145872260,Europe,1128836,19948
2020-09-26,Russia,RU,7212,108,145872260,Europe,1136048,20056
2020-09-27,Russia,RU,7523,169,145872260,Europe,1143571,20225
2020-09-28,Russia,RU,7867,99,145872260,Europe,1151438,20324
2020-09-29,Russia,RU,8135,61,145872260,Europe,1159573,20385
2020-09-30,Russia,RU,8232,160,145872260,Europe,1167805,20545
2020-10-01,Russia,RU,8481,177,145872260,Europe,1176286,20722
2020-10-02,Russia,RU,8945,169,145872260,Europe,1185231,20891
2020-10-03,Russia,RU,9412,186,145872260,Europe,1194643,21077
2020-10-04,Russia,RU,9859,174,145872260,Europe,1204502,21251
2020-10-05,Russia,RU,10499,107,145872260,Europe,1215001,21358
2020-10-06,Russia,RU,10888,117,145872260,Europe,1225889,21475
2020-10-07,Russia,RU,11615,188,145872260,Europe,1237504,21663
2020-10-08,Russia,RU,11115,202,145872260,Europe,1248619,21865
2020-10-09,Russia,RU,11493,191,145872260,Europe,1260112,22056
2020-10-10,Russia,RU,12126,201,145872260,Europe,1272238,22257
2020-10-11,Russia,RU,12846,197,145872260,Europe,1285084,22454
2020-10-12,Russia,RU,13634,143,145872260,Europe,1298718,22597
2020-10-13,Russia,RU,13592,125,145872260,Europe,1312310,22722
2020-10-14,Russia,RU,13868,244,145872260,Europe,1326178,22966
2020-10-15,Russia,RU,14231,239,145872260,Europe,1340409,23205
2020-10-16,Russia,RU,13754,286,145872260,Europe,1354163,23491
2020-10-17,Russia,RU,15150,232,145872260,Europe,1369313,23723
2020-10-18,Russia,RU,14922,279,145872260,Europe,1384235,24002
2020-10-19,Russia,RU,15099,185,145872260,Europe,1399334,24187
2020-10-20,Russia,RU,15982,179,145872260,Europe,1415316,24366
2020-10-21,Russia,RU,16319,269,145872260,Europe,1431635,24635
2020-10-22,Russia,RU,15700,317,145872260,Europe,1447335,24952
2020-10-23,Russia,RU,15971,290,145872260,Europe,1463306,25242
2020-10-24,Russia,RU,17340,283,145872260,Europe,1480646,25525
2020-10-25,Russia,RU,16521,296,145872260,Europe,1497167,25821
2020-10-26,Russia,RU,16710,229,145872260,Europe,1513877,26050
2020-10-27,Russia,RU,17347,219,145872260,Europe,1531224,26269
2020-10-28,Russia,RU,16550,320,145872260,Europe,1547774,26589
2020-10-29,Russia,RU,16202,346,145872260,Europe,1563976,26935
2020-10-30,Russia,RU,17717,366,145872260,Europe,1581693,27301
2020-10-31,Russia,RU,18283,355,145872260,Europe,1599976,27656
2020-11-01,Russia,RU,18140,334,145872260,Europe,1618116,27990
2020-11-02,Russia,RU,18665,245,145872260,Europe,1636781,28235
2020-11-03,Russia,RU,18257,238,145872260,Europe,1655038,28473
2020-11-04,Russia,RU,18648,355,145872260,Europe,1673686,28828
2020-11-05,Russia,RU,19768,389,145872260,Europe,1693454,29217
2020-11-06,Russia,RU,19404,292,145872260,Europe,1712858,29509
2020-11-07,Russia,RU,20582,378,145872260,Europe,1733440,29887
2020-11-08,Russia,RU,20396,364,145872260,Europe,1753836,30251
2020-11-09,Russia,RU,20498,286,145872260,Europe,1774334,30537
2020-11-10,Russia,RU,21798,256,145872260,Europe,1796132,30793
2020-11-11,Russia,RU,20977,368,145872260,Europe,1817109,31161
2020-11-12,Russia,RU,19851,432,145872260,Europe,1836960,31593
2020-11-13,Russia,RU,21608,439,145872260,Europe,1858568,32032
2020-11-14,Russia,RU,21983,411,145872260,Europe,1880551,32443
2020-11-15,Russia,RU,22702,391,145872260,Europe,1903253,32834
2020-11-16,Russia,RU,22572,352,145872260,Europe,1925825,33186
2020-11-17,Russia,RU,22778,303,145872260,Europe,1948603,33489
2020-11-18,Russia,RU,22410,442,145872260,Europe,1971013,33931
2020-11-19,Russia,RU,20985,456,145872260,Europe,1991998,34387
2020-11-20,Russia,RU,23610,463,145872260,Europe,2015608,34850
2020-11-21,Russia,RU,24318,461,145872260,Europe,2039926,35311
2020-11-22,Russia,RU,24822,467,145872260,Europe,2064748,35778
2020-11-23,Russia,RU,24581,401,145872260,Europe,2089329,36179
2020-11-24,Russia,RU,25173,361,145872260,Europe,2114502,36540
2020-11-25,Russia,RU,24326,491,145872260,Europe,2138828,37031
2020-11-26,Russia,RU,23675,507,145872260,Europe,2162503,37538
2020-11-27,Russia,RU,25487,524,145872260,Europe,2187990,38062
2020-11-28,Russia,RU,27543,496,145872260,Europe,2215533,38558
2020-11-29,Russia,RU,27100,510,145872260,Europe,2242633,39068
2020-11-30,Russia,RU,26683,459,145872260,Europe,2269316,39527
2020-12-01,Russia,RU,26338,368,145872260,Europe,2295654,39895
2020-12-02,Russia,RU,26402,569,145872260,Europe,2322056,40464
2020-12-03,Russia,RU,25345,589,145872260,Europe,2347401,41053
2020-12-04,Russia,RU,28145,554,145872260,Europe,2375546,41607
2020-12-05,Russia,RU,27403,569,145872260,Europe,2402949,42176
2020-12-06,Russia,RU,28782,508,145872260,Europe,2431731,42684
2020-12-07,Russia,RU,29039,457,145872260,Europe,2460770,43141
2020-12-08,Russia,RU,28142,456,145872260,Europe,2488912,43597
2020-12-09,Russia,RU,26097,562,145872260,Europe,2515009,44159
2020-12-10,Russia,RU,26190,559,145872260,Europe,2541199,44718
2020-12-11,Russia,RU,27927,562,145872260,Europe,2569126,45280
2020-12-12,Russia,RU,28585,613,145872260,Europe,2597711,45893
2020-12-13,Russia,RU,28137,560,145872260,Europe,2625848,46453
2020-12-14,Russia,RU,28080,488,145872260,Europe,2653928,46941
2020-03-15,Rwanda,RW,1,0,12626938,Africa,1,0
2020-03-16,Rwanda,RW,4,0,12626938,Africa,5,0
2020-03-17,Rwanda,RW,0,0,12626938,Africa,5,0
2020-03-18,Rwanda,RW,2,0,12626938,Africa,7,0
2020-03-19,Rwanda,RW,4,0,12626938,Africa,11,0
2020-03-20,Rwanda,RW,0,0,12626938,Africa,11,0
2020-03-21,Rwanda,RW,6,0,12626938,Africa,17,0
2020-03-22,Rwanda,RW,0,0,12626938,Africa,17,0
2020-03-23,Rwanda,RW,2,0,12626938,Africa,19,0
2020-03-24,Rwanda,RW,17,0,12626938,Africa,36,0
2020-03-25,Rwanda,RW,4,0,12626938,Africa,40,0
2020-03-26,Rwanda,RW,1,0,12626938,Africa,41,0
2020-03-27,Rwanda,RW,9,0,12626938,Africa,50,0
2020-03-28,Rwanda,RW,4,0,12626938,Africa,54,0
2020-03-29,Rwanda,RW,6,0,12626938,Africa,60,0
2020-03-30,Rwanda,RW,10,0,12626938,Africa,70,0
2020-03-31,Rwanda,RW,0,0,12626938,Africa,70,0
2020-04-01,Rwanda,RW,5,0,12626938,Africa,75,0
2020-04-02,Rwanda,RW,7,0,12626938,Africa,82,0
2020-04-03,Rwanda,RW,0,0,12626938,Africa,82,0
2020-04-04,Rwanda,RW,7,0,12626938,Africa,89,0
2020-04-05,Rwanda,RW,13,0,12626938,Africa,102,0
2020-04-06,Rwanda,RW,2,0,12626938,Africa,104,0
2020-04-07,Rwanda,RW,1,0,12626938,Africa,105,0
2020-04-08,Rwanda,RW,0,0,12626938,Africa,105,0
2020-04-09,Rwanda,RW,5,0,12626938,Africa,110,0
2020-04-10,Rwanda,RW,3,0,12626938,Africa,113,0
2020-04-11,Rwanda,RW,5,0,12626938,Africa,118,0
2020-04-12,Rwanda,RW,2,0,12626938,Africa,120,0
2020-04-13,Rwanda,RW,6,0,12626938,Africa,126,0
2020-04-14,Rwanda,RW,1,0,12626938,Africa,127,0
2020-04-15,Rwanda,RW,7,0,12626938,Africa,134,0
2020-04-16,Rwanda,RW,2,0,12626938,Africa,136,0
2020-04-17,Rwanda,RW,2,0,12626938,Africa,138,0
2020-04-18,Rwanda,RW,5,0,12626938,Africa,143,0
2020-04-19,Rwanda,RW,1,0,12626938,Africa,144,0
2020-04-20,Rwanda,RW,3,0,12626938,Africa,147,0
2020-04-21,Rwanda,RW,0,0,12626938,Africa,147,0
2020-04-22,Rwanda,RW,3,0,12626938,Africa,150,0
2020-04-23,Rwanda,RW,3,0,12626938,Africa,153,0
2020-04-24,Rwanda,RW,1,0,12626938,Africa,154,0
2020-04-25,Rwanda,RW,22,0,12626938,Africa,176,0
2020-04-26,Rwanda,RW,7,0,12626938,Africa,183,0
2020-04-27,Rwanda,RW,8,0,12626938,Africa,191,0
2020-04-28,Rwanda,RW,16,0,12626938,Africa,207,0
2020-04-29,Rwanda,RW,5,0,12626938,Africa,212,0
2020-04-30,Rwanda,RW,13,0,12626938,Africa,225,0
2020-05-01,Rwanda,RW,18,0,12626938,Africa,243,0
2020-05-02,Rwanda,RW,6,0,12626938,Africa,249,0
2020-05-03,Rwanda,RW,6,0,12626938,Africa,255,0
2020-05-04,Rwanda,RW,4,0,12626938,Africa,259,0
2020-05-05,Rwanda,RW,2,0,12626938,Africa,261,0
2020-05-06,Rwanda,RW,0,0,12626938,Africa,261,0
2020-05-07,Rwanda,RW,7,0,12626938,Africa,268,0
2020-05-08,Rwanda,RW,3,0,12626938,Africa,271,0
2020-05-09,Rwanda,RW,2,0,12626938,Africa,273,0
2020-05-10,Rwanda,RW,7,0,12626938,Africa,280,0
2020-05-11,Rwanda,RW,4,0,12626938,Africa,284,0
2020-05-12,Rwanda,RW,1,0,12626938,Africa,285,0
2020-05-13,Rwanda,RW,1,0,12626938,Africa,286,0
2020-05-14,Rwanda,RW,1,0,12626938,Africa,287,0
2020-05-15,Rwanda,RW,0,0,12626938,Africa,287,0
2020-05-16,Rwanda,RW,0,0,12626938,Africa,287,0
2020-05-17,Rwanda,RW,2,0,12626938,Africa,289,0
2020-05-18,Rwanda,RW,3,0,12626938,Africa,292,0
2020-05-19,Rwanda,RW,5,0,12626938,Africa,297,0
2020-05-20,Rwanda,RW,11,0,12626938,Africa,308,0
2020-05-21,Rwanda,RW,6,0,12626938,Africa,314,0
2020-05-22,Rwanda,RW,6,0,12626938,Africa,320,0
2020-05-23,Rwanda,RW,1,0,12626938,Africa,321,0
2020-05-24,Rwanda,RW,4,0,12626938,Africa,325,0
2020-05-25,Rwanda,RW,2,0,12626938,Africa,327,0
2020-05-26,Rwanda,RW,9,0,12626938,Africa,336,0
2020-05-27,Rwanda,RW,3,0,12626938,Africa,339,0
2020-05-28,Rwanda,RW,7,0,12626938,Africa,346,0
2020-05-29,Rwanda,RW,3,0,12626938,Africa,349,0
2020-05-30,Rwanda,RW,6,0,12626938,Africa,355,0
2020-05-31,Rwanda,RW,4,1,12626938,Africa,359,1
2020-06-01,Rwanda,RW,11,0,12626938,Africa,370,1
2020-06-02,Rwanda,RW,7,0,12626938,Africa,377,1
2020-06-03,Rwanda,RW,7,1,12626938,Africa,384,2
2020-06-04,Rwanda,RW,13,0,12626938,Africa,397,2
2020-06-05,Rwanda,RW,13,0,12626938,Africa,410,2
2020-06-06,Rwanda,RW,10,0,12626938,Africa,420,2
2020-06-07,Rwanda,RW,11,0,12626938,Africa,431,2
2020-06-08,Rwanda,RW,8,0,12626938,Africa,439,2
2020-06-09,Rwanda,RW,12,0,12626938,Africa,451,2
2020-06-10,Rwanda,RW,12,0,12626938,Africa,463,2
2020-06-11,Rwanda,RW,13,0,12626938,Africa,476,2
2020-06-12,Rwanda,RW,18,0,12626938,Africa,494,2
2020-06-13,Rwanda,RW,16,0,12626938,Africa,510,2
2020-06-14,Rwanda,RW,31,0,12626938,Africa,541,2
2020-06-15,Rwanda,RW,41,0,12626938,Africa,582,2
2020-06-16,Rwanda,RW,30,0,12626938,Africa,612,2
2020-06-17,Rwanda,RW,24,0,12626938,Africa,636,2
2020-06-18,Rwanda,RW,3,0,12626938,Africa,639,2
2020-06-19,Rwanda,RW,7,0,12626938,Africa,646,2
2020-06-20,Rwanda,RW,15,0,12626938,Africa,661,2
2020-06-21,Rwanda,RW,41,0,12626938,Africa,702,2
2020-06-22,Rwanda,RW,26,0,12626938,Africa,728,2
2020-06-23,Rwanda,RW,59,0,12626938,Africa,787,2
2020-06-24,Rwanda,RW,11,0,12626938,Africa,798,2
2020-06-25,Rwanda,RW,32,0,12626938,Africa,830,2
2020-06-26,Rwanda,RW,20,0,12626938,Africa,850,2
2020-06-27,Rwanda,RW,8,0,12626938,Africa,858,2
2020-06-28,Rwanda,RW,20,0,12626938,Africa,878,2
2020-06-29,Rwanda,RW,22,0,12626938,Africa,900,2
2020-06-30,Rwanda,RW,101,0,12626938,Africa,1001,2
2020-07-01,Rwanda,RW,24,0,12626938,Africa,1025,2
2020-07-02,Rwanda,RW,17,1,12626938,Africa,1042,3
2020-07-03,Rwanda,RW,21,0,12626938,Africa,1063,3
2020-07-04,Rwanda,RW,18,0,12626938,Africa,1081,3
2020-07-05,Rwanda,RW,11,0,12626938,Africa,1092,3
2020-07-06,Rwanda,RW,13,0,12626938,Africa,1105,3
2020-07-07,Rwanda,RW,8,0,12626938,Africa,1113,3
2020-07-08,Rwanda,RW,59,0,12626938,Africa,1172,3
2020-07-09,Rwanda,RW,22,0,12626938,Africa,1194,3
2020-07-10,Rwanda,RW,16,0,12626938,Africa,1210,3
2020-07-11,Rwanda,RW,42,0,12626938,Africa,1252,3
2020-07-12,Rwanda,RW,47,1,12626938,Africa,1299,4
2020-07-13,Rwanda,RW,38,0,12626938,Africa,1337,4
2020-07-14,Rwanda,RW,41,0,12626938,Africa,1378,4
2020-07-15,Rwanda,RW,38,0,12626938,Africa,1416,4
2020-07-16,Rwanda,RW,19,0,12626938,Africa,1435,4
2020-07-17,Rwanda,RW,38,0,12626938,Africa,1473,4
2020-07-18,Rwanda,RW,12,0,12626938,Africa,1485,4
2020-07-19,Rwanda,RW,54,1,12626938,Africa,1539,5
2020-07-20,Rwanda,RW,43,0,12626938,Africa,1582,5
2020-07-21,Rwanda,RW,47,0,12626938,Africa,1629,5
2020-07-22,Rwanda,RW,26,0,12626938,Africa,1655,5
2020-07-23,Rwanda,RW,34,0,12626938,Africa,1689,5
2020-07-24,Rwanda,RW,21,0,12626938,Africa,1710,5
2020-07-25,Rwanda,RW,19,0,12626938,Africa,1729,5
2020-07-26,Rwanda,RW,23,0,12626938,Africa,1752,5
2020-07-27,Rwanda,RW,69,0,12626938,Africa,1821,5
2020-07-28,Rwanda,RW,58,0,12626938,Africa,1879,5
2020-07-29,Rwanda,RW,47,0,12626938,Africa,1926,5
2020-07-30,Rwanda,RW,10,0,12626938,Africa,1936,5
2020-07-31,Rwanda,RW,58,0,12626938,Africa,1994,5
2020-08-01,Rwanda,RW,28,0,12626938,Africa,2022,5
2020-08-02,Rwanda,RW,20,0,12626938,Africa,2042,5
2020-08-03,Rwanda,RW,20,0,12626938,Africa,2062,5
2020-08-04,Rwanda,RW,30,0,12626938,Africa,2092,5
2020-08-05,Rwanda,RW,7,0,12626938,Africa,2099,5
2020-08-06,Rwanda,RW,5,0,12626938,Africa,2104,5
2020-08-07,Rwanda,RW,7,0,12626938,Africa,2111,5
2020-08-08,Rwanda,RW,17,0,12626938,Africa,2128,5
2020-08-09,Rwanda,RW,6,1,12626938,Africa,2134,6
2020-08-10,Rwanda,RW,6,1,12626938,Africa,2140,7
2020-08-11,Rwanda,RW,12,0,12626938,Africa,2152,7
2020-08-12,Rwanda,RW,19,0,12626938,Africa,2171,7
2020-08-13,Rwanda,RW,18,1,12626938,Africa,2189,8
2020-08-14,Rwanda,RW,11,0,12626938,Africa,2200,8
2020-08-15,Rwanda,RW,93,0,12626938,Africa,2293,8
2020-08-16,Rwanda,RW,59,0,12626938,Africa,2352,8
2020-08-17,Rwanda,RW,101,0,12626938,Africa,2453,8
2020-08-18,Rwanda,RW,87,0,12626938,Africa,2540,8
2020-08-19,Rwanda,RW,37,2,12626938,Africa,2577,10
2020-08-20,Rwanda,RW,67,0,12626938,Africa,2644,10
2020-08-21,Rwanda,RW,73,1,12626938,Africa,2717,11
2020-08-22,Rwanda,RW,63,0,12626938,Africa,2780,11
2020-08-23,Rwanda,RW,109,0,12626938,Africa,2889,11
2020-08-24,Rwanda,RW,200,1,12626938,Africa,3089,12
2020-08-25,Rwanda,RW,217,2,12626938,Africa,3306,14
2020-08-26,Rwanda,RW,231,1,12626938,Africa,3537,15
2020-08-27,Rwanda,RW,88,0,12626938,Africa,3625,15
2020-08-28,Rwanda,RW,47,0,12626938,Africa,3672,15
2020-08-29,Rwanda,RW,70,1,12626938,Africa,3742,16
2020-08-30,Rwanda,RW,101,0,12626938,Africa,3843,16
2020-08-31,Rwanda,RW,177,0,12626938,Africa,4020,16
2020-09-01,Rwanda,RW,43,0,12626938,Africa,4063,16
2020-09-02,Rwanda,RW,79,0,12626938,Africa,4142,16
2020-09-03,Rwanda,RW,76,1,12626938,Africa,4218,17
2020-09-04,Rwanda,RW,37,1,12626938,Africa,4255,18
2020-09-05,Rwanda,RW,49,0,12626938,Africa,4304,18
2020-09-06,Rwanda,RW,45,0,12626938,Africa,4349,18
2020-09-07,Rwanda,RW,25,1,12626938,Africa,4374,19
2020-09-08,Rwanda,RW,35,0,12626938,Africa,4409,19
2020-09-09,Rwanda,RW,30,1,12626938,Africa,4439,20
2020-09-10,Rwanda,RW,21,1,12626938,Africa,4460,21
2020-09-11,Rwanda,RW,19,1,12626938,Africa,4479,22
2020-09-12,Rwanda,RW,55,0,12626938,Africa,4534,22
2020-09-13,Rwanda,RW,31,0,12626938,Africa,4565,22
2020-09-14,Rwanda,RW,26,0,12626938,Africa,4591,22
2020-09-15,Rwanda,RW,11,0,12626938,Africa,4602,22
2020-09-16,Rwanda,RW,22,0,12626938,Africa,4624,22
2020-09-17,Rwanda,RW,10,0,12626938,Africa,4634,22
2020-09-18,Rwanda,RW,19,1,12626938,Africa,4653,23
2020-09-19,Rwanda,RW,18,2,12626938,Africa,4671,25
2020-09-20,Rwanda,RW,18,1,12626938,Africa,4689,26
2020-09-21,Rwanda,RW,22,0,12626938,Africa,4711,26
2020-09-22,Rwanda,RW,11,1,12626938,Africa,4722,27
2020-09-23,Rwanda,RW,16,0,12626938,Africa,4738,27
2020-09-24,Rwanda,RW,41,0,12626938,Africa,4779,27
2020-09-25,Rwanda,RW,10,0,12626938,Africa,4789,27
2020-09-26,Rwanda,RW,9,2,12626938,Africa,4798,29
2020-09-27,Rwanda,RW,13,0,12626938,Africa,4811,29
2020-09-28,Rwanda,RW,9,0,12626938,Africa,4820,29
2020-09-29,Rwanda,RW,12,0,12626938,Africa,4832,29
2020-09-30,Rwanda,RW,4,0,12626938,Africa,4836,29
2020-10-01,Rwanda,RW,4,0,12626938,Africa,4840,29
2020-10-02,Rwanda,RW,3,0,12626938,Africa,4843,29
2020-10-03,Rwanda,RW,4,0,12626938,Africa,4847,29
2020-10-04,Rwanda,RW,5,0,12626938,Africa,4852,29
2020-10-05,Rwanda,RW,14,0,12626938,Africa,4866,29
2020-10-06,Rwanda,RW,1,0,12626938,Africa,4867,29
2020-10-07,Rwanda,RW,6,0,12626938,Africa,4873,29
2020-10-08,Rwanda,RW,10,0,12626938,Africa,4883,29
2020-10-09,Rwanda,RW,2,0,12626938,Africa,4885,29
2020-10-10,Rwanda,RW,5,1,12626938,Africa,4890,30
2020-10-11,Rwanda,RW,2,0,12626938,Africa,4892,30
2020-10-12,Rwanda,RW,4,1,12626938,Africa,4896,31
2020-10-13,Rwanda,RW,9,1,12626938,Africa,4905,32
2020-10-14,Rwanda,RW,3,0,12626938,Africa,4908,32
2020-10-15,Rwanda,RW,32,1,12626938,Africa,4940,33
2020-10-16,Rwanda,RW,13,0,12626938,Africa,4953,33
2020-10-17,Rwanda,RW,12,1,12626938,Africa,4965,34
2020-10-18,Rwanda,RW,6,0,12626938,Africa,4971,34
2020-10-19,Rwanda,RW,3,0,12626938,Africa,4974,34
2020-10-20,Rwanda,RW,18,0,12626938,Africa,4992,34
2020-10-21,Rwanda,RW,5,0,12626938,Africa,4997,34
2020-10-22,Rwanda,RW,15,0,12626938,Africa,5012,34
2020-10-23,Rwanda,RW,5,0,12626938,Africa,5017,34
2020-10-24,Rwanda,RW,35,0,12626938,Africa,5052,34
2020-10-25,Rwanda,RW,8,0,12626938,Africa,5060,34
2020-10-26,Rwanda,RW,6,0,12626938,Africa,5066,34
2020-10-27,Rwanda,RW,7,0,12626938,Africa,5073,34
2020-10-28,Rwanda,RW,11,1,12626938,Africa,5084,35
2020-10-29,Rwanda,RW,45,0,12626938,Africa,5129,35
2020-10-30,Rwanda,RW,2,0,12626938,Africa,5131,35
2020-10-31,Rwanda,RW,3,0,12626938,Africa,5134,35
2020-11-01,Rwanda,RW,3,0,12626938,Africa,5137,35
2020-11-02,Rwanda,RW,9,0,12626938,Africa,5146,35
2020-11-03,Rwanda,RW,9,0,12626938,Africa,5155,35
2020-11-04,Rwanda,RW,7,0,12626938,Africa,5162,35
2020-11-05,Rwanda,RW,12,0,12626938,Africa,5174,35
2020-11-06,Rwanda,RW,18,1,12626938,Africa,5192,36
2020-11-07,Rwanda,RW,16,0,12626938,Africa,5208,36
2020-11-08,Rwanda,RW,5,0,12626938,Africa,5213,36
2020-11-09,Rwanda,RW,9,0,12626938,Africa,5222,36
2020-11-10,Rwanda,RW,20,2,12626938,Africa,5242,38
2020-11-11,Rwanda,RW,20,2,12626938,Africa,5262,40
2020-11-12,Rwanda,RW,50,1,12626938,Africa,5312,41
2020-11-13,Rwanda,RW,7,0,12626938,Africa,5319,41
2020-11-14,Rwanda,RW,43,1,12626938,Africa,5362,42
2020-11-15,Rwanda,RW,32,0,12626938,Africa,5394,42
2020-11-16,Rwanda,RW,61,3,12626938,Africa,5455,45
2020-11-17,Rwanda,RW,36,0,12626938,Africa,5491,45
2020-11-18,Rwanda,RW,16,1,12626938,Africa,5507,46
2020-11-19,Rwanda,RW,36,0,12626938,Africa,5543,46
2020-11-20,Rwanda,RW,0,0,12626938,Africa,5543,46
2020-11-21,Rwanda,RW,43,0,12626938,Africa,5586,46
2020-11-22,Rwanda,RW,34,0,12626938,Africa,5620,46
2020-11-23,Rwanda,RW,45,1,12626938,Africa,5665,47
2020-11-24,Rwanda,RW,61,0,12626938,Africa,5726,47
2020-11-25,Rwanda,RW,24,0,12626938,Africa,5750,47
2020-11-26,Rwanda,RW,29,0,12626938,Africa,5779,47
2020-11-27,Rwanda,RW,72,0,12626938,Africa,5851,47
2020-11-28,Rwanda,RW,21,0,12626938,Africa,5872,47
2020-11-29,Rwanda,RW,19,0,12626938,Africa,5891,47
2020-11-30,Rwanda,RW,28,1,12626938,Africa,5919,48
2020-12-01,Rwanda,RW,15,1,12626938,Africa,5934,49
2020-12-02,Rwanda,RW,14,0,12626938,Africa,5948,49
2020-12-03,Rwanda,RW,46,1,12626938,Africa,5994,50
2020-12-04,Rwanda,RW,17,0,12626938,Africa,6011,50
2020-12-05,Rwanda,RW,32,1,12626938,Africa,6043,51
2020-12-06,Rwanda,RW,41,0,12626938,Africa,6084,51
2020-12-07,Rwanda,RW,45,0,12626938,Africa,6129,51
2020-12-08,Rwanda,RW,62,0,12626938,Africa,6191,51
2020-12-09,Rwanda,RW,46,0,12626938,Africa,6237,51
2020-12-10,Rwanda,RW,41,2,12626938,Africa,6278,53
2020-12-11,Rwanda,RW,71,0,12626938,Africa,6349,53
2020-12-12,Rwanda,RW,79,1,12626938,Africa,6428,54
2020-12-13,Rwanda,RW,100,2,12626938,Africa,6528,56
2020-12-14,Rwanda,RW,131,0,12626938,Africa,6659,56
2020-03-03,Saudi_Arabia,SA,1,0,34268529,Asia,1,0
2020-03-06,Saudi_Arabia,SA,4,0,34268529,Asia,5,0
2020-03-08,Saudi_Arabia,SA,2,0,34268529,Asia,7,0
2020-03-09,Saudi_Arabia,SA,4,0,34268529,Asia,11,0
2020-03-10,Saudi_Arabia,SA,4,0,34268529,Asia,15,0
2020-03-11,Saudi_Arabia,SA,5,0,34268529,Asia,20,0
2020-03-12,Saudi_Arabia,SA,25,0,34268529,Asia,45,0
2020-03-13,Saudi_Arabia,SA,17,0,34268529,Asia,62,0
2020-03-14,Saudi_Arabia,SA,24,0,34268529,Asia,86,0
2020-03-15,Saudi_Arabia,SA,0,0,34268529,Asia,86,0
2020-03-16,Saudi_Arabia,SA,32,0,34268529,Asia,118,0
2020-03-17,Saudi_Arabia,SA,15,0,34268529,Asia,133,0
2020-03-18,Saudi_Arabia,SA,0,0,34268529,Asia,133,0
2020-03-19,Saudi_Arabia,SA,38,0,34268529,Asia,171,0
2020-03-20,Saudi_Arabia,SA,67,0,34268529,Asia,238,0
2020-03-21,Saudi_Arabia,SA,36,0,34268529,Asia,274,0
2020-03-22,Saudi_Arabia,SA,118,0,34268529,Asia,392,0
2020-03-23,Saudi_Arabia,SA,119,0,34268529,Asia,511,0
2020-03-24,Saudi_Arabia,SA,51,0,34268529,Asia,562,0
2020-03-25,Saudi_Arabia,SA,205,1,34268529,Asia,767,1
2020-03-26,Saudi_Arabia,SA,133,1,34268529,Asia,900,2
2020-03-27,Saudi_Arabia,SA,112,1,34268529,Asia,1012,3
2020-03-28,Saudi_Arabia,SA,92,0,34268529,Asia,1104,3
2020-03-29,Saudi_Arabia,SA,99,1,34268529,Asia,1203,4
2020-03-30,Saudi_Arabia,SA,26,4,34268529,Asia,1229,8
2020-03-31,Saudi_Arabia,SA,224,0,34268529,Asia,1453,8
2020-04-01,Saudi_Arabia,SA,110,2,34268529,Asia,1563,10
2020-04-02,Saudi_Arabia,SA,157,6,34268529,Asia,1720,16
2020-04-03,Saudi_Arabia,SA,165,5,34268529,Asia,1885,21
2020-04-04,Saudi_Arabia,SA,0,0,34268529,Asia,1885,21
2020-04-05,Saudi_Arabia,SA,294,8,34268529,Asia,2179,29
2020-04-06,Saudi_Arabia,SA,206,5,34268529,Asia,2385,34
2020-04-07,Saudi_Arabia,SA,138,4,34268529,Asia,2523,38
2020-04-08,Saudi_Arabia,SA,272,3,34268529,Asia,2795,41
2020-04-09,Saudi_Arabia,SA,137,0,34268529,Asia,2932,41
2020-04-10,Saudi_Arabia,SA,355,3,34268529,Asia,3287,44
2020-04-11,Saudi_Arabia,SA,364,3,34268529,Asia,3651,47
2020-04-12,Saudi_Arabia,SA,382,5,34268529,Asia,4033,52
2020-04-13,Saudi_Arabia,SA,429,7,34268529,Asia,4462,59
2020-04-14,Saudi_Arabia,SA,472,6,34268529,Asia,4934,65
2020-04-15,Saudi_Arabia,SA,435,8,34268529,Asia,5369,73
2020-04-16,Saudi_Arabia,SA,493,6,34268529,Asia,5862,79
2020-04-17,Saudi_Arabia,SA,518,4,34268529,Asia,6380,83
2020-04-18,Saudi_Arabia,SA,762,4,34268529,Asia,7142,87
2020-04-19,Saudi_Arabia,SA,1132,5,34268529,Asia,8274,92
2020-04-20,Saudi_Arabia,SA,1088,5,34268529,Asia,9362,97
2020-04-21,Saudi_Arabia,SA,1122,6,34268529,Asia,10484,103
2020-04-22,Saudi_Arabia,SA,1147,6,34268529,Asia,11631,109
2020-04-23,Saudi_Arabia,SA,1141,5,34268529,Asia,12772,114
2020-04-24,Saudi_Arabia,SA,1158,7,34268529,Asia,13930,121
2020-04-25,Saudi_Arabia,SA,1172,6,34268529,Asia,15102,127
2020-04-26,Saudi_Arabia,SA,1197,9,34268529,Asia,16299,136
2020-04-27,Saudi_Arabia,SA,1223,3,34268529,Asia,17522,139
2020-04-28,Saudi_Arabia,SA,1289,5,34268529,Asia,18811,144
2020-04-29,Saudi_Arabia,SA,1266,8,34268529,Asia,20077,152
2020-04-30,Saudi_Arabia,SA,1325,5,34268529,Asia,21402,157
2020-05-01,Saudi_Arabia,SA,1351,5,34268529,Asia,22753,162
2020-05-02,Saudi_Arabia,SA,1344,7,34268529,Asia,24097,169
2020-05-03,Saudi_Arabia,SA,1362,7,34268529,Asia,25459,176
2020-05-04,Saudi_Arabia,SA,1552,8,34268529,Asia,27011,184
2020-05-05,Saudi_Arabia,SA,1645,7,34268529,Asia,28656,191
2020-05-06,Saudi_Arabia,SA,1595,9,34268529,Asia,30251,200
2020-05-07,Saudi_Arabia,SA,1687,9,34268529,Asia,31938,209
2020-05-08,Saudi_Arabia,SA,1793,10,34268529,Asia,33731,219
2020-05-09,Saudi_Arabia,SA,1701,10,34268529,Asia,35432,229
2020-05-10,Saudi_Arabia,SA,1704,10,34268529,Asia,37136,239
2020-05-11,Saudi_Arabia,SA,1912,7,34268529,Asia,39048,246
2020-05-12,Saudi_Arabia,SA,1966,9,34268529,Asia,41014,255
2020-05-13,Saudi_Arabia,SA,1911,9,34268529,Asia,42925,264
2020-05-14,Saudi_Arabia,SA,1905,9,34268529,Asia,44830,273
2020-05-15,Saudi_Arabia,SA,2039,10,34268529,Asia,46869,283
2020-05-16,Saudi_Arabia,SA,2307,9,34268529,Asia,49176,292
2020-05-17,Saudi_Arabia,SA,2840,10,34268529,Asia,52016,302
2020-05-18,Saudi_Arabia,SA,2736,10,34268529,Asia,54752,312
2020-05-19,Saudi_Arabia,SA,2593,8,34268529,Asia,57345,320
2020-05-20,Saudi_Arabia,SA,2509,9,34268529,Asia,59854,329
2020-05-21,Saudi_Arabia,SA,2691,10,34268529,Asia,62545,339
2020-05-22,Saudi_Arabia,SA,2532,12,34268529,Asia,65077,351
2020-05-23,Saudi_Arabia,SA,2642,13,34268529,Asia,67719,364
2020-05-24,Saudi_Arabia,SA,2442,15,34268529,Asia,70161,379
2020-05-25,Saudi_Arabia,SA,2399,11,34268529,Asia,72560,390
2020-05-26,Saudi_Arabia,SA,2235,9,34268529,Asia,74795,399
2020-05-27,Saudi_Arabia,SA,1931,12,34268529,Asia,76726,411
2020-05-28,Saudi_Arabia,SA,1815,14,34268529,Asia,78541,425
2020-05-29,Saudi_Arabia,SA,1644,16,34268529,Asia,80185,441
2020-05-30,Saudi_Arabia,SA,1581,17,34268529,Asia,81766,458
2020-05-31,Saudi_Arabia,SA,1618,22,34268529,Asia,83384,480
2020-06-01,Saudi_Arabia,SA,1877,23,34268529,Asia,85261,503
2020-06-02,Saudi_Arabia,SA,1881,22,34268529,Asia,87142,525
2020-06-03,Saudi_Arabia,SA,1869,24,34268529,Asia,89011,549
2020-06-04,Saudi_Arabia,SA,2171,30,34268529,Asia,91182,579
2020-06-05,Saudi_Arabia,SA,1975,32,34268529,Asia,93157,611
2020-06-06,Saudi_Arabia,SA,2591,31,34268529,Asia,95748,642
2020-06-07,Saudi_Arabia,SA,3121,34,34268529,Asia,98869,676
2020-06-08,Saudi_Arabia,SA,3045,36,34268529,Asia,101914,712
2020-06-09,Saudi_Arabia,SA,3369,34,34268529,Asia,105283,746
2020-06-10,Saudi_Arabia,SA,3288,37,34268529,Asia,108571,783
2020-06-11,Saudi_Arabia,SA,3717,36,34268529,Asia,112288,819
2020-06-12,Saudi_Arabia,SA,3733,38,34268529,Asia,116021,857
2020-06-13,Saudi_Arabia,SA,3921,36,34268529,Asia,119942,893
2020-06-14,Saudi_Arabia,SA,3366,39,34268529,Asia,123308,932
2020-06-15,Saudi_Arabia,SA,4233,40,34268529,Asia,127541,972
2020-06-16,Saudi_Arabia,SA,4507,39,34268529,Asia,132048,1011
2020-06-17,Saudi_Arabia,SA,4267,41,34268529,Asia,136315,1052
2020-06-18,Saudi_Arabia,SA,4919,39,34268529,Asia,141234,1091
2020-06-19,Saudi_Arabia,SA,4757,48,34268529,Asia,145991,1139
2020-06-20,Saudi_Arabia,SA,4301,45,34268529,Asia,150292,1184
2020-06-21,Saudi_Arabia,SA,3941,46,34268529,Asia,154233,1230
2020-06-22,Saudi_Arabia,SA,3379,37,34268529,Asia,157612,1267
2020-06-23,Saudi_Arabia,SA,3393,40,34268529,Asia,161005,1307
2020-06-24,Saudi_Arabia,SA,3139,39,34268529,Asia,164144,1346
2020-06-25,Saudi_Arabia,SA,3123,41,34268529,Asia,167267,1387
2020-06-26,Saudi_Arabia,SA,3372,41,34268529,Asia,170639,1428
2020-06-27,Saudi_Arabia,SA,3938,46,34268529,Asia,174577,1474
2020-06-28,Saudi_Arabia,SA,3927,37,34268529,Asia,178504,1511
2020-06-29,Saudi_Arabia,SA,3989,40,34268529,Asia,182493,1551
2020-06-30,Saudi_Arabia,SA,3943,48,34268529,Asia,186436,1599
2020-07-01,Saudi_Arabia,SA,4387,50,34268529,Asia,190823,1649
2020-07-02,Saudi_Arabia,SA,3402,49,34268529,Asia,194225,1698
2020-07-03,Saudi_Arabia,SA,3383,54,34268529,Asia,197608,1752
2020-07-04,Saudi_Arabia,SA,4193,50,34268529,Asia,201801,1802
2020-07-05,Saudi_Arabia,SA,4128,56,34268529,Asia,205929,1858
2020-07-06,Saudi_Arabia,SA,3580,58,34268529,Asia,209509,1916
2020-07-07,Saudi_Arabia,SA,4207,52,34268529,Asia,213716,1968
2020-07-08,Saudi_Arabia,SA,3392,49,34268529,Asia,217108,2017
2020-07-09,Saudi_Arabia,SA,3036,42,34268529,Asia,220144,2059
2020-07-10,Saudi_Arabia,SA,3183,41,34268529,Asia,223327,2100
2020-07-11,Saudi_Arabia,SA,3159,51,34268529,Asia,226486,2151
2020-07-12,Saudi_Arabia,SA,2994,30,34268529,Asia,229480,2181
2020-07-13,Saudi_Arabia,SA,2779,42,34268529,Asia,232259,2223
2020-07-14,Saudi_Arabia,SA,2852,20,34268529,Asia,235111,2243
2020-07-15,Saudi_Arabia,SA,2692,40,34268529,Asia,237803,2283
2020-07-16,Saudi_Arabia,SA,2671,42,34268529,Asia,240474,2325
2020-07-17,Saudi_Arabia,SA,2764,45,34268529,Asia,243238,2370
2020-07-18,Saudi_Arabia,SA,2613,37,34268529,Asia,245851,2407
2020-07-19,Saudi_Arabia,SA,2565,40,34268529,Asia,248416,2447
2020-07-20,Saudi_Arabia,SA,2504,39,34268529,Asia,250920,2486
2020-07-21,Saudi_Arabia,SA,2429,37,34268529,Asia,253349,2523
2020-07-22,Saudi_Arabia,SA,2476,34,34268529,Asia,255825,2557
2020-07-23,Saudi_Arabia,SA,2331,44,34268529,Asia,258156,2601
2020-07-24,Saudi_Arabia,SA,2238,34,34268529,Asia,260394,2635
2020-07-25,Saudi_Arabia,SA,2378,37,34268529,Asia,262772,2672
2020-07-26,Saudi_Arabia,SA,2201,31,34268529,Asia,264973,2703
2020-07-27,Saudi_Arabia,SA,1968,30,34268529,Asia,266941,2733
2020-07-28,Saudi_Arabia,SA,1993,27,34268529,Asia,268934,2760
2020-07-29,Saudi_Arabia,SA,1897,29,34268529,Asia,270831,2789
2020-07-30,Saudi_Arabia,SA,1759,27,34268529,Asia,272590,2816
2020-07-31,Saudi_Arabia,SA,1629,50,34268529,Asia,274219,2866
2020-08-01,Saudi_Arabia,SA,1686,0,34268529,Asia,275905,2866
2020-08-02,Saudi_Arabia,SA,1573,1,34268529,Asia,277478,2867
2020-08-03,Saudi_Arabia,SA,1357,50,34268529,Asia,278835,2917
2020-08-04,Saudi_Arabia,SA,1258,32,34268529,Asia,280093,2949
2020-08-05,Saudi_Arabia,SA,1342,35,34268529,Asia,281435,2984
2020-08-06,Saudi_Arabia,SA,1389,36,34268529,Asia,282824,3020
2020-08-07,Saudi_Arabia,SA,1402,35,34268529,Asia,284226,3055
2020-08-08,Saudi_Arabia,SA,1567,38,34268529,Asia,285793,3093
2020-08-09,Saudi_Arabia,SA,1469,37,34268529,Asia,287262,3130
2020-08-10,Saudi_Arabia,SA,1428,37,34268529,Asia,288690,3167
2020-08-11,Saudi_Arabia,SA,1257,32,34268529,Asia,289947,3199
2020-08-12,Saudi_Arabia,SA,1521,34,34268529,Asia,291468,3233
2020-08-13,Saudi_Arabia,SA,1569,36,34268529,Asia,293037,3269
2020-08-14,Saudi_Arabia,SA,1482,34,34268529,Asia,294519,3303
2020-08-15,Saudi_Arabia,SA,1383,35,34268529,Asia,295902,3338
2020-08-16,Saudi_Arabia,SA,1413,31,34268529,Asia,297315,3369
2020-08-17,Saudi_Arabia,SA,1227,39,34268529,Asia,298542,3408
2020-08-18,Saudi_Arabia,SA,1372,28,34268529,Asia,299914,3436
2020-08-19,Saudi_Arabia,SA,1419,34,34268529,Asia,301333,3470
2020-08-20,Saudi_Arabia,SA,1353,36,34268529,Asia,302686,3506
2020-08-21,Saudi_Arabia,SA,1287,42,34268529,Asia,303973,3548
2020-08-22,Saudi_Arabia,SA,1213,32,34268529,Asia,305186,3580
2020-08-23,Saudi_Arabia,SA,1184,39,34268529,Asia,306370,3619
2020-08-24,Saudi_Arabia,SA,1109,30,34268529,Asia,307479,3649
2020-08-25,Saudi_Arabia,SA,1175,42,34268529,Asia,308654,3691
2020-08-26,Saudi_Arabia,SA,1114,31,34268529,Asia,309768,3722
2020-08-27,Saudi_Arabia,SA,1068,33,34268529,Asia,310836,3755
2020-08-28,Saudi_Arabia,SA,1019,30,34268529,Asia,311855,3785
2020-08-29,Saudi_Arabia,SA,1069,28,34268529,Asia,312924,3813
2020-08-30,Saudi_Arabia,SA,987,27,34268529,Asia,313911,3840
2020-08-31,Saudi_Arabia,SA,910,30,34268529,Asia,314821,3870
2020-09-01,Saudi_Arabia,SA,951,27,34268529,Asia,315772,3897
2020-09-02,Saudi_Arabia,SA,898,32,34268529,Asia,316670,3929
2020-09-03,Saudi_Arabia,SA,816,27,34268529,Asia,317486,3956
2020-09-04,Saudi_Arabia,SA,833,26,34268529,Asia,318319,3982
2020-09-05,Saudi_Arabia,SA,822,33,34268529,Asia,319141,4015
2020-09-06,Saudi_Arabia,SA,791,34,34268529,Asia,319932,4049
2020-09-07,Saudi_Arabia,SA,895,32,34268529,Asia,320827,4081
2020-09-08,Saudi_Arabia,SA,768,26,34268529,Asia,321595,4107
2020-09-09,Saudi_Arabia,SA,642,30,34268529,Asia,322237,4137
2020-09-10,Saudi_Arabia,SA,775,28,34268529,Asia,323012,4165
2020-09-11,Saudi_Arabia,SA,708,24,34268529,Asia,323720,4189
2020-09-12,Saudi_Arabia,SA,687,24,34268529,Asia,324407,4213
2020-09-13,Saudi_Arabia,SA,643,27,34268529,Asia,325050,4240
2020-09-14,Saudi_Arabia,SA,601,28,34268529,Asia,325651,4268
2020-09-15,Saudi_Arabia,SA,607,37,34268529,Asia,326258,4305
2020-09-16,Saudi_Arabia,SA,672,33,34268529,Asia,326930,4338
2020-09-17,Saudi_Arabia,SA,621,31,34268529,Asia,327551,4369
2020-09-18,Saudi_Arabia,SA,593,30,34268529,Asia,328144,4399
2020-09-19,Saudi_Arabia,SA,576,31,34268529,Asia,328720,4430
2020-09-20,Saudi_Arabia,SA,551,28,34268529,Asia,329271,4458
2020-09-21,Saudi_Arabia,SA,483,27,34268529,Asia,329754,4485
2020-09-22,Saudi_Arabia,SA,492,27,34268529,Asia,330246,4512
2020-09-23,Saudi_Arabia,SA,552,30,34268529,Asia,330798,4542
2020-09-24,Saudi_Arabia,SA,561,27,34268529,Asia,331359,4569
2020-09-25,Saudi_Arabia,SA,498,30,34268529,Asia,331857,4599
2020-09-26,Saudi_Arabia,SA,472,26,34268529,Asia,332329,4625
2020-09-27,Saudi_Arabia,SA,461,30,34268529,Asia,332790,4655
2020-09-28,Saudi_Arabia,SA,403,28,34268529,Asia,333193,4683
2020-09-29,Saudi_Arabia,SA,455,29,34268529,Asia,333648,4712
2020-09-30,Saudi_Arabia,SA,539,27,34268529,Asia,334187,4739
2020-10-01,Saudi_Arabia,SA,418,29,34268529,Asia,334605,4768
2020-10-02,Saudi_Arabia,SA,492,26,34268529,Asia,335097,4794
2020-10-03,Saudi_Arabia,SA,481,29,34268529,Asia,335578,4823
2020-10-04,Saudi_Arabia,SA,419,27,34268529,Asia,335997,4850
2020-10-05,Saudi_Arabia,SA,390,25,34268529,Asia,336387,4875
2020-10-06,Saudi_Arabia,SA,379,23,34268529,Asia,336766,4898
2020-10-07,Saudi_Arabia,SA,477,25,34268529,Asia,337243,4923
2020-10-08,Saudi_Arabia,SA,468,24,34268529,Asia,337711,4947
2020-10-09,Saudi_Arabia,SA,421,25,34268529,Asia,338132,4972
2020-10-10,Saudi_Arabia,SA,407,24,34268529,Asia,338539,4996
2020-10-11,Saudi_Arabia,SA,405,22,34268529,Asia,338944,5018
2020-10-12,Saudi_Arabia,SA,323,25,34268529,Asia,339267,5043
2020-10-13,Saudi_Arabia,SA,348,25,34268529,Asia,339615,5068
2020-10-14,Saudi_Arabia,SA,474,19,34268529,Asia,340089,5087
2020-10-15,Saudi_Arabia,SA,501,21,34268529,Asia,340590,5108
2020-10-16,Saudi_Arabia,SA,472,19,34268529,Asia,341062,5127
2020-10-17,Saudi_Arabia,SA,433,17,34268529,Asia,341495,5144
2020-10-18,Saudi_Arabia,SA,359,21,34268529,Asia,341854,5165
2020-10-19,Saudi_Arabia,SA,348,20,34268529,Asia,342202,5185
2020-10-20,Saudi_Arabia,SA,381,16,34268529,Asia,342583,5201
2020-10-21,Saudi_Arabia,SA,385,16,34268529,Asia,342968,5217
2020-10-22,Saudi_Arabia,SA,405,18,34268529,Asia,343373,5235
2020-10-23,Saudi_Arabia,SA,401,15,34268529,Asia,343774,5250
2020-10-24,Saudi_Arabia,SA,383,14,34268529,Asia,344157,5264
2020-10-25,Saudi_Arabia,SA,395,17,34268529,Asia,344552,5281
2020-10-26,Saudi_Arabia,SA,323,15,34268529,Asia,344875,5296
2020-10-27,Saudi_Arabia,SA,357,17,34268529,Asia,345232,5313
2020-10-28,Saudi_Arabia,SA,399,16,34268529,Asia,345631,5329
2020-10-29,Saudi_Arabia,SA,416,19,34268529,Asia,346047,5348
2020-10-30,Saudi_Arabia,SA,435,15,34268529,Asia,346482,5363
2020-10-31,Saudi_Arabia,SA,398,20,34268529,Asia,346880,5383
2020-11-01,Saudi_Arabia,SA,402,19,34268529,Asia,347282,5402
2020-11-02,Saudi_Arabia,SA,374,0,34268529,Asia,347656,5402
2020-11-03,Saudi_Arabia,SA,381,35,34268529,Asia,348037,5437
2020-11-04,Saudi_Arabia,SA,473,19,34268529,Asia,348510,5456
2020-11-05,Saudi_Arabia,SA,426,15,34268529,Asia,348936,5471
2020-11-06,Saudi_Arabia,SA,450,18,34268529,Asia,349386,5489
2020-11-07,Saudi_Arabia,SA,436,17,34268529,Asia,349822,5506
2020-11-08,Saudi_Arabia,SA,407,19,34268529,Asia,350229,5525
2020-11-09,Saudi_Arabia,SA,363,15,34268529,Asia,350592,5540
2020-11-10,Saudi_Arabia,SA,392,19,34268529,Asia,350984,5559
2020-11-11,Saudi_Arabia,SA,471,17,34268529,Asia,351455,5576
2020-11-12,Saudi_Arabia,SA,394,14,34268529,Asia,351849,5590
2020-11-13,Saudi_Arabia,SA,311,15,34268529,Asia,352160,5605
2020-11-14,Saudi_Arabia,SA,441,20,34268529,Asia,352601,5625
2020-11-15,Saudi_Arabia,SA,349,16,34268529,Asia,352950,5641
2020-11-16,Saudi_Arabia,SA,305,16,34268529,Asia,353255,5657
2020-11-17,Saudi_Arabia,SA,301,19,34268529,Asia,353556,5676
2020-11-18,Saudi_Arabia,SA,362,16,34268529,Asia,353918,5692
2020-11-19,Saudi_Arabia,SA,290,18,34268529,Asia,354208,5710
2020-11-20,Saudi_Arabia,SA,319,19,34268529,Asia,354527,5729
2020-11-21,Saudi_Arabia,SA,286,16,34268529,Asia,354813,5745
2020-11-22,Saudi_Arabia,SA,221,16,34268529,Asia,355034,5761
2020-11-23,Saudi_Arabia,SA,224,19,34268529,Asia,355258,5780
2020-11-24,Saudi_Arabia,SA,231,16,34268529,Asia,355489,5796
2020-11-25,Saudi_Arabia,SA,252,15,34268529,Asia,355741,5811
2020-11-26,Saudi_Arabia,SA,326,14,34268529,Asia,356067,5825
2020-11-27,Saudi_Arabia,SA,322,15,34268529,Asia,356389,5840
2020-11-28,Saudi_Arabia,SA,302,17,34268529,Asia,356691,5857
2020-11-29,Saudi_Arabia,SA,220,13,34268529,Asia,356911,5870
2020-11-30,Saudi_Arabia,SA,217,14,34268529,Asia,357128,5884
2020-12-01,Saudi_Arabia,SA,232,12,34268529,Asia,357360,5896
2020-12-02,Saudi_Arabia,SA,263,11,34268529,Asia,357623,5907
2020-12-03,Saudi_Arabia,SA,249,12,34268529,Asia,357872,5919
2020-12-04,Saudi_Arabia,SA,230,11,34268529,Asia,358102,5930
2020-12-05,Saudi_Arabia,SA,234,10,34268529,Asia,358336,5940
2020-12-06,Saudi_Arabia,SA,190,14,34268529,Asia,358526,5954
2020-12-07,Saudi_Arabia,SA,187,11,34268529,Asia,358713,5965
2020-12-08,Saudi_Arabia,SA,209,12,34268529,Asia,358922,5977
2020-12-09,Saudi_Arabia,SA,193,12,34268529,Asia,359115,5989
2020-12-10,Saudi_Arabia,SA,159,13,34268529,Asia,359274,6002
2020-12-11,Saudi_Arabia,SA,141,10,34268529,Asia,359415,6012
2020-12-12,Saudi_Arabia,SA,168,11,34268529,Asia,359583,6023
2020-12-13,Saudi_Arabia,SA,166,13,34268529,Asia,359749,6036
2020-12-14,Saudi_Arabia,SA,139,12,34268529,Asia,359888,6048
2020-10-16,Solomon_Islands,SB,2,0,669821,Oceania,2,0
2020-10-17,Solomon_Islands,SB,1,0,669821,Oceania,3,0
2020-10-18,Solomon_Islands,SB,0,0,669821,Oceania,3,0
2020-10-19,Solomon_Islands,SB,0,0,669821,Oceania,3,0
2020-10-20,Solomon_Islands,SB,0,0,669821,Oceania,3,0
2020-10-21,Solomon_Islands,SB,0,0,669821,Oceania,3,0
2020-10-22,Solomon_Islands,SB,0,0,669821,Oceania,3,0
2020-10-23,Solomon_Islands,SB,0,0,669821,Oceania,3,0
2020-10-24,Solomon_Islands,SB,0,0,669821,Oceania,3,0
2020-10-25,Solomon_Islands,SB,1,0,669821,Oceania,4,0
2020-10-26,Solomon_Islands,SB,0,0,669821,Oceania,4,0
2020-10-27,Solomon_Islands,SB,0,0,669821,Oceania,4,0
2020-10-28,Solomon_Islands,SB,4,0,669821,Oceania,8,0
2020-10-29,Solomon_Islands,SB,0,0,669821,Oceania,8,0
2020-10-30,Solomon_Islands,SB,0,0,669821,Oceania,8,0
2020-10-31,Solomon_Islands,SB,0,0,669821,Oceania,8,0
2020-11-01,Solomon_Islands,SB,0,0,669821,Oceania,8,0
2020-11-02,Solomon_Islands,SB,0,0,669821,Oceania,8,0
2020-11-03,Solomon_Islands,SB,0,0,669821,Oceania,8,0
2020-11-04,Solomon_Islands,SB,5,0,669821,Oceania,13,0
2020-11-05,Solomon_Islands,SB,0,0,669821,Oceania,13,0
2020-11-06,Solomon_Islands,SB,0,0,669821,Oceania,13,0
2020-11-07,Solomon_Islands,SB,0,0,669821,Oceania,13,0
2020-11-08,Solomon_Islands,SB,0,0,669821,Oceania,13,0
2020-11-09,Solomon_Islands,SB,0,0,669821,Oceania,13,0
2020-11-10,Solomon_Islands,SB,0,0,669821,Oceania,13,0
2020-11-11,Solomon_Islands,SB,3,0,669821,Oceania,16,0
2020-11-12,Solomon_Islands,SB,0,0,669821,Oceania,16,0
2020-11-13,Solomon_Islands,SB,0,0,669821,Oceania,16,0
2020-11-14,Solomon_Islands,SB,0,0,669821,Oceania,16,0
2020-11-15,Solomon_Islands,SB,0,0,669821,Oceania,16,0
2020-11-16,Solomon_Islands,SB,0,0,669821,Oceania,16,0
2020-11-17,Solomon_Islands,SB,0,0,669821,Oceania,16,0
2020-11-18,Solomon_Islands,SB,0,0,669821,Oceania,16,0
2020-11-19,Solomon_Islands,SB,0,0,669821,Oceania,16,0
2020-11-20,Solomon_Islands,SB,0,0,669821,Oceania,16,0
2020-11-21,Solomon_Islands,SB,0,0,669821,Oceania,16,0
2020-11-22,Solomon_Islands,SB,0,0,669821,Oceania,16,0
2020-11-23,Solomon_Islands,SB,0,0,669821,Oceania,16,0
2020-11-24,Solomon_Islands,SB,0,0,669821,Oceania,16,0
2020-11-25,Solomon_Islands,SB,1,0,669821,Oceania,17,0
2020-11-26,Solomon_Islands,SB,0,0,669821,Oceania,17,0
2020-11-27,Solomon_Islands,SB,0,0,669821,Oceania,17,0
2020-11-28,Solomon_Islands,SB,0,0,669821,Oceania,17,0
2020-11-29,Solomon_Islands,SB,0,0,669821,Oceania,17,0
2020-11-30,Solomon_Islands,SB,0,0,669821,Oceania,17,0
2020-12-01,Solomon_Islands,SB,0,0,669821,Oceania,17,0
2020-12-02,Solomon_Islands,SB,0,0,669821,Oceania,17,0
2020-12-03,Solomon_Islands,SB,0,0,669821,Oceania,17,0
2020-12-04,Solomon_Islands,SB,0,0,669821,Oceania,17,0
2020-12-05,Solomon_Islands,SB,0,0,669821,Oceania,17,0
2020-12-06,Solomon_Islands,SB,0,0,669821,Oceania,17,0
2020-12-07,Solomon_Islands,SB,0,0,669821,Oceania,17,0
2020-12-08,Solomon_Islands,SB,0,0,669821,Oceania,17,0
2020-12-09,Solomon_Islands,SB,0,0,669821,Oceania,17,0
2020-12-10,Solomon_Islands,SB,0,0,669821,Oceania,17,0
2020-12-11,Solomon_Islands,SB,0,0,669821,Oceania,17,0
2020-12-12,Solomon_Islands,SB,0,0,669821,Oceania,17,0
2020-12-13,Solomon_Islands,SB,0,0,669821,Oceania,17,0
2020-12-14,Solomon_Islands,SB,0,0,669821,Oceania,17,0
2020-03-15,Seychelles,SC,2,0,97741,Africa,2,0
2020-03-16,Seychelles,SC,1,0,97741,Africa,3,0
2020-03-17,Seychelles,SC,1,0,97741,Africa,4,0
2020-03-18,Seychelles,SC,0,0,97741,Africa,4,0
2020-03-19,Seychelles,SC,2,0,97741,Africa,6,0
2020-03-20,Seychelles,SC,0,0,97741,Africa,6,0
2020-03-21,Seychelles,SC,1,0,97741,Africa,7,0
2020-03-22,Seychelles,SC,0,0,97741,Africa,7,0
2020-03-23,Seychelles,SC,0,0,97741,Africa,7,0
2020-03-24,Seychelles,SC,0,0,97741,Africa,7,0
2020-03-25,Seychelles,SC,0,0,97741,Africa,7,0
2020-03-26,Seychelles,SC,0,0,97741,Africa,7,0
2020-03-27,Seychelles,SC,0,0,97741,Africa,7,0
2020-03-28,Seychelles,SC,0,0,97741,Africa,7,0
2020-03-29,Seychelles,SC,0,0,97741,Africa,7,0
2020-03-30,Seychelles,SC,1,0,97741,Africa,8,0
2020-03-31,Seychelles,SC,2,0,97741,Africa,10,0
2020-04-01,Seychelles,SC,0,0,97741,Africa,10,0
2020-04-02,Seychelles,SC,0,0,97741,Africa,10,0
2020-04-03,Seychelles,SC,0,0,97741,Africa,10,0
2020-04-04,Seychelles,SC,0,0,97741,Africa,10,0
2020-04-05,Seychelles,SC,0,0,97741,Africa,10,0
2020-04-06,Seychelles,SC,0,0,97741,Africa,10,0
2020-04-07,Seychelles,SC,0,0,97741,Africa,10,0
2020-04-08,Seychelles,SC,0,0,97741,Africa,10,0
2020-04-09,Seychelles,SC,0,0,97741,Africa,10,0
2020-04-10,Seychelles,SC,0,0,97741,Africa,10,0
2020-04-11,Seychelles,SC,0,0,97741,Africa,10,0
2020-04-12,Seychelles,SC,0,0,97741,Africa,10,0
2020-04-13,Seychelles,SC,0,0,97741,Africa,10,0
2020-04-14,Seychelles,SC,0,0,97741,Africa,10,0
2020-04-15,Seychelles,SC,1,0,97741,Africa,11,0
2020-04-16,Seychelles,SC,0,0,97741,Africa,11,0
2020-04-17,Seychelles,SC,0,0,97741,Africa,11,0
2020-04-18,Seychelles,SC,0,0,97741,Africa,11,0
2020-04-19,Seychelles,SC,0,0,97741,Africa,11,0
2020-04-20,Seychelles,SC,0,0,97741,Africa,11,0
2020-04-21,Seychelles,SC,0,0,97741,Africa,11,0
2020-04-22,Seychelles,SC,0,0,97741,Africa,11,0
2020-04-23,Seychelles,SC,0,0,97741,Africa,11,0
2020-04-24,Seychelles,SC,0,0,97741,Africa,11,0
2020-04-25,Seychelles,SC,0,0,97741,Africa,11,0
2020-04-26,Seychelles,SC,0,0,97741,Africa,11,0
2020-04-27,Seychelles,SC,0,0,97741,Africa,11,0
2020-04-28,Seychelles,SC,0,0,97741,Africa,11,0
2020-04-29,Seychelles,SC,0,0,97741,Africa,11,0
2020-04-30,Seychelles,SC,0,0,97741,Africa,11,0
2020-05-01,Seychelles,SC,0,0,97741,Africa,11,0
2020-05-02,Seychelles,SC,0,0,97741,Africa,11,0
2020-05-03,Seychelles,SC,0,0,97741,Africa,11,0
2020-05-04,Seychelles,SC,0,0,97741,Africa,11,0
2020-05-05,Seychelles,SC,0,0,97741,Africa,11,0
2020-05-06,Seychelles,SC,0,0,97741,Africa,11,0
2020-05-07,Seychelles,SC,0,0,97741,Africa,11,0
2020-05-08,Seychelles,SC,0,0,97741,Africa,11,0
2020-05-09,Seychelles,SC,0,0,97741,Africa,11,0
2020-05-10,Seychelles,SC,0,0,97741,Africa,11,0
2020-05-11,Seychelles,SC,0,0,97741,Africa,11,0
2020-05-12,Seychelles,SC,0,0,97741,Africa,11,0
2020-05-13,Seychelles,SC,0,0,97741,Africa,11,0
2020-05-14,Seychelles,SC,0,0,97741,Africa,11,0
2020-05-15,Seychelles,SC,0,0,97741,Africa,11,0
2020-05-16,Seychelles,SC,0,0,97741,Africa,11,0
2020-05-17,Seychelles,SC,0,0,97741,Africa,11,0
2020-05-18,Seychelles,SC,0,0,97741,Africa,11,0
2020-05-19,Seychelles,SC,0,0,97741,Africa,11,0
2020-05-20,Seychelles,SC,0,0,97741,Africa,11,0
2020-05-21,Seychelles,SC,0,0,97741,Africa,11,0
2020-05-22,Seychelles,SC,0,0,97741,Africa,11,0
2020-05-23,Seychelles,SC,0,0,97741,Africa,11,0
2020-05-24,Seychelles,SC,0,0,97741,Africa,11,0
2020-05-25,Seychelles,SC,0,0,97741,Africa,11,0
2020-05-26,Seychelles,SC,0,0,97741,Africa,11,0
2020-05-27,Seychelles,SC,0,0,97741,Africa,11,0
2020-05-28,Seychelles,SC,0,0,97741,Africa,11,0
2020-05-29,Seychelles,SC,0,0,97741,Africa,11,0
2020-05-30,Seychelles,SC,0,0,97741,Africa,11,0
2020-05-31,Seychelles,SC,0,0,97741,Africa,11,0
2020-06-01,Seychelles,SC,0,0,97741,Africa,11,0
2020-06-02,Seychelles,SC,0,0,97741,Africa,11,0
2020-06-03,Seychelles,SC,0,0,97741,Africa,11,0
2020-06-04,Seychelles,SC,0,0,97741,Africa,11,0
2020-06-05,Seychelles,SC,0,0,97741,Africa,11,0
2020-06-06,Seychelles,SC,0,0,97741,Africa,11,0
2020-06-07,Seychelles,SC,0,0,97741,Africa,11,0
2020-06-08,Seychelles,SC,0,0,97741,Africa,11,0
2020-06-09,Seychelles,SC,0,0,97741,Africa,11,0
2020-06-10,Seychelles,SC,0,0,97741,Africa,11,0
2020-06-11,Seychelles,SC,0,0,97741,Africa,11,0
2020-06-12,Seychelles,SC,0,0,97741,Africa,11,0
2020-06-13,Seychelles,SC,0,0,97741,Africa,11,0
2020-06-14,Seychelles,SC,0,0,97741,Africa,11,0
2020-06-15,Seychelles,SC,0,0,97741,Africa,11,0
2020-06-16,Seychelles,SC,0,0,97741,Africa,11,0
2020-06-17,Seychelles,SC,0,0,97741,Africa,11,0
2020-06-18,Seychelles,SC,0,0,97741,Africa,11,0
2020-06-19,Seychelles,SC,0,0,97741,Africa,11,0
2020-06-20,Seychelles,SC,0,0,97741,Africa,11,0
2020-06-21,Seychelles,SC,0,0,97741,Africa,11,0
2020-06-22,Seychelles,SC,0,0,97741,Africa,11,0
2020-06-23,Seychelles,SC,0,0,97741,Africa,11,0
2020-06-24,Seychelles,SC,0,0,97741,Africa,11,0
2020-06-25,Seychelles,SC,0,0,97741,Africa,11,0
2020-06-26,Seychelles,SC,0,0,97741,Africa,11,0
2020-06-27,Seychelles,SC,0,0,97741,Africa,11,0
2020-06-28,Seychelles,SC,0,0,97741,Africa,11,0
2020-06-29,Seychelles,SC,0,0,97741,Africa,11,0
2020-06-30,Seychelles,SC,0,0,97741,Africa,11,0
2020-07-01,Seychelles,SC,0,0,97741,Africa,11,0
2020-07-02,Seychelles,SC,0,0,97741,Africa,11,0
2020-07-03,Seychelles,SC,0,0,97741,Africa,11,0
2020-07-04,Seychelles,SC,0,0,97741,Africa,11,0
2020-07-05,Seychelles,SC,0,0,97741,Africa,11,0
2020-07-06,Seychelles,SC,0,0,97741,Africa,11,0
2020-07-07,Seychelles,SC,70,0,97741,Africa,81,0
2020-07-08,Seychelles,SC,0,0,97741,Africa,81,0
2020-07-09,Seychelles,SC,10,0,97741,Africa,91,0
2020-07-10,Seychelles,SC,3,0,97741,Africa,94,0
2020-07-11,Seychelles,SC,6,0,97741,Africa,100,0
2020-07-12,Seychelles,SC,0,0,97741,Africa,100,0
2020-07-13,Seychelles,SC,0,0,97741,Africa,100,0
2020-07-14,Seychelles,SC,0,0,97741,Africa,100,0
2020-07-15,Seychelles,SC,0,0,97741,Africa,100,0
2020-07-16,Seychelles,SC,0,0,97741,Africa,100,0
2020-07-17,Seychelles,SC,0,0,97741,Africa,100,0
2020-07-18,Seychelles,SC,0,0,97741,Africa,100,0
2020-07-19,Seychelles,SC,0,0,97741,Africa,100,0
2020-07-20,Seychelles,SC,0,0,97741,Africa,100,0
2020-07-21,Seychelles,SC,8,0,97741,Africa,108,0
2020-07-22,Seychelles,SC,6,0,97741,Africa,114,0
2020-07-23,Seychelles,SC,0,0,97741,Africa,114,0
2020-07-24,Seychelles,SC,0,0,97741,Africa,114,0
2020-07-25,Seychelles,SC,0,0,97741,Africa,114,0
2020-07-26,Seychelles,SC,0,0,97741,Africa,114,0
2020-07-27,Seychelles,SC,0,0,97741,Africa,114,0
2020-07-28,Seychelles,SC,0,0,97741,Africa,114,0
2020-07-29,Seychelles,SC,0,0,97741,Africa,114,0
2020-07-30,Seychelles,SC,0,0,97741,Africa,114,0
2020-07-31,Seychelles,SC,0,0,97741,Africa,114,0
2020-08-01,Seychelles,SC,0,0,97741,Africa,114,0
2020-08-02,Seychelles,SC,0,0,97741,Africa,114,0
2020-08-03,Seychelles,SC,0,0,97741,Africa,114,0
2020-08-04,Seychelles,SC,0,0,97741,Africa,114,0
2020-08-05,Seychelles,SC,12,0,97741,Africa,126,0
2020-08-06,Seychelles,SC,0,0,97741,Africa,126,0
2020-08-07,Seychelles,SC,0,0,97741,Africa,126,0
2020-08-08,Seychelles,SC,0,0,97741,Africa,126,0
2020-08-09,Seychelles,SC,0,0,97741,Africa,126,0
2020-08-10,Seychelles,SC,0,0,97741,Africa,126,0
2020-08-11,Seychelles,SC,0,0,97741,Africa,126,0
2020-08-12,Seychelles,SC,1,0,97741,Africa,127,0
2020-08-13,Seychelles,SC,0,0,97741,Africa,127,0
2020-08-14,Seychelles,SC,0,0,97741,Africa,127,0
2020-08-15,Seychelles,SC,0,0,97741,Africa,127,0
2020-08-16,Seychelles,SC,0,0,97741,Africa,127,0
2020-08-17,Seychelles,SC,0,0,97741,Africa,127,0
2020-08-18,Seychelles,SC,0,0,97741,Africa,127,0
2020-08-19,Seychelles,SC,0,0,97741,Africa,127,0
2020-08-20,Seychelles,SC,5,0,97741,Africa,132,0
2020-08-21,Seychelles,SC,0,0,97741,Africa,132,0
2020-08-22,Seychelles,SC,0,0,97741,Africa,132,0
2020-08-23,Seychelles,SC,0,0,97741,Africa,132,0
2020-08-24,Seychelles,SC,0,0,97741,Africa,132,0
2020-08-25,Seychelles,SC,0,0,97741,Africa,132,0
2020-08-26,Seychelles,SC,4,0,97741,Africa,136,0
2020-08-27,Seychelles,SC,0,0,97741,Africa,136,0
2020-08-28,Seychelles,SC,0,0,97741,Africa,136,0
2020-08-29,Seychelles,SC,0,0,97741,Africa,136,0
2020-08-30,Seychelles,SC,0,0,97741,Africa,136,0
2020-08-31,Seychelles,SC,0,0,97741,Africa,136,0
2020-09-01,Seychelles,SC,0,0,97741,Africa,136,0
2020-09-02,Seychelles,SC,0,0,97741,Africa,136,0
2020-09-03,Seychelles,SC,0,0,97741,Africa,136,0
2020-09-04,Seychelles,SC,0,0,97741,Africa,136,0
2020-09-05,Seychelles,SC,0,0,97741,Africa,136,0
2020-09-06,Seychelles,SC,0,0,97741,Africa,136,0
2020-09-07,Seychelles,SC,1,0,97741,Africa,137,0
2020-09-08,Seychelles,SC,0,0,97741,Africa,137,0
2020-09-09,Seychelles,SC,0,0,97741,Africa,137,0
2020-09-10,Seychelles,SC,0,0,97741,Africa,137,0
2020-09-11,Seychelles,SC,0,0,97741,Africa,137,0
2020-09-12,Seychelles,SC,0,0,97741,Africa,137,0
2020-09-13,Seychelles,SC,2,0,97741,Africa,139,0
2020-09-14,Seychelles,SC,0,0,97741,Africa,139,0
2020-09-15,Seychelles,SC,1,0,97741,Africa,140,0
2020-09-16,Seychelles,SC,0,0,97741,Africa,140,0
2020-09-17,Seychelles,SC,0,0,97741,Africa,140,0
2020-09-18,Seychelles,SC,1,0,97741,Africa,141,0
2020-09-19,Seychelles,SC,0,0,97741,Africa,141,0
2020-09-20,Seychelles,SC,0,0,97741,Africa,141,0
2020-09-21,Seychelles,SC,0,0,97741,Africa,141,0
2020-09-22,Seychelles,SC,2,0,97741,Africa,143,0
2020-09-23,Seychelles,SC,0,0,97741,Africa,143,0
2020-09-24,Seychelles,SC,0,0,97741,Africa,143,0
2020-09-25,Seychelles,SC,0,0,97741,Africa,143,0
2020-09-26,Seychelles,SC,0,0,97741,Africa,143,0
2020-09-27,Seychelles,SC,0,0,97741,Africa,143,0
2020-09-28,Seychelles,SC,0,0,97741,Africa,143,0
2020-09-29,Seychelles,SC,0,0,97741,Africa,143,0
2020-09-30,Seychelles,SC,0,0,97741,Africa,143,0
2020-10-01,Seychelles,SC,1,0,97741,Africa,144,0
2020-10-02,Seychelles,SC,0,0,97741,Africa,144,0
2020-10-03,Seychelles,SC,0,0,97741,Africa,144,0
2020-10-04,Seychelles,SC,1,0,97741,Africa,145,0
2020-10-05,Seychelles,SC,0,0,97741,Africa,145,0
2020-10-06,Seychelles,SC,3,0,97741,Africa,148,0
2020-10-07,Seychelles,SC,0,0,97741,Africa,148,0
2020-10-08,Seychelles,SC,0,0,97741,Africa,148,0
2020-10-09,Seychelles,SC,0,0,97741,Africa,148,0
2020-10-10,Seychelles,SC,0,0,97741,Africa,148,0
2020-10-11,Seychelles,SC,0,0,97741,Africa,148,0
2020-10-12,Seychelles,SC,0,0,97741,Africa,148,0
2020-10-13,Seychelles,SC,0,0,97741,Africa,148,0
2020-10-14,Seychelles,SC,0,0,97741,Africa,148,0
2020-10-15,Seychelles,SC,0,0,97741,Africa,148,0
2020-10-16,Seychelles,SC,1,0,97741,Africa,149,0
2020-10-17,Seychelles,SC,0,0,97741,Africa,149,0
2020-10-18,Seychelles,SC,0,0,97741,Africa,149,0
2020-10-19,Seychelles,SC,0,0,97741,Africa,149,0
2020-10-20,Seychelles,SC,0,0,97741,Africa,149,0
2020-10-21,Seychelles,SC,0,0,97741,Africa,149,0
2020-10-22,Seychelles,SC,2,0,97741,Africa,151,0
2020-10-23,Seychelles,SC,2,0,97741,Africa,153,0
2020-10-24,Seychelles,SC,0,0,97741,Africa,153,0
2020-10-25,Seychelles,SC,0,0,97741,Africa,153,0
2020-10-26,Seychelles,SC,0,0,97741,Africa,153,0
2020-10-27,Seychelles,SC,0,0,97741,Africa,153,0
2020-10-28,Seychelles,SC,0,0,97741,Africa,153,0
2020-10-29,Seychelles,SC,0,0,97741,Africa,153,0
2020-10-30,Seychelles,SC,0,0,97741,Africa,153,0
2020-10-31,Seychelles,SC,0,0,97741,Africa,153,0
2020-11-01,Seychelles,SC,0,0,97741,Africa,153,0
2020-11-02,Seychelles,SC,0,0,97741,Africa,153,0
2020-11-03,Seychelles,SC,2,0,97741,Africa,155,0
2020-11-04,Seychelles,SC,2,0,97741,Africa,157,0
2020-11-05,Seychelles,SC,0,0,97741,Africa,157,0
2020-11-06,Seychelles,SC,1,0,97741,Africa,158,0
2020-11-07,Seychelles,SC,0,0,97741,Africa,158,0
2020-11-08,Seychelles,SC,0,0,97741,Africa,158,0
2020-11-09,Seychelles,SC,0,0,97741,Africa,158,0
2020-11-10,Seychelles,SC,0,0,97741,Africa,158,0
2020-11-11,Seychelles,SC,0,0,97741,Africa,158,0
2020-11-12,Seychelles,SC,0,0,97741,Africa,158,0
2020-11-13,Seychelles,SC,0,0,97741,Africa,158,0
2020-11-14,Seychelles,SC,0,0,97741,Africa,158,0
2020-11-15,Seychelles,SC,0,0,97741,Africa,158,0
2020-11-16,Seychelles,SC,0,0,97741,Africa,158,0
2020-11-17,Seychelles,SC,0,0,97741,Africa,158,0
2020-11-18,Seychelles,SC,2,0,97741,Africa,160,0
2020-11-19,Seychelles,SC,0,0,97741,Africa,160,0
2020-11-20,Seychelles,SC,3,0,97741,Africa,163,0
2020-11-21,Seychelles,SC,0,0,97741,Africa,163,0
2020-11-22,Seychelles,SC,0,0,97741,Africa,163,0
2020-11-23,Seychelles,SC,3,0,97741,Africa,166,0
2020-11-24,Seychelles,SC,0,0,97741,Africa,166,0
2020-11-25,Seychelles,SC,0,0,97741,Africa,166,0
2020-11-26,Seychelles,SC,1,0,97741,Africa,167,0
2020-11-27,Seychelles,SC,4,0,97741,Africa,171,0
2020-11-28,Seychelles,SC,2,0,97741,Africa,173,0
2020-11-29,Seychelles,SC,0,0,97741,Africa,173,0
2020-11-30,Seychelles,SC,0,0,97741,Africa,173,0
2020-12-01,Seychelles,SC,10,0,97741,Africa,183,0
2020-12-02,Seychelles,SC,0,0,97741,Africa,183,0
2020-12-03,Seychelles,SC,0,0,97741,Africa,183,0
2020-12-04,Seychelles,SC,0,0,97741,Africa,183,0
2020-12-05,Seychelles,SC,1,0,97741,Africa,184,0
2020-12-06,Seychelles,SC,0,0,97741,Africa,184,0
2020-12-07,Seychelles,SC,0,0,97741,Africa,184,0
2020-12-08,Seychelles,SC,0,0,97741,Africa,184,0
2020-12-09,Seychelles,SC,0,0,97741,Africa,184,0
2020-12-10,Seychelles,SC,0,0,97741,Africa,184,0
2020-12-11,Seychelles,SC,3,0,97741,Africa,187,0
2020-12-12,Seychelles,SC,0,0,97741,Africa,187,0
2020-12-13,Seychelles,SC,0,0,97741,Africa,187,0
2020-12-14,Seychelles,SC,0,0,97741,Africa,187,0
2020-03-14,Sudan,SD,1,0,42813237,Africa,1,0
2020-03-15,Sudan,SD,0,1,42813237,Africa,1,1
2020-03-16,Sudan,SD,0,0,42813237,Africa,1,1
2020-03-17,Sudan,SD,0,0,42813237,Africa,1,1
2020-03-18,Sudan,SD,0,0,42813237,Africa,1,1
2020-03-19,Sudan,SD,1,0,42813237,Africa,2,1
2020-03-20,Sudan,SD,0,0,42813237,Africa,2,1
2020-03-21,Sudan,SD,0,0,42813237,Africa,2,1
2020-03-22,Sudan,SD,0,0,42813237,Africa,2,1
2020-03-23,Sudan,SD,0,0,42813237,Africa,2,1
2020-03-24,Sudan,SD,0,0,42813237,Africa,2,1
2020-03-25,Sudan,SD,1,0,42813237,Africa,3,1
2020-03-26,Sudan,SD,0,0,42813237,Africa,3,1
2020-03-27,Sudan,SD,0,0,42813237,Africa,3,1
2020-03-28,Sudan,SD,0,0,42813237,Africa,3,1
2020-03-29,Sudan,SD,2,0,42813237,Africa,5,1
2020-03-30,Sudan,SD,0,0,42813237,Africa,5,1
2020-03-31,Sudan,SD,1,1,42813237,Africa,6,2
2020-04-01,Sudan,SD,1,0,42813237,Africa,7,2
2020-04-02,Sudan,SD,0,0,42813237,Africa,7,2
2020-04-03,Sudan,SD,0,0,42813237,Africa,7,2
2020-04-04,Sudan,SD,0,0,42813237,Africa,7,2
2020-04-05,Sudan,SD,3,0,42813237,Africa,10,2
2020-04-06,Sudan,SD,2,0,42813237,Africa,12,2
2020-04-07,Sudan,SD,0,0,42813237,Africa,12,2
2020-04-08,Sudan,SD,2,0,42813237,Africa,14,2
2020-04-09,Sudan,SD,0,0,42813237,Africa,14,2
2020-04-10,Sudan,SD,0,0,42813237,Africa,14,2
2020-04-11,Sudan,SD,1,0,42813237,Africa,15,2
2020-04-12,Sudan,SD,4,0,42813237,Africa,19,2
2020-04-13,Sudan,SD,0,0,42813237,Africa,19,2
2020-04-14,Sudan,SD,10,2,42813237,Africa,29,4
2020-04-15,Sudan,SD,3,1,42813237,Africa,32,5
2020-04-16,Sudan,SD,0,0,42813237,Africa,32,5
2020-04-17,Sudan,SD,0,0,42813237,Africa,32,5
2020-04-18,Sudan,SD,0,0,42813237,Africa,32,5
2020-04-19,Sudan,SD,34,5,42813237,Africa,66,10
2020-04-20,Sudan,SD,0,0,42813237,Africa,66,10
2020-04-21,Sudan,SD,26,2,42813237,Africa,92,12
2020-04-22,Sudan,SD,15,0,42813237,Africa,107,12
2020-04-23,Sudan,SD,33,1,42813237,Africa,140,13
2020-04-24,Sudan,SD,22,0,42813237,Africa,162,13
2020-04-25,Sudan,SD,12,3,42813237,Africa,174,16
2020-04-26,Sudan,SD,39,1,42813237,Africa,213,17
2020-04-27,Sudan,SD,24,4,42813237,Africa,237,21
2020-04-28,Sudan,SD,38,1,42813237,Africa,275,22
2020-04-29,Sudan,SD,43,3,42813237,Africa,318,25
2020-04-30,Sudan,SD,57,3,42813237,Africa,375,28
2020-05-01,Sudan,SD,67,3,42813237,Africa,442,31
2020-05-02,Sudan,SD,0,0,42813237,Africa,442,31
2020-05-03,Sudan,SD,150,10,42813237,Africa,592,41
2020-05-04,Sudan,SD,86,0,42813237,Africa,678,41
2020-05-05,Sudan,SD,0,0,42813237,Africa,678,41
2020-05-06,Sudan,SD,100,4,42813237,Africa,778,45
2020-05-07,Sudan,SD,74,4,42813237,Africa,852,49
2020-05-08,Sudan,SD,78,3,42813237,Africa,930,52
2020-05-09,Sudan,SD,181,7,42813237,Africa,1111,59
2020-05-10,Sudan,SD,53,5,42813237,Africa,1164,64
2020-05-11,Sudan,SD,199,6,42813237,Africa,1363,70
2020-05-12,Sudan,SD,163,4,42813237,Africa,1526,74
2020-05-13,Sudan,SD,135,6,42813237,Africa,1661,80
2020-05-14,Sudan,SD,157,10,42813237,Africa,1818,90
2020-05-15,Sudan,SD,146,1,42813237,Africa,1964,91
2020-05-16,Sudan,SD,0,0,42813237,Africa,1964,91
2020-05-17,Sudan,SD,0,0,42813237,Africa,1964,91
2020-05-18,Sudan,SD,325,6,42813237,Africa,2289,97
2020-05-19,Sudan,SD,302,8,42813237,Africa,2591,105
2020-05-20,Sudan,SD,0,0,42813237,Africa,2591,105
2020-05-21,Sudan,SD,137,6,42813237,Africa,2728,111
2020-05-22,Sudan,SD,410,10,42813237,Africa,3138,121
2020-05-23,Sudan,SD,240,16,42813237,Africa,3378,137
2020-05-24,Sudan,SD,250,9,42813237,Africa,3628,146
2020-05-25,Sudan,SD,6,0,42813237,Africa,3634,146
2020-05-26,Sudan,SD,192,19,42813237,Africa,3826,165
2020-05-27,Sudan,SD,150,5,42813237,Africa,3976,170
2020-05-28,Sudan,SD,170,14,42813237,Africa,4146,184
2020-05-29,Sudan,SD,200,11,42813237,Africa,4346,195
2020-05-30,Sudan,SD,175,38,42813237,Africa,4521,233
2020-05-31,Sudan,SD,279,29,42813237,Africa,4800,262
2020-06-01,Sudan,SD,226,24,42813237,Africa,5026,286
2020-06-02,Sudan,SD,147,12,42813237,Africa,5173,298
2020-06-03,Sudan,SD,137,9,42813237,Africa,5310,307
2020-06-04,Sudan,SD,0,0,42813237,Africa,5310,307
2020-06-05,Sudan,SD,189,7,42813237,Africa,5499,314
2020-06-06,Sudan,SD,215,19,42813237,Africa,5714,333
2020-06-07,Sudan,SD,151,14,42813237,Africa,5865,347
2020-06-08,Sudan,SD,218,12,42813237,Africa,6083,359
2020-06-09,Sudan,SD,159,13,42813237,Africa,6242,372
2020-06-10,Sudan,SD,0,0,42813237,Africa,6242,372
2020-06-11,Sudan,SD,185,17,42813237,Africa,6427,389
2020-06-12,Sudan,SD,303,24,42813237,Africa,6730,413
2020-06-13,Sudan,SD,149,20,42813237,Africa,6879,433
2020-06-14,Sudan,SD,0,0,42813237,Africa,6879,433
2020-06-15,Sudan,SD,341,26,42813237,Africa,7220,459
2020-06-16,Sudan,SD,0,0,42813237,Africa,7220,459
2020-06-17,Sudan,SD,520,18,42813237,Africa,7740,477
2020-06-18,Sudan,SD,280,10,42813237,Africa,8020,487
2020-06-19,Sudan,SD,0,0,42813237,Africa,8020,487
2020-06-20,Sudan,SD,296,19,42813237,Africa,8316,506
2020-06-21,Sudan,SD,264,15,42813237,Africa,8580,521
2020-06-22,Sudan,SD,0,0,42813237,Africa,8580,521
2020-06-23,Sudan,SD,118,12,42813237,Africa,8698,533
2020-06-24,Sudan,SD,191,15,42813237,Africa,8889,548
2020-06-25,Sudan,SD,0,0,42813237,Africa,8889,548
2020-06-26,Sudan,SD,95,8,42813237,Africa,8984,556
2020-06-27,Sudan,SD,273,16,42813237,Africa,9257,572
2020-06-28,Sudan,SD,1,0,42813237,Africa,9258,572
2020-06-29,Sudan,SD,0,0,42813237,Africa,9258,572
2020-06-30,Sudan,SD,0,0,42813237,Africa,9258,572
2020-07-01,Sudan,SD,0,0,42813237,Africa,9258,572
2020-07-02,Sudan,SD,315,30,42813237,Africa,9573,602
2020-07-03,Sudan,SD,0,0,42813237,Africa,9573,602
2020-07-04,Sudan,SD,90,2,42813237,Africa,9663,604
2020-07-05,Sudan,SD,0,0,42813237,Africa,9663,604
2020-07-06,Sudan,SD,104,4,42813237,Africa,9767,608
2020-07-07,Sudan,SD,0,0,42813237,Africa,9767,608
2020-07-08,Sudan,SD,230,14,42813237,Africa,9997,622
2020-07-09,Sudan,SD,87,14,42813237,Africa,10084,636
2020-07-10,Sudan,SD,74,5,42813237,Africa,10158,641
2020-07-11,Sudan,SD,46,8,42813237,Africa,10204,649
2020-07-12,Sudan,SD,46,1,42813237,Africa,10250,650
2020-07-13,Sudan,SD,0,0,42813237,Africa,10250,650
2020-07-14,Sudan,SD,66,7,42813237,Africa,10316,657
2020-07-15,Sudan,SD,0,0,42813237,Africa,10316,657
2020-07-16,Sudan,SD,211,11,42813237,Africa,10527,668
2020-07-17,Sudan,SD,0,0,42813237,Africa,10527,668
2020-07-18,Sudan,SD,0,0,42813237,Africa,10527,668
2020-07-19,Sudan,SD,155,5,42813237,Africa,10682,673
2020-07-20,Sudan,SD,80,7,42813237,Africa,10762,680
2020-07-21,Sudan,SD,230,13,42813237,Africa,10992,693
2020-07-22,Sudan,SD,135,13,42813237,Africa,11127,706
2020-07-23,Sudan,SD,0,0,42813237,Africa,11127,706
2020-07-24,Sudan,SD,110,2,42813237,Africa,11237,708
2020-07-25,Sudan,SD,0,0,42813237,Africa,11237,708
2020-07-26,Sudan,SD,65,7,42813237,Africa,11302,715
2020-07-27,Sudan,SD,83,2,42813237,Africa,11385,717
2020-07-28,Sudan,SD,39,3,42813237,Africa,11424,720
2020-07-29,Sudan,SD,72,5,42813237,Africa,11496,725
2020-07-30,Sudan,SD,0,0,42813237,Africa,11496,725
2020-07-31,Sudan,SD,0,0,42813237,Africa,11496,725
2020-08-01,Sudan,SD,148,21,42813237,Africa,11644,746
2020-08-02,Sudan,SD,0,0,42813237,Africa,11644,746
2020-08-03,Sudan,SD,94,6,42813237,Africa,11738,752
2020-08-04,Sudan,SD,0,0,42813237,Africa,11738,752
2020-08-05,Sudan,SD,42,11,42813237,Africa,11780,763
2020-08-06,Sudan,SD,0,0,42813237,Africa,11780,763
2020-08-07,Sudan,SD,0,0,42813237,Africa,11780,763
2020-08-08,Sudan,SD,70,6,42813237,Africa,11850,769
2020-08-09,Sudan,SD,44,4,42813237,Africa,11894,773
2020-08-10,Sudan,SD,0,0,42813237,Africa,11894,773
2020-08-11,Sudan,SD,62,8,42813237,Africa,11956,781
2020-08-12,Sudan,SD,77,5,42813237,Africa,12033,786
2020-08-13,Sudan,SD,82,6,42813237,Africa,12115,792
2020-08-14,Sudan,SD,0,0,42813237,Africa,12115,792
2020-08-15,Sudan,SD,47,1,42813237,Africa,12162,793
2020-08-16,Sudan,SD,152,5,42813237,Africa,12314,798
2020-08-17,Sudan,SD,96,5,42813237,Africa,12410,803
2020-08-18,Sudan,SD,0,0,42813237,Africa,12410,803
2020-08-19,Sudan,SD,75,2,42813237,Africa,12485,805
2020-08-20,Sudan,SD,61,3,42813237,Africa,12546,808
2020-08-21,Sudan,SD,40,4,42813237,Africa,12586,812
2020-08-22,Sudan,SD,37,0,42813237,Africa,12623,812
2020-08-23,Sudan,SD,0,0,42813237,Africa,12623,812
2020-08-24,Sudan,SD,213,3,42813237,Africa,12836,815
2020-08-25,Sudan,SD,0,0,42813237,Africa,12836,815
2020-08-26,Sudan,SD,138,4,42813237,Africa,12974,819
2020-08-27,Sudan,SD,0,0,42813237,Africa,12974,819
2020-08-28,Sudan,SD,71,4,42813237,Africa,13045,823
2020-08-29,Sudan,SD,0,0,42813237,Africa,13045,823
2020-08-30,Sudan,SD,144,0,42813237,Africa,13189,823
2020-08-31,Sudan,SD,0,0,42813237,Africa,13189,823
2020-09-01,Sudan,SD,0,0,42813237,Africa,13189,823
2020-09-02,Sudan,SD,0,0,42813237,Africa,13189,823
2020-09-03,Sudan,SD,0,0,42813237,Africa,13189,823
2020-09-04,Sudan,SD,0,0,42813237,Africa,13189,823
2020-09-05,Sudan,SD,0,0,42813237,Africa,13189,823
2020-09-06,Sudan,SD,0,0,42813237,Africa,13189,823
2020-09-07,Sudan,SD,218,9,42813237,Africa,13407,832
2020-09-08,Sudan,SD,30,1,42813237,Africa,13437,833
2020-09-09,Sudan,SD,0,0,42813237,Africa,13437,833
2020-09-10,Sudan,SD,0,0,42813237,Africa,13437,833
2020-09-11,Sudan,SD,0,0,42813237,Africa,13437,833
2020-09-12,Sudan,SD,0,0,42813237,Africa,13437,833
2020-09-13,Sudan,SD,33,1,42813237,Africa,13470,834
2020-09-14,Sudan,SD,0,0,42813237,Africa,13470,834
2020-09-15,Sudan,SD,65,2,42813237,Africa,13535,836
2020-09-16,Sudan,SD,0,0,42813237,Africa,13535,836
2020-09-17,Sudan,SD,0,0,42813237,Africa,13535,836
2020-09-18,Sudan,SD,0,0,42813237,Africa,13535,836
2020-09-19,Sudan,SD,0,0,42813237,Africa,13535,836
2020-09-20,Sudan,SD,0,0,42813237,Africa,13535,836
2020-09-21,Sudan,SD,20,0,42813237,Africa,13555,836
2020-09-22,Sudan,SD,0,0,42813237,Africa,13555,836
2020-09-23,Sudan,SD,23,0,42813237,Africa,13578,836
2020-09-24,Sudan,SD,0,0,42813237,Africa,13578,836
2020-09-25,Sudan,SD,14,0,42813237,Africa,13592,836
2020-09-26,Sudan,SD,0,0,42813237,Africa,13592,836
2020-09-27,Sudan,SD,14,0,42813237,Africa,13606,836
2020-09-28,Sudan,SD,0,0,42813237,Africa,13606,836
2020-09-29,Sudan,SD,0,0,42813237,Africa,13606,836
2020-09-30,Sudan,SD,0,0,42813237,Africa,13606,836
2020-10-01,Sudan,SD,34,0,42813237,Africa,13640,836
2020-10-02,Sudan,SD,13,0,42813237,Africa,13653,836
2020-10-03,Sudan,SD,0,0,42813237,Africa,13653,836
2020-10-04,Sudan,SD,0,0,42813237,Africa,13653,836
2020-10-05,Sudan,SD,0,0,42813237,Africa,13653,836
2020-10-06,Sudan,SD,0,0,42813237,Africa,13653,836
2020-10-07,Sudan,SD,0,0,42813237,Africa,13653,836
2020-10-08,Sudan,SD,15,0,42813237,Africa,13668,836
2020-10-09,Sudan,SD,0,0,42813237,Africa,13668,836
2020-10-10,Sudan,SD,2,0,42813237,Africa,13670,836
2020-10-11,Sudan,SD,0,0,42813237,Africa,13670,836
2020-10-12,Sudan,SD,0,0,42813237,Africa,13670,836
2020-10-13,Sudan,SD,15,0,42813237,Africa,13685,836
2020-10-14,Sudan,SD,6,0,42813237,Africa,13691,836
2020-10-15,Sudan,SD,0,0,42813237,Africa,13691,836
2020-10-16,Sudan,SD,0,0,42813237,Africa,13691,836
2020-10-17,Sudan,SD,0,0,42813237,Africa,13691,836
2020-10-18,Sudan,SD,0,0,42813237,Africa,13691,836
2020-10-19,Sudan,SD,0,0,42813237,Africa,13691,836
2020-10-20,Sudan,SD,6,0,42813237,Africa,13697,836
2020-10-21,Sudan,SD,27,0,42813237,Africa,13724,836
2020-10-22,Sudan,SD,0,0,42813237,Africa,13724,836
2020-10-23,Sudan,SD,0,0,42813237,Africa,13724,836
2020-10-24,Sudan,SD,0,0,42813237,Africa,13724,836
2020-10-25,Sudan,SD,18,1,42813237,Africa,13742,837
2020-10-26,Sudan,SD,0,0,42813237,Africa,13742,837
2020-10-27,Sudan,SD,5,0,42813237,Africa,13747,837
2020-10-28,Sudan,SD,18,0,42813237,Africa,13765,837
2020-10-29,Sudan,SD,0,0,42813237,Africa,13765,837
2020-10-30,Sudan,SD,0,0,42813237,Africa,13765,837
2020-10-31,Sudan,SD,0,0,42813237,Africa,13765,837
2020-11-01,Sudan,SD,0,0,42813237,Africa,13765,837
2020-11-02,Sudan,SD,54,0,42813237,Africa,13819,837
2020-11-03,Sudan,SD,0,0,42813237,Africa,13819,837
2020-11-04,Sudan,SD,47,0,42813237,Africa,13866,837
2020-11-05,Sudan,SD,77,0,42813237,Africa,13943,837
2020-11-06,Sudan,SD,0,0,42813237,Africa,13943,837
2020-11-07,Sudan,SD,0,0,42813237,Africa,13943,837
2020-11-08,Sudan,SD,0,0,42813237,Africa,13943,837
2020-11-09,Sudan,SD,147,278,42813237,Africa,14090,1115
2020-11-10,Sudan,SD,65,1,42813237,Africa,14155,1116
2020-11-11,Sudan,SD,0,0,42813237,Africa,14155,1116
2020-11-12,Sudan,SD,191,0,42813237,Africa,14346,1116
2020-11-13,Sudan,SD,55,0,42813237,Africa,14401,1116
2020-11-14,Sudan,SD,0,0,42813237,Africa,14401,1116
2020-11-15,Sudan,SD,0,0,42813237,Africa,14401,1116
2020-11-16,Sudan,SD,225,0,42813237,Africa,14626,1116
2020-11-17,Sudan,SD,0,0,42813237,Africa,14626,1116
2020-11-18,Sudan,SD,421,59,42813237,Africa,15047,1175
2020-11-19,Sudan,SD,0,0,42813237,Africa,15047,1175
2020-11-20,Sudan,SD,0,0,42813237,Africa,15047,1175
2020-11-21,Sudan,SD,483,10,42813237,Africa,15530,1185
2020-11-22,Sudan,SD,0,0,42813237,Africa,15530,1185
2020-11-23,Sudan,SD,309,8,42813237,Africa,15839,1193
2020-11-24,Sudan,SD,348,6,42813237,Africa,16187,1199
2020-11-25,Sudan,SD,0,0,42813237,Africa,16187,1199
2020-11-26,Sudan,SD,0,0,42813237,Africa,16187,1199
2020-11-27,Sudan,SD,0,0,42813237,Africa,16187,1199
2020-11-28,Sudan,SD,677,16,42813237,Africa,16864,1215
2020-11-29,Sudan,SD,204,5,42813237,Africa,17068,1220
2020-11-30,Sudan,SD,559,21,42813237,Africa,17627,1241
2020-12-01,Sudan,SD,183,8,42813237,Africa,17810,1249
2020-12-02,Sudan,SD,444,16,42813237,Africa,18254,1265
2020-12-03,Sudan,SD,0,0,42813237,Africa,18254,1265
2020-12-04,Sudan,SD,99,6,42813237,Africa,18353,1271
2020-12-05,Sudan,SD,0,0,42813237,Africa,18353,1271
2020-12-06,Sudan,SD,843,19,42813237,Africa,19196,1290
2020-12-07,Sudan,SD,272,5,42813237,Africa,19468,1295
2020-12-08,Sudan,SD,279,6,42813237,Africa,19747,1301
2020-12-09,Sudan,SD,337,6,42813237,Africa,20084,1307
2020-12-10,Sudan,SD,0,0,42813237,Africa,20084,1307
2020-12-11,Sudan,SD,384,12,42813237,Africa,20468,1319
2020-12-12,Sudan,SD,0,0,42813237,Africa,20468,1319
2020-12-13,Sudan,SD,679,25,42813237,Africa,21147,1344
2020-12-14,Sudan,SD,239,3,42813237,Africa,21386,1347
2019-12-31,Sweden,SE,0,0,10230185,Europe,0,0
2020-01-01,Sweden,SE,0,0,10230185,Europe,0,0
2020-01-02,Sweden,SE,0,0,10230185,Europe,0,0
2020-01-03,Sweden,SE,0,0,10230185,Europe,0,0
2020-01-04,Sweden,SE,0,0,10230185,Europe,0,0
2020-01-05,Sweden,SE,0,0,10230185,Europe,0,0
2020-01-06,Sweden,SE,0,0,10230185,Europe,0,0
2020-01-07,Sweden,SE,0,0,10230185,Europe,0,0
2020-01-08,Sweden,SE,0,0,10230185,Europe,0,0
2020-01-09,Sweden,SE,0,0,10230185,Europe,0,0
2020-01-10,Sweden,SE,0,0,10230185,Europe,0,0
2020-01-11,Sweden,SE,0,0,10230185,Europe,0,0
2020-01-12,Sweden,SE,0,0,10230185,Europe,0,0
2020-01-13,Sweden,SE,0,0,10230185,Europe,0,0
2020-01-14,Sweden,SE,0,0,10230185,Europe,0,0
2020-01-15,Sweden,SE,0,0,10230185,Europe,0,0
2020-01-16,Sweden,SE,0,0,10230185,Europe,0,0
2020-01-17,Sweden,SE,0,0,10230185,Europe,0,0
2020-01-18,Sweden,SE,0,0,10230185,Europe,0,0
2020-01-19,Sweden,SE,0,0,10230185,Europe,0,0
2020-01-20,Sweden,SE,0,0,10230185,Europe,0,0
2020-01-21,Sweden,SE,0,0,10230185,Europe,0,0
2020-01-22,Sweden,SE,0,0,10230185,Europe,0,0
2020-01-23,Sweden,SE,0,0,10230185,Europe,0,0
2020-01-24,Sweden,SE,0,0,10230185,Europe,0,0
2020-01-25,Sweden,SE,0,0,10230185,Europe,0,0
2020-01-26,Sweden,SE,0,0,10230185,Europe,0,0
2020-01-27,Sweden,SE,0,0,10230185,Europe,0,0
2020-01-28,Sweden,SE,0,0,10230185,Europe,0,0
2020-01-29,Sweden,SE,0,0,10230185,Europe,0,0
2020-01-30,Sweden,SE,0,0,10230185,Europe,0,0
2020-01-31,Sweden,SE,0,0,10230185,Europe,0,0
2020-02-01,Sweden,SE,0,0,10230185,Europe,0,0
2020-02-02,Sweden,SE,0,0,10230185,Europe,0,0
2020-02-03,Sweden,SE,0,0,10230185,Europe,0,0
2020-02-04,Sweden,SE,0,0,10230185,Europe,0,0
2020-02-05,Sweden,SE,1,0,10230185,Europe,1,0
2020-02-06,Sweden,SE,0,0,10230185,Europe,1,0
2020-02-07,Sweden,SE,0,0,10230185,Europe,1,0
2020-02-08,Sweden,SE,0,0,10230185,Europe,1,0
2020-02-09,Sweden,SE,0,0,10230185,Europe,1,0
2020-02-10,Sweden,SE,0,0,10230185,Europe,1,0
2020-02-11,Sweden,SE,0,0,10230185,Europe,1,0
2020-02-12,Sweden,SE,0,0,10230185,Europe,1,0
2020-02-13,Sweden,SE,0,0,10230185,Europe,1,0
2020-02-14,Sweden,SE,0,0,10230185,Europe,1,0
2020-02-15,Sweden,SE,0,0,10230185,Europe,1,0
2020-02-16,Sweden,SE,0,0,10230185,Europe,1,0
2020-02-17,Sweden,SE,0,0,10230185,Europe,1,0
2020-02-18,Sweden,SE,0,0,10230185,Europe,1,0
2020-02-19,Sweden,SE,0,0,10230185,Europe,1,0
2020-02-20,Sweden,SE,0,0,10230185,Europe,1,0
2020-02-21,Sweden,SE,0,0,10230185,Europe,1,0
2020-02-22,Sweden,SE,0,0,10230185,Europe,1,0
2020-02-23,Sweden,SE,0,0,10230185,Europe,1,0
2020-02-24,Sweden,SE,0,0,10230185,Europe,1,0
2020-02-25,Sweden,SE,0,0,10230185,Europe,1,0
2020-02-26,Sweden,SE,0,0,10230185,Europe,1,0
2020-02-27,Sweden,SE,1,0,10230185,Europe,2,0
2020-02-28,Sweden,SE,1,0,10230185,Europe,3,0
2020-02-29,Sweden,SE,8,0,10230185,Europe,11,0
2020-03-01,Sweden,SE,3,0,10230185,Europe,14,0
2020-03-02,Sweden,SE,0,0,10230185,Europe,14,0
2020-03-03,Sweden,SE,5,0,10230185,Europe,19,0
2020-03-04,Sweden,SE,13,0,10230185,Europe,32,0
2020-03-05,Sweden,SE,30,0,10230185,Europe,62,0
2020-03-06,Sweden,SE,25,0,10230185,Europe,87,0
2020-03-07,Sweden,SE,59,0,10230185,Europe,146,0
2020-03-08,Sweden,SE,33,0,10230185,Europe,179,0
2020-03-09,Sweden,SE,46,0,10230185,Europe,225,0
2020-03-10,Sweden,SE,101,0,10230185,Europe,326,0
2020-03-11,Sweden,SE,98,0,10230185,Europe,424,0
2020-03-12,Sweden,SE,196,20,10230185,Europe,620,20
2020-03-13,Sweden,SE,151,0,10230185,Europe,771,20
2020-03-14,Sweden,SE,152,1,10230185,Europe,923,21
2020-03-15,Sweden,SE,71,1,10230185,Europe,994,22
2020-03-16,Sweden,SE,69,2,10230185,Europe,1063,24
2020-03-17,Sweden,SE,83,2,10230185,Europe,1146,26
2020-03-18,Sweden,SE,119,1,10230185,Europe,1265,27
2020-03-19,Sweden,SE,145,6,10230185,Europe,1410,33
2020-03-20,Sweden,SE,143,7,10230185,Europe,1553,40
2020-03-21,Sweden,SE,180,9,10230185,Europe,1733,49
2020-03-22,Sweden,SE,136,8,10230185,Europe,1869,57
2020-03-23,Sweden,SE,118,11,10230185,Europe,1987,68
2020-03-24,Sweden,SE,182,11,10230185,Europe,2169,79
2020-03-25,Sweden,SE,230,21,10230185,Europe,2399,100
2020-03-26,Sweden,SE,314,22,10230185,Europe,2713,122
2020-03-27,Sweden,SE,286,31,10230185,Europe,2999,153
2020-03-28,Sweden,SE,365,32,10230185,Europe,3364,185
2020-03-29,Sweden,SE,300,35,10230185,Europe,3664,220
2020-03-30,Sweden,SE,280,38,10230185,Europe,3944,258
2020-03-31,Sweden,SE,416,45,10230185,Europe,4360,303
2020-04-01,Sweden,SE,475,48,10230185,Europe,4835,351
2020-04-02,Sweden,SE,486,53,10230185,Europe,5321,404
2020-04-03,Sweden,SE,554,70,10230185,Europe,5875,474
2020-04-04,Sweden,SE,601,80,10230185,Europe,6476,554
2020-04-05,Sweden,SE,357,70,10230185,Europe,6833,624
2020-04-06,Sweden,SE,340,85,10230185,Europe,7173,709
2020-04-07,Sweden,SE,389,90,10230185,Europe,7562,799
2020-04-08,Sweden,SE,738,84,10230185,Europe,8300,883
2020-04-09,Sweden,SE,654,115,10230185,Europe,8954,998
2020-04-10,Sweden,SE,645,86,10230185,Europe,9599,1084
2020-04-11,Sweden,SE,454,90,10230185,Europe,10053,1174
2020-04-12,Sweden,SE,395,102,10230185,Europe,10448,1276
2020-04-13,Sweden,SE,464,97,10230185,Europe,10912,1373
2020-04-14,Sweden,SE,437,84,10230185,Europe,11349,1457
2020-04-15,Sweden,SE,479,92,10230185,Europe,11828,1549
2020-04-16,Sweden,SE,604,115,10230185,Europe,12432,1664
2020-04-17,Sweden,SE,623,111,10230185,Europe,13055,1775
2020-04-18,Sweden,SE,688,83,10230185,Europe,13743,1858
2020-04-19,Sweden,SE,532,86,10230185,Europe,14275,1944
2020-04-20,Sweden,SE,388,87,10230185,Europe,14663,2031
2020-04-21,Sweden,SE,461,85,10230185,Europe,15124,2116
2020-04-22,Sweden,SE,707,62,10230185,Europe,15831,2178
2020-04-23,Sweden,SE,722,77,10230185,Europe,16553,2255
2020-04-24,Sweden,SE,758,86,10230185,Europe,17311,2341
2020-04-25,Sweden,SE,780,89,10230185,Europe,18091,2430
2020-04-26,Sweden,SE,473,73,10230185,Europe,18564,2503
2020-04-27,Sweden,SE,300,74,10230185,Europe,18864,2577
2020-04-28,Sweden,SE,563,74,10230185,Europe,19427,2651
2020-04-29,Sweden,SE,742,83,10230185,Europe,20169,2734
2020-04-30,Sweden,SE,799,83,10230185,Europe,20968,2817
2020-05-01,Sweden,SE,636,78,10230185,Europe,21604,2895
2020-05-02,Sweden,SE,532,78,10230185,Europe,22136,2973
2020-05-03,Sweden,SE,299,73,10230185,Europe,22435,3046
2020-05-04,Sweden,SE,261,75,10230185,Europe,22696,3121
2020-05-05,Sweden,SE,477,84,10230185,Europe,23173,3205
2020-05-06,Sweden,SE,657,72,10230185,Europe,23830,3277
2020-05-07,Sweden,SE,745,73,10230185,Europe,24575,3350
2020-05-08,Sweden,SE,784,80,10230185,Europe,25359,3430
2020-05-09,Sweden,SE,700,60,10230185,Europe,26059,3490
2020-05-10,Sweden,SE,509,68,10230185,Europe,26568,3558
2020-05-11,Sweden,SE,279,73,10230185,Europe,26847,3631
2020-05-12,Sweden,SE,455,65,10230185,Europe,27302,3696
2020-05-13,Sweden,SE,754,61,10230185,Europe,28056,3757
2020-05-14,Sweden,SE,698,50,10230185,Europe,28754,3807
2020-05-15,Sweden,SE,657,46,10230185,Europe,29411,3853
2020-05-16,Sweden,SE,688,58,10230185,Europe,30099,3911
2020-05-17,Sweden,SE,358,48,10230185,Europe,30457,3959
2020-05-18,Sweden,SE,259,53,10230185,Europe,30716,4012
2020-05-19,Sweden,SE,430,59,10230185,Europe,31146,4071
2020-05-20,Sweden,SE,666,41,10230185,Europe,31812,4112
2020-05-21,Sweden,SE,808,52,10230185,Europe,32620,4164
2020-05-22,Sweden,SE,610,53,10230185,Europe,33230,4217
2020-05-23,Sweden,SE,532,56,10230185,Europe,33762,4273
2020-05-24,Sweden,SE,403,55,10230185,Europe,34165,4328
2020-05-25,Sweden,SE,210,44,10230185,Europe,34375,4372
2020-05-26,Sweden,SE,491,42,10230185,Europe,34866,4414
2020-05-27,Sweden,SE,746,28,10230185,Europe,35612,4442
2020-05-28,Sweden,SE,800,38,10230185,Europe,36412,4480
2020-05-29,Sweden,SE,774,40,10230185,Europe,37186,4520
2020-05-30,Sweden,SE,773,41,10230185,Europe,37959,4561
2020-05-31,Sweden,SE,432,39,10230185,Europe,38391,4600
2020-06-01,Sweden,SE,265,46,10230185,Europe,38656,4646
2020-06-02,Sweden,SE,648,39,10230185,Europe,39304,4685
2020-06-03,Sweden,SE,900,36,10230185,Europe,40204,4721
2020-06-04,Sweden,SE,1046,28,10230185,Europe,41250,4749
2020-06-05,Sweden,SE,1038,43,10230185,Europe,42288,4792
2020-06-06,Sweden,SE,1146,37,10230185,Europe,43434,4829
2020-06-07,Sweden,SE,780,29,10230185,Europe,44214,4858
2020-06-08,Sweden,SE,462,33,10230185,Europe,44676,4891
2020-06-09,Sweden,SE,677,38,10230185,Europe,45353,4929
2020-06-10,Sweden,SE,937,33,10230185,Europe,46290,4962
2020-06-11,Sweden,SE,1437,40,10230185,Europe,47727,5002
2020-06-12,Sweden,SE,1293,35,10230185,Europe,49020,5037
2020-06-13,Sweden,SE,1329,29,10230185,Europe,50349,5066
2020-06-14,Sweden,SE,1032,33,10230185,Europe,51381,5099
2020-06-15,Sweden,SE,418,27,10230185,Europe,51799,5126
2020-06-16,Sweden,SE,685,30,10230185,Europe,52484,5156
2020-06-17,Sweden,SE,1209,28,10230185,Europe,53693,5184
2020-06-18,Sweden,SE,1457,32,10230185,Europe,55150,5216
2020-06-19,Sweden,SE,1494,29,10230185,Europe,56644,5245
2020-06-20,Sweden,SE,1209,30,10230185,Europe,57853,5275
2020-06-21,Sweden,SE,698,29,10230185,Europe,58551,5304
2020-06-22,Sweden,SE,321,22,10230185,Europe,58872,5326
2020-06-23,Sweden,SE,800,20,10230185,Europe,59672,5346
2020-06-24,Sweden,SE,1309,25,10230185,Europe,60981,5371
2020-06-25,Sweden,SE,1698,22,10230185,Europe,62679,5393
2020-06-26,Sweden,SE,1279,23,10230185,Europe,63958,5416
2020-06-27,Sweden,SE,1204,11,10230185,Europe,65162,5427
2020-06-28,Sweden,SE,755,14,10230185,Europe,65917,5441
2020-06-29,Sweden,SE,415,23,10230185,Europe,66332,5464
2020-06-30,Sweden,SE,727,16,10230185,Europe,67059,5480
2020-07-01,Sweden,SE,804,20,10230185,Europe,67863,5500
2020-07-02,Sweden,SE,684,15,10230185,Europe,68547,5515
2020-07-03,Sweden,SE,687,15,10230185,Europe,69234,5530
2020-07-04,Sweden,SE,694,8,10230185,Europe,69928,5538
2020-07-05,Sweden,SE,364,15,10230185,Europe,70292,5553
2020-07-06,Sweden,SE,315,9,10230185,Europe,70607,5562
2020-07-07,Sweden,SE,251,15,10230185,Europe,70858,5577
2020-07-08,Sweden,SE,278,12,10230185,Europe,71136,5589
2020-07-09,Sweden,SE,533,11,10230185,Europe,71669,5600
2020-07-10,Sweden,SE,334,15,10230185,Europe,72003,5615
2020-07-11,Sweden,SE,369,14,10230185,Europe,72372,5629
2020-07-12,Sweden,SE,308,10,10230185,Europe,72680,5639
2020-07-13,Sweden,SE,106,8,10230185,Europe,72786,5647
2020-07-14,Sweden,SE,170,12,10230185,Europe,72956,5659
2020-07-15,Sweden,SE,312,8,10230185,Europe,73268,5667
2020-07-16,Sweden,SE,287,6,10230185,Europe,73555,5673
2020-07-17,Sweden,SE,268,6,10230185,Europe,73823,5679
2020-07-18,Sweden,SE,284,7,10230185,Europe,74107,5686
2020-07-19,Sweden,SE,191,11,10230185,Europe,74298,5697
2020-07-20,Sweden,SE,110,7,10230185,Europe,74408,5704
2020-07-21,Sweden,SE,131,6,10230185,Europe,74539,5710
2020-07-22,Sweden,SE,226,7,10230185,Europe,74765,5717
2020-07-23,Sweden,SE,297,6,10230185,Europe,75062,5723
2020-07-24,Sweden,SE,220,5,10230185,Europe,75282,5728
2020-07-25,Sweden,SE,262,3,10230185,Europe,75544,5731
2020-07-26,Sweden,SE,138,1,10230185,Europe,75682,5732
2020-07-27,Sweden,SE,42,2,10230185,Europe,75724,5734
2020-07-28,Sweden,SE,71,6,10230185,Europe,75795,5740
2020-07-29,Sweden,SE,283,4,10230185,Europe,76078,5744
2020-07-30,Sweden,SE,301,1,10230185,Europe,76379,5745
2020-07-31,Sweden,SE,302,0,10230185,Europe,76681,5745
2020-08-01,Sweden,SE,258,2,10230185,Europe,76939,5747
2020-08-02,Sweden,SE,303,2,10230185,Europe,77242,5749
2020-08-03,Sweden,SE,38,3,10230185,Europe,77280,5752
2020-08-04,Sweden,SE,165,4,10230185,Europe,77445,5756
2020-08-05,Sweden,SE,333,2,10230185,Europe,77778,5758
2020-08-06,Sweden,SE,425,1,10230185,Europe,78203,5759
2020-08-07,Sweden,SE,378,4,10230185,Europe,78581,5763
2020-08-08,Sweden,SE,380,2,10230185,Europe,78961,5765
2020-08-09,Sweden,SE,260,1,10230185,Europe,79221,5766
2020-08-10,Sweden,SE,73,4,10230185,Europe,79294,5770
2020-08-11,Sweden,SE,196,2,10230185,Europe,79490,5772
2020-08-12,Sweden,SE,417,4,10230185,Europe,79907,5776
2020-08-13,Sweden,SE,443,3,10230185,Europe,80350,5779
2020-08-14,Sweden,SE,363,5,10230185,Europe,80713,5784
2020-08-15,Sweden,SE,344,1,10230185,Europe,81057,5785
2020-08-16,Sweden,SE,226,1,10230185,Europe,81283,5786
2020-08-17,Sweden,SE,63,0,10230185,Europe,81346,5786
2020-08-18,Sweden,SE,174,3,10230185,Europe,81520,5789
2020-08-19,Sweden,SE,314,4,10230185,Europe,81834,5793
2020-08-20,Sweden,SE,351,1,10230185,Europe,82185,5794
2020-08-21,Sweden,SE,333,2,10230185,Europe,82518,5796
2020-08-22,Sweden,SE,298,5,10230185,Europe,82816,5801
2020-08-23,Sweden,SE,160,1,10230185,Europe,82976,5802
2020-08-24,Sweden,SE,57,3,10230185,Europe,83033,5805
2020-08-25,Sweden,SE,174,1,10230185,Europe,83207,5806
2020-08-26,Sweden,SE,222,1,10230185,Europe,83429,5807
2020-08-27,Sweden,SE,244,2,10230185,Europe,83673,5809
2020-08-28,Sweden,SE,202,1,10230185,Europe,83875,5810
2020-08-29,Sweden,SE,179,1,10230185,Europe,84054,5811
2020-08-30,Sweden,SE,131,1,10230185,Europe,84185,5812
2020-08-31,Sweden,SE,48,3,10230185,Europe,84233,5815
2020-09-01,Sweden,SE,162,2,10230185,Europe,84395,5817
2020-09-02,Sweden,SE,171,3,10230185,Europe,84566,5820
2020-09-03,Sweden,SE,213,2,10230185,Europe,84779,5822
2020-09-04,Sweden,SE,286,2,10230185,Europe,85065,5824
2020-09-05,Sweden,SE,262,0,10230185,Europe,85327,5824
2020-09-06,Sweden,SE,171,0,10230185,Europe,85498,5824
2020-09-07,Sweden,SE,67,3,10230185,Europe,85565,5827
2020-09-08,Sweden,SE,185,1,10230185,Europe,85750,5828
2020-09-09,Sweden,SE,236,1,10230185,Europe,85986,5829
2020-09-10,Sweden,SE,314,2,10230185,Europe,86300,5831
2020-09-11,Sweden,SE,254,2,10230185,Europe,86554,5833
2020-09-12,Sweden,SE,291,4,10230185,Europe,86845,5837
2020-09-13,Sweden,SE,206,1,10230185,Europe,87051,5838
2020-09-14,Sweden,SE,106,2,10230185,Europe,87157,5840
2020-09-15,Sweden,SE,220,2,10230185,Europe,87377,5842
2020-09-16,Sweden,SE,292,1,10230185,Europe,87669,5843
2020-09-17,Sweden,SE,330,2,10230185,Europe,87999,5845
2020-09-18,Sweden,SE,389,1,10230185,Europe,88388,5846
2020-09-19,Sweden,SE,437,1,10230185,Europe,88825,5847
2020-09-20,Sweden,SE,279,1,10230185,Europe,89104,5848
2020-09-21,Sweden,SE,132,4,10230185,Europe,89236,5852
2020-09-22,Sweden,SE,266,2,10230185,Europe,89502,5854
2020-09-23,Sweden,SE,438,1,10230185,Europe,89940,5855
2020-09-24,Sweden,SE,553,0,10230185,Europe,90493,5855
2020-09-25,Sweden,SE,540,1,10230185,Europe,91033,5856
2020-09-26,Sweden,SE,630,4,10230185,Europe,91663,5860
2020-09-27,Sweden,SE,325,2,10230185,Europe,91988,5862
2020-09-28,Sweden,SE,167,1,10230185,Europe,92155,5863
2020-09-29,Sweden,SE,378,1,10230185,Europe,92533,5864
2020-09-30,Sweden,SE,613,2,10230185,Europe,93146,5866
2020-10-01,Sweden,SE,689,4,10230185,Europe,93835,5870
2020-10-02,Sweden,SE,633,1,10230185,Europe,94468,5871
2020-10-03,Sweden,SE,712,3,10230185,Europe,95180,5874
2020-10-04,Sweden,SE,461,3,10230185,Europe,95641,5877
2020-10-05,Sweden,SE,156,3,10230185,Europe,95797,5880
2020-10-06,Sweden,SE,374,2,10230185,Europe,96171,5882
2020-10-07,Sweden,SE,786,4,10230185,Europe,96957,5886
2020-10-08,Sweden,SE,831,3,10230185,Europe,97788,5889
2020-10-09,Sweden,SE,834,1,10230185,Europe,98622,5890
2020-10-10,Sweden,SE,783,5,10230185,Europe,99405,5895
2020-10-11,Sweden,SE,509,5,10230185,Europe,99914,5900
2020-10-12,Sweden,SE,161,2,10230185,Europe,100075,5902
2020-10-13,Sweden,SE,637,3,10230185,Europe,100712,5905
2020-10-14,Sweden,SE,916,1,10230185,Europe,101628,5906
2020-10-15,Sweden,SE,968,2,10230185,Europe,102596,5908
2020-10-16,Sweden,SE,902,3,10230185,Europe,103498,5911
2020-10-17,Sweden,SE,1179,2,10230185,Europe,104677,5913
2020-10-18,Sweden,SE,697,4,10230185,Europe,105374,5917
2020-10-19,Sweden,SE,321,1,10230185,Europe,105695,5918
2020-10-20,Sweden,SE,771,4,10230185,Europe,106466,5922
2020-10-21,Sweden,SE,1290,4,10230185,Europe,107756,5926
2020-10-22,Sweden,SE,1570,3,10230185,Europe,109326,5929
2020-10-23,Sweden,SE,1666,9,10230185,Europe,110992,5938
2020-10-24,Sweden,SE,1868,7,10230185,Europe,112860,5945
2020-10-25,Sweden,SE,1477,8,10230185,Europe,114337,5953
2020-10-26,Sweden,SE,514,8,10230185,Europe,114851,5961
2020-10-27,Sweden,SE,1068,11,10230185,Europe,115919,5972
2020-10-28,Sweden,SE,2415,9,10230185,Europe,118334,5981
2020-10-29,Sweden,SE,3390,9,10230185,Europe,121724,5990
2020-10-30,Sweden,SE,3262,9,10230185,Europe,124986,5999
2020-10-31,Sweden,SE,4055,9,10230185,Europe,129041,6008
2020-11-01,Sweden,SE,2987,13,10230185,Europe,132028,6021
2020-11-02,Sweden,SE,1297,22,10230185,Europe,133325,6043
2020-11-03,Sweden,SE,1570,20,10230185,Europe,134895,6063
2020-11-04,Sweden,SE,3608,19,10230185,Europe,138503,6082
2020-11-05,Sweden,SE,4483,21,10230185,Europe,142986,6103
2020-11-06,Sweden,SE,4744,22,10230185,Europe,147730,6125
2020-11-07,Sweden,SE,4453,25,10230185,Europe,152183,6150
2020-11-08,Sweden,SE,4452,26,10230185,Europe,156635,6176
2020-11-09,Sweden,SE,2097,22,10230185,Europe,158732,6198
2020-11-10,Sweden,SE,3725,35,10230185,Europe,162457,6233
2020-11-11,Sweden,SE,4498,35,10230185,Europe,166955,6268
2020-11-12,Sweden,SE,5709,27,10230185,Europe,172664,6295
2020-11-13,Sweden,SE,5564,28,10230185,Europe,178228,6323
2020-11-14,Sweden,SE,6731,32,10230185,Europe,184959,6355
2020-11-15,Sweden,SE,3513,37,10230185,Europe,188472,6392
2020-11-16,Sweden,SE,1582,39,10230185,Europe,190054,6431
2020-11-17,Sweden,SE,2543,37,10230185,Europe,192597,6468
2020-11-18,Sweden,SE,4460,40,10230185,Europe,197057,6508
2020-11-19,Sweden,SE,4961,51,10230185,Europe,202018,6559
2020-11-20,Sweden,SE,7621,45,10230185,Europe,209639,6604
2020-11-21,Sweden,SE,5458,45,10230185,Europe,215097,6649
2020-11-22,Sweden,SE,4493,51,10230185,Europe,219590,6700
2020-11-23,Sweden,SE,2422,57,10230185,Europe,222012,6757
2020-11-24,Sweden,SE,3874,54,10230185,Europe,225886,6811
2020-11-25,Sweden,SE,5674,68,10230185,Europe,231560,6879
2020-11-26,Sweden,SE,6061,67,10230185,Europe,237621,6946
2020-11-27,Sweden,SE,6901,57,10230185,Europe,244522,7003
2020-11-28,Sweden,SE,6461,50,10230185,Europe,250983,7053
2020-11-29,Sweden,SE,3825,42,10230185,Europe,254808,7095
2020-11-30,Sweden,SE,2754,45,10230185,Europe,257562,7140
2020-12-01,Sweden,SE,3488,55,10230185,Europe,261050,7195
2020-12-02,Sweden,SE,5819,51,10230185,Europe,266869,7246
2020-12-03,Sweden,SE,6548,52,10230185,Europe,273417,7298
2020-12-04,Sweden,SE,6990,51,10230185,Europe,280407,7349
2020-12-05,Sweden,SE,7343,37,10230185,Europe,287750,7386
2020-12-06,Sweden,SE,4865,19,10230185,Europe,292615,7405
2020-12-07,Sweden,SE,1803,44,10230185,Europe,294418,7449
2020-12-08,Sweden,SE,3778,19,10230185,Europe,298196,7468
2020-12-09,Sweden,SE,7449,24,10230185,Europe,305645,7492
2020-12-10,Sweden,SE,8402,15,10230185,Europe,314047,7507
2020-12-11,Sweden,SE,6051,7,10230185,Europe,320098,7514
2020-12-12,Sweden,SE,0,0,10230185,Europe,320098,7514
2020-12-13,Sweden,SE,0,0,10230185,Europe,320098,7514
2020-12-14,Sweden,SE,0,0,10230185,Europe,320098,7514
2019-12-31,Singapore,SG,0,0,5804343,Asia,0,0
2020-01-01,Singapore,SG,0,0,5804343,Asia,0,0
2020-01-02,Singapore,SG,0,0,5804343,Asia,0,0
2020-01-03,Singapore,SG,0,0,5804343,Asia,0,0
2020-01-04,Singapore,SG,0,0,5804343,Asia,0,0
2020-01-05,Singapore,SG,0,0,5804343,Asia,0,0
2020-01-06,Singapore,SG,0,0,5804343,Asia,0,0
2020-01-07,Singapore,SG,0,0,5804343,Asia,0,0
2020-01-08,Singapore,SG,0,0,5804343,Asia,0,0
2020-01-09,Singapore,SG,0,0,5804343,Asia,0,0
2020-01-10,Singapore,SG,0,0,5804343,Asia,0,0
2020-01-11,Singapore,SG,0,0,5804343,Asia,0,0
2020-01-12,Singapore,SG,0,0,5804343,Asia,0,0
2020-01-13,Singapore,SG,0,0,5804343,Asia,0,0
2020-01-14,Singapore,SG,0,0,5804343,Asia,0,0
2020-01-15,Singapore,SG,0,0,5804343,Asia,0,0
2020-01-16,Singapore,SG,0,0,5804343,Asia,0,0
2020-01-17,Singapore,SG,0,0,5804343,Asia,0,0
2020-01-18,Singapore,SG,0,0,5804343,Asia,0,0
2020-01-19,Singapore,SG,0,0,5804343,Asia,0,0
2020-01-20,Singapore,SG,0,0,5804343,Asia,0,0
2020-01-21,Singapore,SG,0,0,5804343,Asia,0,0
2020-01-22,Singapore,SG,0,0,5804343,Asia,0,0
2020-01-23,Singapore,SG,0,0,5804343,Asia,0,0
2020-01-24,Singapore,SG,3,0,5804343,Asia,3,0
2020-01-25,Singapore,SG,0,0,5804343,Asia,3,0
2020-01-26,Singapore,SG,1,0,5804343,Asia,4,0
2020-01-27,Singapore,SG,0,0,5804343,Asia,4,0
2020-01-28,Singapore,SG,1,0,5804343,Asia,5,0
2020-01-29,Singapore,SG,2,0,5804343,Asia,7,0
2020-01-30,Singapore,SG,3,0,5804343,Asia,10,0
2020-01-31,Singapore,SG,3,0,5804343,Asia,13,0
2020-02-01,Singapore,SG,3,0,5804343,Asia,16,0
2020-02-02,Singapore,SG,2,0,5804343,Asia,18,0
2020-02-03,Singapore,SG,0,0,5804343,Asia,18,0
2020-02-04,Singapore,SG,0,0,5804343,Asia,18,0
2020-02-05,Singapore,SG,6,0,5804343,Asia,24,0
2020-02-06,Singapore,SG,4,0,5804343,Asia,28,0
2020-02-07,Singapore,SG,2,0,5804343,Asia,30,0
2020-02-08,Singapore,SG,3,0,5804343,Asia,33,0
2020-02-09,Singapore,SG,7,0,5804343,Asia,40,0
2020-02-10,Singapore,SG,3,0,5804343,Asia,43,0
2020-02-11,Singapore,SG,2,0,5804343,Asia,45,0
2020-02-12,Singapore,SG,2,0,5804343,Asia,47,0
2020-02-13,Singapore,SG,3,0,5804343,Asia,50,0
2020-02-14,Singapore,SG,8,0,5804343,Asia,58,0
2020-02-15,Singapore,SG,9,0,5804343,Asia,67,0
2020-02-16,Singapore,SG,5,0,5804343,Asia,72,0
2020-02-17,Singapore,SG,3,0,5804343,Asia,75,0
2020-02-18,Singapore,SG,2,0,5804343,Asia,77,0
2020-02-19,Singapore,SG,4,0,5804343,Asia,81,0
2020-02-20,Singapore,SG,3,0,5804343,Asia,84,0
2020-02-21,Singapore,SG,1,0,5804343,Asia,85,0
2020-02-22,Singapore,SG,1,0,5804343,Asia,86,0
2020-02-23,Singapore,SG,3,0,5804343,Asia,89,0
2020-02-24,Singapore,SG,0,0,5804343,Asia,89,0
2020-02-25,Singapore,SG,1,0,5804343,Asia,90,0
2020-02-26,Singapore,SG,1,0,5804343,Asia,91,0
2020-02-27,Singapore,SG,2,0,5804343,Asia,93,0
2020-02-28,Singapore,SG,3,0,5804343,Asia,96,0
2020-02-29,Singapore,SG,2,0,5804343,Asia,98,0
2020-03-01,Singapore,SG,4,0,5804343,Asia,102,0
2020-03-02,Singapore,SG,4,0,5804343,Asia,106,0
2020-03-03,Singapore,SG,2,0,5804343,Asia,108,0
2020-03-04,Singapore,SG,2,0,5804343,Asia,110,0
2020-03-05,Singapore,SG,2,0,5804343,Asia,112,0
2020-03-06,Singapore,SG,5,0,5804343,Asia,117,0
2020-03-07,Singapore,SG,13,0,5804343,Asia,130,0
2020-03-08,Singapore,SG,8,0,5804343,Asia,138,0
2020-03-09,Singapore,SG,12,0,5804343,Asia,150,0
2020-03-10,Singapore,SG,10,0,5804343,Asia,160,0
2020-03-11,Singapore,SG,6,0,5804343,Asia,166,0
2020-03-12,Singapore,SG,12,0,5804343,Asia,178,0
2020-03-13,Singapore,SG,9,0,5804343,Asia,187,0
2020-03-14,Singapore,SG,13,0,5804343,Asia,200,0
2020-03-15,Singapore,SG,14,0,5804343,Asia,214,0
2020-03-16,Singapore,SG,12,0,5804343,Asia,226,0
2020-03-17,Singapore,SG,17,0,5804343,Asia,243,0
2020-03-18,Singapore,SG,23,0,5804343,Asia,266,0
2020-03-19,Singapore,SG,47,0,5804343,Asia,313,0
2020-03-20,Singapore,SG,32,0,5804343,Asia,345,0
2020-03-21,Singapore,SG,40,0,5804343,Asia,385,0
2020-03-22,Singapore,SG,47,2,5804343,Asia,432,2
2020-03-23,Singapore,SG,23,0,5804343,Asia,455,2
2020-03-24,Singapore,SG,54,0,5804343,Asia,509,2
2020-03-25,Singapore,SG,49,0,5804343,Asia,558,2
2020-03-26,Singapore,SG,10,0,5804343,Asia,568,2
2020-03-27,Singapore,SG,26,0,5804343,Asia,594,2
2020-03-28,Singapore,SG,138,0,5804343,Asia,732,2
2020-03-29,Singapore,SG,71,1,5804343,Asia,803,3
2020-03-30,Singapore,SG,41,0,5804343,Asia,844,3
2020-03-31,Singapore,SG,0,0,5804343,Asia,844,3
2020-04-01,Singapore,SG,35,0,5804343,Asia,879,3
2020-04-02,Singapore,SG,121,1,5804343,Asia,1000,4
2020-04-03,Singapore,SG,49,1,5804343,Asia,1049,5
2020-04-04,Singapore,SG,65,0,5804343,Asia,1114,5
2020-04-05,Singapore,SG,75,1,5804343,Asia,1189,6
2020-04-06,Singapore,SG,120,0,5804343,Asia,1309,6
2020-04-07,Singapore,SG,66,0,5804343,Asia,1375,6
2020-04-08,Singapore,SG,106,0,5804343,Asia,1481,6
2020-04-09,Singapore,SG,142,0,5804343,Asia,1623,6
2020-04-10,Singapore,SG,286,0,5804343,Asia,1909,6
2020-04-11,Singapore,SG,0,0,5804343,Asia,1909,6
2020-04-12,Singapore,SG,390,2,5804343,Asia,2299,8
2020-04-13,Singapore,SG,233,0,5804343,Asia,2532,8
2020-04-14,Singapore,SG,386,1,5804343,Asia,2918,9
2020-04-15,Singapore,SG,334,1,5804343,Asia,3252,10
2020-04-16,Singapore,SG,447,0,5804343,Asia,3699,10
2020-04-17,Singapore,SG,728,0,5804343,Asia,4427,10
2020-04-18,Singapore,SG,623,1,5804343,Asia,5050,11
2020-04-19,Singapore,SG,942,0,5804343,Asia,5992,11
2020-04-20,Singapore,SG,596,0,5804343,Asia,6588,11
2020-04-21,Singapore,SG,1426,0,5804343,Asia,8014,11
2020-04-22,Singapore,SG,1111,0,5804343,Asia,9125,11
2020-04-23,Singapore,SG,1016,1,5804343,Asia,10141,12
2020-04-24,Singapore,SG,1037,0,5804343,Asia,11178,12
2020-04-25,Singapore,SG,897,0,5804343,Asia,12075,12
2020-04-26,Singapore,SG,618,0,5804343,Asia,12693,12
2020-04-27,Singapore,SG,931,0,5804343,Asia,13624,12
2020-04-28,Singapore,SG,799,2,5804343,Asia,14423,14
2020-04-29,Singapore,SG,528,0,5804343,Asia,14951,14
2020-04-30,Singapore,SG,690,0,5804343,Asia,15641,14
2020-05-01,Singapore,SG,528,1,5804343,Asia,16169,15
2020-05-02,Singapore,SG,932,1,5804343,Asia,17101,16
2020-05-03,Singapore,SG,447,1,5804343,Asia,17548,17
2020-05-04,Singapore,SG,657,1,5804343,Asia,18205,18
2020-05-05,Singapore,SG,573,0,5804343,Asia,18778,18
2020-05-06,Singapore,SG,632,0,5804343,Asia,19410,18
2020-05-07,Singapore,SG,788,2,5804343,Asia,20198,20
2020-05-08,Singapore,SG,741,0,5804343,Asia,20939,20
2020-05-09,Singapore,SG,768,0,5804343,Asia,21707,20
2020-05-10,Singapore,SG,753,0,5804343,Asia,22460,20
2020-05-11,Singapore,SG,876,0,5804343,Asia,23336,20
2020-05-12,Singapore,SG,451,1,5804343,Asia,23787,21
2020-05-13,Singapore,SG,884,0,5804343,Asia,24671,21
2020-05-14,Singapore,SG,675,0,5804343,Asia,25346,21
2020-05-15,Singapore,SG,752,0,5804343,Asia,26098,21
2020-05-16,Singapore,SG,793,0,5804343,Asia,26891,21
2020-05-17,Singapore,SG,465,1,5804343,Asia,27356,22
2020-05-18,Singapore,SG,682,0,5804343,Asia,28038,22
2020-05-19,Singapore,SG,305,0,5804343,Asia,28343,22
2020-05-20,Singapore,SG,451,0,5804343,Asia,28794,22
2020-05-21,Singapore,SG,570,0,5804343,Asia,29364,22
2020-05-22,Singapore,SG,448,1,5804343,Asia,29812,23
2020-05-23,Singapore,SG,614,0,5804343,Asia,30426,23
2020-05-24,Singapore,SG,642,0,5804343,Asia,31068,23
2020-05-25,Singapore,SG,548,0,5804343,Asia,31616,23
2020-05-26,Singapore,SG,344,0,5804343,Asia,31960,23
2020-05-27,Singapore,SG,383,0,5804343,Asia,32343,23
2020-05-28,Singapore,SG,533,0,5804343,Asia,32876,23
2020-05-29,Singapore,SG,373,0,5804343,Asia,33249,23
2020-05-30,Singapore,SG,611,0,5804343,Asia,33860,23
2020-05-31,Singapore,SG,506,0,5804343,Asia,34366,23
2020-06-01,Singapore,SG,518,0,5804343,Asia,34884,23
2020-06-02,Singapore,SG,408,1,5804343,Asia,35292,24
2020-06-03,Singapore,SG,544,0,5804343,Asia,35836,24
2020-06-04,Singapore,SG,569,0,5804343,Asia,36405,24
2020-06-05,Singapore,SG,517,0,5804343,Asia,36922,24
2020-06-06,Singapore,SG,261,0,5804343,Asia,37183,24
2020-06-07,Singapore,SG,344,1,5804343,Asia,37527,25
2020-06-08,Singapore,SG,383,0,5804343,Asia,37910,25
2020-06-09,Singapore,SG,386,0,5804343,Asia,38296,25
2020-06-10,Singapore,SG,218,0,5804343,Asia,38514,25
2020-06-11,Singapore,SG,451,0,5804343,Asia,38965,25
2020-06-12,Singapore,SG,422,0,5804343,Asia,39387,25
2020-06-13,Singapore,SG,463,0,5804343,Asia,39850,25
2020-06-14,Singapore,SG,347,1,5804343,Asia,40197,26
2020-06-15,Singapore,SG,407,0,5804343,Asia,40604,26
2020-06-16,Singapore,SG,214,0,5804343,Asia,40818,26
2020-06-17,Singapore,SG,151,0,5804343,Asia,40969,26
2020-06-18,Singapore,SG,247,0,5804343,Asia,41216,26
2020-06-19,Singapore,SG,257,0,5804343,Asia,41473,26
2020-06-20,Singapore,SG,142,0,5804343,Asia,41615,26
2020-06-21,Singapore,SG,218,0,5804343,Asia,41833,26
2020-06-22,Singapore,SG,262,0,5804343,Asia,42095,26
2020-06-23,Singapore,SG,218,0,5804343,Asia,42313,26
2020-06-24,Singapore,SG,119,0,5804343,Asia,42432,26
2020-06-25,Singapore,SG,191,0,5804343,Asia,42623,26
2020-06-26,Singapore,SG,113,0,5804343,Asia,42736,26
2020-06-27,Singapore,SG,219,0,5804343,Asia,42955,26
2020-06-28,Singapore,SG,291,0,5804343,Asia,43246,26
2020-06-29,Singapore,SG,213,0,5804343,Asia,43459,26
2020-06-30,Singapore,SG,202,0,5804343,Asia,43661,26
2020-07-01,Singapore,SG,246,0,5804343,Asia,43907,26
2020-07-02,Singapore,SG,215,0,5804343,Asia,44122,26
2020-07-03,Singapore,SG,188,0,5804343,Asia,44310,26
2020-07-04,Singapore,SG,169,0,5804343,Asia,44479,26
2020-07-05,Singapore,SG,185,0,5804343,Asia,44664,26
2020-07-06,Singapore,SG,0,0,5804343,Asia,44664,26
2020-07-07,Singapore,SG,319,0,5804343,Asia,44983,26
2020-07-08,Singapore,SG,157,0,5804343,Asia,45140,26
2020-07-09,Singapore,SG,158,0,5804343,Asia,45298,26
2020-07-10,Singapore,SG,124,0,5804343,Asia,45422,26
2020-07-11,Singapore,SG,191,0,5804343,Asia,45613,26
2020-07-12,Singapore,SG,170,0,5804343,Asia,45783,26
2020-07-13,Singapore,SG,178,0,5804343,Asia,45961,26
2020-07-14,Singapore,SG,322,0,5804343,Asia,46283,26
2020-07-15,Singapore,SG,346,1,5804343,Asia,46629,27
2020-07-16,Singapore,SG,249,0,5804343,Asia,46878,27
2020-07-17,Singapore,SG,248,0,5804343,Asia,47126,27
2020-07-18,Singapore,SG,327,0,5804343,Asia,47453,27
2020-07-19,Singapore,SG,202,0,5804343,Asia,47655,27
2020-07-20,Singapore,SG,257,0,5804343,Asia,47912,27
2020-07-21,Singapore,SG,123,0,5804343,Asia,48035,27
2020-07-22,Singapore,SG,399,0,5804343,Asia,48434,27
2020-07-23,Singapore,SG,310,0,5804343,Asia,48744,27
2020-07-24,Singapore,SG,354,0,5804343,Asia,49098,27
2020-07-25,Singapore,SG,277,0,5804343,Asia,49375,27
2020-07-26,Singapore,SG,513,0,5804343,Asia,49888,27
2020-07-27,Singapore,SG,481,0,5804343,Asia,50369,27
2020-07-28,Singapore,SG,469,0,5804343,Asia,50838,27
2020-07-29,Singapore,SG,359,0,5804343,Asia,51197,27
2020-07-30,Singapore,SG,334,0,5804343,Asia,51531,27
2020-07-31,Singapore,SG,278,0,5804343,Asia,51809,27
2020-08-01,Singapore,SG,396,0,5804343,Asia,52205,27
2020-08-02,Singapore,SG,307,0,5804343,Asia,52512,27
2020-08-03,Singapore,SG,313,0,5804343,Asia,52825,27
2020-08-04,Singapore,SG,226,0,5804343,Asia,53051,27
2020-08-05,Singapore,SG,295,0,5804343,Asia,53346,27
2020-08-06,Singapore,SG,908,0,5804343,Asia,54254,27
2020-08-07,Singapore,SG,301,0,5804343,Asia,54555,27
2020-08-08,Singapore,SG,242,0,5804343,Asia,54797,27
2020-08-09,Singapore,SG,132,0,5804343,Asia,54929,27
2020-08-10,Singapore,SG,175,0,5804343,Asia,55104,27
2020-08-11,Singapore,SG,188,0,5804343,Asia,55292,27
2020-08-12,Singapore,SG,61,0,5804343,Asia,55353,27
2020-08-13,Singapore,SG,42,0,5804343,Asia,55395,27
2020-08-14,Singapore,SG,102,0,5804343,Asia,55497,27
2020-08-15,Singapore,SG,83,0,5804343,Asia,55580,27
2020-08-16,Singapore,SG,81,0,5804343,Asia,55661,27
2020-08-17,Singapore,SG,86,0,5804343,Asia,55747,27
2020-08-18,Singapore,SG,91,0,5804343,Asia,55838,27
2020-08-19,Singapore,SG,100,0,5804343,Asia,55938,27
2020-08-20,Singapore,SG,93,0,5804343,Asia,56031,27
2020-08-21,Singapore,SG,68,0,5804343,Asia,56099,27
2020-08-22,Singapore,SG,117,0,5804343,Asia,56216,27
2020-08-23,Singapore,SG,50,0,5804343,Asia,56266,27
2020-08-24,Singapore,SG,87,0,5804343,Asia,56353,27
2020-08-25,Singapore,SG,51,0,5804343,Asia,56404,27
2020-08-26,Singapore,SG,31,0,5804343,Asia,56435,27
2020-08-27,Singapore,SG,60,0,5804343,Asia,56495,27
2020-08-28,Singapore,SG,77,0,5804343,Asia,56572,27
2020-08-29,Singapore,SG,94,0,5804343,Asia,56666,27
2020-08-30,Singapore,SG,51,0,5804343,Asia,56717,27
2020-08-31,Singapore,SG,54,0,5804343,Asia,56771,27
2020-09-01,Singapore,SG,41,0,5804343,Asia,56812,27
2020-09-02,Singapore,SG,40,0,5804343,Asia,56852,27
2020-09-03,Singapore,SG,8,0,5804343,Asia,56860,27
2020-09-04,Singapore,SG,48,0,5804343,Asia,56908,27
2020-09-05,Singapore,SG,0,0,5804343,Asia,56908,27
2020-09-06,Singapore,SG,74,0,5804343,Asia,56982,27
2020-09-07,Singapore,SG,40,0,5804343,Asia,57022,27
2020-09-08,Singapore,SG,22,0,5804343,Asia,57044,27
2020-09-09,Singapore,SG,47,0,5804343,Asia,57091,27
2020-09-10,Singapore,SG,75,0,5804343,Asia,57166,27
2020-09-11,Singapore,SG,63,0,5804343,Asia,57229,27
2020-09-12,Singapore,SG,86,0,5804343,Asia,57315,27
2020-09-13,Singapore,SG,42,0,5804343,Asia,57357,27
2020-09-14,Singapore,SG,49,0,5804343,Asia,57406,27
2020-09-15,Singapore,SG,48,0,5804343,Asia,57454,27
2020-09-16,Singapore,SG,34,0,5804343,Asia,57488,27
2020-09-17,Singapore,SG,26,0,5804343,Asia,57514,27
2020-09-18,Singapore,SG,18,0,5804343,Asia,57532,27
2020-09-19,Singapore,SG,11,0,5804343,Asia,57543,27
2020-09-20,Singapore,SG,15,0,5804343,Asia,57558,27
2020-09-21,Singapore,SG,18,0,5804343,Asia,57576,27
2020-09-22,Singapore,SG,30,0,5804343,Asia,57606,27
2020-09-23,Singapore,SG,21,0,5804343,Asia,57627,27
2020-09-24,Singapore,SG,12,0,5804343,Asia,57639,27
2020-09-25,Singapore,SG,15,0,5804343,Asia,57654,27
2020-09-26,Singapore,SG,11,0,5804343,Asia,57665,27
2020-09-27,Singapore,SG,20,0,5804343,Asia,57685,27
2020-09-28,Singapore,SG,15,0,5804343,Asia,57700,27
2020-09-29,Singapore,SG,15,0,5804343,Asia,57715,27
2020-09-30,Singapore,SG,27,0,5804343,Asia,57742,27
2020-10-01,Singapore,SG,0,0,5804343,Asia,57742,27
2020-10-02,Singapore,SG,42,0,5804343,Asia,57784,27
2020-10-03,Singapore,SG,10,0,5804343,Asia,57794,27
2020-10-04,Singapore,SG,6,0,5804343,Asia,57800,27
2020-10-05,Singapore,SG,12,0,5804343,Asia,57812,27
2020-10-06,Singapore,SG,7,0,5804343,Asia,57819,27
2020-10-07,Singapore,SG,11,0,5804343,Asia,57830,27
2020-10-08,Singapore,SG,10,0,5804343,Asia,57840,27
2020-10-09,Singapore,SG,9,0,5804343,Asia,57849,27
2020-10-10,Singapore,SG,10,0,5804343,Asia,57859,27
2020-10-11,Singapore,SG,7,0,5804343,Asia,57866,27
2020-10-12,Singapore,SG,10,0,5804343,Asia,57876,27
2020-10-13,Singapore,SG,4,1,5804343,Asia,57880,28
2020-10-14,Singapore,SG,4,0,5804343,Asia,57884,28
2020-10-15,Singapore,SG,5,0,5804343,Asia,57889,28
2020-10-16,Singapore,SG,3,0,5804343,Asia,57892,28
2020-10-17,Singapore,SG,9,0,5804343,Asia,57901,28
2020-10-18,Singapore,SG,3,0,5804343,Asia,57904,28
2020-10-19,Singapore,SG,7,0,5804343,Asia,57911,28
2020-10-20,Singapore,SG,4,0,5804343,Asia,57915,28
2020-10-21,Singapore,SG,6,0,5804343,Asia,57921,28
2020-10-22,Singapore,SG,12,0,5804343,Asia,57933,28
2020-10-23,Singapore,SG,8,0,5804343,Asia,57941,28
2020-10-24,Singapore,SG,10,0,5804343,Asia,57951,28
2020-10-25,Singapore,SG,14,0,5804343,Asia,57965,28
2020-10-26,Singapore,SG,5,0,5804343,Asia,57970,28
2020-10-27,Singapore,SG,3,0,5804343,Asia,57973,28
2020-10-28,Singapore,SG,7,0,5804343,Asia,57980,28
2020-10-29,Singapore,SG,7,0,5804343,Asia,57987,28
2020-10-30,Singapore,SG,7,0,5804343,Asia,57994,28
2020-10-31,Singapore,SG,9,0,5804343,Asia,58003,28
2020-11-01,Singapore,SG,12,0,5804343,Asia,58015,28
2020-11-02,Singapore,SG,4,0,5804343,Asia,58019,28
2020-11-03,Singapore,SG,1,0,5804343,Asia,58020,28
2020-11-04,Singapore,SG,9,0,5804343,Asia,58029,28
2020-11-05,Singapore,SG,7,0,5804343,Asia,58036,28
2020-11-06,Singapore,SG,7,0,5804343,Asia,58043,28
2020-11-07,Singapore,SG,4,0,5804343,Asia,58047,28
2020-11-08,Singapore,SG,7,0,5804343,Asia,58054,28
2020-11-09,Singapore,SG,2,0,5804343,Asia,58056,28
2020-11-10,Singapore,SG,8,0,5804343,Asia,58064,28
2020-11-11,Singapore,SG,9,0,5804343,Asia,58073,28
2020-11-12,Singapore,SG,18,0,5804343,Asia,58091,28
2020-11-13,Singapore,SG,11,0,5804343,Asia,58102,28
2020-11-14,Singapore,SG,12,0,5804343,Asia,58114,28
2020-11-15,Singapore,SG,2,0,5804343,Asia,58116,28
2020-11-16,Singapore,SG,3,0,5804343,Asia,58119,28
2020-11-17,Singapore,SG,5,0,5804343,Asia,58124,28
2020-11-18,Singapore,SG,6,0,5804343,Asia,58130,28
2020-11-19,Singapore,SG,5,0,5804343,Asia,58135,28
2020-11-20,Singapore,SG,4,0,5804343,Asia,58139,28
2020-11-21,Singapore,SG,4,0,5804343,Asia,58143,28
2020-11-22,Singapore,SG,5,0,5804343,Asia,58148,28
2020-11-23,Singapore,SG,12,0,5804343,Asia,58160,28
2020-11-24,Singapore,SG,5,0,5804343,Asia,58165,28
2020-11-25,Singapore,SG,18,0,5804343,Asia,58183,28
2020-11-26,Singapore,SG,7,0,5804343,Asia,58190,28
2020-11-27,Singapore,SG,5,0,5804343,Asia,58195,28
2020-11-28,Singapore,SG,4,0,5804343,Asia,58199,28
2020-11-29,Singapore,SG,6,1,5804343,Asia,58205,29
2020-11-30,Singapore,SG,8,0,5804343,Asia,58213,29
2020-12-01,Singapore,SG,5,0,5804343,Asia,58218,29
2020-12-02,Singapore,SG,10,0,5804343,Asia,58228,29
2020-12-03,Singapore,SG,2,0,5804343,Asia,58230,29
2020-12-04,Singapore,SG,9,0,5804343,Asia,58239,29
2020-12-05,Singapore,SG,3,0,5804343,Asia,58242,29
2020-12-06,Singapore,SG,13,0,5804343,Asia,58255,29
2020-12-07,Singapore,SG,5,0,5804343,Asia,58260,29
2020-12-08,Singapore,SG,13,0,5804343,Asia,58273,29
2020-12-09,Singapore,SG,12,0,5804343,Asia,58285,29
2020-12-10,Singapore,SG,6,0,5804343,Asia,58291,29
2020-12-11,Singapore,SG,6,0,5804343,Asia,58297,29
2020-12-12,Singapore,SG,8,0,5804343,Asia,58305,29
2020-12-13,Singapore,SG,8,0,5804343,Asia,58313,29
2020-12-14,Singapore,SG,7,0,5804343,Asia,58320,29
2020-03-05,Slovenia,SI,1,0,2080908,Europe,1,0
2020-03-06,Slovenia,SI,5,0,2080908,Europe,6,0
2020-03-07,Slovenia,SI,3,0,2080908,Europe,9,0
2020-03-08,Slovenia,SI,3,0,2080908,Europe,12,0
2020-03-09,Slovenia,SI,4,0,2080908,Europe,16,0
2020-03-11,Slovenia,SI,15,0,2080908,Europe,31,0
2020-03-12,Slovenia,SI,26,0,2080908,Europe,57,0
2020-03-13,Slovenia,SI,39,0,2080908,Europe,96,0
2020-03-14,Slovenia,SI,45,0,2080908,Europe,141,0
2020-03-15,Slovenia,SI,40,0,2080908,Europe,181,0
2020-03-16,Slovenia,SI,38,0,2080908,Europe,219,0
2020-03-17,Slovenia,SI,34,0,2080908,Europe,253,0
2020-03-18,Slovenia,SI,22,1,2080908,Europe,275,1
2020-03-19,Slovenia,SI,11,0,2080908,Europe,286,1
2020-03-20,Slovenia,SI,33,0,2080908,Europe,319,1
2020-03-21,Slovenia,SI,22,0,2080908,Europe,341,1
2020-03-22,Slovenia,SI,42,0,2080908,Europe,383,1
2020-03-23,Slovenia,SI,31,0,2080908,Europe,414,1
2020-03-24,Slovenia,SI,28,0,2080908,Europe,442,1
2020-03-25,Slovenia,SI,38,2,2080908,Europe,480,3
2020-03-26,Slovenia,SI,48,1,2080908,Europe,528,4
2020-03-27,Slovenia,SI,49,1,2080908,Europe,577,5
2020-03-28,Slovenia,SI,55,4,2080908,Europe,632,9
2020-03-29,Slovenia,SI,59,0,2080908,Europe,691,9
2020-03-30,Slovenia,SI,39,2,2080908,Europe,730,11
2020-03-31,Slovenia,SI,33,0,2080908,Europe,763,11
2020-04-01,Slovenia,SI,51,2,2080908,Europe,814,13
2020-04-02,Slovenia,SI,27,2,2080908,Europe,841,15
2020-04-03,Slovenia,SI,56,1,2080908,Europe,897,16
2020-04-04,Slovenia,SI,37,4,2080908,Europe,934,20
2020-04-05,Slovenia,SI,43,2,2080908,Europe,977,22
2020-04-06,Slovenia,SI,20,6,2080908,Europe,997,28
2020-04-07,Slovenia,SI,24,2,2080908,Europe,1021,30
2020-04-08,Slovenia,SI,34,6,2080908,Europe,1055,36
2020-04-09,Slovenia,SI,36,4,2080908,Europe,1091,40
2020-04-10,Slovenia,SI,33,3,2080908,Europe,1124,43
2020-04-11,Slovenia,SI,36,2,2080908,Europe,1160,45
2020-04-12,Slovenia,SI,28,5,2080908,Europe,1188,50
2020-04-13,Slovenia,SI,17,3,2080908,Europe,1205,53
2020-04-14,Slovenia,SI,7,2,2080908,Europe,1212,55
2020-04-15,Slovenia,SI,8,1,2080908,Europe,1220,56
2020-04-16,Slovenia,SI,28,5,2080908,Europe,1248,61
2020-04-17,Slovenia,SI,20,0,2080908,Europe,1268,61
2020-04-18,Slovenia,SI,36,5,2080908,Europe,1304,66
2020-04-19,Slovenia,SI,13,4,2080908,Europe,1317,70
2020-04-20,Slovenia,SI,13,4,2080908,Europe,1330,74
2020-04-21,Slovenia,SI,5,0,2080908,Europe,1335,74
2020-04-22,Slovenia,SI,5,3,2080908,Europe,1340,77
2020-04-23,Slovenia,SI,13,2,2080908,Europe,1353,79
2020-04-24,Slovenia,SI,13,0,2080908,Europe,1366,79
2020-04-25,Slovenia,SI,7,1,2080908,Europe,1373,80
2020-04-26,Slovenia,SI,15,1,2080908,Europe,1388,81
2020-04-27,Slovenia,SI,19,1,2080908,Europe,1407,82
2020-04-28,Slovenia,SI,0,1,2080908,Europe,1407,83
2020-04-29,Slovenia,SI,1,3,2080908,Europe,1408,86
2020-04-30,Slovenia,SI,10,3,2080908,Europe,1418,89
2020-05-01,Slovenia,SI,11,2,2080908,Europe,1429,91
2020-05-02,Slovenia,SI,5,2,2080908,Europe,1434,93
2020-05-03,Slovenia,SI,5,1,2080908,Europe,1439,94
2020-05-04,Slovenia,SI,0,2,2080908,Europe,1439,96
2020-05-05,Slovenia,SI,6,1,2080908,Europe,1445,97
2020-05-06,Slovenia,SI,3,1,2080908,Europe,1448,98
2020-05-07,Slovenia,SI,1,1,2080908,Europe,1449,99
2020-05-08,Slovenia,SI,1,0,2080908,Europe,1450,99
2020-05-09,Slovenia,SI,4,1,2080908,Europe,1454,100
2020-05-10,Slovenia,SI,3,1,2080908,Europe,1457,101
2020-05-11,Slovenia,SI,3,1,2080908,Europe,1460,102
2020-05-12,Slovenia,SI,1,0,2080908,Europe,1461,102
2020-05-13,Slovenia,SI,2,0,2080908,Europe,1463,102
2020-05-14,Slovenia,SI,1,1,2080908,Europe,1464,103
2020-05-15,Slovenia,SI,1,0,2080908,Europe,1465,103
2020-05-16,Slovenia,SI,0,0,2080908,Europe,1465,103
2020-05-17,Slovenia,SI,1,0,2080908,Europe,1466,103
2020-05-18,Slovenia,SI,0,1,2080908,Europe,1466,104
2020-05-19,Slovenia,SI,1,0,2080908,Europe,1467,104
2020-05-20,Slovenia,SI,1,0,2080908,Europe,1468,104
2020-05-21,Slovenia,SI,0,2,2080908,Europe,1468,106
2020-05-22,Slovenia,SI,0,0,2080908,Europe,1468,106
2020-05-23,Slovenia,SI,0,0,2080908,Europe,1468,106
2020-05-24,Slovenia,SI,0,0,2080908,Europe,1468,106
2020-05-25,Slovenia,SI,1,0,2080908,Europe,1469,106
2020-05-26,Slovenia,SI,0,0,2080908,Europe,1469,106
2020-05-27,Slovenia,SI,0,0,2080908,Europe,1469,106
2020-05-28,Slovenia,SI,2,1,2080908,Europe,1471,107
2020-05-29,Slovenia,SI,2,1,2080908,Europe,1473,108
2020-05-30,Slovenia,SI,0,0,2080908,Europe,1473,108
2020-05-31,Slovenia,SI,0,0,2080908,Europe,1473,108
2020-06-01,Slovenia,SI,0,0,2080908,Europe,1473,108
2020-06-02,Slovenia,SI,2,0,2080908,Europe,1475,108
2020-06-03,Slovenia,SI,0,0,2080908,Europe,1475,108
2020-06-04,Slovenia,SI,2,0,2080908,Europe,1477,108
2020-06-05,Slovenia,SI,2,0,2080908,Europe,1479,108
2020-06-06,Slovenia,SI,5,0,2080908,Europe,1484,108
2020-06-07,Slovenia,SI,1,0,2080908,Europe,1485,108
2020-06-08,Slovenia,SI,0,0,2080908,Europe,1485,108
2020-06-09,Slovenia,SI,0,0,2080908,Europe,1485,108
2020-06-10,Slovenia,SI,1,0,2080908,Europe,1486,108
2020-06-11,Slovenia,SI,2,1,2080908,Europe,1488,109
2020-06-12,Slovenia,SI,0,0,2080908,Europe,1488,109
2020-06-13,Slovenia,SI,2,0,2080908,Europe,1490,109
2020-06-14,Slovenia,SI,2,0,2080908,Europe,1492,109
2020-06-15,Slovenia,SI,3,0,2080908,Europe,1495,109
2020-06-16,Slovenia,SI,1,0,2080908,Europe,1496,109
2020-06-17,Slovenia,SI,3,0,2080908,Europe,1499,109
2020-06-18,Slovenia,SI,4,0,2080908,Europe,1503,109
2020-06-19,Slovenia,SI,8,0,2080908,Europe,1511,109
2020-06-20,Slovenia,SI,2,0,2080908,Europe,1513,109
2020-06-21,Slovenia,SI,6,0,2080908,Europe,1519,109
2020-06-22,Slovenia,SI,1,0,2080908,Europe,1520,109
2020-06-23,Slovenia,SI,1,0,2080908,Europe,1521,109
2020-06-24,Slovenia,SI,13,2,2080908,Europe,1534,111
2020-06-25,Slovenia,SI,7,0,2080908,Europe,1541,111
2020-06-26,Slovenia,SI,6,0,2080908,Europe,1547,111
2020-06-27,Slovenia,SI,11,0,2080908,Europe,1558,111
2020-06-28,Slovenia,SI,14,0,2080908,Europe,1572,111
2020-06-29,Slovenia,SI,9,0,2080908,Europe,1581,111
2020-06-30,Slovenia,SI,4,0,2080908,Europe,1585,111
2020-07-01,Slovenia,SI,15,0,2080908,Europe,1600,111
2020-07-02,Slovenia,SI,13,0,2080908,Europe,1613,111
2020-07-03,Slovenia,SI,20,0,2080908,Europe,1633,111
2020-07-04,Slovenia,SI,16,0,2080908,Europe,1649,111
2020-07-05,Slovenia,SI,30,0,2080908,Europe,1679,111
2020-07-06,Slovenia,SI,21,0,2080908,Europe,1700,111
2020-07-07,Slovenia,SI,16,0,2080908,Europe,1716,111
2020-07-08,Slovenia,SI,23,0,2080908,Europe,1739,111
2020-07-09,Slovenia,SI,24,0,2080908,Europe,1763,111
2020-07-10,Slovenia,SI,13,0,2080908,Europe,1776,111
2020-07-11,Slovenia,SI,17,0,2080908,Europe,1793,111
2020-07-12,Slovenia,SI,34,0,2080908,Europe,1827,111
2020-07-13,Slovenia,SI,14,0,2080908,Europe,1841,111
2020-07-14,Slovenia,SI,8,0,2080908,Europe,1849,111
2020-07-15,Slovenia,SI,10,0,2080908,Europe,1859,111
2020-07-16,Slovenia,SI,19,0,2080908,Europe,1878,111
2020-07-17,Slovenia,SI,19,0,2080908,Europe,1897,111
2020-07-18,Slovenia,SI,19,0,2080908,Europe,1916,111
2020-07-19,Slovenia,SI,24,0,2080908,Europe,1940,111
2020-07-20,Slovenia,SI,6,0,2080908,Europe,1946,111
2020-07-21,Slovenia,SI,7,0,2080908,Europe,1953,111
2020-07-22,Slovenia,SI,24,0,2080908,Europe,1977,111
2020-07-23,Slovenia,SI,38,4,2080908,Europe,2015,115
2020-07-24,Slovenia,SI,18,0,2080908,Europe,2033,115
2020-07-25,Slovenia,SI,19,0,2080908,Europe,2052,115
2020-07-26,Slovenia,SI,14,0,2080908,Europe,2066,115
2020-07-27,Slovenia,SI,16,0,2080908,Europe,2082,115
2020-07-28,Slovenia,SI,5,2,2080908,Europe,2087,117
2020-07-29,Slovenia,SI,14,0,2080908,Europe,2101,117
2020-07-30,Slovenia,SI,14,0,2080908,Europe,2115,117
2020-07-31,Slovenia,SI,24,0,2080908,Europe,2139,117
2020-08-01,Slovenia,SI,26,0,2080908,Europe,2165,117
2020-08-02,Slovenia,SI,6,0,2080908,Europe,2171,117
2020-08-03,Slovenia,SI,9,0,2080908,Europe,2180,117
2020-08-04,Slovenia,SI,1,0,2080908,Europe,2181,117
2020-08-05,Slovenia,SI,9,1,2080908,Europe,2190,118
2020-08-06,Slovenia,SI,18,0,2080908,Europe,2208,118
2020-08-07,Slovenia,SI,15,0,2080908,Europe,2223,118
2020-08-08,Slovenia,SI,10,1,2080908,Europe,2233,119
2020-08-09,Slovenia,SI,14,1,2080908,Europe,2247,120
2020-08-10,Slovenia,SI,2,0,2080908,Europe,2249,120
2020-08-11,Slovenia,SI,6,0,2080908,Europe,2255,120
2020-08-12,Slovenia,SI,17,0,2080908,Europe,2272,120
2020-08-13,Slovenia,SI,31,3,2080908,Europe,2303,123
2020-08-14,Slovenia,SI,29,1,2080908,Europe,2332,124
2020-08-15,Slovenia,SI,37,0,2080908,Europe,2369,124
2020-08-16,Slovenia,SI,32,0,2080908,Europe,2401,124
2020-08-17,Slovenia,SI,15,0,2080908,Europe,2416,124
2020-08-18,Slovenia,SI,22,0,2080908,Europe,2438,124
2020-08-19,Slovenia,SI,18,0,2080908,Europe,2456,124
2020-08-20,Slovenia,SI,37,1,2080908,Europe,2493,125
2020-08-21,Slovenia,SI,43,0,2080908,Europe,2536,125
2020-08-22,Slovenia,SI,38,2,2080908,Europe,2574,127
2020-08-23,Slovenia,SI,43,0,2080908,Europe,2617,127
2020-08-24,Slovenia,SI,34,0,2080908,Europe,2651,127
2020-08-25,Slovenia,SI,14,1,2080908,Europe,2665,128
2020-08-26,Slovenia,SI,21,0,2080908,Europe,2686,128
2020-08-27,Slovenia,SI,36,0,2080908,Europe,2722,128
2020-08-28,Slovenia,SI,33,0,2080908,Europe,2755,128
2020-08-29,Slovenia,SI,42,0,2080908,Europe,2797,128
2020-08-30,Slovenia,SI,37,0,2080908,Europe,2834,128
2020-08-31,Slovenia,SI,31,0,2080908,Europe,2865,128
2020-09-01,Slovenia,SI,27,0,2080908,Europe,2892,128
2020-09-02,Slovenia,SI,41,0,2080908,Europe,2933,128
2020-09-03,Slovenia,SI,55,0,2080908,Europe,2988,128
2020-09-04,Slovenia,SI,53,1,2080908,Europe,3041,129
2020-09-05,Slovenia,SI,47,0,2080908,Europe,3088,129
2020-09-06,Slovenia,SI,43,1,2080908,Europe,3131,130
2020-09-07,Slovenia,SI,43,0,2080908,Europe,3174,130
2020-09-08,Slovenia,SI,16,0,2080908,Europe,3190,130
2020-09-09,Slovenia,SI,42,0,2080908,Europe,3232,130
2020-09-10,Slovenia,SI,80,1,2080908,Europe,3312,131
2020-09-11,Slovenia,SI,76,0,2080908,Europe,3388,131
2020-09-12,Slovenia,SI,110,0,2080908,Europe,3498,131
2020-09-13,Slovenia,SI,105,0,2080908,Europe,3603,131
2020-09-14,Slovenia,SI,99,0,2080908,Europe,3702,131
2020-09-15,Slovenia,SI,53,0,2080908,Europe,3755,131
2020-09-16,Slovenia,SI,82,0,2080908,Europe,3837,131
2020-09-17,Slovenia,SI,123,0,2080908,Europe,3960,131
2020-09-18,Slovenia,SI,98,0,2080908,Europe,4058,131
2020-09-19,Slovenia,SI,137,2,2080908,Europe,4195,133
2020-09-20,Slovenia,SI,114,0,2080908,Europe,4309,133
2020-09-21,Slovenia,SI,111,0,2080908,Europe,4420,133
2020-09-22,Slovenia,SI,50,0,2080908,Europe,4470,133
2020-09-23,Slovenia,SI,88,0,2080908,Europe,4558,133
2020-09-24,Slovenia,SI,136,0,2080908,Europe,4694,133
2020-09-25,Slovenia,SI,122,2,2080908,Europe,4816,135
2020-09-26,Slovenia,SI,191,0,2080908,Europe,5007,135
2020-09-27,Slovenia,SI,184,1,2080908,Europe,5191,136
2020-09-28,Slovenia,SI,159,0,2080908,Europe,5350,136
2020-09-29,Slovenia,SI,44,0,2080908,Europe,5394,136
2020-09-30,Slovenia,SI,93,2,2080908,Europe,5487,138
2020-10-01,Slovenia,SI,203,0,2080908,Europe,5690,138
2020-10-02,Slovenia,SI,175,0,2080908,Europe,5865,138
2020-10-03,Slovenia,SI,238,2,2080908,Europe,6103,140
2020-10-04,Slovenia,SI,227,0,2080908,Europe,6330,140
2020-10-05,Slovenia,SI,168,0,2080908,Europe,6498,140
2020-10-06,Slovenia,SI,76,0,2080908,Europe,6574,140
2020-10-07,Slovenia,SI,194,1,2080908,Europe,6768,141
2020-10-08,Slovenia,SI,356,0,2080908,Europe,7124,141
2020-10-09,Slovenia,SI,387,0,2080908,Europe,7511,141
2020-10-10,Slovenia,SI,363,0,2080908,Europe,7874,141
2020-10-11,Slovenia,SI,380,0,2080908,Europe,8254,141
2020-10-12,Slovenia,SI,411,1,2080908,Europe,8665,142
2020-10-13,Slovenia,SI,167,2,2080908,Europe,8832,144
2020-10-14,Slovenia,SI,399,3,2080908,Europe,9231,147
2020-10-15,Slovenia,SI,707,1,2080908,Europe,9938,148
2020-10-16,Slovenia,SI,746,5,2080908,Europe,10684,153
2020-10-17,Slovenia,SI,834,0,2080908,Europe,11518,153
2020-10-18,Slovenia,SI,898,0,2080908,Europe,12416,153
2020-10-19,Slovenia,SI,728,8,2080908,Europe,13144,161
2020-10-20,Slovenia,SI,537,3,2080908,Europe,13681,164
2020-10-21,Slovenia,SI,794,2,2080908,Europe,14475,166
2020-10-22,Slovenia,SI,1508,1,2080908,Europe,15983,167
2020-10-23,Slovenia,SI,1668,7,2080908,Europe,17651,174
2020-10-24,Slovenia,SI,1662,5,2080908,Europe,19313,179
2020-10-25,Slovenia,SI,1964,2,2080908,Europe,21277,181
2020-10-26,Slovenia,SI,1673,2,2080908,Europe,22950,183
2020-10-27,Slovenia,SI,1130,5,2080908,Europe,24080,188
2020-10-28,Slovenia,SI,1523,4,2080908,Europe,25603,192
2020-10-29,Slovenia,SI,2612,13,2080908,Europe,28215,205
2020-10-30,Slovenia,SI,2490,10,2080908,Europe,30705,215
2020-10-31,Slovenia,SI,1805,10,2080908,Europe,32510,225
2020-11-01,Slovenia,SI,1797,6,2080908,Europe,34307,231
2020-11-02,Slovenia,SI,1342,5,2080908,Europe,35649,236
2020-11-03,Slovenia,SI,557,15,2080908,Europe,36206,251
2020-11-04,Slovenia,SI,1177,31,2080908,Europe,37383,282
2020-11-05,Slovenia,SI,2025,39,2080908,Europe,39408,321
2020-11-06,Slovenia,SI,1686,20,2080908,Europe,41094,341
2020-11-07,Slovenia,SI,1564,12,2080908,Europe,42658,353
2020-11-08,Slovenia,SI,1613,25,2080908,Europe,44271,378
2020-11-09,Slovenia,SI,890,4,2080908,Europe,45161,382
2020-11-10,Slovenia,SI,464,16,2080908,Europe,45625,398
2020-11-11,Slovenia,SI,1092,12,2080908,Europe,46717,410
2020-11-12,Slovenia,SI,2222,14,2080908,Europe,48939,424
2020-11-13,Slovenia,SI,1931,13,2080908,Europe,50870,437
2020-11-14,Slovenia,SI,1515,44,2080908,Europe,52385,481
2020-11-15,Slovenia,SI,1737,19,2080908,Europe,54122,500
2020-11-16,Slovenia,SI,920,11,2080908,Europe,55042,511
2020-11-17,Slovenia,SI,502,21,2080908,Europe,55544,532
2020-11-18,Slovenia,SI,1393,24,2080908,Europe,56937,556
2020-11-19,Slovenia,SI,2027,30,2080908,Europe,58964,586
2020-11-20,Slovenia,SI,2070,23,2080908,Europe,61034,609
2020-11-21,Slovenia,SI,1546,35,2080908,Europe,62580,644
2020-11-22,Slovenia,SI,1704,13,2080908,Europe,64284,657
2020-11-23,Slovenia,SI,1024,6,2080908,Europe,65308,663
2020-11-24,Slovenia,SI,470,27,2080908,Europe,65778,690
2020-11-25,Slovenia,SI,1302,35,2080908,Europe,67080,725
2020-11-26,Slovenia,SI,2226,52,2080908,Europe,69306,777
2020-11-27,Slovenia,SI,1767,78,2080908,Europe,71073,855
2020-11-28,Slovenia,SI,1601,28,2080908,Europe,72674,883
2020-11-29,Slovenia,SI,1590,30,2080908,Europe,74264,913
2020-11-30,Slovenia,SI,1117,14,2080908,Europe,75381,927
2020-12-01,Slovenia,SI,433,21,2080908,Europe,75814,948
2020-12-02,Slovenia,SI,1321,16,2080908,Europe,77135,964
2020-12-03,Slovenia,SI,2431,78,2080908,Europe,79566,1042
2020-12-04,Slovenia,SI,1783,54,2080908,Europe,81349,1096
2020-12-05,Slovenia,SI,1784,111,2080908,Europe,83133,1207
2020-12-06,Slovenia,SI,1642,37,2080908,Europe,84775,1244
2020-12-07,Slovenia,SI,1030,14,2080908,Europe,85805,1258
2020-12-08,Slovenia,SI,483,30,2080908,Europe,86288,1288
2020-12-09,Slovenia,SI,1648,23,2080908,Europe,87936,1311
2020-12-10,Slovenia,SI,2137,50,2080908,Europe,90073,1361
2020-12-11,Slovenia,SI,1848,26,2080908,Europe,91921,1387
2020-12-12,Slovenia,SI,1816,39,2080908,Europe,93737,1426
2020-12-13,Slovenia,SI,1744,22,2080908,Europe,95481,1448
2020-12-14,Slovenia,SI,833,11,2080908,Europe,96314,1459
2020-03-07,Slovakia,SK,1,0,5450421,Europe,1,0
2020-03-08,Slovakia,SK,2,0,5450421,Europe,3,0
2020-03-09,Slovakia,SK,2,0,5450421,Europe,5,0
2020-03-11,Slovakia,SK,2,0,5450421,Europe,7,0
2020-03-12,Slovakia,SK,3,0,5450421,Europe,10,0
2020-03-13,Slovakia,SK,11,0,5450421,Europe,21,0
2020-03-14,Slovakia,SK,9,0,5450421,Europe,30,0
2020-03-15,Slovakia,SK,14,0,5450421,Europe,44,0
2020-03-16,Slovakia,SK,17,0,5450421,Europe,61,0
2020-03-17,Slovakia,SK,23,0,5450421,Europe,84,0
2020-03-18,Slovakia,SK,13,0,5450421,Europe,97,0
2020-03-19,Slovakia,SK,10,0,5450421,Europe,107,0
2020-03-20,Slovakia,SK,16,0,5450421,Europe,123,0
2020-03-21,Slovakia,SK,14,0,5450421,Europe,137,0
2020-03-22,Slovakia,SK,41,0,5450421,Europe,178,0
2020-03-23,Slovakia,SK,7,0,5450421,Europe,185,0
2020-03-24,Slovakia,SK,6,0,5450421,Europe,191,0
2020-03-25,Slovakia,SK,13,0,5450421,Europe,204,0
2020-03-26,Slovakia,SK,12,0,5450421,Europe,216,0
2020-03-27,Slovakia,SK,10,0,5450421,Europe,226,0
2020-03-28,Slovakia,SK,69,0,5450421,Europe,295,0
2020-03-29,Slovakia,SK,0,0,5450421,Europe,295,0
2020-03-30,Slovakia,SK,41,0,5450421,Europe,336,0
2020-03-31,Slovakia,SK,0,0,5450421,Europe,336,0
2020-04-01,Slovakia,SK,27,0,5450421,Europe,363,0
2020-04-02,Slovakia,SK,37,0,5450421,Europe,400,0
2020-04-03,Slovakia,SK,26,0,5450421,Europe,426,0
2020-04-04,Slovakia,SK,24,0,5450421,Europe,450,0
2020-04-05,Slovakia,SK,21,0,5450421,Europe,471,0
2020-04-06,Slovakia,SK,14,0,5450421,Europe,485,0
2020-04-07,Slovakia,SK,49,2,5450421,Europe,534,2
2020-04-08,Slovakia,SK,47,0,5450421,Europe,581,2
2020-04-09,Slovakia,SK,101,0,5450421,Europe,682,2
2020-04-10,Slovakia,SK,19,0,5450421,Europe,701,2
2020-04-11,Slovakia,SK,14,0,5450421,Europe,715,2
2020-04-12,Slovakia,SK,13,0,5450421,Europe,728,2
2020-04-13,Slovakia,SK,14,0,5450421,Europe,742,2
2020-04-14,Slovakia,SK,27,0,5450421,Europe,769,2
2020-04-15,Slovakia,SK,66,0,5450421,Europe,835,2
2020-04-16,Slovakia,SK,28,4,5450421,Europe,863,6
2020-04-17,Slovakia,SK,114,2,5450421,Europe,977,8
2020-04-18,Slovakia,SK,72,1,5450421,Europe,1049,9
2020-04-19,Slovakia,SK,40,2,5450421,Europe,1089,11
2020-04-20,Slovakia,SK,72,1,5450421,Europe,1161,12
2020-04-21,Slovakia,SK,12,1,5450421,Europe,1173,13
2020-04-22,Slovakia,SK,26,1,5450421,Europe,1199,14
2020-04-23,Slovakia,SK,45,0,5450421,Europe,1244,14
2020-04-24,Slovakia,SK,81,1,5450421,Europe,1325,15
2020-04-25,Slovakia,SK,35,2,5450421,Europe,1360,17
2020-04-26,Slovakia,SK,13,0,5450421,Europe,1373,17
2020-04-27,Slovakia,SK,6,1,5450421,Europe,1379,18
2020-04-28,Slovakia,SK,2,0,5450421,Europe,1381,18
2020-04-29,Slovakia,SK,3,2,5450421,Europe,1384,20
2020-04-30,Slovakia,SK,7,2,5450421,Europe,1391,22
2020-05-01,Slovakia,SK,5,1,5450421,Europe,1396,23
2020-05-02,Slovakia,SK,7,0,5450421,Europe,1403,23
2020-05-03,Slovakia,SK,4,1,5450421,Europe,1407,24
2020-05-04,Slovakia,SK,1,0,5450421,Europe,1408,24
2020-05-05,Slovakia,SK,5,1,5450421,Europe,1413,25
2020-05-06,Slovakia,SK,8,0,5450421,Europe,1421,25
2020-05-07,Slovakia,SK,8,0,5450421,Europe,1429,25
2020-05-08,Slovakia,SK,16,1,5450421,Europe,1445,26
2020-05-09,Slovakia,SK,10,0,5450421,Europe,1455,26
2020-05-10,Slovakia,SK,0,0,5450421,Europe,1455,26
2020-05-11,Slovakia,SK,2,0,5450421,Europe,1457,26
2020-05-12,Slovakia,SK,0,0,5450421,Europe,1457,26
2020-05-13,Slovakia,SK,8,1,5450421,Europe,1465,27
2020-05-14,Slovakia,SK,4,0,5450421,Europe,1469,27
2020-05-15,Slovakia,SK,8,0,5450421,Europe,1477,27
2020-05-16,Slovakia,SK,3,0,5450421,Europe,1480,27
2020-05-17,Slovakia,SK,13,1,5450421,Europe,1493,28
2020-05-18,Slovakia,SK,1,0,5450421,Europe,1494,28
2020-05-19,Slovakia,SK,1,0,5450421,Europe,1495,28
2020-05-20,Slovakia,SK,0,0,5450421,Europe,1495,28
2020-05-21,Slovakia,SK,1,0,5450421,Europe,1496,28
2020-05-22,Slovakia,SK,6,0,5450421,Europe,1502,28
2020-05-23,Slovakia,SK,1,0,5450421,Europe,1503,28
2020-05-24,Slovakia,SK,1,0,5450421,Europe,1504,28
2020-05-25,Slovakia,SK,5,0,5450421,Europe,1509,28
2020-05-26,Slovakia,SK,2,0,5450421,Europe,1511,28
2020-05-27,Slovakia,SK,2,0,5450421,Europe,1513,28
2020-05-28,Slovakia,SK,2,0,5450421,Europe,1515,28
2020-05-29,Slovakia,SK,5,0,5450421,Europe,1520,28
2020-05-30,Slovakia,SK,0,0,5450421,Europe,1520,28
2020-05-31,Slovakia,SK,1,0,5450421,Europe,1521,28
2020-06-01,Slovakia,SK,1,0,5450421,Europe,1522,28
2020-06-02,Slovakia,SK,0,0,5450421,Europe,1522,28
2020-06-03,Slovakia,SK,0,0,5450421,Europe,1522,28
2020-06-04,Slovakia,SK,3,0,5450421,Europe,1525,28
2020-06-05,Slovakia,SK,1,0,5450421,Europe,1526,28
2020-06-06,Slovakia,SK,0,0,5450421,Europe,1526,28
2020-06-07,Slovakia,SK,2,0,5450421,Europe,1528,28
2020-06-08,Slovakia,SK,0,0,5450421,Europe,1528,28
2020-06-09,Slovakia,SK,2,0,5450421,Europe,1530,28
2020-06-10,Slovakia,SK,1,0,5450421,Europe,1531,28
2020-06-11,Slovakia,SK,2,0,5450421,Europe,1533,28
2020-06-12,Slovakia,SK,8,0,5450421,Europe,1541,28
2020-06-13,Slovakia,SK,1,0,5450421,Europe,1542,28
2020-06-14,Slovakia,SK,3,0,5450421,Europe,1545,28
2020-06-15,Slovakia,SK,3,0,5450421,Europe,1548,28
2020-06-16,Slovakia,SK,4,0,5450421,Europe,1552,28
2020-06-17,Slovakia,SK,0,0,5450421,Europe,1552,28
2020-06-18,Slovakia,SK,9,0,5450421,Europe,1561,28
2020-06-19,Slovakia,SK,1,0,5450421,Europe,1562,28
2020-06-20,Slovakia,SK,14,0,5450421,Europe,1576,28
2020-06-21,Slovakia,SK,10,0,5450421,Europe,1586,28
2020-06-22,Slovakia,SK,1,0,5450421,Europe,1587,28
2020-06-23,Slovakia,SK,1,0,5450421,Europe,1588,28
2020-06-24,Slovakia,SK,1,0,5450421,Europe,1589,28
2020-06-25,Slovakia,SK,18,0,5450421,Europe,1607,28
2020-06-26,Slovakia,SK,23,0,5450421,Europe,1630,28
2020-06-27,Slovakia,SK,13,0,5450421,Europe,1643,28
2020-06-28,Slovakia,SK,14,0,5450421,Europe,1657,28
2020-06-29,Slovakia,SK,7,0,5450421,Europe,1664,28
2020-06-30,Slovakia,SK,1,0,5450421,Europe,1665,28
2020-07-01,Slovakia,SK,2,0,5450421,Europe,1667,28
2020-07-02,Slovakia,SK,20,0,5450421,Europe,1687,28
2020-07-03,Slovakia,SK,13,0,5450421,Europe,1700,28
2020-07-04,Slovakia,SK,20,0,5450421,Europe,1720,28
2020-07-05,Slovakia,SK,29,0,5450421,Europe,1749,28
2020-07-06,Slovakia,SK,15,0,5450421,Europe,1764,28
2020-07-07,Slovakia,SK,1,0,5450421,Europe,1765,28
2020-07-08,Slovakia,SK,2,0,5450421,Europe,1767,28
2020-07-09,Slovakia,SK,31,0,5450421,Europe,1798,28
2020-07-10,Slovakia,SK,53,0,5450421,Europe,1851,28
2020-07-11,Slovakia,SK,19,0,5450421,Europe,1870,28
2020-07-12,Slovakia,SK,23,0,5450421,Europe,1893,28
2020-07-13,Slovakia,SK,8,0,5450421,Europe,1901,28
2020-07-14,Slovakia,SK,1,0,5450421,Europe,1902,28
2020-07-15,Slovakia,SK,6,0,5450421,Europe,1908,28
2020-07-16,Slovakia,SK,19,0,5450421,Europe,1927,28
2020-07-17,Slovakia,SK,24,0,5450421,Europe,1951,28
2020-07-18,Slovakia,SK,14,0,5450421,Europe,1965,28
2020-07-19,Slovakia,SK,11,0,5450421,Europe,1976,28
2020-07-20,Slovakia,SK,3,0,5450421,Europe,1979,28
2020-07-21,Slovakia,SK,1,0,5450421,Europe,1980,28
2020-07-22,Slovakia,SK,41,0,5450421,Europe,2021,28
2020-07-23,Slovakia,SK,37,0,5450421,Europe,2058,28
2020-07-24,Slovakia,SK,31,0,5450421,Europe,2089,28
2020-07-25,Slovakia,SK,29,0,5450421,Europe,2118,28
2020-07-26,Slovakia,SK,23,0,5450421,Europe,2141,28
2020-07-27,Slovakia,SK,38,0,5450421,Europe,2179,28
2020-07-28,Slovakia,SK,2,0,5450421,Europe,2181,28
2020-07-29,Slovakia,SK,23,0,5450421,Europe,2204,28
2020-07-30,Slovakia,SK,41,0,5450421,Europe,2245,28
2020-07-31,Slovakia,SK,20,0,5450421,Europe,2265,28
2020-08-01,Slovakia,SK,27,1,5450421,Europe,2292,29
2020-08-02,Slovakia,SK,45,0,5450421,Europe,2337,29
2020-08-03,Slovakia,SK,7,0,5450421,Europe,2344,29
2020-08-04,Slovakia,SK,10,0,5450421,Europe,2354,29
2020-08-05,Slovakia,SK,14,0,5450421,Europe,2368,29
2020-08-06,Slovakia,SK,49,0,5450421,Europe,2417,29
2020-08-07,Slovakia,SK,63,0,5450421,Europe,2480,29
2020-08-08,Slovakia,SK,43,2,5450421,Europe,2523,31
2020-08-09,Slovakia,SK,43,0,5450421,Europe,2566,31
2020-08-10,Slovakia,SK,30,0,5450421,Europe,2596,31
2020-08-11,Slovakia,SK,3,0,5450421,Europe,2599,31
2020-08-12,Slovakia,SK,16,0,5450421,Europe,2615,31
2020-08-13,Slovakia,SK,75,0,5450421,Europe,2690,31
2020-08-14,Slovakia,SK,49,0,5450421,Europe,2739,31
2020-08-15,Slovakia,SK,62,0,5450421,Europe,2801,31
2020-08-16,Slovakia,SK,54,0,5450421,Europe,2855,31
2020-08-17,Slovakia,SK,47,0,5450421,Europe,2902,31
2020-08-18,Slovakia,SK,5,0,5450421,Europe,2907,31
2020-08-19,Slovakia,SK,15,0,5450421,Europe,2922,31
2020-08-20,Slovakia,SK,100,2,5450421,Europe,3022,33
2020-08-21,Slovakia,SK,80,0,5450421,Europe,3102,33
2020-08-22,Slovakia,SK,123,0,5450421,Europe,3225,33
2020-08-23,Slovakia,SK,91,0,5450421,Europe,3316,33
2020-08-24,Slovakia,SK,40,0,5450421,Europe,3356,33
2020-08-25,Slovakia,SK,68,0,5450421,Europe,3424,33
2020-08-26,Slovakia,SK,28,0,5450421,Europe,3452,33
2020-08-27,Slovakia,SK,84,0,5450421,Europe,3536,33
2020-08-28,Slovakia,SK,90,0,5450421,Europe,3626,33
2020-08-29,Slovakia,SK,102,0,5450421,Europe,3728,33
2020-08-30,Slovakia,SK,114,0,5450421,Europe,3842,33
2020-08-31,Slovakia,SK,34,0,5450421,Europe,3876,33
2020-09-01,Slovakia,SK,41,0,5450421,Europe,3917,33
2020-09-02,Slovakia,SK,72,0,5450421,Europe,3989,33
2020-09-03,Slovakia,SK,53,0,5450421,Europe,4042,33
2020-09-04,Slovakia,SK,121,4,5450421,Europe,4163,37
2020-09-05,Slovakia,SK,137,0,5450421,Europe,4300,37
2020-09-06,Slovakia,SK,226,0,5450421,Europe,4526,37
2020-09-07,Slovakia,SK,88,0,5450421,Europe,4614,37
2020-09-08,Slovakia,SK,22,0,5450421,Europe,4636,37
2020-09-09,Slovakia,SK,91,0,5450421,Europe,4727,37
2020-09-10,Slovakia,SK,161,0,5450421,Europe,4888,37
2020-09-11,Slovakia,SK,133,0,5450421,Europe,5021,37
2020-09-12,Slovakia,SK,231,0,5450421,Europe,5252,37
2020-09-13,Slovakia,SK,201,1,5450421,Europe,5453,38
2020-09-14,Slovakia,SK,79,0,5450421,Europe,5532,38
2020-09-15,Slovakia,SK,48,0,5450421,Europe,5580,38
2020-09-16,Slovakia,SK,188,0,5450421,Europe,5768,38
2020-09-17,Slovakia,SK,92,0,5450421,Europe,5860,38
2020-09-18,Slovakia,SK,161,1,5450421,Europe,6021,39
2020-09-19,Slovakia,SK,235,0,5450421,Europe,6256,39
2020-09-20,Slovakia,SK,290,0,5450421,Europe,6546,39
2020-09-21,Slovakia,SK,131,0,5450421,Europe,6677,39
2020-09-22,Slovakia,SK,79,0,5450421,Europe,6756,39
2020-09-23,Slovakia,SK,175,1,5450421,Europe,6931,40
2020-09-24,Slovakia,SK,338,1,5450421,Europe,7269,41
2020-09-25,Slovakia,SK,360,0,5450421,Europe,7629,41
2020-09-26,Slovakia,SK,419,0,5450421,Europe,8048,41
2020-09-27,Slovakia,SK,552,3,5450421,Europe,8600,44
2020-09-28,Slovakia,SK,478,0,5450421,Europe,9078,44
2020-09-29,Slovakia,SK,265,0,5450421,Europe,9343,44
2020-09-30,Slovakia,SK,231,1,5450421,Europe,9574,45
2020-10-01,Slovakia,SK,567,3,5450421,Europe,10141,48
2020-10-02,Slovakia,SK,797,0,5450421,Europe,10938,48
2020-10-03,Slovakia,SK,679,6,5450421,Europe,11617,54
2020-10-04,Slovakia,SK,704,0,5450421,Europe,12321,54
2020-10-05,Slovakia,SK,818,1,5450421,Europe,13139,55
2020-10-06,Slovakia,SK,353,0,5450421,Europe,13492,55
2020-10-07,Slovakia,SK,320,0,5450421,Europe,13812,55
2020-10-08,Slovakia,SK,877,0,5450421,Europe,14689,55
2020-10-09,Slovakia,SK,1037,2,5450421,Europe,15726,57
2020-10-10,Slovakia,SK,1184,0,5450421,Europe,16910,57
2020-10-11,Slovakia,SK,1887,4,5450421,Europe,18797,61
2020-10-12,Slovakia,SK,1054,0,5450421,Europe,19851,61
2020-10-13,Slovakia,SK,504,0,5450421,Europe,20355,61
2020-10-14,Slovakia,SK,531,0,5450421,Europe,20886,61
2020-10-15,Slovakia,SK,1410,5,5450421,Europe,22296,66
2020-10-16,Slovakia,SK,1929,5,5450421,Europe,24225,71
2020-10-17,Slovakia,SK,2075,0,5450421,Europe,26300,71
2020-10-18,Slovakia,SK,1968,11,5450421,Europe,28268,82
2020-10-19,Slovakia,SK,1567,6,5450421,Europe,29835,88
2020-10-20,Slovakia,SK,860,4,5450421,Europe,30695,92
2020-10-21,Slovakia,SK,705,6,5450421,Europe,31400,98
2020-10-22,Slovakia,SK,2202,0,5450421,Europe,33602,98
2020-10-23,Slovakia,SK,1728,17,5450421,Europe,35330,115
2020-10-24,Slovakia,SK,2581,19,5450421,Europe,37911,134
2020-10-25,Slovakia,SK,2890,25,5450421,Europe,40801,159
2020-10-26,Slovakia,SK,3042,0,5450421,Europe,43843,159
2020-10-27,Slovakia,SK,1312,6,5450421,Europe,45155,165
2020-10-28,Slovakia,SK,901,11,5450421,Europe,46056,176
2020-10-29,Slovakia,SK,2887,8,5450421,Europe,48943,184
2020-10-30,Slovakia,SK,2785,16,5450421,Europe,51728,200
2020-10-31,Slovakia,SK,3363,12,5450421,Europe,55091,212
2020-11-01,Slovakia,SK,2573,7,5450421,Europe,57664,219
2020-11-02,Slovakia,SK,2282,0,5450421,Europe,59946,219
2020-11-03,Slovakia,SK,1883,0,5450421,Europe,61829,219
2020-11-04,Slovakia,SK,1727,16,5450421,Europe,63556,235
2020-11-05,Slovakia,SK,3216,26,5450421,Europe,66772,261
2020-11-06,Slovakia,SK,1962,25,5450421,Europe,68734,286
2020-11-07,Slovakia,SK,2354,31,5450421,Europe,71088,317
2020-11-08,Slovakia,SK,2579,34,5450421,Europe,73667,351
2020-11-09,Slovakia,SK,1828,0,5450421,Europe,75495,351
2020-11-10,Slovakia,SK,577,15,5450421,Europe,76072,366
2020-11-11,Slovakia,SK,1051,24,5450421,Europe,77123,390
2020-11-12,Slovakia,SK,2058,24,5450421,Europe,79181,414
2020-11-13,Slovakia,SK,2591,50,5450421,Europe,81772,464
2020-11-14,Slovakia,SK,2024,27,5450421,Europe,83796,491
2020-11-15,Slovakia,SK,1771,19,5450421,Europe,85567,510
2020-11-16,Slovakia,SK,1200,0,5450421,Europe,86767,510
2020-11-17,Slovakia,SK,509,16,5450421,Europe,87276,526
2020-11-18,Slovakia,SK,1326,31,5450421,Europe,88602,557
2020-11-19,Slovakia,SK,1311,22,5450421,Europe,89913,579
2020-11-20,Slovakia,SK,1665,0,5450421,Europe,91578,579
2020-11-21,Slovakia,SK,1818,35,5450421,Europe,93396,614
2020-11-22,Slovakia,SK,1861,30,5450421,Europe,95257,644
2020-11-23,Slovakia,SK,984,27,5450421,Europe,96241,671
2020-11-24,Slovakia,SK,231,22,5450421,Europe,96472,693
2020-11-25,Slovakia,SK,1021,16,5450421,Europe,97493,709
2020-11-26,Slovakia,SK,1811,23,5450421,Europe,99304,732
2020-11-27,Slovakia,SK,1953,17,5450421,Europe,101257,749
2020-11-28,Slovakia,SK,1849,22,5450421,Europe,103106,771
2020-11-29,Slovakia,SK,1526,27,5450421,Europe,104632,798
2020-11-30,Slovakia,SK,1101,18,5450421,Europe,105733,816
2020-12-01,Slovakia,SK,196,23,5450421,Europe,105929,839
2020-12-02,Slovakia,SK,1254,29,5450421,Europe,107183,868
2020-12-03,Slovakia,SK,2043,30,5450421,Europe,109226,898
2020-12-04,Slovakia,SK,1982,32,5450421,Europe,111208,930
2020-12-05,Slovakia,SK,2184,27,5450421,Europe,113392,957
2020-12-06,Slovakia,SK,2070,24,5450421,Europe,115462,981
2020-12-07,Slovakia,SK,1269,15,5450421,Europe,116731,996
2020-12-08,Slovakia,SK,552,22,5450421,Europe,117283,1018
2020-12-09,Slovakia,SK,1949,28,5450421,Europe,119232,1046
2020-12-10,Slovakia,SK,2564,38,5450421,Europe,121796,1084
2020-12-11,Slovakia,SK,3125,20,5450421,Europe,124921,1104
2020-12-12,Slovakia,SK,2166,18,5450421,Europe,127087,1122
2020-12-13,Slovakia,SK,0,0,5450421,Europe,127087,1122
2020-12-14,Slovakia,SK,5897,53,5450421,Europe,132984,1175
2020-04-01,Sierra_Leone,SL,1,0,7813207,Africa,1,0
2020-04-02,Sierra_Leone,SL,0,0,7813207,Africa,1,0
2020-04-03,Sierra_Leone,SL,1,0,7813207,Africa,2,0
2020-04-04,Sierra_Leone,SL,0,0,7813207,Africa,2,0
2020-04-05,Sierra_Leone,SL,2,0,7813207,Africa,4,0
2020-04-06,Sierra_Leone,SL,2,0,7813207,Africa,6,0
2020-04-07,Sierra_Leone,SL,0,0,7813207,Africa,6,0
2020-04-08,Sierra_Leone,SL,0,0,7813207,Africa,6,0
2020-04-09,Sierra_Leone,SL,1,0,7813207,Africa,7,0
2020-04-10,Sierra_Leone,SL,0,0,7813207,Africa,7,0
2020-04-11,Sierra_Leone,SL,1,0,7813207,Africa,8,0
2020-04-12,Sierra_Leone,SL,2,0,7813207,Africa,10,0
2020-04-13,Sierra_Leone,SL,0,0,7813207,Africa,10,0
2020-04-14,Sierra_Leone,SL,1,0,7813207,Africa,11,0
2020-04-15,Sierra_Leone,SL,0,0,7813207,Africa,11,0
2020-04-16,Sierra_Leone,SL,2,0,7813207,Africa,13,0
2020-04-17,Sierra_Leone,SL,2,0,7813207,Africa,15,0
2020-04-18,Sierra_Leone,SL,11,0,7813207,Africa,26,0
2020-04-19,Sierra_Leone,SL,4,0,7813207,Africa,30,0
2020-04-20,Sierra_Leone,SL,5,0,7813207,Africa,35,0
2020-04-21,Sierra_Leone,SL,8,0,7813207,Africa,43,0
2020-04-22,Sierra_Leone,SL,7,0,7813207,Africa,50,0
2020-04-23,Sierra_Leone,SL,11,0,7813207,Africa,61,0
2020-04-24,Sierra_Leone,SL,3,1,7813207,Africa,64,1
2020-04-25,Sierra_Leone,SL,18,2,7813207,Africa,82,3
2020-04-26,Sierra_Leone,SL,0,0,7813207,Africa,82,3
2020-04-27,Sierra_Leone,SL,11,1,7813207,Africa,93,4
2020-04-28,Sierra_Leone,SL,6,0,7813207,Africa,99,4
2020-04-29,Sierra_Leone,SL,5,0,7813207,Africa,104,4
2020-04-30,Sierra_Leone,SL,12,0,7813207,Africa,116,4
2020-05-01,Sierra_Leone,SL,8,3,7813207,Africa,124,7
2020-05-02,Sierra_Leone,SL,12,0,7813207,Africa,136,7
2020-05-03,Sierra_Leone,SL,19,1,7813207,Africa,155,8
2020-05-04,Sierra_Leone,SL,2,0,7813207,Africa,157,8
2020-05-05,Sierra_Leone,SL,21,1,7813207,Africa,178,9
2020-05-06,Sierra_Leone,SL,21,2,7813207,Africa,199,11
2020-05-07,Sierra_Leone,SL,26,3,7813207,Africa,225,14
2020-05-08,Sierra_Leone,SL,6,2,7813207,Africa,231,16
2020-05-09,Sierra_Leone,SL,26,1,7813207,Africa,257,17
2020-05-10,Sierra_Leone,SL,34,1,7813207,Africa,291,18
2020-05-11,Sierra_Leone,SL,16,0,7813207,Africa,307,18
2020-05-12,Sierra_Leone,SL,31,1,7813207,Africa,338,19
2020-05-13,Sierra_Leone,SL,0,1,7813207,Africa,338,20
2020-05-14,Sierra_Leone,SL,49,1,7813207,Africa,387,21
2020-05-15,Sierra_Leone,SL,21,5,7813207,Africa,408,26
2020-05-16,Sierra_Leone,SL,39,1,7813207,Africa,447,27
2020-05-17,Sierra_Leone,SL,15,2,7813207,Africa,462,29
2020-05-18,Sierra_Leone,SL,43,3,7813207,Africa,505,32
2020-05-19,Sierra_Leone,SL,14,1,7813207,Africa,519,33
2020-05-20,Sierra_Leone,SL,15,0,7813207,Africa,534,33
2020-05-21,Sierra_Leone,SL,36,1,7813207,Africa,570,34
2020-05-22,Sierra_Leone,SL,15,1,7813207,Africa,585,35
2020-05-23,Sierra_Leone,SL,21,3,7813207,Africa,606,38
2020-05-24,Sierra_Leone,SL,15,1,7813207,Africa,621,39
2020-05-25,Sierra_Leone,SL,86,1,7813207,Africa,707,40
2020-05-26,Sierra_Leone,SL,28,2,7813207,Africa,735,42
2020-05-27,Sierra_Leone,SL,19,2,7813207,Africa,754,44
2020-05-28,Sierra_Leone,SL,28,1,7813207,Africa,782,45
2020-05-29,Sierra_Leone,SL,30,0,7813207,Africa,812,45
2020-05-30,Sierra_Leone,SL,17,0,7813207,Africa,829,45
2020-05-31,Sierra_Leone,SL,23,1,7813207,Africa,852,46
2020-06-01,Sierra_Leone,SL,9,0,7813207,Africa,861,46
2020-06-02,Sierra_Leone,SL,0,0,7813207,Africa,861,46
2020-06-03,Sierra_Leone,SL,35,0,7813207,Africa,896,46
2020-06-04,Sierra_Leone,SL,13,1,7813207,Africa,909,47
2020-06-05,Sierra_Leone,SL,5,0,7813207,Africa,914,47
2020-06-06,Sierra_Leone,SL,15,0,7813207,Africa,929,47
2020-06-07,Sierra_Leone,SL,17,1,7813207,Africa,946,48
2020-06-08,Sierra_Leone,SL,23,0,7813207,Africa,969,48
2020-06-09,Sierra_Leone,SL,32,1,7813207,Africa,1001,49
2020-06-10,Sierra_Leone,SL,24,1,7813207,Africa,1025,50
2020-06-11,Sierra_Leone,SL,37,0,7813207,Africa,1062,50
2020-06-12,Sierra_Leone,SL,23,0,7813207,Africa,1085,50
2020-06-13,Sierra_Leone,SL,18,1,7813207,Africa,1103,51
2020-06-14,Sierra_Leone,SL,29,0,7813207,Africa,1132,51
2020-06-15,Sierra_Leone,SL,37,0,7813207,Africa,1169,51
2020-06-16,Sierra_Leone,SL,7,0,7813207,Africa,1176,51
2020-06-17,Sierra_Leone,SL,49,0,7813207,Africa,1225,51
2020-06-18,Sierra_Leone,SL,24,0,7813207,Africa,1249,51
2020-06-19,Sierra_Leone,SL,23,0,7813207,Africa,1272,51
2020-06-20,Sierra_Leone,SL,26,2,7813207,Africa,1298,53
2020-06-21,Sierra_Leone,SL,11,0,7813207,Africa,1309,53
2020-06-22,Sierra_Leone,SL,18,2,7813207,Africa,1327,55
2020-06-23,Sierra_Leone,SL,13,0,7813207,Africa,1340,55
2020-06-24,Sierra_Leone,SL,7,0,7813207,Africa,1347,55
2020-06-25,Sierra_Leone,SL,7,1,7813207,Africa,1354,56
2020-06-26,Sierra_Leone,SL,27,0,7813207,Africa,1381,56
2020-06-27,Sierra_Leone,SL,13,3,7813207,Africa,1394,59
2020-06-28,Sierra_Leone,SL,16,0,7813207,Africa,1410,59
2020-06-29,Sierra_Leone,SL,17,1,7813207,Africa,1427,60
2020-06-30,Sierra_Leone,SL,23,0,7813207,Africa,1450,60
2020-07-01,Sierra_Leone,SL,12,0,7813207,Africa,1462,60
2020-07-02,Sierra_Leone,SL,36,0,7813207,Africa,1498,60
2020-07-03,Sierra_Leone,SL,20,0,7813207,Africa,1518,60
2020-07-04,Sierra_Leone,SL,6,2,7813207,Africa,1524,62
2020-07-05,Sierra_Leone,SL,9,0,7813207,Africa,1533,62
2020-07-06,Sierra_Leone,SL,9,0,7813207,Africa,1542,62
2020-07-07,Sierra_Leone,SL,0,0,7813207,Africa,1542,62
2020-07-08,Sierra_Leone,SL,30,1,7813207,Africa,1572,63
2020-07-09,Sierra_Leone,SL,12,0,7813207,Africa,1584,63
2020-07-10,Sierra_Leone,SL,14,0,7813207,Africa,1598,63
2020-07-11,Sierra_Leone,SL,15,0,7813207,Africa,1613,63
2020-07-12,Sierra_Leone,SL,5,0,7813207,Africa,1618,63
2020-07-13,Sierra_Leone,SL,17,0,7813207,Africa,1635,63
2020-07-14,Sierra_Leone,SL,7,0,7813207,Africa,1642,63
2020-07-15,Sierra_Leone,SL,9,1,7813207,Africa,1651,64
2020-07-16,Sierra_Leone,SL,17,0,7813207,Africa,1668,64
2020-07-17,Sierra_Leone,SL,10,0,7813207,Africa,1678,64
2020-07-18,Sierra_Leone,SL,10,1,7813207,Africa,1688,65
2020-07-19,Sierra_Leone,SL,13,0,7813207,Africa,1701,65
2020-07-20,Sierra_Leone,SL,10,0,7813207,Africa,1711,65
2020-07-21,Sierra_Leone,SL,0,1,7813207,Africa,1711,66
2020-07-22,Sierra_Leone,SL,16,0,7813207,Africa,1727,66
2020-07-23,Sierra_Leone,SL,4,0,7813207,Africa,1731,66
2020-07-24,Sierra_Leone,SL,21,0,7813207,Africa,1752,66
2020-07-25,Sierra_Leone,SL,0,0,7813207,Africa,1752,66
2020-07-26,Sierra_Leone,SL,16,0,7813207,Africa,1768,66
2020-07-27,Sierra_Leone,SL,15,0,7813207,Africa,1783,66
2020-07-28,Sierra_Leone,SL,0,0,7813207,Africa,1783,66
2020-07-29,Sierra_Leone,SL,3,0,7813207,Africa,1786,66
2020-07-30,Sierra_Leone,SL,17,1,7813207,Africa,1803,67
2020-07-31,Sierra_Leone,SL,15,0,7813207,Africa,1818,67
2020-08-01,Sierra_Leone,SL,0,0,7813207,Africa,1818,67
2020-08-02,Sierra_Leone,SL,5,0,7813207,Africa,1823,67
2020-08-03,Sierra_Leone,SL,20,0,7813207,Africa,1843,67
2020-08-04,Sierra_Leone,SL,5,0,7813207,Africa,1848,67
2020-08-05,Sierra_Leone,SL,7,0,7813207,Africa,1855,67
2020-08-06,Sierra_Leone,SL,5,0,7813207,Africa,1860,67
2020-08-07,Sierra_Leone,SL,17,1,7813207,Africa,1877,68
2020-08-08,Sierra_Leone,SL,10,0,7813207,Africa,1887,68
2020-08-09,Sierra_Leone,SL,8,0,7813207,Africa,1895,68
2020-08-10,Sierra_Leone,SL,21,0,7813207,Africa,1916,68
2020-08-11,Sierra_Leone,SL,1,1,7813207,Africa,1917,69
2020-08-12,Sierra_Leone,SL,15,0,7813207,Africa,1932,69
2020-08-13,Sierra_Leone,SL,5,0,7813207,Africa,1937,69
2020-08-14,Sierra_Leone,SL,3,0,7813207,Africa,1940,69
2020-08-15,Sierra_Leone,SL,7,0,7813207,Africa,1947,69
2020-08-16,Sierra_Leone,SL,7,0,7813207,Africa,1954,69
2020-08-17,Sierra_Leone,SL,2,0,7813207,Africa,1956,69
2020-08-18,Sierra_Leone,SL,0,0,7813207,Africa,1956,69
2020-08-19,Sierra_Leone,SL,3,0,7813207,Africa,1959,69
2020-08-20,Sierra_Leone,SL,2,0,7813207,Africa,1961,69
2020-08-21,Sierra_Leone,SL,8,0,7813207,Africa,1969,69
2020-08-22,Sierra_Leone,SL,3,0,7813207,Africa,1972,69
2020-08-23,Sierra_Leone,SL,8,0,7813207,Africa,1980,69
2020-08-24,Sierra_Leone,SL,12,0,7813207,Africa,1992,69
2020-08-25,Sierra_Leone,SL,5,0,7813207,Africa,1997,69
2020-08-26,Sierra_Leone,SL,4,0,7813207,Africa,2001,69
2020-08-27,Sierra_Leone,SL,2,0,7813207,Africa,2003,69
2020-08-28,Sierra_Leone,SL,10,1,7813207,Africa,2013,70
2020-08-29,Sierra_Leone,SL,0,0,7813207,Africa,2013,70
2020-08-30,Sierra_Leone,SL,6,0,7813207,Africa,2019,70
2020-08-31,Sierra_Leone,SL,3,0,7813207,Africa,2022,70
2020-09-01,Sierra_Leone,SL,4,0,7813207,Africa,2026,70
2020-09-02,Sierra_Leone,SL,2,1,7813207,Africa,2028,71
2020-09-03,Sierra_Leone,SL,1,0,7813207,Africa,2029,71
2020-09-04,Sierra_Leone,SL,6,0,7813207,Africa,2035,71
2020-09-05,Sierra_Leone,SL,6,0,7813207,Africa,2041,71
2020-09-06,Sierra_Leone,SL,0,0,7813207,Africa,2041,71
2020-09-07,Sierra_Leone,SL,13,0,7813207,Africa,2054,71
2020-09-08,Sierra_Leone,SL,1,0,7813207,Africa,2055,71
2020-09-09,Sierra_Leone,SL,9,1,7813207,Africa,2064,72
2020-09-10,Sierra_Leone,SL,3,0,7813207,Africa,2067,72
2020-09-11,Sierra_Leone,SL,2,0,7813207,Africa,2069,72
2020-09-12,Sierra_Leone,SL,18,0,7813207,Africa,2087,72
2020-09-13,Sierra_Leone,SL,9,0,7813207,Africa,2096,72
2020-09-14,Sierra_Leone,SL,13,0,7813207,Africa,2109,72
2020-09-15,Sierra_Leone,SL,0,0,7813207,Africa,2109,72
2020-09-16,Sierra_Leone,SL,17,0,7813207,Africa,2126,72
2020-09-17,Sierra_Leone,SL,7,0,7813207,Africa,2133,72
2020-09-18,Sierra_Leone,SL,0,0,7813207,Africa,2133,72
2020-09-19,Sierra_Leone,SL,20,0,7813207,Africa,2153,72
2020-09-20,Sierra_Leone,SL,6,0,7813207,Africa,2159,72
2020-09-21,Sierra_Leone,SL,9,0,7813207,Africa,2168,72
2020-09-22,Sierra_Leone,SL,0,0,7813207,Africa,2168,72
2020-09-23,Sierra_Leone,SL,6,0,7813207,Africa,2174,72
2020-09-24,Sierra_Leone,SL,9,0,7813207,Africa,2183,72
2020-09-25,Sierra_Leone,SL,5,0,7813207,Africa,2188,72
2020-09-26,Sierra_Leone,SL,11,0,7813207,Africa,2199,72
2020-09-27,Sierra_Leone,SL,9,0,7813207,Africa,2208,72
2020-09-28,Sierra_Leone,SL,7,0,7813207,Africa,2215,72
2020-09-29,Sierra_Leone,SL,0,0,7813207,Africa,2215,72
2020-09-30,Sierra_Leone,SL,7,0,7813207,Africa,2222,72
2020-10-01,Sierra_Leone,SL,9,0,7813207,Africa,2231,72
2020-10-02,Sierra_Leone,SL,7,0,7813207,Africa,2238,72
2020-10-03,Sierra_Leone,SL,14,0,7813207,Africa,2252,72
2020-10-04,Sierra_Leone,SL,7,0,7813207,Africa,2259,72
2020-10-05,Sierra_Leone,SL,10,0,7813207,Africa,2269,72
2020-10-06,Sierra_Leone,SL,0,0,7813207,Africa,2269,72
2020-10-07,Sierra_Leone,SL,8,0,7813207,Africa,2277,72
2020-10-08,Sierra_Leone,SL,10,0,7813207,Africa,2287,72
2020-10-09,Sierra_Leone,SL,6,0,7813207,Africa,2293,72
2020-10-10,Sierra_Leone,SL,2,0,7813207,Africa,2295,72
2020-10-11,Sierra_Leone,SL,5,0,7813207,Africa,2300,72
2020-10-12,Sierra_Leone,SL,6,0,7813207,Africa,2306,72
2020-10-13,Sierra_Leone,SL,0,0,7813207,Africa,2306,72
2020-10-14,Sierra_Leone,SL,3,0,7813207,Africa,2309,72
2020-10-15,Sierra_Leone,SL,6,1,7813207,Africa,2315,73
2020-10-16,Sierra_Leone,SL,8,0,7813207,Africa,2323,73
2020-10-17,Sierra_Leone,SL,2,0,7813207,Africa,2325,73
2020-10-18,Sierra_Leone,SL,2,0,7813207,Africa,2327,73
2020-10-19,Sierra_Leone,SL,3,0,7813207,Africa,2330,73
2020-10-20,Sierra_Leone,SL,1,0,7813207,Africa,2331,73
2020-10-21,Sierra_Leone,SL,5,0,7813207,Africa,2336,73
2020-10-22,Sierra_Leone,SL,1,0,7813207,Africa,2337,73
2020-10-23,Sierra_Leone,SL,3,0,7813207,Africa,2340,73
2020-10-24,Sierra_Leone,SL,3,1,7813207,Africa,2343,74
2020-10-25,Sierra_Leone,SL,2,0,7813207,Africa,2345,74
2020-10-26,Sierra_Leone,SL,1,0,7813207,Africa,2346,74
2020-10-27,Sierra_Leone,SL,0,0,7813207,Africa,2346,74
2020-10-28,Sierra_Leone,SL,4,0,7813207,Africa,2350,74
2020-10-29,Sierra_Leone,SL,4,0,7813207,Africa,2354,74
2020-10-30,Sierra_Leone,SL,8,0,7813207,Africa,2362,74
2020-10-31,Sierra_Leone,SL,3,0,7813207,Africa,2365,74
2020-11-01,Sierra_Leone,SL,1,0,7813207,Africa,2366,74
2020-11-02,Sierra_Leone,SL,0,0,7813207,Africa,2366,74
2020-11-03,Sierra_Leone,SL,0,0,7813207,Africa,2366,74
2020-11-04,Sierra_Leone,SL,2,0,7813207,Africa,2368,74
2020-11-05,Sierra_Leone,SL,1,0,7813207,Africa,2369,74
2020-11-06,Sierra_Leone,SL,2,0,7813207,Africa,2371,74
2020-11-07,Sierra_Leone,SL,2,0,7813207,Africa,2373,74
2020-11-08,Sierra_Leone,SL,8,0,7813207,Africa,2381,74
2020-11-09,Sierra_Leone,SL,0,0,7813207,Africa,2381,74
2020-11-10,Sierra_Leone,SL,4,0,7813207,Africa,2385,74
2020-11-11,Sierra_Leone,SL,1,0,7813207,Africa,2386,74
2020-11-12,Sierra_Leone,SL,0,0,7813207,Africa,2386,74
2020-11-13,Sierra_Leone,SL,1,0,7813207,Africa,2387,74
2020-11-14,Sierra_Leone,SL,2,0,7813207,Africa,2389,74
2020-11-15,Sierra_Leone,SL,2,0,7813207,Africa,2391,74
2020-11-16,Sierra_Leone,SL,0,0,7813207,Africa,2391,74
2020-11-17,Sierra_Leone,SL,0,0,7813207,Africa,2391,74
2020-11-18,Sierra_Leone,SL,1,0,7813207,Africa,2392,74
2020-11-19,Sierra_Leone,SL,5,0,7813207,Africa,2397,74
2020-11-20,Sierra_Leone,SL,0,0,7813207,Africa,2397,74
2020-11-21,Sierra_Leone,SL,2,0,7813207,Africa,2399,74
2020-11-22,Sierra_Leone,SL,6,0,7813207,Africa,2405,74
2020-11-23,Sierra_Leone,SL,0,0,7813207,Africa,2405,74
2020-11-24,Sierra_Leone,SL,1,0,7813207,Africa,2406,74
2020-11-25,Sierra_Leone,SL,0,0,7813207,Africa,2406,74
2020-11-26,Sierra_Leone,SL,2,0,7813207,Africa,2408,74
2020-11-27,Sierra_Leone,SL,1,0,7813207,Africa,2409,74
2020-11-28,Sierra_Leone,SL,1,0,7813207,Africa,2410,74
2020-11-29,Sierra_Leone,SL,0,0,7813207,Africa,2410,74
2020-11-30,Sierra_Leone,SL,1,0,7813207,Africa,2411,74
2020-12-01,Sierra_Leone,SL,1,0,7813207,Africa,2412,74
2020-12-02,Sierra_Leone,SL,1,0,7813207,Africa,2413,74
2020-12-03,Sierra_Leone,SL,3,0,7813207,Africa,2416,74
2020-12-04,Sierra_Leone,SL,0,0,7813207,Africa,2416,74
2020-12-05,Sierra_Leone,SL,4,0,7813207,Africa,2420,74
2020-12-06,Sierra_Leone,SL,0,0,7813207,Africa,2420,74
2020-12-07,Sierra_Leone,SL,6,0,7813207,Africa,2426,74
2020-12-08,Sierra_Leone,SL,2,0,7813207,Africa,2428,74
2020-12-09,Sierra_Leone,SL,0,0,7813207,Africa,2428,74
2020-12-10,Sierra_Leone,SL,6,0,7813207,Africa,2434,74
2020-12-11,Sierra_Leone,SL,1,0,7813207,Africa,2435,74
2020-12-12,Sierra_Leone,SL,3,1,7813207,Africa,2438,75
2020-12-13,Sierra_Leone,SL,2,0,7813207,Africa,2440,75
2020-12-14,Sierra_Leone,SL,0,0,7813207,Africa,2440,75
2019-12-31,San_Marino,SM,0,0,34453,Europe,0,0
2020-01-01,San_Marino,SM,0,0,34453,Europe,0,0
2020-01-02,San_Marino,SM,0,0,34453,Europe,0,0
2020-01-03,San_Marino,SM,0,0,34453,Europe,0,0
2020-01-04,San_Marino,SM,0,0,34453,Europe,0,0
2020-01-05,San_Marino,SM,0,0,34453,Europe,0,0
2020-01-06,San_Marino,SM,0,0,34453,Europe,0,0
2020-01-07,San_Marino,SM,0,0,34453,Europe,0,0
2020-01-08,San_Marino,SM,0,0,34453,Europe,0,0
2020-01-09,San_Marino,SM,0,0,34453,Europe,0,0
2020-01-10,San_Marino,SM,0,0,34453,Europe,0,0
2020-01-11,San_Marino,SM,0,0,34453,Europe,0,0
2020-01-12,San_Marino,SM,0,0,34453,Europe,0,0
2020-01-13,San_Marino,SM,0,0,34453,Europe,0,0
2020-01-14,San_Marino,SM,0,0,34453,Europe,0,0
2020-01-15,San_Marino,SM,0,0,34453,Europe,0,0
2020-01-16,San_Marino,SM,0,0,34453,Europe,0,0
2020-01-17,San_Marino,SM,0,0,34453,Europe,0,0
2020-01-18,San_Marino,SM,0,0,34453,Europe,0,0
2020-01-19,San_Marino,SM,0,0,34453,Europe,0,0
2020-01-20,San_Marino,SM,0,0,34453,Europe,0,0
2020-01-21,San_Marino,SM,0,0,34453,Europe,0,0
2020-01-22,San_Marino,SM,0,0,34453,Europe,0,0
2020-01-23,San_Marino,SM,0,0,34453,Europe,0,0
2020-01-24,San_Marino,SM,0,0,34453,Europe,0,0
2020-01-25,San_Marino,SM,0,0,34453,Europe,0,0
2020-01-26,San_Marino,SM,0,0,34453,Europe,0,0
2020-01-27,San_Marino,SM,0,0,34453,Europe,0,0
2020-01-28,San_Marino,SM,0,0,34453,Europe,0,0
2020-01-29,San_Marino,SM,0,0,34453,Europe,0,0
2020-01-30,San_Marino,SM,0,0,34453,Europe,0,0
2020-01-31,San_Marino,SM,0,0,34453,Europe,0,0
2020-02-01,San_Marino,SM,0,0,34453,Europe,0,0
2020-02-02,San_Marino,SM,0,0,34453,Europe,0,0
2020-02-03,San_Marino,SM,0,0,34453,Europe,0,0
2020-02-04,San_Marino,SM,0,0,34453,Europe,0,0
2020-02-05,San_Marino,SM,0,0,34453,Europe,0,0
2020-02-06,San_Marino,SM,0,0,34453,Europe,0,0
2020-02-07,San_Marino,SM,0,0,34453,Europe,0,0
2020-02-08,San_Marino,SM,0,0,34453,Europe,0,0
2020-02-09,San_Marino,SM,0,0,34453,Europe,0,0
2020-02-10,San_Marino,SM,0,0,34453,Europe,0,0
2020-02-11,San_Marino,SM,0,0,34453,Europe,0,0
2020-02-12,San_Marino,SM,0,0,34453,Europe,0,0
2020-02-13,San_Marino,SM,0,0,34453,Europe,0,0
2020-02-14,San_Marino,SM,0,0,34453,Europe,0,0
2020-02-15,San_Marino,SM,0,0,34453,Europe,0,0
2020-02-16,San_Marino,SM,0,0,34453,Europe,0,0
2020-02-17,San_Marino,SM,0,0,34453,Europe,0,0
2020-02-18,San_Marino,SM,0,0,34453,Europe,0,0
2020-02-19,San_Marino,SM,0,0,34453,Europe,0,0
2020-02-20,San_Marino,SM,0,0,34453,Europe,0,0
2020-02-21,San_Marino,SM,0,0,34453,Europe,0,0
2020-02-22,San_Marino,SM,0,0,34453,Europe,0,0
2020-02-23,San_Marino,SM,0,0,34453,Europe,0,0
2020-02-24,San_Marino,SM,0,0,34453,Europe,0,0
2020-02-25,San_Marino,SM,0,0,34453,Europe,0,0
2020-02-26,San_Marino,SM,0,0,34453,Europe,0,0
2020-02-27,San_Marino,SM,0,0,34453,Europe,0,0
2020-02-28,San_Marino,SM,1,0,34453,Europe,1,0
2020-02-29,San_Marino,SM,0,0,34453,Europe,1,0
2020-03-01,San_Marino,SM,0,0,34453,Europe,1,0
2020-03-02,San_Marino,SM,7,1,34453,Europe,8,1
2020-03-04,San_Marino,SM,2,0,34453,Europe,10,1
2020-03-05,San_Marino,SM,5,0,34453,Europe,15,1
2020-03-06,San_Marino,SM,7,0,34453,Europe,22,1
2020-03-07,San_Marino,SM,1,0,34453,Europe,23,1
2020-03-08,San_Marino,SM,3,0,34453,Europe,26,1
2020-03-09,San_Marino,SM,11,0,34453,Europe,37,1
2020-03-10,San_Marino,SM,12,1,34453,Europe,49,2
2020-03-11,San_Marino,SM,13,0,34453,Europe,62,2
2020-03-12,San_Marino,SM,4,1,34453,Europe,66,3
2020-03-13,San_Marino,SM,1,2,34453,Europe,67,5
2020-03-14,San_Marino,SM,6,0,34453,Europe,73,5
2020-03-15,San_Marino,SM,19,0,34453,Europe,92,5
2020-03-16,San_Marino,SM,6,2,34453,Europe,98,7
2020-03-17,San_Marino,SM,4,2,34453,Europe,102,9
2020-03-18,San_Marino,SM,2,2,34453,Europe,104,11
2020-03-19,San_Marino,SM,5,3,34453,Europe,109,14
2020-03-20,San_Marino,SM,17,0,34453,Europe,126,14
2020-03-21,San_Marino,SM,25,0,34453,Europe,151,14
2020-03-22,San_Marino,SM,0,6,34453,Europe,151,20
2020-03-23,San_Marino,SM,0,0,34453,Europe,151,20
2020-03-24,San_Marino,SM,36,0,34453,Europe,187,20
2020-03-25,San_Marino,SM,0,1,34453,Europe,187,21
2020-03-26,San_Marino,SM,21,0,34453,Europe,208,21
2020-03-27,San_Marino,SM,10,0,34453,Europe,218,21
2020-03-28,San_Marino,SM,5,0,34453,Europe,223,21
2020-03-29,San_Marino,SM,1,1,34453,Europe,224,22
2020-03-30,San_Marino,SM,5,2,34453,Europe,229,24
2020-03-31,San_Marino,SM,0,1,34453,Europe,229,25
2020-04-01,San_Marino,SM,1,1,34453,Europe,230,26
2020-04-02,San_Marino,SM,6,0,34453,Europe,236,26
2020-04-03,San_Marino,SM,9,4,34453,Europe,245,30
2020-04-04,San_Marino,SM,6,2,34453,Europe,251,32
2020-04-05,San_Marino,SM,8,0,34453,Europe,259,32
2020-04-06,San_Marino,SM,7,0,34453,Europe,266,32
2020-04-07,San_Marino,SM,11,0,34453,Europe,277,32
2020-04-08,San_Marino,SM,2,2,34453,Europe,279,34
2020-04-09,San_Marino,SM,29,0,34453,Europe,308,34
2020-04-10,San_Marino,SM,25,0,34453,Europe,333,34
2020-04-11,San_Marino,SM,11,0,34453,Europe,344,34
2020-04-12,San_Marino,SM,12,1,34453,Europe,356,35
2020-04-13,San_Marino,SM,0,0,34453,Europe,356,35
2020-04-14,San_Marino,SM,0,1,34453,Europe,356,36
2020-04-15,San_Marino,SM,16,0,34453,Europe,372,36
2020-04-16,San_Marino,SM,20,0,34453,Europe,392,36
2020-04-17,San_Marino,SM,34,2,34453,Europe,426,38
2020-04-18,San_Marino,SM,9,1,34453,Europe,435,39
2020-04-19,San_Marino,SM,20,0,34453,Europe,455,39
2020-04-20,San_Marino,SM,6,0,34453,Europe,461,39
2020-04-21,San_Marino,SM,1,0,34453,Europe,462,39
2020-04-22,San_Marino,SM,14,1,34453,Europe,476,40
2020-04-23,San_Marino,SM,12,0,34453,Europe,488,40
2020-04-24,San_Marino,SM,13,0,34453,Europe,501,40
2020-04-25,San_Marino,SM,12,0,34453,Europe,513,40
2020-04-26,San_Marino,SM,0,0,34453,Europe,513,40
2020-04-27,San_Marino,SM,25,1,34453,Europe,538,41
2020-04-28,San_Marino,SM,0,0,34453,Europe,538,41
2020-04-29,San_Marino,SM,15,0,34453,Europe,553,41
2020-04-30,San_Marino,SM,10,0,34453,Europe,563,41
2020-05-01,San_Marino,SM,6,0,34453,Europe,569,41
2020-05-02,San_Marino,SM,11,0,34453,Europe,580,41
2020-05-03,San_Marino,SM,0,0,34453,Europe,580,41
2020-05-04,San_Marino,SM,2,0,34453,Europe,582,41
2020-05-05,San_Marino,SM,0,0,34453,Europe,582,41
2020-05-06,San_Marino,SM,7,0,34453,Europe,589,41
2020-05-07,San_Marino,SM,19,0,34453,Europe,608,41
2020-05-08,San_Marino,SM,14,0,34453,Europe,622,41
2020-05-09,San_Marino,SM,1,0,34453,Europe,623,41
2020-05-10,San_Marino,SM,14,0,34453,Europe,637,41
2020-05-11,San_Marino,SM,-9,0,34453,Europe,628,41
2020-05-12,San_Marino,SM,0,0,34453,Europe,628,41
2020-05-13,San_Marino,SM,10,0,34453,Europe,638,41
2020-05-14,San_Marino,SM,5,0,34453,Europe,643,41
2020-05-15,San_Marino,SM,5,0,34453,Europe,648,41
2020-05-16,San_Marino,SM,4,0,34453,Europe,652,41
2020-05-17,San_Marino,SM,1,0,34453,Europe,653,41
2020-05-18,San_Marino,SM,1,0,34453,Europe,654,41
2020-05-19,San_Marino,SM,0,0,34453,Europe,654,41
2020-05-20,San_Marino,SM,1,0,34453,Europe,655,41
2020-05-21,San_Marino,SM,1,0,34453,Europe,656,41
2020-05-22,San_Marino,SM,2,0,34453,Europe,658,41
2020-05-23,San_Marino,SM,3,0,34453,Europe,661,41
2020-05-24,San_Marino,SM,4,1,34453,Europe,665,42
2020-05-25,San_Marino,SM,0,0,34453,Europe,665,42
2020-05-26,San_Marino,SM,1,0,34453,Europe,666,42
2020-05-27,San_Marino,SM,0,0,34453,Europe,666,42
2020-05-28,San_Marino,SM,1,0,34453,Europe,667,42
2020-05-29,San_Marino,SM,3,0,34453,Europe,670,42
2020-05-30,San_Marino,SM,1,0,34453,Europe,671,42
2020-05-31,San_Marino,SM,0,0,34453,Europe,671,42
2020-06-01,San_Marino,SM,0,0,34453,Europe,671,42
2020-06-02,San_Marino,SM,16,0,34453,Europe,687,42
2020-06-03,San_Marino,SM,0,0,34453,Europe,687,42
2020-06-04,San_Marino,SM,0,0,34453,Europe,687,42
2020-06-05,San_Marino,SM,0,0,34453,Europe,687,42
2020-06-06,San_Marino,SM,0,0,34453,Europe,687,42
2020-06-07,San_Marino,SM,0,0,34453,Europe,687,42
2020-06-08,San_Marino,SM,0,0,34453,Europe,687,42
2020-06-09,San_Marino,SM,0,0,34453,Europe,687,42
2020-06-10,San_Marino,SM,1,0,34453,Europe,688,42
2020-06-11,San_Marino,SM,3,0,34453,Europe,691,42
2020-06-12,San_Marino,SM,0,0,34453,Europe,691,42
2020-06-13,San_Marino,SM,3,0,34453,Europe,694,42
2020-06-14,San_Marino,SM,0,0,34453,Europe,694,42
2020-06-15,San_Marino,SM,0,0,34453,Europe,694,42
2020-06-16,San_Marino,SM,0,0,34453,Europe,694,42
2020-06-17,San_Marino,SM,0,0,34453,Europe,694,42
2020-06-18,San_Marino,SM,2,0,34453,Europe,696,42
2020-06-19,San_Marino,SM,0,0,34453,Europe,696,42
2020-06-20,San_Marino,SM,0,0,34453,Europe,696,42
2020-06-21,San_Marino,SM,0,0,34453,Europe,696,42
2020-06-22,San_Marino,SM,0,0,34453,Europe,696,42
2020-06-23,San_Marino,SM,2,0,34453,Europe,698,42
2020-06-24,San_Marino,SM,0,0,34453,Europe,698,42
2020-06-25,San_Marino,SM,0,0,34453,Europe,698,42
2020-06-26,San_Marino,SM,0,0,34453,Europe,698,42
2020-06-27,San_Marino,SM,0,0,34453,Europe,698,42
2020-06-28,San_Marino,SM,0,0,34453,Europe,698,42
2020-06-29,San_Marino,SM,0,0,34453,Europe,698,42
2020-06-30,San_Marino,SM,0,0,34453,Europe,698,42
2020-07-01,San_Marino,SM,0,0,34453,Europe,698,42
2020-07-02,San_Marino,SM,0,0,34453,Europe,698,42
2020-07-03,San_Marino,SM,0,0,34453,Europe,698,42
2020-07-04,San_Marino,SM,0,0,34453,Europe,698,42
2020-07-05,San_Marino,SM,0,0,34453,Europe,698,42
2020-07-06,San_Marino,SM,0,0,34453,Europe,698,42
2020-07-07,San_Marino,SM,0,0,34453,Europe,698,42
2020-07-08,San_Marino,SM,0,0,34453,Europe,698,42
2020-07-09,San_Marino,SM,1,0,34453,Europe,699,42
2020-07-10,San_Marino,SM,0,0,34453,Europe,699,42
2020-07-11,San_Marino,SM,0,0,34453,Europe,699,42
2020-07-12,San_Marino,SM,0,0,34453,Europe,699,42
2020-07-13,San_Marino,SM,0,0,34453,Europe,699,42
2020-07-14,San_Marino,SM,0,0,34453,Europe,699,42
2020-07-15,San_Marino,SM,0,0,34453,Europe,699,42
2020-07-16,San_Marino,SM,0,0,34453,Europe,699,42
2020-07-17,San_Marino,SM,0,0,34453,Europe,699,42
2020-07-18,San_Marino,SM,0,0,34453,Europe,699,42
2020-07-19,San_Marino,SM,0,0,34453,Europe,699,42
2020-07-20,San_Marino,SM,0,0,34453,Europe,699,42
2020-07-21,San_Marino,SM,0,0,34453,Europe,699,42
2020-07-22,San_Marino,SM,0,0,34453,Europe,699,42
2020-07-23,San_Marino,SM,0,0,34453,Europe,699,42
2020-07-24,San_Marino,SM,0,0,34453,Europe,699,42
2020-07-25,San_Marino,SM,0,0,34453,Europe,699,42
2020-07-26,San_Marino,SM,0,0,34453,Europe,699,42
2020-07-27,San_Marino,SM,0,0,34453,Europe,699,42
2020-07-28,San_Marino,SM,0,0,34453,Europe,699,42
2020-07-29,San_Marino,SM,0,0,34453,Europe,699,42
2020-07-30,San_Marino,SM,0,0,34453,Europe,699,42
2020-07-31,San_Marino,SM,0,0,34453,Europe,699,42
2020-08-01,San_Marino,SM,0,0,34453,Europe,699,42
2020-08-02,San_Marino,SM,0,0,34453,Europe,699,42
2020-08-03,San_Marino,SM,0,0,34453,Europe,699,42
2020-08-04,San_Marino,SM,0,0,34453,Europe,699,42
2020-08-05,San_Marino,SM,0,0,34453,Europe,699,42
2020-08-06,San_Marino,SM,11,0,34453,Europe,710,42
2020-08-07,San_Marino,SM,0,0,34453,Europe,710,42
2020-08-08,San_Marino,SM,0,0,34453,Europe,710,42
2020-08-09,San_Marino,SM,0,0,34453,Europe,710,42
2020-08-10,San_Marino,SM,0,0,34453,Europe,710,42
2020-08-11,San_Marino,SM,0,0,34453,Europe,710,42
2020-08-12,San_Marino,SM,0,0,34453,Europe,710,42
2020-08-13,San_Marino,SM,0,0,34453,Europe,710,42
2020-08-14,San_Marino,SM,0,0,34453,Europe,710,42
2020-08-15,San_Marino,SM,0,0,34453,Europe,710,42
2020-08-16,San_Marino,SM,0,0,34453,Europe,710,42
2020-08-17,San_Marino,SM,0,0,34453,Europe,710,42
2020-08-18,San_Marino,SM,0,0,34453,Europe,710,42
2020-08-19,San_Marino,SM,0,0,34453,Europe,710,42
2020-08-20,San_Marino,SM,0,0,34453,Europe,710,42
2020-08-21,San_Marino,SM,0,0,34453,Europe,710,42
2020-08-22,San_Marino,SM,0,0,34453,Europe,710,42
2020-08-23,San_Marino,SM,0,0,34453,Europe,710,42
2020-08-24,San_Marino,SM,0,0,34453,Europe,710,42
2020-08-25,San_Marino,SM,0,0,34453,Europe,710,42
2020-08-26,San_Marino,SM,0,0,34453,Europe,710,42
2020-08-27,San_Marino,SM,0,0,34453,Europe,710,42
2020-08-28,San_Marino,SM,0,0,34453,Europe,710,42
2020-08-29,San_Marino,SM,0,0,34453,Europe,710,42
2020-08-30,San_Marino,SM,0,0,34453,Europe,710,42
2020-08-31,San_Marino,SM,0,0,34453,Europe,710,42
2020-09-01,San_Marino,SM,5,0,34453,Europe,715,42
2020-09-02,San_Marino,SM,0,0,34453,Europe,715,42
2020-09-03,San_Marino,SM,0,0,34453,Europe,715,42
2020-09-04,San_Marino,SM,0,0,34453,Europe,715,42
2020-09-05,San_Marino,SM,0,0,34453,Europe,715,42
2020-09-06,San_Marino,SM,1,0,34453,Europe,716,42
2020-09-07,San_Marino,SM,0,0,34453,Europe,716,42
2020-09-08,San_Marino,SM,0,0,34453,Europe,716,42
2020-09-09,San_Marino,SM,0,0,34453,Europe,716,42
2020-09-10,San_Marino,SM,6,0,34453,Europe,722,42
2020-09-11,San_Marino,SM,0,0,34453,Europe,722,42
2020-09-12,San_Marino,SM,0,0,34453,Europe,722,42
2020-09-13,San_Marino,SM,0,0,34453,Europe,722,42
2020-09-14,San_Marino,SM,0,0,34453,Europe,722,42
2020-09-15,San_Marino,SM,0,0,34453,Europe,722,42
2020-09-16,San_Marino,SM,1,0,34453,Europe,723,42
2020-09-17,San_Marino,SM,0,0,34453,Europe,723,42
2020-09-18,San_Marino,SM,0,0,34453,Europe,723,42
2020-09-19,San_Marino,SM,0,0,34453,Europe,723,42
2020-09-20,San_Marino,SM,0,0,34453,Europe,723,42
2020-09-21,San_Marino,SM,0,0,34453,Europe,723,42
2020-09-22,San_Marino,SM,0,0,34453,Europe,723,42
2020-09-23,San_Marino,SM,0,0,34453,Europe,723,42
2020-09-24,San_Marino,SM,0,0,34453,Europe,723,42
2020-09-25,San_Marino,SM,4,0,34453,Europe,727,42
2020-09-26,San_Marino,SM,0,0,34453,Europe,727,42
2020-09-27,San_Marino,SM,0,0,34453,Europe,727,42
2020-09-28,San_Marino,SM,0,0,34453,Europe,727,42
2020-09-29,San_Marino,SM,0,0,34453,Europe,727,42
2020-09-30,San_Marino,SM,0,0,34453,Europe,727,42
2020-10-01,San_Marino,SM,5,0,34453,Europe,732,42
2020-10-02,San_Marino,SM,0,0,34453,Europe,732,42
2020-10-03,San_Marino,SM,0,0,34453,Europe,732,42
2020-10-04,San_Marino,SM,0,0,34453,Europe,732,42
2020-10-05,San_Marino,SM,0,0,34453,Europe,732,42
2020-10-06,San_Marino,SM,0,0,34453,Europe,732,42
2020-10-07,San_Marino,SM,19,0,34453,Europe,751,42
2020-10-08,San_Marino,SM,0,0,34453,Europe,751,42
2020-10-09,San_Marino,SM,1,0,34453,Europe,752,42
2020-10-10,San_Marino,SM,0,0,34453,Europe,752,42
2020-10-11,San_Marino,SM,0,0,34453,Europe,752,42
2020-10-12,San_Marino,SM,0,0,34453,Europe,752,42
2020-10-13,San_Marino,SM,0,0,34453,Europe,752,42
2020-10-14,San_Marino,SM,0,0,34453,Europe,752,42
2020-10-15,San_Marino,SM,0,0,34453,Europe,752,42
2020-10-16,San_Marino,SM,7,0,34453,Europe,759,42
2020-10-17,San_Marino,SM,0,0,34453,Europe,759,42
2020-10-18,San_Marino,SM,0,0,34453,Europe,759,42
2020-10-19,San_Marino,SM,0,0,34453,Europe,759,42
2020-10-20,San_Marino,SM,7,0,34453,Europe,766,42
2020-10-21,San_Marino,SM,0,0,34453,Europe,766,42
2020-10-22,San_Marino,SM,8,0,34453,Europe,774,42
2020-10-23,San_Marino,SM,28,0,34453,Europe,802,42
2020-10-24,San_Marino,SM,17,0,34453,Europe,819,42
2020-10-25,San_Marino,SM,0,0,34453,Europe,819,42
2020-10-26,San_Marino,SM,0,0,34453,Europe,819,42
2020-10-27,San_Marino,SM,33,0,34453,Europe,852,42
2020-10-28,San_Marino,SM,0,0,34453,Europe,852,42
2020-10-29,San_Marino,SM,75,0,34453,Europe,927,42
2020-10-30,San_Marino,SM,1,0,34453,Europe,928,42
2020-10-31,San_Marino,SM,0,0,34453,Europe,928,42
2020-11-01,San_Marino,SM,0,0,34453,Europe,928,42
2020-11-02,San_Marino,SM,0,0,34453,Europe,928,42
2020-11-03,San_Marino,SM,0,0,34453,Europe,928,42
2020-11-04,San_Marino,SM,66,0,34453,Europe,994,42
2020-11-05,San_Marino,SM,0,0,34453,Europe,994,42
2020-11-06,San_Marino,SM,49,0,34453,Europe,1043,42
2020-11-07,San_Marino,SM,0,0,34453,Europe,1043,42
2020-11-08,San_Marino,SM,0,0,34453,Europe,1043,42
2020-11-09,San_Marino,SM,0,0,34453,Europe,1043,42
2020-11-10,San_Marino,SM,71,0,34453,Europe,1114,42
2020-11-11,San_Marino,SM,0,0,34453,Europe,1114,42
2020-11-12,San_Marino,SM,76,0,34453,Europe,1190,42
2020-11-13,San_Marino,SM,0,0,34453,Europe,1190,42
2020-11-14,San_Marino,SM,63,0,34453,Europe,1253,42
2020-11-15,San_Marino,SM,0,0,34453,Europe,1253,42
2020-11-16,San_Marino,SM,0,0,34453,Europe,1253,42
2020-11-17,San_Marino,SM,37,0,34453,Europe,1290,42
2020-11-18,San_Marino,SM,0,0,34453,Europe,1290,42
2020-11-19,San_Marino,SM,68,1,34453,Europe,1358,43
2020-11-20,San_Marino,SM,0,0,34453,Europe,1358,43
2020-11-21,San_Marino,SM,37,0,34453,Europe,1395,43
2020-11-22,San_Marino,SM,0,0,34453,Europe,1395,43
2020-11-23,San_Marino,SM,0,0,34453,Europe,1395,43
2020-11-24,San_Marino,SM,33,1,34453,Europe,1428,44
2020-11-25,San_Marino,SM,0,0,34453,Europe,1428,44
2020-11-26,San_Marino,SM,64,0,34453,Europe,1492,44
2020-11-27,San_Marino,SM,22,0,34453,Europe,1514,44
2020-11-28,San_Marino,SM,40,0,34453,Europe,1554,44
2020-11-29,San_Marino,SM,32,1,34453,Europe,1586,45
2020-11-30,San_Marino,SM,0,0,34453,Europe,1586,45
2020-12-01,San_Marino,SM,26,1,34453,Europe,1612,46
2020-12-02,San_Marino,SM,38,0,34453,Europe,1650,46
2020-12-03,San_Marino,SM,37,0,34453,Europe,1687,46
2020-12-04,San_Marino,SM,27,0,34453,Europe,1714,46
2020-12-05,San_Marino,SM,42,1,34453,Europe,1756,47
2020-12-06,San_Marino,SM,33,1,34453,Europe,1789,48
2020-12-07,San_Marino,SM,0,0,34453,Europe,1789,48
2020-12-08,San_Marino,SM,11,0,34453,Europe,1800,48
2020-12-09,San_Marino,SM,0,0,34453,Europe,1800,48
2020-12-10,San_Marino,SM,34,1,34453,Europe,1834,49
2020-12-11,San_Marino,SM,34,0,34453,Europe,1868,49
2020-12-12,San_Marino,SM,40,1,34453,Europe,1908,50
2020-12-13,San_Marino,SM,24,1,34453,Europe,1932,51
2020-12-14,San_Marino,SM,15,0,34453,Europe,1947,51
2020-03-03,Senegal,SN,1,0,16296362,Africa,1,0
2020-03-05,Senegal,SN,2,0,16296362,Africa,3,0
2020-03-06,Senegal,SN,1,0,16296362,Africa,4,0
2020-03-13,Senegal,SN,2,0,16296362,Africa,6,0
2020-03-14,Senegal,SN,13,0,16296362,Africa,19,0
2020-03-15,Senegal,SN,2,0,16296362,Africa,21,0
2020-03-16,Senegal,SN,5,0,16296362,Africa,26,0
2020-03-17,Senegal,SN,1,0,16296362,Africa,27,0
2020-03-18,Senegal,SN,4,0,16296362,Africa,31,0
2020-03-19,Senegal,SN,5,0,16296362,Africa,36,0
2020-03-20,Senegal,SN,0,0,16296362,Africa,36,0
2020-03-21,Senegal,SN,11,0,16296362,Africa,47,0
2020-03-22,Senegal,SN,9,0,16296362,Africa,56,0
2020-03-23,Senegal,SN,11,0,16296362,Africa,67,0
2020-03-24,Senegal,SN,12,0,16296362,Africa,79,0
2020-03-25,Senegal,SN,7,0,16296362,Africa,86,0
2020-03-26,Senegal,SN,13,0,16296362,Africa,99,0
2020-03-27,Senegal,SN,6,0,16296362,Africa,105,0
2020-03-28,Senegal,SN,14,0,16296362,Africa,119,0
2020-03-29,Senegal,SN,11,0,16296362,Africa,130,0
2020-03-30,Senegal,SN,12,0,16296362,Africa,142,0
2020-03-31,Senegal,SN,20,0,16296362,Africa,162,0
2020-04-01,Senegal,SN,13,0,16296362,Africa,175,0
2020-04-02,Senegal,SN,15,1,16296362,Africa,190,1
2020-04-03,Senegal,SN,5,0,16296362,Africa,195,1
2020-04-04,Senegal,SN,12,0,16296362,Africa,207,1
2020-04-05,Senegal,SN,12,1,16296362,Africa,219,2
2020-04-06,Senegal,SN,3,0,16296362,Africa,222,2
2020-04-07,Senegal,SN,4,0,16296362,Africa,226,2
2020-04-08,Senegal,SN,11,0,16296362,Africa,237,2
2020-04-09,Senegal,SN,7,0,16296362,Africa,244,2
2020-04-10,Senegal,SN,6,0,16296362,Africa,250,2
2020-04-11,Senegal,SN,15,0,16296362,Africa,265,2
2020-04-12,Senegal,SN,13,0,16296362,Africa,278,2
2020-04-13,Senegal,SN,2,0,16296362,Africa,280,2
2020-04-14,Senegal,SN,11,0,16296362,Africa,291,2
2020-04-15,Senegal,SN,8,0,16296362,Africa,299,2
2020-04-16,Senegal,SN,15,0,16296362,Africa,314,2
2020-04-17,Senegal,SN,21,0,16296362,Africa,335,2
2020-04-18,Senegal,SN,7,1,16296362,Africa,342,3
2020-04-19,Senegal,SN,8,0,16296362,Africa,350,3
2020-04-20,Senegal,SN,17,1,16296362,Africa,367,4
2020-04-21,Senegal,SN,10,1,16296362,Africa,377,5
2020-04-22,Senegal,SN,35,0,16296362,Africa,412,5
2020-04-23,Senegal,SN,30,1,16296362,Africa,442,6
2020-04-24,Senegal,SN,37,0,16296362,Africa,479,6
2020-04-25,Senegal,SN,66,1,16296362,Africa,545,7
2020-04-26,Senegal,SN,69,0,16296362,Africa,614,7
2020-04-27,Senegal,SN,57,2,16296362,Africa,671,9
2020-04-28,Senegal,SN,64,0,16296362,Africa,735,9
2020-04-29,Senegal,SN,88,0,16296362,Africa,823,9
2020-04-30,Senegal,SN,59,0,16296362,Africa,882,9
2020-05-01,Senegal,SN,51,0,16296362,Africa,933,9
2020-05-02,Senegal,SN,91,0,16296362,Africa,1024,9
2020-05-03,Senegal,SN,91,0,16296362,Africa,1115,9
2020-05-04,Senegal,SN,67,0,16296362,Africa,1182,9
2020-05-05,Senegal,SN,89,1,16296362,Africa,1271,10
2020-05-06,Senegal,SN,58,1,16296362,Africa,1329,11
2020-05-07,Senegal,SN,104,1,16296362,Africa,1433,12
2020-05-08,Senegal,SN,59,1,16296362,Africa,1492,13
2020-05-09,Senegal,SN,59,1,16296362,Africa,1551,14
2020-05-10,Senegal,SN,83,3,16296362,Africa,1634,17
2020-05-11,Senegal,SN,75,2,16296362,Africa,1709,19
2020-05-12,Senegal,SN,177,0,16296362,Africa,1886,19
2020-05-13,Senegal,SN,109,0,16296362,Africa,1995,19
2020-05-14,Senegal,SN,110,3,16296362,Africa,2105,22
2020-05-15,Senegal,SN,84,1,16296362,Africa,2189,23
2020-05-16,Senegal,SN,121,2,16296362,Africa,2310,25
2020-05-17,Senegal,SN,119,0,16296362,Africa,2429,25
2020-05-18,Senegal,SN,51,1,16296362,Africa,2480,26
2020-05-19,Senegal,SN,64,0,16296362,Africa,2544,26
2020-05-20,Senegal,SN,73,4,16296362,Africa,2617,30
2020-05-21,Senegal,SN,97,0,16296362,Africa,2714,30
2020-05-22,Senegal,SN,98,3,16296362,Africa,2812,33
2020-05-23,Senegal,SN,97,0,16296362,Africa,2909,33
2020-05-24,Senegal,SN,67,2,16296362,Africa,2976,35
2020-05-25,Senegal,SN,71,0,16296362,Africa,3047,35
2020-05-26,Senegal,SN,83,1,16296362,Africa,3130,36
2020-05-27,Senegal,SN,31,1,16296362,Africa,3161,37
2020-05-28,Senegal,SN,92,2,16296362,Africa,3253,39
2020-05-29,Senegal,SN,95,2,16296362,Africa,3348,41
2020-05-30,Senegal,SN,81,0,16296362,Africa,3429,41
2020-05-31,Senegal,SN,106,1,16296362,Africa,3535,42
2020-06-01,Senegal,SN,110,0,16296362,Africa,3645,42
2020-06-02,Senegal,SN,94,0,16296362,Africa,3739,42
2020-06-03,Senegal,SN,97,1,16296362,Africa,3836,43
2020-06-04,Senegal,SN,96,2,16296362,Africa,3932,45
2020-06-05,Senegal,SN,89,0,16296362,Africa,4021,45
2020-06-06,Senegal,SN,134,0,16296362,Africa,4155,45
2020-06-07,Senegal,SN,94,2,16296362,Africa,4249,47
2020-06-08,Senegal,SN,79,2,16296362,Africa,4328,49
2020-06-09,Senegal,SN,99,3,16296362,Africa,4427,52
2020-06-10,Senegal,SN,89,0,16296362,Africa,4516,52
2020-06-11,Senegal,SN,124,2,16296362,Africa,4640,54
2020-06-12,Senegal,SN,119,2,16296362,Africa,4759,56
2020-06-13,Senegal,SN,92,0,16296362,Africa,4851,56
2020-06-14,Senegal,SN,145,4,16296362,Africa,4996,60
2020-06-15,Senegal,SN,94,0,16296362,Africa,5090,60
2020-06-16,Senegal,SN,83,4,16296362,Africa,5173,64
2020-06-17,Senegal,SN,74,6,16296362,Africa,5247,70
2020-06-18,Senegal,SN,122,3,16296362,Africa,5369,73
2020-06-19,Senegal,SN,106,3,16296362,Africa,5475,76
2020-06-20,Senegal,SN,164,3,16296362,Africa,5639,79
2020-06-21,Senegal,SN,99,3,16296362,Africa,5738,82
2020-06-22,Senegal,SN,150,2,16296362,Africa,5888,84
2020-06-23,Senegal,SN,82,2,16296362,Africa,5970,86
2020-06-24,Senegal,SN,64,3,16296362,Africa,6034,89
2020-06-25,Senegal,SN,95,4,16296362,Africa,6129,93
2020-06-26,Senegal,SN,104,1,16296362,Africa,6233,94
2020-06-27,Senegal,SN,121,4,16296362,Africa,6354,98
2020-06-28,Senegal,SN,105,4,16296362,Africa,6459,102
2020-06-29,Senegal,SN,127,3,16296362,Africa,6586,105
2020-06-30,Senegal,SN,112,3,16296362,Africa,6698,108
2020-07-01,Senegal,SN,95,4,16296362,Africa,6793,112
2020-07-02,Senegal,SN,132,4,16296362,Africa,6925,116
2020-07-03,Senegal,SN,129,5,16296362,Africa,7054,121
2020-07-04,Senegal,SN,110,4,16296362,Africa,7164,125
2020-07-05,Senegal,SN,108,4,16296362,Africa,7272,129
2020-07-06,Senegal,SN,128,4,16296362,Africa,7400,133
2020-07-07,Senegal,SN,78,3,16296362,Africa,7478,136
2020-07-08,Senegal,SN,69,1,16296362,Africa,7547,137
2020-07-09,Senegal,SN,110,4,16296362,Africa,7657,141
2020-07-10,Senegal,SN,127,2,16296362,Africa,7784,143
2020-07-11,Senegal,SN,98,2,16296362,Africa,7882,145
2020-07-12,Senegal,SN,132,0,16296362,Africa,8014,145
2020-07-13,Senegal,SN,121,3,16296362,Africa,8135,148
2020-07-14,Senegal,SN,63,2,16296362,Africa,8198,150
2020-07-15,Senegal,SN,45,0,16296362,Africa,8243,150
2020-07-16,Senegal,SN,126,3,16296362,Africa,8369,153
2020-07-17,Senegal,SN,112,3,16296362,Africa,8481,156
2020-07-18,Senegal,SN,63,4,16296362,Africa,8544,160
2020-07-19,Senegal,SN,125,3,16296362,Africa,8669,163
2020-07-20,Senegal,SN,141,4,16296362,Africa,8810,167
2020-07-21,Senegal,SN,138,3,16296362,Africa,8948,170
2020-07-22,Senegal,SN,37,4,16296362,Africa,8985,174
2020-07-23,Senegal,SN,136,3,16296362,Africa,9121,177
2020-07-24,Senegal,SN,145,1,16296362,Africa,9266,178
2020-07-25,Senegal,SN,156,4,16296362,Africa,9422,182
2020-07-26,Senegal,SN,130,5,16296362,Africa,9552,187
2020-07-27,Senegal,SN,129,4,16296362,Africa,9681,191
2020-07-28,Senegal,SN,83,3,16296362,Africa,9764,194
2020-07-29,Senegal,SN,41,4,16296362,Africa,9805,198
2020-07-30,Senegal,SN,156,2,16296362,Africa,9961,200
2020-07-31,Senegal,SN,145,4,16296362,Africa,10106,204
2020-08-01,Senegal,SN,126,1,16296362,Africa,10232,205
2020-08-02,Senegal,SN,52,4,16296362,Africa,10284,209
2020-08-03,Senegal,SN,60,0,16296362,Africa,10344,209
2020-08-04,Senegal,SN,42,2,16296362,Africa,10386,211
2020-08-05,Senegal,SN,46,3,16296362,Africa,10432,214
2020-08-06,Senegal,SN,106,0,16296362,Africa,10538,214
2020-08-07,Senegal,SN,177,9,16296362,Africa,10715,223
2020-08-08,Senegal,SN,172,2,16296362,Africa,10887,225
2020-08-09,Senegal,SN,146,4,16296362,Africa,11033,229
2020-08-10,Senegal,SN,142,3,16296362,Africa,11175,232
2020-08-11,Senegal,SN,137,4,16296362,Africa,11312,236
2020-08-12,Senegal,SN,68,2,16296362,Africa,11380,238
2020-08-13,Senegal,SN,207,4,16296362,Africa,11587,242
2020-08-14,Senegal,SN,153,2,16296362,Africa,11740,244
2020-08-15,Senegal,SN,132,5,16296362,Africa,11872,249
2020-08-16,Senegal,SN,160,2,16296362,Africa,12032,251
2020-08-17,Senegal,SN,130,2,16296362,Africa,12162,253
2020-08-18,Senegal,SN,75,3,16296362,Africa,12237,256
2020-08-19,Senegal,SN,68,0,16296362,Africa,12305,256
2020-08-20,Senegal,SN,141,2,16296362,Africa,12446,258
2020-08-21,Senegal,SN,113,3,16296362,Africa,12559,261
2020-08-22,Senegal,SN,130,1,16296362,Africa,12689,262
2020-08-23,Senegal,SN,161,4,16296362,Africa,12850,266
2020-08-24,Senegal,SN,99,3,16296362,Africa,12949,269
2020-08-25,Senegal,SN,64,3,16296362,Africa,13013,272
2020-08-26,Senegal,SN,43,2,16296362,Africa,13056,274
2020-08-27,Senegal,SN,130,1,16296362,Africa,13186,275
2020-08-28,Senegal,SN,108,2,16296362,Africa,13294,277
2020-08-29,Senegal,SN,90,2,16296362,Africa,13384,279
2020-08-30,Senegal,SN,72,3,16296362,Africa,13456,282
2020-08-31,Senegal,SN,100,2,16296362,Africa,13556,284
2020-09-01,Senegal,SN,55,0,16296362,Africa,13611,284
2020-09-02,Senegal,SN,57,0,16296362,Africa,13668,284
2020-09-03,Senegal,SN,75,3,16296362,Africa,13743,287
2020-09-04,Senegal,SN,83,0,16296362,Africa,13826,287
2020-09-05,Senegal,SN,55,0,16296362,Africa,13881,287
2020-09-06,Senegal,SN,67,0,16296362,Africa,13948,287
2020-09-07,Senegal,SN,39,3,16296362,Africa,13987,290
2020-09-08,Senegal,SN,27,1,16296362,Africa,14014,291
2020-09-09,Senegal,SN,30,1,16296362,Africa,14044,292
2020-09-10,Senegal,SN,58,1,16296362,Africa,14102,293
2020-09-11,Senegal,SN,48,0,16296362,Africa,14150,293
2020-09-12,Senegal,SN,43,0,16296362,Africa,14193,293
2020-09-13,Senegal,SN,44,2,16296362,Africa,14237,295
2020-09-14,Senegal,SN,43,2,16296362,Africa,14280,297
2020-09-15,Senegal,SN,26,0,16296362,Africa,14306,297
2020-09-16,Senegal,SN,223,1,16296362,Africa,14529,298
2020-09-17,Senegal,SN,39,1,16296362,Africa,14568,299
2020-09-18,Senegal,SN,50,1,16296362,Africa,14618,300
2020-09-19,Senegal,SN,27,1,16296362,Africa,14645,301
2020-09-20,Senegal,SN,43,1,16296362,Africa,14688,302
2020-09-21,Senegal,SN,26,0,16296362,Africa,14714,302
2020-09-22,Senegal,SN,24,0,16296362,Africa,14738,302
2020-09-23,Senegal,SN,21,0,16296362,Africa,14759,302
2020-09-24,Senegal,SN,36,1,16296362,Africa,14795,303
2020-09-25,Senegal,SN,21,1,16296362,Africa,14816,304
2020-09-26,Senegal,SN,0,0,16296362,Africa,14816,304
2020-09-27,Senegal,SN,53,2,16296362,Africa,14869,306
2020-09-28,Senegal,SN,40,2,16296362,Africa,14909,308
2020-09-29,Senegal,SN,10,1,16296362,Africa,14919,309
2020-09-30,Senegal,SN,26,1,16296362,Africa,14945,310
2020-10-01,Senegal,SN,37,1,16296362,Africa,14982,311
2020-10-02,Senegal,SN,37,0,16296362,Africa,15019,311
2020-10-03,Senegal,SN,32,1,16296362,Africa,15051,312
2020-10-04,Senegal,SN,17,0,16296362,Africa,15068,312
2020-10-05,Senegal,SN,26,0,16296362,Africa,15094,312
2020-10-06,Senegal,SN,28,0,16296362,Africa,15122,312
2020-10-07,Senegal,SN,19,0,16296362,Africa,15141,312
2020-10-08,Senegal,SN,33,1,16296362,Africa,15174,313
2020-10-09,Senegal,SN,16,0,16296362,Africa,15190,313
2020-10-10,Senegal,SN,23,0,16296362,Africa,15213,313
2020-10-11,Senegal,SN,31,1,16296362,Africa,15244,314
2020-10-12,Senegal,SN,24,0,16296362,Africa,15268,314
2020-10-13,Senegal,SN,24,1,16296362,Africa,15292,315
2020-10-14,Senegal,SN,15,0,16296362,Africa,15307,315
2020-10-15,Senegal,SN,24,1,16296362,Africa,15331,316
2020-10-16,Senegal,SN,17,0,16296362,Africa,15348,316
2020-10-17,Senegal,SN,20,1,16296362,Africa,15368,317
2020-10-18,Senegal,SN,24,0,16296362,Africa,15392,317
2020-10-19,Senegal,SN,26,0,16296362,Africa,15418,317
2020-10-20,Senegal,SN,14,2,16296362,Africa,15432,319
2020-10-21,Senegal,SN,27,1,16296362,Africa,15459,320
2020-10-22,Senegal,SN,25,1,16296362,Africa,15484,321
2020-10-23,Senegal,SN,24,0,16296362,Africa,15508,321
2020-10-24,Senegal,SN,17,0,16296362,Africa,15525,321
2020-10-25,Senegal,SN,18,0,16296362,Africa,15543,321
2020-10-26,Senegal,SN,8,0,16296362,Africa,15551,321
2020-10-27,Senegal,SN,14,1,16296362,Africa,15565,322
2020-10-28,Senegal,SN,6,0,16296362,Africa,15571,322
2020-10-29,Senegal,SN,11,0,16296362,Africa,15582,322
2020-10-30,Senegal,SN,11,1,16296362,Africa,15593,323
2020-10-31,Senegal,SN,12,0,16296362,Africa,15605,323
2020-11-01,Senegal,SN,11,1,16296362,Africa,15616,324
2020-11-02,Senegal,SN,14,1,16296362,Africa,15630,325
2020-11-03,Senegal,SN,7,0,16296362,Africa,15637,325
2020-11-04,Senegal,SN,0,0,16296362,Africa,15637,325
2020-11-05,Senegal,SN,3,1,16296362,Africa,15640,326
2020-11-06,Senegal,SN,0,0,16296362,Africa,15640,326
2020-11-07,Senegal,SN,36,0,16296362,Africa,15676,326
2020-11-08,Senegal,SN,17,0,16296362,Africa,15693,326
2020-11-09,Senegal,SN,15,0,16296362,Africa,15708,326
2020-11-10,Senegal,SN,3,0,16296362,Africa,15711,326
2020-11-11,Senegal,SN,9,0,16296362,Africa,15720,326
2020-11-12,Senegal,SN,15,0,16296362,Africa,15735,326
2020-11-13,Senegal,SN,9,0,16296362,Africa,15744,326
2020-11-14,Senegal,SN,11,0,16296362,Africa,15755,326
2020-11-15,Senegal,SN,24,1,16296362,Africa,15779,327
2020-11-16,Senegal,SN,14,1,16296362,Africa,15793,328
2020-11-17,Senegal,SN,8,1,16296362,Africa,15801,329
2020-11-18,Senegal,SN,5,0,16296362,Africa,15806,329
2020-11-19,Senegal,SN,17,0,16296362,Africa,15823,329
2020-11-20,Senegal,SN,12,0,16296362,Africa,15835,329
2020-11-21,Senegal,SN,13,1,16296362,Africa,15848,330
2020-11-22,Senegal,SN,17,0,16296362,Africa,15865,330
2020-11-23,Senegal,SN,17,0,16296362,Africa,15882,330
2020-11-24,Senegal,SN,15,0,16296362,Africa,15897,330
2020-11-25,Senegal,SN,11,1,16296362,Africa,15908,331
2020-11-26,Senegal,SN,19,0,16296362,Africa,15927,331
2020-11-27,Senegal,SN,33,0,16296362,Africa,15960,331
2020-11-28,Senegal,SN,21,1,16296362,Africa,15981,332
2020-11-29,Senegal,SN,46,0,16296362,Africa,16027,332
2020-11-30,Senegal,SN,48,1,16296362,Africa,16075,333
2020-12-01,Senegal,SN,14,0,16296362,Africa,16089,333
2020-12-02,Senegal,SN,18,0,16296362,Africa,16107,333
2020-12-03,Senegal,SN,66,0,16296362,Africa,16173,333
2020-12-04,Senegal,SN,44,2,16296362,Africa,16217,335
2020-12-05,Senegal,SN,80,1,16296362,Africa,16297,336
2020-12-06,Senegal,SN,100,1,16296362,Africa,16397,337
2020-12-07,Senegal,SN,80,1,16296362,Africa,16477,338
2020-12-08,Senegal,SN,76,2,16296362,Africa,16553,340
2020-12-09,Senegal,SN,0,0,16296362,Africa,16553,340
2020-12-10,Senegal,SN,112,1,16296362,Africa,16665,341
2020-12-11,Senegal,SN,101,2,16296362,Africa,16766,343
2020-12-12,Senegal,SN,127,2,16296362,Africa,16893,345
2020-12-13,Senegal,SN,104,4,16296362,Africa,16997,349
2020-12-14,Senegal,SN,78,0,16296362,Africa,17075,349
2020-03-17,Somalia,SO,1,0,15442906,Africa,1,0
2020-03-18,Somalia,SO,0,0,15442906,Africa,1,0
2020-03-19,Somalia,SO,0,0,15442906,Africa,1,0
2020-03-20,Somalia,SO,0,0,15442906,Africa,1,0
2020-03-21,Somalia,SO,0,0,15442906,Africa,1,0
2020-03-22,Somalia,SO,0,0,15442906,Africa,1,0
2020-03-23,Somalia,SO,0,0,15442906,Africa,1,0
2020-03-24,Somalia,SO,0,0,15442906,Africa,1,0
2020-03-25,Somalia,SO,0,0,15442906,Africa,1,0
2020-03-26,Somalia,SO,0,0,15442906,Africa,1,0
2020-03-27,Somalia,SO,1,0,15442906,Africa,2,0
2020-03-28,Somalia,SO,1,0,15442906,Africa,3,0
2020-03-29,Somalia,SO,0,0,15442906,Africa,3,0
2020-03-30,Somalia,SO,0,0,15442906,Africa,3,0
2020-03-31,Somalia,SO,0,0,15442906,Africa,3,0
2020-04-01,Somalia,SO,0,0,15442906,Africa,3,0
2020-04-02,Somalia,SO,2,0,15442906,Africa,5,0
2020-04-03,Somalia,SO,0,0,15442906,Africa,5,0
2020-04-04,Somalia,SO,0,0,15442906,Africa,5,0
2020-04-05,Somalia,SO,2,0,15442906,Africa,7,0
2020-04-06,Somalia,SO,0,0,15442906,Africa,7,0
2020-04-07,Somalia,SO,0,0,15442906,Africa,7,0
2020-04-08,Somalia,SO,1,0,15442906,Africa,8,0
2020-04-09,Somalia,SO,0,0,15442906,Africa,8,0
2020-04-10,Somalia,SO,4,1,15442906,Africa,12,1
2020-04-11,Somalia,SO,9,0,15442906,Africa,21,1
2020-04-12,Somalia,SO,0,0,15442906,Africa,21,1
2020-04-13,Somalia,SO,4,1,15442906,Africa,25,2
2020-04-14,Somalia,SO,0,0,15442906,Africa,25,2
2020-04-15,Somalia,SO,35,0,15442906,Africa,60,2
2020-04-16,Somalia,SO,20,3,15442906,Africa,80,5
2020-04-17,Somalia,SO,0,0,15442906,Africa,80,5
2020-04-18,Somalia,SO,36,0,15442906,Africa,116,5
2020-04-19,Somalia,SO,19,2,15442906,Africa,135,7
2020-04-20,Somalia,SO,29,0,15442906,Africa,164,7
2020-04-21,Somalia,SO,73,1,15442906,Africa,237,8
2020-04-22,Somalia,SO,49,0,15442906,Africa,286,8
2020-04-23,Somalia,SO,0,6,15442906,Africa,286,14
2020-04-24,Somalia,SO,42,0,15442906,Africa,328,14
2020-04-25,Somalia,SO,0,2,15442906,Africa,328,16
2020-04-26,Somalia,SO,62,2,15442906,Africa,390,18
2020-04-27,Somalia,SO,46,5,15442906,Africa,436,23
2020-04-28,Somalia,SO,44,3,15442906,Africa,480,26
2020-04-29,Somalia,SO,48,2,15442906,Africa,528,28
2020-04-30,Somalia,SO,54,0,15442906,Africa,582,28
2020-05-01,Somalia,SO,19,0,15442906,Africa,601,28
2020-05-02,Somalia,SO,0,0,15442906,Africa,601,28
2020-05-03,Somalia,SO,70,3,15442906,Africa,671,31
2020-05-04,Somalia,SO,51,1,15442906,Africa,722,32
2020-05-05,Somalia,SO,34,3,15442906,Africa,756,35
2020-05-06,Somalia,SO,79,3,15442906,Africa,835,38
2020-05-07,Somalia,SO,38,1,15442906,Africa,873,39
2020-05-08,Somalia,SO,55,5,15442906,Africa,928,44
2020-05-09,Somalia,SO,0,0,15442906,Africa,928,44
2020-05-10,Somalia,SO,69,4,15442906,Africa,997,48
2020-05-11,Somalia,SO,57,3,15442906,Africa,1054,51
2020-05-12,Somalia,SO,35,1,15442906,Africa,1089,52
2020-05-13,Somalia,SO,81,0,15442906,Africa,1170,52
2020-05-14,Somalia,SO,49,0,15442906,Africa,1219,52
2020-05-15,Somalia,SO,65,1,15442906,Africa,1284,53
2020-05-16,Somalia,SO,0,0,15442906,Africa,1284,53
2020-05-17,Somalia,SO,73,2,15442906,Africa,1357,55
2020-05-18,Somalia,SO,64,1,15442906,Africa,1421,56
2020-05-19,Somalia,SO,34,1,15442906,Africa,1455,57
2020-05-20,Somalia,SO,47,2,15442906,Africa,1502,59
2020-05-21,Somalia,SO,71,2,15442906,Africa,1573,61
2020-05-22,Somalia,SO,21,0,15442906,Africa,1594,61
2020-05-23,Somalia,SO,0,0,15442906,Africa,1594,61
2020-05-24,Somalia,SO,0,0,15442906,Africa,1594,61
2020-05-25,Somalia,SO,0,0,15442906,Africa,1594,61
2020-05-26,Somalia,SO,95,5,15442906,Africa,1689,66
2020-05-27,Somalia,SO,22,1,15442906,Africa,1711,67
2020-05-28,Somalia,SO,20,0,15442906,Africa,1731,67
2020-05-29,Somalia,SO,97,5,15442906,Africa,1828,72
2020-05-30,Somalia,SO,0,0,15442906,Africa,1828,72
2020-05-31,Somalia,SO,88,1,15442906,Africa,1916,73
2020-06-01,Somalia,SO,60,5,15442906,Africa,1976,78
2020-06-02,Somalia,SO,47,1,15442906,Africa,2023,79
2020-06-03,Somalia,SO,66,0,15442906,Africa,2089,79
2020-06-04,Somalia,SO,57,0,15442906,Africa,2146,79
2020-06-05,Somalia,SO,58,0,15442906,Africa,2204,79
2020-06-06,Somalia,SO,0,0,15442906,Africa,2204,79
2020-06-07,Somalia,SO,85,3,15442906,Africa,2289,82
2020-06-08,Somalia,SO,45,1,15442906,Africa,2334,83
2020-06-09,Somalia,SO,34,1,15442906,Africa,2368,84
2020-06-10,Somalia,SO,48,1,15442906,Africa,2416,85
2020-06-11,Somalia,SO,36,0,15442906,Africa,2452,85
2020-06-12,Somalia,SO,61,0,15442906,Africa,2513,85
2020-06-13,Somalia,SO,0,0,15442906,Africa,2513,85
2020-06-14,Somalia,SO,66,2,15442906,Africa,2579,87
2020-06-15,Somalia,SO,24,1,15442906,Africa,2603,88
2020-06-16,Somalia,SO,39,0,15442906,Africa,2642,88
2020-06-17,Somalia,SO,16,0,15442906,Africa,2658,88
2020-06-18,Somalia,SO,38,0,15442906,Africa,2696,88
2020-06-19,Somalia,SO,23,0,15442906,Africa,2719,88
2020-06-20,Somalia,SO,0,0,15442906,Africa,2719,88
2020-06-21,Somalia,SO,36,0,15442906,Africa,2755,88
2020-06-22,Somalia,SO,24,2,15442906,Africa,2779,90
2020-06-23,Somalia,SO,33,0,15442906,Africa,2812,90
2020-06-24,Somalia,SO,23,0,15442906,Africa,2835,90
2020-06-25,Somalia,SO,25,0,15442906,Africa,2860,90
2020-06-26,Somalia,SO,18,0,15442906,Africa,2878,90
2020-06-27,Somalia,SO,0,0,15442906,Africa,2878,90
2020-06-28,Somalia,SO,0,0,15442906,Africa,2878,90
2020-06-29,Somalia,SO,16,0,15442906,Africa,2894,90
2020-06-30,Somalia,SO,10,0,15442906,Africa,2904,90
2020-07-01,Somalia,SO,20,0,15442906,Africa,2924,90
2020-07-02,Somalia,SO,0,0,15442906,Africa,2924,90
2020-07-03,Somalia,SO,20,0,15442906,Africa,2944,90
2020-07-04,Somalia,SO,0,0,15442906,Africa,2944,90
2020-07-05,Somalia,SO,17,2,15442906,Africa,2961,92
2020-07-06,Somalia,SO,36,0,15442906,Africa,2997,92
2020-07-07,Somalia,SO,9,0,15442906,Africa,3006,92
2020-07-08,Somalia,SO,9,0,15442906,Africa,3015,92
2020-07-09,Somalia,SO,13,0,15442906,Africa,3028,92
2020-07-10,Somalia,SO,10,0,15442906,Africa,3038,92
2020-07-11,Somalia,SO,0,0,15442906,Africa,3038,92
2020-07-12,Somalia,SO,13,0,15442906,Africa,3051,92
2020-07-13,Somalia,SO,8,1,15442906,Africa,3059,93
2020-07-14,Somalia,SO,0,0,15442906,Africa,3059,93
2020-07-15,Somalia,SO,17,0,15442906,Africa,3076,93
2020-07-16,Somalia,SO,7,0,15442906,Africa,3083,93
2020-07-17,Somalia,SO,0,0,15442906,Africa,3083,93
2020-07-18,Somalia,SO,23,0,15442906,Africa,3106,93
2020-07-19,Somalia,SO,5,0,15442906,Africa,3111,93
2020-07-20,Somalia,SO,8,0,15442906,Africa,3119,93
2020-07-21,Somalia,SO,11,0,15442906,Africa,3130,93
2020-07-22,Somalia,SO,5,0,15442906,Africa,3135,93
2020-07-23,Somalia,SO,26,0,15442906,Africa,3161,93
2020-07-24,Somalia,SO,10,0,15442906,Africa,3171,93
2020-07-25,Somalia,SO,0,0,15442906,Africa,3171,93
2020-07-26,Somalia,SO,7,0,15442906,Africa,3178,93
2020-07-27,Somalia,SO,0,0,15442906,Africa,3178,93
2020-07-28,Somalia,SO,0,0,15442906,Africa,3178,93
2020-07-29,Somalia,SO,18,0,15442906,Africa,3196,93
2020-07-30,Somalia,SO,16,0,15442906,Africa,3212,93
2020-07-31,Somalia,SO,0,0,15442906,Africa,3212,93
2020-08-01,Somalia,SO,0,0,15442906,Africa,3212,93
2020-08-02,Somalia,SO,0,0,15442906,Africa,3212,93
2020-08-03,Somalia,SO,0,0,15442906,Africa,3212,93
2020-08-04,Somalia,SO,8,0,15442906,Africa,3220,93
2020-08-05,Somalia,SO,0,0,15442906,Africa,3220,93
2020-08-06,Somalia,SO,1,0,15442906,Africa,3221,93
2020-08-07,Somalia,SO,6,0,15442906,Africa,3227,93
2020-08-08,Somalia,SO,0,0,15442906,Africa,3227,93
2020-08-09,Somalia,SO,0,0,15442906,Africa,3227,93
2020-08-10,Somalia,SO,0,0,15442906,Africa,3227,93
2020-08-11,Somalia,SO,0,0,15442906,Africa,3227,93
2020-08-12,Somalia,SO,0,0,15442906,Africa,3227,93
2020-08-13,Somalia,SO,0,0,15442906,Africa,3227,93
2020-08-14,Somalia,SO,0,0,15442906,Africa,3227,93
2020-08-15,Somalia,SO,23,0,15442906,Africa,3250,93
2020-08-16,Somalia,SO,6,0,15442906,Africa,3256,93
2020-08-17,Somalia,SO,0,0,15442906,Africa,3256,93
2020-08-18,Somalia,SO,1,0,15442906,Africa,3257,93
2020-08-19,Somalia,SO,0,0,15442906,Africa,3257,93
2020-08-20,Somalia,SO,8,0,15442906,Africa,3265,93
2020-08-21,Somalia,SO,0,0,15442906,Africa,3265,93
2020-08-22,Somalia,SO,0,0,15442906,Africa,3265,93
2020-08-23,Somalia,SO,4,0,15442906,Africa,3269,93
2020-08-24,Somalia,SO,0,0,15442906,Africa,3269,93
2020-08-25,Somalia,SO,0,0,15442906,Africa,3269,93
2020-08-26,Somalia,SO,6,2,15442906,Africa,3275,95
2020-08-27,Somalia,SO,0,0,15442906,Africa,3275,95
2020-08-28,Somalia,SO,0,0,15442906,Africa,3275,95
2020-08-29,Somalia,SO,0,0,15442906,Africa,3275,95
2020-08-30,Somalia,SO,35,2,15442906,Africa,3310,97
2020-08-31,Somalia,SO,0,0,15442906,Africa,3310,97
2020-09-01,Somalia,SO,0,0,15442906,Africa,3310,97
2020-09-02,Somalia,SO,0,0,15442906,Africa,3310,97
2020-09-03,Somalia,SO,0,0,15442906,Africa,3310,97
2020-09-04,Somalia,SO,0,0,15442906,Africa,3310,97
2020-09-05,Somalia,SO,22,0,15442906,Africa,3332,97
2020-09-06,Somalia,SO,0,0,15442906,Africa,3332,97
2020-09-07,Somalia,SO,30,0,15442906,Africa,3362,97
2020-09-08,Somalia,SO,0,0,15442906,Africa,3362,97
2020-09-09,Somalia,SO,0,0,15442906,Africa,3362,97
2020-09-10,Somalia,SO,9,0,15442906,Africa,3371,97
2020-09-11,Somalia,SO,0,0,15442906,Africa,3371,97
2020-09-12,Somalia,SO,5,1,15442906,Africa,3376,98
2020-09-13,Somalia,SO,0,0,15442906,Africa,3376,98
2020-09-14,Somalia,SO,13,0,15442906,Africa,3389,98
2020-09-15,Somalia,SO,0,0,15442906,Africa,3389,98
2020-09-16,Somalia,SO,0,0,15442906,Africa,3389,98
2020-09-17,Somalia,SO,1,0,15442906,Africa,3390,98
2020-09-18,Somalia,SO,0,0,15442906,Africa,3390,98
2020-09-19,Somalia,SO,0,0,15442906,Africa,3390,98
2020-09-20,Somalia,SO,52,0,15442906,Africa,3442,98
2020-09-21,Somalia,SO,0,0,15442906,Africa,3442,98
2020-09-22,Somalia,SO,23,0,15442906,Africa,3465,98
2020-09-23,Somalia,SO,0,0,15442906,Africa,3465,98
2020-09-24,Somalia,SO,0,0,15442906,Africa,3465,98
2020-09-25,Somalia,SO,0,0,15442906,Africa,3465,98
2020-09-26,Somalia,SO,0,0,15442906,Africa,3465,98
2020-09-27,Somalia,SO,123,1,15442906,Africa,3588,99
2020-09-28,Somalia,SO,0,0,15442906,Africa,3588,99
2020-09-29,Somalia,SO,0,0,15442906,Africa,3588,99
2020-09-30,Somalia,SO,0,0,15442906,Africa,3588,99
2020-10-01,Somalia,SO,0,0,15442906,Africa,3588,99
2020-10-02,Somalia,SO,5,0,15442906,Africa,3593,99
2020-10-03,Somalia,SO,0,0,15442906,Africa,3593,99
2020-10-04,Somalia,SO,152,0,15442906,Africa,3745,99
2020-10-05,Somalia,SO,0,0,15442906,Africa,3745,99
2020-10-06,Somalia,SO,0,0,15442906,Africa,3745,99
2020-10-07,Somalia,SO,0,0,15442906,Africa,3745,99
2020-10-08,Somalia,SO,0,0,15442906,Africa,3745,99
2020-10-09,Somalia,SO,0,0,15442906,Africa,3745,99
2020-10-10,Somalia,SO,102,0,15442906,Africa,3847,99
2020-10-11,Somalia,SO,0,0,15442906,Africa,3847,99
2020-10-12,Somalia,SO,17,0,15442906,Africa,3864,99
2020-10-13,Somalia,SO,0,0,15442906,Africa,3864,99
2020-10-14,Somalia,SO,0,0,15442906,Africa,3864,99
2020-10-15,Somalia,SO,0,0,15442906,Africa,3864,99
2020-10-16,Somalia,SO,0,0,15442906,Africa,3864,99
2020-10-17,Somalia,SO,0,0,15442906,Africa,3864,99
2020-10-18,Somalia,SO,0,0,15442906,Africa,3864,99
2020-10-19,Somalia,SO,0,0,15442906,Africa,3864,99
2020-10-20,Somalia,SO,26,2,15442906,Africa,3890,101
2020-10-21,Somalia,SO,0,0,15442906,Africa,3890,101
2020-10-22,Somalia,SO,0,0,15442906,Africa,3890,101
2020-10-23,Somalia,SO,7,1,15442906,Africa,3897,102
2020-10-24,Somalia,SO,0,0,15442906,Africa,3897,102
2020-10-25,Somalia,SO,0,0,15442906,Africa,3897,102
2020-10-26,Somalia,SO,44,2,15442906,Africa,3941,104
2020-10-27,Somalia,SO,0,0,15442906,Africa,3941,104
2020-10-28,Somalia,SO,0,0,15442906,Africa,3941,104
2020-10-29,Somalia,SO,0,0,15442906,Africa,3941,104
2020-10-30,Somalia,SO,0,0,15442906,Africa,3941,104
2020-10-31,Somalia,SO,0,0,15442906,Africa,3941,104
2020-11-01,Somalia,SO,0,0,15442906,Africa,3941,104
2020-11-02,Somalia,SO,0,0,15442906,Africa,3941,104
2020-11-03,Somalia,SO,0,0,15442906,Africa,3941,104
2020-11-04,Somalia,SO,288,3,15442906,Africa,4229,107
2020-11-05,Somalia,SO,0,0,15442906,Africa,4229,107
2020-11-06,Somalia,SO,0,0,15442906,Africa,4229,107
2020-11-07,Somalia,SO,0,0,15442906,Africa,4229,107
2020-11-08,Somalia,SO,0,0,15442906,Africa,4229,107
2020-11-09,Somalia,SO,0,0,15442906,Africa,4229,107
2020-11-10,Somalia,SO,72,0,15442906,Africa,4301,107
2020-11-11,Somalia,SO,0,0,15442906,Africa,4301,107
2020-11-12,Somalia,SO,0,0,15442906,Africa,4301,107
2020-11-13,Somalia,SO,0,0,15442906,Africa,4301,107
2020-11-14,Somalia,SO,0,0,15442906,Africa,4301,107
2020-11-15,Somalia,SO,0,0,15442906,Africa,4301,107
2020-11-16,Somalia,SO,0,0,15442906,Africa,4301,107
2020-11-17,Somalia,SO,81,1,15442906,Africa,4382,108
2020-11-18,Somalia,SO,0,0,15442906,Africa,4382,108
2020-11-19,Somalia,SO,0,0,15442906,Africa,4382,108
2020-11-20,Somalia,SO,0,0,15442906,Africa,4382,108
2020-11-21,Somalia,SO,0,0,15442906,Africa,4382,108
2020-11-22,Somalia,SO,0,0,15442906,Africa,4382,108
2020-11-23,Somalia,SO,63,5,15442906,Africa,4445,113
2020-11-24,Somalia,SO,0,0,15442906,Africa,4445,113
2020-11-25,Somalia,SO,0,0,15442906,Africa,4445,113
2020-11-26,Somalia,SO,0,0,15442906,Africa,4445,113
2020-11-27,Somalia,SO,0,0,15442906,Africa,4445,113
2020-11-28,Somalia,SO,0,0,15442906,Africa,4445,113
2020-11-29,Somalia,SO,0,0,15442906,Africa,4445,113
2020-11-30,Somalia,SO,0,0,15442906,Africa,4445,113
2020-12-01,Somalia,SO,0,0,15442906,Africa,4445,113
2020-12-02,Somalia,SO,80,8,15442906,Africa,4525,121
2020-12-03,Somalia,SO,0,0,15442906,Africa,4525,121
2020-12-04,Somalia,SO,0,0,15442906,Africa,4525,121
2020-12-05,Somalia,SO,0,0,15442906,Africa,4525,121
2020-12-06,Somalia,SO,0,0,15442906,Africa,4525,121
2020-12-07,Somalia,SO,0,0,15442906,Africa,4525,121
2020-12-08,Somalia,SO,54,0,15442906,Africa,4579,121
2020-12-09,Somalia,SO,0,0,15442906,Africa,4579,121
2020-12-10,Somalia,SO,0,0,15442906,Africa,4579,121
2020-12-11,Somalia,SO,0,0,15442906,Africa,4579,121
2020-12-12,Somalia,SO,0,0,15442906,Africa,4579,121
2020-12-13,Somalia,SO,0,0,15442906,Africa,4579,121
2020-12-14,Somalia,SO,0,0,15442906,Africa,4579,121
2020-03-15,Suriname,SR,1,0,581363,America,1,0
2020-03-21,Suriname,SR,0,0,581363,America,1,0
2020-03-22,Suriname,SR,4,0,581363,America,5,0
2020-03-23,Suriname,SR,0,0,581363,America,5,0
2020-03-24,Suriname,SR,1,0,581363,America,6,0
2020-03-25,Suriname,SR,2,0,581363,America,8,0
2020-03-26,Suriname,SR,0,0,581363,America,8,0
2020-03-27,Suriname,SR,0,0,581363,America,8,0
2020-03-28,Suriname,SR,0,0,581363,America,8,0
2020-03-29,Suriname,SR,0,0,581363,America,8,0
2020-03-30,Suriname,SR,0,0,581363,America,8,0
2020-03-31,Suriname,SR,0,0,581363,America,8,0
2020-04-01,Suriname,SR,2,0,581363,America,10,0
2020-04-02,Suriname,SR,0,0,581363,America,10,0
2020-04-03,Suriname,SR,0,0,581363,America,10,0
2020-04-04,Suriname,SR,0,1,581363,America,10,1
2020-04-05,Suriname,SR,0,0,581363,America,10,1
2020-04-06,Suriname,SR,0,0,581363,America,10,1
2020-04-07,Suriname,SR,0,0,581363,America,10,1
2020-04-08,Suriname,SR,0,0,581363,America,10,1
2020-04-09,Suriname,SR,0,0,581363,America,10,1
2020-04-10,Suriname,SR,0,0,581363,America,10,1
2020-04-11,Suriname,SR,0,0,581363,America,10,1
2020-04-12,Suriname,SR,0,0,581363,America,10,1
2020-04-13,Suriname,SR,0,0,581363,America,10,1
2020-04-14,Suriname,SR,0,0,581363,America,10,1
2020-04-15,Suriname,SR,0,0,581363,America,10,1
2020-04-16,Suriname,SR,0,0,581363,America,10,1
2020-04-17,Suriname,SR,0,0,581363,America,10,1
2020-04-18,Suriname,SR,0,0,581363,America,10,1
2020-04-19,Suriname,SR,0,0,581363,America,10,1
2020-04-20,Suriname,SR,0,0,581363,America,10,1
2020-04-21,Suriname,SR,0,0,581363,America,10,1
2020-04-22,Suriname,SR,0,0,581363,America,10,1
2020-04-23,Suriname,SR,0,0,581363,America,10,1
2020-04-24,Suriname,SR,0,0,581363,America,10,1
2020-04-25,Suriname,SR,0,0,581363,America,10,1
2020-04-26,Suriname,SR,0,0,581363,America,10,1
2020-04-27,Suriname,SR,0,0,581363,America,10,1
2020-04-28,Suriname,SR,0,0,581363,America,10,1
2020-04-29,Suriname,SR,0,0,581363,America,10,1
2020-04-30,Suriname,SR,0,0,581363,America,10,1
2020-05-01,Suriname,SR,0,0,581363,America,10,1
2020-05-02,Suriname,SR,0,0,581363,America,10,1
2020-05-03,Suriname,SR,0,0,581363,America,10,1
2020-05-04,Suriname,SR,0,0,581363,America,10,1
2020-05-05,Suriname,SR,0,0,581363,America,10,1
2020-05-06,Suriname,SR,0,0,581363,America,10,1
2020-05-07,Suriname,SR,0,0,581363,America,10,1
2020-05-08,Suriname,SR,0,0,581363,America,10,1
2020-05-09,Suriname,SR,0,0,581363,America,10,1
2020-05-10,Suriname,SR,0,0,581363,America,10,1
2020-05-11,Suriname,SR,0,0,581363,America,10,1
2020-05-12,Suriname,SR,0,0,581363,America,10,1
2020-05-13,Suriname,SR,0,0,581363,America,10,1
2020-05-14,Suriname,SR,0,0,581363,America,10,1
2020-05-15,Suriname,SR,0,0,581363,America,10,1
2020-05-16,Suriname,SR,0,0,581363,America,10,1
2020-05-17,Suriname,SR,0,0,581363,America,10,1
2020-05-18,Suriname,SR,0,0,581363,America,10,1
2020-05-19,Suriname,SR,1,0,581363,America,11,1
2020-05-20,Suriname,SR,0,0,581363,America,11,1
2020-05-21,Suriname,SR,0,0,581363,America,11,1
2020-05-22,Suriname,SR,0,0,581363,America,11,1
2020-05-23,Suriname,SR,0,0,581363,America,11,1
2020-05-24,Suriname,SR,0,0,581363,America,11,1
2020-05-25,Suriname,SR,0,0,581363,America,11,1
2020-05-26,Suriname,SR,0,0,581363,America,11,1
2020-05-27,Suriname,SR,0,0,581363,America,11,1
2020-05-28,Suriname,SR,1,0,581363,America,12,1
2020-05-29,Suriname,SR,0,0,581363,America,12,1
2020-05-30,Suriname,SR,0,0,581363,America,12,1
2020-05-31,Suriname,SR,2,0,581363,America,14,1
2020-06-01,Suriname,SR,9,0,581363,America,23,1
2020-06-02,Suriname,SR,21,0,581363,America,44,1
2020-06-03,Suriname,SR,10,0,581363,America,54,1
2020-06-04,Suriname,SR,20,0,581363,America,74,1
2020-06-05,Suriname,SR,8,0,581363,America,82,1
2020-06-06,Suriname,SR,9,0,581363,America,91,1
2020-06-07,Suriname,SR,9,0,581363,America,100,1
2020-06-08,Suriname,SR,22,0,581363,America,122,1
2020-06-09,Suriname,SR,8,1,581363,America,130,2
2020-06-10,Suriname,SR,7,0,581363,America,137,2
2020-06-11,Suriname,SR,0,0,581363,America,137,2
2020-06-12,Suriname,SR,31,0,581363,America,168,2
2020-06-13,Suriname,SR,19,1,581363,America,187,3
2020-06-14,Suriname,SR,9,0,581363,America,196,3
2020-06-15,Suriname,SR,12,0,581363,America,208,3
2020-06-16,Suriname,SR,21,2,581363,America,229,5
2020-06-17,Suriname,SR,7,1,581363,America,236,6
2020-06-18,Suriname,SR,25,0,581363,America,261,6
2020-06-19,Suriname,SR,16,1,581363,America,277,7
2020-06-20,Suriname,SR,16,1,581363,America,293,8
2020-06-21,Suriname,SR,9,0,581363,America,302,8
2020-06-22,Suriname,SR,12,0,581363,America,314,8
2020-06-23,Suriname,SR,5,0,581363,America,319,8
2020-06-24,Suriname,SR,0,1,581363,America,319,9
2020-06-25,Suriname,SR,38,1,581363,America,357,10
2020-06-26,Suriname,SR,16,0,581363,America,373,10
2020-06-27,Suriname,SR,18,0,581363,America,391,10
2020-06-28,Suriname,SR,0,0,581363,America,391,10
2020-06-29,Suriname,SR,99,1,581363,America,490,11
2020-06-30,Suriname,SR,11,2,581363,America,501,13
2020-07-01,Suriname,SR,16,0,581363,America,517,13
2020-07-02,Suriname,SR,18,0,581363,America,535,13
2020-07-03,Suriname,SR,12,0,581363,America,547,13
2020-07-04,Suriname,SR,14,0,581363,America,561,13
2020-07-05,Suriname,SR,4,1,581363,America,565,14
2020-07-06,Suriname,SR,29,0,581363,America,594,14
2020-07-07,Suriname,SR,20,0,581363,America,614,14
2020-07-08,Suriname,SR,0,0,581363,America,614,14
2020-07-09,Suriname,SR,51,3,581363,America,665,17
2020-07-10,Suriname,SR,29,0,581363,America,694,17
2020-07-11,Suriname,SR,32,1,581363,America,726,18
2020-07-12,Suriname,SR,15,0,581363,America,741,18
2020-07-13,Suriname,SR,0,0,581363,America,741,18
2020-07-14,Suriname,SR,39,0,581363,America,780,18
2020-07-15,Suriname,SR,21,0,581363,America,801,18
2020-07-16,Suriname,SR,48,0,581363,America,849,18
2020-07-17,Suriname,SR,69,0,581363,America,918,18
2020-07-18,Suriname,SR,25,1,581363,America,943,19
2020-07-19,Suriname,SR,58,1,581363,America,1001,20
2020-07-20,Suriname,SR,28,1,581363,America,1029,21
2020-07-21,Suriname,SR,50,0,581363,America,1079,21
2020-07-22,Suriname,SR,52,0,581363,America,1131,21
2020-07-23,Suriname,SR,45,0,581363,America,1176,21
2020-07-24,Suriname,SR,58,2,581363,America,1234,23
2020-07-25,Suriname,SR,71,0,581363,America,1305,23
2020-07-26,Suriname,SR,76,0,581363,America,1381,23
2020-07-27,Suriname,SR,58,0,581363,America,1439,23
2020-07-28,Suriname,SR,44,1,581363,America,1483,24
2020-07-29,Suriname,SR,27,0,581363,America,1510,24
2020-07-30,Suriname,SR,97,2,581363,America,1607,26
2020-07-31,Suriname,SR,43,0,581363,America,1650,26
2020-08-01,Suriname,SR,56,0,581363,America,1706,26
2020-08-02,Suriname,SR,54,0,581363,America,1760,26
2020-08-03,Suriname,SR,89,1,581363,America,1849,27
2020-08-04,Suriname,SR,44,0,581363,America,1893,27
2020-08-05,Suriname,SR,88,0,581363,America,1981,27
2020-08-06,Suriname,SR,69,0,581363,America,2050,27
2020-08-07,Suriname,SR,46,2,581363,America,2096,29
2020-08-08,Suriname,SR,107,0,581363,America,2203,29
2020-08-09,Suriname,SR,103,0,581363,America,2306,29
2020-08-10,Suriname,SR,85,0,581363,America,2391,29
2020-08-11,Suriname,SR,98,1,581363,America,2489,30
2020-08-12,Suriname,SR,70,9,581363,America,2559,39
2020-08-13,Suriname,SR,94,0,581363,America,2653,39
2020-08-14,Suriname,SR,108,1,581363,America,2761,40
2020-08-15,Suriname,SR,77,1,581363,America,2838,41
2020-08-16,Suriname,SR,123,1,581363,America,2961,42
2020-08-17,Suriname,SR,55,5,581363,America,3016,47
2020-08-18,Suriname,SR,61,1,581363,America,3077,48
2020-08-19,Suriname,SR,139,6,581363,America,3216,54
2020-08-20,Suriname,SR,79,0,581363,America,3295,54
2020-08-21,Suriname,SR,71,1,581363,America,3366,55
2020-08-22,Suriname,SR,94,1,581363,America,3460,56
2020-08-23,Suriname,SR,109,1,581363,America,3569,57
2020-08-24,Suriname,SR,38,1,581363,America,3607,58
2020-08-25,Suriname,SR,25,2,581363,America,3632,60
2020-08-26,Suriname,SR,66,1,581363,America,3698,61
2020-08-27,Suriname,SR,26,1,581363,America,3724,62
2020-08-28,Suriname,SR,69,4,581363,America,3793,66
2020-08-29,Suriname,SR,55,0,581363,America,3848,66
2020-08-30,Suriname,SR,106,1,581363,America,3954,67
2020-08-31,Suriname,SR,55,0,581363,America,4009,67
2020-09-01,Suriname,SR,25,4,581363,America,4034,71
2020-09-02,Suriname,SR,55,1,581363,America,4089,72
2020-09-03,Suriname,SR,60,0,581363,America,4149,72
2020-09-04,Suriname,SR,66,1,581363,America,4215,73
2020-09-05,Suriname,SR,37,2,581363,America,4252,75
2020-09-06,Suriname,SR,68,2,581363,America,4320,77
2020-09-07,Suriname,SR,26,8,581363,America,4346,85
2020-09-08,Suriname,SR,14,6,581363,America,4360,91
2020-09-09,Suriname,SR,59,0,581363,America,4419,91
2020-09-10,Suriname,SR,28,1,581363,America,4447,92
2020-09-11,Suriname,SR,30,1,581363,America,4477,93
2020-09-12,Suriname,SR,52,0,581363,America,4529,93
2020-09-13,Suriname,SR,50,0,581363,America,4579,93
2020-09-14,Suriname,SR,3,0,581363,America,4582,93
2020-09-15,Suriname,SR,29,2,581363,America,4611,95
2020-09-16,Suriname,SR,14,0,581363,America,4625,95
2020-09-17,Suriname,SR,20,0,581363,America,4645,95
2020-09-18,Suriname,SR,26,0,581363,America,4671,95
2020-09-19,Suriname,SR,20,1,581363,America,4691,96
2020-09-20,Suriname,SR,18,1,581363,America,4709,97
2020-09-21,Suriname,SR,14,0,581363,America,4723,97
2020-09-22,Suriname,SR,17,0,581363,America,4740,97
2020-09-23,Suriname,SR,19,3,581363,America,4759,100
2020-09-24,Suriname,SR,20,1,581363,America,4779,101
2020-09-25,Suriname,SR,10,1,581363,America,4789,102
2020-09-26,Suriname,SR,28,0,581363,America,4817,102
2020-09-27,Suriname,SR,14,0,581363,America,4831,102
2020-09-28,Suriname,SR,4,0,581363,America,4835,102
2020-09-29,Suriname,SR,1,0,581363,America,4836,102
2020-09-30,Suriname,SR,27,2,581363,America,4863,104
2020-10-01,Suriname,SR,14,0,581363,America,4877,104
2020-10-02,Suriname,SR,14,1,581363,America,4891,105
2020-10-03,Suriname,SR,8,0,581363,America,4899,105
2020-10-04,Suriname,SR,25,1,581363,America,4924,106
2020-10-05,Suriname,SR,17,0,581363,America,4941,106
2020-10-06,Suriname,SR,13,0,581363,America,4954,106
2020-10-07,Suriname,SR,11,0,581363,America,4965,106
2020-10-08,Suriname,SR,14,0,581363,America,4979,106
2020-10-09,Suriname,SR,25,0,581363,America,5004,106
2020-10-10,Suriname,SR,14,0,581363,America,5018,106
2020-10-11,Suriname,SR,17,1,581363,America,5035,107
2020-10-12,Suriname,SR,16,0,581363,America,5051,107
2020-10-13,Suriname,SR,7,0,581363,America,5058,107
2020-10-14,Suriname,SR,14,0,581363,America,5072,107
2020-10-15,Suriname,SR,11,1,581363,America,5083,108
2020-10-16,Suriname,SR,11,1,581363,America,5094,109
2020-10-17,Suriname,SR,19,0,581363,America,5113,109
2020-10-18,Suriname,SR,10,0,581363,America,5123,109
2020-10-19,Suriname,SR,7,0,581363,America,5130,109
2020-10-20,Suriname,SR,3,0,581363,America,5133,109
2020-10-21,Suriname,SR,11,0,581363,America,5144,109
2020-10-22,Suriname,SR,6,0,581363,America,5150,109
2020-10-23,Suriname,SR,4,0,581363,America,5154,109
2020-10-24,Suriname,SR,1,0,581363,America,5155,109
2020-10-25,Suriname,SR,11,0,581363,America,5166,109
2020-10-26,Suriname,SR,4,0,581363,America,5170,109
2020-10-27,Suriname,SR,10,1,581363,America,5180,110
2020-10-28,Suriname,SR,7,1,581363,America,5187,111
2020-10-29,Suriname,SR,0,0,581363,America,5187,111
2020-10-30,Suriname,SR,10,0,581363,America,5197,111
2020-10-31,Suriname,SR,4,0,581363,America,5201,111
2020-11-01,Suriname,SR,2,0,581363,America,5203,111
2020-11-02,Suriname,SR,7,0,581363,America,5210,111
2020-11-03,Suriname,SR,2,0,581363,America,5212,111
2020-11-04,Suriname,SR,6,0,581363,America,5218,111
2020-11-05,Suriname,SR,2,1,581363,America,5220,112
2020-11-06,Suriname,SR,5,0,581363,America,5225,112
2020-11-07,Suriname,SR,2,0,581363,America,5227,112
2020-11-08,Suriname,SR,7,1,581363,America,5234,113
2020-11-09,Suriname,SR,5,0,581363,America,5239,113
2020-11-10,Suriname,SR,2,0,581363,America,5241,113
2020-11-11,Suriname,SR,4,0,581363,America,5245,113
2020-11-12,Suriname,SR,9,0,581363,America,5254,113
2020-11-13,Suriname,SR,7,1,581363,America,5261,114
2020-11-14,Suriname,SR,7,0,581363,America,5268,114
2020-11-15,Suriname,SR,6,0,581363,America,5274,114
2020-11-16,Suriname,SR,0,0,581363,America,5274,114
2020-11-17,Suriname,SR,1,1,581363,America,5275,115
2020-11-18,Suriname,SR,3,1,581363,America,5278,116
2020-11-19,Suriname,SR,4,0,581363,America,5282,116
2020-11-20,Suriname,SR,2,0,581363,America,5284,116
2020-11-21,Suriname,SR,5,0,581363,America,5289,116
2020-11-22,Suriname,SR,6,0,581363,America,5295,116
2020-11-23,Suriname,SR,1,0,581363,America,5296,116
2020-11-24,Suriname,SR,1,0,581363,America,5297,116
2020-11-25,Suriname,SR,3,1,581363,America,5300,117
2020-11-26,Suriname,SR,5,0,581363,America,5305,117
2020-11-27,Suriname,SR,2,0,581363,America,5307,117
2020-11-28,Suriname,SR,4,0,581363,America,5311,117
2020-11-29,Suriname,SR,1,0,581363,America,5312,117
2020-11-30,Suriname,SR,0,0,581363,America,5312,117
2020-12-01,Suriname,SR,0,0,581363,America,5312,117
2020-12-02,Suriname,SR,7,0,581363,America,5319,117
2020-12-03,Suriname,SR,1,0,581363,America,5320,117
2020-12-04,Suriname,SR,2,0,581363,America,5322,117
2020-12-05,Suriname,SR,0,0,581363,America,5322,117
2020-12-06,Suriname,SR,2,0,581363,America,5324,117
2020-12-07,Suriname,SR,0,0,581363,America,5324,117
2020-12-08,Suriname,SR,1,0,581363,America,5325,117
2020-12-09,Suriname,SR,1,0,581363,America,5326,117
2020-12-10,Suriname,SR,7,0,581363,America,5333,117
2020-12-11,Suriname,SR,4,0,581363,America,5337,117
2020-12-12,Suriname,SR,2,0,581363,America,5339,117
2020-12-13,Suriname,SR,10,0,581363,America,5349,117
2020-12-14,Suriname,SR,4,0,581363,America,5353,117
2020-04-06,South_Sudan,SS,1,0,11062114,Africa,1,0
2020-04-07,South_Sudan,SS,0,0,11062114,Africa,1,0
2020-04-08,South_Sudan,SS,0,0,11062114,Africa,1,0
2020-04-09,South_Sudan,SS,1,0,11062114,Africa,2,0
2020-04-10,South_Sudan,SS,0,0,11062114,Africa,2,0
2020-04-11,South_Sudan,SS,1,0,11062114,Africa,3,0
2020-04-12,South_Sudan,SS,1,0,11062114,Africa,4,0
2020-04-13,South_Sudan,SS,0,0,11062114,Africa,4,0
2020-04-14,South_Sudan,SS,0,0,11062114,Africa,4,0
2020-04-15,South_Sudan,SS,0,0,11062114,Africa,4,0
2020-04-16,South_Sudan,SS,0,0,11062114,Africa,4,0
2020-04-17,South_Sudan,SS,0,0,11062114,Africa,4,0
2020-04-18,South_Sudan,SS,0,0,11062114,Africa,4,0
2020-04-19,South_Sudan,SS,0,0,11062114,Africa,4,0
2020-04-20,South_Sudan,SS,0,0,11062114,Africa,4,0
2020-04-21,South_Sudan,SS,0,0,11062114,Africa,4,0
2020-04-22,South_Sudan,SS,0,0,11062114,Africa,4,0
2020-04-23,South_Sudan,SS,0,0,11062114,Africa,4,0
2020-04-24,South_Sudan,SS,0,0,11062114,Africa,4,0
2020-04-25,South_Sudan,SS,1,0,11062114,Africa,5,0
2020-04-26,South_Sudan,SS,0,0,11062114,Africa,5,0
2020-04-27,South_Sudan,SS,1,0,11062114,Africa,6,0
2020-04-28,South_Sudan,SS,0,0,11062114,Africa,6,0
2020-04-29,South_Sudan,SS,28,0,11062114,Africa,34,0
2020-04-30,South_Sudan,SS,0,0,11062114,Africa,34,0
2020-05-01,South_Sudan,SS,1,0,11062114,Africa,35,0
2020-05-02,South_Sudan,SS,10,0,11062114,Africa,45,0
2020-05-03,South_Sudan,SS,0,0,11062114,Africa,45,0
2020-05-04,South_Sudan,SS,1,0,11062114,Africa,46,0
2020-05-05,South_Sudan,SS,0,0,11062114,Africa,46,0
2020-05-06,South_Sudan,SS,6,0,11062114,Africa,52,0
2020-05-07,South_Sudan,SS,22,0,11062114,Africa,74,0
2020-05-08,South_Sudan,SS,16,0,11062114,Africa,90,0
2020-05-09,South_Sudan,SS,30,0,11062114,Africa,120,0
2020-05-10,South_Sudan,SS,23,0,11062114,Africa,143,0
2020-05-11,South_Sudan,SS,13,0,11062114,Africa,156,0
2020-05-12,South_Sudan,SS,0,0,11062114,Africa,156,0
2020-05-13,South_Sudan,SS,38,0,11062114,Africa,194,0
2020-05-14,South_Sudan,SS,9,0,11062114,Africa,203,0
2020-05-15,South_Sudan,SS,28,1,11062114,Africa,231,1
2020-05-16,South_Sudan,SS,5,3,11062114,Africa,236,4
2020-05-17,South_Sudan,SS,0,0,11062114,Africa,236,4
2020-05-18,South_Sudan,SS,46,0,11062114,Africa,282,4
2020-05-19,South_Sudan,SS,0,0,11062114,Africa,282,4
2020-05-20,South_Sudan,SS,3,2,11062114,Africa,285,6
2020-05-21,South_Sudan,SS,0,0,11062114,Africa,285,6
2020-05-22,South_Sudan,SS,54,0,11062114,Africa,339,6
2020-05-23,South_Sudan,SS,0,0,11062114,Africa,339,6
2020-05-24,South_Sudan,SS,224,0,11062114,Africa,563,6
2020-05-25,South_Sudan,SS,0,0,11062114,Africa,563,6
2020-05-26,South_Sudan,SS,92,2,11062114,Africa,655,8
2020-05-27,South_Sudan,SS,151,0,11062114,Africa,806,8
2020-05-28,South_Sudan,SS,0,0,11062114,Africa,806,8
2020-05-29,South_Sudan,SS,0,0,11062114,Africa,806,8
2020-05-30,South_Sudan,SS,188,2,11062114,Africa,994,10
2020-05-31,South_Sudan,SS,0,0,11062114,Africa,994,10
2020-06-01,South_Sudan,SS,0,0,11062114,Africa,994,10
2020-06-02,South_Sudan,SS,0,0,11062114,Africa,994,10
2020-06-03,South_Sudan,SS,0,0,11062114,Africa,994,10
2020-06-04,South_Sudan,SS,0,0,11062114,Africa,994,10
2020-06-05,South_Sudan,SS,323,4,11062114,Africa,1317,14
2020-06-06,South_Sudan,SS,0,0,11062114,Africa,1317,14
2020-06-07,South_Sudan,SS,0,0,11062114,Africa,1317,14
2020-06-08,South_Sudan,SS,0,0,11062114,Africa,1317,14
2020-06-09,South_Sudan,SS,287,5,11062114,Africa,1604,19
2020-06-10,South_Sudan,SS,0,0,11062114,Africa,1604,19
2020-06-11,South_Sudan,SS,0,0,11062114,Africa,1604,19
2020-06-12,South_Sudan,SS,0,0,11062114,Africa,1604,19
2020-06-13,South_Sudan,SS,66,3,11062114,Africa,1670,22
2020-06-14,South_Sudan,SS,23,5,11062114,Africa,1693,27
2020-06-15,South_Sudan,SS,0,0,11062114,Africa,1693,27
2020-06-16,South_Sudan,SS,62,3,11062114,Africa,1755,30
2020-06-17,South_Sudan,SS,21,0,11062114,Africa,1776,30
2020-06-18,South_Sudan,SS,31,1,11062114,Africa,1807,31
2020-06-19,South_Sudan,SS,6,0,11062114,Africa,1813,31
2020-06-20,South_Sudan,SS,0,0,11062114,Africa,1813,31
2020-06-21,South_Sudan,SS,51,3,11062114,Africa,1864,34
2020-06-22,South_Sudan,SS,18,0,11062114,Africa,1882,34
2020-06-23,South_Sudan,SS,10,0,11062114,Africa,1892,34
2020-06-24,South_Sudan,SS,24,1,11062114,Africa,1916,35
2020-06-25,South_Sudan,SS,14,1,11062114,Africa,1930,36
2020-06-26,South_Sudan,SS,12,0,11062114,Africa,1942,36
2020-06-27,South_Sudan,SS,10,0,11062114,Africa,1952,36
2020-06-28,South_Sudan,SS,6,0,11062114,Africa,1958,36
2020-06-29,South_Sudan,SS,31,0,11062114,Africa,1989,36
2020-06-30,South_Sudan,SS,17,1,11062114,Africa,2006,37
2020-07-01,South_Sudan,SS,0,0,11062114,Africa,2006,37
2020-07-02,South_Sudan,SS,0,0,11062114,Africa,2006,37
2020-07-03,South_Sudan,SS,30,1,11062114,Africa,2036,38
2020-07-04,South_Sudan,SS,0,0,11062114,Africa,2036,38
2020-07-05,South_Sudan,SS,0,0,11062114,Africa,2036,38
2020-07-06,South_Sudan,SS,0,0,11062114,Africa,2036,38
2020-07-07,South_Sudan,SS,57,2,11062114,Africa,2093,40
2020-07-08,South_Sudan,SS,5,0,11062114,Africa,2098,40
2020-07-09,South_Sudan,SS,8,0,11062114,Africa,2106,40
2020-07-10,South_Sudan,SS,7,0,11062114,Africa,2113,40
2020-07-11,South_Sudan,SS,16,1,11062114,Africa,2129,41
2020-07-12,South_Sudan,SS,0,0,11062114,Africa,2129,41
2020-07-13,South_Sudan,SS,10,0,11062114,Africa,2139,41
2020-07-14,South_Sudan,SS,9,0,11062114,Africa,2148,41
2020-07-15,South_Sudan,SS,0,0,11062114,Africa,2148,41
2020-07-16,South_Sudan,SS,5,0,11062114,Africa,2153,41
2020-07-17,South_Sudan,SS,18,0,11062114,Africa,2171,41
2020-07-18,South_Sudan,SS,20,2,11062114,Africa,2191,43
2020-07-19,South_Sudan,SS,0,0,11062114,Africa,2191,43
2020-07-20,South_Sudan,SS,9,0,11062114,Africa,2200,43
2020-07-21,South_Sudan,SS,11,2,11062114,Africa,2211,45
2020-07-22,South_Sudan,SS,0,0,11062114,Africa,2211,45
2020-07-23,South_Sudan,SS,0,0,11062114,Africa,2211,45
2020-07-24,South_Sudan,SS,28,0,11062114,Africa,2239,45
2020-07-25,South_Sudan,SS,19,0,11062114,Africa,2258,45
2020-07-26,South_Sudan,SS,0,0,11062114,Africa,2258,45
2020-07-27,South_Sudan,SS,4,0,11062114,Africa,2262,45
2020-07-28,South_Sudan,SS,43,1,11062114,Africa,2305,46
2020-07-29,South_Sudan,SS,17,0,11062114,Africa,2322,46
2020-07-30,South_Sudan,SS,0,0,11062114,Africa,2322,46
2020-07-31,South_Sudan,SS,0,0,11062114,Africa,2322,46
2020-08-01,South_Sudan,SS,0,0,11062114,Africa,2322,46
2020-08-02,South_Sudan,SS,30,0,11062114,Africa,2352,46
2020-08-03,South_Sudan,SS,77,0,11062114,Africa,2429,46
2020-08-04,South_Sudan,SS,0,0,11062114,Africa,2429,46
2020-08-05,South_Sudan,SS,8,1,11062114,Africa,2437,47
2020-08-06,South_Sudan,SS,13,0,11062114,Africa,2450,47
2020-08-07,South_Sudan,SS,8,0,11062114,Africa,2458,47
2020-08-08,South_Sudan,SS,5,0,11062114,Africa,2463,47
2020-08-09,South_Sudan,SS,0,0,11062114,Africa,2463,47
2020-08-10,South_Sudan,SS,7,0,11062114,Africa,2470,47
2020-08-11,South_Sudan,SS,0,0,11062114,Africa,2470,47
2020-08-12,South_Sudan,SS,2,0,11062114,Africa,2472,47
2020-08-13,South_Sudan,SS,5,0,11062114,Africa,2477,47
2020-08-14,South_Sudan,SS,1,0,11062114,Africa,2478,47
2020-08-15,South_Sudan,SS,4,0,11062114,Africa,2482,47
2020-08-16,South_Sudan,SS,6,0,11062114,Africa,2488,47
2020-08-17,South_Sudan,SS,1,0,11062114,Africa,2489,47
2020-08-18,South_Sudan,SS,1,0,11062114,Africa,2490,47
2020-08-19,South_Sudan,SS,0,0,11062114,Africa,2490,47
2020-08-20,South_Sudan,SS,4,0,11062114,Africa,2494,47
2020-08-21,South_Sudan,SS,0,0,11062114,Africa,2494,47
2020-08-22,South_Sudan,SS,3,0,11062114,Africa,2497,47
2020-08-23,South_Sudan,SS,0,0,11062114,Africa,2497,47
2020-08-24,South_Sudan,SS,2,0,11062114,Africa,2499,47
2020-08-25,South_Sudan,SS,5,0,11062114,Africa,2504,47
2020-08-26,South_Sudan,SS,3,0,11062114,Africa,2507,47
2020-08-27,South_Sudan,SS,3,0,11062114,Africa,2510,47
2020-08-28,South_Sudan,SS,4,0,11062114,Africa,2514,47
2020-08-29,South_Sudan,SS,4,0,11062114,Africa,2518,47
2020-08-30,South_Sudan,SS,1,0,11062114,Africa,2519,47
2020-08-31,South_Sudan,SS,0,0,11062114,Africa,2519,47
2020-09-01,South_Sudan,SS,8,0,11062114,Africa,2527,47
2020-09-02,South_Sudan,SS,0,0,11062114,Africa,2527,47
2020-09-03,South_Sudan,SS,5,0,11062114,Africa,2532,47
2020-09-04,South_Sudan,SS,1,0,11062114,Africa,2533,47
2020-09-05,South_Sudan,SS,3,0,11062114,Africa,2536,47
2020-09-06,South_Sudan,SS,8,1,11062114,Africa,2544,48
2020-09-07,South_Sudan,SS,0,0,11062114,Africa,2544,48
2020-09-08,South_Sudan,SS,1,0,11062114,Africa,2545,48
2020-09-09,South_Sudan,SS,0,0,11062114,Africa,2545,48
2020-09-10,South_Sudan,SS,7,0,11062114,Africa,2552,48
2020-09-11,South_Sudan,SS,3,0,11062114,Africa,2555,48
2020-09-12,South_Sudan,SS,13,0,11062114,Africa,2568,48
2020-09-13,South_Sudan,SS,10,1,11062114,Africa,2578,49
2020-09-14,South_Sudan,SS,0,0,11062114,Africa,2578,49
2020-09-15,South_Sudan,SS,9,0,11062114,Africa,2587,49
2020-09-16,South_Sudan,SS,5,0,11062114,Africa,2592,49
2020-09-17,South_Sudan,SS,2,0,11062114,Africa,2594,49
2020-09-18,South_Sudan,SS,5,0,11062114,Africa,2599,49
2020-09-19,South_Sudan,SS,10,0,11062114,Africa,2609,49
2020-09-20,South_Sudan,SS,33,0,11062114,Africa,2642,49
2020-09-21,South_Sudan,SS,0,0,11062114,Africa,2642,49
2020-09-22,South_Sudan,SS,7,0,11062114,Africa,2649,49
2020-09-23,South_Sudan,SS,11,0,11062114,Africa,2660,49
2020-09-24,South_Sudan,SS,0,0,11062114,Africa,2660,49
2020-09-25,South_Sudan,SS,4,0,11062114,Africa,2664,49
2020-09-26,South_Sudan,SS,12,0,11062114,Africa,2676,49
2020-09-27,South_Sudan,SS,0,0,11062114,Africa,2676,49
2020-09-28,South_Sudan,SS,10,0,11062114,Africa,2686,49
2020-09-29,South_Sudan,SS,6,0,11062114,Africa,2692,49
2020-09-30,South_Sudan,SS,8,0,11062114,Africa,2700,49
2020-10-01,South_Sudan,SS,4,0,11062114,Africa,2704,49
2020-10-02,South_Sudan,SS,0,0,11062114,Africa,2704,49
2020-10-03,South_Sudan,SS,11,1,11062114,Africa,2715,50
2020-10-04,South_Sudan,SS,0,0,11062114,Africa,2715,50
2020-10-05,South_Sudan,SS,11,0,11062114,Africa,2726,50
2020-10-06,South_Sudan,SS,0,0,11062114,Africa,2726,50
2020-10-07,South_Sudan,SS,8,0,11062114,Africa,2734,50
2020-10-08,South_Sudan,SS,0,0,11062114,Africa,2734,50
2020-10-09,South_Sudan,SS,14,0,11062114,Africa,2748,50
2020-10-10,South_Sudan,SS,13,4,11062114,Africa,2761,54
2020-10-11,South_Sudan,SS,0,0,11062114,Africa,2761,54
2020-10-12,South_Sudan,SS,16,1,11062114,Africa,2777,55
2020-10-13,South_Sudan,SS,10,0,11062114,Africa,2787,55
2020-10-14,South_Sudan,SS,11,0,11062114,Africa,2798,55
2020-10-15,South_Sudan,SS,0,0,11062114,Africa,2798,55
2020-10-16,South_Sudan,SS,9,0,11062114,Africa,2807,55
2020-10-17,South_Sudan,SS,10,0,11062114,Africa,2817,55
2020-10-18,South_Sudan,SS,0,0,11062114,Africa,2817,55
2020-10-19,South_Sudan,SS,25,0,11062114,Africa,2842,55
2020-10-20,South_Sudan,SS,5,0,11062114,Africa,2847,55
2020-10-21,South_Sudan,SS,0,0,11062114,Africa,2847,55
2020-10-22,South_Sudan,SS,23,0,11062114,Africa,2870,55
2020-10-23,South_Sudan,SS,2,0,11062114,Africa,2872,55
2020-10-24,South_Sudan,SS,4,1,11062114,Africa,2876,56
2020-10-25,South_Sudan,SS,2,0,11062114,Africa,2878,56
2020-10-26,South_Sudan,SS,5,0,11062114,Africa,2883,56
2020-10-27,South_Sudan,SS,0,0,11062114,Africa,2883,56
2020-10-28,South_Sudan,SS,7,0,11062114,Africa,2890,56
2020-10-29,South_Sudan,SS,0,0,11062114,Africa,2890,56
2020-10-30,South_Sudan,SS,13,2,11062114,Africa,2903,58
2020-10-31,South_Sudan,SS,0,0,11062114,Africa,2903,58
2020-11-01,South_Sudan,SS,2,0,11062114,Africa,2905,58
2020-11-02,South_Sudan,SS,21,1,11062114,Africa,2926,59
2020-11-03,South_Sudan,SS,0,0,11062114,Africa,2926,59
2020-11-04,South_Sudan,SS,14,0,11062114,Africa,2940,59
2020-11-05,South_Sudan,SS,3,0,11062114,Africa,2943,59
2020-11-06,South_Sudan,SS,2,0,11062114,Africa,2945,59
2020-11-07,South_Sudan,SS,10,0,11062114,Africa,2955,59
2020-11-08,South_Sudan,SS,0,0,11062114,Africa,2955,59
2020-11-09,South_Sudan,SS,0,0,11062114,Africa,2955,59
2020-11-10,South_Sudan,SS,5,0,11062114,Africa,2960,59
2020-11-11,South_Sudan,SS,0,0,11062114,Africa,2960,59
2020-11-12,South_Sudan,SS,0,0,11062114,Africa,2960,59
2020-11-13,South_Sudan,SS,0,0,11062114,Africa,2960,59
2020-11-14,South_Sudan,SS,20,0,11062114,Africa,2980,59
2020-11-15,South_Sudan,SS,23,0,11062114,Africa,3003,59
2020-11-16,South_Sudan,SS,0,0,11062114,Africa,3003,59
2020-11-17,South_Sudan,SS,9,0,11062114,Africa,3012,59
2020-11-18,South_Sudan,SS,4,0,11062114,Africa,3016,59
2020-11-19,South_Sudan,SS,0,0,11062114,Africa,3016,59
2020-11-20,South_Sudan,SS,0,0,11062114,Africa,3016,59
2020-11-21,South_Sudan,SS,0,0,11062114,Africa,3016,59
2020-11-22,South_Sudan,SS,31,1,11062114,Africa,3047,60
2020-11-23,South_Sudan,SS,0,0,11062114,Africa,3047,60
2020-11-24,South_Sudan,SS,0,0,11062114,Africa,3047,60
2020-11-25,South_Sudan,SS,0,0,11062114,Africa,3047,60
2020-11-26,South_Sudan,SS,0,0,11062114,Africa,3047,60
2020-11-27,South_Sudan,SS,37,1,11062114,Africa,3084,61
2020-11-28,South_Sudan,SS,8,0,11062114,Africa,3092,61
2020-11-29,South_Sudan,SS,12,0,11062114,Africa,3104,61
2020-11-30,South_Sudan,SS,5,0,11062114,Africa,3109,61
2020-12-01,South_Sudan,SS,0,0,11062114,Africa,3109,61
2020-12-02,South_Sudan,SS,2,0,11062114,Africa,3111,61
2020-12-03,South_Sudan,SS,7,0,11062114,Africa,3118,61
2020-12-04,South_Sudan,SS,36,1,11062114,Africa,3154,62
2020-12-05,South_Sudan,SS,0,0,11062114,Africa,3154,62
2020-12-06,South_Sudan,SS,12,0,11062114,Africa,3166,62
2020-12-07,South_Sudan,SS,15,0,11062114,Africa,3181,62
2020-12-08,South_Sudan,SS,0,0,11062114,Africa,3181,62
2020-12-09,South_Sudan,SS,0,0,11062114,Africa,3181,62
2020-12-10,South_Sudan,SS,0,0,11062114,Africa,3181,62
2020-12-11,South_Sudan,SS,0,0,11062114,Africa,3181,62
2020-12-12,South_Sudan,SS,0,0,11062114,Africa,3181,62
2020-12-13,South_Sudan,SS,25,0,11062114,Africa,3206,62
2020-12-14,South_Sudan,SS,0,0,11062114,Africa,3206,62
2020-04-09,Sao_Tome_and_Principe,ST,4,0,215048,Africa,4,0
2020-04-10,Sao_Tome_and_Principe,ST,0,0,215048,Africa,4,0
2020-04-11,Sao_Tome_and_Principe,ST,0,0,215048,Africa,4,0
2020-04-12,Sao_Tome_and_Principe,ST,0,0,215048,Africa,4,0
2020-04-13,Sao_Tome_and_Principe,ST,0,0,215048,Africa,4,0
2020-04-14,Sao_Tome_and_Principe,ST,0,0,215048,Africa,4,0
2020-04-15,Sao_Tome_and_Principe,ST,0,0,215048,Africa,4,0
2020-04-16,Sao_Tome_and_Principe,ST,0,0,215048,Africa,4,0
2020-04-17,Sao_Tome_and_Principe,ST,0,0,215048,Africa,4,0
2020-04-18,Sao_Tome_and_Principe,ST,0,0,215048,Africa,4,0
2020-04-19,Sao_Tome_and_Principe,ST,0,0,215048,Africa,4,0
2020-04-20,Sao_Tome_and_Principe,ST,0,0,215048,Africa,4,0
2020-04-21,Sao_Tome_and_Principe,ST,0,0,215048,Africa,4,0
2020-04-22,Sao_Tome_and_Principe,ST,0,0,215048,Africa,4,0
2020-04-23,Sao_Tome_and_Principe,ST,3,0,215048,Africa,7,0
2020-04-24,Sao_Tome_and_Principe,ST,1,0,215048,Africa,8,0
2020-04-25,Sao_Tome_and_Principe,ST,0,0,215048,Africa,8,0
2020-04-26,Sao_Tome_and_Principe,ST,0,0,215048,Africa,8,0
2020-04-27,Sao_Tome_and_Principe,ST,0,0,215048,Africa,8,0
2020-04-28,Sao_Tome_and_Principe,ST,0,0,215048,Africa,8,0
2020-04-29,Sao_Tome_and_Principe,ST,3,0,215048,Africa,11,0
2020-04-30,Sao_Tome_and_Principe,ST,3,0,215048,Africa,14,0
2020-05-01,Sao_Tome_and_Principe,ST,2,1,215048,Africa,16,1
2020-05-02,Sao_Tome_and_Principe,ST,2,0,215048,Africa,18,1
2020-05-03,Sao_Tome_and_Principe,ST,0,0,215048,Africa,18,1
2020-05-04,Sao_Tome_and_Principe,ST,0,0,215048,Africa,18,1
2020-05-05,Sao_Tome_and_Principe,ST,156,2,215048,Africa,174,3
2020-05-06,Sao_Tome_and_Principe,ST,0,0,215048,Africa,174,3
2020-05-07,Sao_Tome_and_Principe,ST,0,0,215048,Africa,174,3
2020-05-08,Sao_Tome_and_Principe,ST,13,1,215048,Africa,187,4
2020-05-09,Sao_Tome_and_Principe,ST,21,1,215048,Africa,208,5
2020-05-10,Sao_Tome_and_Principe,ST,0,0,215048,Africa,208,5
2020-05-11,Sao_Tome_and_Principe,ST,0,0,215048,Africa,208,5
2020-05-12,Sao_Tome_and_Principe,ST,4,0,215048,Africa,212,5
2020-05-13,Sao_Tome_and_Principe,ST,8,1,215048,Africa,220,6
2020-05-14,Sao_Tome_and_Principe,ST,15,1,215048,Africa,235,7
2020-05-15,Sao_Tome_and_Principe,ST,0,0,215048,Africa,235,7
2020-05-16,Sao_Tome_and_Principe,ST,0,0,215048,Africa,235,7
2020-05-17,Sao_Tome_and_Principe,ST,0,0,215048,Africa,235,7
2020-05-18,Sao_Tome_and_Principe,ST,0,0,215048,Africa,235,7
2020-05-19,Sao_Tome_and_Principe,ST,11,0,215048,Africa,246,7
2020-05-20,Sao_Tome_and_Principe,ST,5,1,215048,Africa,251,8
2020-05-21,Sao_Tome_and_Principe,ST,0,0,215048,Africa,251,8
2020-05-22,Sao_Tome_and_Principe,ST,0,0,215048,Africa,251,8
2020-05-23,Sao_Tome_and_Principe,ST,0,0,215048,Africa,251,8
2020-05-24,Sao_Tome_and_Principe,ST,40,0,215048,Africa,291,8
2020-05-25,Sao_Tome_and_Principe,ST,8,1,215048,Africa,299,9
2020-05-26,Sao_Tome_and_Principe,ST,0,2,215048,Africa,299,11
2020-05-27,Sao_Tome_and_Principe,ST,142,1,215048,Africa,441,12
2020-05-28,Sao_Tome_and_Principe,ST,2,0,215048,Africa,443,12
2020-05-29,Sao_Tome_and_Principe,ST,15,0,215048,Africa,458,12
2020-05-30,Sao_Tome_and_Principe,ST,5,0,215048,Africa,463,12
2020-05-31,Sao_Tome_and_Principe,ST,16,0,215048,Africa,479,12
2020-06-01,Sao_Tome_and_Principe,ST,4,0,215048,Africa,483,12
2020-06-02,Sao_Tome_and_Principe,ST,1,0,215048,Africa,484,12
2020-06-03,Sao_Tome_and_Principe,ST,0,0,215048,Africa,484,12
2020-06-04,Sao_Tome_and_Principe,ST,0,0,215048,Africa,484,12
2020-06-05,Sao_Tome_and_Principe,ST,15,0,215048,Africa,499,12
2020-06-06,Sao_Tome_and_Principe,ST,10,0,215048,Africa,509,12
2020-06-07,Sao_Tome_and_Principe,ST,4,0,215048,Africa,513,12
2020-06-08,Sao_Tome_and_Principe,ST,1,0,215048,Africa,514,12
2020-06-09,Sao_Tome_and_Principe,ST,0,0,215048,Africa,514,12
2020-06-10,Sao_Tome_and_Principe,ST,0,0,215048,Africa,514,12
2020-06-11,Sao_Tome_and_Principe,ST,118,0,215048,Africa,632,12
2020-06-12,Sao_Tome_and_Principe,ST,7,0,215048,Africa,639,12
2020-06-13,Sao_Tome_and_Principe,ST,11,0,215048,Africa,650,12
2020-06-14,Sao_Tome_and_Principe,ST,9,0,215048,Africa,659,12
2020-06-15,Sao_Tome_and_Principe,ST,2,0,215048,Africa,661,12
2020-06-16,Sao_Tome_and_Principe,ST,0,0,215048,Africa,661,12
2020-06-17,Sao_Tome_and_Principe,ST,10,0,215048,Africa,671,12
2020-06-18,Sao_Tome_and_Principe,ST,12,0,215048,Africa,683,12
2020-06-19,Sao_Tome_and_Principe,ST,5,0,215048,Africa,688,12
2020-06-20,Sao_Tome_and_Principe,ST,5,0,215048,Africa,693,12
2020-06-21,Sao_Tome_and_Principe,ST,5,0,215048,Africa,698,12
2020-06-22,Sao_Tome_and_Principe,ST,0,0,215048,Africa,698,12
2020-06-23,Sao_Tome_and_Principe,ST,4,0,215048,Africa,702,12
2020-06-24,Sao_Tome_and_Principe,ST,5,0,215048,Africa,707,12
2020-06-25,Sao_Tome_and_Principe,ST,3,1,215048,Africa,710,13
2020-06-26,Sao_Tome_and_Principe,ST,1,0,215048,Africa,711,13
2020-06-27,Sao_Tome_and_Principe,ST,1,0,215048,Africa,712,13
2020-06-28,Sao_Tome_and_Principe,ST,1,0,215048,Africa,713,13
2020-06-29,Sao_Tome_and_Principe,ST,0,0,215048,Africa,713,13
2020-06-30,Sao_Tome_and_Principe,ST,0,0,215048,Africa,713,13
2020-07-01,Sao_Tome_and_Principe,ST,1,0,215048,Africa,714,13
2020-07-02,Sao_Tome_and_Principe,ST,1,0,215048,Africa,715,13
2020-07-03,Sao_Tome_and_Principe,ST,2,0,215048,Africa,717,13
2020-07-04,Sao_Tome_and_Principe,ST,2,0,215048,Africa,719,13
2020-07-05,Sao_Tome_and_Principe,ST,0,0,215048,Africa,719,13
2020-07-06,Sao_Tome_and_Principe,ST,1,0,215048,Africa,720,13
2020-07-07,Sao_Tome_and_Principe,ST,1,0,215048,Africa,721,13
2020-07-08,Sao_Tome_and_Principe,ST,3,0,215048,Africa,724,13
2020-07-09,Sao_Tome_and_Principe,ST,0,0,215048,Africa,724,13
2020-07-10,Sao_Tome_and_Principe,ST,2,1,215048,Africa,726,14
2020-07-11,Sao_Tome_and_Principe,ST,1,0,215048,Africa,727,14
2020-07-12,Sao_Tome_and_Principe,ST,0,0,215048,Africa,727,14
2020-07-13,Sao_Tome_and_Principe,ST,2,0,215048,Africa,729,14
2020-07-14,Sao_Tome_and_Principe,ST,3,0,215048,Africa,732,14
2020-07-15,Sao_Tome_and_Principe,ST,0,0,215048,Africa,732,14
2020-07-16,Sao_Tome_and_Principe,ST,5,0,215048,Africa,737,14
2020-07-17,Sao_Tome_and_Principe,ST,3,0,215048,Africa,740,14
2020-07-18,Sao_Tome_and_Principe,ST,1,0,215048,Africa,741,14
2020-07-19,Sao_Tome_and_Principe,ST,2,0,215048,Africa,743,14
2020-07-20,Sao_Tome_and_Principe,ST,3,0,215048,Africa,746,14
2020-07-21,Sao_Tome_and_Principe,ST,0,0,215048,Africa,746,14
2020-07-22,Sao_Tome_and_Principe,ST,0,0,215048,Africa,746,14
2020-07-23,Sao_Tome_and_Principe,ST,1,0,215048,Africa,747,14
2020-07-24,Sao_Tome_and_Principe,ST,2,0,215048,Africa,749,14
2020-07-25,Sao_Tome_and_Principe,ST,111,0,215048,Africa,860,14
2020-07-26,Sao_Tome_and_Principe,ST,2,0,215048,Africa,862,14
2020-07-27,Sao_Tome_and_Principe,ST,1,0,215048,Africa,863,14
2020-07-28,Sao_Tome_and_Principe,ST,2,0,215048,Africa,865,14
2020-07-29,Sao_Tome_and_Principe,ST,2,0,215048,Africa,867,14
2020-07-30,Sao_Tome_and_Principe,ST,1,1,215048,Africa,868,15
2020-07-31,Sao_Tome_and_Principe,ST,2,0,215048,Africa,870,15
2020-08-01,Sao_Tome_and_Principe,ST,1,0,215048,Africa,871,15
2020-08-02,Sao_Tome_and_Principe,ST,3,0,215048,Africa,874,15
2020-08-03,Sao_Tome_and_Principe,ST,0,0,215048,Africa,874,15
2020-08-04,Sao_Tome_and_Principe,ST,0,0,215048,Africa,874,15
2020-08-05,Sao_Tome_and_Principe,ST,1,0,215048,Africa,875,15
2020-08-06,Sao_Tome_and_Principe,ST,3,0,215048,Africa,878,15
2020-08-07,Sao_Tome_and_Principe,ST,0,0,215048,Africa,878,15
2020-08-08,Sao_Tome_and_Principe,ST,0,0,215048,Africa,878,15
2020-08-09,Sao_Tome_and_Principe,ST,0,0,215048,Africa,878,15
2020-08-10,Sao_Tome_and_Principe,ST,0,0,215048,Africa,878,15
2020-08-11,Sao_Tome_and_Principe,ST,0,0,215048,Africa,878,15
2020-08-12,Sao_Tome_and_Principe,ST,3,0,215048,Africa,881,15
2020-08-13,Sao_Tome_and_Principe,ST,1,0,215048,Africa,882,15
2020-08-14,Sao_Tome_and_Principe,ST,0,0,215048,Africa,882,15
2020-08-15,Sao_Tome_and_Principe,ST,1,0,215048,Africa,883,15
2020-08-16,Sao_Tome_and_Principe,ST,2,0,215048,Africa,885,15
2020-08-17,Sao_Tome_and_Principe,ST,0,0,215048,Africa,885,15
2020-08-18,Sao_Tome_and_Principe,ST,0,0,215048,Africa,885,15
2020-08-19,Sao_Tome_and_Principe,ST,0,0,215048,Africa,885,15
2020-08-20,Sao_Tome_and_Principe,ST,0,0,215048,Africa,885,15
2020-08-21,Sao_Tome_and_Principe,ST,0,0,215048,Africa,885,15
2020-08-22,Sao_Tome_and_Principe,ST,3,0,215048,Africa,888,15
2020-08-23,Sao_Tome_and_Principe,ST,4,0,215048,Africa,892,15
2020-08-24,Sao_Tome_and_Principe,ST,0,0,215048,Africa,892,15
2020-08-25,Sao_Tome_and_Principe,ST,0,0,215048,Africa,892,15
2020-08-26,Sao_Tome_and_Principe,ST,0,0,215048,Africa,892,15
2020-08-27,Sao_Tome_and_Principe,ST,0,0,215048,Africa,892,15
2020-08-28,Sao_Tome_and_Principe,ST,2,0,215048,Africa,894,15
2020-08-29,Sao_Tome_and_Principe,ST,1,0,215048,Africa,895,15
2020-08-30,Sao_Tome_and_Principe,ST,0,0,215048,Africa,895,15
2020-08-31,Sao_Tome_and_Principe,ST,1,0,215048,Africa,896,15
2020-09-01,Sao_Tome_and_Principe,ST,0,0,215048,Africa,896,15
2020-09-02,Sao_Tome_and_Principe,ST,0,0,215048,Africa,896,15
2020-09-03,Sao_Tome_and_Principe,ST,0,0,215048,Africa,896,15
2020-09-04,Sao_Tome_and_Principe,ST,1,0,215048,Africa,897,15
2020-09-05,Sao_Tome_and_Principe,ST,0,0,215048,Africa,897,15
2020-09-06,Sao_Tome_and_Principe,ST,1,0,215048,Africa,898,15
2020-09-07,Sao_Tome_and_Principe,ST,0,0,215048,Africa,898,15
2020-09-08,Sao_Tome_and_Principe,ST,0,0,215048,Africa,898,15
2020-09-09,Sao_Tome_and_Principe,ST,0,0,215048,Africa,898,15
2020-09-10,Sao_Tome_and_Principe,ST,0,0,215048,Africa,898,15
2020-09-11,Sao_Tome_and_Principe,ST,3,0,215048,Africa,901,15
2020-09-12,Sao_Tome_and_Principe,ST,5,0,215048,Africa,906,15
2020-09-13,Sao_Tome_and_Principe,ST,0,0,215048,Africa,906,15
2020-09-14,Sao_Tome_and_Principe,ST,0,0,215048,Africa,906,15
2020-09-15,Sao_Tome_and_Principe,ST,0,0,215048,Africa,906,15
2020-09-16,Sao_Tome_and_Principe,ST,1,0,215048,Africa,907,15
2020-09-17,Sao_Tome_and_Principe,ST,0,0,215048,Africa,907,15
2020-09-18,Sao_Tome_and_Principe,ST,0,0,215048,Africa,907,15
2020-09-19,Sao_Tome_and_Principe,ST,1,0,215048,Africa,908,15
2020-09-20,Sao_Tome_and_Principe,ST,0,0,215048,Africa,908,15
2020-09-21,Sao_Tome_and_Principe,ST,0,0,215048,Africa,908,15
2020-09-22,Sao_Tome_and_Principe,ST,0,0,215048,Africa,908,15
2020-09-23,Sao_Tome_and_Principe,ST,0,0,215048,Africa,908,15
2020-09-24,Sao_Tome_and_Principe,ST,0,0,215048,Africa,908,15
2020-09-25,Sao_Tome_and_Principe,ST,2,0,215048,Africa,910,15
2020-09-26,Sao_Tome_and_Principe,ST,1,0,215048,Africa,911,15
2020-09-27,Sao_Tome_and_Principe,ST,0,0,215048,Africa,911,15
2020-09-28,Sao_Tome_and_Principe,ST,0,0,215048,Africa,911,15
2020-09-29,Sao_Tome_and_Principe,ST,0,0,215048,Africa,911,15
2020-09-30,Sao_Tome_and_Principe,ST,0,0,215048,Africa,911,15
2020-10-01,Sao_Tome_and_Principe,ST,0,0,215048,Africa,911,15
2020-10-02,Sao_Tome_and_Principe,ST,0,0,215048,Africa,911,15
2020-10-03,Sao_Tome_and_Principe,ST,0,0,215048,Africa,911,15
2020-10-04,Sao_Tome_and_Principe,ST,2,0,215048,Africa,913,15
2020-10-05,Sao_Tome_and_Principe,ST,0,0,215048,Africa,913,15
2020-10-06,Sao_Tome_and_Principe,ST,0,0,215048,Africa,913,15
2020-10-07,Sao_Tome_and_Principe,ST,1,0,215048,Africa,914,15
2020-10-08,Sao_Tome_and_Principe,ST,0,0,215048,Africa,914,15
2020-10-09,Sao_Tome_and_Principe,ST,7,0,215048,Africa,921,15
2020-10-10,Sao_Tome_and_Principe,ST,1,0,215048,Africa,922,15
2020-10-11,Sao_Tome_and_Principe,ST,0,0,215048,Africa,922,15
2020-10-12,Sao_Tome_and_Principe,ST,7,0,215048,Africa,929,15
2020-10-13,Sao_Tome_and_Principe,ST,0,0,215048,Africa,929,15
2020-10-14,Sao_Tome_and_Principe,ST,0,0,215048,Africa,929,15
2020-10-15,Sao_Tome_and_Principe,ST,0,0,215048,Africa,929,15
2020-10-16,Sao_Tome_and_Principe,ST,0,0,215048,Africa,929,15
2020-10-17,Sao_Tome_and_Principe,ST,3,0,215048,Africa,932,15
2020-10-18,Sao_Tome_and_Principe,ST,0,0,215048,Africa,932,15
2020-10-19,Sao_Tome_and_Principe,ST,1,0,215048,Africa,933,15
2020-10-20,Sao_Tome_and_Principe,ST,0,0,215048,Africa,933,15
2020-10-21,Sao_Tome_and_Principe,ST,0,0,215048,Africa,933,15
2020-10-22,Sao_Tome_and_Principe,ST,2,0,215048,Africa,935,15
2020-10-23,Sao_Tome_and_Principe,ST,0,0,215048,Africa,935,15
2020-10-24,Sao_Tome_and_Principe,ST,3,0,215048,Africa,938,15
2020-10-25,Sao_Tome_and_Principe,ST,2,0,215048,Africa,940,15
2020-10-26,Sao_Tome_and_Principe,ST,0,0,215048,Africa,940,15
2020-10-27,Sao_Tome_and_Principe,ST,1,0,215048,Africa,941,15
2020-10-28,Sao_Tome_and_Principe,ST,0,0,215048,Africa,941,15
2020-10-29,Sao_Tome_and_Principe,ST,2,0,215048,Africa,943,15
2020-10-30,Sao_Tome_and_Principe,ST,1,1,215048,Africa,944,16
2020-10-31,Sao_Tome_and_Principe,ST,1,0,215048,Africa,945,16
2020-11-01,Sao_Tome_and_Principe,ST,0,0,215048,Africa,945,16
2020-11-02,Sao_Tome_and_Principe,ST,4,0,215048,Africa,949,16
2020-11-03,Sao_Tome_and_Principe,ST,0,0,215048,Africa,949,16
2020-11-04,Sao_Tome_and_Principe,ST,5,0,215048,Africa,954,16
2020-11-05,Sao_Tome_and_Principe,ST,4,0,215048,Africa,958,16
2020-11-06,Sao_Tome_and_Principe,ST,0,0,215048,Africa,958,16
2020-11-07,Sao_Tome_and_Principe,ST,2,0,215048,Africa,960,16
2020-11-08,Sao_Tome_and_Principe,ST,2,0,215048,Africa,962,16
2020-11-09,Sao_Tome_and_Principe,ST,0,0,215048,Africa,962,16
2020-11-10,Sao_Tome_and_Principe,ST,0,0,215048,Africa,962,16
2020-11-11,Sao_Tome_and_Principe,ST,0,0,215048,Africa,962,16
2020-11-12,Sao_Tome_and_Principe,ST,0,0,215048,Africa,962,16
2020-11-13,Sao_Tome_and_Principe,ST,1,0,215048,Africa,963,16
2020-11-14,Sao_Tome_and_Principe,ST,0,0,215048,Africa,963,16
2020-11-15,Sao_Tome_and_Principe,ST,1,0,215048,Africa,964,16
2020-11-16,Sao_Tome_and_Principe,ST,1,0,215048,Africa,965,16
2020-11-17,Sao_Tome_and_Principe,ST,0,0,215048,Africa,965,16
2020-11-18,Sao_Tome_and_Principe,ST,2,0,215048,Africa,967,16
2020-11-19,Sao_Tome_and_Principe,ST,0,0,215048,Africa,967,16
2020-11-20,Sao_Tome_and_Principe,ST,7,0,215048,Africa,974,16
2020-11-21,Sao_Tome_and_Principe,ST,0,1,215048,Africa,974,17
2020-11-22,Sao_Tome_and_Principe,ST,5,0,215048,Africa,979,17
2020-11-23,Sao_Tome_and_Principe,ST,0,0,215048,Africa,979,17
2020-11-24,Sao_Tome_and_Principe,ST,2,0,215048,Africa,981,17
2020-11-25,Sao_Tome_and_Principe,ST,0,0,215048,Africa,981,17
2020-11-26,Sao_Tome_and_Principe,ST,1,0,215048,Africa,982,17
2020-11-27,Sao_Tome_and_Principe,ST,3,0,215048,Africa,985,17
2020-11-28,Sao_Tome_and_Principe,ST,0,0,215048,Africa,985,17
2020-11-29,Sao_Tome_and_Principe,ST,0,0,215048,Africa,985,17
2020-11-30,Sao_Tome_and_Principe,ST,4,0,215048,Africa,989,17
2020-12-01,Sao_Tome_and_Principe,ST,2,0,215048,Africa,991,17
2020-12-02,Sao_Tome_and_Principe,ST,5,0,215048,Africa,996,17
2020-12-03,Sao_Tome_and_Principe,ST,1,0,215048,Africa,997,17
2020-12-04,Sao_Tome_and_Principe,ST,0,0,215048,Africa,997,17
2020-12-05,Sao_Tome_and_Principe,ST,2,0,215048,Africa,999,17
2020-12-06,Sao_Tome_and_Principe,ST,0,0,215048,Africa,999,17
2020-12-07,Sao_Tome_and_Principe,ST,0,0,215048,Africa,999,17
2020-12-08,Sao_Tome_and_Principe,ST,3,0,215048,Africa,1002,17
2020-12-09,Sao_Tome_and_Principe,ST,3,0,215048,Africa,1005,17
2020-12-10,Sao_Tome_and_Principe,ST,0,0,215048,Africa,1005,17
2020-12-11,Sao_Tome_and_Principe,ST,4,0,215048,Africa,1009,17
2020-12-12,Sao_Tome_and_Principe,ST,0,0,215048,Africa,1009,17
2020-12-13,Sao_Tome_and_Principe,ST,0,0,215048,Africa,1009,17
2020-12-14,Sao_Tome_and_Principe,ST,0,0,215048,Africa,1009,17
2020-03-19,El_Salvador,SV,1,0,6453550,America,1,0
2020-03-20,El_Salvador,SV,0,0,6453550,America,1,0
2020-03-21,El_Salvador,SV,2,0,6453550,America,3,0
2020-03-22,El_Salvador,SV,0,0,6453550,America,3,0
2020-03-23,El_Salvador,SV,0,0,6453550,America,3,0
2020-03-24,El_Salvador,SV,2,0,6453550,America,5,0
2020-03-25,El_Salvador,SV,4,0,6453550,America,9,0
2020-03-26,El_Salvador,SV,4,0,6453550,America,13,0
2020-03-27,El_Salvador,SV,0,0,6453550,America,13,0
2020-03-28,El_Salvador,SV,0,0,6453550,America,13,0
2020-03-29,El_Salvador,SV,6,0,6453550,America,19,0
2020-03-30,El_Salvador,SV,11,0,6453550,America,30,0
2020-03-31,El_Salvador,SV,2,0,6453550,America,32,0
2020-04-01,El_Salvador,SV,0,1,6453550,America,32,1
2020-04-02,El_Salvador,SV,9,1,6453550,America,41,2
2020-04-03,El_Salvador,SV,5,0,6453550,America,46,2
2020-04-04,El_Salvador,SV,10,1,6453550,America,56,3
2020-04-05,El_Salvador,SV,6,0,6453550,America,62,3
2020-04-06,El_Salvador,SV,7,0,6453550,America,69,3
2020-04-07,El_Salvador,SV,9,1,6453550,America,78,4
2020-04-08,El_Salvador,SV,0,0,6453550,America,78,4
2020-04-09,El_Salvador,SV,25,1,6453550,America,103,5
2020-04-10,El_Salvador,SV,14,1,6453550,America,117,6
2020-04-11,El_Salvador,SV,1,0,6453550,America,118,6
2020-04-12,El_Salvador,SV,0,0,6453550,America,118,6
2020-04-13,El_Salvador,SV,7,0,6453550,America,125,6
2020-04-14,El_Salvador,SV,24,0,6453550,America,149,6
2020-04-15,El_Salvador,SV,10,0,6453550,America,159,6
2020-04-16,El_Salvador,SV,0,0,6453550,America,159,6
2020-04-17,El_Salvador,SV,5,0,6453550,America,164,6
2020-04-18,El_Salvador,SV,13,1,6453550,America,177,7
2020-04-19,El_Salvador,SV,13,0,6453550,America,190,7
2020-04-20,El_Salvador,SV,11,0,6453550,America,201,7
2020-04-21,El_Salvador,SV,17,0,6453550,America,218,7
2020-04-22,El_Salvador,SV,7,0,6453550,America,225,7
2020-04-23,El_Salvador,SV,12,1,6453550,America,237,8
2020-04-24,El_Salvador,SV,13,0,6453550,America,250,8
2020-04-25,El_Salvador,SV,11,0,6453550,America,261,8
2020-04-26,El_Salvador,SV,37,0,6453550,America,298,8
2020-04-27,El_Salvador,SV,0,0,6453550,America,298,8
2020-04-28,El_Salvador,SV,25,0,6453550,America,323,8
2020-04-29,El_Salvador,SV,22,1,6453550,America,345,9
2020-04-30,El_Salvador,SV,32,0,6453550,America,377,9
2020-05-01,El_Salvador,SV,47,1,6453550,America,424,10
2020-05-02,El_Salvador,SV,22,0,6453550,America,446,10
2020-05-03,El_Salvador,SV,0,1,6453550,America,446,11
2020-05-04,El_Salvador,SV,109,1,6453550,America,555,12
2020-05-05,El_Salvador,SV,32,1,6453550,America,587,13
2020-05-06,El_Salvador,SV,0,1,6453550,America,587,14
2020-05-07,El_Salvador,SV,108,1,6453550,America,695,15
2020-05-08,El_Salvador,SV,0,0,6453550,America,695,15
2020-05-09,El_Salvador,SV,89,1,6453550,America,784,16
2020-05-10,El_Salvador,SV,105,1,6453550,America,889,17
2020-05-11,El_Salvador,SV,69,0,6453550,America,958,17
2020-05-12,El_Salvador,SV,40,1,6453550,America,998,18
2020-05-13,El_Salvador,SV,39,2,6453550,America,1037,20
2020-05-14,El_Salvador,SV,75,0,6453550,America,1112,20
2020-05-15,El_Salvador,SV,98,3,6453550,America,1210,23
2020-05-16,El_Salvador,SV,55,2,6453550,America,1265,25
2020-05-17,El_Salvador,SV,0,1,6453550,America,1265,26
2020-05-18,El_Salvador,SV,73,4,6453550,America,1338,30
2020-05-19,El_Salvador,SV,75,0,6453550,America,1413,30
2020-05-20,El_Salvador,SV,85,1,6453550,America,1498,31
2020-05-21,El_Salvador,SV,73,1,6453550,America,1571,32
2020-05-22,El_Salvador,SV,69,1,6453550,America,1640,33
2020-05-23,El_Salvador,SV,85,0,6453550,America,1725,33
2020-05-24,El_Salvador,SV,94,2,6453550,America,1819,35
2020-05-25,El_Salvador,SV,96,0,6453550,America,1915,35
2020-05-26,El_Salvador,SV,68,1,6453550,America,1983,36
2020-05-27,El_Salvador,SV,59,0,6453550,America,2042,36
2020-05-28,El_Salvador,SV,67,3,6453550,America,2109,39
2020-05-29,El_Salvador,SV,85,0,6453550,America,2194,39
2020-05-30,El_Salvador,SV,84,4,6453550,America,2278,43
2020-05-31,El_Salvador,SV,239,3,6453550,America,2517,46
2020-06-01,El_Salvador,SV,0,0,6453550,America,2517,46
2020-06-02,El_Salvador,SV,65,0,6453550,America,2582,46
2020-06-03,El_Salvador,SV,71,3,6453550,America,2653,49
2020-06-04,El_Salvador,SV,52,2,6453550,America,2705,51
2020-06-05,El_Salvador,SV,76,1,6453550,America,2781,52
2020-06-06,El_Salvador,SV,68,1,6453550,America,2849,53
2020-06-07,El_Salvador,SV,85,0,6453550,America,2934,53
2020-06-08,El_Salvador,SV,81,2,6453550,America,3015,55
2020-06-09,El_Salvador,SV,89,3,6453550,America,3104,58
2020-06-10,El_Salvador,SV,87,2,6453550,America,3191,60
2020-06-11,El_Salvador,SV,83,4,6453550,America,3274,64
2020-06-12,El_Salvador,SV,207,4,6453550,America,3481,68
2020-06-13,El_Salvador,SV,0,4,6453550,America,3481,72
2020-06-14,El_Salvador,SV,122,0,6453550,America,3603,72
2020-06-15,El_Salvador,SV,117,2,6453550,America,3720,74
2020-06-16,El_Salvador,SV,106,2,6453550,America,3826,76
2020-06-17,El_Salvador,SV,115,2,6453550,America,3941,78
2020-06-18,El_Salvador,SV,125,4,6453550,America,4066,82
2020-06-19,El_Salvador,SV,134,4,6453550,America,4200,86
2020-06-20,El_Salvador,SV,129,7,6453550,America,4329,93
2020-06-21,El_Salvador,SV,297,5,6453550,America,4626,98
2020-06-22,El_Salvador,SV,0,9,6453550,America,4626,107
2020-06-23,El_Salvador,SV,182,0,6453550,America,4808,107
2020-06-24,El_Salvador,SV,165,6,6453550,America,4973,113
2020-06-25,El_Salvador,SV,177,13,6453550,America,5150,126
2020-06-26,El_Salvador,SV,186,7,6453550,America,5336,133
2020-06-27,El_Salvador,SV,181,10,6453550,America,5517,143
2020-06-28,El_Salvador,SV,417,9,6453550,America,5934,152
2020-06-29,El_Salvador,SV,0,12,6453550,America,5934,164
2020-06-30,El_Salvador,SV,239,0,6453550,America,6173,164
2020-07-01,El_Salvador,SV,265,10,6453550,America,6438,174
2020-07-02,El_Salvador,SV,298,8,6453550,America,6736,182
2020-07-03,El_Salvador,SV,264,9,6453550,America,7000,191
2020-07-04,El_Salvador,SV,267,19,6453550,America,7267,210
2020-07-05,El_Salvador,SV,240,0,6453550,America,7507,210
2020-07-06,El_Salvador,SV,270,7,6453550,America,7777,217
2020-07-07,El_Salvador,SV,250,6,6453550,America,8027,223
2020-07-08,El_Salvador,SV,280,6,6453550,America,8307,229
2020-07-09,El_Salvador,SV,259,6,6453550,America,8566,235
2020-07-10,El_Salvador,SV,278,8,6453550,America,8844,243
2020-07-11,El_Salvador,SV,298,6,6453550,America,9142,249
2020-07-12,El_Salvador,SV,249,5,6453550,America,9391,254
2020-07-13,El_Salvador,SV,283,13,6453550,America,9674,267
2020-07-14,El_Salvador,SV,304,11,6453550,America,9978,278
2020-07-15,El_Salvador,SV,325,0,6453550,America,10303,278
2020-07-16,El_Salvador,SV,342,20,6453550,America,10645,298
2020-07-17,El_Salvador,SV,312,11,6453550,America,10957,309
2020-07-18,El_Salvador,SV,250,15,6453550,America,11207,324
2020-07-19,El_Salvador,SV,301,0,6453550,America,11508,324
2020-07-20,El_Salvador,SV,338,20,6453550,America,11846,344
2020-07-21,El_Salvador,SV,361,8,6453550,America,12207,352
2020-07-22,El_Salvador,SV,375,11,6453550,America,12582,363
2020-07-23,El_Salvador,SV,393,0,6453550,America,12975,363
2020-07-24,El_Salvador,SV,402,9,6453550,America,13377,372
2020-07-25,El_Salvador,SV,415,18,6453550,America,13792,390
2020-07-26,El_Salvador,SV,429,0,6453550,America,14221,390
2020-07-27,El_Salvador,SV,409,18,6453550,America,14630,408
2020-07-28,El_Salvador,SV,405,0,6453550,America,15035,408
2020-07-29,El_Salvador,SV,411,9,6453550,America,15446,417
2020-07-30,El_Salvador,SV,395,13,6453550,America,15841,430
2020-07-31,El_Salvador,SV,389,9,6453550,America,16230,439
2020-08-01,El_Salvador,SV,402,9,6453550,America,16632,448
2020-08-02,El_Salvador,SV,418,19,6453550,America,17050,467
2020-08-03,El_Salvador,SV,398,0,6453550,America,17448,467
2020-08-04,El_Salvador,SV,395,19,6453550,America,17843,486
2020-08-05,El_Salvador,SV,419,0,6453550,America,18262,486
2020-08-06,El_Salvador,SV,439,27,6453550,America,18701,513
2020-08-07,El_Salvador,SV,425,7,6453550,America,19126,520
2020-08-08,El_Salvador,SV,418,16,6453550,America,19544,536
2020-08-09,El_Salvador,SV,434,0,6453550,America,19978,536
2020-08-10,El_Salvador,SV,445,27,6453550,America,20423,563
2020-08-11,El_Salvador,SV,449,7,6453550,America,20872,570
2020-08-12,El_Salvador,SV,397,7,6453550,America,21269,577
2020-08-13,El_Salvador,SV,375,0,6453550,America,21644,577
2020-08-14,El_Salvador,SV,349,7,6453550,America,21993,584
2020-08-15,El_Salvador,SV,321,11,6453550,America,22314,595
2020-08-16,El_Salvador,SV,305,17,6453550,America,22619,612
2020-08-17,El_Salvador,SV,293,6,6453550,America,22912,618
2020-08-18,El_Salvador,SV,281,0,6453550,America,23193,618
2020-08-19,El_Salvador,SV,269,15,6453550,America,23462,633
2020-08-20,El_Salvador,SV,255,7,6453550,America,23717,640
2020-08-21,El_Salvador,SV,247,0,6453550,America,23964,640
2020-08-22,El_Salvador,SV,456,14,6453550,America,24420,654
2020-08-23,El_Salvador,SV,0,0,6453550,America,24420,654
2020-08-24,El_Salvador,SV,202,15,6453550,America,24622,669
2020-08-25,El_Salvador,SV,189,9,6453550,America,24811,678
2020-08-26,El_Salvador,SV,175,9,6453550,America,24986,687
2020-08-27,El_Salvador,SV,154,0,6453550,America,25140,687
2020-08-28,El_Salvador,SV,144,7,6453550,America,25284,694
2020-08-29,El_Salvador,SV,131,8,6453550,America,25415,702
2020-08-30,El_Salvador,SV,220,11,6453550,America,25635,713
2020-08-31,El_Salvador,SV,94,4,6453550,America,25729,717
2020-09-01,El_Salvador,SV,91,7,6453550,America,25820,724
2020-09-02,El_Salvador,SV,84,7,6453550,America,25904,731
2020-09-03,El_Salvador,SV,0,8,6453550,America,25904,739
2020-09-04,El_Salvador,SV,96,5,6453550,America,26000,744
2020-09-05,El_Salvador,SV,99,8,6453550,America,26099,752
2020-09-06,El_Salvador,SV,209,7,6453550,America,26308,759
2020-09-07,El_Salvador,SV,0,5,6453550,America,26308,764
2020-09-08,El_Salvador,SV,105,0,6453550,America,26413,764
2020-09-09,El_Salvador,SV,98,1,6453550,America,26511,765
2020-09-10,El_Salvador,SV,91,5,6453550,America,26602,770
2020-09-11,El_Salvador,SV,86,7,6453550,America,26688,777
2020-09-12,El_Salvador,SV,163,5,6453550,America,26851,782
2020-09-13,El_Salvador,SV,77,3,6453550,America,26928,785
2020-09-14,El_Salvador,SV,81,3,6453550,America,27009,788
2020-09-15,El_Salvador,SV,79,4,6453550,America,27088,792
2020-09-16,El_Salvador,SV,75,4,6453550,America,27163,796
2020-09-17,El_Salvador,SV,0,5,6453550,America,27163,801
2020-09-18,El_Salvador,SV,86,0,6453550,America,27249,801
2020-09-19,El_Salvador,SV,97,7,6453550,America,27346,808
2020-09-20,El_Salvador,SV,82,3,6453550,America,27428,811
2020-09-21,El_Salvador,SV,125,1,6453550,America,27553,812
2020-09-22,El_Salvador,SV,245,2,6453550,America,27798,814
2020-09-23,El_Salvador,SV,156,5,6453550,America,27954,819
2020-09-24,El_Salvador,SV,0,0,6453550,America,27954,819
2020-09-25,El_Salvador,SV,247,4,6453550,America,28201,823
2020-09-26,El_Salvador,SV,214,3,6453550,America,28415,826
2020-09-27,El_Salvador,SV,0,0,6453550,America,28415,826
2020-09-28,El_Salvador,SV,215,0,6453550,America,28630,826
2020-09-29,El_Salvador,SV,179,5,6453550,America,28809,831
2020-09-30,El_Salvador,SV,172,12,6453550,America,28981,843
2020-10-01,El_Salvador,SV,96,0,6453550,America,29077,843
2020-10-02,El_Salvador,SV,98,5,6453550,America,29175,848
2020-10-03,El_Salvador,SV,0,5,6453550,America,29175,853
2020-10-04,El_Salvador,SV,183,10,6453550,America,29358,863
2020-10-05,El_Salvador,SV,92,0,6453550,America,29450,863
2020-10-06,El_Salvador,SV,193,6,6453550,America,29643,869
2020-10-07,El_Salvador,SV,94,4,6453550,America,29737,873
2020-10-08,El_Salvador,SV,105,4,6453550,America,29842,877
2020-10-09,El_Salvador,SV,0,4,6453550,America,29842,881
2020-10-10,El_Salvador,SV,109,0,6453550,America,29951,881
2020-10-11,El_Salvador,SV,0,6,6453550,America,29951,887
2020-10-12,El_Salvador,SV,245,7,6453550,America,30196,894
2020-10-13,El_Salvador,SV,0,0,6453550,America,30196,894
2020-10-14,El_Salvador,SV,284,5,6453550,America,30480,899
2020-10-15,El_Salvador,SV,286,5,6453550,America,30766,904
2020-10-16,El_Salvador,SV,295,8,6453550,America,31061,912
2020-10-17,El_Salvador,SV,204,5,6453550,America,31265,917
2020-10-18,El_Salvador,SV,191,5,6453550,America,31456,922
2020-10-19,El_Salvador,SV,210,0,6453550,America,31666,922
2020-10-20,El_Salvador,SV,0,4,6453550,America,31666,926
2020-10-21,El_Salvador,SV,309,7,6453550,America,31975,933
2020-10-22,El_Salvador,SV,145,3,6453550,America,32120,936
2020-10-23,El_Salvador,SV,142,4,6453550,America,32262,940
2020-10-24,El_Salvador,SV,159,4,6453550,America,32421,944
2020-10-25,El_Salvador,SV,164,5,6453550,America,32585,949
2020-10-26,El_Salvador,SV,0,4,6453550,America,32585,953
2020-10-27,El_Salvador,SV,340,0,6453550,America,32925,953
2020-10-28,El_Salvador,SV,0,9,6453550,America,32925,962
2020-10-29,El_Salvador,SV,0,5,6453550,America,32925,967
2020-10-30,El_Salvador,SV,520,4,6453550,America,33445,971
2020-10-31,El_Salvador,SV,0,4,6453550,America,33445,975
2020-11-01,El_Salvador,SV,0,4,6453550,America,33445,979
2020-11-02,El_Salvador,SV,570,4,6453550,America,34015,983
2020-11-03,El_Salvador,SV,0,4,6453550,America,34015,987
2020-11-04,El_Salvador,SV,0,5,6453550,America,34015,992
2020-11-05,El_Salvador,SV,0,5,6453550,America,34015,997
2020-11-06,El_Salvador,SV,767,5,6453550,America,34782,1002
2020-11-07,El_Salvador,SV,363,4,6453550,America,35145,1006
2020-11-08,El_Salvador,SV,0,4,6453550,America,35145,1010
2020-11-09,El_Salvador,SV,0,4,6453550,America,35145,1014
2020-11-10,El_Salvador,SV,0,6,6453550,America,35145,1020
2020-11-11,El_Salvador,SV,0,4,6453550,America,35145,1024
2020-11-12,El_Salvador,SV,0,4,6453550,America,35145,1028
2020-11-13,El_Salvador,SV,885,5,6453550,America,36030,1033
2020-11-14,El_Salvador,SV,165,6,6453550,America,36195,1039
2020-11-15,El_Salvador,SV,163,5,6453550,America,36358,1044
2020-11-16,El_Salvador,SV,0,3,6453550,America,36358,1047
2020-11-17,El_Salvador,SV,311,5,6453550,America,36669,1052
2020-11-18,El_Salvador,SV,0,4,6453550,America,36669,1056
2020-11-19,El_Salvador,SV,296,5,6453550,America,36965,1061
2020-11-20,El_Salvador,SV,144,3,6453550,America,37109,1064
2020-11-21,El_Salvador,SV,141,6,6453550,America,37250,1070
2020-11-22,El_Salvador,SV,0,5,6453550,America,37250,1075
2020-11-23,El_Salvador,SV,312,6,6453550,America,37562,1081
2020-11-24,El_Salvador,SV,322,5,6453550,America,37884,1086
2020-11-25,El_Salvador,SV,0,0,6453550,America,37884,1086
2020-11-26,El_Salvador,SV,0,12,6453550,America,37884,1098
2020-11-27,El_Salvador,SV,521,4,6453550,America,38405,1102
2020-11-28,El_Salvador,SV,0,5,6453550,America,38405,1107
2020-11-29,El_Salvador,SV,0,4,6453550,America,38405,1111
2020-11-30,El_Salvador,SV,0,3,6453550,America,38405,1114
2020-12-01,El_Salvador,SV,536,0,6453550,America,38941,1114
2020-12-02,El_Salvador,SV,189,15,6453550,America,39130,1129
2020-12-03,El_Salvador,SV,0,5,6453550,America,39130,1134
2020-12-04,El_Salvador,SV,588,8,6453550,America,39718,1142
2020-12-05,El_Salvador,SV,0,11,6453550,America,39718,1153
2020-12-06,El_Salvador,SV,413,6,6453550,America,40131,1159
2020-12-07,El_Salvador,SV,214,5,6453550,America,40345,1164
2020-12-08,El_Salvador,SV,0,0,6453550,America,40345,1164
2020-12-09,El_Salvador,SV,396,10,6453550,America,40741,1174
2020-12-10,El_Salvador,SV,0,6,6453550,America,40741,1180
2020-12-11,El_Salvador,SV,0,6,6453550,America,40741,1186
2020-12-12,El_Salvador,SV,422,7,6453550,America,41163,1193
2020-12-13,El_Salvador,SV,231,7,6453550,America,41394,1200
2020-12-14,El_Salvador,SV,486,5,6453550,America,41880,1205
2020-03-03,Sint_Maarten,SX,1,0,42389,America,1,0
2020-03-26,Sint_Maarten,SX,1,0,42389,America,2,0
2020-03-27,Sint_Maarten,SX,0,0,42389,America,2,0
2020-03-28,Sint_Maarten,SX,1,0,42389,America,3,0
2020-03-29,Sint_Maarten,SX,0,0,42389,America,3,0
2020-03-30,Sint_Maarten,SX,0,0,42389,America,3,0
2020-04-01,Sint_Maarten,SX,3,0,42389,America,6,0
2020-04-02,Sint_Maarten,SX,10,1,42389,America,16,1
2020-04-03,Sint_Maarten,SX,7,1,42389,America,23,2
2020-04-04,Sint_Maarten,SX,0,0,42389,America,23,2
2020-04-05,Sint_Maarten,SX,0,0,42389,America,23,2
2020-04-06,Sint_Maarten,SX,2,2,42389,America,25,4
2020-04-07,Sint_Maarten,SX,0,0,42389,America,25,4
2020-04-08,Sint_Maarten,SX,15,4,42389,America,40,8
2020-04-09,Sint_Maarten,SX,0,0,42389,America,40,8
2020-04-10,Sint_Maarten,SX,10,0,42389,America,50,8
2020-04-11,Sint_Maarten,SX,0,1,42389,America,50,9
2020-04-12,Sint_Maarten,SX,0,0,42389,America,50,9
2020-04-13,Sint_Maarten,SX,0,0,42389,America,50,9
2020-04-14,Sint_Maarten,SX,2,0,42389,America,52,9
2020-04-15,Sint_Maarten,SX,0,0,42389,America,52,9
2020-04-16,Sint_Maarten,SX,5,0,42389,America,57,9
2020-04-17,Sint_Maarten,SX,0,0,42389,America,57,9
2020-04-18,Sint_Maarten,SX,0,0,42389,America,57,9
2020-04-19,Sint_Maarten,SX,7,0,42389,America,64,9
2020-04-20,Sint_Maarten,SX,3,1,42389,America,67,10
2020-04-21,Sint_Maarten,SX,1,0,42389,America,68,10
2020-04-22,Sint_Maarten,SX,0,0,42389,America,68,10
2020-04-23,Sint_Maarten,SX,5,2,42389,America,73,12
2020-04-24,Sint_Maarten,SX,0,0,42389,America,73,12
2020-04-25,Sint_Maarten,SX,0,0,42389,America,73,12
2020-04-26,Sint_Maarten,SX,0,0,42389,America,73,12
2020-04-27,Sint_Maarten,SX,1,1,42389,America,74,13
2020-04-28,Sint_Maarten,SX,1,0,42389,America,75,13
2020-04-29,Sint_Maarten,SX,0,0,42389,America,75,13
2020-04-30,Sint_Maarten,SX,1,0,42389,America,76,13
2020-05-01,Sint_Maarten,SX,0,0,42389,America,76,13
2020-05-02,Sint_Maarten,SX,0,0,42389,America,76,13
2020-05-03,Sint_Maarten,SX,0,0,42389,America,76,13
2020-05-04,Sint_Maarten,SX,0,0,42389,America,76,13
2020-05-05,Sint_Maarten,SX,0,0,42389,America,76,13
2020-05-06,Sint_Maarten,SX,0,1,42389,America,76,14
2020-05-07,Sint_Maarten,SX,0,0,42389,America,76,14
2020-05-08,Sint_Maarten,SX,0,0,42389,America,76,14
2020-05-09,Sint_Maarten,SX,0,1,42389,America,76,15
2020-05-10,Sint_Maarten,SX,0,0,42389,America,76,15
2020-05-11,Sint_Maarten,SX,0,0,42389,America,76,15
2020-05-12,Sint_Maarten,SX,0,0,42389,America,76,15
2020-05-13,Sint_Maarten,SX,1,0,42389,America,77,15
2020-05-14,Sint_Maarten,SX,0,0,42389,America,77,15
2020-05-15,Sint_Maarten,SX,0,0,42389,America,77,15
2020-05-16,Sint_Maarten,SX,0,0,42389,America,77,15
2020-05-17,Sint_Maarten,SX,0,0,42389,America,77,15
2020-05-18,Sint_Maarten,SX,0,0,42389,America,77,15
2020-05-19,Sint_Maarten,SX,0,0,42389,America,77,15
2020-05-20,Sint_Maarten,SX,0,0,42389,America,77,15
2020-05-21,Sint_Maarten,SX,0,0,42389,America,77,15
2020-05-22,Sint_Maarten,SX,0,0,42389,America,77,15
2020-05-23,Sint_Maarten,SX,0,0,42389,America,77,15
2020-05-24,Sint_Maarten,SX,0,0,42389,America,77,15
2020-05-25,Sint_Maarten,SX,0,0,42389,America,77,15
2020-05-26,Sint_Maarten,SX,0,0,42389,America,77,15
2020-05-27,Sint_Maarten,SX,0,0,42389,America,77,15
2020-05-28,Sint_Maarten,SX,0,0,42389,America,77,15
2020-05-29,Sint_Maarten,SX,0,0,42389,America,77,15
2020-05-30,Sint_Maarten,SX,0,0,42389,America,77,15
2020-05-31,Sint_Maarten,SX,0,0,42389,America,77,15
2020-06-01,Sint_Maarten,SX,0,0,42389,America,77,15
2020-06-02,Sint_Maarten,SX,0,0,42389,America,77,15
2020-06-03,Sint_Maarten,SX,0,0,42389,America,77,15
2020-06-04,Sint_Maarten,SX,0,0,42389,America,77,15
2020-06-05,Sint_Maarten,SX,0,0,42389,America,77,15
2020-06-06,Sint_Maarten,SX,0,0,42389,America,77,15
2020-06-07,Sint_Maarten,SX,0,0,42389,America,77,15
2020-06-08,Sint_Maarten,SX,0,0,42389,America,77,15
2020-06-09,Sint_Maarten,SX,0,0,42389,America,77,15
2020-06-10,Sint_Maarten,SX,0,0,42389,America,77,15
2020-06-11,Sint_Maarten,SX,0,0,42389,America,77,15
2020-06-12,Sint_Maarten,SX,0,0,42389,America,77,15
2020-06-13,Sint_Maarten,SX,0,0,42389,America,77,15
2020-06-14,Sint_Maarten,SX,0,0,42389,America,77,15
2020-06-15,Sint_Maarten,SX,0,0,42389,America,77,15
2020-06-16,Sint_Maarten,SX,0,0,42389,America,77,15
2020-06-17,Sint_Maarten,SX,0,0,42389,America,77,15
2020-06-18,Sint_Maarten,SX,0,0,42389,America,77,15
2020-06-19,Sint_Maarten,SX,0,0,42389,America,77,15
2020-06-20,Sint_Maarten,SX,0,0,42389,America,77,15
2020-06-21,Sint_Maarten,SX,0,0,42389,America,77,15
2020-06-22,Sint_Maarten,SX,0,0,42389,America,77,15
2020-06-23,Sint_Maarten,SX,0,0,42389,America,77,15
2020-06-24,Sint_Maarten,SX,0,0,42389,America,77,15
2020-06-25,Sint_Maarten,SX,0,0,42389,America,77,15
2020-06-26,Sint_Maarten,SX,0,0,42389,America,77,15
2020-06-27,Sint_Maarten,SX,0,0,42389,America,77,15
2020-06-28,Sint_Maarten,SX,0,0,42389,America,77,15
2020-06-29,Sint_Maarten,SX,0,0,42389,America,77,15
2020-06-30,Sint_Maarten,SX,0,0,42389,America,77,15
2020-07-01,Sint_Maarten,SX,0,0,42389,America,77,15
2020-07-02,Sint_Maarten,SX,0,0,42389,America,77,15
2020-07-03,Sint_Maarten,SX,0,0,42389,America,77,15
2020-07-04,Sint_Maarten,SX,0,0,42389,America,77,15
2020-07-05,Sint_Maarten,SX,1,0,42389,America,78,15
2020-07-06,Sint_Maarten,SX,0,0,42389,America,78,15
2020-07-07,Sint_Maarten,SX,0,0,42389,America,78,15
2020-07-08,Sint_Maarten,SX,0,0,42389,America,78,15
2020-07-09,Sint_Maarten,SX,0,0,42389,America,78,15
2020-07-10,Sint_Maarten,SX,0,0,42389,America,78,15
2020-07-11,Sint_Maarten,SX,0,0,42389,America,78,15
2020-07-12,Sint_Maarten,SX,0,0,42389,America,78,15
2020-07-13,Sint_Maarten,SX,0,0,42389,America,78,15
2020-07-14,Sint_Maarten,SX,0,0,42389,America,78,15
2020-07-15,Sint_Maarten,SX,0,0,42389,America,78,15
2020-07-16,Sint_Maarten,SX,0,0,42389,America,78,15
2020-07-17,Sint_Maarten,SX,1,0,42389,America,79,15
2020-07-18,Sint_Maarten,SX,0,0,42389,America,79,15
2020-07-19,Sint_Maarten,SX,0,0,42389,America,79,15
2020-07-20,Sint_Maarten,SX,0,0,42389,America,79,15
2020-07-21,Sint_Maarten,SX,0,0,42389,America,79,15
2020-07-22,Sint_Maarten,SX,0,0,42389,America,79,15
2020-07-23,Sint_Maarten,SX,2,0,42389,America,81,15
2020-07-24,Sint_Maarten,SX,3,0,42389,America,84,15
2020-07-25,Sint_Maarten,SX,10,0,42389,America,94,15
2020-07-26,Sint_Maarten,SX,0,0,42389,America,94,15
2020-07-27,Sint_Maarten,SX,0,0,42389,America,94,15
2020-07-28,Sint_Maarten,SX,20,0,42389,America,114,15
2020-07-29,Sint_Maarten,SX,7,0,42389,America,121,15
2020-07-30,Sint_Maarten,SX,0,0,42389,America,121,15
2020-07-31,Sint_Maarten,SX,7,0,42389,America,128,15
2020-08-01,Sint_Maarten,SX,0,0,42389,America,128,15
2020-08-02,Sint_Maarten,SX,0,0,42389,America,128,15
2020-08-03,Sint_Maarten,SX,18,1,42389,America,146,16
2020-08-04,Sint_Maarten,SX,4,0,42389,America,150,16
2020-08-05,Sint_Maarten,SX,6,0,42389,America,156,16
2020-08-06,Sint_Maarten,SX,4,0,42389,America,160,16
2020-08-07,Sint_Maarten,SX,16,0,42389,America,176,16
2020-08-08,Sint_Maarten,SX,1,1,42389,America,177,17
2020-08-09,Sint_Maarten,SX,12,0,42389,America,189,17
2020-08-10,Sint_Maarten,SX,0,0,42389,America,189,17
2020-08-11,Sint_Maarten,SX,0,0,42389,America,189,17
2020-08-12,Sint_Maarten,SX,30,0,42389,America,219,17
2020-08-13,Sint_Maarten,SX,29,0,42389,America,248,17
2020-08-14,Sint_Maarten,SX,15,0,42389,America,263,17
2020-08-15,Sint_Maarten,SX,6,0,42389,America,269,17
2020-08-16,Sint_Maarten,SX,31,0,42389,America,300,17
2020-08-17,Sint_Maarten,SX,17,0,42389,America,317,17
2020-08-18,Sint_Maarten,SX,9,0,42389,America,326,17
2020-08-19,Sint_Maarten,SX,0,0,42389,America,326,17
2020-08-20,Sint_Maarten,SX,22,0,42389,America,348,17
2020-08-21,Sint_Maarten,SX,5,0,42389,America,353,17
2020-08-22,Sint_Maarten,SX,0,0,42389,America,353,17
2020-08-23,Sint_Maarten,SX,15,0,42389,America,368,17
2020-08-24,Sint_Maarten,SX,28,0,42389,America,396,17
2020-08-25,Sint_Maarten,SX,12,0,42389,America,408,17
2020-08-26,Sint_Maarten,SX,10,0,42389,America,418,17
2020-08-27,Sint_Maarten,SX,24,0,42389,America,442,17
2020-08-28,Sint_Maarten,SX,2,0,42389,America,444,17
2020-08-29,Sint_Maarten,SX,0,0,42389,America,444,17
2020-08-30,Sint_Maarten,SX,16,0,42389,America,460,17
2020-08-31,Sint_Maarten,SX,3,0,42389,America,463,17
2020-09-01,Sint_Maarten,SX,13,0,42389,America,476,17
2020-09-02,Sint_Maarten,SX,6,2,42389,America,482,19
2020-09-03,Sint_Maarten,SX,0,0,42389,America,482,19
2020-09-04,Sint_Maarten,SX,22,0,42389,America,504,19
2020-09-05,Sint_Maarten,SX,7,0,42389,America,511,19
2020-09-06,Sint_Maarten,SX,0,0,42389,America,511,19
2020-09-07,Sint_Maarten,SX,0,0,42389,America,511,19
2020-09-08,Sint_Maarten,SX,5,0,42389,America,516,19
2020-09-09,Sint_Maarten,SX,11,0,42389,America,527,19
2020-09-10,Sint_Maarten,SX,3,0,42389,America,530,19
2020-09-11,Sint_Maarten,SX,0,0,42389,America,530,19
2020-09-12,Sint_Maarten,SX,1,0,42389,America,531,19
2020-09-13,Sint_Maarten,SX,2,0,42389,America,533,19
2020-09-14,Sint_Maarten,SX,16,0,42389,America,549,19
2020-09-15,Sint_Maarten,SX,0,0,42389,America,549,19
2020-09-16,Sint_Maarten,SX,0,0,42389,America,549,19
2020-09-17,Sint_Maarten,SX,8,0,42389,America,557,19
2020-09-18,Sint_Maarten,SX,8,0,42389,America,565,19
2020-09-19,Sint_Maarten,SX,9,1,42389,America,574,20
2020-09-20,Sint_Maarten,SX,10,0,42389,America,584,20
2020-09-21,Sint_Maarten,SX,0,0,42389,America,584,20
2020-09-22,Sint_Maarten,SX,7,0,42389,America,591,20
2020-09-23,Sint_Maarten,SX,3,0,42389,America,594,20
2020-09-24,Sint_Maarten,SX,22,1,42389,America,616,21
2020-09-25,Sint_Maarten,SX,2,1,42389,America,618,22
2020-09-26,Sint_Maarten,SX,9,0,42389,America,627,22
2020-09-27,Sint_Maarten,SX,6,0,42389,America,633,22
2020-09-28,Sint_Maarten,SX,11,0,42389,America,644,22
2020-09-29,Sint_Maarten,SX,1,0,42389,America,645,22
2020-09-30,Sint_Maarten,SX,14,0,42389,America,659,22
2020-10-01,Sint_Maarten,SX,8,0,42389,America,667,22
2020-10-02,Sint_Maarten,SX,1,0,42389,America,668,22
2020-10-03,Sint_Maarten,SX,6,0,42389,America,674,22
2020-10-04,Sint_Maarten,SX,4,0,42389,America,678,22
2020-10-05,Sint_Maarten,SX,1,0,42389,America,679,22
2020-10-06,Sint_Maarten,SX,7,0,42389,America,686,22
2020-10-07,Sint_Maarten,SX,0,0,42389,America,686,22
2020-10-08,Sint_Maarten,SX,3,0,42389,America,689,22
2020-10-09,Sint_Maarten,SX,9,0,42389,America,698,22
2020-10-10,Sint_Maarten,SX,5,0,42389,America,703,22
2020-10-11,Sint_Maarten,SX,4,0,42389,America,707,22
2020-10-12,Sint_Maarten,SX,3,0,42389,America,710,22
2020-10-13,Sint_Maarten,SX,0,0,42389,America,710,22
2020-10-14,Sint_Maarten,SX,9,0,42389,America,719,22
2020-10-15,Sint_Maarten,SX,10,0,42389,America,729,22
2020-10-16,Sint_Maarten,SX,8,0,42389,America,737,22
2020-10-17,Sint_Maarten,SX,9,0,42389,America,746,22
2020-10-18,Sint_Maarten,SX,3,0,42389,America,749,22
2020-10-19,Sint_Maarten,SX,4,0,42389,America,753,22
2020-10-20,Sint_Maarten,SX,3,0,42389,America,756,22
2020-10-21,Sint_Maarten,SX,0,0,42389,America,756,22
2020-10-22,Sint_Maarten,SX,13,0,42389,America,769,22
2020-10-23,Sint_Maarten,SX,7,0,42389,America,776,22
2020-10-24,Sint_Maarten,SX,4,0,42389,America,780,22
2020-10-25,Sint_Maarten,SX,0,0,42389,America,780,22
2020-10-26,Sint_Maarten,SX,4,0,42389,America,784,22
2020-10-27,Sint_Maarten,SX,5,0,42389,America,789,22
2020-10-28,Sint_Maarten,SX,0,0,42389,America,789,22
2020-10-29,Sint_Maarten,SX,16,0,42389,America,805,22
2020-10-30,Sint_Maarten,SX,0,0,42389,America,805,22
2020-10-31,Sint_Maarten,SX,0,0,42389,America,805,22
2020-11-01,Sint_Maarten,SX,21,0,42389,America,826,22
2020-11-02,Sint_Maarten,SX,5,0,42389,America,831,22
2020-11-03,Sint_Maarten,SX,13,0,42389,America,844,22
2020-11-04,Sint_Maarten,SX,15,0,42389,America,859,22
2020-11-05,Sint_Maarten,SX,11,0,42389,America,870,22
2020-11-06,Sint_Maarten,SX,7,1,42389,America,877,23
2020-11-07,Sint_Maarten,SX,9,0,42389,America,886,23
2020-11-08,Sint_Maarten,SX,0,0,42389,America,886,23
2020-11-09,Sint_Maarten,SX,10,0,42389,America,896,23
2020-11-10,Sint_Maarten,SX,0,0,42389,America,896,23
2020-11-11,Sint_Maarten,SX,12,0,42389,America,908,23
2020-11-12,Sint_Maarten,SX,2,0,42389,America,910,23
2020-11-13,Sint_Maarten,SX,4,0,42389,America,914,23
2020-11-14,Sint_Maarten,SX,9,1,42389,America,923,24
2020-11-15,Sint_Maarten,SX,0,0,42389,America,923,24
2020-11-16,Sint_Maarten,SX,10,0,42389,America,933,24
2020-11-17,Sint_Maarten,SX,6,0,42389,America,939,24
2020-11-18,Sint_Maarten,SX,15,0,42389,America,954,24
2020-11-19,Sint_Maarten,SX,10,0,42389,America,964,24
2020-11-20,Sint_Maarten,SX,9,0,42389,America,973,24
2020-11-21,Sint_Maarten,SX,10,1,42389,America,983,25
2020-11-22,Sint_Maarten,SX,13,0,42389,America,996,25
2020-11-23,Sint_Maarten,SX,11,0,42389,America,1007,25
2020-11-24,Sint_Maarten,SX,10,0,42389,America,1017,25
2020-11-25,Sint_Maarten,SX,3,0,42389,America,1020,25
2020-11-26,Sint_Maarten,SX,16,0,42389,America,1036,25
2020-11-27,Sint_Maarten,SX,5,0,42389,America,1041,25
2020-11-28,Sint_Maarten,SX,12,0,42389,America,1053,25
2020-11-29,Sint_Maarten,SX,9,0,42389,America,1062,25
2020-11-30,Sint_Maarten,SX,4,0,42389,America,1066,25
2020-12-01,Sint_Maarten,SX,3,0,42389,America,1069,25
2020-12-02,Sint_Maarten,SX,3,0,42389,America,1072,25
2020-12-03,Sint_Maarten,SX,20,0,42389,America,1092,25
2020-12-04,Sint_Maarten,SX,13,0,42389,America,1105,25
2020-12-05,Sint_Maarten,SX,15,1,42389,America,1120,26
2020-12-06,Sint_Maarten,SX,19,0,42389,America,1139,26
2020-12-07,Sint_Maarten,SX,2,0,42389,America,1141,26
2020-12-08,Sint_Maarten,SX,14,0,42389,America,1155,26
2020-12-09,Sint_Maarten,SX,6,0,42389,America,1161,26
2020-12-10,Sint_Maarten,SX,24,0,42389,America,1185,26
2020-12-11,Sint_Maarten,SX,16,0,42389,America,1201,26
2020-12-12,Sint_Maarten,SX,24,0,42389,America,1225,26
2020-12-13,Sint_Maarten,SX,7,0,42389,America,1232,26
2020-12-14,Sint_Maarten,SX,0,0,42389,America,1232,26
2020-03-23,Syria,SY,1,0,17070132,Asia,1,0
2020-03-24,Syria,SY,0,0,17070132,Asia,1,0
2020-03-25,Syria,SY,0,0,17070132,Asia,1,0
2020-03-26,Syria,SY,0,0,17070132,Asia,1,0
2020-03-27,Syria,SY,4,0,17070132,Asia,5,0
2020-03-28,Syria,SY,0,0,17070132,Asia,5,0
2020-03-29,Syria,SY,0,0,17070132,Asia,5,0
2020-03-30,Syria,SY,4,1,17070132,Asia,9,1
2020-03-31,Syria,SY,1,1,17070132,Asia,10,2
2020-04-01,Syria,SY,0,0,17070132,Asia,10,2
2020-04-02,Syria,SY,0,0,17070132,Asia,10,2
2020-04-03,Syria,SY,6,0,17070132,Asia,16,2
2020-04-04,Syria,SY,0,0,17070132,Asia,16,2
2020-04-05,Syria,SY,0,0,17070132,Asia,16,2
2020-04-06,Syria,SY,3,0,17070132,Asia,19,2
2020-04-07,Syria,SY,0,0,17070132,Asia,19,2
2020-04-08,Syria,SY,0,0,17070132,Asia,19,2
2020-04-09,Syria,SY,0,0,17070132,Asia,19,2
2020-04-10,Syria,SY,0,0,17070132,Asia,19,2
2020-04-11,Syria,SY,0,0,17070132,Asia,19,2
2020-04-12,Syria,SY,6,0,17070132,Asia,25,2
2020-04-13,Syria,SY,0,0,17070132,Asia,25,2
2020-04-14,Syria,SY,0,0,17070132,Asia,25,2
2020-04-15,Syria,SY,4,0,17070132,Asia,29,2
2020-04-16,Syria,SY,4,0,17070132,Asia,33,2
2020-04-17,Syria,SY,0,0,17070132,Asia,33,2
2020-04-18,Syria,SY,5,0,17070132,Asia,38,2
2020-04-19,Syria,SY,0,0,17070132,Asia,38,2
2020-04-20,Syria,SY,1,1,17070132,Asia,39,3
2020-04-21,Syria,SY,0,0,17070132,Asia,39,3
2020-04-22,Syria,SY,3,0,17070132,Asia,42,3
2020-04-23,Syria,SY,0,0,17070132,Asia,42,3
2020-04-24,Syria,SY,0,0,17070132,Asia,42,3
2020-04-25,Syria,SY,0,0,17070132,Asia,42,3
2020-04-26,Syria,SY,0,0,17070132,Asia,42,3
2020-04-27,Syria,SY,1,0,17070132,Asia,43,3
2020-04-28,Syria,SY,0,0,17070132,Asia,43,3
2020-04-29,Syria,SY,0,0,17070132,Asia,43,3
2020-04-30,Syria,SY,0,0,17070132,Asia,43,3
2020-05-01,Syria,SY,0,0,17070132,Asia,43,3
2020-05-02,Syria,SY,1,0,17070132,Asia,44,3
2020-05-03,Syria,SY,0,0,17070132,Asia,44,3
2020-05-04,Syria,SY,0,0,17070132,Asia,44,3
2020-05-05,Syria,SY,0,0,17070132,Asia,44,3
2020-05-06,Syria,SY,0,0,17070132,Asia,44,3
2020-05-07,Syria,SY,1,0,17070132,Asia,45,3
2020-05-08,Syria,SY,0,0,17070132,Asia,45,3
2020-05-09,Syria,SY,2,0,17070132,Asia,47,3
2020-05-10,Syria,SY,0,0,17070132,Asia,47,3
2020-05-11,Syria,SY,0,0,17070132,Asia,47,3
2020-05-12,Syria,SY,0,0,17070132,Asia,47,3
2020-05-13,Syria,SY,0,0,17070132,Asia,47,3
2020-05-14,Syria,SY,1,0,17070132,Asia,48,3
2020-05-15,Syria,SY,0,0,17070132,Asia,48,3
2020-05-16,Syria,SY,2,0,17070132,Asia,50,3
2020-05-17,Syria,SY,1,0,17070132,Asia,51,3
2020-05-18,Syria,SY,7,0,17070132,Asia,58,3
2020-05-19,Syria,SY,0,0,17070132,Asia,58,3
2020-05-20,Syria,SY,0,0,17070132,Asia,58,3
2020-05-21,Syria,SY,0,0,17070132,Asia,58,3
2020-05-22,Syria,SY,0,0,17070132,Asia,58,3
2020-05-23,Syria,SY,1,1,17070132,Asia,59,4
2020-05-24,Syria,SY,11,0,17070132,Asia,70,4
2020-05-25,Syria,SY,16,0,17070132,Asia,86,4
2020-05-26,Syria,SY,20,0,17070132,Asia,106,4
2020-05-27,Syria,SY,15,0,17070132,Asia,121,4
2020-05-28,Syria,SY,0,0,17070132,Asia,121,4
2020-05-29,Syria,SY,0,0,17070132,Asia,121,4
2020-05-30,Syria,SY,1,0,17070132,Asia,122,4
2020-05-31,Syria,SY,0,0,17070132,Asia,122,4
2020-06-01,Syria,SY,0,0,17070132,Asia,122,4
2020-06-02,Syria,SY,1,1,17070132,Asia,123,5
2020-06-03,Syria,SY,0,1,17070132,Asia,123,6
2020-06-04,Syria,SY,0,0,17070132,Asia,123,6
2020-06-05,Syria,SY,1,0,17070132,Asia,124,6
2020-06-06,Syria,SY,0,0,17070132,Asia,124,6
2020-06-07,Syria,SY,0,0,17070132,Asia,124,6
2020-06-08,Syria,SY,17,0,17070132,Asia,141,6
2020-06-09,Syria,SY,3,0,17070132,Asia,144,6
2020-06-10,Syria,SY,2,0,17070132,Asia,146,6
2020-06-11,Syria,SY,6,0,17070132,Asia,152,6
2020-06-12,Syria,SY,12,0,17070132,Asia,164,6
2020-06-13,Syria,SY,0,0,17070132,Asia,164,6
2020-06-14,Syria,SY,6,0,17070132,Asia,170,6
2020-06-15,Syria,SY,7,0,17070132,Asia,177,6
2020-06-16,Syria,SY,0,0,17070132,Asia,177,6
2020-06-17,Syria,SY,0,0,17070132,Asia,177,6
2020-06-18,Syria,SY,1,1,17070132,Asia,178,7
2020-06-19,Syria,SY,9,0,17070132,Asia,187,7
2020-06-20,Syria,SY,0,0,17070132,Asia,187,7
2020-06-21,Syria,SY,11,0,17070132,Asia,198,7
2020-06-22,Syria,SY,6,0,17070132,Asia,204,7
2020-06-23,Syria,SY,15,0,17070132,Asia,219,7
2020-06-24,Syria,SY,12,0,17070132,Asia,231,7
2020-06-25,Syria,SY,0,0,17070132,Asia,231,7
2020-06-26,Syria,SY,11,0,17070132,Asia,242,7
2020-06-27,Syria,SY,13,1,17070132,Asia,255,8
2020-06-28,Syria,SY,1,1,17070132,Asia,256,9
2020-06-29,Syria,SY,0,0,17070132,Asia,256,9
2020-06-30,Syria,SY,13,0,17070132,Asia,269,9
2020-07-01,Syria,SY,10,0,17070132,Asia,279,9
2020-07-02,Syria,SY,14,0,17070132,Asia,293,9
2020-07-03,Syria,SY,19,0,17070132,Asia,312,9
2020-07-04,Syria,SY,16,1,17070132,Asia,328,10
2020-07-05,Syria,SY,10,0,17070132,Asia,338,10
2020-07-06,Syria,SY,20,3,17070132,Asia,358,13
2020-07-07,Syria,SY,14,1,17070132,Asia,372,14
2020-07-08,Syria,SY,0,0,17070132,Asia,372,14
2020-07-09,Syria,SY,0,0,17070132,Asia,372,14
2020-07-10,Syria,SY,0,0,17070132,Asia,372,14
2020-07-11,Syria,SY,22,2,17070132,Asia,394,16
2020-07-12,Syria,SY,0,0,17070132,Asia,394,16
2020-07-13,Syria,SY,0,0,17070132,Asia,394,16
2020-07-14,Syria,SY,23,3,17070132,Asia,417,19
2020-07-15,Syria,SY,22,2,17070132,Asia,439,21
2020-07-16,Syria,SY,19,1,17070132,Asia,458,22
2020-07-17,Syria,SY,19,0,17070132,Asia,477,22
2020-07-18,Syria,SY,19,3,17070132,Asia,496,25
2020-07-19,Syria,SY,0,0,17070132,Asia,496,25
2020-07-20,Syria,SY,0,0,17070132,Asia,496,25
2020-07-21,Syria,SY,26,4,17070132,Asia,522,29
2020-07-22,Syria,SY,18,2,17070132,Asia,540,31
2020-07-23,Syria,SY,21,1,17070132,Asia,561,32
2020-07-24,Syria,SY,23,3,17070132,Asia,584,35
2020-07-25,Syria,SY,0,0,17070132,Asia,584,35
2020-07-26,Syria,SY,43,1,17070132,Asia,627,36
2020-07-27,Syria,SY,23,2,17070132,Asia,650,38
2020-07-28,Syria,SY,24,2,17070132,Asia,674,40
2020-07-29,Syria,SY,20,0,17070132,Asia,694,40
2020-07-30,Syria,SY,23,0,17070132,Asia,717,40
2020-07-31,Syria,SY,21,1,17070132,Asia,738,41
2020-08-01,Syria,SY,0,0,17070132,Asia,738,41
2020-08-02,Syria,SY,19,2,17070132,Asia,757,43
2020-08-03,Syria,SY,52,1,17070132,Asia,809,44
2020-08-04,Syria,SY,38,2,17070132,Asia,847,46
2020-08-05,Syria,SY,45,0,17070132,Asia,892,46
2020-08-06,Syria,SY,52,2,17070132,Asia,944,48
2020-08-07,Syria,SY,0,0,17070132,Asia,944,48
2020-08-08,Syria,SY,116,0,17070132,Asia,1060,48
2020-08-09,Syria,SY,65,2,17070132,Asia,1125,50
2020-08-10,Syria,SY,63,2,17070132,Asia,1188,52
2020-08-11,Syria,SY,0,0,17070132,Asia,1188,52
2020-08-12,Syria,SY,139,1,17070132,Asia,1327,53
2020-08-13,Syria,SY,5,0,17070132,Asia,1332,53
2020-08-14,Syria,SY,100,2,17070132,Asia,1432,55
2020-08-15,Syria,SY,83,3,17070132,Asia,1515,58
2020-08-16,Syria,SY,78,2,17070132,Asia,1593,60
2020-08-17,Syria,SY,84,4,17070132,Asia,1677,64
2020-08-18,Syria,SY,87,4,17070132,Asia,1764,68
2020-08-19,Syria,SY,0,0,17070132,Asia,1764,68
2020-08-20,Syria,SY,163,10,17070132,Asia,1927,78
2020-08-21,Syria,SY,81,4,17070132,Asia,2008,82
2020-08-22,Syria,SY,65,1,17070132,Asia,2073,83
2020-08-23,Syria,SY,70,2,17070132,Asia,2143,85
2020-08-24,Syria,SY,0,0,17070132,Asia,2143,85
2020-08-25,Syria,SY,150,7,17070132,Asia,2293,92
2020-08-26,Syria,SY,0,0,17070132,Asia,2293,92
2020-08-27,Syria,SY,147,6,17070132,Asia,2440,98
2020-08-28,Syria,SY,64,2,17070132,Asia,2504,100
2020-08-29,Syria,SY,59,3,17070132,Asia,2563,103
2020-08-30,Syria,SY,65,3,17070132,Asia,2628,106
2020-08-31,Syria,SY,75,3,17070132,Asia,2703,109
2020-09-01,Syria,SY,62,3,17070132,Asia,2765,112
2020-09-02,Syria,SY,65,4,17070132,Asia,2830,116
2020-09-03,Syria,SY,68,4,17070132,Asia,2898,120
2020-09-04,Syria,SY,75,4,17070132,Asia,2973,124
2020-09-05,Syria,SY,68,3,17070132,Asia,3041,127
2020-09-06,Syria,SY,63,3,17070132,Asia,3104,130
2020-09-07,Syria,SY,67,4,17070132,Asia,3171,134
2020-09-08,Syria,SY,58,3,17070132,Asia,3229,137
2020-09-09,Syria,SY,60,3,17070132,Asia,3289,140
2020-09-10,Syria,SY,62,3,17070132,Asia,3351,143
2020-09-11,Syria,SY,65,4,17070132,Asia,3416,147
2020-09-12,Syria,SY,60,3,17070132,Asia,3476,150
2020-09-13,Syria,SY,30,2,17070132,Asia,3506,152
2020-09-14,Syria,SY,34,3,17070132,Asia,3540,155
2020-09-15,Syria,SY,36,2,17070132,Asia,3576,157
2020-09-16,Syria,SY,38,3,17070132,Asia,3614,160
2020-09-17,Syria,SY,40,3,17070132,Asia,3654,163
2020-09-18,Syria,SY,37,2,17070132,Asia,3691,165
2020-09-19,Syria,SY,40,3,17070132,Asia,3731,168
2020-09-20,Syria,SY,34,0,17070132,Asia,3765,168
2020-09-21,Syria,SY,35,4,17070132,Asia,3800,172
2020-09-22,Syria,SY,33,3,17070132,Asia,3833,175
2020-09-23,Syria,SY,44,3,17070132,Asia,3877,178
2020-09-24,Syria,SY,47,3,17070132,Asia,3924,181
2020-09-25,Syria,SY,42,2,17070132,Asia,3966,183
2020-09-26,Syria,SY,35,2,17070132,Asia,4001,185
2020-09-27,Syria,SY,37,3,17070132,Asia,4038,188
2020-09-28,Syria,SY,34,4,17070132,Asia,4072,192
2020-09-29,Syria,SY,30,2,17070132,Asia,4102,194
2020-09-30,Syria,SY,46,3,17070132,Asia,4148,197
2020-10-01,Syria,SY,52,3,17070132,Asia,4200,200
2020-10-02,Syria,SY,47,2,17070132,Asia,4247,202
2020-10-03,Syria,SY,42,1,17070132,Asia,4289,203
2020-10-04,Syria,SY,40,1,17070132,Asia,4329,204
2020-10-05,Syria,SY,37,1,17070132,Asia,4366,205
2020-10-06,Syria,SY,45,2,17070132,Asia,4411,207
2020-10-07,Syria,SY,46,2,17070132,Asia,4457,209
2020-10-08,Syria,SY,47,3,17070132,Asia,4504,212
2020-10-09,Syria,SY,62,3,17070132,Asia,4566,215
2020-10-10,Syria,SY,50,3,17070132,Asia,4616,218
2020-10-11,Syria,SY,57,3,17070132,Asia,4673,221
2020-10-12,Syria,SY,0,0,17070132,Asia,4673,221
2020-10-13,Syria,SY,101,7,17070132,Asia,4774,228
2020-10-14,Syria,SY,52,3,17070132,Asia,4826,231
2020-10-15,Syria,SY,57,3,17070132,Asia,4883,234
2020-10-16,Syria,SY,48,4,17070132,Asia,4931,238
2020-10-17,Syria,SY,56,3,17070132,Asia,4987,241
2020-10-18,Syria,SY,46,4,17070132,Asia,5033,245
2020-10-19,Syria,SY,44,3,17070132,Asia,5077,248
2020-10-20,Syria,SY,57,3,17070132,Asia,5134,251
2020-10-21,Syria,SY,46,3,17070132,Asia,5180,254
2020-10-22,Syria,SY,44,3,17070132,Asia,5224,257
2020-10-23,Syria,SY,43,3,17070132,Asia,5267,260
2020-10-24,Syria,SY,52,4,17070132,Asia,5319,264
2020-10-25,Syria,SY,40,3,17070132,Asia,5359,267
2020-10-26,Syria,SY,49,2,17070132,Asia,5408,269
2020-10-27,Syria,SY,53,3,17070132,Asia,5461,272
2020-10-28,Syria,SY,67,3,17070132,Asia,5528,275
2020-10-29,Syria,SY,52,3,17070132,Asia,5580,278
2020-10-30,Syria,SY,53,3,17070132,Asia,5633,281
2020-10-31,Syria,SY,50,4,17070132,Asia,5683,285
2020-11-01,Syria,SY,45,3,17070132,Asia,5728,288
2020-11-02,Syria,SY,61,4,17070132,Asia,5789,292
2020-11-03,Syria,SY,54,3,17070132,Asia,5843,295
2020-11-04,Syria,SY,45,3,17070132,Asia,5888,298
2020-11-05,Syria,SY,76,3,17070132,Asia,5964,301
2020-11-06,Syria,SY,76,4,17070132,Asia,6040,305
2020-11-07,Syria,SY,62,4,17070132,Asia,6102,309
2020-11-08,Syria,SY,45,4,17070132,Asia,6147,313
2020-11-09,Syria,SY,68,4,17070132,Asia,6215,317
2020-11-10,Syria,SY,69,4,17070132,Asia,6284,321
2020-11-11,Syria,SY,68,4,17070132,Asia,6352,325
2020-11-12,Syria,SY,69,4,17070132,Asia,6421,329
2020-11-13,Syria,SY,65,4,17070132,Asia,6486,333
2020-11-14,Syria,SY,66,4,17070132,Asia,6552,337
2020-11-15,Syria,SY,61,4,17070132,Asia,6613,341
2020-11-16,Syria,SY,71,4,17070132,Asia,6684,345
2020-11-17,Syria,SY,75,5,17070132,Asia,6759,350
2020-11-18,Syria,SY,77,4,17070132,Asia,6836,354
2020-11-19,Syria,SY,83,4,17070132,Asia,6919,358
2020-11-20,Syria,SY,72,5,17070132,Asia,6991,363
2020-11-21,Syria,SY,88,5,17070132,Asia,7079,368
2020-11-22,Syria,SY,75,4,17070132,Asia,7154,372
2020-11-23,Syria,SY,71,4,17070132,Asia,7225,376
2020-11-24,Syria,SY,70,4,17070132,Asia,7295,380
2020-11-25,Syria,SY,74,5,17070132,Asia,7369,385
2020-11-26,Syria,SY,90,6,17070132,Asia,7459,391
2020-11-27,Syria,SY,83,8,17070132,Asia,7542,399
2020-11-28,Syria,SY,93,5,17070132,Asia,7635,404
2020-11-29,Syria,SY,80,5,17070132,Asia,7715,409
2020-11-30,Syria,SY,82,4,17070132,Asia,7797,413
2020-12-01,Syria,SY,90,4,17070132,Asia,7887,417
2020-12-02,Syria,SY,86,5,17070132,Asia,7973,422
2020-12-03,Syria,SY,86,4,17070132,Asia,8059,426
2020-12-04,Syria,SY,88,6,17070132,Asia,8147,432
2020-12-05,Syria,SY,86,5,17070132,Asia,8233,437
2020-12-06,Syria,SY,87,5,17070132,Asia,8320,442
2020-12-07,Syria,SY,83,5,17070132,Asia,8403,447
2020-12-08,Syria,SY,87,5,17070132,Asia,8490,452
2020-12-09,Syria,SY,90,6,17070132,Asia,8580,458
2020-12-10,Syria,SY,95,7,17070132,Asia,8675,465
2020-12-11,Syria,SY,112,11,17070132,Asia,8787,476
2020-12-12,Syria,SY,124,15,17070132,Asia,8911,491
2020-12-13,Syria,SY,130,15,17070132,Asia,9041,506
2020-12-14,Syria,SY,125,12,17070132,Asia,9166,518
2020-03-15,Eswatini,SZ,1,0,1148133,Africa,1,0
2020-03-16,Eswatini,SZ,0,0,1148133,Africa,1,0
2020-03-17,Eswatini,SZ,0,0,1148133,Africa,1,0
2020-03-18,Eswatini,SZ,0,0,1148133,Africa,1,0
2020-03-19,Eswatini,SZ,0,0,1148133,Africa,1,0
2020-03-20,Eswatini,SZ,0,0,1148133,Africa,1,0
2020-03-21,Eswatini,SZ,0,0,1148133,Africa,1,0
2020-03-22,Eswatini,SZ,0,0,1148133,Africa,1,0
2020-03-23,Eswatini,SZ,3,0,1148133,Africa,4,0
2020-03-24,Eswatini,SZ,0,0,1148133,Africa,4,0
2020-03-25,Eswatini,SZ,0,0,1148133,Africa,4,0
2020-03-26,Eswatini,SZ,0,0,1148133,Africa,4,0
2020-03-27,Eswatini,SZ,2,0,1148133,Africa,6,0
2020-03-28,Eswatini,SZ,3,0,1148133,Africa,9,0
2020-03-29,Eswatini,SZ,0,0,1148133,Africa,9,0
2020-03-30,Eswatini,SZ,0,0,1148133,Africa,9,0
2020-03-31,Eswatini,SZ,0,0,1148133,Africa,9,0
2020-04-01,Eswatini,SZ,0,0,1148133,Africa,9,0
2020-04-02,Eswatini,SZ,0,0,1148133,Africa,9,0
2020-04-03,Eswatini,SZ,0,0,1148133,Africa,9,0
2020-04-04,Eswatini,SZ,0,0,1148133,Africa,9,0
2020-04-05,Eswatini,SZ,0,0,1148133,Africa,9,0
2020-04-06,Eswatini,SZ,0,0,1148133,Africa,9,0
2020-04-07,Eswatini,SZ,1,0,1148133,Africa,10,0
2020-04-08,Eswatini,SZ,0,0,1148133,Africa,10,0
2020-04-09,Eswatini,SZ,2,0,1148133,Africa,12,0
2020-04-10,Eswatini,SZ,0,0,1148133,Africa,12,0
2020-04-11,Eswatini,SZ,0,0,1148133,Africa,12,0
2020-04-12,Eswatini,SZ,2,0,1148133,Africa,14,0
2020-04-13,Eswatini,SZ,0,0,1148133,Africa,14,0
2020-04-14,Eswatini,SZ,1,0,1148133,Africa,15,0
2020-04-15,Eswatini,SZ,0,0,1148133,Africa,15,0
2020-04-16,Eswatini,SZ,1,0,1148133,Africa,16,0
2020-04-17,Eswatini,SZ,0,0,1148133,Africa,16,0
2020-04-18,Eswatini,SZ,3,1,1148133,Africa,19,1
2020-04-19,Eswatini,SZ,0,0,1148133,Africa,19,1
2020-04-20,Eswatini,SZ,3,0,1148133,Africa,22,1
2020-04-21,Eswatini,SZ,2,0,1148133,Africa,24,1
2020-04-22,Eswatini,SZ,0,0,1148133,Africa,24,1
2020-04-23,Eswatini,SZ,7,0,1148133,Africa,31,1
2020-04-24,Eswatini,SZ,1,0,1148133,Africa,32,1
2020-04-25,Eswatini,SZ,8,0,1148133,Africa,40,1
2020-04-26,Eswatini,SZ,0,0,1148133,Africa,40,1
2020-04-27,Eswatini,SZ,19,0,1148133,Africa,59,1
2020-04-28,Eswatini,SZ,6,0,1148133,Africa,65,1
2020-04-29,Eswatini,SZ,6,0,1148133,Africa,71,1
2020-04-30,Eswatini,SZ,20,0,1148133,Africa,91,1
2020-05-01,Eswatini,SZ,9,0,1148133,Africa,100,1
2020-05-02,Eswatini,SZ,6,0,1148133,Africa,106,1
2020-05-03,Eswatini,SZ,2,0,1148133,Africa,108,1
2020-05-04,Eswatini,SZ,4,0,1148133,Africa,112,1
2020-05-05,Eswatini,SZ,4,0,1148133,Africa,116,1
2020-05-06,Eswatini,SZ,0,0,1148133,Africa,116,1
2020-05-07,Eswatini,SZ,7,1,1148133,Africa,123,2
2020-05-08,Eswatini,SZ,30,0,1148133,Africa,153,2
2020-05-09,Eswatini,SZ,6,0,1148133,Africa,159,2
2020-05-10,Eswatini,SZ,4,0,1148133,Africa,163,2
2020-05-11,Eswatini,SZ,9,0,1148133,Africa,172,2
2020-05-12,Eswatini,SZ,3,0,1148133,Africa,175,2
2020-05-13,Eswatini,SZ,9,0,1148133,Africa,184,2
2020-05-14,Eswatini,SZ,3,0,1148133,Africa,187,2
2020-05-15,Eswatini,SZ,0,0,1148133,Africa,187,2
2020-05-16,Eswatini,SZ,3,0,1148133,Africa,190,2
2020-05-17,Eswatini,SZ,12,0,1148133,Africa,202,2
2020-05-18,Eswatini,SZ,1,0,1148133,Africa,203,2
2020-05-19,Eswatini,SZ,0,0,1148133,Africa,203,2
2020-05-20,Eswatini,SZ,5,0,1148133,Africa,208,2
2020-05-21,Eswatini,SZ,9,0,1148133,Africa,217,2
2020-05-22,Eswatini,SZ,3,0,1148133,Africa,220,2
2020-05-23,Eswatini,SZ,0,0,1148133,Africa,220,2
2020-05-24,Eswatini,SZ,18,0,1148133,Africa,238,2
2020-05-25,Eswatini,SZ,12,0,1148133,Africa,250,2
2020-05-26,Eswatini,SZ,6,0,1148133,Africa,256,2
2020-05-27,Eswatini,SZ,5,0,1148133,Africa,261,2
2020-05-28,Eswatini,SZ,11,0,1148133,Africa,272,2
2020-05-29,Eswatini,SZ,7,0,1148133,Africa,279,2
2020-05-30,Eswatini,SZ,0,0,1148133,Africa,279,2
2020-05-31,Eswatini,SZ,4,0,1148133,Africa,283,2
2020-06-01,Eswatini,SZ,2,0,1148133,Africa,285,2
2020-06-02,Eswatini,SZ,8,1,1148133,Africa,293,3
2020-06-03,Eswatini,SZ,0,0,1148133,Africa,293,3
2020-06-04,Eswatini,SZ,2,0,1148133,Africa,295,3
2020-06-05,Eswatini,SZ,5,0,1148133,Africa,300,3
2020-06-06,Eswatini,SZ,5,0,1148133,Africa,305,3
2020-06-07,Eswatini,SZ,17,0,1148133,Africa,322,3
2020-06-08,Eswatini,SZ,11,0,1148133,Africa,333,3
2020-06-09,Eswatini,SZ,7,0,1148133,Africa,340,3
2020-06-10,Eswatini,SZ,31,0,1148133,Africa,371,3
2020-06-11,Eswatini,SZ,27,0,1148133,Africa,398,3
2020-06-12,Eswatini,SZ,51,0,1148133,Africa,449,3
2020-06-13,Eswatini,SZ,23,0,1148133,Africa,472,3
2020-06-14,Eswatini,SZ,14,0,1148133,Africa,486,3
2020-06-15,Eswatini,SZ,4,1,1148133,Africa,490,4
2020-06-16,Eswatini,SZ,16,0,1148133,Africa,506,4
2020-06-17,Eswatini,SZ,14,0,1148133,Africa,520,4
2020-06-18,Eswatini,SZ,43,0,1148133,Africa,563,4
2020-06-19,Eswatini,SZ,23,0,1148133,Africa,586,4
2020-06-20,Eswatini,SZ,37,0,1148133,Africa,623,4
2020-06-21,Eswatini,SZ,4,1,1148133,Africa,627,5
2020-06-22,Eswatini,SZ,8,0,1148133,Africa,635,5
2020-06-23,Eswatini,SZ,8,1,1148133,Africa,643,6
2020-06-24,Eswatini,SZ,31,1,1148133,Africa,674,7
2020-06-25,Eswatini,SZ,16,0,1148133,Africa,690,7
2020-06-26,Eswatini,SZ,16,1,1148133,Africa,706,8
2020-06-27,Eswatini,SZ,22,0,1148133,Africa,728,8
2020-06-28,Eswatini,SZ,17,0,1148133,Africa,745,8
2020-06-29,Eswatini,SZ,36,3,1148133,Africa,781,11
2020-06-30,Eswatini,SZ,14,0,1148133,Africa,795,11
2020-07-01,Eswatini,SZ,17,0,1148133,Africa,812,11
2020-07-02,Eswatini,SZ,28,0,1148133,Africa,840,11
2020-07-03,Eswatini,SZ,33,0,1148133,Africa,873,11
2020-07-04,Eswatini,SZ,36,2,1148133,Africa,909,13
2020-07-05,Eswatini,SZ,45,0,1148133,Africa,954,13
2020-07-06,Eswatini,SZ,34,0,1148133,Africa,988,13
2020-07-07,Eswatini,SZ,23,0,1148133,Africa,1011,13
2020-07-08,Eswatini,SZ,45,1,1148133,Africa,1056,14
2020-07-09,Eswatini,SZ,82,0,1148133,Africa,1138,14
2020-07-10,Eswatini,SZ,75,3,1148133,Africa,1213,17
2020-07-11,Eswatini,SZ,44,1,1148133,Africa,1257,18
2020-07-12,Eswatini,SZ,54,0,1148133,Africa,1311,18
2020-07-13,Eswatini,SZ,40,2,1148133,Africa,1351,20
2020-07-14,Eswatini,SZ,38,0,1148133,Africa,1389,20
2020-07-15,Eswatini,SZ,45,0,1148133,Africa,1434,20
2020-07-16,Eswatini,SZ,55,0,1148133,Africa,1489,20
2020-07-17,Eswatini,SZ,63,1,1148133,Africa,1552,21
2020-07-18,Eswatini,SZ,67,0,1148133,Africa,1619,21
2020-07-19,Eswatini,SZ,110,0,1148133,Africa,1729,21
2020-07-20,Eswatini,SZ,64,0,1148133,Africa,1793,21
2020-07-21,Eswatini,SZ,33,2,1148133,Africa,1826,23
2020-07-22,Eswatini,SZ,68,1,1148133,Africa,1894,24
2020-07-23,Eswatini,SZ,44,1,1148133,Africa,1938,25
2020-07-24,Eswatini,SZ,83,3,1148133,Africa,2021,28
2020-07-25,Eswatini,SZ,52,0,1148133,Africa,2073,28
2020-07-26,Eswatini,SZ,69,0,1148133,Africa,2142,28
2020-07-27,Eswatini,SZ,65,4,1148133,Africa,2207,32
2020-07-28,Eswatini,SZ,109,2,1148133,Africa,2316,34
2020-07-29,Eswatini,SZ,88,5,1148133,Africa,2404,39
2020-07-30,Eswatini,SZ,147,1,1148133,Africa,2551,40
2020-07-31,Eswatini,SZ,26,0,1148133,Africa,2577,40
2020-08-01,Eswatini,SZ,71,1,1148133,Africa,2648,41
2020-08-02,Eswatini,SZ,58,2,1148133,Africa,2706,43
2020-08-03,Eswatini,SZ,69,0,1148133,Africa,2775,43
2020-08-04,Eswatini,SZ,63,2,1148133,Africa,2838,45
2020-08-05,Eswatini,SZ,18,4,1148133,Africa,2856,49
2020-08-06,Eswatini,SZ,53,4,1148133,Africa,2909,53
2020-08-07,Eswatini,SZ,59,2,1148133,Africa,2968,55
2020-08-08,Eswatini,SZ,68,1,1148133,Africa,3036,56
2020-08-09,Eswatini,SZ,92,0,1148133,Africa,3128,56
2020-08-10,Eswatini,SZ,108,2,1148133,Africa,3236,58
2020-08-11,Eswatini,SZ,73,3,1148133,Africa,3309,61
2020-08-12,Eswatini,SZ,101,2,1148133,Africa,3410,63
2020-08-13,Eswatini,SZ,115,0,1148133,Africa,3525,63
2020-08-14,Eswatini,SZ,74,2,1148133,Africa,3599,65
2020-08-15,Eswatini,SZ,71,3,1148133,Africa,3670,68
2020-08-16,Eswatini,SZ,75,1,1148133,Africa,3745,69
2020-08-17,Eswatini,SZ,94,1,1148133,Africa,3839,70
2020-08-18,Eswatini,SZ,55,3,1148133,Africa,3894,73
2020-08-19,Eswatini,SZ,95,3,1148133,Africa,3989,76
2020-08-20,Eswatini,SZ,69,3,1148133,Africa,4058,79
2020-08-21,Eswatini,SZ,52,2,1148133,Africa,4110,81
2020-08-22,Eswatini,SZ,18,0,1148133,Africa,4128,81
2020-08-23,Eswatini,SZ,61,2,1148133,Africa,4189,83
2020-08-24,Eswatini,SZ,36,2,1148133,Africa,4225,85
2020-08-25,Eswatini,SZ,79,0,1148133,Africa,4304,85
2020-08-26,Eswatini,SZ,23,1,1148133,Africa,4327,86
2020-08-27,Eswatini,SZ,60,2,1148133,Africa,4387,88
2020-08-28,Eswatini,SZ,46,1,1148133,Africa,4433,89
2020-08-29,Eswatini,SZ,28,2,1148133,Africa,4461,91
2020-08-30,Eswatini,SZ,49,0,1148133,Africa,4510,91
2020-08-31,Eswatini,SZ,51,0,1148133,Africa,4561,91
2020-09-01,Eswatini,SZ,16,0,1148133,Africa,4577,91
2020-09-02,Eswatini,SZ,41,3,1148133,Africa,4618,94
2020-09-03,Eswatini,SZ,50,0,1148133,Africa,4668,94
2020-09-04,Eswatini,SZ,52,0,1148133,Africa,4720,94
2020-09-05,Eswatini,SZ,60,0,1148133,Africa,4780,94
2020-09-06,Eswatini,SZ,39,0,1148133,Africa,4819,94
2020-09-07,Eswatini,SZ,34,0,1148133,Africa,4853,94
2020-09-08,Eswatini,SZ,31,0,1148133,Africa,4884,94
2020-09-09,Eswatini,SZ,20,2,1148133,Africa,4904,96
2020-09-10,Eswatini,SZ,32,1,1148133,Africa,4936,97
2020-09-11,Eswatini,SZ,58,1,1148133,Africa,4994,98
2020-09-12,Eswatini,SZ,31,0,1148133,Africa,5025,98
2020-09-13,Eswatini,SZ,25,0,1148133,Africa,5050,98
2020-09-14,Eswatini,SZ,25,0,1148133,Africa,5075,98
2020-09-15,Eswatini,SZ,29,3,1148133,Africa,5104,101
2020-09-16,Eswatini,SZ,24,0,1148133,Africa,5128,101
2020-09-17,Eswatini,SZ,27,0,1148133,Africa,5155,101
2020-09-18,Eswatini,SZ,36,2,1148133,Africa,5191,103
2020-09-19,Eswatini,SZ,24,0,1148133,Africa,5215,103
2020-09-20,Eswatini,SZ,30,1,1148133,Africa,5245,104
2020-09-21,Eswatini,SZ,24,0,1148133,Africa,5269,104
2020-09-22,Eswatini,SZ,13,0,1148133,Africa,5282,104
2020-09-23,Eswatini,SZ,25,2,1148133,Africa,5307,106
2020-09-24,Eswatini,SZ,36,2,1148133,Africa,5343,108
2020-09-25,Eswatini,SZ,32,0,1148133,Africa,5375,108
2020-09-26,Eswatini,SZ,24,0,1148133,Africa,5399,108
2020-09-27,Eswatini,SZ,20,0,1148133,Africa,5419,108
2020-09-28,Eswatini,SZ,12,0,1148133,Africa,5431,108
2020-09-29,Eswatini,SZ,21,0,1148133,Africa,5452,108
2020-09-30,Eswatini,SZ,10,0,1148133,Africa,5462,108
2020-10-01,Eswatini,SZ,20,1,1148133,Africa,5482,109
2020-10-02,Eswatini,SZ,18,2,1148133,Africa,5500,111
2020-10-03,Eswatini,SZ,21,0,1148133,Africa,5521,111
2020-10-04,Eswatini,SZ,9,0,1148133,Africa,5530,111
2020-10-05,Eswatini,SZ,39,0,1148133,Africa,5569,111
2020-10-06,Eswatini,SZ,10,1,1148133,Africa,5579,112
2020-10-07,Eswatini,SZ,19,0,1148133,Africa,5598,112
2020-10-08,Eswatini,SZ,19,1,1148133,Africa,5617,113
2020-10-09,Eswatini,SZ,15,0,1148133,Africa,5632,113
2020-10-10,Eswatini,SZ,12,0,1148133,Africa,5644,113
2020-10-11,Eswatini,SZ,16,0,1148133,Africa,5660,113
2020-10-12,Eswatini,SZ,9,0,1148133,Africa,5669,113
2020-10-13,Eswatini,SZ,14,0,1148133,Africa,5683,113
2020-10-14,Eswatini,SZ,13,1,1148133,Africa,5696,114
2020-10-15,Eswatini,SZ,19,0,1148133,Africa,5715,114
2020-10-16,Eswatini,SZ,18,1,1148133,Africa,5733,115
2020-10-17,Eswatini,SZ,13,0,1148133,Africa,5746,115
2020-10-18,Eswatini,SZ,19,0,1148133,Africa,5765,115
2020-10-19,Eswatini,SZ,15,1,1148133,Africa,5780,116
2020-10-20,Eswatini,SZ,8,0,1148133,Africa,5788,116
2020-10-21,Eswatini,SZ,12,0,1148133,Africa,5800,116
2020-10-22,Eswatini,SZ,5,0,1148133,Africa,5805,116
2020-10-23,Eswatini,SZ,9,0,1148133,Africa,5814,116
2020-10-24,Eswatini,SZ,17,0,1148133,Africa,5831,116
2020-10-25,Eswatini,SZ,16,0,1148133,Africa,5847,116
2020-10-26,Eswatini,SZ,7,0,1148133,Africa,5854,116
2020-10-27,Eswatini,SZ,9,0,1148133,Africa,5863,116
2020-10-28,Eswatini,SZ,12,0,1148133,Africa,5875,116
2020-10-29,Eswatini,SZ,11,0,1148133,Africa,5886,116
2020-10-30,Eswatini,SZ,13,1,1148133,Africa,5899,117
2020-10-31,Eswatini,SZ,10,0,1148133,Africa,5909,117
2020-11-01,Eswatini,SZ,8,0,1148133,Africa,5917,117
2020-11-02,Eswatini,SZ,8,0,1148133,Africa,5925,117
2020-11-03,Eswatini,SZ,4,0,1148133,Africa,5929,117
2020-11-04,Eswatini,SZ,13,0,1148133,Africa,5942,117
2020-11-05,Eswatini,SZ,13,0,1148133,Africa,5955,117
2020-11-06,Eswatini,SZ,12,0,1148133,Africa,5967,117
2020-11-07,Eswatini,SZ,9,0,1148133,Africa,5976,117
2020-11-08,Eswatini,SZ,13,0,1148133,Africa,5989,117
2020-11-09,Eswatini,SZ,14,0,1148133,Africa,6003,117
2020-11-10,Eswatini,SZ,10,0,1148133,Africa,6013,117
2020-11-11,Eswatini,SZ,11,0,1148133,Africa,6024,117
2020-11-12,Eswatini,SZ,20,0,1148133,Africa,6044,117
2020-11-13,Eswatini,SZ,16,0,1148133,Africa,6060,117
2020-11-14,Eswatini,SZ,16,1,1148133,Africa,6076,118
2020-11-15,Eswatini,SZ,17,1,1148133,Africa,6093,119
2020-11-16,Eswatini,SZ,2,0,1148133,Africa,6095,119
2020-11-17,Eswatini,SZ,10,0,1148133,Africa,6105,119
2020-11-18,Eswatini,SZ,19,0,1148133,Africa,6124,119
2020-11-19,Eswatini,SZ,20,0,1148133,Africa,6144,119
2020-11-20,Eswatini,SZ,12,0,1148133,Africa,6156,119
2020-11-21,Eswatini,SZ,29,0,1148133,Africa,6185,119
2020-11-22,Eswatini,SZ,20,0,1148133,Africa,6205,119
2020-11-23,Eswatini,SZ,14,1,1148133,Africa,6219,120
2020-11-24,Eswatini,SZ,14,0,1148133,Africa,6233,120
2020-11-25,Eswatini,SZ,14,0,1148133,Africa,6247,120
2020-11-26,Eswatini,SZ,25,0,1148133,Africa,6272,120
2020-11-27,Eswatini,SZ,57,0,1148133,Africa,6329,120
2020-11-28,Eswatini,SZ,33,0,1148133,Africa,6362,120
2020-11-29,Eswatini,SZ,44,1,1148133,Africa,6406,121
2020-11-30,Eswatini,SZ,4,0,1148133,Africa,6410,121
2020-12-01,Eswatini,SZ,9,1,1148133,Africa,6419,122
2020-12-02,Eswatini,SZ,23,0,1148133,Africa,6442,122
2020-12-03,Eswatini,SZ,13,0,1148133,Africa,6455,122
2020-12-04,Eswatini,SZ,19,0,1148133,Africa,6474,122
2020-12-05,Eswatini,SZ,6,0,1148133,Africa,6480,122
2020-12-06,Eswatini,SZ,15,0,1148133,Africa,6495,122
2020-12-07,Eswatini,SZ,6,0,1148133,Africa,6501,122
2020-12-08,Eswatini,SZ,28,1,1148133,Africa,6529,123
2020-12-09,Eswatini,SZ,34,1,1148133,Africa,6563,124
2020-12-10,Eswatini,SZ,49,1,1148133,Africa,6612,125
2020-12-11,Eswatini,SZ,21,1,1148133,Africa,6633,126
2020-12-12,Eswatini,SZ,52,0,1148133,Africa,6685,126
2020-12-13,Eswatini,SZ,29,1,1148133,Africa,6714,127
2020-12-14,Eswatini,SZ,54,0,1148133,Africa,6768,127
2020-03-25,Turks_and_Caicos_islands,TC,1,0,38194,America,1,0
2020-03-26,Turks_and_Caicos_islands,TC,0,0,38194,America,1,0
2020-03-27,Turks_and_Caicos_islands,TC,1,0,38194,America,2,0
2020-03-28,Turks_and_Caicos_islands,TC,0,0,38194,America,2,0
2020-03-29,Turks_and_Caicos_islands,TC,3,0,38194,America,5,0
2020-03-30,Turks_and_Caicos_islands,TC,0,0,38194,America,5,0
2020-03-31,Turks_and_Caicos_islands,TC,0,0,38194,America,5,0
2020-04-01,Turks_and_Caicos_islands,TC,0,0,38194,America,5,0
2020-04-02,Turks_and_Caicos_islands,TC,0,0,38194,America,5,0
2020-04-03,Turks_and_Caicos_islands,TC,0,0,38194,America,5,0
2020-04-04,Turks_and_Caicos_islands,TC,0,0,38194,America,5,0
2020-04-05,Turks_and_Caicos_islands,TC,0,0,38194,America,5,0
2020-04-06,Turks_and_Caicos_islands,TC,0,1,38194,America,5,1
2020-04-07,Turks_and_Caicos_islands,TC,3,0,38194,America,8,1
2020-04-08,Turks_and_Caicos_islands,TC,0,0,38194,America,8,1
2020-04-09,Turks_and_Caicos_islands,TC,0,0,38194,America,8,1
2020-04-10,Turks_and_Caicos_islands,TC,0,0,38194,America,8,1
2020-04-11,Turks_and_Caicos_islands,TC,1,0,38194,America,9,1
2020-04-12,Turks_and_Caicos_islands,TC,0,0,38194,America,9,1
2020-04-13,Turks_and_Caicos_islands,TC,0,0,38194,America,9,1
2020-04-14,Turks_and_Caicos_islands,TC,1,0,38194,America,10,1
2020-04-15,Turks_and_Caicos_islands,TC,0,0,38194,America,10,1
2020-04-16,Turks_and_Caicos_islands,TC,1,0,38194,America,11,1
2020-04-17,Turks_and_Caicos_islands,TC,0,0,38194,America,11,1
2020-04-18,Turks_and_Caicos_islands,TC,0,0,38194,America,11,1
2020-04-19,Turks_and_Caicos_islands,TC,0,0,38194,America,11,1
2020-04-20,Turks_and_Caicos_islands,TC,0,0,38194,America,11,1
2020-04-21,Turks_and_Caicos_islands,TC,0,0,38194,America,11,1
2020-04-22,Turks_and_Caicos_islands,TC,0,0,38194,America,11,1
2020-04-23,Turks_and_Caicos_islands,TC,0,0,38194,America,11,1
2020-04-24,Turks_and_Caicos_islands,TC,0,0,38194,America,11,1
2020-04-25,Turks_and_Caicos_islands,TC,0,0,38194,America,11,1
2020-04-26,Turks_and_Caicos_islands,TC,0,0,38194,America,11,1
2020-04-27,Turks_and_Caicos_islands,TC,0,0,38194,America,11,1
2020-04-28,Turks_and_Caicos_islands,TC,1,0,38194,America,12,1
2020-04-29,Turks_and_Caicos_islands,TC,0,0,38194,America,12,1
2020-04-30,Turks_and_Caicos_islands,TC,0,0,38194,America,12,1
2020-05-01,Turks_and_Caicos_islands,TC,0,0,38194,America,12,1
2020-05-02,Turks_and_Caicos_islands,TC,0,0,38194,America,12,1
2020-05-03,Turks_and_Caicos_islands,TC,0,0,38194,America,12,1
2020-05-04,Turks_and_Caicos_islands,TC,0,0,38194,America,12,1
2020-05-05,Turks_and_Caicos_islands,TC,0,0,38194,America,12,1
2020-05-06,Turks_and_Caicos_islands,TC,0,0,38194,America,12,1
2020-05-07,Turks_and_Caicos_islands,TC,0,0,38194,America,12,1
2020-05-08,Turks_and_Caicos_islands,TC,0,0,38194,America,12,1
2020-05-09,Turks_and_Caicos_islands,TC,0,0,38194,America,12,1
2020-05-10,Turks_and_Caicos_islands,TC,0,0,38194,America,12,1
2020-05-11,Turks_and_Caicos_islands,TC,0,0,38194,America,12,1
2020-05-12,Turks_and_Caicos_islands,TC,0,0,38194,America,12,1
2020-05-13,Turks_and_Caicos_islands,TC,0,0,38194,America,12,1
2020-05-14,Turks_and_Caicos_islands,TC,0,0,38194,America,12,1
2020-05-15,Turks_and_Caicos_islands,TC,0,0,38194,America,12,1
2020-05-16,Turks_and_Caicos_islands,TC,0,0,38194,America,12,1
2020-05-17,Turks_and_Caicos_islands,TC,0,0,38194,America,12,1
2020-05-18,Turks_and_Caicos_islands,TC,0,0,38194,America,12,1
2020-05-19,Turks_and_Caicos_islands,TC,0,0,38194,America,12,1
2020-05-20,Turks_and_Caicos_islands,TC,0,0,38194,America,12,1
2020-05-21,Turks_and_Caicos_islands,TC,0,0,38194,America,12,1
2020-05-22,Turks_and_Caicos_islands,TC,0,0,38194,America,12,1
2020-05-23,Turks_and_Caicos_islands,TC,0,0,38194,America,12,1
2020-05-24,Turks_and_Caicos_islands,TC,0,0,38194,America,12,1
2020-05-25,Turks_and_Caicos_islands,TC,0,0,38194,America,12,1
2020-05-26,Turks_and_Caicos_islands,TC,0,0,38194,America,12,1
2020-05-27,Turks_and_Caicos_islands,TC,0,0,38194,America,12,1
2020-05-28,Turks_and_Caicos_islands,TC,0,0,38194,America,12,1
2020-05-29,Turks_and_Caicos_islands,TC,0,0,38194,America,12,1
2020-05-30,Turks_and_Caicos_islands,TC,0,0,38194,America,12,1
2020-05-31,Turks_and_Caicos_islands,TC,0,0,38194,America,12,1
2020-06-01,Turks_and_Caicos_islands,TC,0,0,38194,America,12,1
2020-06-02,Turks_and_Caicos_islands,TC,0,0,38194,America,12,1
2020-06-03,Turks_and_Caicos_islands,TC,0,0,38194,America,12,1
2020-06-04,Turks_and_Caicos_islands,TC,0,0,38194,America,12,1
2020-06-05,Turks_and_Caicos_islands,TC,0,0,38194,America,12,1
2020-06-06,Turks_and_Caicos_islands,TC,0,0,38194,America,12,1
2020-06-07,Turks_and_Caicos_islands,TC,0,0,38194,America,12,1
2020-06-08,Turks_and_Caicos_islands,TC,0,0,38194,America,12,1
2020-06-09,Turks_and_Caicos_islands,TC,0,0,38194,America,12,1
2020-06-10,Turks_and_Caicos_islands,TC,0,0,38194,America,12,1
2020-06-11,Turks_and_Caicos_islands,TC,0,0,38194,America,12,1
2020-06-12,Turks_and_Caicos_islands,TC,0,0,38194,America,12,1
2020-06-13,Turks_and_Caicos_islands,TC,0,0,38194,America,12,1
2020-06-14,Turks_and_Caicos_islands,TC,0,0,38194,America,12,1
2020-06-15,Turks_and_Caicos_islands,TC,0,0,38194,America,12,1
2020-06-16,Turks_and_Caicos_islands,TC,0,0,38194,America,12,1
2020-06-17,Turks_and_Caicos_islands,TC,0,0,38194,America,12,1
2020-06-18,Turks_and_Caicos_islands,TC,0,0,38194,America,12,1
2020-06-19,Turks_and_Caicos_islands,TC,0,0,38194,America,12,1
2020-06-20,Turks_and_Caicos_islands,TC,0,0,38194,America,12,1
2020-06-21,Turks_and_Caicos_islands,TC,0,0,38194,America,12,1
2020-06-22,Turks_and_Caicos_islands,TC,2,0,38194,America,14,1
2020-06-23,Turks_and_Caicos_islands,TC,0,0,38194,America,14,1
2020-06-24,Turks_and_Caicos_islands,TC,0,0,38194,America,14,1
2020-06-25,Turks_and_Caicos_islands,TC,1,0,38194,America,15,1
2020-06-26,Turks_and_Caicos_islands,TC,0,0,38194,America,15,1
2020-06-27,Turks_and_Caicos_islands,TC,0,0,38194,America,15,1
2020-06-28,Turks_and_Caicos_islands,TC,1,0,38194,America,16,1
2020-06-29,Turks_and_Caicos_islands,TC,12,0,38194,America,28,1
2020-06-30,Turks_and_Caicos_islands,TC,13,0,38194,America,41,1
2020-07-01,Turks_and_Caicos_islands,TC,0,1,38194,America,41,2
2020-07-02,Turks_and_Caicos_islands,TC,1,0,38194,America,42,2
2020-07-03,Turks_and_Caicos_islands,TC,2,0,38194,America,44,2
2020-07-04,Turks_and_Caicos_islands,TC,0,0,38194,America,44,2
2020-07-05,Turks_and_Caicos_islands,TC,1,0,38194,America,45,2
2020-07-06,Turks_and_Caicos_islands,TC,2,0,38194,America,47,2
2020-07-07,Turks_and_Caicos_islands,TC,2,0,38194,America,49,2
2020-07-08,Turks_and_Caicos_islands,TC,0,0,38194,America,49,2
2020-07-09,Turks_and_Caicos_islands,TC,6,0,38194,America,55,2
2020-07-10,Turks_and_Caicos_islands,TC,0,0,38194,America,55,2
2020-07-11,Turks_and_Caicos_islands,TC,11,0,38194,America,66,2
2020-07-12,Turks_and_Caicos_islands,TC,0,0,38194,America,66,2
2020-07-13,Turks_and_Caicos_islands,TC,6,0,38194,America,72,2
2020-07-14,Turks_and_Caicos_islands,TC,0,0,38194,America,72,2
2020-07-15,Turks_and_Caicos_islands,TC,0,0,38194,America,72,2
2020-07-16,Turks_and_Caicos_islands,TC,0,0,38194,America,72,2
2020-07-17,Turks_and_Caicos_islands,TC,0,0,38194,America,72,2
2020-07-18,Turks_and_Caicos_islands,TC,2,0,38194,America,74,2
2020-07-19,Turks_and_Caicos_islands,TC,1,0,38194,America,75,2
2020-07-20,Turks_and_Caicos_islands,TC,6,0,38194,America,81,2
2020-07-21,Turks_and_Caicos_islands,TC,0,0,38194,America,81,2
2020-07-22,Turks_and_Caicos_islands,TC,1,0,38194,America,82,2
2020-07-23,Turks_and_Caicos_islands,TC,4,0,38194,America,86,2
2020-07-24,Turks_and_Caicos_islands,TC,4,0,38194,America,90,2
2020-07-25,Turks_and_Caicos_islands,TC,2,0,38194,America,92,2
2020-07-26,Turks_and_Caicos_islands,TC,5,0,38194,America,97,2
2020-07-27,Turks_and_Caicos_islands,TC,2,0,38194,America,99,2
2020-07-28,Turks_and_Caicos_islands,TC,0,0,38194,America,99,2
2020-07-29,Turks_and_Caicos_islands,TC,0,0,38194,America,99,2
2020-07-30,Turks_and_Caicos_islands,TC,0,0,38194,America,99,2
2020-07-31,Turks_and_Caicos_islands,TC,5,0,38194,America,104,2
2020-08-01,Turks_and_Caicos_islands,TC,3,0,38194,America,107,2
2020-08-02,Turks_and_Caicos_islands,TC,7,0,38194,America,114,2
2020-08-03,Turks_and_Caicos_islands,TC,2,0,38194,America,116,2
2020-08-04,Turks_and_Caicos_islands,TC,0,0,38194,America,116,2
2020-08-05,Turks_and_Caicos_islands,TC,0,0,38194,America,116,2
2020-08-06,Turks_and_Caicos_islands,TC,13,0,38194,America,129,2
2020-08-07,Turks_and_Caicos_islands,TC,12,0,38194,America,141,2
2020-08-08,Turks_and_Caicos_islands,TC,29,0,38194,America,170,2
2020-08-09,Turks_and_Caicos_islands,TC,27,0,38194,America,197,2
2020-08-10,Turks_and_Caicos_islands,TC,19,0,38194,America,216,2
2020-08-11,Turks_and_Caicos_islands,TC,0,0,38194,America,216,2
2020-08-12,Turks_and_Caicos_islands,TC,8,0,38194,America,224,2
2020-08-13,Turks_and_Caicos_islands,TC,17,0,38194,America,241,2
2020-08-14,Turks_and_Caicos_islands,TC,17,0,38194,America,258,2
2020-08-15,Turks_and_Caicos_islands,TC,16,0,38194,America,274,2
2020-08-16,Turks_and_Caicos_islands,TC,24,0,38194,America,298,2
2020-08-17,Turks_and_Caicos_islands,TC,0,0,38194,America,298,2
2020-08-18,Turks_and_Caicos_islands,TC,0,0,38194,America,298,2
2020-08-19,Turks_and_Caicos_islands,TC,17,0,38194,America,315,2
2020-08-20,Turks_and_Caicos_islands,TC,12,0,38194,America,327,2
2020-08-21,Turks_and_Caicos_islands,TC,7,0,38194,America,334,2
2020-08-22,Turks_and_Caicos_islands,TC,13,0,38194,America,347,2
2020-08-23,Turks_and_Caicos_islands,TC,36,0,38194,America,383,2
2020-08-24,Turks_and_Caicos_islands,TC,0,0,38194,America,383,2
2020-08-25,Turks_and_Caicos_islands,TC,0,0,38194,America,383,2
2020-08-26,Turks_and_Caicos_islands,TC,48,0,38194,America,431,2
2020-08-27,Turks_and_Caicos_islands,TC,33,1,38194,America,464,3
2020-08-28,Turks_and_Caicos_islands,TC,18,0,38194,America,482,3
2020-08-29,Turks_and_Caicos_islands,TC,8,0,38194,America,490,3
2020-08-30,Turks_and_Caicos_islands,TC,15,0,38194,America,505,3
2020-08-31,Turks_and_Caicos_islands,TC,2,0,38194,America,507,3
2020-09-01,Turks_and_Caicos_islands,TC,1,1,38194,America,508,4
2020-09-02,Turks_and_Caicos_islands,TC,0,0,38194,America,508,4
2020-09-03,Turks_and_Caicos_islands,TC,47,0,38194,America,555,4
2020-09-04,Turks_and_Caicos_islands,TC,0,0,38194,America,555,4
2020-09-05,Turks_and_Caicos_islands,TC,22,1,38194,America,577,5
2020-09-06,Turks_and_Caicos_islands,TC,14,0,38194,America,591,5
2020-09-07,Turks_and_Caicos_islands,TC,7,0,38194,America,598,5
2020-09-08,Turks_and_Caicos_islands,TC,1,0,38194,America,599,5
2020-09-09,Turks_and_Caicos_islands,TC,15,0,38194,America,614,5
2020-09-10,Turks_and_Caicos_islands,TC,14,0,38194,America,628,5
2020-09-11,Turks_and_Caicos_islands,TC,10,0,38194,America,638,5
2020-09-12,Turks_and_Caicos_islands,TC,3,0,38194,America,641,5
2020-09-13,Turks_and_Caicos_islands,TC,3,0,38194,America,644,5
2020-09-14,Turks_and_Caicos_islands,TC,2,0,38194,America,646,5
2020-09-15,Turks_and_Caicos_islands,TC,2,0,38194,America,648,5
2020-09-16,Turks_and_Caicos_islands,TC,2,0,38194,America,650,5
2020-09-17,Turks_and_Caicos_islands,TC,9,0,38194,America,659,5
2020-09-18,Turks_and_Caicos_islands,TC,4,0,38194,America,663,5
2020-09-19,Turks_and_Caicos_islands,TC,4,0,38194,America,667,5
2020-09-20,Turks_and_Caicos_islands,TC,1,0,38194,America,668,5
2020-09-21,Turks_and_Caicos_islands,TC,0,0,38194,America,668,5
2020-09-22,Turks_and_Caicos_islands,TC,0,0,38194,America,668,5
2020-09-23,Turks_and_Caicos_islands,TC,4,0,38194,America,672,5
2020-09-24,Turks_and_Caicos_islands,TC,4,0,38194,America,676,5
2020-09-25,Turks_and_Caicos_islands,TC,3,0,38194,America,679,5
2020-09-26,Turks_and_Caicos_islands,TC,1,0,38194,America,680,5
2020-09-27,Turks_and_Caicos_islands,TC,1,0,38194,America,681,5
2020-09-28,Turks_and_Caicos_islands,TC,1,0,38194,America,682,5
2020-09-29,Turks_and_Caicos_islands,TC,0,0,38194,America,682,5
2020-09-30,Turks_and_Caicos_islands,TC,4,1,38194,America,686,6
2020-10-01,Turks_and_Caicos_islands,TC,3,0,38194,America,689,6
2020-10-02,Turks_and_Caicos_islands,TC,1,0,38194,America,690,6
2020-10-03,Turks_and_Caicos_islands,TC,5,0,38194,America,695,6
2020-10-04,Turks_and_Caicos_islands,TC,0,0,38194,America,695,6
2020-10-05,Turks_and_Caicos_islands,TC,0,0,38194,America,695,6
2020-10-06,Turks_and_Caicos_islands,TC,0,0,38194,America,695,6
2020-10-07,Turks_and_Caicos_islands,TC,0,0,38194,America,695,6
2020-10-08,Turks_and_Caicos_islands,TC,0,0,38194,America,695,6
2020-10-09,Turks_and_Caicos_islands,TC,0,0,38194,America,695,6
2020-10-10,Turks_and_Caicos_islands,TC,0,0,38194,America,695,6
2020-10-11,Turks_and_Caicos_islands,TC,0,0,38194,America,695,6
2020-10-12,Turks_and_Caicos_islands,TC,0,0,38194,America,695,6
2020-10-13,Turks_and_Caicos_islands,TC,1,0,38194,America,696,6
2020-10-14,Turks_and_Caicos_islands,TC,0,0,38194,America,696,6
2020-10-15,Turks_and_Caicos_islands,TC,0,0,38194,America,696,6
2020-10-16,Turks_and_Caicos_islands,TC,0,0,38194,America,696,6
2020-10-17,Turks_and_Caicos_islands,TC,1,0,38194,America,697,6
2020-10-18,Turks_and_Caicos_islands,TC,1,0,38194,America,698,6
2020-10-19,Turks_and_Caicos_islands,TC,0,0,38194,America,698,6
2020-10-20,Turks_and_Caicos_islands,TC,0,0,38194,America,698,6
2020-10-21,Turks_and_Caicos_islands,TC,0,0,38194,America,698,6
2020-10-22,Turks_and_Caicos_islands,TC,0,0,38194,America,698,6
2020-10-23,Turks_and_Caicos_islands,TC,0,0,38194,America,698,6
2020-10-24,Turks_and_Caicos_islands,TC,1,0,38194,America,699,6
2020-10-25,Turks_and_Caicos_islands,TC,2,0,38194,America,701,6
2020-10-26,Turks_and_Caicos_islands,TC,0,0,38194,America,701,6
2020-10-27,Turks_and_Caicos_islands,TC,0,0,38194,America,701,6
2020-10-28,Turks_and_Caicos_islands,TC,2,0,38194,America,703,6
2020-10-29,Turks_and_Caicos_islands,TC,0,0,38194,America,703,6
2020-10-30,Turks_and_Caicos_islands,TC,0,0,38194,America,703,6
2020-10-31,Turks_and_Caicos_islands,TC,0,0,38194,America,703,6
2020-11-01,Turks_and_Caicos_islands,TC,1,0,38194,America,704,6
2020-11-02,Turks_and_Caicos_islands,TC,0,0,38194,America,704,6
2020-11-03,Turks_and_Caicos_islands,TC,0,0,38194,America,704,6
2020-11-04,Turks_and_Caicos_islands,TC,0,0,38194,America,704,6
2020-11-05,Turks_and_Caicos_islands,TC,1,0,38194,America,705,6
2020-11-06,Turks_and_Caicos_islands,TC,0,0,38194,America,705,6
2020-11-07,Turks_and_Caicos_islands,TC,2,0,38194,America,707,6
2020-11-08,Turks_and_Caicos_islands,TC,0,0,38194,America,707,6
2020-11-09,Turks_and_Caicos_islands,TC,0,0,38194,America,707,6
2020-11-10,Turks_and_Caicos_islands,TC,0,0,38194,America,707,6
2020-11-11,Turks_and_Caicos_islands,TC,4,0,38194,America,711,6
2020-11-12,Turks_and_Caicos_islands,TC,5,0,38194,America,716,6
2020-11-13,Turks_and_Caicos_islands,TC,0,0,38194,America,716,6
2020-11-14,Turks_and_Caicos_islands,TC,0,0,38194,America,716,6
2020-11-15,Turks_and_Caicos_islands,TC,4,0,38194,America,720,6
2020-11-16,Turks_and_Caicos_islands,TC,0,0,38194,America,720,6
2020-11-17,Turks_and_Caicos_islands,TC,0,0,38194,America,720,6
2020-11-18,Turks_and_Caicos_islands,TC,0,0,38194,America,720,6
2020-11-19,Turks_and_Caicos_islands,TC,1,0,38194,America,721,6
2020-11-20,Turks_and_Caicos_islands,TC,0,0,38194,America,721,6
2020-11-21,Turks_and_Caicos_islands,TC,19,0,38194,America,740,6
2020-11-22,Turks_and_Caicos_islands,TC,0,0,38194,America,740,6
2020-11-23,Turks_and_Caicos_islands,TC,6,0,38194,America,746,6
2020-11-24,Turks_and_Caicos_islands,TC,0,0,38194,America,746,6
2020-11-25,Turks_and_Caicos_islands,TC,0,0,38194,America,746,6
2020-11-26,Turks_and_Caicos_islands,TC,0,0,38194,America,746,6
2020-11-27,Turks_and_Caicos_islands,TC,0,0,38194,America,746,6
2020-11-28,Turks_and_Caicos_islands,TC,2,0,38194,America,748,6
2020-11-29,Turks_and_Caicos_islands,TC,0,0,38194,America,748,6
2020-11-30,Turks_and_Caicos_islands,TC,0,0,38194,America,748,6
2020-12-01,Turks_and_Caicos_islands,TC,0,0,38194,America,748,6
2020-12-02,Turks_and_Caicos_islands,TC,2,0,38194,America,750,6
2020-12-03,Turks_and_Caicos_islands,TC,1,0,38194,America,751,6
2020-12-04,Turks_and_Caicos_islands,TC,0,0,38194,America,751,6
2020-12-05,Turks_and_Caicos_islands,TC,4,0,38194,America,755,6
2020-12-06,Turks_and_Caicos_islands,TC,1,0,38194,America,756,6
2020-12-07,Turks_and_Caicos_islands,TC,0,0,38194,America,756,6
2020-12-08,Turks_and_Caicos_islands,TC,0,0,38194,America,756,6
2020-12-09,Turks_and_Caicos_islands,TC,5,0,38194,America,761,6
2020-12-10,Turks_and_Caicos_islands,TC,7,0,38194,America,768,6
2020-12-11,Turks_and_Caicos_islands,TC,0,0,38194,America,768,6
2020-12-12,Turks_and_Caicos_islands,TC,1,0,38194,America,769,6
2020-12-13,Turks_and_Caicos_islands,TC,0,0,38194,America,769,6
2020-12-14,Turks_and_Caicos_islands,TC,0,0,38194,America,769,6
2020-03-20,Chad,TD,1,0,15946882,Africa,1,0
2020-03-21,Chad,TD,0,0,15946882,Africa,1,0
2020-03-22,Chad,TD,1,0,15946882,Africa,2,0
2020-03-23,Chad,TD,0,0,15946882,Africa,2,0
2020-03-24,Chad,TD,0,0,15946882,Africa,2,0
2020-03-25,Chad,TD,1,0,15946882,Africa,3,0
2020-03-26,Chad,TD,0,0,15946882,Africa,3,0
2020-03-27,Chad,TD,2,0,15946882,Africa,5,0
2020-03-28,Chad,TD,0,0,15946882,Africa,5,0
2020-03-29,Chad,TD,0,0,15946882,Africa,5,0
2020-03-30,Chad,TD,0,0,15946882,Africa,5,0
2020-03-31,Chad,TD,2,0,15946882,Africa,7,0
2020-04-01,Chad,TD,0,0,15946882,Africa,7,0
2020-04-02,Chad,TD,0,0,15946882,Africa,7,0
2020-04-03,Chad,TD,0,0,15946882,Africa,7,0
2020-04-04,Chad,TD,0,0,15946882,Africa,7,0
2020-04-05,Chad,TD,1,0,15946882,Africa,8,0
2020-04-06,Chad,TD,1,0,15946882,Africa,9,0
2020-04-07,Chad,TD,0,0,15946882,Africa,9,0
2020-04-08,Chad,TD,0,0,15946882,Africa,9,0
2020-04-09,Chad,TD,1,0,15946882,Africa,10,0
2020-04-10,Chad,TD,1,0,15946882,Africa,11,0
2020-04-11,Chad,TD,0,0,15946882,Africa,11,0
2020-04-12,Chad,TD,0,0,15946882,Africa,11,0
2020-04-13,Chad,TD,4,0,15946882,Africa,15,0
2020-04-14,Chad,TD,8,0,15946882,Africa,23,0
2020-04-15,Chad,TD,0,0,15946882,Africa,23,0
2020-04-16,Chad,TD,4,0,15946882,Africa,27,0
2020-04-17,Chad,TD,0,0,15946882,Africa,27,0
2020-04-18,Chad,TD,6,0,15946882,Africa,33,0
2020-04-19,Chad,TD,0,0,15946882,Africa,33,0
2020-04-20,Chad,TD,0,0,15946882,Africa,33,0
2020-04-21,Chad,TD,0,0,15946882,Africa,33,0
2020-04-22,Chad,TD,1,0,15946882,Africa,34,0
2020-04-23,Chad,TD,0,0,15946882,Africa,34,0
2020-04-24,Chad,TD,6,0,15946882,Africa,40,0
2020-04-25,Chad,TD,0,0,15946882,Africa,40,0
2020-04-26,Chad,TD,0,0,15946882,Africa,40,0
2020-04-27,Chad,TD,6,0,15946882,Africa,46,0
2020-04-28,Chad,TD,0,0,15946882,Africa,46,0
2020-04-29,Chad,TD,6,2,15946882,Africa,52,2
2020-04-30,Chad,TD,0,0,15946882,Africa,52,2
2020-05-01,Chad,TD,21,3,15946882,Africa,73,5
2020-05-02,Chad,TD,0,0,15946882,Africa,73,5
2020-05-03,Chad,TD,44,5,15946882,Africa,117,10
2020-05-04,Chad,TD,0,0,15946882,Africa,117,10
2020-05-05,Chad,TD,0,0,15946882,Africa,117,10
2020-05-06,Chad,TD,53,7,15946882,Africa,170,17
2020-05-07,Chad,TD,0,0,15946882,Africa,170,17
2020-05-08,Chad,TD,83,10,15946882,Africa,253,27
2020-05-09,Chad,TD,7,1,15946882,Africa,260,28
2020-05-10,Chad,TD,62,3,15946882,Africa,322,31
2020-05-11,Chad,TD,0,0,15946882,Africa,322,31
2020-05-12,Chad,TD,0,0,15946882,Africa,322,31
2020-05-13,Chad,TD,35,9,15946882,Africa,357,40
2020-05-14,Chad,TD,15,2,15946882,Africa,372,42
2020-05-15,Chad,TD,27,4,15946882,Africa,399,46
2020-05-16,Chad,TD,29,2,15946882,Africa,428,48
2020-05-17,Chad,TD,46,2,15946882,Africa,474,50
2020-05-18,Chad,TD,29,3,15946882,Africa,503,53
2020-05-19,Chad,TD,16,0,15946882,Africa,519,53
2020-05-20,Chad,TD,26,3,15946882,Africa,545,56
2020-05-21,Chad,TD,20,1,15946882,Africa,565,57
2020-05-22,Chad,TD,23,1,15946882,Africa,588,58
2020-05-23,Chad,TD,23,1,15946882,Africa,611,59
2020-05-24,Chad,TD,37,1,15946882,Africa,648,60
2020-05-25,Chad,TD,27,0,15946882,Africa,675,60
2020-05-26,Chad,TD,12,1,15946882,Africa,687,61
2020-05-27,Chad,TD,13,1,15946882,Africa,700,62
2020-05-28,Chad,TD,15,2,15946882,Africa,715,64
2020-05-29,Chad,TD,11,1,15946882,Africa,726,65
2020-05-30,Chad,TD,33,0,15946882,Africa,759,65
2020-05-31,Chad,TD,0,0,15946882,Africa,759,65
2020-06-01,Chad,TD,19,0,15946882,Africa,778,65
2020-06-02,Chad,TD,12,1,15946882,Africa,790,66
2020-06-03,Chad,TD,13,0,15946882,Africa,803,66
2020-06-04,Chad,TD,17,0,15946882,Africa,820,66
2020-06-05,Chad,TD,8,0,15946882,Africa,828,66
2020-06-06,Chad,TD,8,2,15946882,Africa,836,68
2020-06-07,Chad,TD,0,1,15946882,Africa,836,69
2020-06-08,Chad,TD,1,0,15946882,Africa,837,69
2020-06-09,Chad,TD,2,1,15946882,Africa,839,70
2020-06-10,Chad,TD,5,1,15946882,Africa,844,71
2020-06-11,Chad,TD,2,1,15946882,Africa,846,72
2020-06-12,Chad,TD,2,0,15946882,Africa,848,72
2020-06-13,Chad,TD,0,0,15946882,Africa,848,72
2020-06-14,Chad,TD,0,0,15946882,Africa,848,72
2020-06-15,Chad,TD,2,1,15946882,Africa,850,73
2020-06-16,Chad,TD,0,0,15946882,Africa,850,73
2020-06-17,Chad,TD,3,1,15946882,Africa,853,74
2020-06-18,Chad,TD,1,0,15946882,Africa,854,74
2020-06-19,Chad,TD,0,0,15946882,Africa,854,74
2020-06-20,Chad,TD,4,0,15946882,Africa,858,74
2020-06-21,Chad,TD,0,0,15946882,Africa,858,74
2020-06-22,Chad,TD,0,0,15946882,Africa,858,74
2020-06-23,Chad,TD,0,0,15946882,Africa,858,74
2020-06-24,Chad,TD,2,0,15946882,Africa,860,74
2020-06-25,Chad,TD,0,0,15946882,Africa,860,74
2020-06-26,Chad,TD,3,0,15946882,Africa,863,74
2020-06-27,Chad,TD,2,0,15946882,Africa,865,74
2020-06-28,Chad,TD,0,0,15946882,Africa,865,74
2020-06-29,Chad,TD,1,0,15946882,Africa,866,74
2020-06-30,Chad,TD,0,0,15946882,Africa,866,74
2020-07-01,Chad,TD,0,0,15946882,Africa,866,74
2020-07-02,Chad,TD,0,0,15946882,Africa,866,74
2020-07-03,Chad,TD,2,0,15946882,Africa,868,74
2020-07-04,Chad,TD,3,0,15946882,Africa,871,74
2020-07-05,Chad,TD,0,0,15946882,Africa,871,74
2020-07-06,Chad,TD,1,0,15946882,Africa,872,74
2020-07-07,Chad,TD,0,0,15946882,Africa,872,74
2020-07-08,Chad,TD,1,0,15946882,Africa,873,74
2020-07-09,Chad,TD,0,0,15946882,Africa,873,74
2020-07-10,Chad,TD,0,0,15946882,Africa,873,74
2020-07-11,Chad,TD,1,0,15946882,Africa,874,74
2020-07-12,Chad,TD,0,0,15946882,Africa,874,74
2020-07-13,Chad,TD,6,1,15946882,Africa,880,75
2020-07-14,Chad,TD,0,0,15946882,Africa,880,75
2020-07-15,Chad,TD,4,0,15946882,Africa,884,75
2020-07-16,Chad,TD,1,0,15946882,Africa,885,75
2020-07-17,Chad,TD,1,0,15946882,Africa,886,75
2020-07-18,Chad,TD,1,0,15946882,Africa,887,75
2020-07-19,Chad,TD,2,0,15946882,Africa,889,75
2020-07-20,Chad,TD,0,0,15946882,Africa,889,75
2020-07-21,Chad,TD,0,0,15946882,Africa,889,75
2020-07-22,Chad,TD,0,0,15946882,Africa,889,75
2020-07-23,Chad,TD,0,0,15946882,Africa,889,75
2020-07-24,Chad,TD,26,0,15946882,Africa,915,75
2020-07-25,Chad,TD,0,0,15946882,Africa,915,75
2020-07-26,Chad,TD,0,0,15946882,Africa,915,75
2020-07-27,Chad,TD,0,0,15946882,Africa,915,75
2020-07-28,Chad,TD,7,0,15946882,Africa,922,75
2020-07-29,Chad,TD,4,0,15946882,Africa,926,75
2020-07-30,Chad,TD,0,0,15946882,Africa,926,75
2020-07-31,Chad,TD,9,0,15946882,Africa,935,75
2020-08-01,Chad,TD,1,0,15946882,Africa,936,75
2020-08-02,Chad,TD,0,0,15946882,Africa,936,75
2020-08-03,Chad,TD,0,0,15946882,Africa,936,75
2020-08-04,Chad,TD,0,0,15946882,Africa,936,75
2020-08-05,Chad,TD,2,0,15946882,Africa,938,75
2020-08-06,Chad,TD,1,0,15946882,Africa,939,75
2020-08-07,Chad,TD,3,1,15946882,Africa,942,76
2020-08-08,Chad,TD,0,0,15946882,Africa,942,76
2020-08-09,Chad,TD,0,0,15946882,Africa,942,76
2020-08-10,Chad,TD,2,0,15946882,Africa,944,76
2020-08-11,Chad,TD,1,0,15946882,Africa,945,76
2020-08-12,Chad,TD,1,0,15946882,Africa,946,76
2020-08-13,Chad,TD,3,0,15946882,Africa,949,76
2020-08-14,Chad,TD,0,0,15946882,Africa,949,76
2020-08-15,Chad,TD,2,0,15946882,Africa,951,76
2020-08-16,Chad,TD,1,0,15946882,Africa,952,76
2020-08-17,Chad,TD,4,0,15946882,Africa,956,76
2020-08-18,Chad,TD,3,0,15946882,Africa,959,76
2020-08-19,Chad,TD,11,0,15946882,Africa,970,76
2020-08-20,Chad,TD,1,0,15946882,Africa,971,76
2020-08-21,Chad,TD,1,0,15946882,Africa,972,76
2020-08-22,Chad,TD,9,0,15946882,Africa,981,76
2020-08-23,Chad,TD,1,0,15946882,Africa,982,76
2020-08-24,Chad,TD,4,0,15946882,Africa,986,76
2020-08-25,Chad,TD,1,0,15946882,Africa,987,76
2020-08-26,Chad,TD,8,1,15946882,Africa,995,77
2020-08-27,Chad,TD,3,0,15946882,Africa,998,77
2020-08-28,Chad,TD,6,0,15946882,Africa,1004,77
2020-08-29,Chad,TD,4,0,15946882,Africa,1008,77
2020-08-30,Chad,TD,0,0,15946882,Africa,1008,77
2020-08-31,Chad,TD,4,0,15946882,Africa,1012,77
2020-09-01,Chad,TD,1,0,15946882,Africa,1013,77
2020-09-02,Chad,TD,4,0,15946882,Africa,1017,77
2020-09-03,Chad,TD,0,0,15946882,Africa,1017,77
2020-09-04,Chad,TD,1,0,15946882,Africa,1018,77
2020-09-05,Chad,TD,5,0,15946882,Africa,1023,77
2020-09-06,Chad,TD,11,0,15946882,Africa,1034,77
2020-09-07,Chad,TD,5,2,15946882,Africa,1039,79
2020-09-08,Chad,TD,1,0,15946882,Africa,1040,79
2020-09-09,Chad,TD,5,0,15946882,Africa,1045,79
2020-09-10,Chad,TD,3,0,15946882,Africa,1048,79
2020-09-11,Chad,TD,3,0,15946882,Africa,1051,79
2020-09-12,Chad,TD,30,0,15946882,Africa,1081,79
2020-09-13,Chad,TD,2,1,15946882,Africa,1083,80
2020-09-14,Chad,TD,1,0,15946882,Africa,1084,80
2020-09-15,Chad,TD,1,1,15946882,Africa,1085,81
2020-09-16,Chad,TD,2,0,15946882,Africa,1087,81
2020-09-17,Chad,TD,3,0,15946882,Africa,1090,81
2020-09-18,Chad,TD,25,0,15946882,Africa,1115,81
2020-09-19,Chad,TD,32,0,15946882,Africa,1147,81
2020-09-20,Chad,TD,2,0,15946882,Africa,1149,81
2020-09-21,Chad,TD,2,0,15946882,Africa,1151,81
2020-09-22,Chad,TD,2,0,15946882,Africa,1153,81
2020-09-23,Chad,TD,2,0,15946882,Africa,1155,81
2020-09-24,Chad,TD,9,1,15946882,Africa,1164,82
2020-09-25,Chad,TD,7,0,15946882,Africa,1171,82
2020-09-26,Chad,TD,4,1,15946882,Africa,1175,83
2020-09-27,Chad,TD,2,0,15946882,Africa,1177,83
2020-09-28,Chad,TD,1,1,15946882,Africa,1178,84
2020-09-29,Chad,TD,7,1,15946882,Africa,1185,85
2020-09-30,Chad,TD,8,0,15946882,Africa,1193,85
2020-10-01,Chad,TD,7,0,15946882,Africa,1200,85
2020-10-02,Chad,TD,3,0,15946882,Africa,1203,85
2020-10-03,Chad,TD,8,0,15946882,Africa,1211,85
2020-10-04,Chad,TD,3,0,15946882,Africa,1214,85
2020-10-05,Chad,TD,3,1,15946882,Africa,1217,86
2020-10-06,Chad,TD,6,0,15946882,Africa,1223,86
2020-10-07,Chad,TD,15,2,15946882,Africa,1238,88
2020-10-08,Chad,TD,13,0,15946882,Africa,1251,88
2020-10-09,Chad,TD,11,1,15946882,Africa,1262,89
2020-10-10,Chad,TD,12,1,15946882,Africa,1274,90
2020-10-11,Chad,TD,17,2,15946882,Africa,1291,92
2020-10-12,Chad,TD,13,0,15946882,Africa,1304,92
2020-10-13,Chad,TD,4,0,15946882,Africa,1308,92
2020-10-14,Chad,TD,13,0,15946882,Africa,1321,92
2020-10-15,Chad,TD,8,0,15946882,Africa,1329,92
2020-10-16,Chad,TD,21,0,15946882,Africa,1350,92
2020-10-17,Chad,TD,11,1,15946882,Africa,1361,93
2020-10-18,Chad,TD,4,0,15946882,Africa,1365,93
2020-10-19,Chad,TD,14,0,15946882,Africa,1379,93
2020-10-20,Chad,TD,11,0,15946882,Africa,1390,93
2020-10-21,Chad,TD,9,0,15946882,Africa,1399,93
2020-10-22,Chad,TD,5,3,15946882,Africa,1404,96
2020-10-23,Chad,TD,6,0,15946882,Africa,1410,96
2020-10-24,Chad,TD,13,0,15946882,Africa,1423,96
2020-10-25,Chad,TD,11,0,15946882,Africa,1434,96
2020-10-26,Chad,TD,3,0,15946882,Africa,1437,96
2020-10-27,Chad,TD,4,0,15946882,Africa,1441,96
2020-10-28,Chad,TD,19,0,15946882,Africa,1460,96
2020-10-29,Chad,TD,8,1,15946882,Africa,1468,97
2020-10-30,Chad,TD,5,0,15946882,Africa,1473,97
2020-10-31,Chad,TD,10,1,15946882,Africa,1483,98
2020-11-01,Chad,TD,0,0,15946882,Africa,1483,98
2020-11-02,Chad,TD,15,0,15946882,Africa,1498,98
2020-11-03,Chad,TD,1,0,15946882,Africa,1499,98
2020-11-04,Chad,TD,14,0,15946882,Africa,1513,98
2020-11-05,Chad,TD,4,1,15946882,Africa,1517,99
2020-11-06,Chad,TD,12,0,15946882,Africa,1529,99
2020-11-07,Chad,TD,9,0,15946882,Africa,1538,99
2020-11-08,Chad,TD,5,0,15946882,Africa,1543,99
2020-11-09,Chad,TD,4,0,15946882,Africa,1547,99
2020-11-10,Chad,TD,4,0,15946882,Africa,1551,99
2020-11-11,Chad,TD,10,0,15946882,Africa,1561,99
2020-11-12,Chad,TD,4,0,15946882,Africa,1565,99
2020-11-13,Chad,TD,0,0,15946882,Africa,1565,99
2020-11-14,Chad,TD,24,1,15946882,Africa,1589,100
2020-11-15,Chad,TD,2,0,15946882,Africa,1591,100
2020-11-16,Chad,TD,6,1,15946882,Africa,1597,101
2020-11-17,Chad,TD,6,0,15946882,Africa,1603,101
2020-11-18,Chad,TD,5,0,15946882,Africa,1608,101
2020-11-19,Chad,TD,8,0,15946882,Africa,1616,101
2020-11-20,Chad,TD,4,0,15946882,Africa,1620,101
2020-11-21,Chad,TD,6,0,15946882,Africa,1626,101
2020-11-22,Chad,TD,7,0,15946882,Africa,1633,101
2020-11-23,Chad,TD,9,0,15946882,Africa,1642,101
2020-11-24,Chad,TD,6,0,15946882,Africa,1648,101
2020-11-25,Chad,TD,1,0,15946882,Africa,1649,101
2020-11-26,Chad,TD,6,0,15946882,Africa,1655,101
2020-11-27,Chad,TD,6,0,15946882,Africa,1661,101
2020-11-28,Chad,TD,2,0,15946882,Africa,1663,101
2020-11-29,Chad,TD,0,0,15946882,Africa,1663,101
2020-11-30,Chad,TD,19,0,15946882,Africa,1682,101
2020-12-01,Chad,TD,6,0,15946882,Africa,1688,101
2020-12-02,Chad,TD,12,1,15946882,Africa,1700,102
2020-12-03,Chad,TD,5,0,15946882,Africa,1705,102
2020-12-04,Chad,TD,3,0,15946882,Africa,1708,102
2020-12-05,Chad,TD,11,0,15946882,Africa,1719,102
2020-12-06,Chad,TD,3,0,15946882,Africa,1722,102
2020-12-07,Chad,TD,3,0,15946882,Africa,1725,102
2020-12-08,Chad,TD,3,0,15946882,Africa,1728,102
2020-12-09,Chad,TD,1,0,15946882,Africa,1729,102
2020-12-10,Chad,TD,3,0,15946882,Africa,1732,102
2020-12-11,Chad,TD,7,0,15946882,Africa,1739,102
2020-12-12,Chad,TD,6,0,15946882,Africa,1745,102
2020-12-13,Chad,TD,6,0,15946882,Africa,1751,102
2020-12-14,Chad,TD,19,0,15946882,Africa,1770,102
2020-03-07,Togo,TG,1,0,8082359,Africa,1,0
2020-03-15,Togo,TG,0,0,8082359,Africa,1,0
2020-03-16,Togo,TG,0,0,8082359,Africa,1,0
2020-03-17,Togo,TG,0,0,8082359,Africa,1,0
2020-03-18,Togo,TG,0,0,8082359,Africa,1,0
2020-03-19,Togo,TG,0,0,8082359,Africa,1,0
2020-03-20,Togo,TG,0,0,8082359,Africa,1,0
2020-03-21,Togo,TG,8,0,8082359,Africa,9,0
2020-03-22,Togo,TG,6,0,8082359,Africa,15,0
2020-03-23,Togo,TG,0,0,8082359,Africa,15,0
2020-03-24,Togo,TG,3,0,8082359,Africa,18,0
2020-03-25,Togo,TG,0,0,8082359,Africa,18,0
2020-03-26,Togo,TG,5,0,8082359,Africa,23,0
2020-03-27,Togo,TG,1,0,8082359,Africa,24,0
2020-03-28,Togo,TG,1,1,8082359,Africa,25,1
2020-03-29,Togo,TG,3,0,8082359,Africa,28,1
2020-03-30,Togo,TG,2,0,8082359,Africa,30,1
2020-03-31,Togo,TG,4,0,8082359,Africa,34,1
2020-04-01,Togo,TG,0,0,8082359,Africa,34,1
2020-04-02,Togo,TG,2,1,8082359,Africa,36,2
2020-04-03,Togo,TG,3,0,8082359,Africa,39,2
2020-04-04,Togo,TG,1,1,8082359,Africa,40,3
2020-04-05,Togo,TG,1,0,8082359,Africa,41,3
2020-04-06,Togo,TG,3,0,8082359,Africa,44,3
2020-04-07,Togo,TG,14,0,8082359,Africa,58,3
2020-04-08,Togo,TG,7,0,8082359,Africa,65,3
2020-04-09,Togo,TG,5,0,8082359,Africa,70,3
2020-04-10,Togo,TG,3,0,8082359,Africa,73,3
2020-04-11,Togo,TG,3,0,8082359,Africa,76,3
2020-04-12,Togo,TG,0,0,8082359,Africa,76,3
2020-04-13,Togo,TG,0,0,8082359,Africa,76,3
2020-04-14,Togo,TG,1,0,8082359,Africa,77,3
2020-04-15,Togo,TG,0,0,8082359,Africa,77,3
2020-04-16,Togo,TG,4,0,8082359,Africa,81,3
2020-04-17,Togo,TG,0,2,8082359,Africa,81,5
2020-04-18,Togo,TG,2,0,8082359,Africa,83,5
2020-04-19,Togo,TG,1,0,8082359,Africa,84,5
2020-04-20,Togo,TG,0,0,8082359,Africa,84,5
2020-04-21,Togo,TG,0,1,8082359,Africa,84,6
2020-04-22,Togo,TG,2,0,8082359,Africa,86,6
2020-04-23,Togo,TG,2,0,8082359,Africa,88,6
2020-04-24,Togo,TG,0,0,8082359,Africa,88,6
2020-04-25,Togo,TG,2,0,8082359,Africa,90,6
2020-04-26,Togo,TG,6,0,8082359,Africa,96,6
2020-04-27,Togo,TG,2,0,8082359,Africa,98,6
2020-04-28,Togo,TG,1,0,8082359,Africa,99,6
2020-04-29,Togo,TG,0,0,8082359,Africa,99,6
2020-04-30,Togo,TG,10,1,8082359,Africa,109,7
2020-05-01,Togo,TG,7,2,8082359,Africa,116,9
2020-05-02,Togo,TG,7,0,8082359,Africa,123,9
2020-05-03,Togo,TG,0,0,8082359,Africa,123,9
2020-05-04,Togo,TG,1,0,8082359,Africa,124,9
2020-05-05,Togo,TG,2,0,8082359,Africa,126,9
2020-05-06,Togo,TG,2,0,8082359,Africa,128,9
2020-05-07,Togo,TG,0,0,8082359,Africa,128,9
2020-05-08,Togo,TG,7,0,8082359,Africa,135,9
2020-05-09,Togo,TG,10,1,8082359,Africa,145,10
2020-05-10,Togo,TG,8,0,8082359,Africa,153,10
2020-05-11,Togo,TG,21,1,8082359,Africa,174,11
2020-05-12,Togo,TG,7,0,8082359,Africa,181,11
2020-05-13,Togo,TG,18,0,8082359,Africa,199,11
2020-05-14,Togo,TG,20,0,8082359,Africa,219,11
2020-05-15,Togo,TG,19,0,8082359,Africa,238,11
2020-05-16,Togo,TG,25,0,8082359,Africa,263,11
2020-05-17,Togo,TG,35,0,8082359,Africa,298,11
2020-05-18,Togo,TG,3,0,8082359,Africa,301,11
2020-05-19,Togo,TG,29,1,8082359,Africa,330,12
2020-05-20,Togo,TG,8,0,8082359,Africa,338,12
2020-05-21,Togo,TG,2,0,8082359,Africa,340,12
2020-05-22,Togo,TG,14,0,8082359,Africa,354,12
2020-05-23,Togo,TG,9,0,8082359,Africa,363,12
2020-05-24,Togo,TG,10,0,8082359,Africa,373,12
2020-05-25,Togo,TG,8,0,8082359,Africa,381,12
2020-05-26,Togo,TG,5,1,8082359,Africa,386,13
2020-05-27,Togo,TG,5,0,8082359,Africa,391,13
2020-05-28,Togo,TG,4,0,8082359,Africa,395,13
2020-05-29,Togo,TG,27,0,8082359,Africa,422,13
2020-05-30,Togo,TG,6,0,8082359,Africa,428,13
2020-05-31,Togo,TG,5,0,8082359,Africa,433,13
2020-06-01,Togo,TG,9,0,8082359,Africa,442,13
2020-06-02,Togo,TG,1,0,8082359,Africa,443,13
2020-06-03,Togo,TG,2,0,8082359,Africa,445,13
2020-06-04,Togo,TG,7,0,8082359,Africa,452,13
2020-06-05,Togo,TG,13,0,8082359,Africa,465,13
2020-06-06,Togo,TG,20,0,8082359,Africa,485,13
2020-06-07,Togo,TG,2,0,8082359,Africa,487,13
2020-06-08,Togo,TG,8,0,8082359,Africa,495,13
2020-06-09,Togo,TG,2,0,8082359,Africa,497,13
2020-06-10,Togo,TG,4,0,8082359,Africa,501,13
2020-06-11,Togo,TG,21,0,8082359,Africa,522,13
2020-06-12,Togo,TG,2,0,8082359,Africa,524,13
2020-06-13,Togo,TG,1,0,8082359,Africa,525,13
2020-06-14,Togo,TG,5,0,8082359,Africa,530,13
2020-06-15,Togo,TG,1,0,8082359,Africa,531,13
2020-06-16,Togo,TG,1,0,8082359,Africa,532,13
2020-06-17,Togo,TG,5,0,8082359,Africa,537,13
2020-06-18,Togo,TG,7,0,8082359,Africa,544,13
2020-06-19,Togo,TG,3,0,8082359,Africa,547,13
2020-06-20,Togo,TG,8,0,8082359,Africa,555,13
2020-06-21,Togo,TG,6,0,8082359,Africa,561,13
2020-06-22,Togo,TG,8,0,8082359,Africa,569,13
2020-06-23,Togo,TG,0,0,8082359,Africa,569,13
2020-06-24,Togo,TG,7,0,8082359,Africa,576,13
2020-06-25,Togo,TG,7,1,8082359,Africa,583,14
2020-06-26,Togo,TG,5,0,8082359,Africa,588,14
2020-06-27,Togo,TG,3,0,8082359,Africa,591,14
2020-06-28,Togo,TG,24,0,8082359,Africa,615,14
2020-06-29,Togo,TG,27,0,8082359,Africa,642,14
2020-06-30,Togo,TG,1,0,8082359,Africa,643,14
2020-07-01,Togo,TG,7,0,8082359,Africa,650,14
2020-07-02,Togo,TG,11,0,8082359,Africa,661,14
2020-07-03,Togo,TG,6,0,8082359,Africa,667,14
2020-07-04,Togo,TG,4,0,8082359,Africa,671,14
2020-07-05,Togo,TG,5,1,8082359,Africa,676,15
2020-07-06,Togo,TG,4,0,8082359,Africa,680,15
2020-07-07,Togo,TG,0,0,8082359,Africa,680,15
2020-07-08,Togo,TG,9,0,8082359,Africa,689,15
2020-07-09,Togo,TG,6,0,8082359,Africa,695,15
2020-07-10,Togo,TG,9,0,8082359,Africa,704,15
2020-07-11,Togo,TG,6,0,8082359,Africa,710,15
2020-07-12,Togo,TG,8,0,8082359,Africa,718,15
2020-07-13,Togo,TG,2,0,8082359,Africa,720,15
2020-07-14,Togo,TG,1,0,8082359,Africa,721,15
2020-07-15,Togo,TG,10,0,8082359,Africa,731,15
2020-07-16,Togo,TG,9,0,8082359,Africa,740,15
2020-07-17,Togo,TG,9,0,8082359,Africa,749,15
2020-07-18,Togo,TG,0,0,8082359,Africa,749,15
2020-07-19,Togo,TG,17,0,8082359,Africa,766,15
2020-07-20,Togo,TG,8,0,8082359,Africa,774,15
2020-07-21,Togo,TG,9,0,8082359,Africa,783,15
2020-07-22,Togo,TG,7,0,8082359,Africa,790,15
2020-07-23,Togo,TG,16,1,8082359,Africa,806,16
2020-07-24,Togo,TG,22,0,8082359,Africa,828,16
2020-07-25,Togo,TG,11,1,8082359,Africa,839,17
2020-07-26,Togo,TG,14,0,8082359,Africa,853,17
2020-07-27,Togo,TG,15,1,8082359,Africa,868,18
2020-07-28,Togo,TG,6,0,8082359,Africa,874,18
2020-07-29,Togo,TG,22,0,8082359,Africa,896,18
2020-07-30,Togo,TG,0,0,8082359,Africa,896,18
2020-07-31,Togo,TG,31,0,8082359,Africa,927,18
2020-08-01,Togo,TG,14,1,8082359,Africa,941,19
2020-08-02,Togo,TG,17,0,8082359,Africa,958,19
2020-08-03,Togo,TG,3,0,8082359,Africa,961,19
2020-08-04,Togo,TG,15,0,8082359,Africa,976,19
2020-08-05,Togo,TG,12,0,8082359,Africa,988,19
2020-08-06,Togo,TG,13,2,8082359,Africa,1001,21
2020-08-07,Togo,TG,11,1,8082359,Africa,1012,22
2020-08-08,Togo,TG,16,0,8082359,Africa,1028,22
2020-08-09,Togo,TG,18,1,8082359,Africa,1046,23
2020-08-10,Togo,TG,14,0,8082359,Africa,1060,23
2020-08-11,Togo,TG,7,2,8082359,Africa,1067,25
2020-08-12,Togo,TG,3,1,8082359,Africa,1070,26
2020-08-13,Togo,TG,22,0,8082359,Africa,1092,26
2020-08-14,Togo,TG,12,0,8082359,Africa,1104,26
2020-08-15,Togo,TG,20,0,8082359,Africa,1124,26
2020-08-16,Togo,TG,6,1,8082359,Africa,1130,27
2020-08-17,Togo,TG,17,0,8082359,Africa,1147,27
2020-08-18,Togo,TG,7,0,8082359,Africa,1154,27
2020-08-19,Togo,TG,19,0,8082359,Africa,1173,27
2020-08-20,Togo,TG,17,0,8082359,Africa,1190,27
2020-08-21,Togo,TG,22,0,8082359,Africa,1212,27
2020-08-22,Togo,TG,27,0,8082359,Africa,1239,27
2020-08-23,Togo,TG,36,0,8082359,Africa,1275,27
2020-08-24,Togo,TG,2,0,8082359,Africa,1277,27
2020-08-25,Togo,TG,18,0,8082359,Africa,1295,27
2020-08-26,Togo,TG,14,0,8082359,Africa,1309,27
2020-08-27,Togo,TG,17,0,8082359,Africa,1326,27
2020-08-28,Togo,TG,0,0,8082359,Africa,1326,27
2020-08-29,Togo,TG,39,0,8082359,Africa,1365,27
2020-08-30,Togo,TG,25,0,8082359,Africa,1390,27
2020-08-31,Togo,TG,6,0,8082359,Africa,1396,27
2020-09-01,Togo,TG,4,1,8082359,Africa,1400,28
2020-09-02,Togo,TG,16,0,8082359,Africa,1416,28
2020-09-03,Togo,TG,18,2,8082359,Africa,1434,30
2020-09-04,Togo,TG,9,1,8082359,Africa,1443,31
2020-09-05,Togo,TG,14,0,8082359,Africa,1457,31
2020-09-06,Togo,TG,20,1,8082359,Africa,1477,32
2020-09-07,Togo,TG,11,0,8082359,Africa,1488,32
2020-09-08,Togo,TG,5,1,8082359,Africa,1493,33
2020-09-09,Togo,TG,20,1,8082359,Africa,1513,34
2020-09-10,Togo,TG,15,2,8082359,Africa,1528,36
2020-09-11,Togo,TG,9,1,8082359,Africa,1537,37
2020-09-12,Togo,TG,11,0,8082359,Africa,1548,37
2020-09-13,Togo,TG,7,0,8082359,Africa,1555,37
2020-09-14,Togo,TG,17,0,8082359,Africa,1572,37
2020-09-15,Togo,TG,6,3,8082359,Africa,1578,40
2020-09-16,Togo,TG,17,0,8082359,Africa,1595,40
2020-09-17,Togo,TG,13,0,8082359,Africa,1608,40
2020-09-18,Togo,TG,10,1,8082359,Africa,1618,41
2020-09-19,Togo,TG,22,0,8082359,Africa,1640,41
2020-09-20,Togo,TG,19,0,8082359,Africa,1659,41
2020-09-21,Togo,TG,7,0,8082359,Africa,1666,41
2020-09-22,Togo,TG,3,0,8082359,Africa,1669,41
2020-09-23,Togo,TG,14,0,8082359,Africa,1683,41
2020-09-24,Togo,TG,18,0,8082359,Africa,1701,41
2020-09-25,Togo,TG,6,3,8082359,Africa,1707,44
2020-09-26,Togo,TG,15,0,8082359,Africa,1722,44
2020-09-27,Togo,TG,14,2,8082359,Africa,1736,46
2020-09-28,Togo,TG,7,0,8082359,Africa,1743,46
2020-09-29,Togo,TG,6,1,8082359,Africa,1749,47
2020-09-30,Togo,TG,10,1,8082359,Africa,1759,48
2020-10-01,Togo,TG,25,0,8082359,Africa,1784,48
2020-10-02,Togo,TG,25,0,8082359,Africa,1809,48
2020-10-03,Togo,TG,9,0,8082359,Africa,1818,48
2020-10-04,Togo,TG,22,0,8082359,Africa,1840,48
2020-10-05,Togo,TG,14,0,8082359,Africa,1854,48
2020-10-06,Togo,TG,10,0,8082359,Africa,1864,48
2020-10-07,Togo,TG,17,1,8082359,Africa,1881,49
2020-10-08,Togo,TG,17,0,8082359,Africa,1898,49
2020-10-09,Togo,TG,9,0,8082359,Africa,1907,49
2020-10-10,Togo,TG,14,0,8082359,Africa,1921,49
2020-10-11,Togo,TG,14,0,8082359,Africa,1935,49
2020-10-12,Togo,TG,5,0,8082359,Africa,1940,49
2020-10-13,Togo,TG,9,0,8082359,Africa,1949,49
2020-10-14,Togo,TG,23,1,8082359,Africa,1972,50
2020-10-15,Togo,TG,11,1,8082359,Africa,1983,51
2020-10-16,Togo,TG,13,0,8082359,Africa,1996,51
2020-10-17,Togo,TG,31,0,8082359,Africa,2027,51
2020-10-18,Togo,TG,22,0,8082359,Africa,2049,51
2020-10-19,Togo,TG,8,0,8082359,Africa,2057,51
2020-10-20,Togo,TG,14,0,8082359,Africa,2071,51
2020-10-21,Togo,TG,33,0,8082359,Africa,2104,51
2020-10-22,Togo,TG,16,0,8082359,Africa,2120,51
2020-10-23,Togo,TG,19,1,8082359,Africa,2139,52
2020-10-24,Togo,TG,23,0,8082359,Africa,2162,52
2020-10-25,Togo,TG,25,0,8082359,Africa,2187,52
2020-10-26,Togo,TG,13,0,8082359,Africa,2200,52
2020-10-27,Togo,TG,4,1,8082359,Africa,2204,53
2020-10-28,Togo,TG,25,1,8082359,Africa,2229,54
2020-10-29,Togo,TG,9,0,8082359,Africa,2238,54
2020-10-30,Togo,TG,58,1,8082359,Africa,2296,55
2020-10-31,Togo,TG,16,0,8082359,Africa,2312,55
2020-11-01,Togo,TG,19,2,8082359,Africa,2331,57
2020-11-02,Togo,TG,26,0,8082359,Africa,2357,57
2020-11-03,Togo,TG,7,0,8082359,Africa,2364,57
2020-11-04,Togo,TG,17,0,8082359,Africa,2381,57
2020-11-05,Togo,TG,25,0,8082359,Africa,2406,57
2020-11-06,Togo,TG,36,0,8082359,Africa,2442,57
2020-11-07,Togo,TG,18,0,8082359,Africa,2460,57
2020-11-08,Togo,TG,23,0,8082359,Africa,2483,57
2020-11-09,Togo,TG,33,0,8082359,Africa,2516,57
2020-11-10,Togo,TG,7,0,8082359,Africa,2523,57
2020-11-11,Togo,TG,35,0,8082359,Africa,2558,57
2020-11-12,Togo,TG,35,2,8082359,Africa,2593,59
2020-11-13,Togo,TG,12,1,8082359,Africa,2605,60
2020-11-14,Togo,TG,22,0,8082359,Africa,2627,60
2020-11-15,Togo,TG,24,1,8082359,Africa,2651,61
2020-11-16,Togo,TG,24,0,8082359,Africa,2675,61
2020-11-17,Togo,TG,18,0,8082359,Africa,2693,61
2020-11-18,Togo,TG,29,1,8082359,Africa,2722,62
2020-11-19,Togo,TG,30,1,8082359,Africa,2752,63
2020-11-20,Togo,TG,19,0,8082359,Africa,2771,63
2020-11-21,Togo,TG,25,1,8082359,Africa,2796,64
2020-11-22,Togo,TG,33,0,8082359,Africa,2829,64
2020-11-23,Togo,TG,14,0,8082359,Africa,2843,64
2020-11-24,Togo,TG,11,0,8082359,Africa,2854,64
2020-11-25,Togo,TG,18,0,8082359,Africa,2872,64
2020-11-26,Togo,TG,17,0,8082359,Africa,2889,64
2020-11-27,Togo,TG,15,0,8082359,Africa,2904,64
2020-11-28,Togo,TG,22,0,8082359,Africa,2926,64
2020-11-29,Togo,TG,20,0,8082359,Africa,2946,64
2020-11-30,Togo,TG,16,0,8082359,Africa,2962,64
2020-12-01,Togo,TG,12,0,8082359,Africa,2974,64
2020-12-02,Togo,TG,23,0,8082359,Africa,2997,64
2020-12-03,Togo,TG,17,1,8082359,Africa,3014,65
2020-12-04,Togo,TG,25,0,8082359,Africa,3039,65
2020-12-05,Togo,TG,12,0,8082359,Africa,3051,65
2020-12-06,Togo,TG,34,0,8082359,Africa,3085,65
2020-12-07,Togo,TG,10,0,8082359,Africa,3095,65
2020-12-08,Togo,TG,16,0,8082359,Africa,3111,65
2020-12-09,Togo,TG,21,0,8082359,Africa,3132,65
2020-12-10,Togo,TG,19,0,8082359,Africa,3151,65
2020-12-11,Togo,TG,31,1,8082359,Africa,3182,66
2020-12-12,Togo,TG,20,0,8082359,Africa,3202,66
2020-12-13,Togo,TG,19,0,8082359,Africa,3221,66
2020-12-14,Togo,TG,30,0,8082359,Africa,3251,66
2019-12-31,Thailand,TH,0,0,69625581,Asia,0,0
2020-01-01,Thailand,TH,0,0,69625581,Asia,0,0
2020-01-02,Thailand,TH,0,0,69625581,Asia,0,0
2020-01-03,Thailand,TH,0,0,69625581,Asia,0,0
2020-01-04,Thailand,TH,0,0,69625581,Asia,0,0
2020-01-05,Thailand,TH,0,0,69625581,Asia,0,0
2020-01-06,Thailand,TH,0,0,69625581,Asia,0,0
2020-01-07,Thailand,TH,0,0,69625581,Asia,0,0
2020-01-08,Thailand,TH,0,0,69625581,Asia,0,0
2020-01-09,Thailand,TH,0,0,69625581,Asia,0,0
2020-01-10,Thailand,TH,0,0,69625581,Asia,0,0
2020-01-11,Thailand,TH,0,0,69625581,Asia,0,0
2020-01-12,Thailand,TH,0,0,69625581,Asia,0,0
2020-01-13,Thailand,TH,1,0,69625581,Asia,1,0
2020-01-14,Thailand,TH,0,0,69625581,Asia,1,0
2020-01-15,Thailand,TH,0,0,69625581,Asia,1,0
2020-01-16,Thailand,TH,0,0,69625581,Asia,1,0
2020-01-17,Thailand,TH,1,0,69625581,Asia,2,0
2020-01-18,Thailand,TH,0,0,69625581,Asia,2,0
2020-01-19,Thailand,TH,0,0,69625581,Asia,2,0
2020-01-20,Thailand,TH,0,0,69625581,Asia,2,0
2020-01-21,Thailand,TH,0,0,69625581,Asia,2,0
2020-01-22,Thailand,TH,2,0,69625581,Asia,4,0
2020-01-23,Thailand,TH,0,0,69625581,Asia,4,0
2020-01-24,Thailand,TH,0,0,69625581,Asia,4,0
2020-01-25,Thailand,TH,1,0,69625581,Asia,5,0
2020-01-26,Thailand,TH,0,0,69625581,Asia,5,0
2020-01-27,Thailand,TH,3,0,69625581,Asia,8,0
2020-01-28,Thailand,TH,6,0,69625581,Asia,14,0
2020-01-29,Thailand,TH,0,0,69625581,Asia,14,0
2020-01-30,Thailand,TH,0,0,69625581,Asia,14,0
2020-01-31,Thailand,TH,0,0,69625581,Asia,14,0
2020-02-01,Thailand,TH,5,0,69625581,Asia,19,0
2020-02-02,Thailand,TH,0,0,69625581,Asia,19,0
2020-02-03,Thailand,TH,0,0,69625581,Asia,19,0
2020-02-04,Thailand,TH,0,0,69625581,Asia,19,0
2020-02-05,Thailand,TH,6,0,69625581,Asia,25,0
2020-02-06,Thailand,TH,0,0,69625581,Asia,25,0
2020-02-07,Thailand,TH,0,0,69625581,Asia,25,0
2020-02-08,Thailand,TH,7,0,69625581,Asia,32,0
2020-02-09,Thailand,TH,0,0,69625581,Asia,32,0
2020-02-10,Thailand,TH,0,0,69625581,Asia,32,0
2020-02-11,Thailand,TH,0,0,69625581,Asia,32,0
2020-02-12,Thailand,TH,1,0,69625581,Asia,33,0
2020-02-13,Thailand,TH,0,0,69625581,Asia,33,0
2020-02-14,Thailand,TH,0,0,69625581,Asia,33,0
2020-02-15,Thailand,TH,1,0,69625581,Asia,34,0
2020-02-16,Thailand,TH,0,0,69625581,Asia,34,0
2020-02-17,Thailand,TH,0,0,69625581,Asia,34,0
2020-02-18,Thailand,TH,1,0,69625581,Asia,35,0
2020-02-19,Thailand,TH,0,0,69625581,Asia,35,0
2020-02-20,Thailand,TH,0,0,69625581,Asia,35,0
2020-02-21,Thailand,TH,0,0,69625581,Asia,35,0
2020-02-22,Thailand,TH,0,0,69625581,Asia,35,0
2020-02-23,Thailand,TH,0,0,69625581,Asia,35,0
2020-02-24,Thailand,TH,0,0,69625581,Asia,35,0
2020-02-25,Thailand,TH,2,0,69625581,Asia,37,0
2020-02-26,Thailand,TH,3,0,69625581,Asia,40,0
2020-02-27,Thailand,TH,0,0,69625581,Asia,40,0
2020-02-28,Thailand,TH,0,0,69625581,Asia,40,0
2020-02-29,Thailand,TH,2,0,69625581,Asia,42,0
2020-03-01,Thailand,TH,0,1,69625581,Asia,42,1
2020-03-02,Thailand,TH,1,0,69625581,Asia,43,1
2020-03-05,Thailand,TH,4,0,69625581,Asia,47,1
2020-03-07,Thailand,TH,3,0,69625581,Asia,50,1
2020-03-11,Thailand,TH,9,0,69625581,Asia,59,1
2020-03-12,Thailand,TH,11,0,69625581,Asia,70,1
2020-03-14,Thailand,TH,12,0,69625581,Asia,82,1
2020-03-15,Thailand,TH,0,0,69625581,Asia,82,1
2020-03-16,Thailand,TH,32,0,69625581,Asia,114,1
2020-03-17,Thailand,TH,63,0,69625581,Asia,177,1
2020-03-18,Thailand,TH,0,0,69625581,Asia,177,1
2020-03-19,Thailand,TH,0,0,69625581,Asia,177,1
2020-03-20,Thailand,TH,35,0,69625581,Asia,212,1
2020-03-21,Thailand,TH,154,0,69625581,Asia,366,1
2020-03-22,Thailand,TH,233,0,69625581,Asia,599,1
2020-03-23,Thailand,TH,122,0,69625581,Asia,721,1
2020-03-24,Thailand,TH,106,3,69625581,Asia,827,4
2020-03-25,Thailand,TH,107,0,69625581,Asia,934,4
2020-03-26,Thailand,TH,111,0,69625581,Asia,1045,4
2020-03-27,Thailand,TH,91,1,69625581,Asia,1136,5
2020-03-28,Thailand,TH,0,0,69625581,Asia,1136,5
2020-03-29,Thailand,TH,109,1,69625581,Asia,1245,6
2020-03-30,Thailand,TH,143,1,69625581,Asia,1388,7
2020-03-31,Thailand,TH,263,3,69625581,Asia,1651,10
2020-04-01,Thailand,TH,0,0,69625581,Asia,1651,10
2020-04-02,Thailand,TH,120,2,69625581,Asia,1771,12
2020-04-03,Thailand,TH,104,3,69625581,Asia,1875,15
2020-04-04,Thailand,TH,103,4,69625581,Asia,1978,19
2020-04-05,Thailand,TH,191,4,69625581,Asia,2169,23
2020-04-06,Thailand,TH,51,3,69625581,Asia,2220,26
2020-04-07,Thailand,TH,38,0,69625581,Asia,2258,26
2020-04-08,Thailand,TH,111,4,69625581,Asia,2369,30
2020-04-09,Thailand,TH,54,2,69625581,Asia,2423,32
2020-04-10,Thailand,TH,50,1,69625581,Asia,2473,33
2020-04-11,Thailand,TH,45,2,69625581,Asia,2518,35
2020-04-12,Thailand,TH,33,3,69625581,Asia,2551,38
2020-04-13,Thailand,TH,28,2,69625581,Asia,2579,40
2020-04-14,Thailand,TH,34,1,69625581,Asia,2613,41
2020-04-15,Thailand,TH,30,2,69625581,Asia,2643,43
2020-04-16,Thailand,TH,29,3,69625581,Asia,2672,46
2020-04-17,Thailand,TH,28,1,69625581,Asia,2700,47
2020-04-18,Thailand,TH,0,0,69625581,Asia,2700,47
2020-04-19,Thailand,TH,33,0,69625581,Asia,2733,47
2020-04-20,Thailand,TH,32,0,69625581,Asia,2765,47
2020-04-21,Thailand,TH,27,0,69625581,Asia,2792,47
2020-04-22,Thailand,TH,19,1,69625581,Asia,2811,48
2020-04-23,Thailand,TH,28,2,69625581,Asia,2839,50
2020-04-24,Thailand,TH,0,0,69625581,Asia,2839,50
2020-04-25,Thailand,TH,15,0,69625581,Asia,2854,50
2020-04-26,Thailand,TH,68,1,69625581,Asia,2922,51
2020-04-27,Thailand,TH,0,0,69625581,Asia,2922,51
2020-04-28,Thailand,TH,16,3,69625581,Asia,2938,54
2020-04-29,Thailand,TH,0,0,69625581,Asia,2938,54
2020-04-30,Thailand,TH,16,0,69625581,Asia,2954,54
2020-05-01,Thailand,TH,6,0,69625581,Asia,2960,54
2020-05-02,Thailand,TH,0,0,69625581,Asia,2960,54
2020-05-03,Thailand,TH,6,0,69625581,Asia,2966,54
2020-05-04,Thailand,TH,3,0,69625581,Asia,2969,54
2020-05-05,Thailand,TH,18,0,69625581,Asia,2987,54
2020-05-06,Thailand,TH,1,0,69625581,Asia,2988,54
2020-05-07,Thailand,TH,1,1,69625581,Asia,2989,55
2020-05-08,Thailand,TH,3,0,69625581,Asia,2992,55
2020-05-09,Thailand,TH,8,0,69625581,Asia,3000,55
2020-05-10,Thailand,TH,4,1,69625581,Asia,3004,56
2020-05-11,Thailand,TH,11,0,69625581,Asia,3015,56
2020-05-12,Thailand,TH,0,0,69625581,Asia,3015,56
2020-05-13,Thailand,TH,2,0,69625581,Asia,3017,56
2020-05-14,Thailand,TH,0,0,69625581,Asia,3017,56
2020-05-15,Thailand,TH,1,0,69625581,Asia,3018,56
2020-05-16,Thailand,TH,7,0,69625581,Asia,3025,56
2020-05-17,Thailand,TH,3,0,69625581,Asia,3028,56
2020-05-18,Thailand,TH,0,0,69625581,Asia,3028,56
2020-05-19,Thailand,TH,3,0,69625581,Asia,3031,56
2020-05-20,Thailand,TH,3,0,69625581,Asia,3034,56
2020-05-21,Thailand,TH,0,0,69625581,Asia,3034,56
2020-05-22,Thailand,TH,3,0,69625581,Asia,3037,56
2020-05-23,Thailand,TH,3,0,69625581,Asia,3040,56
2020-05-24,Thailand,TH,0,0,69625581,Asia,3040,56
2020-05-25,Thailand,TH,2,1,69625581,Asia,3042,57
2020-05-26,Thailand,TH,0,0,69625581,Asia,3042,57
2020-05-27,Thailand,TH,3,0,69625581,Asia,3045,57
2020-05-28,Thailand,TH,9,0,69625581,Asia,3054,57
2020-05-29,Thailand,TH,11,0,69625581,Asia,3065,57
2020-05-30,Thailand,TH,11,0,69625581,Asia,3076,57
2020-05-31,Thailand,TH,5,0,69625581,Asia,3081,57
2020-06-01,Thailand,TH,0,0,69625581,Asia,3081,57
2020-06-02,Thailand,TH,1,0,69625581,Asia,3082,57
2020-06-03,Thailand,TH,1,1,69625581,Asia,3083,58
2020-06-04,Thailand,TH,18,0,69625581,Asia,3101,58
2020-06-05,Thailand,TH,1,0,69625581,Asia,3102,58
2020-06-06,Thailand,TH,2,0,69625581,Asia,3104,58
2020-06-07,Thailand,TH,8,0,69625581,Asia,3112,58
2020-06-08,Thailand,TH,7,0,69625581,Asia,3119,58
2020-06-09,Thailand,TH,0,0,69625581,Asia,3119,58
2020-06-10,Thailand,TH,6,0,69625581,Asia,3125,58
2020-06-11,Thailand,TH,0,0,69625581,Asia,3125,58
2020-06-12,Thailand,TH,0,0,69625581,Asia,3125,58
2020-06-13,Thailand,TH,4,0,69625581,Asia,3129,58
2020-06-14,Thailand,TH,5,0,69625581,Asia,3134,58
2020-06-15,Thailand,TH,1,0,69625581,Asia,3135,58
2020-06-16,Thailand,TH,0,0,69625581,Asia,3135,58
2020-06-17,Thailand,TH,0,0,69625581,Asia,3135,58
2020-06-18,Thailand,TH,6,0,69625581,Asia,3141,58
2020-06-19,Thailand,TH,0,0,69625581,Asia,3141,58
2020-06-20,Thailand,TH,5,0,69625581,Asia,3146,58
2020-06-21,Thailand,TH,1,0,69625581,Asia,3147,58
2020-06-22,Thailand,TH,1,0,69625581,Asia,3148,58
2020-06-23,Thailand,TH,3,0,69625581,Asia,3151,58
2020-06-24,Thailand,TH,5,0,69625581,Asia,3156,58
2020-06-25,Thailand,TH,2,0,69625581,Asia,3158,58
2020-06-26,Thailand,TH,0,0,69625581,Asia,3158,58
2020-06-27,Thailand,TH,4,0,69625581,Asia,3162,58
2020-06-28,Thailand,TH,0,0,69625581,Asia,3162,58
2020-06-29,Thailand,TH,0,0,69625581,Asia,3162,58
2020-06-30,Thailand,TH,9,0,69625581,Asia,3171,58
2020-07-01,Thailand,TH,2,0,69625581,Asia,3173,58
2020-07-02,Thailand,TH,6,0,69625581,Asia,3179,58
2020-07-03,Thailand,TH,1,0,69625581,Asia,3180,58
2020-07-04,Thailand,TH,5,0,69625581,Asia,3185,58
2020-07-05,Thailand,TH,5,0,69625581,Asia,3190,58
2020-07-06,Thailand,TH,5,0,69625581,Asia,3195,58
2020-07-07,Thailand,TH,0,0,69625581,Asia,3195,58
2020-07-08,Thailand,TH,2,0,69625581,Asia,3197,58
2020-07-09,Thailand,TH,5,0,69625581,Asia,3202,58
2020-07-10,Thailand,TH,0,0,69625581,Asia,3202,58
2020-07-11,Thailand,TH,14,0,69625581,Asia,3216,58
2020-07-12,Thailand,TH,1,0,69625581,Asia,3217,58
2020-07-13,Thailand,TH,3,0,69625581,Asia,3220,58
2020-07-14,Thailand,TH,7,0,69625581,Asia,3227,58
2020-07-15,Thailand,TH,5,0,69625581,Asia,3232,58
2020-07-16,Thailand,TH,4,0,69625581,Asia,3236,58
2020-07-17,Thailand,TH,3,0,69625581,Asia,3239,58
2020-07-18,Thailand,TH,7,0,69625581,Asia,3246,58
2020-07-19,Thailand,TH,3,0,69625581,Asia,3249,58
2020-07-20,Thailand,TH,1,0,69625581,Asia,3250,58
2020-07-21,Thailand,TH,5,0,69625581,Asia,3255,58
2020-07-22,Thailand,TH,6,0,69625581,Asia,3261,58
2020-07-23,Thailand,TH,8,0,69625581,Asia,3269,58
2020-07-24,Thailand,TH,10,0,69625581,Asia,3279,58
2020-07-25,Thailand,TH,3,0,69625581,Asia,3282,58
2020-07-26,Thailand,TH,9,0,69625581,Asia,3291,58
2020-07-27,Thailand,TH,4,0,69625581,Asia,3295,58
2020-07-28,Thailand,TH,2,0,69625581,Asia,3297,58
2020-07-29,Thailand,TH,1,0,69625581,Asia,3298,58
2020-07-30,Thailand,TH,6,0,69625581,Asia,3304,58
2020-07-31,Thailand,TH,6,0,69625581,Asia,3310,58
2020-08-01,Thailand,TH,2,0,69625581,Asia,3312,58
2020-08-02,Thailand,TH,5,0,69625581,Asia,3317,58
2020-08-03,Thailand,TH,3,0,69625581,Asia,3320,58
2020-08-04,Thailand,TH,1,0,69625581,Asia,3321,58
2020-08-05,Thailand,TH,7,0,69625581,Asia,3328,58
2020-08-06,Thailand,TH,2,0,69625581,Asia,3330,58
2020-08-07,Thailand,TH,15,0,69625581,Asia,3345,58
2020-08-08,Thailand,TH,3,0,69625581,Asia,3348,58
2020-08-09,Thailand,TH,3,0,69625581,Asia,3351,58
2020-08-10,Thailand,TH,0,0,69625581,Asia,3351,58
2020-08-11,Thailand,TH,0,0,69625581,Asia,3351,58
2020-08-12,Thailand,TH,5,0,69625581,Asia,3356,58
2020-08-13,Thailand,TH,0,0,69625581,Asia,3356,58
2020-08-14,Thailand,TH,20,0,69625581,Asia,3376,58
2020-08-15,Thailand,TH,0,0,69625581,Asia,3376,58
2020-08-16,Thailand,TH,1,0,69625581,Asia,3377,58
2020-08-17,Thailand,TH,1,0,69625581,Asia,3378,58
2020-08-18,Thailand,TH,0,0,69625581,Asia,3378,58
2020-08-19,Thailand,TH,4,0,69625581,Asia,3382,58
2020-08-20,Thailand,TH,7,0,69625581,Asia,3389,58
2020-08-21,Thailand,TH,1,0,69625581,Asia,3390,58
2020-08-22,Thailand,TH,0,0,69625581,Asia,3390,58
2020-08-23,Thailand,TH,5,0,69625581,Asia,3395,58
2020-08-24,Thailand,TH,2,0,69625581,Asia,3397,58
2020-08-25,Thailand,TH,5,0,69625581,Asia,3402,58
2020-08-26,Thailand,TH,1,0,69625581,Asia,3403,58
2020-08-27,Thailand,TH,1,0,69625581,Asia,3404,58
2020-08-28,Thailand,TH,6,0,69625581,Asia,3410,58
2020-08-29,Thailand,TH,1,0,69625581,Asia,3411,58
2020-08-30,Thailand,TH,0,0,69625581,Asia,3411,58
2020-08-31,Thailand,TH,1,0,69625581,Asia,3412,58
2020-09-01,Thailand,TH,5,0,69625581,Asia,3417,58
2020-09-02,Thailand,TH,8,0,69625581,Asia,3425,58
2020-09-03,Thailand,TH,2,0,69625581,Asia,3427,58
2020-09-04,Thailand,TH,4,0,69625581,Asia,3431,58
2020-09-05,Thailand,TH,0,0,69625581,Asia,3431,58
2020-09-06,Thailand,TH,13,0,69625581,Asia,3444,58
2020-09-07,Thailand,TH,1,0,69625581,Asia,3445,58
2020-09-08,Thailand,TH,1,0,69625581,Asia,3446,58
2020-09-09,Thailand,TH,1,0,69625581,Asia,3447,58
2020-09-10,Thailand,TH,7,0,69625581,Asia,3454,58
2020-09-11,Thailand,TH,7,0,69625581,Asia,3461,58
2020-09-12,Thailand,TH,5,0,69625581,Asia,3466,58
2020-09-13,Thailand,TH,7,0,69625581,Asia,3473,58
2020-09-14,Thailand,TH,2,0,69625581,Asia,3475,58
2020-09-15,Thailand,TH,5,0,69625581,Asia,3480,58
2020-09-16,Thailand,TH,10,0,69625581,Asia,3490,58
2020-09-17,Thailand,TH,0,0,69625581,Asia,3490,58
2020-09-18,Thailand,TH,7,0,69625581,Asia,3497,58
2020-09-19,Thailand,TH,3,1,69625581,Asia,3500,59
2020-09-20,Thailand,TH,6,0,69625581,Asia,3506,59
2020-09-21,Thailand,TH,0,0,69625581,Asia,3506,59
2020-09-22,Thailand,TH,5,0,69625581,Asia,3511,59
2020-09-23,Thailand,TH,3,0,69625581,Asia,3514,59
2020-09-24,Thailand,TH,2,0,69625581,Asia,3516,59
2020-09-25,Thailand,TH,3,0,69625581,Asia,3519,59
2020-09-26,Thailand,TH,3,0,69625581,Asia,3522,59
2020-09-27,Thailand,TH,1,0,69625581,Asia,3523,59
2020-09-28,Thailand,TH,22,0,69625581,Asia,3545,59
2020-09-29,Thailand,TH,14,0,69625581,Asia,3559,59
2020-09-30,Thailand,TH,5,0,69625581,Asia,3564,59
2020-10-01,Thailand,TH,5,0,69625581,Asia,3569,59
2020-10-02,Thailand,TH,6,0,69625581,Asia,3575,59
2020-10-03,Thailand,TH,8,0,69625581,Asia,3583,59
2020-10-04,Thailand,TH,0,0,69625581,Asia,3583,59
2020-10-05,Thailand,TH,7,0,69625581,Asia,3590,59
2020-10-06,Thailand,TH,10,0,69625581,Asia,3600,59
2020-10-07,Thailand,TH,15,0,69625581,Asia,3615,59
2020-10-08,Thailand,TH,7,0,69625581,Asia,3622,59
2020-10-09,Thailand,TH,6,0,69625581,Asia,3628,59
2020-10-10,Thailand,TH,6,0,69625581,Asia,3634,59
2020-10-11,Thailand,TH,0,0,69625581,Asia,3634,59
2020-10-12,Thailand,TH,7,0,69625581,Asia,3641,59
2020-10-13,Thailand,TH,2,0,69625581,Asia,3643,59
2020-10-14,Thailand,TH,9,0,69625581,Asia,3652,59
2020-10-15,Thailand,TH,13,0,69625581,Asia,3665,59
2020-10-16,Thailand,TH,4,0,69625581,Asia,3669,59
2020-10-17,Thailand,TH,10,0,69625581,Asia,3679,59
2020-10-18,Thailand,TH,7,0,69625581,Asia,3686,59
2020-10-19,Thailand,TH,5,0,69625581,Asia,3691,59
2020-10-20,Thailand,TH,9,0,69625581,Asia,3700,59
2020-10-21,Thailand,TH,9,0,69625581,Asia,3709,59
2020-10-22,Thailand,TH,10,0,69625581,Asia,3719,59
2020-10-23,Thailand,TH,8,0,69625581,Asia,3727,59
2020-10-24,Thailand,TH,4,0,69625581,Asia,3731,59
2020-10-25,Thailand,TH,5,0,69625581,Asia,3736,59
2020-10-26,Thailand,TH,7,0,69625581,Asia,3743,59
2020-10-27,Thailand,TH,3,0,69625581,Asia,3746,59
2020-10-28,Thailand,TH,13,0,69625581,Asia,3759,59
2020-10-29,Thailand,TH,4,0,69625581,Asia,3763,59
2020-10-30,Thailand,TH,12,0,69625581,Asia,3775,59
2020-10-31,Thailand,TH,5,0,69625581,Asia,3780,59
2020-11-01,Thailand,TH,4,0,69625581,Asia,3784,59
2020-11-02,Thailand,TH,3,0,69625581,Asia,3787,59
2020-11-03,Thailand,TH,10,0,69625581,Asia,3797,59
2020-11-04,Thailand,TH,7,0,69625581,Asia,3804,59
2020-11-05,Thailand,TH,6,0,69625581,Asia,3810,59
2020-11-06,Thailand,TH,8,1,69625581,Asia,3818,60
2020-11-07,Thailand,TH,12,0,69625581,Asia,3830,60
2020-11-08,Thailand,TH,7,0,69625581,Asia,3837,60
2020-11-09,Thailand,TH,3,0,69625581,Asia,3840,60
2020-11-10,Thailand,TH,4,0,69625581,Asia,3844,60
2020-11-11,Thailand,TH,3,0,69625581,Asia,3847,60
2020-11-12,Thailand,TH,5,0,69625581,Asia,3852,60
2020-11-13,Thailand,TH,9,0,69625581,Asia,3861,60
2020-11-14,Thailand,TH,5,0,69625581,Asia,3866,60
2020-11-15,Thailand,TH,8,0,69625581,Asia,3874,60
2020-11-16,Thailand,TH,1,0,69625581,Asia,3875,60
2020-11-17,Thailand,TH,3,0,69625581,Asia,3878,60
2020-11-18,Thailand,TH,2,0,69625581,Asia,3880,60
2020-11-19,Thailand,TH,8,0,69625581,Asia,3888,60
2020-11-20,Thailand,TH,4,0,69625581,Asia,3892,60
2020-11-21,Thailand,TH,10,0,69625581,Asia,3902,60
2020-11-22,Thailand,TH,11,0,69625581,Asia,3913,60
2020-11-23,Thailand,TH,0,0,69625581,Asia,3913,60
2020-11-24,Thailand,TH,7,0,69625581,Asia,3920,60
2020-11-25,Thailand,TH,6,0,69625581,Asia,3926,60
2020-11-26,Thailand,TH,16,0,69625581,Asia,3942,60
2020-11-27,Thailand,TH,19,0,69625581,Asia,3961,60
2020-11-28,Thailand,TH,5,0,69625581,Asia,3966,60
2020-11-29,Thailand,TH,11,0,69625581,Asia,3977,60
2020-11-30,Thailand,TH,0,0,69625581,Asia,3977,60
2020-12-01,Thailand,TH,21,0,69625581,Asia,3998,60
2020-12-02,Thailand,TH,28,0,69625581,Asia,4026,60
2020-12-03,Thailand,TH,13,0,69625581,Asia,4039,60
2020-12-04,Thailand,TH,0,0,69625581,Asia,4039,60
2020-12-05,Thailand,TH,33,0,69625581,Asia,4072,60
2020-12-06,Thailand,TH,14,0,69625581,Asia,4086,60
2020-12-07,Thailand,TH,21,0,69625581,Asia,4107,60
2020-12-08,Thailand,TH,0,0,69625581,Asia,4107,60
2020-12-09,Thailand,TH,19,0,69625581,Asia,4126,60
2020-12-10,Thailand,TH,25,0,69625581,Asia,4151,60
2020-12-11,Thailand,TH,29,0,69625581,Asia,4180,60
2020-12-12,Thailand,TH,12,0,69625581,Asia,4192,60
2020-12-13,Thailand,TH,17,0,69625581,Asia,4209,60
2020-12-14,Thailand,TH,28,0,69625581,Asia,4237,60
2020-05-01,Tajikistan,TJ,15,0,9321023,Asia,15,0
2020-05-02,Tajikistan,TJ,0,0,9321023,Asia,15,0
2020-05-03,Tajikistan,TJ,17,0,9321023,Asia,32,0
2020-05-04,Tajikistan,TJ,44,2,9321023,Asia,76,2
2020-05-05,Tajikistan,TJ,154,1,9321023,Asia,230,3
2020-05-06,Tajikistan,TJ,63,2,9321023,Asia,293,5
2020-05-07,Tajikistan,TJ,86,3,9321023,Asia,379,8
2020-05-08,Tajikistan,TJ,82,4,9321023,Asia,461,12
2020-05-09,Tajikistan,TJ,61,0,9321023,Asia,522,12
2020-05-10,Tajikistan,TJ,90,8,9321023,Asia,612,20
2020-05-11,Tajikistan,TJ,0,0,9321023,Asia,612,20
2020-05-12,Tajikistan,TJ,49,1,9321023,Asia,661,21
2020-05-13,Tajikistan,TJ,68,2,9321023,Asia,729,23
2020-05-14,Tajikistan,TJ,72,0,9321023,Asia,801,23
2020-05-15,Tajikistan,TJ,106,6,9321023,Asia,907,29
2020-05-16,Tajikistan,TJ,211,4,9321023,Asia,1118,33
2020-05-17,Tajikistan,TJ,204,3,9321023,Asia,1322,36
2020-05-18,Tajikistan,TJ,202,3,9321023,Asia,1524,39
2020-05-19,Tajikistan,TJ,205,2,9321023,Asia,1729,41
2020-05-20,Tajikistan,TJ,0,0,9321023,Asia,1729,41
2020-05-21,Tajikistan,TJ,207,3,9321023,Asia,1936,44
2020-05-22,Tajikistan,TJ,204,0,9321023,Asia,2140,44
2020-05-23,Tajikistan,TJ,210,0,9321023,Asia,2350,44
2020-05-24,Tajikistan,TJ,201,0,9321023,Asia,2551,44
2020-05-25,Tajikistan,TJ,187,0,9321023,Asia,2738,44
2020-05-26,Tajikistan,TJ,362,2,9321023,Asia,3100,46
2020-05-27,Tajikistan,TJ,0,0,9321023,Asia,3100,46
2020-05-28,Tajikistan,TJ,0,0,9321023,Asia,3100,46
2020-05-29,Tajikistan,TJ,463,1,9321023,Asia,3563,47
2020-05-30,Tajikistan,TJ,0,0,9321023,Asia,3563,47
2020-05-31,Tajikistan,TJ,244,0,9321023,Asia,3807,47
2020-06-01,Tajikistan,TJ,0,0,9321023,Asia,3807,47
2020-06-02,Tajikistan,TJ,123,0,9321023,Asia,3930,47
2020-06-03,Tajikistan,TJ,83,0,9321023,Asia,4013,47
2020-06-04,Tajikistan,TJ,87,0,9321023,Asia,4100,47
2020-06-05,Tajikistan,TJ,189,1,9321023,Asia,4289,48
2020-06-06,Tajikistan,TJ,81,0,9321023,Asia,4370,48
2020-06-07,Tajikistan,TJ,83,0,9321023,Asia,4453,48
2020-06-08,Tajikistan,TJ,76,0,9321023,Asia,4529,48
2020-06-09,Tajikistan,TJ,80,0,9321023,Asia,4609,48
2020-06-10,Tajikistan,TJ,81,0,9321023,Asia,4690,48
2020-06-11,Tajikistan,TJ,73,0,9321023,Asia,4763,48
2020-06-12,Tajikistan,TJ,71,1,9321023,Asia,4834,49
2020-06-13,Tajikistan,TJ,68,0,9321023,Asia,4902,49
2020-06-14,Tajikistan,TJ,69,1,9321023,Asia,4971,50
2020-06-15,Tajikistan,TJ,64,0,9321023,Asia,5035,50
2020-06-16,Tajikistan,TJ,62,0,9321023,Asia,5097,50
2020-06-17,Tajikistan,TJ,63,0,9321023,Asia,5160,50
2020-06-18,Tajikistan,TJ,61,1,9321023,Asia,5221,51
2020-06-19,Tajikistan,TJ,58,0,9321023,Asia,5279,51
2020-06-20,Tajikistan,TJ,59,0,9321023,Asia,5338,51
2020-06-21,Tajikistan,TJ,61,1,9321023,Asia,5399,52
2020-06-22,Tajikistan,TJ,58,0,9321023,Asia,5457,52
2020-06-23,Tajikistan,TJ,56,0,9321023,Asia,5513,52
2020-06-24,Tajikistan,TJ,54,0,9321023,Asia,5567,52
2020-06-25,Tajikistan,TJ,63,0,9321023,Asia,5630,52
2020-06-26,Tajikistan,TJ,61,0,9321023,Asia,5691,52
2020-06-27,Tajikistan,TJ,56,0,9321023,Asia,5747,52
2020-06-28,Tajikistan,TJ,52,0,9321023,Asia,5799,52
2020-06-29,Tajikistan,TJ,50,0,9321023,Asia,5849,52
2020-06-30,Tajikistan,TJ,51,0,9321023,Asia,5900,52
2020-07-01,Tajikistan,TJ,54,0,9321023,Asia,5954,52
2020-07-02,Tajikistan,TJ,51,0,9321023,Asia,6005,52
2020-07-03,Tajikistan,TJ,53,0,9321023,Asia,6058,52
2020-07-04,Tajikistan,TJ,50,0,9321023,Asia,6108,52
2020-07-05,Tajikistan,TJ,51,0,9321023,Asia,6159,52
2020-07-06,Tajikistan,TJ,54,1,9321023,Asia,6213,53
2020-07-07,Tajikistan,TJ,49,0,9321023,Asia,6262,53
2020-07-08,Tajikistan,TJ,53,0,9321023,Asia,6315,53
2020-07-09,Tajikistan,TJ,49,1,9321023,Asia,6364,54
2020-07-10,Tajikistan,TJ,46,0,9321023,Asia,6410,54
2020-07-11,Tajikistan,TJ,47,1,9321023,Asia,6457,55
2020-07-12,Tajikistan,TJ,49,0,9321023,Asia,6506,55
2020-07-13,Tajikistan,TJ,46,0,9321023,Asia,6552,55
2020-07-14,Tajikistan,TJ,43,0,9321023,Asia,6595,55
2020-07-15,Tajikistan,TJ,48,1,9321023,Asia,6643,56
2020-07-16,Tajikistan,TJ,52,0,9321023,Asia,6695,56
2020-07-17,Tajikistan,TJ,46,0,9321023,Asia,6741,56
2020-07-18,Tajikistan,TJ,45,0,9321023,Asia,6786,56
2020-07-19,Tajikistan,TJ,48,1,9321023,Asia,6834,57
2020-07-20,Tajikistan,TJ,44,0,9321023,Asia,6878,57
2020-07-21,Tajikistan,TJ,43,0,9321023,Asia,6921,57
2020-07-22,Tajikistan,TJ,46,0,9321023,Asia,6967,57
2020-07-23,Tajikistan,TJ,48,1,9321023,Asia,7015,58
2020-07-24,Tajikistan,TJ,45,0,9321023,Asia,7060,58
2020-07-25,Tajikistan,TJ,44,0,9321023,Asia,7104,58
2020-07-26,Tajikistan,TJ,46,1,9321023,Asia,7150,59
2020-07-27,Tajikistan,TJ,42,0,9321023,Asia,7192,59
2020-07-28,Tajikistan,TJ,43,1,9321023,Asia,7235,60
2020-07-29,Tajikistan,TJ,41,0,9321023,Asia,7276,60
2020-07-30,Tajikistan,TJ,44,0,9321023,Asia,7320,60
2020-07-31,Tajikistan,TJ,46,0,9321023,Asia,7366,60
2020-08-01,Tajikistan,TJ,43,0,9321023,Asia,7409,60
2020-08-02,Tajikistan,TJ,42,0,9321023,Asia,7451,60
2020-08-03,Tajikistan,TJ,44,1,9321023,Asia,7495,61
2020-08-04,Tajikistan,TJ,43,0,9321023,Asia,7538,61
2020-08-05,Tajikistan,TJ,45,0,9321023,Asia,7583,61
2020-08-06,Tajikistan,TJ,42,0,9321023,Asia,7625,61
2020-08-07,Tajikistan,TJ,40,1,9321023,Asia,7665,62
2020-08-08,Tajikistan,TJ,41,0,9321023,Asia,7706,62
2020-08-09,Tajikistan,TJ,0,0,9321023,Asia,7706,62
2020-08-10,Tajikistan,TJ,39,0,9321023,Asia,7745,62
2020-08-11,Tajikistan,TJ,82,0,9321023,Asia,7827,62
2020-08-12,Tajikistan,TJ,44,1,9321023,Asia,7871,63
2020-08-13,Tajikistan,TJ,41,0,9321023,Asia,7912,63
2020-08-14,Tajikistan,TJ,38,0,9321023,Asia,7950,63
2020-08-15,Tajikistan,TJ,39,0,9321023,Asia,7989,63
2020-08-16,Tajikistan,TJ,40,1,9321023,Asia,8029,64
2020-08-17,Tajikistan,TJ,36,0,9321023,Asia,8065,64
2020-08-18,Tajikistan,TJ,34,0,9321023,Asia,8099,64
2020-08-19,Tajikistan,TJ,32,1,9321023,Asia,8131,65
2020-08-20,Tajikistan,TJ,35,0,9321023,Asia,8166,65
2020-08-21,Tajikistan,TJ,37,1,9321023,Asia,8203,66
2020-08-22,Tajikistan,TJ,38,0,9321023,Asia,8241,66
2020-08-23,Tajikistan,TJ,36,0,9321023,Asia,8277,66
2020-08-24,Tajikistan,TJ,34,0,9321023,Asia,8311,66
2020-08-25,Tajikistan,TJ,35,1,9321023,Asia,8346,67
2020-08-26,Tajikistan,TJ,33,0,9321023,Asia,8379,67
2020-08-27,Tajikistan,TJ,34,0,9321023,Asia,8413,67
2020-08-28,Tajikistan,TJ,36,1,9321023,Asia,8449,68
2020-08-29,Tajikistan,TJ,32,0,9321023,Asia,8481,68
2020-08-30,Tajikistan,TJ,0,0,9321023,Asia,8481,68
2020-08-31,Tajikistan,TJ,69,0,9321023,Asia,8550,68
2020-09-01,Tajikistan,TJ,33,0,9321023,Asia,8583,68
2020-09-02,Tajikistan,TJ,36,1,9321023,Asia,8619,69
2020-09-03,Tajikistan,TJ,35,0,9321023,Asia,8654,69
2020-09-04,Tajikistan,TJ,36,0,9321023,Asia,8690,69
2020-09-05,Tajikistan,TJ,34,0,9321023,Asia,8724,69
2020-09-06,Tajikistan,TJ,33,1,9321023,Asia,8757,70
2020-09-07,Tajikistan,TJ,35,0,9321023,Asia,8792,70
2020-09-08,Tajikistan,TJ,32,0,9321023,Asia,8824,70
2020-09-09,Tajikistan,TJ,36,0,9321023,Asia,8860,70
2020-09-10,Tajikistan,TJ,39,1,9321023,Asia,8899,71
2020-09-11,Tajikistan,TJ,40,1,9321023,Asia,8939,72
2020-09-12,Tajikistan,TJ,38,0,9321023,Asia,8977,72
2020-09-13,Tajikistan,TJ,37,0,9321023,Asia,9014,72
2020-09-14,Tajikistan,TJ,35,0,9321023,Asia,9049,72
2020-09-15,Tajikistan,TJ,39,0,9321023,Asia,9088,72
2020-09-16,Tajikistan,TJ,41,1,9321023,Asia,9129,73
2020-09-17,Tajikistan,TJ,42,0,9321023,Asia,9171,73
2020-09-18,Tajikistan,TJ,43,0,9321023,Asia,9214,73
2020-09-19,Tajikistan,TJ,45,0,9321023,Asia,9259,73
2020-09-20,Tajikistan,TJ,44,0,9321023,Asia,9303,73
2020-09-21,Tajikistan,TJ,43,0,9321023,Asia,9346,73
2020-09-22,Tajikistan,TJ,42,0,9321023,Asia,9388,73
2020-09-23,Tajikistan,TJ,44,0,9321023,Asia,9432,73
2020-09-24,Tajikistan,TJ,43,1,9321023,Asia,9475,74
2020-09-25,Tajikistan,TJ,45,0,9321023,Asia,9520,74
2020-09-26,Tajikistan,TJ,42,0,9321023,Asia,9562,74
2020-09-27,Tajikistan,TJ,43,1,9321023,Asia,9605,75
2020-09-28,Tajikistan,TJ,41,0,9321023,Asia,9646,75
2020-09-29,Tajikistan,TJ,39,0,9321023,Asia,9685,75
2020-09-30,Tajikistan,TJ,41,0,9321023,Asia,9726,75
2020-10-01,Tajikistan,TJ,43,1,9321023,Asia,9769,76
2020-10-02,Tajikistan,TJ,42,1,9321023,Asia,9811,77
2020-10-03,Tajikistan,TJ,41,0,9321023,Asia,9852,77
2020-10-04,Tajikistan,TJ,43,0,9321023,Asia,9895,77
2020-10-05,Tajikistan,TJ,40,1,9321023,Asia,9935,78
2020-10-06,Tajikistan,TJ,39,0,9321023,Asia,9974,78
2020-10-07,Tajikistan,TJ,40,0,9321023,Asia,10014,78
2020-10-08,Tajikistan,TJ,41,0,9321023,Asia,10055,78
2020-10-09,Tajikistan,TJ,42,0,9321023,Asia,10097,78
2020-10-10,Tajikistan,TJ,40,1,9321023,Asia,10137,79
2020-10-11,Tajikistan,TJ,43,0,9321023,Asia,10180,79
2020-10-12,Tajikistan,TJ,42,0,9321023,Asia,10222,79
2020-10-13,Tajikistan,TJ,38,0,9321023,Asia,10260,79
2020-10-14,Tajikistan,TJ,37,0,9321023,Asia,10297,79
2020-10-15,Tajikistan,TJ,39,0,9321023,Asia,10336,79
2020-10-16,Tajikistan,TJ,38,1,9321023,Asia,10374,80
2020-10-17,Tajikistan,TJ,40,0,9321023,Asia,10414,80
2020-10-18,Tajikistan,TJ,41,0,9321023,Asia,10455,80
2020-10-19,Tajikistan,TJ,38,0,9321023,Asia,10493,80
2020-10-20,Tajikistan,TJ,40,0,9321023,Asia,10533,80
2020-10-21,Tajikistan,TJ,41,0,9321023,Asia,10574,80
2020-10-22,Tajikistan,TJ,39,0,9321023,Asia,10613,80
2020-10-23,Tajikistan,TJ,40,1,9321023,Asia,10653,81
2020-10-24,Tajikistan,TJ,42,0,9321023,Asia,10695,81
2020-10-25,Tajikistan,TJ,41,0,9321023,Asia,10736,81
2020-10-26,Tajikistan,TJ,40,0,9321023,Asia,10776,81
2020-10-27,Tajikistan,TJ,43,0,9321023,Asia,10819,81
2020-10-28,Tajikistan,TJ,41,0,9321023,Asia,10860,81
2020-10-29,Tajikistan,TJ,40,1,9321023,Asia,10900,82
2020-10-30,Tajikistan,TJ,39,0,9321023,Asia,10939,82
2020-10-31,Tajikistan,TJ,38,0,9321023,Asia,10977,82
2020-11-01,Tajikistan,TJ,40,0,9321023,Asia,11017,82
2020-11-02,Tajikistan,TJ,37,0,9321023,Asia,11054,82
2020-11-03,Tajikistan,TJ,42,0,9321023,Asia,11096,82
2020-11-04,Tajikistan,TJ,43,1,9321023,Asia,11139,83
2020-11-05,Tajikistan,TJ,41,0,9321023,Asia,11180,83
2020-11-06,Tajikistan,TJ,39,0,9321023,Asia,11219,83
2020-11-07,Tajikistan,TJ,37,0,9321023,Asia,11256,83
2020-11-08,Tajikistan,TJ,0,0,9321023,Asia,11256,83
2020-11-09,Tajikistan,TJ,80,0,9321023,Asia,11336,83
2020-11-10,Tajikistan,TJ,40,0,9321023,Asia,11376,83
2020-11-11,Tajikistan,TJ,41,1,9321023,Asia,11417,84
2020-11-12,Tajikistan,TJ,39,0,9321023,Asia,11456,84
2020-11-13,Tajikistan,TJ,40,0,9321023,Asia,11496,84
2020-11-14,Tajikistan,TJ,38,1,9321023,Asia,11534,85
2020-11-15,Tajikistan,TJ,39,0,9321023,Asia,11573,85
2020-11-16,Tajikistan,TJ,37,0,9321023,Asia,11610,85
2020-11-17,Tajikistan,TJ,39,0,9321023,Asia,11649,85
2020-11-18,Tajikistan,TJ,40,0,9321023,Asia,11689,85
2020-11-19,Tajikistan,TJ,42,1,9321023,Asia,11731,86
2020-11-20,Tajikistan,TJ,41,0,9321023,Asia,11772,86
2020-11-21,Tajikistan,TJ,43,0,9321023,Asia,11815,86
2020-11-22,Tajikistan,TJ,39,0,9321023,Asia,11854,86
2020-11-23,Tajikistan,TJ,40,0,9321023,Asia,11894,86
2020-11-24,Tajikistan,TJ,38,0,9321023,Asia,11932,86
2020-11-25,Tajikistan,TJ,39,0,9321023,Asia,11971,86
2020-11-26,Tajikistan,TJ,37,0,9321023,Asia,12008,86
2020-11-27,Tajikistan,TJ,36,0,9321023,Asia,12044,86
2020-11-28,Tajikistan,TJ,38,0,9321023,Asia,12082,86
2020-11-29,Tajikistan,TJ,36,0,9321023,Asia,12118,86
2020-11-30,Tajikistan,TJ,37,0,9321023,Asia,12155,86
2020-12-01,Tajikistan,TJ,39,0,9321023,Asia,12194,86
2020-12-02,Tajikistan,TJ,37,0,9321023,Asia,12231,86
2020-12-03,Tajikistan,TJ,38,1,9321023,Asia,12269,87
2020-12-04,Tajikistan,TJ,39,0,9321023,Asia,12308,87
2020-12-05,Tajikistan,TJ,41,0,9321023,Asia,12349,87
2020-12-06,Tajikistan,TJ,40,0,9321023,Asia,12389,87
2020-12-07,Tajikistan,TJ,39,0,9321023,Asia,12428,87
2020-12-08,Tajikistan,TJ,41,0,9321023,Asia,12469,87
2020-12-09,Tajikistan,TJ,42,1,9321023,Asia,12511,88
2020-12-10,Tajikistan,TJ,40,0,9321023,Asia,12551,88
2020-12-11,Tajikistan,TJ,37,0,9321023,Asia,12588,88
2020-12-12,Tajikistan,TJ,43,0,9321023,Asia,12631,88
2020-12-13,Tajikistan,TJ,35,0,9321023,Asia,12666,88
2020-12-14,Tajikistan,TJ,38,0,9321023,Asia,12704,88
2020-03-22,Timor_Leste,TL,1,0,1293120,Asia,1,0
2020-03-23,Timor_Leste,TL,0,0,1293120,Asia,1,0
2020-03-24,Timor_Leste,TL,0,0,1293120,Asia,1,0
2020-03-25,Timor_Leste,TL,0,0,1293120,Asia,1,0
2020-03-26,Timor_Leste,TL,0,0,1293120,Asia,1,0
2020-03-27,Timor_Leste,TL,0,0,1293120,Asia,1,0
2020-03-28,Timor_Leste,TL,0,0,1293120,Asia,1,0
2020-03-29,Timor_Leste,TL,0,0,1293120,Asia,1,0
2020-03-30,Timor_Leste,TL,0,0,1293120,Asia,1,0
2020-03-31,Timor_Leste,TL,0,0,1293120,Asia,1,0
2020-04-01,Timor_Leste,TL,0,0,1293120,Asia,1,0
2020-04-02,Timor_Leste,TL,0,0,1293120,Asia,1,0
2020-04-03,Timor_Leste,TL,0,0,1293120,Asia,1,0
2020-04-04,Timor_Leste,TL,0,0,1293120,Asia,1,0
2020-04-05,Timor_Leste,TL,0,0,1293120,Asia,1,0
2020-04-06,Timor_Leste,TL,0,0,1293120,Asia,1,0
2020-04-07,Timor_Leste,TL,0,0,1293120,Asia,1,0
2020-04-08,Timor_Leste,TL,0,0,1293120,Asia,1,0
2020-04-09,Timor_Leste,TL,0,0,1293120,Asia,1,0
2020-04-10,Timor_Leste,TL,1,0,1293120,Asia,2,0
2020-04-11,Timor_Leste,TL,0,0,1293120,Asia,2,0
2020-04-12,Timor_Leste,TL,0,0,1293120,Asia,2,0
2020-04-13,Timor_Leste,TL,0,0,1293120,Asia,2,0
2020-04-14,Timor_Leste,TL,2,0,1293120,Asia,4,0
2020-04-15,Timor_Leste,TL,2,0,1293120,Asia,6,0
2020-04-16,Timor_Leste,TL,0,0,1293120,Asia,6,0
2020-04-17,Timor_Leste,TL,12,0,1293120,Asia,18,0
2020-04-18,Timor_Leste,TL,0,0,1293120,Asia,18,0
2020-04-19,Timor_Leste,TL,0,0,1293120,Asia,18,0
2020-04-20,Timor_Leste,TL,1,0,1293120,Asia,19,0
2020-04-21,Timor_Leste,TL,3,0,1293120,Asia,22,0
2020-04-22,Timor_Leste,TL,1,0,1293120,Asia,23,0
2020-04-23,Timor_Leste,TL,0,0,1293120,Asia,23,0
2020-04-24,Timor_Leste,TL,0,0,1293120,Asia,23,0
2020-04-25,Timor_Leste,TL,1,0,1293120,Asia,24,0
2020-04-26,Timor_Leste,TL,0,0,1293120,Asia,24,0
2020-04-27,Timor_Leste,TL,0,0,1293120,Asia,24,0
2020-04-28,Timor_Leste,TL,0,0,1293120,Asia,24,0
2020-04-29,Timor_Leste,TL,0,0,1293120,Asia,24,0
2020-04-30,Timor_Leste,TL,0,0,1293120,Asia,24,0
2020-05-01,Timor_Leste,TL,0,0,1293120,Asia,24,0
2020-05-02,Timor_Leste,TL,0,0,1293120,Asia,24,0
2020-05-03,Timor_Leste,TL,0,0,1293120,Asia,24,0
2020-05-04,Timor_Leste,TL,0,0,1293120,Asia,24,0
2020-05-05,Timor_Leste,TL,0,0,1293120,Asia,24,0
2020-05-06,Timor_Leste,TL,0,0,1293120,Asia,24,0
2020-05-07,Timor_Leste,TL,0,0,1293120,Asia,24,0
2020-05-08,Timor_Leste,TL,0,0,1293120,Asia,24,0
2020-05-09,Timor_Leste,TL,0,0,1293120,Asia,24,0
2020-05-10,Timor_Leste,TL,0,0,1293120,Asia,24,0
2020-05-11,Timor_Leste,TL,0,0,1293120,Asia,24,0
2020-05-12,Timor_Leste,TL,0,0,1293120,Asia,24,0
2020-05-13,Timor_Leste,TL,0,0,1293120,Asia,24,0
2020-05-14,Timor_Leste,TL,0,0,1293120,Asia,24,0
2020-05-15,Timor_Leste,TL,0,0,1293120,Asia,24,0
2020-05-16,Timor_Leste,TL,0,0,1293120,Asia,24,0
2020-05-17,Timor_Leste,TL,0,0,1293120,Asia,24,0
2020-05-18,Timor_Leste,TL,0,0,1293120,Asia,24,0
2020-05-19,Timor_Leste,TL,0,0,1293120,Asia,24,0
2020-05-20,Timor_Leste,TL,0,0,1293120,Asia,24,0
2020-05-21,Timor_Leste,TL,0,0,1293120,Asia,24,0
2020-05-22,Timor_Leste,TL,0,0,1293120,Asia,24,0
2020-05-23,Timor_Leste,TL,0,0,1293120,Asia,24,0
2020-05-24,Timor_Leste,TL,0,0,1293120,Asia,24,0
2020-05-25,Timor_Leste,TL,0,0,1293120,Asia,24,0
2020-05-26,Timor_Leste,TL,0,0,1293120,Asia,24,0
2020-05-27,Timor_Leste,TL,0,0,1293120,Asia,24,0
2020-05-28,Timor_Leste,TL,0,0,1293120,Asia,24,0
2020-05-29,Timor_Leste,TL,0,0,1293120,Asia,24,0
2020-05-30,Timor_Leste,TL,0,0,1293120,Asia,24,0
2020-05-31,Timor_Leste,TL,0,0,1293120,Asia,24,0
2020-06-01,Timor_Leste,TL,0,0,1293120,Asia,24,0
2020-06-02,Timor_Leste,TL,0,0,1293120,Asia,24,0
2020-06-03,Timor_Leste,TL,0,0,1293120,Asia,24,0
2020-06-04,Timor_Leste,TL,0,0,1293120,Asia,24,0
2020-06-05,Timor_Leste,TL,0,0,1293120,Asia,24,0
2020-06-06,Timor_Leste,TL,0,0,1293120,Asia,24,0
2020-06-07,Timor_Leste,TL,0,0,1293120,Asia,24,0
2020-06-08,Timor_Leste,TL,0,0,1293120,Asia,24,0
2020-06-09,Timor_Leste,TL,0,0,1293120,Asia,24,0
2020-06-10,Timor_Leste,TL,0,0,1293120,Asia,24,0
2020-06-11,Timor_Leste,TL,0,0,1293120,Asia,24,0
2020-06-12,Timor_Leste,TL,0,0,1293120,Asia,24,0
2020-06-13,Timor_Leste,TL,0,0,1293120,Asia,24,0
2020-06-14,Timor_Leste,TL,0,0,1293120,Asia,24,0
2020-06-15,Timor_Leste,TL,0,0,1293120,Asia,24,0
2020-06-16,Timor_Leste,TL,0,0,1293120,Asia,24,0
2020-06-17,Timor_Leste,TL,0,0,1293120,Asia,24,0
2020-06-18,Timor_Leste,TL,0,0,1293120,Asia,24,0
2020-06-19,Timor_Leste,TL,0,0,1293120,Asia,24,0
2020-06-20,Timor_Leste,TL,0,0,1293120,Asia,24,0
2020-06-21,Timor_Leste,TL,0,0,1293120,Asia,24,0
2020-06-22,Timor_Leste,TL,0,0,1293120,Asia,24,0
2020-06-23,Timor_Leste,TL,0,0,1293120,Asia,24,0
2020-06-24,Timor_Leste,TL,0,0,1293120,Asia,24,0
2020-06-25,Timor_Leste,TL,0,0,1293120,Asia,24,0
2020-06-26,Timor_Leste,TL,0,0,1293120,Asia,24,0
2020-06-27,Timor_Leste,TL,0,0,1293120,Asia,24,0
2020-06-28,Timor_Leste,TL,0,0,1293120,Asia,24,0
2020-06-29,Timor_Leste,TL,0,0,1293120,Asia,24,0
2020-06-30,Timor_Leste,TL,0,0,1293120,Asia,24,0
2020-07-01,Timor_Leste,TL,0,0,1293120,Asia,24,0
2020-07-02,Timor_Leste,TL,0,0,1293120,Asia,24,0
2020-07-03,Timor_Leste,TL,0,0,1293120,Asia,24,0
2020-07-04,Timor_Leste,TL,0,0,1293120,Asia,24,0
2020-07-05,Timor_Leste,TL,0,0,1293120,Asia,24,0
2020-07-06,Timor_Leste,TL,0,0,1293120,Asia,24,0
2020-07-07,Timor_Leste,TL,0,0,1293120,Asia,24,0
2020-07-08,Timor_Leste,TL,0,0,1293120,Asia,24,0
2020-07-09,Timor_Leste,TL,0,0,1293120,Asia,24,0
2020-07-10,Timor_Leste,TL,0,0,1293120,Asia,24,0
2020-07-11,Timor_Leste,TL,0,0,1293120,Asia,24,0
2020-07-12,Timor_Leste,TL,0,0,1293120,Asia,24,0
2020-07-13,Timor_Leste,TL,0,0,1293120,Asia,24,0
2020-07-14,Timor_Leste,TL,0,0,1293120,Asia,24,0
2020-07-15,Timor_Leste,TL,0,0,1293120,Asia,24,0
2020-07-16,Timor_Leste,TL,0,0,1293120,Asia,24,0
2020-07-17,Timor_Leste,TL,0,0,1293120,Asia,24,0
2020-07-18,Timor_Leste,TL,0,0,1293120,Asia,24,0
2020-07-19,Timor_Leste,TL,0,0,1293120,Asia,24,0
2020-07-20,Timor_Leste,TL,0,0,1293120,Asia,24,0
2020-07-21,Timor_Leste,TL,0,0,1293120,Asia,24,0
2020-07-22,Timor_Leste,TL,0,0,1293120,Asia,24,0
2020-07-23,Timor_Leste,TL,0,0,1293120,Asia,24,0
2020-07-24,Timor_Leste,TL,0,0,1293120,Asia,24,0
2020-07-25,Timor_Leste,TL,0,0,1293120,Asia,24,0
2020-07-26,Timor_Leste,TL,0,0,1293120,Asia,24,0
2020-07-27,Timor_Leste,TL,0,0,1293120,Asia,24,0
2020-07-28,Timor_Leste,TL,0,0,1293120,Asia,24,0
2020-07-29,Timor_Leste,TL,0,0,1293120,Asia,24,0
2020-07-30,Timor_Leste,TL,0,0,1293120,Asia,24,0
2020-07-31,Timor_Leste,TL,0,0,1293120,Asia,24,0
2020-08-01,Timor_Leste,TL,0,0,1293120,Asia,24,0
2020-08-02,Timor_Leste,TL,0,0,1293120,Asia,24,0
2020-08-03,Timor_Leste,TL,0,0,1293120,Asia,24,0
2020-08-04,Timor_Leste,TL,0,0,1293120,Asia,24,0
2020-08-05,Timor_Leste,TL,1,0,1293120,Asia,25,0
2020-08-06,Timor_Leste,TL,0,0,1293120,Asia,25,0
2020-08-07,Timor_Leste,TL,0,0,1293120,Asia,25,0
2020-08-08,Timor_Leste,TL,0,0,1293120,Asia,25,0
2020-08-09,Timor_Leste,TL,0,0,1293120,Asia,25,0
2020-08-10,Timor_Leste,TL,0,0,1293120,Asia,25,0
2020-08-11,Timor_Leste,TL,0,0,1293120,Asia,25,0
2020-08-12,Timor_Leste,TL,0,0,1293120,Asia,25,0
2020-08-13,Timor_Leste,TL,0,0,1293120,Asia,25,0
2020-08-14,Timor_Leste,TL,0,0,1293120,Asia,25,0
2020-08-15,Timor_Leste,TL,0,0,1293120,Asia,25,0
2020-08-16,Timor_Leste,TL,0,0,1293120,Asia,25,0
2020-08-17,Timor_Leste,TL,0,0,1293120,Asia,25,0
2020-08-18,Timor_Leste,TL,0,0,1293120,Asia,25,0
2020-08-19,Timor_Leste,TL,0,0,1293120,Asia,25,0
2020-08-20,Timor_Leste,TL,0,0,1293120,Asia,25,0
2020-08-21,Timor_Leste,TL,1,0,1293120,Asia,26,0
2020-08-22,Timor_Leste,TL,0,0,1293120,Asia,26,0
2020-08-23,Timor_Leste,TL,0,0,1293120,Asia,26,0
2020-08-24,Timor_Leste,TL,0,0,1293120,Asia,26,0
2020-08-25,Timor_Leste,TL,0,0,1293120,Asia,26,0
2020-08-26,Timor_Leste,TL,0,0,1293120,Asia,26,0
2020-08-27,Timor_Leste,TL,1,0,1293120,Asia,27,0
2020-08-28,Timor_Leste,TL,0,0,1293120,Asia,27,0
2020-08-29,Timor_Leste,TL,0,0,1293120,Asia,27,0
2020-08-30,Timor_Leste,TL,0,0,1293120,Asia,27,0
2020-08-31,Timor_Leste,TL,0,0,1293120,Asia,27,0
2020-09-01,Timor_Leste,TL,0,0,1293120,Asia,27,0
2020-09-02,Timor_Leste,TL,0,0,1293120,Asia,27,0
2020-09-03,Timor_Leste,TL,0,0,1293120,Asia,27,0
2020-09-04,Timor_Leste,TL,0,0,1293120,Asia,27,0
2020-09-05,Timor_Leste,TL,0,0,1293120,Asia,27,0
2020-09-06,Timor_Leste,TL,0,0,1293120,Asia,27,0
2020-09-07,Timor_Leste,TL,0,0,1293120,Asia,27,0
2020-09-08,Timor_Leste,TL,0,0,1293120,Asia,27,0
2020-09-09,Timor_Leste,TL,0,0,1293120,Asia,27,0
2020-09-10,Timor_Leste,TL,0,0,1293120,Asia,27,0
2020-09-11,Timor_Leste,TL,0,0,1293120,Asia,27,0
2020-09-12,Timor_Leste,TL,0,0,1293120,Asia,27,0
2020-09-13,Timor_Leste,TL,0,0,1293120,Asia,27,0
2020-09-14,Timor_Leste,TL,0,0,1293120,Asia,27,0
2020-09-15,Timor_Leste,TL,0,0,1293120,Asia,27,0
2020-09-16,Timor_Leste,TL,0,0,1293120,Asia,27,0
2020-09-17,Timor_Leste,TL,0,0,1293120,Asia,27,0
2020-09-18,Timor_Leste,TL,0,0,1293120,Asia,27,0
2020-09-19,Timor_Leste,TL,0,0,1293120,Asia,27,0
2020-09-20,Timor_Leste,TL,0,0,1293120,Asia,27,0
2020-09-21,Timor_Leste,TL,0,0,1293120,Asia,27,0
2020-09-22,Timor_Leste,TL,0,0,1293120,Asia,27,0
2020-09-23,Timor_Leste,TL,0,0,1293120,Asia,27,0
2020-09-24,Timor_Leste,TL,0,0,1293120,Asia,27,0
2020-09-25,Timor_Leste,TL,0,0,1293120,Asia,27,0
2020-09-26,Timor_Leste,TL,0,0,1293120,Asia,27,0
2020-09-27,Timor_Leste,TL,0,0,1293120,Asia,27,0
2020-09-28,Timor_Leste,TL,0,0,1293120,Asia,27,0
2020-09-29,Timor_Leste,TL,1,0,1293120,Asia,28,0
2020-09-30,Timor_Leste,TL,0,0,1293120,Asia,28,0
2020-10-01,Timor_Leste,TL,0,0,1293120,Asia,28,0
2020-10-02,Timor_Leste,TL,0,0,1293120,Asia,28,0
2020-10-03,Timor_Leste,TL,0,0,1293120,Asia,28,0
2020-10-04,Timor_Leste,TL,0,0,1293120,Asia,28,0
2020-10-05,Timor_Leste,TL,0,0,1293120,Asia,28,0
2020-10-06,Timor_Leste,TL,0,0,1293120,Asia,28,0
2020-10-07,Timor_Leste,TL,0,0,1293120,Asia,28,0
2020-10-08,Timor_Leste,TL,0,0,1293120,Asia,28,0
2020-10-09,Timor_Leste,TL,0,0,1293120,Asia,28,0
2020-10-10,Timor_Leste,TL,0,0,1293120,Asia,28,0
2020-10-11,Timor_Leste,TL,0,0,1293120,Asia,28,0
2020-10-12,Timor_Leste,TL,0,0,1293120,Asia,28,0
2020-10-13,Timor_Leste,TL,1,0,1293120,Asia,29,0
2020-10-14,Timor_Leste,TL,0,0,1293120,Asia,29,0
2020-10-15,Timor_Leste,TL,0,0,1293120,Asia,29,0
2020-10-16,Timor_Leste,TL,0,0,1293120,Asia,29,0
2020-10-17,Timor_Leste,TL,0,0,1293120,Asia,29,0
2020-10-18,Timor_Leste,TL,0,0,1293120,Asia,29,0
2020-10-19,Timor_Leste,TL,0,0,1293120,Asia,29,0
2020-10-20,Timor_Leste,TL,0,0,1293120,Asia,29,0
2020-10-21,Timor_Leste,TL,0,0,1293120,Asia,29,0
2020-10-22,Timor_Leste,TL,0,0,1293120,Asia,29,0
2020-10-23,Timor_Leste,TL,0,0,1293120,Asia,29,0
2020-10-24,Timor_Leste,TL,0,0,1293120,Asia,29,0
2020-10-25,Timor_Leste,TL,0,0,1293120,Asia,29,0
2020-10-26,Timor_Leste,TL,0,0,1293120,Asia,29,0
2020-10-27,Timor_Leste,TL,1,0,1293120,Asia,30,0
2020-10-28,Timor_Leste,TL,0,0,1293120,Asia,30,0
2020-10-29,Timor_Leste,TL,0,0,1293120,Asia,30,0
2020-10-30,Timor_Leste,TL,0,0,1293120,Asia,30,0
2020-10-31,Timor_Leste,TL,0,0,1293120,Asia,30,0
2020-11-01,Timor_Leste,TL,0,0,1293120,Asia,30,0
2020-11-02,Timor_Leste,TL,0,0,1293120,Asia,30,0
2020-11-03,Timor_Leste,TL,0,0,1293120,Asia,30,0
2020-11-04,Timor_Leste,TL,0,0,1293120,Asia,30,0
2020-11-05,Timor_Leste,TL,0,0,1293120,Asia,30,0
2020-11-06,Timor_Leste,TL,0,0,1293120,Asia,30,0
2020-11-07,Timor_Leste,TL,0,0,1293120,Asia,30,0
2020-11-08,Timor_Leste,TL,0,0,1293120,Asia,30,0
2020-11-09,Timor_Leste,TL,0,0,1293120,Asia,30,0
2020-11-10,Timor_Leste,TL,0,0,1293120,Asia,30,0
2020-11-11,Timor_Leste,TL,0,0,1293120,Asia,30,0
2020-11-12,Timor_Leste,TL,0,0,1293120,Asia,30,0
2020-11-13,Timor_Leste,TL,0,0,1293120,Asia,30,0
2020-11-14,Timor_Leste,TL,0,0,1293120,Asia,30,0
2020-11-15,Timor_Leste,TL,0,0,1293120,Asia,30,0
2020-11-16,Timor_Leste,TL,0,0,1293120,Asia,30,0
2020-11-17,Timor_Leste,TL,0,0,1293120,Asia,30,0
2020-11-18,Timor_Leste,TL,0,0,1293120,Asia,30,0
2020-11-19,Timor_Leste,TL,0,0,1293120,Asia,30,0
2020-11-20,Timor_Leste,TL,0,0,1293120,Asia,30,0
2020-11-21,Timor_Leste,TL,0,0,1293120,Asia,30,0
2020-11-22,Timor_Leste,TL,0,0,1293120,Asia,30,0
2020-11-23,Timor_Leste,TL,0,0,1293120,Asia,30,0
2020-11-24,Timor_Leste,TL,0,0,1293120,Asia,30,0
2020-11-25,Timor_Leste,TL,0,0,1293120,Asia,30,0
2020-11-26,Timor_Leste,TL,0,0,1293120,Asia,30,0
2020-11-27,Timor_Leste,TL,0,0,1293120,Asia,30,0
2020-11-28,Timor_Leste,TL,0,0,1293120,Asia,30,0
2020-11-29,Timor_Leste,TL,0,0,1293120,Asia,30,0
2020-11-30,Timor_Leste,TL,0,0,1293120,Asia,30,0
2020-12-01,Timor_Leste,TL,0,0,1293120,Asia,30,0
2020-12-02,Timor_Leste,TL,0,0,1293120,Asia,30,0
2020-12-03,Timor_Leste,TL,1,0,1293120,Asia,31,0
2020-12-04,Timor_Leste,TL,0,0,1293120,Asia,31,0
2020-12-05,Timor_Leste,TL,0,0,1293120,Asia,31,0
2020-12-06,Timor_Leste,TL,0,0,1293120,Asia,31,0
2020-12-07,Timor_Leste,TL,0,0,1293120,Asia,31,0
2020-12-08,Timor_Leste,TL,0,0,1293120,Asia,31,0
2020-12-09,Timor_Leste,TL,0,0,1293120,Asia,31,0
2020-12-10,Timor_Leste,TL,0,0,1293120,Asia,31,0
2020-12-11,Timor_Leste,TL,0,0,1293120,Asia,31,0
2020-12-12,Timor_Leste,TL,0,0,1293120,Asia,31,0
2020-12-13,Timor_Leste,TL,0,0,1293120,Asia,31,0
2020-12-14,Timor_Leste,TL,0,0,1293120,Asia,31,0
2020-03-03,Tunisia,TN,1,0,11694721,Africa,1,0
2020-03-10,Tunisia,TN,1,0,11694721,Africa,2,0
2020-03-11,Tunisia,TN,3,0,11694721,Africa,5,0
2020-03-12,Tunisia,TN,2,0,11694721,Africa,7,0
2020-03-13,Tunisia,TN,6,0,11694721,Africa,13,0
2020-03-14,Tunisia,TN,3,0,11694721,Africa,16,0
2020-03-15,Tunisia,TN,0,0,11694721,Africa,16,0
2020-03-16,Tunisia,TN,2,0,11694721,Africa,18,0
2020-03-17,Tunisia,TN,2,0,11694721,Africa,20,0
2020-03-18,Tunisia,TN,4,0,11694721,Africa,24,0
2020-03-19,Tunisia,TN,5,0,11694721,Africa,29,0
2020-03-20,Tunisia,TN,10,0,11694721,Africa,39,0
2020-03-21,Tunisia,TN,15,1,11694721,Africa,54,1
2020-03-22,Tunisia,TN,6,0,11694721,Africa,60,1
2020-03-23,Tunisia,TN,15,2,11694721,Africa,75,3
2020-03-24,Tunisia,TN,14,0,11694721,Africa,89,3
2020-03-25,Tunisia,TN,25,0,11694721,Africa,114,3
2020-03-26,Tunisia,TN,59,2,11694721,Africa,173,5
2020-03-27,Tunisia,TN,0,0,11694721,Africa,173,5
2020-03-28,Tunisia,TN,54,1,11694721,Africa,227,6
2020-03-29,Tunisia,TN,0,0,11694721,Africa,227,6
2020-03-30,Tunisia,TN,51,2,11694721,Africa,278,8
2020-03-31,Tunisia,TN,34,0,11694721,Africa,312,8
2020-04-01,Tunisia,TN,50,1,11694721,Africa,362,9
2020-04-02,Tunisia,TN,32,1,11694721,Africa,394,10
2020-04-03,Tunisia,TN,61,3,11694721,Africa,455,13
2020-04-04,Tunisia,TN,0,0,11694721,Africa,455,13
2020-04-05,Tunisia,TN,40,5,11694721,Africa,495,18
2020-04-06,Tunisia,TN,58,1,11694721,Africa,553,19
2020-04-07,Tunisia,TN,21,3,11694721,Africa,574,22
2020-04-08,Tunisia,TN,22,0,11694721,Africa,596,22
2020-04-09,Tunisia,TN,27,1,11694721,Africa,623,23
2020-04-10,Tunisia,TN,20,2,11694721,Africa,643,25
2020-04-11,Tunisia,TN,28,0,11694721,Africa,671,25
2020-04-12,Tunisia,TN,14,3,11694721,Africa,685,28
2020-04-13,Tunisia,TN,22,3,11694721,Africa,707,31
2020-04-14,Tunisia,TN,19,3,11694721,Africa,726,34
2020-04-15,Tunisia,TN,21,0,11694721,Africa,747,34
2020-04-16,Tunisia,TN,33,1,11694721,Africa,780,35
2020-04-17,Tunisia,TN,42,2,11694721,Africa,822,37
2020-04-18,Tunisia,TN,42,0,11694721,Africa,864,37
2020-04-19,Tunisia,TN,2,0,11694721,Africa,866,37
2020-04-20,Tunisia,TN,13,1,11694721,Africa,879,38
2020-04-21,Tunisia,TN,5,0,11694721,Africa,884,38
2020-04-22,Tunisia,TN,17,0,11694721,Africa,901,38
2020-04-23,Tunisia,TN,0,0,11694721,Africa,901,38
2020-04-24,Tunisia,TN,17,0,11694721,Africa,918,38
2020-04-25,Tunisia,TN,4,0,11694721,Africa,922,38
2020-04-26,Tunisia,TN,17,0,11694721,Africa,939,38
2020-04-27,Tunisia,TN,10,0,11694721,Africa,949,38
2020-04-28,Tunisia,TN,18,1,11694721,Africa,967,39
2020-04-29,Tunisia,TN,8,1,11694721,Africa,975,40
2020-04-30,Tunisia,TN,5,0,11694721,Africa,980,40
2020-05-01,Tunisia,TN,14,0,11694721,Africa,994,40
2020-05-02,Tunisia,TN,4,1,11694721,Africa,998,41
2020-05-03,Tunisia,TN,11,1,11694721,Africa,1009,42
2020-05-04,Tunisia,TN,4,0,11694721,Africa,1013,42
2020-05-05,Tunisia,TN,5,1,11694721,Africa,1018,43
2020-05-06,Tunisia,TN,4,0,11694721,Africa,1022,43
2020-05-07,Tunisia,TN,3,0,11694721,Africa,1025,43
2020-05-08,Tunisia,TN,1,1,11694721,Africa,1026,44
2020-05-09,Tunisia,TN,4,1,11694721,Africa,1030,45
2020-05-10,Tunisia,TN,2,0,11694721,Africa,1032,45
2020-05-11,Tunisia,TN,0,0,11694721,Africa,1032,45
2020-05-12,Tunisia,TN,0,0,11694721,Africa,1032,45
2020-05-13,Tunisia,TN,0,0,11694721,Africa,1032,45
2020-05-14,Tunisia,TN,0,0,11694721,Africa,1032,45
2020-05-15,Tunisia,TN,0,0,11694721,Africa,1032,45
2020-05-16,Tunisia,TN,3,0,11694721,Africa,1035,45
2020-05-17,Tunisia,TN,0,0,11694721,Africa,1035,45
2020-05-18,Tunisia,TN,2,0,11694721,Africa,1037,45
2020-05-19,Tunisia,TN,6,1,11694721,Africa,1043,46
2020-05-20,Tunisia,TN,1,1,11694721,Africa,1044,47
2020-05-21,Tunisia,TN,1,0,11694721,Africa,1045,47
2020-05-22,Tunisia,TN,1,0,11694721,Africa,1046,47
2020-05-23,Tunisia,TN,2,0,11694721,Africa,1048,47
2020-05-24,Tunisia,TN,0,1,11694721,Africa,1048,48
2020-05-25,Tunisia,TN,3,0,11694721,Africa,1051,48
2020-05-26,Tunisia,TN,0,0,11694721,Africa,1051,48
2020-05-27,Tunisia,TN,0,0,11694721,Africa,1051,48
2020-05-28,Tunisia,TN,0,0,11694721,Africa,1051,48
2020-05-29,Tunisia,TN,17,0,11694721,Africa,1068,48
2020-05-30,Tunisia,TN,3,0,11694721,Africa,1071,48
2020-05-31,Tunisia,TN,5,0,11694721,Africa,1076,48
2020-06-01,Tunisia,TN,1,0,11694721,Africa,1077,48
2020-06-02,Tunisia,TN,7,0,11694721,Africa,1084,48
2020-06-03,Tunisia,TN,2,0,11694721,Africa,1086,48
2020-06-04,Tunisia,TN,1,1,11694721,Africa,1087,49
2020-06-05,Tunisia,TN,0,0,11694721,Africa,1087,49
2020-06-06,Tunisia,TN,0,0,11694721,Africa,1087,49
2020-06-07,Tunisia,TN,0,0,11694721,Africa,1087,49
2020-06-08,Tunisia,TN,0,0,11694721,Africa,1087,49
2020-06-09,Tunisia,TN,0,0,11694721,Africa,1087,49
2020-06-10,Tunisia,TN,0,0,11694721,Africa,1087,49
2020-06-11,Tunisia,TN,0,0,11694721,Africa,1087,49
2020-06-12,Tunisia,TN,0,0,11694721,Africa,1087,49
2020-06-13,Tunisia,TN,6,0,11694721,Africa,1093,49
2020-06-14,Tunisia,TN,1,0,11694721,Africa,1094,49
2020-06-15,Tunisia,TN,2,0,11694721,Africa,1096,49
2020-06-16,Tunisia,TN,14,0,11694721,Africa,1110,49
2020-06-17,Tunisia,TN,15,0,11694721,Africa,1125,49
2020-06-18,Tunisia,TN,3,1,11694721,Africa,1128,50
2020-06-19,Tunisia,TN,4,0,11694721,Africa,1132,50
2020-06-20,Tunisia,TN,14,0,11694721,Africa,1146,50
2020-06-21,Tunisia,TN,10,0,11694721,Africa,1156,50
2020-06-22,Tunisia,TN,1,0,11694721,Africa,1157,50
2020-06-23,Tunisia,TN,2,0,11694721,Africa,1159,50
2020-06-24,Tunisia,TN,0,0,11694721,Africa,1159,50
2020-06-25,Tunisia,TN,1,0,11694721,Africa,1160,50
2020-06-26,Tunisia,TN,2,0,11694721,Africa,1162,50
2020-06-27,Tunisia,TN,2,0,11694721,Africa,1164,50
2020-06-28,Tunisia,TN,4,0,11694721,Africa,1168,50
2020-06-29,Tunisia,TN,1,0,11694721,Africa,1169,50
2020-06-30,Tunisia,TN,3,0,11694721,Africa,1172,50
2020-07-01,Tunisia,TN,2,0,11694721,Africa,1174,50
2020-07-02,Tunisia,TN,1,0,11694721,Africa,1175,50
2020-07-03,Tunisia,TN,3,0,11694721,Africa,1178,50
2020-07-04,Tunisia,TN,3,0,11694721,Africa,1181,50
2020-07-05,Tunisia,TN,5,0,11694721,Africa,1186,50
2020-07-06,Tunisia,TN,2,0,11694721,Africa,1188,50
2020-07-07,Tunisia,TN,11,0,11694721,Africa,1199,50
2020-07-08,Tunisia,TN,6,0,11694721,Africa,1205,50
2020-07-09,Tunisia,TN,16,0,11694721,Africa,1221,50
2020-07-10,Tunisia,TN,10,0,11694721,Africa,1231,50
2020-07-11,Tunisia,TN,9,0,11694721,Africa,1240,50
2020-07-12,Tunisia,TN,5,0,11694721,Africa,1245,50
2020-07-13,Tunisia,TN,18,0,11694721,Africa,1263,50
2020-07-14,Tunisia,TN,39,0,11694721,Africa,1302,50
2020-07-15,Tunisia,TN,4,0,11694721,Africa,1306,50
2020-07-16,Tunisia,TN,13,0,11694721,Africa,1319,50
2020-07-17,Tunisia,TN,8,0,11694721,Africa,1327,50
2020-07-18,Tunisia,TN,9,0,11694721,Africa,1336,50
2020-07-19,Tunisia,TN,12,0,11694721,Africa,1348,50
2020-07-20,Tunisia,TN,26,0,11694721,Africa,1374,50
2020-07-21,Tunisia,TN,7,0,11694721,Africa,1381,50
2020-07-22,Tunisia,TN,8,0,11694721,Africa,1389,50
2020-07-23,Tunisia,TN,5,0,11694721,Africa,1394,50
2020-07-24,Tunisia,TN,12,0,11694721,Africa,1406,50
2020-07-25,Tunisia,TN,19,0,11694721,Africa,1425,50
2020-07-26,Tunisia,TN,18,0,11694721,Africa,1443,50
2020-07-27,Tunisia,TN,9,0,11694721,Africa,1452,50
2020-07-28,Tunisia,TN,3,0,11694721,Africa,1455,50
2020-07-29,Tunisia,TN,13,0,11694721,Africa,1468,50
2020-07-30,Tunisia,TN,20,0,11694721,Africa,1488,50
2020-07-31,Tunisia,TN,26,0,11694721,Africa,1514,50
2020-08-01,Tunisia,TN,21,0,11694721,Africa,1535,50
2020-08-02,Tunisia,TN,17,1,11694721,Africa,1552,51
2020-08-03,Tunisia,TN,9,0,11694721,Africa,1561,51
2020-08-04,Tunisia,TN,4,0,11694721,Africa,1565,51
2020-08-05,Tunisia,TN,19,0,11694721,Africa,1584,51
2020-08-06,Tunisia,TN,17,0,11694721,Africa,1601,51
2020-08-07,Tunisia,TN,41,0,11694721,Africa,1642,51
2020-08-08,Tunisia,TN,14,0,11694721,Africa,1656,51
2020-08-09,Tunisia,TN,22,0,11694721,Africa,1678,51
2020-08-10,Tunisia,TN,19,0,11694721,Africa,1697,51
2020-08-11,Tunisia,TN,20,0,11694721,Africa,1717,51
2020-08-12,Tunisia,TN,21,1,11694721,Africa,1738,52
2020-08-13,Tunisia,TN,42,0,11694721,Africa,1780,52
2020-08-14,Tunisia,TN,67,1,11694721,Africa,1847,53
2020-08-15,Tunisia,TN,56,0,11694721,Africa,1903,53
2020-08-16,Tunisia,TN,120,1,11694721,Africa,2023,54
2020-08-17,Tunisia,TN,84,0,11694721,Africa,2107,54
2020-08-18,Tunisia,TN,78,2,11694721,Africa,2185,56
2020-08-19,Tunisia,TN,0,0,11694721,Africa,2185,56
2020-08-20,Tunisia,TN,242,4,11694721,Africa,2427,60
2020-08-21,Tunisia,TN,116,3,11694721,Africa,2543,63
2020-08-22,Tunisia,TN,64,1,11694721,Africa,2607,64
2020-08-23,Tunisia,TN,131,4,11694721,Africa,2738,68
2020-08-24,Tunisia,TN,0,0,11694721,Africa,2738,68
2020-08-25,Tunisia,TN,155,3,11694721,Africa,2893,71
2020-08-26,Tunisia,TN,176,0,11694721,Africa,3069,71
2020-08-27,Tunisia,TN,137,0,11694721,Africa,3206,71
2020-08-28,Tunisia,TN,117,2,11694721,Africa,3323,73
2020-08-29,Tunisia,TN,138,1,11694721,Africa,3461,74
2020-08-30,Tunisia,TN,111,2,11694721,Africa,3572,76
2020-08-31,Tunisia,TN,113,0,11694721,Africa,3685,76
2020-09-01,Tunisia,TN,118,1,11694721,Africa,3803,77
2020-09-02,Tunisia,TN,0,0,11694721,Africa,3803,77
2020-09-03,Tunisia,TN,393,4,11694721,Africa,4196,81
2020-09-04,Tunisia,TN,198,3,11694721,Africa,4394,84
2020-09-05,Tunisia,TN,0,0,11694721,Africa,4394,84
2020-09-06,Tunisia,TN,148,3,11694721,Africa,4542,87
2020-09-07,Tunisia,TN,234,6,11694721,Africa,4776,93
2020-09-08,Tunisia,TN,348,0,11694721,Africa,5124,93
2020-09-09,Tunisia,TN,293,3,11694721,Africa,5417,96
2020-09-10,Tunisia,TN,0,0,11694721,Africa,5417,96
2020-09-11,Tunisia,TN,465,3,11694721,Africa,5882,99
2020-09-12,Tunisia,TN,377,4,11694721,Africa,6259,103
2020-09-13,Tunisia,TN,376,4,11694721,Africa,6635,107
2020-09-14,Tunisia,TN,0,0,11694721,Africa,6635,107
2020-09-15,Tunisia,TN,747,10,11694721,Africa,7382,117
2020-09-16,Tunisia,TN,241,6,11694721,Africa,7623,123
2020-09-17,Tunisia,TN,477,6,11694721,Africa,8100,129
2020-09-18,Tunisia,TN,470,4,11694721,Africa,8570,133
2020-09-19,Tunisia,TN,0,0,11694721,Africa,8570,133
2020-09-20,Tunisia,TN,1166,22,11694721,Africa,9736,155
2020-09-21,Tunisia,TN,996,4,11694721,Africa,10732,159
2020-09-22,Tunisia,TN,528,5,11694721,Africa,11260,164
2020-09-23,Tunisia,TN,0,0,11694721,Africa,11260,164
2020-09-24,Tunisia,TN,1219,10,11694721,Africa,12479,174
2020-09-25,Tunisia,TN,826,6,11694721,Africa,13305,180
2020-09-26,Tunisia,TN,1087,11,11694721,Africa,14392,191
2020-09-27,Tunisia,TN,786,16,11694721,Africa,15178,207
2020-09-28,Tunisia,TN,936,7,11694721,Africa,16114,214
2020-09-29,Tunisia,TN,0,0,11694721,Africa,16114,214
2020-09-30,Tunisia,TN,1291,32,11694721,Africa,17405,246
2020-10-01,Tunisia,TN,1008,19,11694721,Africa,18413,265
2020-10-02,Tunisia,TN,0,0,11694721,Africa,18413,265
2020-10-03,Tunisia,TN,1308,6,11694721,Africa,19721,271
2020-10-04,Tunisia,TN,1223,5,11694721,Africa,20944,276
2020-10-05,Tunisia,TN,2509,45,11694721,Africa,23453,321
2020-10-06,Tunisia,TN,0,0,11694721,Africa,23453,321
2020-10-07,Tunisia,TN,0,0,11694721,Africa,23453,321
2020-10-08,Tunisia,TN,2312,43,11694721,Africa,25765,364
2020-10-09,Tunisia,TN,0,0,11694721,Africa,25765,364
2020-10-10,Tunisia,TN,2357,45,11694721,Africa,28122,409
2020-10-11,Tunisia,TN,3137,47,11694721,Africa,31259,456
2020-10-12,Tunisia,TN,0,0,11694721,Africa,31259,456
2020-10-13,Tunisia,TN,1297,22,11694721,Africa,32556,478
2020-10-14,Tunisia,TN,0,0,11694721,Africa,32556,478
2020-10-15,Tunisia,TN,2234,34,11694721,Africa,34790,512
2020-10-16,Tunisia,TN,0,0,11694721,Africa,34790,512
2020-10-17,Tunisia,TN,0,0,11694721,Africa,34790,512
2020-10-18,Tunisia,TN,5752,114,11694721,Africa,40542,626
2020-10-19,Tunisia,TN,0,0,11694721,Africa,40542,626
2020-10-20,Tunisia,TN,2185,61,11694721,Africa,42727,687
2020-10-21,Tunisia,TN,1723,24,11694721,Africa,44450,711
2020-10-22,Tunisia,TN,1442,29,11694721,Africa,45892,740
2020-10-23,Tunisia,TN,0,0,11694721,Africa,45892,740
2020-10-24,Tunisia,TN,1322,44,11694721,Africa,47214,784
2020-10-25,Tunisia,TN,1585,35,11694721,Africa,48799,819
2020-10-26,Tunisia,TN,0,0,11694721,Africa,48799,819
2020-10-27,Tunisia,TN,3600,164,11694721,Africa,52399,983
2020-10-28,Tunisia,TN,0,0,11694721,Africa,52399,983
2020-10-29,Tunisia,TN,1879,170,11694721,Africa,54278,1153
2020-10-30,Tunisia,TN,3751,100,11694721,Africa,58029,1253
2020-10-31,Tunisia,TN,1784,64,11694721,Africa,59813,1317
2020-11-01,Tunisia,TN,1302,31,11694721,Africa,61115,1348
2020-11-02,Tunisia,TN,791,33,11694721,Africa,61906,1381
2020-11-03,Tunisia,TN,0,0,11694721,Africa,61906,1381
2020-11-04,Tunisia,TN,1220,102,11694721,Africa,63126,1483
2020-11-05,Tunisia,TN,1237,29,11694721,Africa,64363,1512
2020-11-06,Tunisia,TN,1971,65,11694721,Africa,66334,1577
2020-11-07,Tunisia,TN,0,0,11694721,Africa,66334,1577
2020-11-08,Tunisia,TN,3209,217,11694721,Africa,69543,1794
2020-11-09,Tunisia,TN,1576,79,11694721,Africa,71119,1873
2020-11-10,Tunisia,TN,450,47,11694721,Africa,71569,1920
2020-11-11,Tunisia,TN,1424,86,11694721,Africa,72993,2006
2020-11-12,Tunisia,TN,1529,96,11694721,Africa,74522,2102
2020-11-13,Tunisia,TN,1584,49,11694721,Africa,76106,2151
2020-11-14,Tunisia,TN,1562,58,11694721,Africa,77668,2209
2020-11-15,Tunisia,TN,1671,70,11694721,Africa,79339,2279
2020-11-16,Tunisia,TN,1065,66,11694721,Africa,80404,2345
2020-11-17,Tunisia,TN,599,44,11694721,Africa,81003,2389
2020-11-18,Tunisia,TN,720,56,11694721,Africa,81723,2445
2020-11-19,Tunisia,TN,2049,96,11694721,Africa,83772,2541
2020-11-20,Tunisia,TN,1223,70,11694721,Africa,84995,2611
2020-11-21,Tunisia,TN,1270,73,11694721,Africa,86265,2684
2020-11-22,Tunisia,TN,1206,68,11694721,Africa,87471,2752
2020-11-23,Tunisia,TN,1240,69,11694721,Africa,88711,2821
2020-11-24,Tunisia,TN,484,41,11694721,Africa,89195,2862
2020-11-25,Tunisia,TN,1018,73,11694721,Africa,90213,2935
2020-11-26,Tunisia,TN,1094,48,11694721,Africa,91307,2983
2020-11-27,Tunisia,TN,1168,51,11694721,Africa,92475,3034
2020-11-28,Tunisia,TN,1295,72,11694721,Africa,93770,3106
2020-11-29,Tunisia,TN,1210,47,11694721,Africa,94980,3153
2020-11-30,Tunisia,TN,1271,66,11694721,Africa,96251,3219
2020-12-01,Tunisia,TN,518,41,11694721,Africa,96769,3260
2020-12-02,Tunisia,TN,1303,51,11694721,Africa,98072,3311
2020-12-03,Tunisia,TN,1208,48,11694721,Africa,99280,3359
2020-12-04,Tunisia,TN,0,0,11694721,Africa,99280,3359
2020-12-05,Tunisia,TN,2620,122,11694721,Africa,101900,3481
2020-12-06,Tunisia,TN,1091,45,11694721,Africa,102991,3526
2020-12-07,Tunisia,TN,1011,35,11694721,Africa,104002,3561
2020-12-08,Tunisia,TN,327,35,11694721,Africa,104329,3596
2020-12-09,Tunisia,TN,1116,72,11694721,Africa,105445,3668
2020-12-10,Tunisia,TN,1411,49,11694721,Africa,106856,3717
2020-12-11,Tunisia,TN,958,41,11694721,Africa,107814,3758
2020-12-12,Tunisia,TN,1290,43,11694721,Africa,109104,3801
2020-12-13,Tunisia,TN,1289,35,11694721,Africa,110393,3836
2020-12-14,Tunisia,TN,968,58,11694721,Africa,111361,3894
2020-03-12,Turkey,TR,1,0,82003882,Europe,1,0
2020-03-13,Turkey,TR,1,0,82003882,Europe,2,0
2020-03-16,Turkey,TR,16,0,82003882,Europe,18,0
2020-03-17,Turkey,TR,29,0,82003882,Europe,47,0
2020-03-18,Turkey,TR,51,0,82003882,Europe,98,0
2020-03-19,Turkey,TR,93,1,82003882,Europe,191,1
2020-03-20,Turkey,TR,168,3,82003882,Europe,359,4
2020-03-21,Turkey,TR,311,5,82003882,Europe,670,9
2020-03-22,Turkey,TR,277,12,82003882,Europe,947,21
2020-03-23,Turkey,TR,289,9,82003882,Europe,1236,30
2020-03-24,Turkey,TR,293,7,82003882,Europe,1529,37
2020-03-25,Turkey,TR,343,7,82003882,Europe,1872,44
2020-03-26,Turkey,TR,561,15,82003882,Europe,2433,59
2020-03-27,Turkey,TR,1196,16,82003882,Europe,3629,75
2020-03-28,Turkey,TR,2069,17,82003882,Europe,5698,92
2020-03-29,Turkey,TR,1704,16,82003882,Europe,7402,108
2020-03-30,Turkey,TR,1815,23,82003882,Europe,9217,131
2020-03-31,Turkey,TR,1610,37,82003882,Europe,10827,168
2020-04-01,Turkey,TR,2704,46,82003882,Europe,13531,214
2020-04-02,Turkey,TR,2148,63,82003882,Europe,15679,277
2020-04-03,Turkey,TR,2456,79,82003882,Europe,18135,356
2020-04-04,Turkey,TR,2786,69,82003882,Europe,20921,425
2020-04-05,Turkey,TR,3013,76,82003882,Europe,23934,501
2020-04-06,Turkey,TR,3135,73,82003882,Europe,27069,574
2020-04-07,Turkey,TR,3148,75,82003882,Europe,30217,649
2020-04-08,Turkey,TR,3892,76,82003882,Europe,34109,725
2020-04-09,Turkey,TR,4117,87,82003882,Europe,38226,812
2020-04-10,Turkey,TR,4056,96,82003882,Europe,42282,908
2020-04-11,Turkey,TR,4747,98,82003882,Europe,47029,1006
2020-04-12,Turkey,TR,5138,95,82003882,Europe,52167,1101
2020-04-13,Turkey,TR,4789,97,82003882,Europe,56956,1198
2020-04-14,Turkey,TR,4093,98,82003882,Europe,61049,1296
2020-04-15,Turkey,TR,4062,107,82003882,Europe,65111,1403
2020-04-16,Turkey,TR,4281,115,82003882,Europe,69392,1518
2020-04-17,Turkey,TR,4801,125,82003882,Europe,74193,1643
2020-04-18,Turkey,TR,4353,126,82003882,Europe,78546,1769
2020-04-19,Turkey,TR,3783,121,82003882,Europe,82329,1890
2020-04-20,Turkey,TR,3977,127,82003882,Europe,86306,2017
2020-04-21,Turkey,TR,4674,123,82003882,Europe,90980,2140
2020-04-22,Turkey,TR,4611,119,82003882,Europe,95591,2259
2020-04-23,Turkey,TR,3083,117,82003882,Europe,98674,2376
2020-04-24,Turkey,TR,3116,115,82003882,Europe,101790,2491
2020-04-25,Turkey,TR,3122,109,82003882,Europe,104912,2600
2020-04-26,Turkey,TR,2861,106,82003882,Europe,107773,2706
2020-04-27,Turkey,TR,2357,99,82003882,Europe,110130,2805
2020-04-28,Turkey,TR,2131,95,82003882,Europe,112261,2900
2020-04-29,Turkey,TR,2392,92,82003882,Europe,114653,2992
2020-04-30,Turkey,TR,2936,89,82003882,Europe,117589,3081
2020-05-01,Turkey,TR,2615,93,82003882,Europe,120204,3174
2020-05-02,Turkey,TR,2188,84,82003882,Europe,122392,3258
2020-05-03,Turkey,TR,1983,78,82003882,Europe,124375,3336
2020-05-04,Turkey,TR,1670,61,82003882,Europe,126045,3397
2020-05-05,Turkey,TR,1614,64,82003882,Europe,127659,3461
2020-05-06,Turkey,TR,1832,59,82003882,Europe,129491,3520
2020-05-07,Turkey,TR,2253,64,82003882,Europe,131744,3584
2020-05-08,Turkey,TR,1977,57,82003882,Europe,133721,3641
2020-05-09,Turkey,TR,1848,48,82003882,Europe,135569,3689
2020-05-10,Turkey,TR,1546,50,82003882,Europe,137115,3739
2020-05-11,Turkey,TR,1542,47,82003882,Europe,138657,3786
2020-05-12,Turkey,TR,1114,55,82003882,Europe,139771,3841
2020-05-13,Turkey,TR,1704,53,82003882,Europe,141475,3894
2020-05-14,Turkey,TR,1639,58,82003882,Europe,143114,3952
2020-05-15,Turkey,TR,1635,55,82003882,Europe,144749,4007
2020-05-16,Turkey,TR,1708,48,82003882,Europe,146457,4055
2020-05-17,Turkey,TR,1610,41,82003882,Europe,148067,4096
2020-05-18,Turkey,TR,1368,44,82003882,Europe,149435,4140
2020-05-19,Turkey,TR,1158,31,82003882,Europe,150593,4171
2020-05-20,Turkey,TR,1022,28,82003882,Europe,151615,4199
2020-05-21,Turkey,TR,972,23,82003882,Europe,152587,4222
2020-05-22,Turkey,TR,961,27,82003882,Europe,153548,4249
2020-05-23,Turkey,TR,952,27,82003882,Europe,154500,4276
2020-05-24,Turkey,TR,1186,32,82003882,Europe,155686,4308
2020-05-25,Turkey,TR,1141,32,82003882,Europe,156827,4340
2020-05-26,Turkey,TR,987,29,82003882,Europe,157814,4369
2020-05-27,Turkey,TR,948,28,82003882,Europe,158762,4397
2020-05-28,Turkey,TR,1035,34,82003882,Europe,159797,4431
2020-05-29,Turkey,TR,1182,30,82003882,Europe,160979,4461
2020-05-30,Turkey,TR,1141,28,82003882,Europe,162120,4489
2020-05-31,Turkey,TR,983,26,82003882,Europe,163103,4515
2020-06-01,Turkey,TR,839,25,82003882,Europe,163942,4540
2020-06-02,Turkey,TR,827,23,82003882,Europe,164769,4563
2020-06-03,Turkey,TR,786,22,82003882,Europe,165555,4585
2020-06-04,Turkey,TR,867,24,82003882,Europe,166422,4609
2020-06-05,Turkey,TR,988,21,82003882,Europe,167410,4630
2020-06-06,Turkey,TR,930,18,82003882,Europe,168340,4648
2020-06-07,Turkey,TR,878,21,82003882,Europe,169218,4669
2020-06-08,Turkey,TR,914,23,82003882,Europe,170132,4692
2020-06-09,Turkey,TR,989,19,82003882,Europe,171121,4711
2020-06-10,Turkey,TR,993,18,82003882,Europe,172114,4729
2020-06-11,Turkey,TR,922,17,82003882,Europe,173036,4746
2020-06-12,Turkey,TR,987,17,82003882,Europe,174023,4763
2020-06-13,Turkey,TR,1195,15,82003882,Europe,175218,4778
2020-06-14,Turkey,TR,1459,14,82003882,Europe,176677,4792
2020-06-15,Turkey,TR,1562,15,82003882,Europe,178239,4807
2020-06-16,Turkey,TR,1592,18,82003882,Europe,179831,4825
2020-06-17,Turkey,TR,1467,17,82003882,Europe,181298,4842
2020-06-18,Turkey,TR,1429,19,82003882,Europe,182727,4861
2020-06-19,Turkey,TR,1304,21,82003882,Europe,184031,4882
2020-06-20,Turkey,TR,1214,23,82003882,Europe,185245,4905
2020-06-21,Turkey,TR,1248,22,82003882,Europe,186493,4927
2020-06-22,Turkey,TR,1192,23,82003882,Europe,187685,4950
2020-06-23,Turkey,TR,1212,24,82003882,Europe,188897,4974
2020-06-24,Turkey,TR,1268,27,82003882,Europe,190165,5001
2020-06-25,Turkey,TR,1492,24,82003882,Europe,191657,5025
2020-06-26,Turkey,TR,1458,21,82003882,Europe,193115,5046
2020-06-27,Turkey,TR,1396,19,82003882,Europe,194511,5065
2020-06-28,Turkey,TR,1372,17,82003882,Europe,195883,5082
2020-06-29,Turkey,TR,1356,15,82003882,Europe,197239,5097
2020-06-30,Turkey,TR,1374,18,82003882,Europe,198613,5115
2020-07-01,Turkey,TR,1293,16,82003882,Europe,199906,5131
2020-07-02,Turkey,TR,1192,19,82003882,Europe,201098,5150
2020-07-03,Turkey,TR,1186,17,82003882,Europe,202284,5167
2020-07-04,Turkey,TR,1172,19,82003882,Europe,203456,5186
2020-07-05,Turkey,TR,1154,20,82003882,Europe,204610,5206
2020-07-06,Turkey,TR,1148,19,82003882,Europe,205758,5225
2020-07-07,Turkey,TR,1086,16,82003882,Europe,206844,5241
2020-07-08,Turkey,TR,1053,19,82003882,Europe,207897,5260
2020-07-09,Turkey,TR,1041,22,82003882,Europe,208938,5282
2020-07-10,Turkey,TR,1024,18,82003882,Europe,209962,5300
2020-07-11,Turkey,TR,1003,23,82003882,Europe,210965,5323
2020-07-12,Turkey,TR,1016,21,82003882,Europe,211981,5344
2020-07-13,Turkey,TR,1012,19,82003882,Europe,212993,5363
2020-07-14,Turkey,TR,1008,19,82003882,Europe,214001,5382
2020-07-15,Turkey,TR,992,20,82003882,Europe,214993,5402
2020-07-16,Turkey,TR,947,17,82003882,Europe,215940,5419
2020-07-17,Turkey,TR,933,21,82003882,Europe,216873,5440
2020-07-18,Turkey,TR,926,18,82003882,Europe,217799,5458
2020-07-19,Turkey,TR,918,17,82003882,Europe,218717,5475
2020-07-20,Turkey,TR,924,16,82003882,Europe,219641,5491
2020-07-21,Turkey,TR,931,17,82003882,Europe,220572,5508
2020-07-22,Turkey,TR,928,18,82003882,Europe,221500,5526
2020-07-23,Turkey,TR,902,19,82003882,Europe,222402,5545
2020-07-24,Turkey,TR,913,18,82003882,Europe,223315,5563
2020-07-25,Turkey,TR,937,17,82003882,Europe,224252,5580
2020-07-26,Turkey,TR,921,16,82003882,Europe,225173,5596
2020-07-27,Turkey,TR,927,17,82003882,Europe,226100,5613
2020-07-28,Turkey,TR,919,17,82003882,Europe,227019,5630
2020-07-29,Turkey,TR,963,15,82003882,Europe,227982,5645
2020-07-30,Turkey,TR,942,14,82003882,Europe,228924,5659
2020-07-31,Turkey,TR,967,15,82003882,Europe,229891,5674
2020-08-01,Turkey,TR,982,17,82003882,Europe,230873,5691
2020-08-02,Turkey,TR,996,19,82003882,Europe,231869,5710
2020-08-03,Turkey,TR,987,18,82003882,Europe,232856,5728
2020-08-04,Turkey,TR,995,19,82003882,Europe,233851,5747
2020-08-05,Turkey,TR,1083,18,82003882,Europe,234934,5765
2020-08-06,Turkey,TR,1178,19,82003882,Europe,236112,5784
2020-08-07,Turkey,TR,1153,14,82003882,Europe,237265,5798
2020-08-08,Turkey,TR,1185,15,82003882,Europe,238450,5813
2020-08-09,Turkey,TR,1172,16,82003882,Europe,239622,5829
2020-08-10,Turkey,TR,1182,15,82003882,Europe,240804,5844
2020-08-11,Turkey,TR,1193,14,82003882,Europe,241997,5858
2020-08-12,Turkey,TR,1183,15,82003882,Europe,243180,5873
2020-08-13,Turkey,TR,1212,18,82003882,Europe,244392,5891
2020-08-14,Turkey,TR,1243,21,82003882,Europe,245635,5912
2020-08-15,Turkey,TR,1226,22,82003882,Europe,246861,5934
2020-08-16,Turkey,TR,1256,21,82003882,Europe,248117,5955
2020-08-17,Turkey,TR,1192,19,82003882,Europe,249309,5974
2020-08-18,Turkey,TR,1233,22,82003882,Europe,250542,5996
2020-08-19,Turkey,TR,1263,20,82003882,Europe,251805,6016
2020-08-20,Turkey,TR,1303,23,82003882,Europe,253108,6039
2020-08-21,Turkey,TR,1412,19,82003882,Europe,254520,6058
2020-08-22,Turkey,TR,1203,22,82003882,Europe,255723,6080
2020-08-23,Turkey,TR,1309,22,82003882,Europe,257032,6102
2020-08-24,Turkey,TR,1217,19,82003882,Europe,258249,6121
2020-08-25,Turkey,TR,1443,18,82003882,Europe,259692,6139
2020-08-26,Turkey,TR,1502,24,82003882,Europe,261194,6163
2020-08-27,Turkey,TR,1313,20,82003882,Europe,262507,6183
2020-08-28,Turkey,TR,1491,26,82003882,Europe,263998,6209
2020-08-29,Turkey,TR,1517,36,82003882,Europe,265515,6245
2020-08-30,Turkey,TR,1549,39,82003882,Europe,267064,6284
2020-08-31,Turkey,TR,1482,42,82003882,Europe,268546,6326
2020-09-01,Turkey,TR,1587,44,82003882,Europe,270133,6370
2020-09-02,Turkey,TR,1572,47,82003882,Europe,271705,6417
2020-09-03,Turkey,TR,1596,45,82003882,Europe,273301,6462
2020-09-04,Turkey,TR,1642,49,82003882,Europe,274943,6511
2020-09-05,Turkey,TR,1612,53,82003882,Europe,276555,6564
2020-09-06,Turkey,TR,1673,56,82003882,Europe,278228,6620
2020-09-07,Turkey,TR,1578,53,82003882,Europe,279806,6673
2020-09-08,Turkey,TR,1703,57,82003882,Europe,281509,6730
2020-09-09,Turkey,TR,1761,52,82003882,Europe,283270,6782
2020-09-10,Turkey,TR,1673,55,82003882,Europe,284943,6837
2020-09-11,Turkey,TR,1512,58,82003882,Europe,286455,6895
2020-09-12,Turkey,TR,1671,56,82003882,Europe,288126,6951
2020-09-13,Turkey,TR,1509,48,82003882,Europe,289635,6999
2020-09-14,Turkey,TR,1527,57,82003882,Europe,291162,7056
2020-09-15,Turkey,TR,1716,63,82003882,Europe,292878,7119
2020-09-16,Turkey,TR,1742,67,82003882,Europe,294620,7186
2020-09-17,Turkey,TR,1771,63,82003882,Europe,296391,7249
2020-09-18,Turkey,TR,1648,66,82003882,Europe,298039,7315
2020-09-19,Turkey,TR,1771,62,82003882,Europe,299810,7377
2020-09-20,Turkey,TR,1538,68,82003882,Europe,301348,7445
2020-09-21,Turkey,TR,1519,61,82003882,Europe,302867,7506
2020-09-22,Turkey,TR,1743,68,82003882,Europe,304610,7574
2020-09-23,Turkey,TR,1692,65,82003882,Europe,306302,7639
2020-09-24,Turkey,TR,1767,72,82003882,Europe,308069,7711
2020-09-25,Turkey,TR,1721,74,82003882,Europe,309790,7785
2020-09-26,Turkey,TR,1665,73,82003882,Europe,311455,7858
2020-09-27,Turkey,TR,1511,71,82003882,Europe,312966,7929
2020-09-28,Turkey,TR,1467,68,82003882,Europe,314433,7997
2020-09-29,Turkey,TR,1412,65,82003882,Europe,315845,8062
2020-09-30,Turkey,TR,1427,68,82003882,Europe,317272,8130
2020-10-01,Turkey,TR,1391,65,82003882,Europe,318663,8195
2020-10-02,Turkey,TR,1407,67,82003882,Europe,320070,8262
2020-10-03,Turkey,TR,1442,63,82003882,Europe,321512,8325
2020-10-04,Turkey,TR,1502,59,82003882,Europe,323014,8384
2020-10-05,Turkey,TR,1429,57,82003882,Europe,324443,8441
2020-10-06,Turkey,TR,1603,57,82003882,Europe,326046,8498
2020-10-07,Turkey,TR,1511,55,82003882,Europe,327557,8553
2020-10-08,Turkey,TR,1581,56,82003882,Europe,329138,8609
2020-10-09,Turkey,TR,1615,58,82003882,Europe,330753,8667
2020-10-10,Turkey,TR,1629,55,82003882,Europe,332382,8722
2020-10-11,Turkey,TR,1649,56,82003882,Europe,334031,8778
2020-10-12,Turkey,TR,1502,59,82003882,Europe,335533,8837
2020-10-13,Turkey,TR,1614,58,82003882,Europe,337147,8895
2020-10-14,Turkey,TR,1632,62,82003882,Europe,338779,8957
2020-10-15,Turkey,TR,1671,57,82003882,Europe,340450,9014
2020-10-16,Turkey,TR,1693,66,82003882,Europe,342143,9080
2020-10-17,Turkey,TR,1812,73,82003882,Europe,343955,9153
2020-10-18,Turkey,TR,1723,71,82003882,Europe,345678,9224
2020-10-19,Turkey,TR,1815,72,82003882,Europe,347493,9296
2020-10-20,Turkey,TR,2026,75,82003882,Europe,349519,9371
2020-10-21,Turkey,TR,1894,74,82003882,Europe,351413,9445
2020-10-22,Turkey,TR,2013,68,82003882,Europe,353426,9513
2020-10-23,Turkey,TR,2102,71,82003882,Europe,355528,9584
2020-10-24,Turkey,TR,2165,74,82003882,Europe,357693,9658
2020-10-25,Turkey,TR,2091,69,82003882,Europe,359784,9727
2020-10-26,Turkey,TR,2017,72,82003882,Europe,361801,9799
2020-10-27,Turkey,TR,2198,75,82003882,Europe,363999,9874
2020-10-28,Turkey,TR,2209,76,82003882,Europe,366208,9950
2020-10-29,Turkey,TR,2305,77,82003882,Europe,368513,10027
2020-10-30,Turkey,TR,2319,72,82003882,Europe,370832,10099
2020-10-31,Turkey,TR,2322,78,82003882,Europe,373154,10177
2020-11-01,Turkey,TR,2213,75,82003882,Europe,375367,10252
2020-11-02,Turkey,TR,2106,74,82003882,Europe,377473,10326
2020-11-03,Turkey,TR,2302,76,82003882,Europe,379775,10402
2020-11-04,Turkey,TR,2343,79,82003882,Europe,382118,10481
2020-11-05,Turkey,TR,2391,77,82003882,Europe,384509,10558
2020-11-06,Turkey,TR,2311,81,82003882,Europe,386820,10639
2020-11-07,Turkey,TR,2436,83,82003882,Europe,389256,10722
2020-11-08,Turkey,TR,2483,81,82003882,Europe,391739,10803
2020-11-09,Turkey,TR,2516,84,82003882,Europe,394255,10887
2020-11-10,Turkey,TR,2576,85,82003882,Europe,396831,10972
2020-11-11,Turkey,TR,2529,87,82003882,Europe,399360,11059
2020-11-12,Turkey,TR,2693,86,82003882,Europe,402053,11145
2020-11-13,Turkey,TR,2841,88,82003882,Europe,404894,11233
2020-11-14,Turkey,TR,3045,93,82003882,Europe,407939,11326
2020-11-15,Turkey,TR,3116,92,82003882,Europe,411055,11418
2020-11-16,Turkey,TR,3223,89,82003882,Europe,414278,11507
2020-11-17,Turkey,TR,3316,94,82003882,Europe,417594,11601
2020-11-18,Turkey,TR,3819,103,82003882,Europe,421413,11704
2020-11-19,Turkey,TR,4215,116,82003882,Europe,425628,11820
2020-11-20,Turkey,TR,4542,123,82003882,Europe,430170,11943
2020-11-21,Turkey,TR,5103,141,82003882,Europe,435273,12084
2020-11-22,Turkey,TR,5532,135,82003882,Europe,440805,12219
2020-11-23,Turkey,TR,6017,139,82003882,Europe,446822,12358
2020-11-24,Turkey,TR,6713,153,82003882,Europe,453535,12511
2020-11-25,Turkey,TR,7381,161,82003882,Europe,460916,12672
2020-11-26,Turkey,TR,6814,168,82003882,Europe,467730,12840
2020-11-27,Turkey,TR,29132,174,82003882,Europe,496862,13014
2020-11-28,Turkey,TR,29845,177,82003882,Europe,526707,13191
2020-11-29,Turkey,TR,30103,182,82003882,Europe,556810,13373
2020-11-30,Turkey,TR,29281,185,82003882,Europe,586091,13558
2020-12-01,Turkey,TR,31219,188,82003882,Europe,617310,13746
2020-12-02,Turkey,TR,30110,190,82003882,Europe,647420,13936
2020-12-03,Turkey,TR,31923,193,82003882,Europe,679343,14129
2020-12-04,Turkey,TR,32381,187,82003882,Europe,711724,14316
2020-12-05,Turkey,TR,32736,193,82003882,Europe,744460,14509
2020-12-06,Turkey,TR,31896,196,82003882,Europe,776356,14705
2020-12-07,Turkey,TR,30402,195,82003882,Europe,806758,14900
2020-12-08,Turkey,TR,32137,203,82003882,Europe,838895,15103
2020-12-09,Turkey,TR,33198,211,82003882,Europe,872093,15314
2020-12-10,Turkey,TR,31712,217,82003882,Europe,903805,15531
2020-12-11,Turkey,TR,30424,220,82003882,Europe,934229,15751
2020-12-12,Turkey,TR,0,0,82003882,Europe,934229,15751
2020-12-13,Turkey,TR,32106,226,82003882,Europe,966335,15977
2020-12-14,Turkey,TR,29136,222,82003882,Europe,995471,16199
2020-03-13,Trinidad_and_Tobago,TT,1,0,1394969,America,1,0
2020-03-14,Trinidad_and_Tobago,TT,1,0,1394969,America,2,0
2020-03-15,Trinidad_and_Tobago,TT,0,0,1394969,America,2,0
2020-03-16,Trinidad_and_Tobago,TT,2,0,1394969,America,4,0
2020-03-17,Trinidad_and_Tobago,TT,1,0,1394969,America,5,0
2020-03-18,Trinidad_and_Tobago,TT,2,0,1394969,America,7,0
2020-03-19,Trinidad_and_Tobago,TT,2,0,1394969,America,9,0
2020-03-20,Trinidad_and_Tobago,TT,0,0,1394969,America,9,0
2020-03-21,Trinidad_and_Tobago,TT,0,0,1394969,America,9,0
2020-03-22,Trinidad_and_Tobago,TT,40,0,1394969,America,49,0
2020-03-23,Trinidad_and_Tobago,TT,1,0,1394969,America,50,0
2020-03-24,Trinidad_and_Tobago,TT,1,0,1394969,America,51,0
2020-03-25,Trinidad_and_Tobago,TT,6,0,1394969,America,57,0
2020-03-26,Trinidad_and_Tobago,TT,3,1,1394969,America,60,1
2020-03-27,Trinidad_and_Tobago,TT,5,0,1394969,America,65,1
2020-03-28,Trinidad_and_Tobago,TT,1,1,1394969,America,66,2
2020-03-29,Trinidad_and_Tobago,TT,8,0,1394969,America,74,2
2020-03-30,Trinidad_and_Tobago,TT,4,1,1394969,America,78,3
2020-03-31,Trinidad_and_Tobago,TT,7,0,1394969,America,85,3
2020-04-01,Trinidad_and_Tobago,TT,2,0,1394969,America,87,3
2020-04-02,Trinidad_and_Tobago,TT,2,2,1394969,America,89,5
2020-04-03,Trinidad_and_Tobago,TT,8,1,1394969,America,97,6
2020-04-04,Trinidad_and_Tobago,TT,3,0,1394969,America,100,6
2020-04-05,Trinidad_and_Tobago,TT,3,0,1394969,America,103,6
2020-04-06,Trinidad_and_Tobago,TT,1,1,1394969,America,104,7
2020-04-07,Trinidad_and_Tobago,TT,1,1,1394969,America,105,8
2020-04-08,Trinidad_and_Tobago,TT,2,0,1394969,America,107,8
2020-04-09,Trinidad_and_Tobago,TT,0,0,1394969,America,107,8
2020-04-10,Trinidad_and_Tobago,TT,2,0,1394969,America,109,8
2020-04-11,Trinidad_and_Tobago,TT,0,0,1394969,America,109,8
2020-04-12,Trinidad_and_Tobago,TT,3,0,1394969,America,112,8
2020-04-13,Trinidad_and_Tobago,TT,1,0,1394969,America,113,8
2020-04-14,Trinidad_and_Tobago,TT,0,0,1394969,America,113,8
2020-04-15,Trinidad_and_Tobago,TT,0,0,1394969,America,113,8
2020-04-16,Trinidad_and_Tobago,TT,1,0,1394969,America,114,8
2020-04-17,Trinidad_and_Tobago,TT,0,0,1394969,America,114,8
2020-04-18,Trinidad_and_Tobago,TT,0,0,1394969,America,114,8
2020-04-19,Trinidad_and_Tobago,TT,0,0,1394969,America,114,8
2020-04-20,Trinidad_and_Tobago,TT,0,0,1394969,America,114,8
2020-04-21,Trinidad_and_Tobago,TT,0,0,1394969,America,114,8
2020-04-22,Trinidad_and_Tobago,TT,1,0,1394969,America,115,8
2020-04-23,Trinidad_and_Tobago,TT,0,0,1394969,America,115,8
2020-04-24,Trinidad_and_Tobago,TT,0,0,1394969,America,115,8
2020-04-25,Trinidad_and_Tobago,TT,0,0,1394969,America,115,8
2020-04-26,Trinidad_and_Tobago,TT,0,0,1394969,America,115,8
2020-04-27,Trinidad_and_Tobago,TT,1,0,1394969,America,116,8
2020-04-28,Trinidad_and_Tobago,TT,0,0,1394969,America,116,8
2020-04-29,Trinidad_and_Tobago,TT,0,0,1394969,America,116,8
2020-04-30,Trinidad_and_Tobago,TT,0,0,1394969,America,116,8
2020-05-01,Trinidad_and_Tobago,TT,0,0,1394969,America,116,8
2020-05-02,Trinidad_and_Tobago,TT,0,0,1394969,America,116,8
2020-05-03,Trinidad_and_Tobago,TT,0,0,1394969,America,116,8
2020-05-04,Trinidad_and_Tobago,TT,0,0,1394969,America,116,8
2020-05-05,Trinidad_and_Tobago,TT,0,0,1394969,America,116,8
2020-05-06,Trinidad_and_Tobago,TT,0,0,1394969,America,116,8
2020-05-07,Trinidad_and_Tobago,TT,0,0,1394969,America,116,8
2020-05-08,Trinidad_and_Tobago,TT,0,0,1394969,America,116,8
2020-05-09,Trinidad_and_Tobago,TT,0,0,1394969,America,116,8
2020-05-10,Trinidad_and_Tobago,TT,0,0,1394969,America,116,8
2020-05-11,Trinidad_and_Tobago,TT,0,0,1394969,America,116,8
2020-05-12,Trinidad_and_Tobago,TT,0,0,1394969,America,116,8
2020-05-13,Trinidad_and_Tobago,TT,0,0,1394969,America,116,8
2020-05-14,Trinidad_and_Tobago,TT,0,0,1394969,America,116,8
2020-05-15,Trinidad_and_Tobago,TT,0,0,1394969,America,116,8
2020-05-16,Trinidad_and_Tobago,TT,0,0,1394969,America,116,8
2020-05-17,Trinidad_and_Tobago,TT,0,0,1394969,America,116,8
2020-05-18,Trinidad_and_Tobago,TT,0,0,1394969,America,116,8
2020-05-19,Trinidad_and_Tobago,TT,0,0,1394969,America,116,8
2020-05-20,Trinidad_and_Tobago,TT,0,0,1394969,America,116,8
2020-05-21,Trinidad_and_Tobago,TT,0,0,1394969,America,116,8
2020-05-22,Trinidad_and_Tobago,TT,0,0,1394969,America,116,8
2020-05-23,Trinidad_and_Tobago,TT,0,0,1394969,America,116,8
2020-05-24,Trinidad_and_Tobago,TT,0,0,1394969,America,116,8
2020-05-25,Trinidad_and_Tobago,TT,0,0,1394969,America,116,8
2020-05-26,Trinidad_and_Tobago,TT,0,0,1394969,America,116,8
2020-05-27,Trinidad_and_Tobago,TT,0,0,1394969,America,116,8
2020-05-28,Trinidad_and_Tobago,TT,0,0,1394969,America,116,8
2020-05-29,Trinidad_and_Tobago,TT,0,0,1394969,America,116,8
2020-05-30,Trinidad_and_Tobago,TT,0,0,1394969,America,116,8
2020-05-31,Trinidad_and_Tobago,TT,1,0,1394969,America,117,8
2020-06-01,Trinidad_and_Tobago,TT,0,0,1394969,America,117,8
2020-06-02,Trinidad_and_Tobago,TT,0,0,1394969,America,117,8
2020-06-03,Trinidad_and_Tobago,TT,0,0,1394969,America,117,8
2020-06-04,Trinidad_and_Tobago,TT,0,0,1394969,America,117,8
2020-06-05,Trinidad_and_Tobago,TT,0,0,1394969,America,117,8
2020-06-06,Trinidad_and_Tobago,TT,0,0,1394969,America,117,8
2020-06-07,Trinidad_and_Tobago,TT,0,0,1394969,America,117,8
2020-06-08,Trinidad_and_Tobago,TT,0,0,1394969,America,117,8
2020-06-09,Trinidad_and_Tobago,TT,0,0,1394969,America,117,8
2020-06-10,Trinidad_and_Tobago,TT,0,0,1394969,America,117,8
2020-06-11,Trinidad_and_Tobago,TT,0,0,1394969,America,117,8
2020-06-12,Trinidad_and_Tobago,TT,0,0,1394969,America,117,8
2020-06-13,Trinidad_and_Tobago,TT,0,0,1394969,America,117,8
2020-06-14,Trinidad_and_Tobago,TT,0,0,1394969,America,117,8
2020-06-15,Trinidad_and_Tobago,TT,6,0,1394969,America,123,8
2020-06-16,Trinidad_and_Tobago,TT,0,0,1394969,America,123,8
2020-06-17,Trinidad_and_Tobago,TT,0,0,1394969,America,123,8
2020-06-18,Trinidad_and_Tobago,TT,0,0,1394969,America,123,8
2020-06-19,Trinidad_and_Tobago,TT,0,0,1394969,America,123,8
2020-06-20,Trinidad_and_Tobago,TT,0,0,1394969,America,123,8
2020-06-21,Trinidad_and_Tobago,TT,0,0,1394969,America,123,8
2020-06-22,Trinidad_and_Tobago,TT,0,0,1394969,America,123,8
2020-06-23,Trinidad_and_Tobago,TT,0,0,1394969,America,123,8
2020-06-24,Trinidad_and_Tobago,TT,0,0,1394969,America,123,8
2020-06-25,Trinidad_and_Tobago,TT,0,0,1394969,America,123,8
2020-06-26,Trinidad_and_Tobago,TT,0,0,1394969,America,123,8
2020-06-27,Trinidad_and_Tobago,TT,1,0,1394969,America,124,8
2020-06-28,Trinidad_and_Tobago,TT,0,0,1394969,America,124,8
2020-06-29,Trinidad_and_Tobago,TT,2,0,1394969,America,126,8
2020-06-30,Trinidad_and_Tobago,TT,0,0,1394969,America,126,8
2020-07-01,Trinidad_and_Tobago,TT,4,0,1394969,America,130,8
2020-07-02,Trinidad_and_Tobago,TT,0,0,1394969,America,130,8
2020-07-03,Trinidad_and_Tobago,TT,0,0,1394969,America,130,8
2020-07-04,Trinidad_and_Tobago,TT,0,0,1394969,America,130,8
2020-07-05,Trinidad_and_Tobago,TT,0,0,1394969,America,130,8
2020-07-06,Trinidad_and_Tobago,TT,3,0,1394969,America,133,8
2020-07-07,Trinidad_and_Tobago,TT,0,0,1394969,America,133,8
2020-07-08,Trinidad_and_Tobago,TT,0,0,1394969,America,133,8
2020-07-09,Trinidad_and_Tobago,TT,0,0,1394969,America,133,8
2020-07-10,Trinidad_and_Tobago,TT,0,0,1394969,America,133,8
2020-07-11,Trinidad_and_Tobago,TT,0,0,1394969,America,133,8
2020-07-12,Trinidad_and_Tobago,TT,0,0,1394969,America,133,8
2020-07-13,Trinidad_and_Tobago,TT,0,0,1394969,America,133,8
2020-07-14,Trinidad_and_Tobago,TT,0,0,1394969,America,133,8
2020-07-15,Trinidad_and_Tobago,TT,0,0,1394969,America,133,8
2020-07-16,Trinidad_and_Tobago,TT,0,0,1394969,America,133,8
2020-07-17,Trinidad_and_Tobago,TT,0,0,1394969,America,133,8
2020-07-18,Trinidad_and_Tobago,TT,3,0,1394969,America,136,8
2020-07-19,Trinidad_and_Tobago,TT,1,0,1394969,America,137,8
2020-07-20,Trinidad_and_Tobago,TT,0,0,1394969,America,137,8
2020-07-21,Trinidad_and_Tobago,TT,0,0,1394969,America,137,8
2020-07-22,Trinidad_and_Tobago,TT,2,0,1394969,America,139,8
2020-07-23,Trinidad_and_Tobago,TT,2,0,1394969,America,141,8
2020-07-24,Trinidad_and_Tobago,TT,0,0,1394969,America,141,8
2020-07-25,Trinidad_and_Tobago,TT,1,0,1394969,America,142,8
2020-07-26,Trinidad_and_Tobago,TT,5,0,1394969,America,147,8
2020-07-27,Trinidad_and_Tobago,TT,0,0,1394969,America,147,8
2020-07-28,Trinidad_and_Tobago,TT,1,0,1394969,America,148,8
2020-07-29,Trinidad_and_Tobago,TT,6,0,1394969,America,154,8
2020-07-30,Trinidad_and_Tobago,TT,2,0,1394969,America,156,8
2020-07-31,Trinidad_and_Tobago,TT,8,0,1394969,America,164,8
2020-08-01,Trinidad_and_Tobago,TT,5,0,1394969,America,169,8
2020-08-02,Trinidad_and_Tobago,TT,4,0,1394969,America,173,8
2020-08-03,Trinidad_and_Tobago,TT,9,0,1394969,America,182,8
2020-08-04,Trinidad_and_Tobago,TT,0,0,1394969,America,182,8
2020-08-05,Trinidad_and_Tobago,TT,12,0,1394969,America,194,8
2020-08-06,Trinidad_and_Tobago,TT,5,0,1394969,America,199,8
2020-08-07,Trinidad_and_Tobago,TT,11,0,1394969,America,210,8
2020-08-08,Trinidad_and_Tobago,TT,15,0,1394969,America,225,8
2020-08-09,Trinidad_and_Tobago,TT,50,0,1394969,America,275,8
2020-08-10,Trinidad_and_Tobago,TT,4,0,1394969,America,279,8
2020-08-11,Trinidad_and_Tobago,TT,2,0,1394969,America,281,8
2020-08-12,Trinidad_and_Tobago,TT,14,0,1394969,America,295,8
2020-08-13,Trinidad_and_Tobago,TT,31,0,1394969,America,326,8
2020-08-14,Trinidad_and_Tobago,TT,78,0,1394969,America,404,8
2020-08-15,Trinidad_and_Tobago,TT,8,0,1394969,America,412,8
2020-08-16,Trinidad_and_Tobago,TT,62,2,1394969,America,474,10
2020-08-17,Trinidad_and_Tobago,TT,78,1,1394969,America,552,11
2020-08-18,Trinidad_and_Tobago,TT,0,0,1394969,America,552,11
2020-08-19,Trinidad_and_Tobago,TT,77,1,1394969,America,629,12
2020-08-20,Trinidad_and_Tobago,TT,57,0,1394969,America,686,12
2020-08-21,Trinidad_and_Tobago,TT,81,0,1394969,America,767,12
2020-08-22,Trinidad_and_Tobago,TT,97,0,1394969,America,864,12
2020-08-23,Trinidad_and_Tobago,TT,66,1,1394969,America,930,13
2020-08-24,Trinidad_and_Tobago,TT,77,1,1394969,America,1007,14
2020-08-25,Trinidad_and_Tobago,TT,92,1,1394969,America,1099,15
2020-08-26,Trinidad_and_Tobago,TT,153,0,1394969,America,1252,15
2020-08-27,Trinidad_and_Tobago,TT,159,0,1394969,America,1411,15
2020-08-28,Trinidad_and_Tobago,TT,65,0,1394969,America,1476,15
2020-08-29,Trinidad_and_Tobago,TT,78,4,1394969,America,1554,19
2020-08-30,Trinidad_and_Tobago,TT,91,0,1394969,America,1645,19
2020-08-31,Trinidad_and_Tobago,TT,38,2,1394969,America,1683,21
2020-09-01,Trinidad_and_Tobago,TT,76,1,1394969,America,1759,22
2020-09-02,Trinidad_and_Tobago,TT,38,5,1394969,America,1797,27
2020-09-03,Trinidad_and_Tobago,TT,123,1,1394969,America,1920,28
2020-09-04,Trinidad_and_Tobago,TT,64,1,1394969,America,1984,29
2020-09-05,Trinidad_and_Tobago,TT,56,2,1394969,America,2040,31
2020-09-06,Trinidad_and_Tobago,TT,190,2,1394969,America,2230,33
2020-09-07,Trinidad_and_Tobago,TT,20,1,1394969,America,2250,34
2020-09-08,Trinidad_and_Tobago,TT,27,3,1394969,America,2277,37
2020-09-09,Trinidad_and_Tobago,TT,114,2,1394969,America,2391,39
2020-09-10,Trinidad_and_Tobago,TT,197,0,1394969,America,2588,39
2020-09-11,Trinidad_and_Tobago,TT,110,4,1394969,America,2698,43
2020-09-12,Trinidad_and_Tobago,TT,127,7,1394969,America,2825,50
2020-09-13,Trinidad_and_Tobago,TT,168,1,1394969,America,2993,51
2020-09-14,Trinidad_and_Tobago,TT,49,2,1394969,America,3042,53
2020-09-15,Trinidad_and_Tobago,TT,99,2,1394969,America,3141,55
2020-09-16,Trinidad_and_Tobago,TT,82,1,1394969,America,3223,56
2020-09-17,Trinidad_and_Tobago,TT,104,2,1394969,America,3327,58
2020-09-18,Trinidad_and_Tobago,TT,107,2,1394969,America,3434,60
2020-09-19,Trinidad_and_Tobago,TT,217,0,1394969,America,3651,60
2020-09-20,Trinidad_and_Tobago,TT,202,1,1394969,America,3853,61
2020-09-21,Trinidad_and_Tobago,TT,48,4,1394969,America,3901,65
2020-09-22,Trinidad_and_Tobago,TT,44,0,1394969,America,3945,65
2020-09-23,Trinidad_and_Tobago,TT,81,0,1394969,America,4026,65
2020-09-24,Trinidad_and_Tobago,TT,110,2,1394969,America,4136,67
2020-09-25,Trinidad_and_Tobago,TT,99,0,1394969,America,4235,67
2020-09-26,Trinidad_and_Tobago,TT,42,3,1394969,America,4277,70
2020-09-27,Trinidad_and_Tobago,TT,35,0,1394969,America,4312,70
2020-09-28,Trinidad_and_Tobago,TT,50,1,1394969,America,4362,71
2020-09-29,Trinidad_and_Tobago,TT,24,1,1394969,America,4386,72
2020-09-30,Trinidad_and_Tobago,TT,77,2,1394969,America,4463,74
2020-10-01,Trinidad_and_Tobago,TT,68,2,1394969,America,4531,76
2020-10-02,Trinidad_and_Tobago,TT,39,0,1394969,America,4570,76
2020-10-03,Trinidad_and_Tobago,TT,59,0,1394969,America,4629,76
2020-10-04,Trinidad_and_Tobago,TT,80,2,1394969,America,4709,78
2020-10-05,Trinidad_and_Tobago,TT,54,3,1394969,America,4763,81
2020-10-06,Trinidad_and_Tobago,TT,4,1,1394969,America,4767,82
2020-10-07,Trinidad_and_Tobago,TT,79,1,1394969,America,4846,83
2020-10-08,Trinidad_and_Tobago,TT,41,1,1394969,America,4887,84
2020-10-09,Trinidad_and_Tobago,TT,76,2,1394969,America,4963,86
2020-10-10,Trinidad_and_Tobago,TT,58,3,1394969,America,5021,89
2020-10-11,Trinidad_and_Tobago,TT,22,1,1394969,America,5043,90
2020-10-12,Trinidad_and_Tobago,TT,58,0,1394969,America,5101,90
2020-10-13,Trinidad_and_Tobago,TT,15,2,1394969,America,5116,92
2020-10-14,Trinidad_and_Tobago,TT,11,1,1394969,America,5127,93
2020-10-15,Trinidad_and_Tobago,TT,27,0,1394969,America,5154,93
2020-10-16,Trinidad_and_Tobago,TT,40,0,1394969,America,5194,93
2020-10-17,Trinidad_and_Tobago,TT,47,2,1394969,America,5241,95
2020-10-18,Trinidad_and_Tobago,TT,40,0,1394969,America,5281,95
2020-10-19,Trinidad_and_Tobago,TT,16,1,1394969,America,5297,96
2020-10-20,Trinidad_and_Tobago,TT,1,1,1394969,America,5298,97
2020-10-21,Trinidad_and_Tobago,TT,35,1,1394969,America,5333,98
2020-10-22,Trinidad_and_Tobago,TT,59,3,1394969,America,5392,101
2020-10-23,Trinidad_and_Tobago,TT,54,2,1394969,America,5446,103
2020-10-24,Trinidad_and_Tobago,TT,41,1,1394969,America,5487,104
2020-10-25,Trinidad_and_Tobago,TT,16,1,1394969,America,5503,105
2020-10-26,Trinidad_and_Tobago,TT,8,0,1394969,America,5511,105
2020-10-27,Trinidad_and_Tobago,TT,24,1,1394969,America,5535,106
2020-10-28,Trinidad_and_Tobago,TT,33,0,1394969,America,5568,106
2020-10-29,Trinidad_and_Tobago,TT,26,1,1394969,America,5594,107
2020-10-30,Trinidad_and_Tobago,TT,42,0,1394969,America,5636,107
2020-10-31,Trinidad_and_Tobago,TT,32,0,1394969,America,5668,107
2020-11-01,Trinidad_and_Tobago,TT,0,0,1394969,America,5668,107
2020-11-02,Trinidad_and_Tobago,TT,0,0,1394969,America,5668,107
2020-11-03,Trinidad_and_Tobago,TT,36,2,1394969,America,5704,109
2020-11-04,Trinidad_and_Tobago,TT,50,1,1394969,America,5754,110
2020-11-05,Trinidad_and_Tobago,TT,10,0,1394969,America,5764,110
2020-11-06,Trinidad_and_Tobago,TT,10,1,1394969,America,5774,111
2020-11-07,Trinidad_and_Tobago,TT,24,0,1394969,America,5798,111
2020-11-08,Trinidad_and_Tobago,TT,40,0,1394969,America,5838,111
2020-11-09,Trinidad_and_Tobago,TT,11,0,1394969,America,5849,111
2020-11-10,Trinidad_and_Tobago,TT,0,0,1394969,America,5849,111
2020-11-11,Trinidad_and_Tobago,TT,31,0,1394969,America,5880,111
2020-11-12,Trinidad_and_Tobago,TT,24,0,1394969,America,5904,111
2020-11-13,Trinidad_and_Tobago,TT,26,0,1394969,America,5930,111
2020-11-14,Trinidad_and_Tobago,TT,50,0,1394969,America,5980,111
2020-11-15,Trinidad_and_Tobago,TT,97,1,1394969,America,6077,112
2020-11-16,Trinidad_and_Tobago,TT,3,0,1394969,America,6080,112
2020-11-17,Trinidad_and_Tobago,TT,16,0,1394969,America,6096,112
2020-11-18,Trinidad_and_Tobago,TT,39,1,1394969,America,6135,113
2020-11-19,Trinidad_and_Tobago,TT,45,0,1394969,America,6180,113
2020-11-20,Trinidad_and_Tobago,TT,53,0,1394969,America,6233,113
2020-11-21,Trinidad_and_Tobago,TT,28,0,1394969,America,6261,113
2020-11-22,Trinidad_and_Tobago,TT,63,2,1394969,America,6324,115
2020-11-23,Trinidad_and_Tobago,TT,126,0,1394969,America,6450,115
2020-11-24,Trinidad_and_Tobago,TT,25,0,1394969,America,6475,115
2020-11-25,Trinidad_and_Tobago,TT,13,0,1394969,America,6488,115
2020-11-26,Trinidad_and_Tobago,TT,15,1,1394969,America,6503,116
2020-11-27,Trinidad_and_Tobago,TT,67,0,1394969,America,6570,116
2020-11-28,Trinidad_and_Tobago,TT,16,2,1394969,America,6586,118
2020-11-29,Trinidad_and_Tobago,TT,44,0,1394969,America,6630,118
2020-11-30,Trinidad_and_Tobago,TT,30,2,1394969,America,6660,120
2020-12-01,Trinidad_and_Tobago,TT,9,0,1394969,America,6669,120
2020-12-02,Trinidad_and_Tobago,TT,16,0,1394969,America,6685,120
2020-12-03,Trinidad_and_Tobago,TT,19,1,1394969,America,6704,121
2020-12-04,Trinidad_and_Tobago,TT,21,0,1394969,America,6725,121
2020-12-05,Trinidad_and_Tobago,TT,10,0,1394969,America,6735,121
2020-12-06,Trinidad_and_Tobago,TT,16,1,1394969,America,6751,122
2020-12-07,Trinidad_and_Tobago,TT,16,0,1394969,America,6767,122
2020-12-08,Trinidad_and_Tobago,TT,8,0,1394969,America,6775,122
2020-12-09,Trinidad_and_Tobago,TT,7,0,1394969,America,6782,122
2020-12-10,Trinidad_and_Tobago,TT,26,0,1394969,America,6808,122
2020-12-11,Trinidad_and_Tobago,TT,25,0,1394969,America,6833,122
2020-12-12,Trinidad_and_Tobago,TT,19,0,1394969,America,6852,122
2020-12-13,Trinidad_and_Tobago,TT,12,0,1394969,America,6864,122
2020-12-14,Trinidad_and_Tobago,TT,15,0,1394969,America,6879,122
2019-12-31,Taiwan,TW,0,0,23773881,Asia,0,0
2020-01-01,Taiwan,TW,0,0,23773881,Asia,0,0
2020-01-02,Taiwan,TW,0,0,23773881,Asia,0,0
2020-01-03,Taiwan,TW,0,0,23773881,Asia,0,0
2020-01-04,Taiwan,TW,0,0,23773881,Asia,0,0
2020-01-05,Taiwan,TW,0,0,23773881,Asia,0,0
2020-01-06,Taiwan,TW,0,0,23773881,Asia,0,0
2020-01-07,Taiwan,TW,0,0,23773881,Asia,0,0
2020-01-08,Taiwan,TW,0,0,23773881,Asia,0,0
2020-01-09,Taiwan,TW,0,0,23773881,Asia,0,0
2020-01-10,Taiwan,TW,0,0,23773881,Asia,0,0
2020-01-11,Taiwan,TW,0,0,23773881,Asia,0,0
2020-01-12,Taiwan,TW,0,0,23773881,Asia,0,0
2020-01-13,Taiwan,TW,0,0,23773881,Asia,0,0
2020-01-14,Taiwan,TW,0,0,23773881,Asia,0,0
2020-01-15,Taiwan,TW,0,0,23773881,Asia,0,0
2020-01-16,Taiwan,TW,0,0,23773881,Asia,0,0
2020-01-17,Taiwan,TW,0,0,23773881,Asia,0,0
2020-01-18,Taiwan,TW,0,0,23773881,Asia,0,0
2020-01-19,Taiwan,TW,0,0,23773881,Asia,0,0
2020-01-20,Taiwan,TW,0,0,23773881,Asia,0,0
2020-01-21,Taiwan,TW,1,0,23773881,Asia,1,0
2020-01-22,Taiwan,TW,0,0,23773881,Asia,1,0
2020-01-23,Taiwan,TW,0,0,23773881,Asia,1,0
2020-01-24,Taiwan,TW,0,0,23773881,Asia,1,0
2020-01-25,Taiwan,TW,2,0,23773881,Asia,3,0
2020-01-26,Taiwan,TW,0,0,23773881,Asia,3,0
2020-01-27,Taiwan,TW,2,0,23773881,Asia,5,0
2020-01-28,Taiwan,TW,2,0,23773881,Asia,7,0
2020-01-29,Taiwan,TW,1,0,23773881,Asia,8,0
2020-01-30,Taiwan,TW,0,0,23773881,Asia,8,0
2020-01-31,Taiwan,TW,1,0,23773881,Asia,9,0
2020-02-01,Taiwan,TW,1,0,23773881,Asia,10,0
2020-02-02,Taiwan,TW,0,0,23773881,Asia,10,0
2020-02-03,Taiwan,TW,0,0,23773881,Asia,10,0
2020-02-04,Taiwan,TW,0,0,23773881,Asia,10,0
2020-02-05,Taiwan,TW,1,0,23773881,Asia,11,0
2020-02-06,Taiwan,TW,0,0,23773881,Asia,11,0
2020-02-07,Taiwan,TW,5,0,23773881,Asia,16,0
2020-02-08,Taiwan,TW,1,0,23773881,Asia,17,0
2020-02-09,Taiwan,TW,1,0,23773881,Asia,18,0
2020-02-10,Taiwan,TW,0,0,23773881,Asia,18,0
2020-02-11,Taiwan,TW,0,0,23773881,Asia,18,0
2020-02-12,Taiwan,TW,0,0,23773881,Asia,18,0
2020-02-13,Taiwan,TW,0,0,23773881,Asia,18,0
2020-02-14,Taiwan,TW,0,0,23773881,Asia,18,0
2020-02-15,Taiwan,TW,0,0,23773881,Asia,18,0
2020-02-16,Taiwan,TW,0,0,23773881,Asia,18,0
2020-02-17,Taiwan,TW,2,1,23773881,Asia,20,1
2020-02-18,Taiwan,TW,2,0,23773881,Asia,22,1
2020-02-19,Taiwan,TW,0,0,23773881,Asia,22,1
2020-02-20,Taiwan,TW,2,0,23773881,Asia,24,1
2020-02-21,Taiwan,TW,0,0,23773881,Asia,24,1
2020-02-22,Taiwan,TW,2,0,23773881,Asia,26,1
2020-02-23,Taiwan,TW,0,0,23773881,Asia,26,1
2020-02-24,Taiwan,TW,2,0,23773881,Asia,28,1
2020-02-25,Taiwan,TW,2,0,23773881,Asia,30,1
2020-02-26,Taiwan,TW,1,0,23773881,Asia,31,1
2020-02-27,Taiwan,TW,1,0,23773881,Asia,32,1
2020-02-28,Taiwan,TW,2,0,23773881,Asia,34,1
2020-02-29,Taiwan,TW,5,0,23773881,Asia,39,1
2020-03-01,Taiwan,TW,1,0,23773881,Asia,40,1
2020-03-02,Taiwan,TW,0,0,23773881,Asia,40,1
2020-03-03,Taiwan,TW,1,0,23773881,Asia,41,1
2020-03-04,Taiwan,TW,1,0,23773881,Asia,42,1
2020-03-05,Taiwan,TW,0,0,23773881,Asia,42,1
2020-03-06,Taiwan,TW,2,0,23773881,Asia,44,1
2020-03-07,Taiwan,TW,1,0,23773881,Asia,45,1
2020-03-08,Taiwan,TW,0,0,23773881,Asia,45,1
2020-03-09,Taiwan,TW,0,0,23773881,Asia,45,1
2020-03-10,Taiwan,TW,0,0,23773881,Asia,45,1
2020-03-11,Taiwan,TW,3,0,23773881,Asia,48,1
2020-03-12,Taiwan,TW,0,0,23773881,Asia,48,1
2020-03-13,Taiwan,TW,1,0,23773881,Asia,49,1
2020-03-14,Taiwan,TW,4,0,23773881,Asia,53,1
2020-03-15,Taiwan,TW,6,0,23773881,Asia,59,1
2020-03-16,Taiwan,TW,0,0,23773881,Asia,59,1
2020-03-17,Taiwan,TW,8,0,23773881,Asia,67,1
2020-03-18,Taiwan,TW,10,0,23773881,Asia,77,1
2020-03-19,Taiwan,TW,31,0,23773881,Asia,108,1
2020-03-20,Taiwan,TW,0,0,23773881,Asia,108,1
2020-03-21,Taiwan,TW,27,1,23773881,Asia,135,2
2020-03-22,Taiwan,TW,18,0,23773881,Asia,153,2
2020-03-23,Taiwan,TW,12,0,23773881,Asia,165,2
2020-03-24,Taiwan,TW,30,0,23773881,Asia,195,2
2020-03-25,Taiwan,TW,21,0,23773881,Asia,216,2
2020-03-26,Taiwan,TW,19,0,23773881,Asia,235,2
2020-03-27,Taiwan,TW,17,0,23773881,Asia,252,2
2020-03-28,Taiwan,TW,15,0,23773881,Asia,267,2
2020-03-29,Taiwan,TW,16,0,23773881,Asia,283,2
2020-03-30,Taiwan,TW,23,3,23773881,Asia,306,5
2020-03-31,Taiwan,TW,0,0,23773881,Asia,306,5
2020-04-01,Taiwan,TW,16,0,23773881,Asia,322,5
2020-04-02,Taiwan,TW,17,0,23773881,Asia,339,5
2020-04-03,Taiwan,TW,0,0,23773881,Asia,339,5
2020-04-04,Taiwan,TW,16,0,23773881,Asia,355,5
2020-04-05,Taiwan,TW,8,0,23773881,Asia,363,5
2020-04-06,Taiwan,TW,0,0,23773881,Asia,363,5
2020-04-07,Taiwan,TW,10,0,23773881,Asia,373,5
2020-04-08,Taiwan,TW,3,0,23773881,Asia,376,5
2020-04-09,Taiwan,TW,3,0,23773881,Asia,379,5
2020-04-10,Taiwan,TW,1,0,23773881,Asia,380,5
2020-04-11,Taiwan,TW,0,0,23773881,Asia,380,5
2020-04-12,Taiwan,TW,5,1,23773881,Asia,385,6
2020-04-13,Taiwan,TW,3,0,23773881,Asia,388,6
2020-04-14,Taiwan,TW,5,0,23773881,Asia,393,6
2020-04-15,Taiwan,TW,2,0,23773881,Asia,395,6
2020-04-16,Taiwan,TW,0,0,23773881,Asia,395,6
2020-04-17,Taiwan,TW,0,0,23773881,Asia,395,6
2020-04-18,Taiwan,TW,0,0,23773881,Asia,395,6
2020-04-19,Taiwan,TW,3,0,23773881,Asia,398,6
2020-04-20,Taiwan,TW,22,0,23773881,Asia,420,6
2020-04-21,Taiwan,TW,2,0,23773881,Asia,422,6
2020-04-22,Taiwan,TW,3,0,23773881,Asia,425,6
2020-04-23,Taiwan,TW,1,0,23773881,Asia,426,6
2020-04-24,Taiwan,TW,1,0,23773881,Asia,427,6
2020-04-25,Taiwan,TW,1,0,23773881,Asia,428,6
2020-04-26,Taiwan,TW,1,0,23773881,Asia,429,6
2020-04-27,Taiwan,TW,0,0,23773881,Asia,429,6
2020-04-28,Taiwan,TW,0,0,23773881,Asia,429,6
2020-04-29,Taiwan,TW,0,0,23773881,Asia,429,6
2020-04-30,Taiwan,TW,0,0,23773881,Asia,429,6
2020-05-01,Taiwan,TW,0,0,23773881,Asia,429,6
2020-05-02,Taiwan,TW,0,0,23773881,Asia,429,6
2020-05-03,Taiwan,TW,3,0,23773881,Asia,432,6
2020-05-04,Taiwan,TW,4,0,23773881,Asia,436,6
2020-05-05,Taiwan,TW,2,0,23773881,Asia,438,6
2020-05-06,Taiwan,TW,0,0,23773881,Asia,438,6
2020-05-07,Taiwan,TW,1,0,23773881,Asia,439,6
2020-05-08,Taiwan,TW,1,0,23773881,Asia,440,6
2020-05-09,Taiwan,TW,0,0,23773881,Asia,440,6
2020-05-10,Taiwan,TW,0,0,23773881,Asia,440,6
2020-05-11,Taiwan,TW,0,0,23773881,Asia,440,6
2020-05-12,Taiwan,TW,0,1,23773881,Asia,440,7
2020-05-13,Taiwan,TW,0,0,23773881,Asia,440,7
2020-05-14,Taiwan,TW,0,0,23773881,Asia,440,7
2020-05-15,Taiwan,TW,0,0,23773881,Asia,440,7
2020-05-16,Taiwan,TW,0,0,23773881,Asia,440,7
2020-05-17,Taiwan,TW,0,0,23773881,Asia,440,7
2020-05-18,Taiwan,TW,0,0,23773881,Asia,440,7
2020-05-19,Taiwan,TW,0,0,23773881,Asia,440,7
2020-05-20,Taiwan,TW,0,0,23773881,Asia,440,7
2020-05-21,Taiwan,TW,1,0,23773881,Asia,441,7
2020-05-22,Taiwan,TW,0,0,23773881,Asia,441,7
2020-05-23,Taiwan,TW,0,0,23773881,Asia,441,7
2020-05-24,Taiwan,TW,0,0,23773881,Asia,441,7
2020-05-25,Taiwan,TW,0,0,23773881,Asia,441,7
2020-05-26,Taiwan,TW,0,0,23773881,Asia,441,7
2020-05-27,Taiwan,TW,0,0,23773881,Asia,441,7
2020-05-28,Taiwan,TW,0,0,23773881,Asia,441,7
2020-05-29,Taiwan,TW,0,0,23773881,Asia,441,7
2020-05-30,Taiwan,TW,1,0,23773881,Asia,442,7
2020-05-31,Taiwan,TW,0,0,23773881,Asia,442,7
2020-06-01,Taiwan,TW,0,0,23773881,Asia,442,7
2020-06-02,Taiwan,TW,1,0,23773881,Asia,443,7
2020-06-03,Taiwan,TW,0,0,23773881,Asia,443,7
2020-06-04,Taiwan,TW,0,0,23773881,Asia,443,7
2020-06-05,Taiwan,TW,0,0,23773881,Asia,443,7
2020-06-06,Taiwan,TW,0,0,23773881,Asia,443,7
2020-06-07,Taiwan,TW,0,0,23773881,Asia,443,7
2020-06-08,Taiwan,TW,0,0,23773881,Asia,443,7
2020-06-09,Taiwan,TW,0,0,23773881,Asia,443,7
2020-06-10,Taiwan,TW,0,0,23773881,Asia,443,7
2020-06-11,Taiwan,TW,0,0,23773881,Asia,443,7
2020-06-12,Taiwan,TW,0,0,23773881,Asia,443,7
2020-06-13,Taiwan,TW,0,0,23773881,Asia,443,7
2020-06-14,Taiwan,TW,0,0,23773881,Asia,443,7
2020-06-15,Taiwan,TW,0,0,23773881,Asia,443,7
2020-06-16,Taiwan,TW,2,0,23773881,Asia,445,7
2020-06-17,Taiwan,TW,0,0,23773881,Asia,445,7
2020-06-18,Taiwan,TW,0,0,23773881,Asia,445,7
2020-06-19,Taiwan,TW,1,0,23773881,Asia,446,7
2020-06-20,Taiwan,TW,0,0,23773881,Asia,446,7
2020-06-21,Taiwan,TW,0,0,23773881,Asia,446,7
2020-06-22,Taiwan,TW,0,0,23773881,Asia,446,7
2020-06-23,Taiwan,TW,0,0,23773881,Asia,446,7
2020-06-24,Taiwan,TW,0,0,23773881,Asia,446,7
2020-06-25,Taiwan,TW,0,0,23773881,Asia,446,7
2020-06-26,Taiwan,TW,1,0,23773881,Asia,447,7
2020-06-27,Taiwan,TW,0,0,23773881,Asia,447,7
2020-06-28,Taiwan,TW,0,0,23773881,Asia,447,7
2020-06-29,Taiwan,TW,0,0,23773881,Asia,447,7
2020-06-30,Taiwan,TW,0,0,23773881,Asia,447,7
2020-07-01,Taiwan,TW,0,0,23773881,Asia,447,7
2020-07-02,Taiwan,TW,1,0,23773881,Asia,448,7
2020-07-03,Taiwan,TW,1,0,23773881,Asia,449,7
2020-07-04,Taiwan,TW,0,0,23773881,Asia,449,7
2020-07-05,Taiwan,TW,0,0,23773881,Asia,449,7
2020-07-06,Taiwan,TW,0,0,23773881,Asia,449,7
2020-07-07,Taiwan,TW,0,0,23773881,Asia,449,7
2020-07-08,Taiwan,TW,0,0,23773881,Asia,449,7
2020-07-09,Taiwan,TW,0,0,23773881,Asia,449,7
2020-07-10,Taiwan,TW,2,0,23773881,Asia,451,7
2020-07-11,Taiwan,TW,0,0,23773881,Asia,451,7
2020-07-12,Taiwan,TW,0,0,23773881,Asia,451,7
2020-07-13,Taiwan,TW,0,0,23773881,Asia,451,7
2020-07-14,Taiwan,TW,0,0,23773881,Asia,451,7
2020-07-15,Taiwan,TW,0,0,23773881,Asia,451,7
2020-07-16,Taiwan,TW,1,0,23773881,Asia,452,7
2020-07-17,Taiwan,TW,2,0,23773881,Asia,454,7
2020-07-18,Taiwan,TW,0,0,23773881,Asia,454,7
2020-07-19,Taiwan,TW,1,0,23773881,Asia,455,7
2020-07-20,Taiwan,TW,0,0,23773881,Asia,455,7
2020-07-21,Taiwan,TW,0,0,23773881,Asia,455,7
2020-07-22,Taiwan,TW,0,0,23773881,Asia,455,7
2020-07-23,Taiwan,TW,0,0,23773881,Asia,455,7
2020-07-24,Taiwan,TW,3,0,23773881,Asia,458,7
2020-07-25,Taiwan,TW,0,0,23773881,Asia,458,7
2020-07-26,Taiwan,TW,0,0,23773881,Asia,458,7
2020-07-27,Taiwan,TW,4,0,23773881,Asia,462,7
2020-07-28,Taiwan,TW,5,0,23773881,Asia,467,7
2020-07-29,Taiwan,TW,0,0,23773881,Asia,467,7
2020-07-30,Taiwan,TW,0,0,23773881,Asia,467,7
2020-07-31,Taiwan,TW,0,0,23773881,Asia,467,7
2020-08-01,Taiwan,TW,7,0,23773881,Asia,474,7
2020-08-02,Taiwan,TW,0,0,23773881,Asia,474,7
2020-08-03,Taiwan,TW,1,0,23773881,Asia,475,7
2020-08-04,Taiwan,TW,1,0,23773881,Asia,476,7
2020-08-05,Taiwan,TW,0,0,23773881,Asia,476,7
2020-08-06,Taiwan,TW,1,0,23773881,Asia,477,7
2020-08-07,Taiwan,TW,0,0,23773881,Asia,477,7
2020-08-08,Taiwan,TW,2,0,23773881,Asia,479,7
2020-08-09,Taiwan,TW,1,0,23773881,Asia,480,7
2020-08-10,Taiwan,TW,0,0,23773881,Asia,480,7
2020-08-11,Taiwan,TW,0,0,23773881,Asia,480,7
2020-08-12,Taiwan,TW,1,0,23773881,Asia,481,7
2020-08-13,Taiwan,TW,0,0,23773881,Asia,481,7
2020-08-14,Taiwan,TW,0,0,23773881,Asia,481,7
2020-08-15,Taiwan,TW,1,0,23773881,Asia,482,7
2020-08-16,Taiwan,TW,2,0,23773881,Asia,484,7
2020-08-17,Taiwan,TW,1,0,23773881,Asia,485,7
2020-08-18,Taiwan,TW,0,0,23773881,Asia,485,7
2020-08-19,Taiwan,TW,1,0,23773881,Asia,486,7
2020-08-20,Taiwan,TW,0,0,23773881,Asia,486,7
2020-08-21,Taiwan,TW,0,0,23773881,Asia,486,7
2020-08-22,Taiwan,TW,1,0,23773881,Asia,487,7
2020-08-23,Taiwan,TW,0,0,23773881,Asia,487,7
2020-08-24,Taiwan,TW,0,0,23773881,Asia,487,7
2020-08-25,Taiwan,TW,0,0,23773881,Asia,487,7
2020-08-26,Taiwan,TW,0,0,23773881,Asia,487,7
2020-08-27,Taiwan,TW,0,0,23773881,Asia,487,7
2020-08-28,Taiwan,TW,0,0,23773881,Asia,487,7
2020-08-29,Taiwan,TW,1,0,23773881,Asia,488,7
2020-08-30,Taiwan,TW,0,0,23773881,Asia,488,7
2020-08-31,Taiwan,TW,0,0,23773881,Asia,488,7
2020-09-01,Taiwan,TW,0,0,23773881,Asia,488,7
2020-09-02,Taiwan,TW,1,0,23773881,Asia,489,7
2020-09-03,Taiwan,TW,0,0,23773881,Asia,489,7
2020-09-04,Taiwan,TW,1,0,23773881,Asia,490,7
2020-09-05,Taiwan,TW,0,0,23773881,Asia,490,7
2020-09-06,Taiwan,TW,3,0,23773881,Asia,493,7
2020-09-07,Taiwan,TW,0,0,23773881,Asia,493,7
2020-09-08,Taiwan,TW,1,0,23773881,Asia,494,7
2020-09-09,Taiwan,TW,1,0,23773881,Asia,495,7
2020-09-10,Taiwan,TW,1,0,23773881,Asia,496,7
2020-09-11,Taiwan,TW,0,0,23773881,Asia,496,7
2020-09-12,Taiwan,TW,2,0,23773881,Asia,498,7
2020-09-13,Taiwan,TW,0,0,23773881,Asia,498,7
2020-09-14,Taiwan,TW,0,0,23773881,Asia,498,7
2020-09-15,Taiwan,TW,1,0,23773881,Asia,499,7
2020-09-16,Taiwan,TW,1,0,23773881,Asia,500,7
2020-09-17,Taiwan,TW,3,0,23773881,Asia,503,7
2020-09-18,Taiwan,TW,0,0,23773881,Asia,503,7
2020-09-19,Taiwan,TW,3,0,23773881,Asia,506,7
2020-09-20,Taiwan,TW,1,0,23773881,Asia,507,7
2020-09-21,Taiwan,TW,2,0,23773881,Asia,509,7
2020-09-22,Taiwan,TW,0,0,23773881,Asia,509,7
2020-09-23,Taiwan,TW,0,0,23773881,Asia,509,7
2020-09-24,Taiwan,TW,0,0,23773881,Asia,509,7
2020-09-25,Taiwan,TW,0,0,23773881,Asia,509,7
2020-09-26,Taiwan,TW,1,0,23773881,Asia,510,7
2020-09-27,Taiwan,TW,0,0,23773881,Asia,510,7
2020-09-28,Taiwan,TW,0,0,23773881,Asia,510,7
2020-09-29,Taiwan,TW,3,0,23773881,Asia,513,7
2020-09-30,Taiwan,TW,1,0,23773881,Asia,514,7
2020-10-01,Taiwan,TW,0,0,23773881,Asia,514,7
2020-10-02,Taiwan,TW,3,0,23773881,Asia,517,7
2020-10-03,Taiwan,TW,0,0,23773881,Asia,517,7
2020-10-04,Taiwan,TW,0,0,23773881,Asia,517,7
2020-10-05,Taiwan,TW,0,0,23773881,Asia,517,7
2020-10-06,Taiwan,TW,1,0,23773881,Asia,518,7
2020-10-07,Taiwan,TW,3,0,23773881,Asia,521,7
2020-10-08,Taiwan,TW,3,0,23773881,Asia,524,7
2020-10-09,Taiwan,TW,3,0,23773881,Asia,527,7
2020-10-10,Taiwan,TW,0,0,23773881,Asia,527,7
2020-10-11,Taiwan,TW,0,0,23773881,Asia,527,7
2020-10-12,Taiwan,TW,0,0,23773881,Asia,527,7
2020-10-13,Taiwan,TW,3,0,23773881,Asia,530,7
2020-10-14,Taiwan,TW,0,0,23773881,Asia,530,7
2020-10-15,Taiwan,TW,0,0,23773881,Asia,530,7
2020-10-16,Taiwan,TW,5,0,23773881,Asia,535,7
2020-10-17,Taiwan,TW,0,0,23773881,Asia,535,7
2020-10-18,Taiwan,TW,0,0,23773881,Asia,535,7
2020-10-19,Taiwan,TW,5,0,23773881,Asia,540,7
2020-10-20,Taiwan,TW,0,0,23773881,Asia,540,7
2020-10-21,Taiwan,TW,3,0,23773881,Asia,543,7
2020-10-22,Taiwan,TW,1,0,23773881,Asia,544,7
2020-10-23,Taiwan,TW,4,0,23773881,Asia,548,7
2020-10-24,Taiwan,TW,2,0,23773881,Asia,550,7
2020-10-25,Taiwan,TW,0,0,23773881,Asia,550,7
2020-10-26,Taiwan,TW,0,0,23773881,Asia,550,7
2020-10-27,Taiwan,TW,0,0,23773881,Asia,550,7
2020-10-28,Taiwan,TW,0,0,23773881,Asia,550,7
2020-10-29,Taiwan,TW,3,0,23773881,Asia,553,7
2020-10-30,Taiwan,TW,1,0,23773881,Asia,554,7
2020-10-31,Taiwan,TW,1,0,23773881,Asia,555,7
2020-11-01,Taiwan,TW,3,0,23773881,Asia,558,7
2020-11-02,Taiwan,TW,5,0,23773881,Asia,563,7
2020-11-03,Taiwan,TW,4,0,23773881,Asia,567,7
2020-11-04,Taiwan,TW,1,0,23773881,Asia,568,7
2020-11-05,Taiwan,TW,1,0,23773881,Asia,569,7
2020-11-06,Taiwan,TW,4,0,23773881,Asia,573,7
2020-11-07,Taiwan,TW,0,0,23773881,Asia,573,7
2020-11-08,Taiwan,TW,4,0,23773881,Asia,577,7
2020-11-09,Taiwan,TW,1,0,23773881,Asia,578,7
2020-11-10,Taiwan,TW,2,0,23773881,Asia,580,7
2020-11-11,Taiwan,TW,4,0,23773881,Asia,584,7
2020-11-12,Taiwan,TW,5,0,23773881,Asia,589,7
2020-11-13,Taiwan,TW,8,0,23773881,Asia,597,7
2020-11-14,Taiwan,TW,3,0,23773881,Asia,600,7
2020-11-15,Taiwan,TW,2,0,23773881,Asia,602,7
2020-11-16,Taiwan,TW,1,0,23773881,Asia,603,7
2020-11-17,Taiwan,TW,2,0,23773881,Asia,605,7
2020-11-18,Taiwan,TW,2,0,23773881,Asia,607,7
2020-11-19,Taiwan,TW,2,0,23773881,Asia,609,7
2020-11-20,Taiwan,TW,0,0,23773881,Asia,609,7
2020-11-21,Taiwan,TW,2,0,23773881,Asia,611,7
2020-11-22,Taiwan,TW,6,0,23773881,Asia,617,7
2020-11-23,Taiwan,TW,1,0,23773881,Asia,618,7
2020-11-24,Taiwan,TW,0,0,23773881,Asia,618,7
2020-11-25,Taiwan,TW,5,0,23773881,Asia,623,7
2020-11-26,Taiwan,TW,2,0,23773881,Asia,625,7
2020-11-27,Taiwan,TW,14,0,23773881,Asia,639,7
2020-11-28,Taiwan,TW,9,0,23773881,Asia,648,7
2020-11-29,Taiwan,TW,3,0,23773881,Asia,651,7
2020-11-30,Taiwan,TW,24,0,23773881,Asia,675,7
2020-12-01,Taiwan,TW,4,0,23773881,Asia,679,7
2020-12-02,Taiwan,TW,6,0,23773881,Asia,685,7
2020-12-03,Taiwan,TW,1,0,23773881,Asia,686,7
2020-12-04,Taiwan,TW,4,0,23773881,Asia,690,7
2020-12-05,Taiwan,TW,3,0,23773881,Asia,693,7
2020-12-06,Taiwan,TW,23,0,23773881,Asia,716,7
2020-12-07,Taiwan,TW,0,0,23773881,Asia,716,7
2020-12-08,Taiwan,TW,2,0,23773881,Asia,718,7
2020-12-09,Taiwan,TW,2,0,23773881,Asia,720,7
2020-12-10,Taiwan,TW,4,0,23773881,Asia,724,7
2020-12-11,Taiwan,TW,1,0,23773881,Asia,725,7
2020-12-12,Taiwan,TW,8,0,23773881,Asia,733,7
2020-12-13,Taiwan,TW,3,0,23773881,Asia,736,7
2020-12-14,Taiwan,TW,4,0,23773881,Asia,740,7
2020-03-17,United_Republic_of_Tanzania,TZ,1,0,58005461,Africa,1,0
2020-03-18,United_Republic_of_Tanzania,TZ,0,0,58005461,Africa,1,0
2020-03-19,United_Republic_of_Tanzania,TZ,2,0,58005461,Africa,3,0
2020-03-20,United_Republic_of_Tanzania,TZ,0,0,58005461,Africa,3,0
2020-03-21,United_Republic_of_Tanzania,TZ,0,0,58005461,Africa,3,0
2020-03-22,United_Republic_of_Tanzania,TZ,3,0,58005461,Africa,6,0
2020-03-23,United_Republic_of_Tanzania,TZ,6,0,58005461,Africa,12,0
2020-03-24,United_Republic_of_Tanzania,TZ,0,0,58005461,Africa,12,0
2020-03-25,United_Republic_of_Tanzania,TZ,0,0,58005461,Africa,12,0
2020-03-26,United_Republic_of_Tanzania,TZ,0,0,58005461,Africa,12,0
2020-03-27,United_Republic_of_Tanzania,TZ,1,0,58005461,Africa,13,0
2020-03-28,United_Republic_of_Tanzania,TZ,0,0,58005461,Africa,13,0
2020-03-29,United_Republic_of_Tanzania,TZ,0,1,58005461,Africa,13,1
2020-03-30,United_Republic_of_Tanzania,TZ,1,0,58005461,Africa,14,1
2020-03-31,United_Republic_of_Tanzania,TZ,5,0,58005461,Africa,19,1
2020-04-01,United_Republic_of_Tanzania,TZ,0,0,58005461,Africa,19,1
2020-04-02,United_Republic_of_Tanzania,TZ,1,0,58005461,Africa,20,1
2020-04-03,United_Republic_of_Tanzania,TZ,1,0,58005461,Africa,21,1
2020-04-04,United_Republic_of_Tanzania,TZ,0,0,58005461,Africa,21,1
2020-04-05,United_Republic_of_Tanzania,TZ,0,0,58005461,Africa,21,1
2020-04-06,United_Republic_of_Tanzania,TZ,1,0,58005461,Africa,22,1
2020-04-07,United_Republic_of_Tanzania,TZ,2,0,58005461,Africa,24,1
2020-04-08,United_Republic_of_Tanzania,TZ,0,0,58005461,Africa,24,1
2020-04-09,United_Republic_of_Tanzania,TZ,1,0,58005461,Africa,25,1
2020-04-10,United_Republic_of_Tanzania,TZ,0,0,58005461,Africa,25,1
2020-04-11,United_Republic_of_Tanzania,TZ,7,2,58005461,Africa,32,3
2020-04-12,United_Republic_of_Tanzania,TZ,0,0,58005461,Africa,32,3
2020-04-13,United_Republic_of_Tanzania,TZ,0,0,58005461,Africa,32,3
2020-04-14,United_Republic_of_Tanzania,TZ,14,0,58005461,Africa,46,3
2020-04-15,United_Republic_of_Tanzania,TZ,7,0,58005461,Africa,53,3
2020-04-16,United_Republic_of_Tanzania,TZ,35,1,58005461,Africa,88,4
2020-04-17,United_Republic_of_Tanzania,TZ,6,0,58005461,Africa,94,4
2020-04-18,United_Republic_of_Tanzania,TZ,53,1,58005461,Africa,147,5
2020-04-19,United_Republic_of_Tanzania,TZ,1,0,58005461,Africa,148,5
2020-04-20,United_Republic_of_Tanzania,TZ,22,0,58005461,Africa,170,5
2020-04-21,United_Republic_of_Tanzania,TZ,0,0,58005461,Africa,170,5
2020-04-22,United_Republic_of_Tanzania,TZ,84,3,58005461,Africa,254,8
2020-04-23,United_Republic_of_Tanzania,TZ,31,2,58005461,Africa,285,10
2020-04-24,United_Republic_of_Tanzania,TZ,0,0,58005461,Africa,285,10
2020-04-25,United_Republic_of_Tanzania,TZ,15,0,58005461,Africa,300,10
2020-04-26,United_Republic_of_Tanzania,TZ,0,0,58005461,Africa,300,10
2020-04-27,United_Republic_of_Tanzania,TZ,0,0,58005461,Africa,300,10
2020-04-28,United_Republic_of_Tanzania,TZ,0,0,58005461,Africa,300,10
2020-04-29,United_Republic_of_Tanzania,TZ,6,0,58005461,Africa,306,10
2020-04-30,United_Republic_of_Tanzania,TZ,174,6,58005461,Africa,480,16
2020-05-01,United_Republic_of_Tanzania,TZ,0,0,58005461,Africa,480,16
2020-05-02,United_Republic_of_Tanzania,TZ,0,0,58005461,Africa,480,16
2020-05-03,United_Republic_of_Tanzania,TZ,0,0,58005461,Africa,480,16
2020-05-04,United_Republic_of_Tanzania,TZ,0,0,58005461,Africa,480,16
2020-05-05,United_Republic_of_Tanzania,TZ,0,2,58005461,Africa,480,18
2020-05-06,United_Republic_of_Tanzania,TZ,0,0,58005461,Africa,480,18
2020-05-07,United_Republic_of_Tanzania,TZ,0,0,58005461,Africa,480,18
2020-05-08,United_Republic_of_Tanzania,TZ,29,3,58005461,Africa,509,21
2020-05-09,United_Republic_of_Tanzania,TZ,0,0,58005461,Africa,509,21
2020-05-10,United_Republic_of_Tanzania,TZ,0,0,58005461,Africa,509,21
2020-05-11,United_Republic_of_Tanzania,TZ,0,0,58005461,Africa,509,21
2020-05-12,United_Republic_of_Tanzania,TZ,0,0,58005461,Africa,509,21
2020-05-13,United_Republic_of_Tanzania,TZ,0,0,58005461,Africa,509,21
2020-05-14,United_Republic_of_Tanzania,TZ,0,0,58005461,Africa,509,21
2020-05-15,United_Republic_of_Tanzania,TZ,0,0,58005461,Africa,509,21
2020-05-16,United_Republic_of_Tanzania,TZ,0,0,58005461,Africa,509,21
2020-05-17,United_Republic_of_Tanzania,TZ,0,0,58005461,Africa,509,21
2020-05-18,United_Republic_of_Tanzania,TZ,0,0,58005461,Africa,509,21
2020-05-19,United_Republic_of_Tanzania,TZ,0,0,58005461,Africa,509,21
2020-05-20,United_Republic_of_Tanzania,TZ,0,0,58005461,Africa,509,21
2020-05-21,United_Republic_of_Tanzania,TZ,0,0,58005461,Africa,509,21
2020-05-22,United_Republic_of_Tanzania,TZ,0,0,58005461,Africa,509,21
2020-05-23,United_Republic_of_Tanzania,TZ,0,0,58005461,Africa,509,21
2020-05-24,United_Republic_of_Tanzania,TZ,0,0,58005461,Africa,509,21
2020-05-25,United_Republic_of_Tanzania,TZ,0,0,58005461,Africa,509,21
2020-05-26,United_Republic_of_Tanzania,TZ,0,0,58005461,Africa,509,21
2020-05-27,United_Republic_of_Tanzania,TZ,0,0,58005461,Africa,509,21
2020-05-28,United_Republic_of_Tanzania,TZ,0,0,58005461,Africa,509,21
2020-05-29,United_Republic_of_Tanzania,TZ,0,0,58005461,Africa,509,21
2020-05-30,United_Republic_of_Tanzania,TZ,0,0,58005461,Africa,509,21
2020-05-31,United_Republic_of_Tanzania,TZ,0,0,58005461,Africa,509,21
2020-06-01,United_Republic_of_Tanzania,TZ,0,0,58005461,Africa,509,21
2020-06-02,United_Republic_of_Tanzania,TZ,0,0,58005461,Africa,509,21
2020-06-03,United_Republic_of_Tanzania,TZ,0,0,58005461,Africa,509,21
2020-06-04,United_Republic_of_Tanzania,TZ,0,0,58005461,Africa,509,21
2020-06-05,United_Republic_of_Tanzania,TZ,0,0,58005461,Africa,509,21
2020-06-06,United_Republic_of_Tanzania,TZ,0,0,58005461,Africa,509,21
2020-06-07,United_Republic_of_Tanzania,TZ,0,0,58005461,Africa,509,21
2020-06-08,United_Republic_of_Tanzania,TZ,0,0,58005461,Africa,509,21
2020-06-09,United_Republic_of_Tanzania,TZ,0,0,58005461,Africa,509,21
2020-06-10,United_Republic_of_Tanzania,TZ,0,0,58005461,Africa,509,21
2020-06-11,United_Republic_of_Tanzania,TZ,0,0,58005461,Africa,509,21
2020-06-12,United_Republic_of_Tanzania,TZ,0,0,58005461,Africa,509,21
2020-06-13,United_Republic_of_Tanzania,TZ,0,0,58005461,Africa,509,21
2020-06-14,United_Republic_of_Tanzania,TZ,0,0,58005461,Africa,509,21
2020-06-15,United_Republic_of_Tanzania,TZ,0,0,58005461,Africa,509,21
2020-06-16,United_Republic_of_Tanzania,TZ,0,0,58005461,Africa,509,21
2020-06-17,United_Republic_of_Tanzania,TZ,0,0,58005461,Africa,509,21
2020-06-18,United_Republic_of_Tanzania,TZ,0,0,58005461,Africa,509,21
2020-06-19,United_Republic_of_Tanzania,TZ,0,0,58005461,Africa,509,21
2020-06-20,United_Republic_of_Tanzania,TZ,0,0,58005461,Africa,509,21
2020-06-21,United_Republic_of_Tanzania,TZ,0,0,58005461,Africa,509,21
2020-06-22,United_Republic_of_Tanzania,TZ,0,0,58005461,Africa,509,21
2020-06-23,United_Republic_of_Tanzania,TZ,0,0,58005461,Africa,509,21
2020-06-24,United_Republic_of_Tanzania,TZ,0,0,58005461,Africa,509,21
2020-06-25,United_Republic_of_Tanzania,TZ,0,0,58005461,Africa,509,21
2020-06-26,United_Republic_of_Tanzania,TZ,0,0,58005461,Africa,509,21
2020-06-27,United_Republic_of_Tanzania,TZ,0,0,58005461,Africa,509,21
2020-06-28,United_Republic_of_Tanzania,TZ,0,0,58005461,Africa,509,21
2020-06-29,United_Republic_of_Tanzania,TZ,0,0,58005461,Africa,509,21
2020-06-30,United_Republic_of_Tanzania,TZ,0,0,58005461,Africa,509,21
2020-07-01,United_Republic_of_Tanzania,TZ,0,0,58005461,Africa,509,21
2020-07-02,United_Republic_of_Tanzania,TZ,0,0,58005461,Africa,509,21
2020-07-03,United_Republic_of_Tanzania,TZ,0,0,58005461,Africa,509,21
2020-07-04,United_Republic_of_Tanzania,TZ,0,0,58005461,Africa,509,21
2020-07-05,United_Republic_of_Tanzania,TZ,0,0,58005461,Africa,509,21
2020-07-06,United_Republic_of_Tanzania,TZ,0,0,58005461,Africa,509,21
2020-07-07,United_Republic_of_Tanzania,TZ,0,0,58005461,Africa,509,21
2020-07-08,United_Republic_of_Tanzania,TZ,0,0,58005461,Africa,509,21
2020-07-09,United_Republic_of_Tanzania,TZ,0,0,58005461,Africa,509,21
2020-07-10,United_Republic_of_Tanzania,TZ,0,0,58005461,Africa,509,21
2020-07-11,United_Republic_of_Tanzania,TZ,0,0,58005461,Africa,509,21
2020-07-12,United_Republic_of_Tanzania,TZ,0,0,58005461,Africa,509,21
2020-07-13,United_Republic_of_Tanzania,TZ,0,0,58005461,Africa,509,21
2020-07-14,United_Republic_of_Tanzania,TZ,0,0,58005461,Africa,509,21
2020-07-15,United_Republic_of_Tanzania,TZ,0,0,58005461,Africa,509,21
2020-07-16,United_Republic_of_Tanzania,TZ,0,0,58005461,Africa,509,21
2020-07-17,United_Republic_of_Tanzania,TZ,0,0,58005461,Africa,509,21
2020-07-18,United_Republic_of_Tanzania,TZ,0,0,58005461,Africa,509,21
2020-07-19,United_Republic_of_Tanzania,TZ,0,0,58005461,Africa,509,21
2020-07-20,United_Republic_of_Tanzania,TZ,0,0,58005461,Africa,509,21
2020-07-21,United_Republic_of_Tanzania,TZ,0,0,58005461,Africa,509,21
2020-07-22,United_Republic_of_Tanzania,TZ,0,0,58005461,Africa,509,21
2020-07-23,United_Republic_of_Tanzania,TZ,0,0,58005461,Africa,509,21
2020-07-24,United_Republic_of_Tanzania,TZ,0,0,58005461,Africa,509,21
2020-07-25,United_Republic_of_Tanzania,TZ,0,0,58005461,Africa,509,21
2020-07-26,United_Republic_of_Tanzania,TZ,0,0,58005461,Africa,509,21
2020-07-27,United_Republic_of_Tanzania,TZ,0,0,58005461,Africa,509,21
2020-07-28,United_Republic_of_Tanzania,TZ,0,0,58005461,Africa,509,21
2020-07-29,United_Republic_of_Tanzania,TZ,0,0,58005461,Africa,509,21
2020-07-30,United_Republic_of_Tanzania,TZ,0,0,58005461,Africa,509,21
2020-07-31,United_Republic_of_Tanzania,TZ,0,0,58005461,Africa,509,21
2020-08-01,United_Republic_of_Tanzania,TZ,0,0,58005461,Africa,509,21
2020-08-02,United_Republic_of_Tanzania,TZ,0,0,58005461,Africa,509,21
2020-08-03,United_Republic_of_Tanzania,TZ,0,0,58005461,Africa,509,21
2020-08-04,United_Republic_of_Tanzania,TZ,0,0,58005461,Africa,509,21
2020-08-05,United_Republic_of_Tanzania,TZ,0,0,58005461,Africa,509,21
2020-08-06,United_Republic_of_Tanzania,TZ,0,0,58005461,Africa,509,21
2020-08-07,United_Republic_of_Tanzania,TZ,0,0,58005461,Africa,509,21
2020-08-08,United_Republic_of_Tanzania,TZ,0,0,58005461,Africa,509,21
2020-08-09,United_Republic_of_Tanzania,TZ,0,0,58005461,Africa,509,21
2020-08-10,United_Republic_of_Tanzania,TZ,0,0,58005461,Africa,509,21
2020-08-11,United_Republic_of_Tanzania,TZ,0,0,58005461,Africa,509,21
2020-08-12,United_Republic_of_Tanzania,TZ,0,0,58005461,Africa,509,21
2020-08-13,United_Republic_of_Tanzania,TZ,0,0,58005461,Africa,509,21
2020-08-14,United_Republic_of_Tanzania,TZ,0,0,58005461,Africa,509,21
2020-08-15,United_Republic_of_Tanzania,TZ,0,0,58005461,Africa,509,21
2020-08-16,United_Republic_of_Tanzania,TZ,0,0,58005461,Africa,509,21
2020-08-17,United_Republic_of_Tanzania,TZ,0,0,58005461,Africa,509,21
2020-08-18,United_Republic_of_Tanzania,TZ,0,0,58005461,Africa,509,21
2020-08-19,United_Republic_of_Tanzania,TZ,0,0,58005461,Africa,509,21
2020-08-20,United_Republic_of_Tanzania,TZ,0,0,58005461,Africa,509,21
2020-08-21,United_Republic_of_Tanzania,TZ,0,0,58005461,Africa,509,21
2020-08-22,United_Republic_of_Tanzania,TZ,0,0,58005461,Africa,509,21
2020-08-23,United_Republic_of_Tanzania,TZ,0,0,58005461,Africa,509,21
2020-08-24,United_Republic_of_Tanzania,TZ,0,0,58005461,Africa,509,21
2020-08-25,United_Republic_of_Tanzania,TZ,0,0,58005461,Africa,509,21
2020-08-26,United_Republic_of_Tanzania,TZ,0,0,58005461,Africa,509,21
2020-08-27,United_Republic_of_Tanzania,TZ,0,0,58005461,Africa,509,21
2020-08-28,United_Republic_of_Tanzania,TZ,0,0,58005461,Africa,509,21
2020-08-29,United_Republic_of_Tanzania,TZ,0,0,58005461,Africa,509,21
2020-08-30,United_Republic_of_Tanzania,TZ,0,0,58005461,Africa,509,21
2020-08-31,United_Republic_of_Tanzania,TZ,0,0,58005461,Africa,509,21
2020-09-01,United_Republic_of_Tanzania,TZ,0,0,58005461,Africa,509,21
2020-09-02,United_Republic_of_Tanzania,TZ,0,0,58005461,Africa,509,21
2020-09-03,United_Republic_of_Tanzania,TZ,0,0,58005461,Africa,509,21
2020-09-04,United_Republic_of_Tanzania,TZ,0,0,58005461,Africa,509,21
2020-09-05,United_Republic_of_Tanzania,TZ,0,0,58005461,Africa,509,21
2020-09-06,United_Republic_of_Tanzania,TZ,0,0,58005461,Africa,509,21
2020-09-07,United_Republic_of_Tanzania,TZ,0,0,58005461,Africa,509,21
2020-09-08,United_Republic_of_Tanzania,TZ,0,0,58005461,Africa,509,21
2020-09-09,United_Republic_of_Tanzania,TZ,0,0,58005461,Africa,509,21
2020-09-10,United_Republic_of_Tanzania,TZ,0,0,58005461,Africa,509,21
2020-09-11,United_Republic_of_Tanzania,TZ,0,0,58005461,Africa,509,21
2020-09-12,United_Republic_of_Tanzania,TZ,0,0,58005461,Africa,509,21
2020-09-13,United_Republic_of_Tanzania,TZ,0,0,58005461,Africa,509,21
2020-09-14,United_Republic_of_Tanzania,TZ,0,0,58005461,Africa,509,21
2020-09-15,United_Republic_of_Tanzania,TZ,0,0,58005461,Africa,509,21
2020-09-16,United_Republic_of_Tanzania,TZ,0,0,58005461,Africa,509,21
2020-09-17,United_Republic_of_Tanzania,TZ,0,0,58005461,Africa,509,21
2020-09-18,United_Republic_of_Tanzania,TZ,0,0,58005461,Africa,509,21
2020-09-19,United_Republic_of_Tanzania,TZ,0,0,58005461,Africa,509,21
2020-09-20,United_Republic_of_Tanzania,TZ,0,0,58005461,Africa,509,21
2020-09-21,United_Republic_of_Tanzania,TZ,0,0,58005461,Africa,509,21
2020-09-22,United_Republic_of_Tanzania,TZ,0,0,58005461,Africa,509,21
2020-09-23,United_Republic_of_Tanzania,TZ,0,0,58005461,Africa,509,21
2020-09-24,United_Republic_of_Tanzania,TZ,0,0,58005461,Africa,509,21
2020-09-25,United_Republic_of_Tanzania,TZ,0,0,58005461,Africa,509,21
2020-09-26,United_Republic_of_Tanzania,TZ,0,0,58005461,Africa,509,21
2020-09-27,United_Republic_of_Tanzania,TZ,0,0,58005461,Africa,509,21
2020-09-28,United_Republic_of_Tanzania,TZ,0,0,58005461,Africa,509,21
2020-09-29,United_Republic_of_Tanzania,TZ,0,0,58005461,Africa,509,21
2020-09-30,United_Republic_of_Tanzania,TZ,0,0,58005461,Africa,509,21
2020-10-01,United_Republic_of_Tanzania,TZ,0,0,58005461,Africa,509,21
2020-10-02,United_Republic_of_Tanzania,TZ,0,0,58005461,Africa,509,21
2020-10-03,United_Republic_of_Tanzania,TZ,0,0,58005461,Africa,509,21
2020-10-04,United_Republic_of_Tanzania,TZ,0,0,58005461,Africa,509,21
2020-10-05,United_Republic_of_Tanzania,TZ,0,0,58005461,Africa,509,21
2020-10-06,United_Republic_of_Tanzania,TZ,0,0,58005461,Africa,509,21
2020-10-07,United_Republic_of_Tanzania,TZ,0,0,58005461,Africa,509,21
2020-10-08,United_Republic_of_Tanzania,TZ,0,0,58005461,Africa,509,21
2020-10-09,United_Republic_of_Tanzania,TZ,0,0,58005461,Africa,509,21
2020-10-10,United_Republic_of_Tanzania,TZ,0,0,58005461,Africa,509,21
2020-10-11,United_Republic_of_Tanzania,TZ,0,0,58005461,Africa,509,21
2020-10-12,United_Republic_of_Tanzania,TZ,0,0,58005461,Africa,509,21
2020-10-13,United_Republic_of_Tanzania,TZ,0,0,58005461,Africa,509,21
2020-10-14,United_Republic_of_Tanzania,TZ,0,0,58005461,Africa,509,21
2020-10-15,United_Republic_of_Tanzania,TZ,0,0,58005461,Africa,509,21
2020-10-16,United_Republic_of_Tanzania,TZ,0,0,58005461,Africa,509,21
2020-10-17,United_Republic_of_Tanzania,TZ,0,0,58005461,Africa,509,21
2020-10-18,United_Republic_of_Tanzania,TZ,0,0,58005461,Africa,509,21
2020-10-19,United_Republic_of_Tanzania,TZ,0,0,58005461,Africa,509,21
2020-10-20,United_Republic_of_Tanzania,TZ,0,0,58005461,Africa,509,21
2020-10-21,United_Republic_of_Tanzania,TZ,0,0,58005461,Africa,509,21
2020-10-22,United_Republic_of_Tanzania,TZ,0,0,58005461,Africa,509,21
2020-10-23,United_Republic_of_Tanzania,TZ,0,0,58005461,Africa,509,21
2020-10-24,United_Republic_of_Tanzania,TZ,0,0,58005461,Africa,509,21
2020-10-25,United_Republic_of_Tanzania,TZ,0,0,58005461,Africa,509,21
2020-10-26,United_Republic_of_Tanzania,TZ,0,0,58005461,Africa,509,21
2020-10-27,United_Republic_of_Tanzania,TZ,0,0,58005461,Africa,509,21
2020-10-28,United_Republic_of_Tanzania,TZ,0,0,58005461,Africa,509,21
2020-10-29,United_Republic_of_Tanzania,TZ,0,0,58005461,Africa,509,21
2020-10-30,United_Republic_of_Tanzania,TZ,0,0,58005461,Africa,509,21
2020-10-31,United_Republic_of_Tanzania,TZ,0,0,58005461,Africa,509,21
2020-11-01,United_Republic_of_Tanzania,TZ,0,0,58005461,Africa,509,21
2020-11-02,United_Republic_of_Tanzania,TZ,0,0,58005461,Africa,509,21
2020-11-03,United_Republic_of_Tanzania,TZ,0,0,58005461,Africa,509,21
2020-11-04,United_Republic_of_Tanzania,TZ,0,0,58005461,Africa,509,21
2020-11-05,United_Republic_of_Tanzania,TZ,0,0,58005461,Africa,509,21
2020-11-06,United_Republic_of_Tanzania,TZ,0,0,58005461,Africa,509,21
2020-11-07,United_Republic_of_Tanzania,TZ,0,0,58005461,Africa,509,21
2020-11-08,United_Republic_of_Tanzania,TZ,0,0,58005461,Africa,509,21
2020-11-09,United_Republic_of_Tanzania,TZ,0,0,58005461,Africa,509,21
2020-11-10,United_Republic_of_Tanzania,TZ,0,0,58005461,Africa,509,21
2020-11-11,United_Republic_of_Tanzania,TZ,0,0,58005461,Africa,509,21
2020-11-12,United_Republic_of_Tanzania,TZ,0,0,58005461,Africa,509,21
2020-11-13,United_Republic_of_Tanzania,TZ,0,0,58005461,Africa,509,21
2020-11-14,United_Republic_of_Tanzania,TZ,0,0,58005461,Africa,509,21
2020-11-15,United_Republic_of_Tanzania,TZ,0,0,58005461,Africa,509,21
2020-11-16,United_Republic_of_Tanzania,TZ,0,0,58005461,Africa,509,21
2020-11-17,United_Republic_of_Tanzania,TZ,0,0,58005461,Africa,509,21
2020-11-18,United_Republic_of_Tanzania,TZ,0,0,58005461,Africa,509,21
2020-11-19,United_Republic_of_Tanzania,TZ,0,0,58005461,Africa,509,21
2020-11-20,United_Republic_of_Tanzania,TZ,0,0,58005461,Africa,509,21
2020-11-21,United_Republic_of_Tanzania,TZ,0,0,58005461,Africa,509,21
2020-11-22,United_Republic_of_Tanzania,TZ,0,0,58005461,Africa,509,21
2020-11-23,United_Republic_of_Tanzania,TZ,0,0,58005461,Africa,509,21
2020-11-24,United_Republic_of_Tanzania,TZ,0,0,58005461,Africa,509,21
2020-11-25,United_Republic_of_Tanzania,TZ,0,0,58005461,Africa,509,21
2020-11-26,United_Republic_of_Tanzania,TZ,0,0,58005461,Africa,509,21
2020-11-27,United_Republic_of_Tanzania,TZ,0,0,58005461,Africa,509,21
2020-11-28,United_Republic_of_Tanzania,TZ,0,0,58005461,Africa,509,21
2020-11-29,United_Republic_of_Tanzania,TZ,0,0,58005461,Africa,509,21
2020-11-30,United_Republic_of_Tanzania,TZ,0,0,58005461,Africa,509,21
2020-12-01,United_Republic_of_Tanzania,TZ,0,0,58005461,Africa,509,21
2020-12-02,United_Republic_of_Tanzania,TZ,0,0,58005461,Africa,509,21
2020-12-03,United_Republic_of_Tanzania,TZ,0,0,58005461,Africa,509,21
2020-12-04,United_Republic_of_Tanzania,TZ,0,0,58005461,Africa,509,21
2020-12-05,United_Republic_of_Tanzania,TZ,0,0,58005461,Africa,509,21
2020-12-06,United_Republic_of_Tanzania,TZ,0,0,58005461,Africa,509,21
2020-12-07,United_Republic_of_Tanzania,TZ,0,0,58005461,Africa,509,21
2020-12-08,United_Republic_of_Tanzania,TZ,0,0,58005461,Africa,509,21
2020-12-09,United_Republic_of_Tanzania,TZ,0,0,58005461,Africa,509,21
2020-12-10,United_Republic_of_Tanzania,TZ,0,0,58005461,Africa,509,21
2020-12-11,United_Republic_of_Tanzania,TZ,0,0,58005461,Africa,509,21
2020-12-12,United_Republic_of_Tanzania,TZ,0,0,58005461,Africa,509,21
2020-12-13,United_Republic_of_Tanzania,TZ,0,0,58005461,Africa,509,21
2020-12-14,United_Republic_of_Tanzania,TZ,0,0,58005461,Africa,509,21
2020-03-04,Ukraine,UA,1,0,43993643,Europe,1,0
2020-03-13,Ukraine,UA,2,0,43993643,Europe,3,0
2020-03-16,Ukraine,UA,0,0,43993643,Europe,3,0
2020-03-17,Ukraine,UA,2,0,43993643,Europe,5,0
2020-03-18,Ukraine,UA,9,0,43993643,Europe,14,0
2020-03-19,Ukraine,UA,5,2,43993643,Europe,19,2
2020-03-20,Ukraine,UA,7,0,43993643,Europe,26,2
2020-03-21,Ukraine,UA,0,1,43993643,Europe,26,3
2020-03-22,Ukraine,UA,15,0,43993643,Europe,41,3
2020-03-23,Ukraine,UA,6,0,43993643,Europe,47,3
2020-03-24,Ukraine,UA,26,0,43993643,Europe,73,3
2020-03-25,Ukraine,UA,11,0,43993643,Europe,84,3
2020-03-26,Ukraine,UA,29,1,43993643,Europe,113,4
2020-03-27,Ukraine,UA,43,1,43993643,Europe,156,5
2020-03-28,Ukraine,UA,62,0,43993643,Europe,218,5
2020-03-29,Ukraine,UA,93,3,43993643,Europe,311,8
2020-03-30,Ukraine,UA,107,1,43993643,Europe,418,9
2020-03-31,Ukraine,UA,62,2,43993643,Europe,480,11
2020-04-01,Ukraine,UA,69,2,43993643,Europe,549,13
2020-04-02,Ukraine,UA,245,7,43993643,Europe,794,20
2020-04-03,Ukraine,UA,103,2,43993643,Europe,897,22
2020-04-04,Ukraine,UA,175,5,43993643,Europe,1072,27
2020-04-05,Ukraine,UA,153,5,43993643,Europe,1225,32
2020-04-06,Ukraine,UA,83,5,43993643,Europe,1308,37
2020-04-07,Ukraine,UA,11,1,43993643,Europe,1319,38
2020-04-08,Ukraine,UA,143,7,43993643,Europe,1462,45
2020-04-09,Ukraine,UA,206,7,43993643,Europe,1668,52
2020-04-10,Ukraine,UA,224,5,43993643,Europe,1892,57
2020-04-11,Ukraine,UA,311,12,43993643,Europe,2203,69
2020-04-12,Ukraine,UA,308,4,43993643,Europe,2511,73
2020-04-13,Ukraine,UA,266,10,43993643,Europe,2777,83
2020-04-14,Ukraine,UA,325,10,43993643,Europe,3102,93
2020-04-15,Ukraine,UA,270,5,43993643,Europe,3372,98
2020-04-16,Ukraine,UA,392,10,43993643,Europe,3764,108
2020-04-17,Ukraine,UA,397,8,43993643,Europe,4161,116
2020-04-18,Ukraine,UA,301,9,43993643,Europe,4462,125
2020-04-19,Ukraine,UA,644,8,43993643,Europe,5106,133
2020-04-20,Ukraine,UA,343,8,43993643,Europe,5449,141
2020-04-21,Ukraine,UA,261,10,43993643,Europe,5710,151
2020-04-22,Ukraine,UA,415,10,43993643,Europe,6125,161
2020-04-23,Ukraine,UA,467,13,43993643,Europe,6592,174
2020-04-24,Ukraine,UA,578,13,43993643,Europe,7170,187
2020-04-25,Ukraine,UA,477,6,43993643,Europe,7647,193
2020-04-26,Ukraine,UA,478,8,43993643,Europe,8125,201
2020-04-27,Ukraine,UA,492,8,43993643,Europe,8617,209
2020-04-28,Ukraine,UA,392,11,43993643,Europe,9009,220
2020-04-29,Ukraine,UA,401,19,43993643,Europe,9410,239
2020-04-30,Ukraine,UA,456,11,43993643,Europe,9866,250
2020-05-01,Ukraine,UA,540,11,43993643,Europe,10406,261
2020-05-02,Ukraine,UA,455,11,43993643,Europe,10861,272
2020-05-03,Ukraine,UA,550,7,43993643,Europe,11411,279
2020-05-04,Ukraine,UA,502,9,43993643,Europe,11913,288
2020-05-05,Ukraine,UA,418,15,43993643,Europe,12331,303
2020-05-06,Ukraine,UA,366,13,43993643,Europe,12697,316
2020-05-07,Ukraine,UA,487,11,43993643,Europe,13184,327
2020-05-08,Ukraine,UA,507,13,43993643,Europe,13691,340
2020-05-09,Ukraine,UA,504,21,43993643,Europe,14195,361
2020-05-10,Ukraine,UA,515,15,43993643,Europe,14710,376
2020-05-11,Ukraine,UA,522,15,43993643,Europe,15232,391
2020-05-12,Ukraine,UA,416,17,43993643,Europe,15648,408
2020-05-13,Ukraine,UA,375,17,43993643,Europe,16023,425
2020-05-14,Ukraine,UA,402,14,43993643,Europe,16425,439
2020-05-15,Ukraine,UA,422,17,43993643,Europe,16847,456
2020-05-16,Ukraine,UA,483,20,43993643,Europe,17330,476
2020-05-17,Ukraine,UA,528,21,43993643,Europe,17858,497
2020-05-18,Ukraine,UA,433,17,43993643,Europe,18291,514
2020-05-19,Ukraine,UA,325,21,43993643,Europe,18616,535
2020-05-20,Ukraine,UA,260,13,43993643,Europe,18876,548
2020-05-21,Ukraine,UA,354,16,43993643,Europe,19230,564
2020-05-22,Ukraine,UA,476,15,43993643,Europe,19706,579
2020-05-23,Ukraine,UA,442,9,43993643,Europe,20148,588
2020-05-24,Ukraine,UA,432,17,43993643,Europe,20580,605
2020-05-25,Ukraine,UA,406,12,43993643,Europe,20986,617
2020-05-26,Ukraine,UA,259,6,43993643,Europe,21245,623
2020-05-27,Ukraine,UA,339,21,43993643,Europe,21584,644
2020-05-28,Ukraine,UA,321,14,43993643,Europe,21905,658
2020-05-29,Ukraine,UA,477,11,43993643,Europe,22382,669
2020-05-30,Ukraine,UA,429,10,43993643,Europe,22811,679
2020-05-31,Ukraine,UA,393,17,43993643,Europe,23204,696
2020-06-01,Ukraine,UA,468,12,43993643,Europe,23672,708
2020-06-02,Ukraine,UA,340,10,43993643,Europe,24012,718
2020-06-03,Ukraine,UA,328,9,43993643,Europe,24340,727
2020-06-04,Ukraine,UA,483,8,43993643,Europe,24823,735
2020-06-05,Ukraine,UA,588,12,43993643,Europe,25411,747
2020-06-06,Ukraine,UA,553,15,43993643,Europe,25964,762
2020-06-07,Ukraine,UA,550,15,43993643,Europe,26514,777
2020-06-08,Ukraine,UA,485,11,43993643,Europe,26999,788
2020-06-09,Ukraine,UA,463,9,43993643,Europe,27462,797
2020-06-10,Ukraine,UA,394,13,43993643,Europe,27856,810
2020-06-11,Ukraine,UA,525,23,43993643,Europe,28381,833
2020-06-12,Ukraine,UA,689,21,43993643,Europe,29070,854
2020-06-13,Ukraine,UA,683,16,43993643,Europe,29753,870
2020-06-14,Ukraine,UA,753,10,43993643,Europe,30506,880
2020-06-15,Ukraine,UA,648,9,43993643,Europe,31154,889
2020-06-16,Ukraine,UA,656,12,43993643,Europe,31810,901
2020-06-17,Ukraine,UA,666,11,43993643,Europe,32476,912
2020-06-18,Ukraine,UA,758,31,43993643,Europe,33234,943
2020-06-19,Ukraine,UA,829,23,43993643,Europe,34063,966
2020-06-20,Ukraine,UA,921,19,43993643,Europe,34984,985
2020-06-21,Ukraine,UA,841,9,43993643,Europe,35825,994
2020-06-22,Ukraine,UA,735,8,43993643,Europe,36560,1002
2020-06-23,Ukraine,UA,681,10,43993643,Europe,37241,1012
2020-06-24,Ukraine,UA,833,23,43993643,Europe,38074,1035
2020-06-25,Ukraine,UA,940,16,43993643,Europe,39014,1051
2020-06-26,Ukraine,UA,994,16,43993643,Europe,40008,1067
2020-06-27,Ukraine,UA,1109,19,43993643,Europe,41117,1086
2020-06-28,Ukraine,UA,948,24,43993643,Europe,42065,1110
2020-06-29,Ukraine,UA,917,19,43993643,Europe,42982,1129
2020-06-30,Ukraine,UA,646,18,43993643,Europe,43628,1147
2020-07-01,Ukraine,UA,706,12,43993643,Europe,44334,1159
2020-07-02,Ukraine,UA,664,14,43993643,Europe,44998,1173
2020-07-03,Ukraine,UA,889,12,43993643,Europe,45887,1185
2020-07-04,Ukraine,UA,876,27,43993643,Europe,46763,1212
2020-07-05,Ukraine,UA,914,15,43993643,Europe,47677,1227
2020-07-06,Ukraine,UA,823,22,43993643,Europe,48500,1249
2020-07-07,Ukraine,UA,543,13,43993643,Europe,49043,1262
2020-07-08,Ukraine,UA,564,21,43993643,Europe,49607,1283
2020-07-09,Ukraine,UA,807,23,43993643,Europe,50414,1306
2020-07-10,Ukraine,UA,810,21,43993643,Europe,51224,1327
2020-07-11,Ukraine,UA,819,18,43993643,Europe,52043,1345
2020-07-12,Ukraine,UA,800,27,43993643,Europe,52843,1372
2020-07-13,Ukraine,UA,678,11,43993643,Europe,53521,1383
2020-07-14,Ukraine,UA,612,15,43993643,Europe,54133,1398
2020-07-15,Ukraine,UA,638,14,43993643,Europe,54771,1412
2020-07-16,Ukraine,UA,836,15,43993643,Europe,55607,1427
2020-07-17,Ukraine,UA,848,18,43993643,Europe,56455,1445
2020-07-18,Ukraine,UA,809,11,43993643,Europe,57264,1456
2020-07-19,Ukraine,UA,847,21,43993643,Europe,58111,1477
2020-07-20,Ukraine,UA,731,8,43993643,Europe,58842,1485
2020-07-21,Ukraine,UA,651,13,43993643,Europe,59493,1498
2020-07-22,Ukraine,UA,673,20,43993643,Europe,60166,1518
2020-07-23,Ukraine,UA,829,16,43993643,Europe,60995,1534
2020-07-24,Ukraine,UA,856,17,43993643,Europe,61851,1551
2020-07-25,Ukraine,UA,972,20,43993643,Europe,62823,1571
2020-07-26,Ukraine,UA,1106,19,43993643,Europe,63929,1590
2020-07-27,Ukraine,UA,920,15,43993643,Europe,64849,1605
2020-07-28,Ukraine,UA,807,11,43993643,Europe,65656,1616
2020-07-29,Ukraine,UA,919,13,43993643,Europe,66575,1629
2020-07-30,Ukraine,UA,1022,21,43993643,Europe,67597,1650
2020-07-31,Ukraine,UA,1197,23,43993643,Europe,68794,1673
2020-08-01,Ukraine,UA,1090,20,43993643,Europe,69884,1693
2020-08-02,Ukraine,UA,1172,16,43993643,Europe,71056,1709
2020-08-03,Ukraine,UA,1112,16,43993643,Europe,72168,1725
2020-08-04,Ukraine,UA,990,13,43993643,Europe,73158,1738
2020-08-05,Ukraine,UA,1061,26,43993643,Europe,74219,1764
2020-08-06,Ukraine,UA,1271,24,43993643,Europe,75490,1788
2020-08-07,Ukraine,UA,1318,31,43993643,Europe,76808,1819
2020-08-08,Ukraine,UA,1453,33,43993643,Europe,78261,1852
2020-08-09,Ukraine,UA,1489,27,43993643,Europe,79750,1879
2020-08-10,Ukraine,UA,2207,43,43993643,Europe,81957,1922
2020-08-11,Ukraine,UA,1158,29,43993643,Europe,83115,1951
2020-08-12,Ukraine,UA,1433,19,43993643,Europe,84548,1970
2020-08-13,Ukraine,UA,1592,22,43993643,Europe,86140,1992
2020-08-14,Ukraine,UA,1732,19,43993643,Europe,87872,2011
2020-08-15,Ukraine,UA,0,0,43993643,Europe,87872,2011
2020-08-16,Ukraine,UA,1847,33,43993643,Europe,89719,2044
2020-08-17,Ukraine,UA,3101,45,43993643,Europe,92820,2089
2020-08-18,Ukraine,UA,1616,27,43993643,Europe,94436,2116
2020-08-19,Ukraine,UA,0,0,43993643,Europe,94436,2116
2020-08-20,Ukraine,UA,1967,28,43993643,Europe,96403,2144
2020-08-21,Ukraine,UA,2134,40,43993643,Europe,98537,2184
2020-08-22,Ukraine,UA,2106,23,43993643,Europe,100643,2207
2020-08-23,Ukraine,UA,2328,37,43993643,Europe,102971,2244
2020-08-24,Ukraine,UA,1987,27,43993643,Europe,104958,2271
2020-08-25,Ukraine,UA,1796,22,43993643,Europe,106754,2293
2020-08-26,Ukraine,UA,3331,25,43993643,Europe,110085,2318
2020-08-27,Ukraine,UA,1974,85,43993643,Europe,112059,2403
2020-08-28,Ukraine,UA,0,0,43993643,Europe,112059,2403
2020-08-29,Ukraine,UA,2438,35,43993643,Europe,114497,2438
2020-08-30,Ukraine,UA,2481,54,43993643,Europe,116978,2492
2020-08-31,Ukraine,UA,2096,35,43993643,Europe,119074,2527
2020-09-01,Ukraine,UA,2141,30,43993643,Europe,121215,2557
2020-09-02,Ukraine,UA,2088,48,43993643,Europe,123303,2605
2020-09-03,Ukraine,UA,2486,51,43993643,Europe,125789,2656
2020-09-04,Ukraine,UA,2439,54,43993643,Europe,128228,2710
2020-09-05,Ukraine,UA,2723,13,43993643,Europe,130951,2723
2020-09-06,Ukraine,UA,2836,88,43993643,Europe,133787,2811
2020-09-07,Ukraine,UA,2107,0,43993643,Europe,135894,2811
2020-09-08,Ukraine,UA,2174,66,43993643,Europe,138068,2877
2020-09-09,Ukraine,UA,4962,102,43993643,Europe,143030,2979
2020-09-10,Ukraine,UA,2582,0,43993643,Europe,145612,2979
2020-09-11,Ukraine,UA,3144,97,43993643,Europe,148756,3076
2020-09-12,Ukraine,UA,0,0,43993643,Europe,148756,3076
2020-09-13,Ukraine,UA,3103,27,43993643,Europe,151859,3103
2020-09-14,Ukraine,UA,2476,75,43993643,Europe,154335,3178
2020-09-15,Ukraine,UA,2462,33,43993643,Europe,156797,3211
2020-09-16,Ukraine,UA,5863,129,43993643,Europe,162660,3340
2020-09-17,Ukraine,UA,0,0,43993643,Europe,162660,3340
2020-09-18,Ukraine,UA,3584,60,43993643,Europe,166244,3400
2020-09-19,Ukraine,UA,3228,68,43993643,Europe,169472,3468
2020-09-20,Ukraine,UA,3240,48,43993643,Europe,172712,3516
2020-09-21,Ukraine,UA,2966,41,43993643,Europe,175678,3557
2020-09-22,Ukraine,UA,2675,26,43993643,Europe,178353,3583
2020-09-23,Ukraine,UA,2884,59,43993643,Europe,181237,3642
2020-09-24,Ukraine,UA,3497,63,43993643,Europe,184734,3705
2020-09-25,Ukraine,UA,3372,52,43993643,Europe,188106,3757
2020-09-26,Ukraine,UA,3565,70,43993643,Europe,191671,3827
2020-09-27,Ukraine,UA,3833,76,43993643,Europe,195504,3903
2020-09-28,Ukraine,UA,3130,56,43993643,Europe,198634,3959
2020-09-29,Ukraine,UA,2671,37,43993643,Europe,201305,3996
2020-09-30,Ukraine,UA,3627,69,43993643,Europe,204932,4065
2020-10-01,Ukraine,UA,4027,64,43993643,Europe,208959,4129
2020-10-02,Ukraine,UA,0,64,43993643,Europe,208959,4193
2020-10-03,Ukraine,UA,8702,68,43993643,Europe,217661,4261
2020-10-04,Ukraine,UA,4571,92,43993643,Europe,222232,4353
2020-10-05,Ukraine,UA,4230,44,43993643,Europe,226462,4397
2020-10-06,Ukraine,UA,3774,33,43993643,Europe,230236,4430
2020-10-07,Ukraine,UA,4348,90,43993643,Europe,234584,4520
2020-10-08,Ukraine,UA,4753,77,43993643,Europe,239337,4597
2020-10-09,Ukraine,UA,5397,93,43993643,Europe,244734,4690
2020-10-10,Ukraine,UA,0,0,43993643,Europe,244734,4690
2020-10-11,Ukraine,UA,11532,197,43993643,Europe,256266,4887
2020-10-12,Ukraine,UA,4768,85,43993643,Europe,261034,4972
2020-10-13,Ukraine,UA,4420,43,43993643,Europe,265454,5015
2020-10-14,Ukraine,UA,5133,118,43993643,Europe,270587,5133
2020-10-15,Ukraine,UA,5590,96,43993643,Europe,276177,5229
2020-10-16,Ukraine,UA,5062,73,43993643,Europe,281239,5302
2020-10-17,Ukraine,UA,5992,106,43993643,Europe,287231,5408
2020-10-18,Ukraine,UA,6410,109,43993643,Europe,293641,5517
2020-10-19,Ukraine,UA,9997,156,43993643,Europe,303638,5673
2020-10-20,Ukraine,UA,5469,113,43993643,Europe,309107,5786
2020-10-21,Ukraine,UA,0,0,43993643,Europe,309107,5786
2020-10-22,Ukraine,UA,6719,141,43993643,Europe,315826,5927
2020-10-23,Ukraine,UA,7053,116,43993643,Europe,322879,6043
2020-10-24,Ukraine,UA,7517,121,43993643,Europe,330396,6164
2020-10-25,Ukraine,UA,7014,125,43993643,Europe,337410,6289
2020-10-26,Ukraine,UA,6079,102,43993643,Europe,343489,6391
2020-10-27,Ukraine,UA,5435,73,43993643,Europe,348924,6464
2020-10-28,Ukraine,UA,6677,126,43993643,Europe,355601,6590
2020-10-29,Ukraine,UA,7474,165,43993643,Europe,363075,6755
2020-10-30,Ukraine,UA,7342,113,43993643,Europe,370417,6868
2020-10-31,Ukraine,UA,8312,173,43993643,Europe,378729,7041
2020-11-01,Ukraine,UA,8752,155,43993643,Europe,387481,7196
2020-11-02,Ukraine,UA,7959,110,43993643,Europe,395440,7306
2020-11-03,Ukraine,UA,6754,69,43993643,Europe,402194,7375
2020-11-04,Ukraine,UA,8899,157,43993643,Europe,411093,7532
2020-11-05,Ukraine,UA,9524,199,43993643,Europe,420617,7731
2020-11-06,Ukraine,UA,9850,193,43993643,Europe,430467,7924
2020-11-07,Ukraine,UA,9721,201,43993643,Europe,440188,8125
2020-11-08,Ukraine,UA,10746,187,43993643,Europe,450934,8312
2020-11-09,Ukraine,UA,9397,138,43993643,Europe,460331,8450
2020-11-10,Ukraine,UA,8687,115,43993643,Europe,469018,8565
2020-11-11,Ukraine,UA,10179,191,43993643,Europe,479197,8756
2020-11-12,Ukraine,UA,10611,191,43993643,Europe,489808,8947
2020-11-13,Ukraine,UA,11057,198,43993643,Europe,500865,9145
2020-11-14,Ukraine,UA,11787,172,43993643,Europe,512652,9317
2020-11-15,Ukraine,UA,12524,191,43993643,Europe,525176,9508
2020-11-16,Ukraine,UA,10681,95,43993643,Europe,535857,9603
2020-11-17,Ukraine,UA,9832,94,43993643,Europe,545689,9697
2020-11-18,Ukraine,UA,11968,159,43993643,Europe,557657,9856
2020-11-19,Ukraine,UA,12496,256,43993643,Europe,570153,10112
2020-11-20,Ukraine,UA,13357,257,43993643,Europe,583510,10369
2020-11-21,Ukraine,UA,29155,444,43993643,Europe,612665,10813
2020-11-22,Ukraine,UA,0,0,43993643,Europe,612665,10813
2020-11-23,Ukraine,UA,0,0,43993643,Europe,612665,10813
2020-11-24,Ukraine,UA,23024,262,43993643,Europe,635689,11075
2020-11-25,Ukraine,UA,12287,188,43993643,Europe,647976,11263
2020-11-26,Ukraine,UA,13882,229,43993643,Europe,661858,11492
2020-11-27,Ukraine,UA,15331,225,43993643,Europe,677189,11717
2020-11-28,Ukraine,UA,16218,192,43993643,Europe,693407,11909
2020-11-29,Ukraine,UA,16294,184,43993643,Europe,709701,12093
2020-11-30,Ukraine,UA,12978,120,43993643,Europe,722679,12213
2020-12-01,Ukraine,UA,9946,114,43993643,Europe,732625,12327
2020-12-02,Ukraine,UA,12498,221,43993643,Europe,745123,12548
2020-12-03,Ukraine,UA,13141,169,43993643,Europe,758264,12717
2020-12-04,Ukraine,UA,14496,243,43993643,Europe,772760,12960
2020-12-05,Ukraine,UA,15131,235,43993643,Europe,787891,13195
2020-12-06,Ukraine,UA,13825,226,43993643,Europe,801716,13421
2020-12-07,Ukraine,UA,11590,167,43993643,Europe,813306,13588
2020-12-08,Ukraine,UA,8641,145,43993643,Europe,821947,13733
2020-12-09,Ukraine,UA,10811,195,43993643,Europe,832758,13928
2020-12-10,Ukraine,UA,12585,276,43993643,Europe,845343,14204
2020-12-11,Ukraine,UA,13371,266,43993643,Europe,858714,14470
2020-12-12,Ukraine,UA,13514,285,43993643,Europe,872228,14755
2020-12-13,Ukraine,UA,12811,243,43993643,Europe,885039,14998
2020-12-14,Ukraine,UA,15627,249,43993643,Europe,900666,15247
2020-03-22,Uganda,UG,1,0,44269587,Africa,1,0
2020-03-23,Uganda,UG,0,0,44269587,Africa,1,0
2020-03-24,Uganda,UG,8,0,44269587,Africa,9,0
2020-03-25,Uganda,UG,0,0,44269587,Africa,9,0
2020-03-26,Uganda,UG,5,0,44269587,Africa,14,0
2020-03-27,Uganda,UG,0,0,44269587,Africa,14,0
2020-03-28,Uganda,UG,0,0,44269587,Africa,14,0
2020-03-29,Uganda,UG,16,0,44269587,Africa,30,0
2020-03-30,Uganda,UG,3,0,44269587,Africa,33,0
2020-03-31,Uganda,UG,0,0,44269587,Africa,33,0
2020-04-01,Uganda,UG,11,0,44269587,Africa,44,0
2020-04-02,Uganda,UG,0,0,44269587,Africa,44,0
2020-04-03,Uganda,UG,1,0,44269587,Africa,45,0
2020-04-04,Uganda,UG,3,0,44269587,Africa,48,0
2020-04-05,Uganda,UG,0,0,44269587,Africa,48,0
2020-04-06,Uganda,UG,4,0,44269587,Africa,52,0
2020-04-07,Uganda,UG,0,0,44269587,Africa,52,0
2020-04-08,Uganda,UG,0,0,44269587,Africa,52,0
2020-04-09,Uganda,UG,1,0,44269587,Africa,53,0
2020-04-10,Uganda,UG,0,0,44269587,Africa,53,0
2020-04-11,Uganda,UG,0,0,44269587,Africa,53,0
2020-04-12,Uganda,UG,0,0,44269587,Africa,53,0
2020-04-13,Uganda,UG,1,0,44269587,Africa,54,0
2020-04-14,Uganda,UG,0,0,44269587,Africa,54,0
2020-04-15,Uganda,UG,1,0,44269587,Africa,55,0
2020-04-16,Uganda,UG,0,0,44269587,Africa,55,0
2020-04-17,Uganda,UG,0,0,44269587,Africa,55,0
2020-04-18,Uganda,UG,0,0,44269587,Africa,55,0
2020-04-19,Uganda,UG,0,0,44269587,Africa,55,0
2020-04-20,Uganda,UG,0,0,44269587,Africa,55,0
2020-04-21,Uganda,UG,1,0,44269587,Africa,56,0
2020-04-22,Uganda,UG,2,0,44269587,Africa,58,0
2020-04-23,Uganda,UG,3,0,44269587,Africa,61,0
2020-04-24,Uganda,UG,13,0,44269587,Africa,74,0
2020-04-25,Uganda,UG,1,0,44269587,Africa,75,0
2020-04-26,Uganda,UG,0,0,44269587,Africa,75,0
2020-04-27,Uganda,UG,4,0,44269587,Africa,79,0
2020-04-28,Uganda,UG,0,0,44269587,Africa,79,0
2020-04-29,Uganda,UG,0,0,44269587,Africa,79,0
2020-04-30,Uganda,UG,2,0,44269587,Africa,81,0
2020-05-01,Uganda,UG,2,0,44269587,Africa,83,0
2020-05-02,Uganda,UG,2,0,44269587,Africa,85,0
2020-05-03,Uganda,UG,3,0,44269587,Africa,88,0
2020-05-04,Uganda,UG,1,0,44269587,Africa,89,0
2020-05-05,Uganda,UG,8,0,44269587,Africa,97,0
2020-05-06,Uganda,UG,1,0,44269587,Africa,98,0
2020-05-07,Uganda,UG,0,0,44269587,Africa,98,0
2020-05-08,Uganda,UG,3,0,44269587,Africa,101,0
2020-05-09,Uganda,UG,0,0,44269587,Africa,101,0
2020-05-10,Uganda,UG,15,0,44269587,Africa,116,0
2020-05-11,Uganda,UG,5,0,44269587,Africa,121,0
2020-05-12,Uganda,UG,1,0,44269587,Africa,122,0
2020-05-13,Uganda,UG,4,0,44269587,Africa,126,0
2020-05-14,Uganda,UG,13,0,44269587,Africa,139,0
2020-05-15,Uganda,UG,21,0,44269587,Africa,160,0
2020-05-16,Uganda,UG,43,0,44269587,Africa,203,0
2020-05-17,Uganda,UG,24,0,44269587,Africa,227,0
2020-05-18,Uganda,UG,0,0,44269587,Africa,227,0
2020-05-19,Uganda,UG,33,0,44269587,Africa,260,0
2020-05-20,Uganda,UG,0,0,44269587,Africa,260,0
2020-05-21,Uganda,UG,-115,0,44269587,Africa,145,0
2020-05-22,Uganda,UG,15,0,44269587,Africa,160,0
2020-05-23,Uganda,UG,15,0,44269587,Africa,175,0
2020-05-24,Uganda,UG,23,0,44269587,Africa,198,0
2020-05-25,Uganda,UG,14,0,44269587,Africa,212,0
2020-05-26,Uganda,UG,10,0,44269587,Africa,222,0
2020-05-27,Uganda,UG,31,0,44269587,Africa,253,0
2020-05-28,Uganda,UG,28,0,44269587,Africa,281,0
2020-05-29,Uganda,UG,36,0,44269587,Africa,317,0
2020-05-30,Uganda,UG,12,0,44269587,Africa,329,0
2020-05-31,Uganda,UG,84,0,44269587,Africa,413,0
2020-06-01,Uganda,UG,45,0,44269587,Africa,458,0
2020-06-02,Uganda,UG,-1,0,44269587,Africa,457,0
2020-06-03,Uganda,UG,32,0,44269587,Africa,489,0
2020-06-04,Uganda,UG,18,0,44269587,Africa,507,0
2020-06-05,Uganda,UG,15,0,44269587,Africa,522,0
2020-06-06,Uganda,UG,35,0,44269587,Africa,557,0
2020-06-07,Uganda,UG,36,0,44269587,Africa,593,0
2020-06-08,Uganda,UG,23,0,44269587,Africa,616,0
2020-06-09,Uganda,UG,30,0,44269587,Africa,646,0
2020-06-10,Uganda,UG,11,0,44269587,Africa,657,0
2020-06-11,Uganda,UG,8,0,44269587,Africa,665,0
2020-06-12,Uganda,UG,14,0,44269587,Africa,679,0
2020-06-13,Uganda,UG,6,0,44269587,Africa,685,0
2020-06-14,Uganda,UG,0,0,44269587,Africa,685,0
2020-06-15,Uganda,UG,11,0,44269587,Africa,696,0
2020-06-16,Uganda,UG,9,0,44269587,Africa,705,0
2020-06-17,Uganda,UG,19,0,44269587,Africa,724,0
2020-06-18,Uganda,UG,8,0,44269587,Africa,732,0
2020-06-19,Uganda,UG,9,0,44269587,Africa,741,0
2020-06-20,Uganda,UG,14,0,44269587,Africa,755,0
2020-06-21,Uganda,UG,0,0,44269587,Africa,755,0
2020-06-22,Uganda,UG,15,0,44269587,Africa,770,0
2020-06-23,Uganda,UG,4,0,44269587,Africa,774,0
2020-06-24,Uganda,UG,23,0,44269587,Africa,797,0
2020-06-25,Uganda,UG,8,0,44269587,Africa,805,0
2020-06-26,Uganda,UG,16,0,44269587,Africa,821,0
2020-06-27,Uganda,UG,12,0,44269587,Africa,833,0
2020-06-28,Uganda,UG,15,0,44269587,Africa,848,0
2020-06-29,Uganda,UG,11,0,44269587,Africa,859,0
2020-06-30,Uganda,UG,11,0,44269587,Africa,870,0
2020-07-01,Uganda,UG,19,0,44269587,Africa,889,0
2020-07-02,Uganda,UG,4,0,44269587,Africa,893,0
2020-07-03,Uganda,UG,9,0,44269587,Africa,902,0
2020-07-04,Uganda,UG,9,0,44269587,Africa,911,0
2020-07-05,Uganda,UG,16,0,44269587,Africa,927,0
2020-07-06,Uganda,UG,12,0,44269587,Africa,939,0
2020-07-07,Uganda,UG,14,0,44269587,Africa,953,0
2020-07-08,Uganda,UG,18,0,44269587,Africa,971,0
2020-07-09,Uganda,UG,6,0,44269587,Africa,977,0
2020-07-10,Uganda,UG,23,0,44269587,Africa,1000,0
2020-07-11,Uganda,UG,6,0,44269587,Africa,1006,0
2020-07-12,Uganda,UG,7,0,44269587,Africa,1013,0
2020-07-13,Uganda,UG,12,0,44269587,Africa,1025,0
2020-07-14,Uganda,UG,4,0,44269587,Africa,1029,0
2020-07-15,Uganda,UG,11,0,44269587,Africa,1040,0
2020-07-16,Uganda,UG,3,0,44269587,Africa,1043,0
2020-07-17,Uganda,UG,8,0,44269587,Africa,1051,0
2020-07-18,Uganda,UG,5,0,44269587,Africa,1056,0
2020-07-19,Uganda,UG,6,0,44269587,Africa,1062,0
2020-07-20,Uganda,UG,3,0,44269587,Africa,1065,0
2020-07-21,Uganda,UG,4,0,44269587,Africa,1069,0
2020-07-22,Uganda,UG,3,0,44269587,Africa,1072,0
2020-07-23,Uganda,UG,3,0,44269587,Africa,1075,0
2020-07-24,Uganda,UG,0,0,44269587,Africa,1075,0
2020-07-25,Uganda,UG,14,1,44269587,Africa,1089,1
2020-07-26,Uganda,UG,14,0,44269587,Africa,1103,1
2020-07-27,Uganda,UG,12,1,44269587,Africa,1115,2
2020-07-28,Uganda,UG,13,0,44269587,Africa,1128,2
2020-07-29,Uganda,UG,7,0,44269587,Africa,1135,2
2020-07-30,Uganda,UG,5,0,44269587,Africa,1140,2
2020-07-31,Uganda,UG,7,0,44269587,Africa,1147,2
2020-08-01,Uganda,UG,7,1,44269587,Africa,1154,3
2020-08-02,Uganda,UG,22,1,44269587,Africa,1176,4
2020-08-03,Uganda,UG,6,0,44269587,Africa,1182,4
2020-08-04,Uganda,UG,13,1,44269587,Africa,1195,5
2020-08-05,Uganda,UG,8,0,44269587,Africa,1203,5
2020-08-06,Uganda,UG,10,0,44269587,Africa,1213,5
2020-08-07,Uganda,UG,10,0,44269587,Africa,1223,5
2020-08-08,Uganda,UG,31,1,44269587,Africa,1254,6
2020-08-09,Uganda,UG,13,0,44269587,Africa,1267,6
2020-08-10,Uganda,UG,16,1,44269587,Africa,1283,7
2020-08-11,Uganda,UG,14,2,44269587,Africa,1297,9
2020-08-12,Uganda,UG,16,0,44269587,Africa,1313,9
2020-08-13,Uganda,UG,19,0,44269587,Africa,1332,9
2020-08-14,Uganda,UG,21,2,44269587,Africa,1353,11
2020-08-15,Uganda,UG,32,1,44269587,Africa,1385,12
2020-08-16,Uganda,UG,49,1,44269587,Africa,1434,13
2020-08-17,Uganda,UG,66,0,44269587,Africa,1500,13
2020-08-18,Uganda,UG,60,2,44269587,Africa,1560,15
2020-08-19,Uganda,UG,43,0,44269587,Africa,1603,15
2020-08-20,Uganda,UG,0,0,44269587,Africa,1603,15
2020-08-21,Uganda,UG,147,4,44269587,Africa,1750,19
2020-08-22,Uganda,UG,98,0,44269587,Africa,1848,19
2020-08-23,Uganda,UG,0,0,44269587,Africa,1848,19
2020-08-24,Uganda,UG,415,0,44269587,Africa,2263,19
2020-08-25,Uganda,UG,99,3,44269587,Africa,2362,22
2020-08-26,Uganda,UG,64,3,44269587,Africa,2426,25
2020-08-27,Uganda,UG,98,1,44269587,Africa,2524,26
2020-08-28,Uganda,UG,155,2,44269587,Africa,2679,28
2020-08-29,Uganda,UG,77,0,44269587,Africa,2756,28
2020-08-30,Uganda,UG,91,1,44269587,Africa,2847,29
2020-08-31,Uganda,UG,81,1,44269587,Africa,2928,30
2020-09-01,Uganda,UG,44,2,44269587,Africa,2972,32
2020-09-02,Uganda,UG,65,0,44269587,Africa,3037,32
2020-09-03,Uganda,UG,75,0,44269587,Africa,3112,32
2020-09-04,Uganda,UG,176,1,44269587,Africa,3288,33
2020-09-05,Uganda,UG,65,2,44269587,Africa,3353,35
2020-09-06,Uganda,UG,186,4,44269587,Africa,3539,39
2020-09-07,Uganda,UG,128,2,44269587,Africa,3667,41
2020-09-08,Uganda,UG,109,3,44269587,Africa,3776,44
2020-09-09,Uganda,UG,124,2,44269587,Africa,3900,46
2020-09-10,Uganda,UG,201,0,44269587,Africa,4101,46
2020-09-11,Uganda,UG,190,2,44269587,Africa,4291,48
2020-09-12,Uganda,UG,86,1,44269587,Africa,4377,49
2020-09-13,Uganda,UG,326,3,44269587,Africa,4703,52
2020-09-14,Uganda,UG,96,3,44269587,Africa,4799,55
2020-09-15,Uganda,UG,0,0,44269587,Africa,4799,55
2020-09-16,Uganda,UG,324,3,44269587,Africa,5123,58
2020-09-17,Uganda,UG,143,2,44269587,Africa,5266,60
2020-09-18,Uganda,UG,114,0,44269587,Africa,5380,60
2020-09-19,Uganda,UG,214,1,44269587,Africa,5594,61
2020-09-20,Uganda,UG,423,2,44269587,Africa,6017,63
2020-09-21,Uganda,UG,270,0,44269587,Africa,6287,63
2020-09-22,Uganda,UG,181,0,44269587,Africa,6468,63
2020-09-23,Uganda,UG,244,1,44269587,Africa,6712,64
2020-09-24,Uganda,UG,167,5,44269587,Africa,6879,69
2020-09-25,Uganda,UG,185,1,44269587,Africa,7064,70
2020-09-26,Uganda,UG,154,1,44269587,Africa,7218,71
2020-09-27,Uganda,UG,146,0,44269587,Africa,7364,71
2020-09-28,Uganda,UG,166,2,44269587,Africa,7530,73
2020-09-29,Uganda,UG,247,2,44269587,Africa,7777,75
2020-09-30,Uganda,UG,240,0,44269587,Africa,8017,75
2020-10-01,Uganda,UG,112,0,44269587,Africa,8129,75
2020-10-02,Uganda,UG,158,0,44269587,Africa,8287,75
2020-10-03,Uganda,UG,204,4,44269587,Africa,8491,79
2020-10-04,Uganda,UG,171,0,44269587,Africa,8662,79
2020-10-05,Uganda,UG,146,2,44269587,Africa,8808,81
2020-10-06,Uganda,UG,157,1,44269587,Africa,8965,82
2020-10-07,Uganda,UG,117,2,44269587,Africa,9082,84
2020-10-08,Uganda,UG,178,1,44269587,Africa,9260,85
2020-10-09,Uganda,UG,182,0,44269587,Africa,9442,85
2020-10-10,Uganda,UG,96,1,44269587,Africa,9538,86
2020-10-11,Uganda,UG,163,7,44269587,Africa,9701,93
2020-10-12,Uganda,UG,100,0,44269587,Africa,9801,93
2020-10-13,Uganda,UG,63,1,44269587,Africa,9864,94
2020-10-14,Uganda,UG,81,1,44269587,Africa,9945,95
2020-10-15,Uganda,UG,124,0,44269587,Africa,10069,95
2020-10-16,Uganda,UG,48,1,44269587,Africa,10117,96
2020-10-17,Uganda,UG,217,0,44269587,Africa,10334,96
2020-10-18,Uganda,UG,121,0,44269587,Africa,10455,96
2020-10-19,Uganda,UG,135,1,44269587,Africa,10590,97
2020-10-20,Uganda,UG,101,0,44269587,Africa,10691,97
2020-10-21,Uganda,UG,97,0,44269587,Africa,10788,97
2020-10-22,Uganda,UG,145,1,44269587,Africa,10933,98
2020-10-23,Uganda,UG,108,0,44269587,Africa,11041,98
2020-10-24,Uganda,UG,122,1,44269587,Africa,11163,99
2020-10-25,Uganda,UG,134,0,44269587,Africa,11297,99
2020-10-26,Uganda,UG,146,2,44269587,Africa,11443,101
2020-10-27,Uganda,UG,114,0,44269587,Africa,11557,101
2020-10-28,Uganda,UG,64,2,44269587,Africa,11621,103
2020-10-29,Uganda,UG,146,3,44269587,Africa,11767,106
2020-10-30,Uganda,UG,434,2,44269587,Africa,12201,108
2020-10-31,Uganda,UG,209,2,44269587,Africa,12410,110
2020-11-01,Uganda,UG,85,1,44269587,Africa,12495,111
2020-11-02,Uganda,UG,248,1,44269587,Africa,12743,112
2020-11-03,Uganda,UG,228,2,44269587,Africa,12971,114
2020-11-04,Uganda,UG,128,1,44269587,Africa,13099,115
2020-11-05,Uganda,UG,252,2,44269587,Africa,13351,117
2020-11-06,Uganda,UG,217,0,44269587,Africa,13568,117
2020-11-07,Uganda,UG,284,14,44269587,Africa,13852,131
2020-11-08,Uganda,UG,214,0,44269587,Africa,14066,131
2020-11-09,Uganda,UG,337,1,44269587,Africa,14403,132
2020-11-10,Uganda,UG,171,1,44269587,Africa,14574,133
2020-11-11,Uganda,UG,130,0,44269587,Africa,14704,133
2020-11-12,Uganda,UG,289,6,44269587,Africa,14993,139
2020-11-13,Uganda,UG,224,4,44269587,Africa,15217,143
2020-11-14,Uganda,UG,185,1,44269587,Africa,15402,144
2020-11-15,Uganda,UG,0,0,44269587,Africa,15402,144
2020-11-16,Uganda,UG,618,1,44269587,Africa,16020,145
2020-11-17,Uganda,UG,237,5,44269587,Africa,16257,150
2020-11-18,Uganda,UG,306,0,44269587,Africa,16563,150
2020-11-19,Uganda,UG,342,7,44269587,Africa,16905,157
2020-11-20,Uganda,UG,243,1,44269587,Africa,17148,158
2020-11-21,Uganda,UG,283,10,44269587,Africa,17431,168
2020-11-22,Uganda,UG,236,0,44269587,Africa,17667,168
2020-11-23,Uganda,UG,301,4,44269587,Africa,17968,172
2020-11-24,Uganda,UG,197,9,44269587,Africa,18165,181
2020-11-25,Uganda,UG,241,5,44269587,Africa,18406,186
2020-11-26,Uganda,UG,484,5,44269587,Africa,18890,191
2020-11-27,Uganda,UG,225,0,44269587,Africa,19115,191
2020-11-28,Uganda,UG,473,6,44269587,Africa,19588,197
2020-11-29,Uganda,UG,356,4,44269587,Africa,19944,201
2020-11-30,Uganda,UG,201,0,44269587,Africa,20145,201
2020-12-01,Uganda,UG,314,4,44269587,Africa,20459,205
2020-12-02,Uganda,UG,576,0,44269587,Africa,21035,205
2020-12-03,Uganda,UG,374,1,44269587,Africa,21409,206
2020-12-04,Uganda,UG,203,0,44269587,Africa,21612,206
2020-12-05,Uganda,UG,286,0,44269587,Africa,21898,206
2020-12-06,Uganda,UG,290,0,44269587,Africa,22188,206
2020-12-07,Uganda,UG,311,0,44269587,Africa,22499,206
2020-12-08,Uganda,UG,701,1,44269587,Africa,23200,207
2020-12-09,Uganda,UG,660,0,44269587,Africa,23860,207
2020-12-10,Uganda,UG,1199,12,44269587,Africa,25059,219
2020-12-11,Uganda,UG,671,1,44269587,Africa,25730,220
2020-12-12,Uganda,UG,639,0,44269587,Africa,26369,220
2020-12-13,Uganda,UG,702,0,44269587,Africa,27071,220
2020-12-14,Uganda,UG,461,1,44269587,Africa,27532,221
2019-12-31,United_Kingdom,UK,0,0,66647112,Europe,0,0
2020-01-01,United_Kingdom,UK,0,0,66647112,Europe,0,0
2020-01-02,United_Kingdom,UK,0,0,66647112,Europe,0,0
2020-01-03,United_Kingdom,UK,0,0,66647112,Europe,0,0
2020-01-04,United_Kingdom,UK,0,0,66647112,Europe,0,0
2020-01-05,United_Kingdom,UK,0,0,66647112,Europe,0,0
2020-01-06,United_Kingdom,UK,0,0,66647112,Europe,0,0
2020-01-07,United_Kingdom,UK,0,0,66647112,Europe,0,0
2020-01-08,United_Kingdom,UK,0,0,66647112,Europe,0,0
2020-01-09,United_Kingdom,UK,0,0,66647112,Europe,0,0
2020-01-10,United_Kingdom,UK,0,0,66647112,Europe,0,0
2020-01-11,United_Kingdom,UK,0,0,66647112,Europe,0,0
2020-01-12,United_Kingdom,UK,0,0,66647112,Europe,0,0
2020-01-13,United_Kingdom,UK,0,0,66647112,Europe,0,0
2020-01-14,United_Kingdom,UK,0,0,66647112,Europe,0,0
2020-01-15,United_Kingdom,UK,0,0,66647112,Europe,0,0
2020-01-16,United_Kingdom,UK,0,0,66647112,Europe,0,0
2020-01-17,United_Kingdom,UK,0,0,66647112,Europe,0,0
2020-01-18,United_Kingdom,UK,0,0,66647112,Europe,0,0
2020-01-19,United_Kingdom,UK,0,0,66647112,Europe,0,0
2020-01-20,United_Kingdom,UK,0,0,66647112,Europe,0,0
2020-01-21,United_Kingdom,UK,0,0,66647112,Europe,0,0
2020-01-22,United_Kingdom,UK,0,0,66647112,Europe,0,0
2020-01-23,United_Kingdom,UK,0,0,66647112,Europe,0,0
2020-01-24,United_Kingdom,UK,0,0,66647112,Europe,0,0
2020-01-25,United_Kingdom,UK,0,0,66647112,Europe,0,0
2020-01-26,United_Kingdom,UK,0,0,66647112,Europe,0,0
2020-01-27,United_Kingdom,UK,0,0,66647112,Europe,0,0
2020-01-28,United_Kingdom,UK,0,0,66647112,Europe,0,0
2020-01-29,United_Kingdom,UK,0,0,66647112,Europe,0,0
2020-01-30,United_Kingdom,UK,0,0,66647112,Europe,0,0
2020-01-31,United_Kingdom,UK,0,0,66647112,Europe,0,0
2020-02-01,United_Kingdom,UK,2,0,66647112,Europe,2,0
2020-02-02,United_Kingdom,UK,0,0,66647112,Europe,2,0
2020-02-03,United_Kingdom,UK,0,0,66647112,Europe,2,0
2020-02-04,United_Kingdom,UK,0,0,66647112,Europe,2,0
2020-02-05,United_Kingdom,UK,1,0,66647112,Europe,3,0
2020-02-06,United_Kingdom,UK,0,0,66647112,Europe,3,0
2020-02-07,United_Kingdom,UK,1,0,66647112,Europe,4,0
2020-02-08,United_Kingdom,UK,0,0,66647112,Europe,4,0
2020-02-09,United_Kingdom,UK,0,0,66647112,Europe,4,0
2020-02-10,United_Kingdom,UK,4,0,66647112,Europe,8,0
2020-02-11,United_Kingdom,UK,1,0,66647112,Europe,9,0
2020-02-12,United_Kingdom,UK,0,0,66647112,Europe,9,0
2020-02-13,United_Kingdom,UK,1,0,66647112,Europe,10,0
2020-02-14,United_Kingdom,UK,0,0,66647112,Europe,10,0
2020-02-15,United_Kingdom,UK,0,0,66647112,Europe,10,0
2020-02-16,United_Kingdom,UK,0,0,66647112,Europe,10,0
2020-02-17,United_Kingdom,UK,0,0,66647112,Europe,10,0
2020-02-18,United_Kingdom,UK,0,0,66647112,Europe,10,0
2020-02-19,United_Kingdom,UK,0,0,66647112,Europe,10,0
2020-02-20,United_Kingdom,UK,0,0,66647112,Europe,10,0
2020-02-21,United_Kingdom,UK,0,0,66647112,Europe,10,0
2020-02-22,United_Kingdom,UK,0,0,66647112,Europe,10,0
2020-02-23,United_Kingdom,UK,1,0,66647112,Europe,11,0
2020-02-24,United_Kingdom,UK,0,0,66647112,Europe,11,0
2020-02-25,United_Kingdom,UK,0,0,66647112,Europe,11,0
2020-02-26,United_Kingdom,UK,2,0,66647112,Europe,13,0
2020-02-27,United_Kingdom,UK,5,0,66647112,Europe,18,0
2020-02-28,United_Kingdom,UK,4,0,66647112,Europe,22,0
2020-02-29,United_Kingdom,UK,8,0,66647112,Europe,30,0
2020-03-01,United_Kingdom,UK,12,0,66647112,Europe,42,0
2020-03-02,United_Kingdom,UK,5,0,66647112,Europe,47,0
2020-03-03,United_Kingdom,UK,22,0,66647112,Europe,69,0
2020-03-04,United_Kingdom,UK,40,0,66647112,Europe,109,0
2020-03-05,United_Kingdom,UK,55,0,66647112,Europe,164,0
2020-03-06,United_Kingdom,UK,56,0,66647112,Europe,220,0
2020-03-07,United_Kingdom,UK,51,1,66647112,Europe,271,1
2020-03-08,United_Kingdom,UK,81,1,66647112,Europe,352,2
2020-03-09,United_Kingdom,UK,60,0,66647112,Europe,412,2
2020-03-10,United_Kingdom,UK,57,1,66647112,Europe,469,3
2020-03-11,United_Kingdom,UK,148,4,66647112,Europe,617,7
2020-03-12,United_Kingdom,UK,259,0,66647112,Europe,876,7
2020-03-13,United_Kingdom,UK,406,2,66647112,Europe,1282,9
2020-03-14,United_Kingdom,UK,484,1,66647112,Europe,1766,10
2020-03-15,United_Kingdom,UK,478,19,66647112,Europe,2244,29
2020-03-16,United_Kingdom,UK,361,14,66647112,Europe,2605,43
2020-03-17,United_Kingdom,UK,442,22,66647112,Europe,3047,65
2020-03-18,United_Kingdom,UK,611,17,66647112,Europe,3658,82
2020-03-19,United_Kingdom,UK,769,34,66647112,Europe,4427,116
2020-03-20,United_Kingdom,UK,999,46,66647112,Europe,5426,162
2020-03-21,United_Kingdom,UK,1055,32,66647112,Europe,6481,194
2020-03-22,United_Kingdom,UK,1255,58,66647112,Europe,7736,252
2020-03-23,United_Kingdom,UK,1198,36,66647112,Europe,8934,288
2020-03-24,United_Kingdom,UK,1378,76,66647112,Europe,10312,364
2020-03-25,United_Kingdom,UK,2338,148,66647112,Europe,12650,512
2020-03-26,United_Kingdom,UK,2375,191,66647112,Europe,15025,703
2020-03-27,United_Kingdom,UK,2692,181,66647112,Europe,17717,884
2020-03-28,United_Kingdom,UK,3087,288,66647112,Europe,20804,1172
2020-03-29,United_Kingdom,UK,3197,292,66647112,Europe,24001,1464
2020-03-30,United_Kingdom,UK,2822,212,66647112,Europe,26823,1676
2020-03-31,United_Kingdom,UK,2858,374,66647112,Europe,29681,2050
2020-04-01,United_Kingdom,UK,4273,403,66647112,Europe,33954,2453
2020-04-02,United_Kingdom,UK,4514,672,66647112,Europe,38468,3125
2020-04-03,United_Kingdom,UK,4913,657,66647112,Europe,43381,3782
2020-04-04,United_Kingdom,UK,4868,736,66647112,Europe,48249,4518
2020-04-05,United_Kingdom,UK,4911,756,66647112,Europe,53160,5274
2020-04-06,United_Kingdom,UK,4020,599,66647112,Europe,57180,5873
2020-04-07,United_Kingdom,UK,3592,567,66647112,Europe,60772,6440
2020-04-08,United_Kingdom,UK,5282,1105,66647112,Europe,66054,7545
2020-04-09,United_Kingdom,UK,5450,1030,66647112,Europe,71504,8575
2020-04-10,United_Kingdom,UK,5131,1116,66647112,Europe,76635,9691
2020-04-11,United_Kingdom,UK,4858,1122,66647112,Europe,81493,10813
2020-04-12,United_Kingdom,UK,4313,843,66647112,Europe,85806,11656
2020-04-13,United_Kingdom,UK,3579,657,66647112,Europe,89385,12313
2020-04-14,United_Kingdom,UK,3489,724,66647112,Europe,92874,13037
2020-04-15,United_Kingdom,UK,4178,1076,66647112,Europe,97052,14113
2020-04-16,United_Kingdom,UK,4326,880,66647112,Europe,101378,14993
2020-04-17,United_Kingdom,UK,5065,1036,66647112,Europe,106443,16029
2020-04-18,United_Kingdom,UK,5292,913,66647112,Europe,111735,16942
2020-04-19,United_Kingdom,UK,4956,1105,66647112,Europe,116691,18047
2020-04-20,United_Kingdom,UK,4721,432,66647112,Europe,121412,18479
2020-04-21,United_Kingdom,UK,3853,570,66647112,Europe,125265,19049
2020-04-22,United_Kingdom,UK,4854,1224,66647112,Europe,130119,20273
2020-04-23,United_Kingdom,UK,4760,847,66647112,Europe,134879,21120
2020-04-24,United_Kingdom,UK,5487,682,66647112,Europe,140366,21802
2020-04-25,United_Kingdom,UK,5158,1010,66647112,Europe,145524,22812
2020-04-26,United_Kingdom,UK,4970,815,66647112,Europe,150494,23627
2020-04-27,United_Kingdom,UK,3748,364,66647112,Europe,154242,23991
2020-04-28,United_Kingdom,UK,3473,320,66647112,Europe,157715,24311
2020-04-29,United_Kingdom,UK,4706,969,66647112,Europe,162421,25280
2020-04-30,United_Kingdom,UK,4729,769,66647112,Europe,167150,26049
2020-05-01,United_Kingdom,UK,5442,634,66647112,Europe,172592,26683
2020-05-02,United_Kingdom,UK,4966,698,66647112,Europe,177558,27381
2020-05-03,United_Kingdom,UK,4737,584,66647112,Europe,182295,27965
2020-05-04,United_Kingdom,UK,3229,253,66647112,Europe,185524,28218
2020-05-05,United_Kingdom,UK,2982,272,66647112,Europe,188506,28490
2020-05-06,United_Kingdom,UK,3389,726,66647112,Europe,191895,29216
2020-05-07,United_Kingdom,UK,3682,647,66647112,Europe,195577,29863
2020-05-08,United_Kingdom,UK,3827,458,66647112,Europe,199404,30321
2020-05-09,United_Kingdom,UK,3767,579,66647112,Europe,203171,30900
2020-05-10,United_Kingdom,UK,3063,275,66647112,Europe,206234,31175
2020-05-11,United_Kingdom,UK,2157,217,66647112,Europe,208391,31392
2020-05-12,United_Kingdom,UK,2329,187,66647112,Europe,210720,31579
2020-05-13,United_Kingdom,UK,3586,614,66647112,Europe,214306,32193
2020-05-14,United_Kingdom,UK,3402,447,66647112,Europe,217708,32640
2020-05-15,United_Kingdom,UK,3307,352,66647112,Europe,221015,32992
2020-05-16,United_Kingdom,UK,2628,350,66647112,Europe,223643,33342
2020-05-17,United_Kingdom,UK,2526,411,66647112,Europe,226169,33753
2020-05-18,United_Kingdom,UK,2079,67,66647112,Europe,228248,33820
2020-05-19,United_Kingdom,UK,1838,146,66647112,Europe,230086,33966
2020-05-20,United_Kingdom,UK,2589,500,66647112,Europe,232675,34466
2020-05-21,United_Kingdom,UK,3052,328,66647112,Europe,235727,34794
2020-05-22,United_Kingdom,UK,2718,273,66647112,Europe,238445,35067
2020-05-23,United_Kingdom,UK,2574,291,66647112,Europe,241019,35358
2020-05-24,United_Kingdom,UK,2062,220,66647112,Europe,243081,35578
2020-05-25,United_Kingdom,UK,1527,379,66647112,Europe,244608,35957
2020-05-26,United_Kingdom,UK,1364,104,66647112,Europe,245972,36061
2020-05-27,United_Kingdom,UK,1624,131,66647112,Europe,247596,36192
2020-05-28,United_Kingdom,UK,1672,422,66647112,Europe,249268,36614
2020-05-29,United_Kingdom,UK,1835,343,66647112,Europe,251103,36957
2020-05-30,United_Kingdom,UK,1760,274,66647112,Europe,252863,37231
2020-05-31,United_Kingdom,UK,1527,154,66647112,Europe,254390,37385
2020-06-01,United_Kingdom,UK,1125,60,66647112,Europe,255515,37445
2020-06-02,United_Kingdom,UK,1079,86,66647112,Europe,256594,37531
2020-06-03,United_Kingdom,UK,1441,249,66647112,Europe,258035,37780
2020-06-04,United_Kingdom,UK,1484,254,66647112,Europe,259519,38034
2020-06-05,United_Kingdom,UK,1356,130,66647112,Europe,260875,38164
2020-06-06,United_Kingdom,UK,1243,258,66647112,Europe,262118,38422
2020-06-07,United_Kingdom,UK,1120,143,66647112,Europe,263238,38565
2020-06-08,United_Kingdom,UK,801,54,66647112,Europe,264039,38619
2020-06-09,United_Kingdom,UK,721,47,66647112,Europe,264760,38666
2020-06-10,United_Kingdom,UK,1099,195,66647112,Europe,265859,38861
2020-06-11,United_Kingdom,UK,1158,164,66647112,Europe,267017,39025
2020-06-12,United_Kingdom,UK,1199,76,66647112,Europe,268216,39101
2020-06-13,United_Kingdom,UK,1017,131,66647112,Europe,269233,39232
2020-06-14,United_Kingdom,UK,1052,107,66647112,Europe,270285,39339
2020-06-15,United_Kingdom,UK,890,27,66647112,Europe,271175,39366
2020-06-16,United_Kingdom,UK,822,29,66647112,Europe,271997,39395
2020-06-17,United_Kingdom,UK,1043,120,66647112,Europe,273040,39515
2020-06-18,United_Kingdom,UK,1102,110,66647112,Europe,274142,39625
2020-06-19,United_Kingdom,UK,1013,67,66647112,Europe,275155,39692
2020-06-20,United_Kingdom,UK,1027,84,66647112,Europe,276182,39776
2020-06-21,United_Kingdom,UK,986,71,66647112,Europe,277168,39847
2020-06-22,United_Kingdom,UK,687,31,66647112,Europe,277855,39878
2020-06-23,United_Kingdom,UK,639,14,66647112,Europe,278494,39892
2020-06-24,United_Kingdom,UK,896,94,66647112,Europe,279390,39986
2020-06-25,United_Kingdom,UK,886,87,66647112,Europe,280276,40073
2020-06-26,United_Kingdom,UK,778,99,66647112,Europe,281054,40172
2020-06-27,United_Kingdom,UK,721,77,66647112,Europe,281775,40249
2020-06-28,United_Kingdom,UK,671,40,66647112,Europe,282446,40289
2020-06-29,United_Kingdom,UK,649,31,66647112,Europe,283095,40320
2020-06-30,United_Kingdom,UK,446,21,66647112,Europe,283541,40341
2020-07-01,United_Kingdom,UK,730,53,66647112,Europe,284271,40394
2020-07-02,United_Kingdom,UK,617,97,66647112,Europe,284888,40491
2020-07-03,United_Kingdom,UK,651,41,66647112,Europe,285539,40532
2020-07-04,United_Kingdom,UK,602,49,66647112,Europe,286141,40581
2020-07-05,United_Kingdom,UK,579,32,66647112,Europe,286720,40613
2020-07-06,United_Kingdom,UK,401,19,66647112,Europe,287121,40632
2020-07-07,United_Kingdom,UK,555,11,66647112,Europe,287676,40643
2020-07-08,United_Kingdom,UK,704,54,66647112,Europe,288380,40697
2020-07-09,United_Kingdom,UK,597,57,66647112,Europe,288977,40754
2020-07-10,United_Kingdom,UK,693,31,66647112,Europe,289670,40785
2020-07-11,United_Kingdom,UK,715,34,66647112,Europe,290385,40819
2020-07-12,United_Kingdom,UK,565,17,66647112,Europe,290950,40836
2020-07-13,United_Kingdom,UK,442,9,66647112,Europe,291392,40845
2020-07-14,United_Kingdom,UK,361,10,66647112,Europe,291753,40855
2020-07-15,United_Kingdom,UK,726,44,66647112,Europe,292479,40899
2020-07-16,United_Kingdom,UK,685,26,66647112,Europe,293164,40925
2020-07-17,United_Kingdom,UK,772,24,66647112,Europe,293936,40949
2020-07-18,United_Kingdom,UK,704,26,66647112,Europe,294640,40975
2020-07-19,United_Kingdom,UK,569,9,66647112,Europe,295209,40984
2020-07-20,United_Kingdom,UK,493,11,66647112,Europe,295702,40995
2020-07-21,United_Kingdom,UK,413,10,66647112,Europe,296115,41005
2020-07-22,United_Kingdom,UK,793,25,66647112,Europe,296908,41030
2020-07-23,United_Kingdom,UK,751,17,66647112,Europe,297659,41047
2020-07-24,United_Kingdom,UK,773,9,66647112,Europe,298432,41056
2020-07-25,United_Kingdom,UK,731,32,66647112,Europe,299163,41088
2020-07-26,United_Kingdom,UK,667,15,66647112,Europe,299830,41103
2020-07-27,United_Kingdom,UK,421,8,66647112,Europe,300251,41111
2020-07-28,United_Kingdom,UK,371,3,66647112,Europe,300622,41114
2020-07-29,United_Kingdom,UK,70,21,66647112,Europe,300692,41135
2020-07-30,United_Kingdom,UK,763,34,66647112,Europe,301455,41169
2020-07-31,United_Kingdom,UK,846,0,66647112,Europe,302301,41169
2020-08-01,United_Kingdom,UK,880,20,66647112,Europe,303181,41189
2020-08-02,United_Kingdom,UK,771,13,66647112,Europe,303952,41202
2020-08-03,United_Kingdom,UK,743,5,66647112,Europe,304695,41207
2020-08-04,United_Kingdom,UK,928,1,66647112,Europe,305623,41208
2020-08-05,United_Kingdom,UK,670,18,66647112,Europe,306293,41226
2020-08-06,United_Kingdom,UK,891,14,66647112,Europe,307184,41240
2020-08-07,United_Kingdom,UK,950,18,66647112,Europe,308134,41258
2020-08-08,United_Kingdom,UK,871,12,66647112,Europe,309005,41270
2020-08-09,United_Kingdom,UK,758,3,66647112,Europe,309763,41273
2020-08-10,United_Kingdom,UK,1062,5,66647112,Europe,310825,41278
2020-08-11,United_Kingdom,UK,816,18,66647112,Europe,311641,41296
2020-08-12,United_Kingdom,UK,1148,13,66647112,Europe,312789,41309
2020-08-13,United_Kingdom,UK,1009,20,66647112,Europe,313798,41329
2020-08-14,United_Kingdom,UK,1129,18,66647112,Europe,314927,41347
2020-08-15,United_Kingdom,UK,1440,11,66647112,Europe,316367,41358
2020-08-16,United_Kingdom,UK,1077,3,66647112,Europe,317444,41361
2020-08-17,United_Kingdom,UK,1040,5,66647112,Europe,318484,41366
2020-08-18,United_Kingdom,UK,713,3,66647112,Europe,319197,41369
2020-08-19,United_Kingdom,UK,1089,12,66647112,Europe,320286,41381
2020-08-20,United_Kingdom,UK,812,16,66647112,Europe,321098,41397
2020-08-21,United_Kingdom,UK,1182,6,66647112,Europe,322280,41403
2020-08-22,United_Kingdom,UK,1033,2,66647112,Europe,323313,41405
2020-08-23,United_Kingdom,UK,1288,18,66647112,Europe,324601,41423
2020-08-24,United_Kingdom,UK,1041,6,66647112,Europe,325642,41429
2020-08-25,United_Kingdom,UK,972,4,66647112,Europe,326614,41433
2020-08-26,United_Kingdom,UK,1184,16,66647112,Europe,327798,41449
2020-08-27,United_Kingdom,UK,1048,16,66647112,Europe,328846,41465
2020-08-28,United_Kingdom,UK,1522,12,66647112,Europe,330368,41477
2020-08-29,United_Kingdom,UK,1276,9,66647112,Europe,331644,41486
2020-08-30,United_Kingdom,UK,1108,12,66647112,Europe,332752,41498
2020-08-31,United_Kingdom,UK,1715,1,66647112,Europe,334467,41499
2020-09-01,United_Kingdom,UK,1406,2,66647112,Europe,335873,41501
2020-09-02,United_Kingdom,UK,1295,3,66647112,Europe,337168,41504
2020-09-03,United_Kingdom,UK,1508,10,66647112,Europe,338676,41514
2020-09-04,United_Kingdom,UK,1735,13,66647112,Europe,340411,41527
2020-09-05,United_Kingdom,UK,1940,10,66647112,Europe,342351,41537
2020-09-06,United_Kingdom,UK,1813,12,66647112,Europe,344164,41549
2020-09-07,United_Kingdom,UK,2988,2,66647112,Europe,347152,41551
2020-09-08,United_Kingdom,UK,2948,3,66647112,Europe,350100,41554
2020-09-09,United_Kingdom,UK,2460,32,66647112,Europe,352560,41586
2020-09-10,United_Kingdom,UK,2659,8,66647112,Europe,355219,41594
2020-09-11,United_Kingdom,UK,2919,14,66647112,Europe,358138,41608
2020-09-12,United_Kingdom,UK,3539,6,66647112,Europe,361677,41614
2020-09-13,United_Kingdom,UK,3497,9,66647112,Europe,365174,41623
2020-09-14,United_Kingdom,UK,3330,5,66647112,Europe,368504,41628
2020-09-15,United_Kingdom,UK,2621,9,66647112,Europe,371125,41637
2020-09-16,United_Kingdom,UK,3103,27,66647112,Europe,374228,41664
2020-09-17,United_Kingdom,UK,3991,20,66647112,Europe,378219,41684
2020-09-18,United_Kingdom,UK,3395,21,66647112,Europe,381614,41705
2020-09-19,United_Kingdom,UK,4322,27,66647112,Europe,385936,41732
2020-09-20,United_Kingdom,UK,4422,27,66647112,Europe,390358,41759
2020-09-21,United_Kingdom,UK,3899,18,66647112,Europe,394257,41777
2020-09-22,United_Kingdom,UK,4368,11,66647112,Europe,398625,41788
2020-09-23,United_Kingdom,UK,4926,37,66647112,Europe,403551,41825
2020-09-24,United_Kingdom,UK,6178,37,66647112,Europe,409729,41862
2020-09-25,United_Kingdom,UK,6634,40,66647112,Europe,416363,41902
2020-09-26,United_Kingdom,UK,6873,34,66647112,Europe,423236,41936
2020-09-27,United_Kingdom,UK,6041,35,66647112,Europe,429277,41971
2020-09-28,United_Kingdom,UK,5692,17,66647112,Europe,434969,41988
2020-09-29,United_Kingdom,UK,4044,13,66647112,Europe,439013,42001
2020-09-30,United_Kingdom,UK,7143,71,66647112,Europe,446156,42072
2020-10-01,United_Kingdom,UK,7108,71,66647112,Europe,453264,42143
2020-10-02,United_Kingdom,UK,6914,59,66647112,Europe,460178,42202
2020-10-03,United_Kingdom,UK,6968,66,66647112,Europe,467146,42268
2020-10-04,United_Kingdom,UK,12871,49,66647112,Europe,480017,42317
2020-10-05,United_Kingdom,UK,22961,33,66647112,Europe,502978,42350
2020-10-06,United_Kingdom,UK,12593,19,66647112,Europe,515571,42369
2020-10-07,United_Kingdom,UK,14542,76,66647112,Europe,530113,42445
2020-10-08,United_Kingdom,UK,14162,70,66647112,Europe,544275,42515
2020-10-09,United_Kingdom,UK,17540,77,66647112,Europe,561815,42592
2020-10-10,United_Kingdom,UK,13864,87,66647112,Europe,575679,42679
2020-10-11,United_Kingdom,UK,15165,81,66647112,Europe,590844,42760
2020-10-12,United_Kingdom,UK,12872,65,66647112,Europe,603716,42825
2020-10-13,United_Kingdom,UK,13972,50,66647112,Europe,617688,42875
2020-10-14,United_Kingdom,UK,17232,143,66647112,Europe,634920,43018
2020-10-15,United_Kingdom,UK,19724,137,66647112,Europe,654644,43155
2020-10-16,United_Kingdom,UK,18978,138,66647112,Europe,673622,43293
2020-10-17,United_Kingdom,UK,15635,136,66647112,Europe,689257,43429
2020-10-18,United_Kingdom,UK,16171,150,66647112,Europe,705428,43579
2020-10-19,United_Kingdom,UK,16981,67,66647112,Europe,722409,43646
2020-10-20,United_Kingdom,UK,18803,80,66647112,Europe,741212,43726
2020-10-21,United_Kingdom,UK,21330,241,66647112,Europe,762542,43967
2020-10-22,United_Kingdom,UK,26687,191,66647112,Europe,789229,44158
2020-10-23,United_Kingdom,UK,21238,189,66647112,Europe,810467,44347
2020-10-24,United_Kingdom,UK,20531,224,66647112,Europe,830998,44571
2020-10-25,United_Kingdom,UK,23012,174,66647112,Europe,854010,44745
2020-10-26,United_Kingdom,UK,19790,151,66647112,Europe,873800,44896
2020-10-27,United_Kingdom,UK,20890,102,66647112,Europe,894690,44998
2020-10-28,United_Kingdom,UK,22885,367,66647112,Europe,917575,45365
2020-10-29,United_Kingdom,UK,24700,310,66647112,Europe,942275,45675
2020-10-30,United_Kingdom,UK,23065,280,66647112,Europe,965340,45955
2020-10-31,United_Kingdom,UK,24405,274,66647112,Europe,989745,46229
2020-11-01,United_Kingdom,UK,21915,326,66647112,Europe,1011660,46555
2020-11-02,United_Kingdom,UK,23254,162,66647112,Europe,1034914,46717
2020-11-03,United_Kingdom,UK,18950,136,66647112,Europe,1053864,46853
2020-11-04,United_Kingdom,UK,20018,397,66647112,Europe,1073882,47250
2020-11-05,United_Kingdom,UK,25177,492,66647112,Europe,1099059,47742
2020-11-06,United_Kingdom,UK,24138,378,66647112,Europe,1123197,48120
2020-11-07,United_Kingdom,UK,23287,355,66647112,Europe,1146484,48475
2020-11-08,United_Kingdom,UK,24957,413,66647112,Europe,1171441,48888
2020-11-09,United_Kingdom,UK,20572,156,66647112,Europe,1192013,49044
2020-11-10,United_Kingdom,UK,21350,194,66647112,Europe,1213363,49238
2020-11-11,United_Kingdom,UK,20412,532,66647112,Europe,1233775,49770
2020-11-12,United_Kingdom,UK,22950,595,66647112,Europe,1256725,50365
2020-11-13,United_Kingdom,UK,33470,563,66647112,Europe,1290195,50928
2020-11-14,United_Kingdom,UK,27301,376,66647112,Europe,1317496,51304
2020-11-15,United_Kingdom,UK,26860,462,66647112,Europe,1344356,51766
2020-11-16,United_Kingdom,UK,24962,168,66647112,Europe,1369318,51934
2020-11-17,United_Kingdom,UK,21363,213,66647112,Europe,1390681,52147
2020-11-18,United_Kingdom,UK,20051,598,66647112,Europe,1410732,52745
2020-11-19,United_Kingdom,UK,19609,529,66647112,Europe,1430341,53274
2020-11-20,United_Kingdom,UK,22915,501,66647112,Europe,1453256,53775
2020-11-21,United_Kingdom,UK,20252,511,66647112,Europe,1473508,54286
2020-11-22,United_Kingdom,UK,19875,340,66647112,Europe,1493383,54626
2020-11-23,United_Kingdom,UK,18662,125,66647112,Europe,1512045,54751
2020-11-24,United_Kingdom,UK,15450,479,66647112,Europe,1527495,55230
2020-11-25,United_Kingdom,UK,11299,608,66647112,Europe,1538794,55838
2020-11-26,United_Kingdom,UK,18213,695,66647112,Europe,1557007,56533
2020-11-27,United_Kingdom,UK,17555,498,66647112,Europe,1574562,57031
2020-11-28,United_Kingdom,UK,14739,520,66647112,Europe,1589301,57551
2020-11-29,United_Kingdom,UK,15871,479,66647112,Europe,1605172,58030
2020-11-30,United_Kingdom,UK,12155,215,66647112,Europe,1617327,58245
2020-12-01,United_Kingdom,UK,12330,203,66647112,Europe,1629657,58448
2020-12-02,United_Kingdom,UK,13429,603,66647112,Europe,1643086,59051
2020-12-03,United_Kingdom,UK,16170,648,66647112,Europe,1659256,59699
2020-12-04,United_Kingdom,UK,14878,414,66647112,Europe,1674134,60113
2020-12-05,United_Kingdom,UK,16298,504,66647112,Europe,1690432,60617
2020-12-06,United_Kingdom,UK,15539,397,66647112,Europe,1705971,61014
2020-12-07,United_Kingdom,UK,17271,231,66647112,Europe,1723242,61245
2020-12-08,United_Kingdom,UK,14718,189,66647112,Europe,1737960,61434
2020-12-09,United_Kingdom,UK,12281,599,66647112,Europe,1750241,62033
2020-12-10,United_Kingdom,UK,16578,533,66647112,Europe,1766819,62566
2020-12-11,United_Kingdom,UK,20964,516,66647112,Europe,1787783,63082
2020-12-12,United_Kingdom,UK,21672,424,66647112,Europe,1809455,63506
2020-12-13,United_Kingdom,UK,21501,520,66647112,Europe,1830956,64026
2020-12-14,United_Kingdom,UK,18447,144,66647112,Europe,1849403,64170
2019-12-31,United_States_of_America,US,0,0,329064917,America,0,0
2020-01-01,United_States_of_America,US,0,0,329064917,America,0,0
2020-01-02,United_States_of_America,US,0,0,329064917,America,0,0
2020-01-03,United_States_of_America,US,0,0,329064917,America,0,0
2020-01-04,United_States_of_America,US,0,0,329064917,America,0,0
2020-01-05,United_States_of_America,US,0,0,329064917,America,0,0
2020-01-06,United_States_of_America,US,0,0,329064917,America,0,0
2020-01-07,United_States_of_America,US,0,0,329064917,America,0,0
2020-01-08,United_States_of_America,US,0,0,329064917,America,0,0
2020-01-09,United_States_of_America,US,0,0,329064917,America,0,0
2020-01-10,United_States_of_America,US,0,0,329064917,America,0,0
2020-01-11,United_States_of_America,US,0,0,329064917,America,0,0
2020-01-12,United_States_of_America,US,0,0,329064917,America,0,0
2020-01-13,United_States_of_America,US,0,0,329064917,America,0,0
2020-01-14,United_States_of_America,US,0,0,329064917,America,0,0
2020-01-15,United_States_of_America,US,0,0,329064917,America,0,0
2020-01-16,United_States_of_America,US,0,0,329064917,America,0,0
2020-01-17,United_States_of_America,US,0,0,329064917,America,0,0
2020-01-18,United_States_of_America,US,0,0,329064917,America,0,0
2020-01-19,United_States_of_America,US,0,0,329064917,America,0,0
2020-01-20,United_States_of_America,US,0,0,329064917,America,0,0
2020-01-21,United_States_of_America,US,1,0,329064917,America,1,0
2020-01-22,United_States_of_America,US,0,0,329064917,America,1,0
2020-01-23,United_States_of_America,US,0,0,329064917,America,1,0
2020-01-24,United_States_of_America,US,0,0,329064917,America,1,0
2020-01-25,United_States_of_America,US,1,0,329064917,America,2,0
2020-01-26,United_States_of_America,US,0,0,329064917,America,2,0
2020-01-27,United_States_of_America,US,3,0,329064917,America,5,0
2020-01-28,United_States_of_America,US,0,0,329064917,America,5,0
2020-01-29,United_States_of_America,US,0,0,329064917,America,5,0
2020-01-30,United_States_of_America,US,0,0,329064917,America,5,0
2020-01-31,United_States_of_America,US,1,0,329064917,America,6,0
2020-02-01,United_States_of_America,US,1,0,329064917,America,7,0
2020-02-02,United_States_of_America,US,1,0,329064917,America,8,0
2020-02-03,United_States_of_America,US,3,0,329064917,America,11,0
2020-02-04,United_States_of_America,US,0,0,329064917,America,11,0
2020-02-05,United_States_of_America,US,0,0,329064917,America,11,0
2020-02-06,United_States_of_America,US,1,0,329064917,America,12,0
2020-02-07,United_States_of_America,US,0,0,329064917,America,12,0
2020-02-08,United_States_of_America,US,0,0,329064917,America,12,0
2020-02-09,United_States_of_America,US,0,0,329064917,America,12,0
2020-02-10,United_States_of_America,US,0,0,329064917,America,12,0
2020-02-11,United_States_of_America,US,1,0,329064917,America,13,0
2020-02-12,United_States_of_America,US,0,0,329064917,America,13,0
2020-02-13,United_States_of_America,US,1,0,329064917,America,14,0
2020-02-14,United_States_of_America,US,1,0,329064917,America,15,0
2020-02-15,United_States_of_America,US,0,0,329064917,America,15,0
2020-02-16,United_States_of_America,US,0,0,329064917,America,15,0
2020-02-17,United_States_of_America,US,0,0,329064917,America,15,0
2020-02-18,United_States_of_America,US,0,0,329064917,America,15,0
2020-02-19,United_States_of_America,US,0,0,329064917,America,15,0
2020-02-20,United_States_of_America,US,0,0,329064917,America,15,0
2020-02-21,United_States_of_America,US,1,0,329064917,America,16,0
2020-02-22,United_States_of_America,US,19,0,329064917,America,35,0
2020-02-23,United_States_of_America,US,0,0,329064917,America,35,0
2020-02-24,United_States_of_America,US,0,0,329064917,America,35,0
2020-02-25,United_States_of_America,US,18,0,329064917,America,53,0
2020-02-26,United_States_of_America,US,0,0,329064917,America,53,0
2020-02-27,United_States_of_America,US,6,0,329064917,America,59,0
2020-02-28,United_States_of_America,US,1,0,329064917,America,60,0
2020-02-29,United_States_of_America,US,6,0,329064917,America,66,0
2020-03-01,United_States_of_America,US,3,1,329064917,America,69,1
2020-03-02,United_States_of_America,US,20,1,329064917,America,89,2
2020-03-03,United_States_of_America,US,14,4,329064917,America,103,6
2020-03-04,United_States_of_America,US,22,3,329064917,America,125,9
2020-03-05,United_States_of_America,US,34,2,329064917,America,159,11
2020-03-06,United_States_of_America,US,74,1,329064917,America,233,12
2020-03-07,United_States_of_America,US,105,2,329064917,America,338,14
2020-03-08,United_States_of_America,US,95,3,329064917,America,433,17
2020-03-09,United_States_of_America,US,121,4,329064917,America,554,21
2020-03-10,United_States_of_America,US,200,5,329064917,America,754,26
2020-03-11,United_States_of_America,US,271,2,329064917,America,1025,28
2020-03-12,United_States_of_America,US,287,2,329064917,America,1312,30
2020-03-13,United_States_of_America,US,351,10,329064917,America,1663,40
2020-03-14,United_States_of_America,US,511,7,329064917,America,2174,47
2020-03-15,United_States_of_America,US,777,10,329064917,America,2951,57
2020-03-16,United_States_of_America,US,823,12,329064917,America,3774,69
2020-03-17,United_States_of_America,US,887,16,329064917,America,4661,85
2020-03-18,United_States_of_America,US,1766,23,329064917,America,6427,108
2020-03-19,United_States_of_America,US,2988,42,329064917,America,9415,150
2020-03-20,United_States_of_America,US,4835,0,329064917,America,14250,150
2020-03-21,United_States_of_America,US,5374,110,329064917,America,19624,260
2020-03-22,United_States_of_America,US,7123,80,329064917,America,26747,340
2020-03-23,United_States_of_America,US,8459,131,329064917,America,35206,471
2020-03-24,United_States_of_America,US,11236,119,329064917,America,46442,590
2020-03-25,United_States_of_America,US,8789,211,329064917,America,55231,801
2020-03-26,United_States_of_America,US,13963,249,329064917,America,69194,1050
2020-03-27,United_States_of_America,US,16797,246,329064917,America,85991,1296
2020-03-28,United_States_of_America,US,18695,411,329064917,America,104686,1707
2020-03-29,United_States_of_America,US,19979,484,329064917,America,124665,2191
2020-03-30,United_States_of_America,US,18360,318,329064917,America,143025,2509
2020-03-31,United_States_of_America,US,21595,661,329064917,America,164620,3170
2020-04-01,United_States_of_America,US,24998,909,329064917,America,189618,4079
2020-04-02,United_States_of_America,US,27103,1059,329064917,America,216721,5138
2020-04-03,United_States_of_America,US,28819,915,329064917,America,245540,6053
2020-04-04,United_States_of_America,US,32425,1104,329064917,America,277965,7157
2020-04-05,United_States_of_America,US,34272,1344,329064917,America,312237,8501
2020-04-06,United_States_of_America,US,25398,1146,329064917,America,337635,9647
2020-04-07,United_States_of_America,US,30561,1342,329064917,America,368196,10989
2020-04-08,United_States_of_America,US,30613,1906,329064917,America,398809,12895
2020-04-09,United_States_of_America,US,33323,1922,329064917,America,432132,14817
2020-04-10,United_States_of_America,US,33901,1873,329064917,America,466033,16690
2020-04-11,United_States_of_America,US,35527,2087,329064917,America,501560,18777
2020-04-12,United_States_of_America,US,28391,1831,329064917,America,529951,20608
2020-04-13,United_States_of_America,US,27620,1500,329064917,America,557571,22108
2020-04-14,United_States_of_America,US,25023,1541,329064917,America,582594,23649
2020-04-15,United_States_of_America,US,26922,2408,329064917,America,609516,26057
2020-04-16,United_States_of_America,US,30148,4928,329064917,America,639664,30985
2020-04-17,United_States_of_America,US,31667,2299,329064917,America,671331,33284
2020-04-18,United_States_of_America,US,30833,3770,329064917,America,702164,37054
2020-04-19,United_States_of_America,US,32922,1856,329064917,America,735086,38910
2020-04-20,United_States_of_America,US,24601,1772,329064917,America,759687,40682
2020-04-21,United_States_of_America,US,28065,1857,329064917,America,787752,42539
2020-04-22,United_States_of_America,US,37289,2524,329064917,America,825041,45063
2020-04-23,United_States_of_America,US,17588,1721,329064917,America,842629,46784
2020-04-24,United_States_of_America,US,26543,3179,329064917,America,869172,49963
2020-04-25,United_States_of_America,US,21352,1054,329064917,America,890524,51017
2020-04-26,United_States_of_America,US,48529,2172,329064917,America,939053,53189
2020-04-27,United_States_of_America,US,26857,1687,329064917,America,965910,54876
2020-04-28,United_States_of_America,US,22541,1369,329064917,America,988451,56245
2020-04-29,United_States_of_America,US,24132,2110,329064917,America,1012583,58355
2020-04-30,United_States_of_America,US,27326,2611,329064917,America,1039909,60966
2020-05-01,United_States_of_America,US,29917,2040,329064917,America,1069826,63006
2020-05-02,United_States_of_America,US,33955,2062,329064917,America,1103781,65068
2020-05-03,United_States_of_America,US,29288,1317,329064917,America,1133069,66385
2020-05-04,United_States_of_America,US,24972,1297,329064917,America,1158041,67682
2020-05-05,United_States_of_America,US,22593,1252,329064917,America,1180634,68934
2020-05-06,United_States_of_America,US,23841,2144,329064917,America,1204475,71078
2020-05-07,United_States_of_America,US,24128,2353,329064917,America,1228603,73431
2020-05-08,United_States_of_America,US,28369,2239,329064917,America,1256972,75670
2020-05-09,United_States_of_America,US,26957,1510,329064917,America,1283929,77180
2020-05-10,United_States_of_America,US,25612,1614,329064917,America,1309541,78794
2020-05-11,United_States_of_America,US,20258,734,329064917,America,1329799,79528
2020-05-12,United_States_of_America,US,18117,1156,329064917,America,1347916,80684
2020-05-13,United_States_of_America,US,22048,1703,329064917,America,1369964,82387
2020-05-14,United_States_of_America,US,20782,1746,329064917,America,1390746,84133
2020-05-15,United_States_of_America,US,27143,1773,329064917,America,1417889,85906
2020-05-16,United_States_of_America,US,25508,1662,329064917,America,1443397,87568
2020-05-17,United_States_of_America,US,24487,1186,329064917,America,1467884,88754
2020-05-18,United_States_of_America,US,18873,808,329064917,America,1486757,89562
2020-05-19,United_States_of_America,US,21841,791,329064917,America,1508598,90353
2020-05-20,United_States_of_America,US,19970,1568,329064917,America,1528568,91921
2020-05-21,United_States_of_America,US,23285,1518,329064917,America,1551853,93439
2020-05-22,United_States_of_America,US,25434,1263,329064917,America,1577287,94702
2020-05-23,United_States_of_America,US,24147,1305,329064917,America,1601434,96007
2020-05-24,United_States_of_America,US,21236,1080,329064917,America,1622670,97087
2020-05-25,United_States_of_America,US,20568,633,329064917,America,1643238,97720
2020-05-26,United_States_of_America,US,19064,500,329064917,America,1662302,98220
2020-05-27,United_States_of_America,US,18910,696,329064917,America,1681212,98916
2020-05-28,United_States_of_America,US,18721,1526,329064917,America,1699933,100442
2020-05-29,United_States_of_America,US,21817,1175,329064917,America,1721750,101617
2020-05-30,United_States_of_America,US,25337,1219,329064917,America,1747087,102836
2020-05-31,United_States_of_America,US,23297,945,329064917,America,1770384,103781
2020-06-01,United_States_of_America,US,19807,602,329064917,America,1790191,104383
2020-06-02,United_States_of_America,US,21086,764,329064917,America,1811277,105147
2020-06-03,United_States_of_America,US,20544,1034,329064917,America,1831821,106181
2020-06-04,United_States_of_America,US,19699,994,329064917,America,1851520,107175
2020-06-05,United_States_of_America,US,21140,1036,329064917,America,1872660,108211
2020-06-06,United_States_of_America,US,25178,932,329064917,America,1897838,109143
2020-06-07,United_States_of_America,US,22223,659,329064917,America,1920061,109802
2020-06-08,United_States_of_America,US,22302,712,329064917,America,1942363,110514
2020-06-09,United_States_of_America,US,18822,493,329064917,America,1961185,111007
2020-06-10,United_States_of_America,US,18665,999,329064917,America,1979850,112006
2020-06-11,United_States_of_America,US,20614,918,329064917,America,2000464,112924
2020-06-12,United_States_of_America,US,22883,896,329064917,America,2023347,113820
2020-06-13,United_States_of_America,US,25639,849,329064917,America,2048986,114669
2020-06-14,United_States_of_America,US,25540,767,329064917,America,2074526,115436
2020-06-15,United_States_of_America,US,19543,296,329064917,America,2094069,115732
2020-06-16,United_States_of_America,US,19957,395,329064917,America,2114026,116127
2020-06-17,United_States_of_America,US,23705,836,329064917,America,2137731,116963
2020-06-18,United_States_of_America,US,25559,754,329064917,America,2163290,117717
2020-06-19,United_States_of_America,US,27762,717,329064917,America,2191052,118434
2020-06-20,United_States_of_America,US,29909,678,329064917,America,2220961,119112
2020-06-21,United_States_of_America,US,34158,607,329064917,America,2255119,119719
2020-06-22,United_States_of_America,US,25793,256,329064917,America,2280912,119975
2020-06-23,United_States_of_America,US,31390,427,329064917,America,2312302,120402
2020-06-24,United_States_of_America,US,34720,826,329064917,America,2347022,121228
2020-06-25,United_States_of_America,US,34339,751,329064917,America,2381361,121979
2020-06-26,United_States_of_America,US,40949,2437,329064917,America,2422310,124416
2020-06-27,United_States_of_America,US,45527,623,329064917,America,2467837,125039
2020-06-28,United_States_of_America,US,42486,500,329064917,America,2510323,125539
2020-06-29,United_States_of_America,US,38673,265,329064917,America,2548996,125804
2020-06-30,United_States_of_America,US,41556,336,329064917,America,2590552,126140
2020-07-01,United_States_of_America,US,43880,1270,329064917,America,2634432,127410
2020-07-02,United_States_of_America,US,52048,652,329064917,America,2686480,128062
2020-07-03,United_States_of_America,US,53399,678,329064917,America,2739879,128740
2020-07-04,United_States_of_America,US,54442,694,329064917,America,2794321,129434
2020-07-05,United_States_of_America,US,45221,242,329064917,America,2839542,129676
2020-07-06,United_States_of_America,US,49093,271,329064917,America,2888635,129947
2020-07-07,United_States_of_America,US,49990,359,329064917,America,2938625,130306
2020-07-08,United_States_of_America,US,57473,1174,329064917,America,2996098,131480
2020-07-09,United_States_of_America,US,58906,829,329064917,America,3055004,132309
2020-07-10,United_States_of_America,US,63004,982,329064917,America,3118008,133291
2020-07-11,United_States_of_America,US,66625,806,329064917,America,3184633,134097
2020-07-12,United_States_of_America,US,63051,717,329064917,America,3247684,134814
2020-07-13,United_States_of_America,US,57258,391,329064917,America,3304942,135205
2020-07-14,United_States_of_America,US,58114,400,329064917,America,3363056,135605
2020-07-15,United_States_of_America,US,68518,861,329064917,America,3431574,136466
2020-07-16,United_States_of_America,US,67717,953,329064917,America,3499291,137419
2020-07-17,United_States_of_America,US,76930,939,329064917,America,3576221,138358
2020-07-18,United_States_of_America,US,71494,908,329064917,America,3647715,139266
2020-07-19,United_States_of_America,US,63749,853,329064917,America,3711464,140119
2020-07-20,United_States_of_America,US,61796,415,329064917,America,3773260,140534
2020-07-21,United_States_of_America,US,56750,372,329064917,America,3830010,140906
2020-07-22,United_States_of_America,US,72048,1160,329064917,America,3902058,142066
2020-07-23,United_States_of_America,US,68848,1124,329064917,America,3970906,143190
2020-07-24,United_States_of_America,US,63196,1052,329064917,America,4034102,144242
2020-07-25,United_States_of_America,US,78427,1304,329064917,America,4112529,145546
2020-07-26,United_States_of_America,US,65498,914,329064917,America,4178027,146460
2020-07-27,United_States_of_America,US,55993,475,329064917,America,4234020,146935
2020-07-28,United_States_of_America,US,56243,1076,329064917,America,4290263,148011
2020-07-29,United_States_of_America,US,61734,1245,329064917,America,4351997,149256
2020-07-30,United_States_of_America,US,74985,1457,329064917,America,4426982,150713
2020-07-31,United_States_of_America,US,68032,1357,329064917,America,4495014,152070
2020-08-01,United_States_of_America,US,67023,1244,329064917,America,4562037,153314
2020-08-02,United_States_of_America,US,58407,1133,329064917,America,4620444,154447
2020-08-03,United_States_of_America,US,47511,413,329064917,America,4667955,154860
2020-08-04,United_States_of_America,US,45607,543,329064917,America,4713562,155403
2020-08-05,United_States_of_America,US,57525,1403,329064917,America,4771087,156806
2020-08-06,United_States_of_America,US,52804,1450,329064917,America,4823891,158256
2020-08-07,United_States_of_America,US,59755,1848,329064917,America,4883646,160104
2020-08-08,United_States_of_America,US,58150,1252,329064917,America,4941796,161356
2020-08-09,United_States_of_America,US,56221,1069,329064917,America,4998017,162425
2020-08-10,United_States_of_America,US,46847,513,329064917,America,5044864,162938
2020-08-11,United_States_of_America,US,49530,523,329064917,America,5094394,163461
2020-08-12,United_States_of_America,US,46813,1076,329064917,America,5141207,164537
2020-08-13,United_States_of_America,US,55941,1490,329064917,America,5197148,166027
2020-08-14,United_States_of_America,US,51094,1083,329064917,America,5248242,167110
2020-08-15,United_States_of_America,US,64838,1336,329064917,America,5313080,168446
2020-08-16,United_States_of_America,US,48085,1035,329064917,America,5361165,169481
2020-08-17,United_States_of_America,US,42104,571,329064917,America,5403269,170052
2020-08-18,United_States_of_America,US,35056,445,329064917,America,5438325,170497
2020-08-19,United_States_of_America,US,44091,1324,329064917,America,5482416,171821
2020-08-20,United_States_of_America,US,47426,1356,329064917,America,5529842,173177
2020-08-21,United_States_of_America,US,44005,1078,329064917,America,5573847,174255
2020-08-22,United_States_of_America,US,49880,1151,329064917,America,5623727,175406
2020-08-23,United_States_of_America,US,44378,956,329064917,America,5668105,176362
2020-08-24,United_States_of_America,US,34506,444,329064917,America,5702611,176806
2020-08-25,United_States_of_America,US,38298,473,329064917,America,5740909,177279
2020-08-26,United_States_of_America,US,38119,1207,329064917,America,5779028,178486
2020-08-27,United_States_of_America,US,42848,1228,329064917,America,5821876,179714
2020-08-28,United_States_of_America,US,45909,1110,329064917,America,5867785,180824
2020-08-29,United_States_of_America,US,49654,949,329064917,America,5917439,181773
2020-08-30,United_States_of_America,US,44143,1006,329064917,America,5961582,182779
2020-08-31,United_States_of_America,US,35581,290,329064917,America,5997163,183069
2020-09-01,United_States_of_America,US,33850,529,329064917,America,6031013,183598
2020-09-02,United_States_of_America,US,44639,1091,329064917,America,6075652,184689
2020-09-03,United_States_of_America,US,38754,1055,329064917,America,6114406,185744
2020-09-04,United_States_of_America,US,36249,1053,329064917,America,6150655,186797
2020-09-05,United_States_of_America,US,51071,968,329064917,America,6201726,187765
2020-09-06,United_States_of_America,US,44140,773,329064917,America,6245866,188538
2020-09-07,United_States_of_America,US,30555,403,329064917,America,6276421,188941
2020-09-08,United_States_of_America,US,24250,267,329064917,America,6300671,189208
2020-09-09,United_States_of_America,US,27122,471,329064917,America,6327793,189679
2020-09-10,United_States_of_America,US,31927,1136,329064917,America,6359720,190815
2020-09-11,United_States_of_America,US,37507,974,329064917,America,6397227,191789
2020-09-12,United_States_of_America,US,48061,1227,329064917,America,6445288,193016
2020-09-13,United_States_of_America,US,40820,685,329064917,America,6486108,193701
2020-09-14,United_States_of_America,US,33871,378,329064917,America,6519979,194079
2020-09-15,United_States_of_America,US,34841,451,329064917,America,6554820,194530
2020-09-16,United_States_of_America,US,51473,1407,329064917,America,6606293,195937
2020-09-17,United_States_of_America,US,24598,865,329064917,America,6630891,196802
2020-09-18,United_States_of_America,US,43567,831,329064917,America,6674458,197633
2020-09-19,United_States_of_America,US,50209,956,329064917,America,6724667,198589
2020-09-20,United_States_of_America,US,40295,669,329064917,America,6764962,199258
2020-09-21,United_States_of_America,US,39852,251,329064917,America,6804814,199509
2020-09-22,United_States_of_America,US,53153,372,329064917,America,6857967,199881
2020-09-23,United_States_of_America,US,38307,926,329064917,America,6896274,200807
2020-09-24,United_States_of_America,US,37930,1102,329064917,America,6934204,201909
2020-09-25,United_States_of_America,US,44213,901,329064917,America,6978417,202810
2020-09-26,United_States_of_America,US,55013,964,329064917,America,7033430,203774
2020-09-27,United_States_of_America,US,45368,723,329064917,America,7078798,204497
2020-09-28,United_States_of_America,US,36248,259,329064917,America,7115046,204756
2020-09-29,United_States_of_America,US,32998,314,329064917,America,7148044,205070
2020-09-30,United_States_of_America,US,43017,928,329064917,America,7191061,205998
2020-10-01,United_States_of_America,US,41982,930,329064917,America,7233043,206928
2020-10-02,United_States_of_America,US,44771,880,329064917,America,7277814,207808
2020-10-03,United_States_of_America,US,54471,908,329064917,America,7332285,208716
2020-10-04,United_States_of_America,US,50659,678,329064917,America,7382944,209394
2020-10-05,United_States_of_America,US,34901,400,329064917,America,7417845,209794
2020-10-06,United_States_of_America,US,40705,398,329064917,America,7458550,210192
2020-10-07,United_States_of_America,US,43062,717,329064917,America,7501612,210909
2020-10-08,United_States_of_America,US,48182,892,329064917,America,7549794,211801
2020-10-09,United_States_of_America,US,56800,972,329064917,America,7606594,212773
2020-10-10,United_States_of_America,US,58082,1014,329064917,America,7664676,213787
2020-10-11,United_States_of_America,US,54271,590,329064917,America,7718947,214377
2020-10-12,United_States_of_America,US,43597,394,329064917,America,7762544,214771
2020-10-13,United_States_of_America,US,41653,314,329064917,America,7804197,215085
2020-10-14,United_States_of_America,US,52517,817,329064917,America,7856714,215902
2020-10-15,United_States_of_America,US,59386,970,329064917,America,7916100,216872
2020-10-16,United_States_of_America,US,63785,828,329064917,America,7979885,217700
2020-10-17,United_States_of_America,US,70256,899,329064917,America,8050141,218599
2020-10-18,United_States_of_America,US,56611,690,329064917,America,8106752,219289
2020-10-19,United_States_of_America,US,47843,385,329064917,America,8154595,219674
2020-10-20,United_States_of_America,US,60160,459,329064917,America,8214755,220133
2020-10-21,United_States_of_America,US,58549,933,329064917,America,8273304,221066
2020-10-22,United_States_of_America,US,62978,1135,329064917,America,8336282,222201
2020-10-23,United_States_of_America,US,72058,841,329064917,America,8408340,223042
2020-10-24,United_States_of_America,US,85329,953,329064917,America,8493669,223995
2020-10-25,United_States_of_America,US,83056,904,329064917,America,8576725,224899
2020-10-26,United_States_of_America,US,59440,331,329064917,America,8636165,225230
2020-10-27,United_States_of_America,US,68359,505,329064917,America,8704524,225735
2020-10-28,United_States_of_America,US,75129,988,329064917,America,8779653,226723
2020-10-29,United_States_of_America,US,78371,977,329064917,America,8858024,227700
2020-10-30,United_States_of_America,US,88130,968,329064917,America,8946154,228668
2020-10-31,United_States_of_America,US,101273,1040,329064917,America,9047427,229708
2020-11-01,United_States_of_America,US,78934,848,329064917,America,9126361,230556
2020-11-02,United_States_of_America,US,81001,440,329064917,America,9207362,230996
2020-11-03,United_States_of_America,US,83883,555,329064917,America,9291245,231551
2020-11-04,United_States_of_America,US,92734,1076,329064917,America,9383979,232627
2020-11-05,United_States_of_America,US,102507,1102,329064917,America,9486486,233729
2020-11-06,United_States_of_America,US,122436,1208,329064917,America,9608922,234937
2020-11-07,United_States_of_America,US,130623,1162,329064917,America,9739545,236099
2020-11-08,United_States_of_America,US,121413,1014,329064917,America,9860958,237113
2020-11-09,United_States_of_America,US,110693,459,329064917,America,9971651,237572
2020-11-10,United_States_of_America,US,138901,679,329064917,America,10110552,238251
2020-11-11,United_States_of_America,US,147274,1432,329064917,America,10257826,239683
2020-11-12,United_States_of_America,US,143306,2117,329064917,America,10401132,241800
2020-11-13,United_States_of_America,US,153669,630,329064917,America,10554801,242430
2020-11-14,United_States_of_America,US,184813,1915,329064917,America,10739614,244345
2020-11-15,United_States_of_America,US,165277,1255,329064917,America,10904891,245600
2020-11-16,United_States_of_America,US,132170,614,329064917,America,11037061,246214
2020-11-17,United_States_of_America,US,168425,1006,329064917,America,11205486,247220
2020-11-18,United_States_of_America,US,154316,1467,329064917,America,11359802,248687
2020-11-19,United_States_of_America,US,170005,1850,329064917,America,11529807,250537
2020-11-20,United_States_of_America,US,188020,2018,329064917,America,11717827,252555
2020-11-21,United_States_of_America,US,196117,1858,329064917,America,11913944,254413
2020-11-22,United_States_of_America,US,175494,1486,329064917,America,12089438,255899
2020-11-23,United_States_of_America,US,157471,883,329064917,America,12246909,256782
2020-11-24,United_States_of_America,US,173963,919,329064917,America,12420872,257701
2020-11-25,United_States_of_America,US,170293,2224,329064917,America,12591165,259925
2020-11-26,United_States_of_America,US,186589,2341,329064917,America,12777754,262266
2020-11-27,United_States_of_America,US,106091,1189,329064917,America,12883845,263455
2020-11-28,United_States_of_America,US,207913,1404,329064917,America,13091758,264859
2020-11-29,United_States_of_America,US,154893,1204,329064917,America,13246651,266063
2020-11-30,United_States_of_America,US,136670,810,329064917,America,13383321,266873
2020-12-01,United_States_of_America,US,157903,1172,329064917,America,13541224,268045
2020-12-02,United_States_of_America,US,180421,2600,329064917,America,13721645,270645
2020-12-03,United_States_of_America,US,203311,3190,329064917,America,13924956,273835
2020-12-04,United_States_of_America,US,214747,2481,329064917,America,14139703,276316
2020-12-05,United_States_of_America,US,231930,2680,329064917,America,14371633,278996
2020-12-06,United_States_of_America,US,211933,2203,329064917,America,14583566,281199
2020-12-07,United_States_of_America,US,173432,1111,329064917,America,14756998,282310
2020-12-08,United_States_of_America,US,197334,1433,329064917,America,14954332,283743
2020-12-09,United_States_of_America,US,217344,2564,329064917,America,15171676,286307
2020-12-10,United_States_of_America,US,220025,3124,329064917,America,15391701,289431
2020-12-11,United_States_of_America,US,224680,2748,329064917,America,15616381,292179
2020-12-12,United_States_of_America,US,234633,3343,329064917,America,15851014,295522
2020-12-13,United_States_of_America,US,216017,2315,329064917,America,16067031,297837
2020-12-14,United_States_of_America,US,189723,1340,329064917,America,16256754,299177
2020-03-15,Uruguay,UY,6,0,3461731,America,6,0
2020-03-16,Uruguay,UY,2,0,3461731,America,8,0
2020-03-17,Uruguay,UY,21,0,3461731,America,29,0
2020-03-18,Uruguay,UY,21,0,3461731,America,50,0
2020-03-19,Uruguay,UY,29,0,3461731,America,79,0
2020-03-20,Uruguay,UY,15,0,3461731,America,94,0
2020-03-21,Uruguay,UY,16,0,3461731,America,110,0
2020-03-22,Uruguay,UY,25,0,3461731,America,135,0
2020-03-23,Uruguay,UY,23,0,3461731,America,158,0
2020-03-24,Uruguay,UY,4,0,3461731,America,162,0
2020-03-25,Uruguay,UY,27,0,3461731,America,189,0
2020-03-26,Uruguay,UY,28,0,3461731,America,217,0
2020-03-27,Uruguay,UY,21,0,3461731,America,238,0
2020-03-28,Uruguay,UY,0,0,3461731,America,238,0
2020-03-29,Uruguay,UY,21,0,3461731,America,259,0
2020-03-30,Uruguay,UY,36,1,3461731,America,295,1
2020-03-31,Uruguay,UY,29,0,3461731,America,324,1
2020-04-01,Uruguay,UY,6,0,3461731,America,330,1
2020-04-02,Uruguay,UY,11,1,3461731,America,341,2
2020-04-03,Uruguay,UY,18,2,3461731,America,359,4
2020-04-04,Uruguay,UY,12,0,3461731,America,371,4
2020-04-05,Uruguay,UY,19,1,3461731,America,390,5
2020-04-06,Uruguay,UY,17,1,3461731,America,407,6
2020-04-07,Uruguay,UY,4,0,3461731,America,411,6
2020-04-08,Uruguay,UY,6,1,3461731,America,417,7
2020-04-09,Uruguay,UY,9,0,3461731,America,426,7
2020-04-10,Uruguay,UY,7,0,3461731,America,433,7
2020-04-11,Uruguay,UY,13,0,3461731,America,446,7
2020-04-12,Uruguay,UY,7,0,3461731,America,453,7
2020-04-13,Uruguay,UY,12,1,3461731,America,465,8
2020-04-14,Uruguay,UY,7,0,3461731,America,472,8
2020-04-15,Uruguay,UY,11,0,3461731,America,483,8
2020-04-16,Uruguay,UY,10,1,3461731,America,493,9
2020-04-17,Uruguay,UY,9,0,3461731,America,502,9
2020-04-18,Uruguay,UY,6,0,3461731,America,508,9
2020-04-19,Uruguay,UY,9,0,3461731,America,517,9
2020-04-20,Uruguay,UY,11,1,3461731,America,528,10
2020-04-21,Uruguay,UY,7,0,3461731,America,535,10
2020-04-22,Uruguay,UY,8,2,3461731,America,543,12
2020-04-23,Uruguay,UY,6,0,3461731,America,549,12
2020-04-24,Uruguay,UY,8,0,3461731,America,557,12
2020-04-25,Uruguay,UY,6,0,3461731,America,563,12
2020-04-26,Uruguay,UY,33,2,3461731,America,596,14
2020-04-27,Uruguay,UY,10,1,3461731,America,606,15
2020-04-28,Uruguay,UY,14,0,3461731,America,620,15
2020-04-29,Uruguay,UY,5,0,3461731,America,625,15
2020-04-30,Uruguay,UY,5,0,3461731,America,630,15
2020-05-01,Uruguay,UY,13,2,3461731,America,643,17
2020-05-02,Uruguay,UY,5,0,3461731,America,648,17
2020-05-03,Uruguay,UY,4,0,3461731,America,652,17
2020-05-04,Uruguay,UY,3,0,3461731,America,655,17
2020-05-05,Uruguay,UY,2,0,3461731,America,657,17
2020-05-06,Uruguay,UY,13,0,3461731,America,670,17
2020-05-07,Uruguay,UY,3,0,3461731,America,673,17
2020-05-08,Uruguay,UY,11,0,3461731,America,684,17
2020-05-09,Uruguay,UY,10,1,3461731,America,694,18
2020-05-10,Uruguay,UY,8,0,3461731,America,702,18
2020-05-11,Uruguay,UY,5,1,3461731,America,707,19
2020-05-12,Uruguay,UY,4,0,3461731,America,711,19
2020-05-13,Uruguay,UY,6,0,3461731,America,717,19
2020-05-14,Uruguay,UY,2,0,3461731,America,719,19
2020-05-15,Uruguay,UY,5,0,3461731,America,724,19
2020-05-16,Uruguay,UY,8,0,3461731,America,732,19
2020-05-17,Uruguay,UY,1,0,3461731,America,733,19
2020-05-18,Uruguay,UY,1,1,3461731,America,734,20
2020-05-19,Uruguay,UY,3,0,3461731,America,737,20
2020-05-20,Uruguay,UY,1,0,3461731,America,738,20
2020-05-21,Uruguay,UY,8,0,3461731,America,746,20
2020-05-22,Uruguay,UY,3,0,3461731,America,749,20
2020-05-23,Uruguay,UY,4,0,3461731,America,753,20
2020-05-24,Uruguay,UY,11,2,3461731,America,764,22
2020-05-25,Uruguay,UY,5,0,3461731,America,769,22
2020-05-26,Uruguay,UY,18,0,3461731,America,787,22
2020-05-27,Uruguay,UY,2,0,3461731,America,789,22
2020-05-28,Uruguay,UY,14,0,3461731,America,803,22
2020-05-29,Uruguay,UY,8,0,3461731,America,811,22
2020-05-30,Uruguay,UY,5,0,3461731,America,816,22
2020-05-31,Uruguay,UY,5,0,3461731,America,821,22
2020-06-01,Uruguay,UY,2,0,3461731,America,823,22
2020-06-02,Uruguay,UY,2,1,3461731,America,825,23
2020-06-03,Uruguay,UY,1,0,3461731,America,826,23
2020-06-04,Uruguay,UY,2,0,3461731,America,828,23
2020-06-05,Uruguay,UY,4,0,3461731,America,832,23
2020-06-06,Uruguay,UY,2,0,3461731,America,834,23
2020-06-07,Uruguay,UY,11,0,3461731,America,845,23
2020-06-08,Uruguay,UY,0,0,3461731,America,845,23
2020-06-09,Uruguay,UY,0,0,3461731,America,845,23
2020-06-10,Uruguay,UY,1,0,3461731,America,846,23
2020-06-11,Uruguay,UY,1,0,3461731,America,847,23
2020-06-12,Uruguay,UY,0,0,3461731,America,847,23
2020-06-13,Uruguay,UY,0,0,3461731,America,847,23
2020-06-14,Uruguay,UY,0,0,3461731,America,847,23
2020-06-15,Uruguay,UY,1,0,3461731,America,848,23
2020-06-16,Uruguay,UY,0,0,3461731,America,848,23
2020-06-17,Uruguay,UY,1,1,3461731,America,849,24
2020-06-18,Uruguay,UY,0,0,3461731,America,849,24
2020-06-19,Uruguay,UY,1,0,3461731,America,850,24
2020-06-20,Uruguay,UY,3,0,3461731,America,853,24
2020-06-21,Uruguay,UY,6,1,3461731,America,859,25
2020-06-22,Uruguay,UY,17,0,3461731,America,876,25
2020-06-23,Uruguay,UY,6,0,3461731,America,882,25
2020-06-24,Uruguay,UY,3,0,3461731,America,885,25
2020-06-25,Uruguay,UY,17,1,3461731,America,902,26
2020-06-26,Uruguay,UY,5,0,3461731,America,907,26
2020-06-27,Uruguay,UY,12,0,3461731,America,919,26
2020-06-28,Uruguay,UY,5,0,3461731,America,924,26
2020-06-29,Uruguay,UY,5,1,3461731,America,929,27
2020-06-30,Uruguay,UY,3,0,3461731,America,932,27
2020-07-01,Uruguay,UY,4,0,3461731,America,936,27
2020-07-02,Uruguay,UY,7,1,3461731,America,943,28
2020-07-03,Uruguay,UY,4,0,3461731,America,947,28
2020-07-04,Uruguay,UY,5,0,3461731,America,952,28
2020-07-05,Uruguay,UY,3,0,3461731,America,955,28
2020-07-06,Uruguay,UY,1,0,3461731,America,956,28
2020-07-07,Uruguay,UY,4,1,3461731,America,960,29
2020-07-08,Uruguay,UY,5,0,3461731,America,965,29
2020-07-09,Uruguay,UY,9,0,3461731,America,974,29
2020-07-10,Uruguay,UY,3,0,3461731,America,977,29
2020-07-11,Uruguay,UY,8,0,3461731,America,985,29
2020-07-12,Uruguay,UY,1,1,3461731,America,986,30
2020-07-13,Uruguay,UY,1,1,3461731,America,987,31
2020-07-14,Uruguay,UY,2,0,3461731,America,989,31
2020-07-15,Uruguay,UY,8,0,3461731,America,997,31
2020-07-16,Uruguay,UY,12,0,3461731,America,1009,31
2020-07-17,Uruguay,UY,0,0,3461731,America,1009,31
2020-07-18,Uruguay,UY,28,1,3461731,America,1037,32
2020-07-19,Uruguay,UY,7,1,3461731,America,1044,33
2020-07-20,Uruguay,UY,10,0,3461731,America,1054,33
2020-07-21,Uruguay,UY,10,0,3461731,America,1064,33
2020-07-22,Uruguay,UY,32,0,3461731,America,1096,33
2020-07-23,Uruguay,UY,21,1,3461731,America,1117,34
2020-07-24,Uruguay,UY,24,0,3461731,America,1141,34
2020-07-25,Uruguay,UY,25,0,3461731,America,1166,34
2020-07-26,Uruguay,UY,8,0,3461731,America,1174,34
2020-07-27,Uruguay,UY,18,0,3461731,America,1192,34
2020-07-28,Uruguay,UY,10,1,3461731,America,1202,35
2020-07-29,Uruguay,UY,16,0,3461731,America,1218,35
2020-07-30,Uruguay,UY,19,0,3461731,America,1237,35
2020-07-31,Uruguay,UY,6,0,3461731,America,1243,35
2020-08-01,Uruguay,UY,21,0,3461731,America,1264,35
2020-08-02,Uruguay,UY,14,0,3461731,America,1278,35
2020-08-03,Uruguay,UY,8,1,3461731,America,1286,36
2020-08-04,Uruguay,UY,5,0,3461731,America,1291,36
2020-08-05,Uruguay,UY,9,1,3461731,America,1300,37
2020-08-06,Uruguay,UY,9,0,3461731,America,1309,37
2020-08-07,Uruguay,UY,9,0,3461731,America,1318,37
2020-08-08,Uruguay,UY,7,0,3461731,America,1325,37
2020-08-09,Uruguay,UY,10,0,3461731,America,1335,37
2020-08-10,Uruguay,UY,18,0,3461731,America,1353,37
2020-08-11,Uruguay,UY,11,0,3461731,America,1364,37
2020-08-12,Uruguay,UY,21,0,3461731,America,1385,37
2020-08-13,Uruguay,UY,8,0,3461731,America,1393,37
2020-08-14,Uruguay,UY,16,0,3461731,America,1409,37
2020-08-15,Uruguay,UY,12,1,3461731,America,1421,38
2020-08-16,Uruguay,UY,13,0,3461731,America,1434,38
2020-08-17,Uruguay,UY,6,0,3461731,America,1440,38
2020-08-18,Uruguay,UY,17,2,3461731,America,1457,40
2020-08-19,Uruguay,UY,28,0,3461731,America,1485,40
2020-08-20,Uruguay,UY,8,0,3461731,America,1493,40
2020-08-21,Uruguay,UY,13,1,3461731,America,1506,41
2020-08-22,Uruguay,UY,10,1,3461731,America,1516,42
2020-08-23,Uruguay,UY,5,0,3461731,America,1521,42
2020-08-24,Uruguay,UY,6,0,3461731,America,1527,42
2020-08-25,Uruguay,UY,6,0,3461731,America,1533,42
2020-08-26,Uruguay,UY,3,1,3461731,America,1536,43
2020-08-27,Uruguay,UY,7,0,3461731,America,1543,43
2020-08-28,Uruguay,UY,8,0,3461731,America,1551,43
2020-08-29,Uruguay,UY,5,0,3461731,America,1556,43
2020-08-30,Uruguay,UY,14,1,3461731,America,1570,44
2020-08-31,Uruguay,UY,15,0,3461731,America,1585,44
2020-09-01,Uruguay,UY,10,0,3461731,America,1595,44
2020-09-02,Uruguay,UY,16,0,3461731,America,1611,44
2020-09-03,Uruguay,UY,15,0,3461731,America,1626,44
2020-09-04,Uruguay,UY,10,0,3461731,America,1636,44
2020-09-05,Uruguay,UY,17,1,3461731,America,1653,45
2020-09-06,Uruguay,UY,16,0,3461731,America,1669,45
2020-09-07,Uruguay,UY,10,0,3461731,America,1679,45
2020-09-08,Uruguay,UY,14,0,3461731,America,1693,45
2020-09-09,Uruguay,UY,19,0,3461731,America,1712,45
2020-09-10,Uruguay,UY,29,0,3461731,America,1741,45
2020-09-11,Uruguay,UY,18,0,3461731,America,1759,45
2020-09-12,Uruguay,UY,14,0,3461731,America,1773,45
2020-09-13,Uruguay,UY,7,0,3461731,America,1780,45
2020-09-14,Uruguay,UY,28,0,3461731,America,1808,45
2020-09-15,Uruguay,UY,4,0,3461731,America,1812,45
2020-09-16,Uruguay,UY,15,0,3461731,America,1827,45
2020-09-17,Uruguay,UY,29,0,3461731,America,1856,45
2020-09-18,Uruguay,UY,20,1,3461731,America,1876,46
2020-09-19,Uruguay,UY,14,0,3461731,America,1890,46
2020-09-20,Uruguay,UY,14,0,3461731,America,1904,46
2020-09-21,Uruguay,UY,13,0,3461731,America,1917,46
2020-09-22,Uruguay,UY,10,0,3461731,America,1927,46
2020-09-23,Uruguay,UY,7,0,3461731,America,1934,46
2020-09-24,Uruguay,UY,12,1,3461731,America,1946,47
2020-09-25,Uruguay,UY,13,0,3461731,America,1959,47
2020-09-26,Uruguay,UY,8,0,3461731,America,1967,47
2020-09-27,Uruguay,UY,31,0,3461731,America,1998,47
2020-09-28,Uruguay,UY,10,0,3461731,America,2008,47
2020-09-29,Uruguay,UY,2,0,3461731,America,2010,47
2020-09-30,Uruguay,UY,23,1,3461731,America,2033,48
2020-10-01,Uruguay,UY,13,0,3461731,America,2046,48
2020-10-02,Uruguay,UY,15,0,3461731,America,2061,48
2020-10-03,Uruguay,UY,36,0,3461731,America,2097,48
2020-10-04,Uruguay,UY,25,0,3461731,America,2122,48
2020-10-05,Uruguay,UY,23,0,3461731,America,2145,48
2020-10-06,Uruguay,UY,10,0,3461731,America,2155,48
2020-10-07,Uruguay,UY,22,1,3461731,America,2177,49
2020-10-08,Uruguay,UY,29,0,3461731,America,2206,49
2020-10-09,Uruguay,UY,20,0,3461731,America,2226,49
2020-10-10,Uruguay,UY,25,0,3461731,America,2251,49
2020-10-11,Uruguay,UY,17,1,3461731,America,2268,50
2020-10-12,Uruguay,UY,26,0,3461731,America,2294,50
2020-10-13,Uruguay,UY,19,1,3461731,America,2313,51
2020-10-14,Uruguay,UY,24,0,3461731,America,2337,51
2020-10-15,Uruguay,UY,1,0,3461731,America,2338,51
2020-10-16,Uruguay,UY,79,0,3461731,America,2417,51
2020-10-17,Uruguay,UY,33,0,3461731,America,2450,51
2020-10-18,Uruguay,UY,51,0,3461731,America,2501,51
2020-10-19,Uruguay,UY,30,0,3461731,America,2531,51
2020-10-20,Uruguay,UY,29,0,3461731,America,2560,51
2020-10-21,Uruguay,UY,63,1,3461731,America,2623,52
2020-10-22,Uruguay,UY,40,1,3461731,America,2663,53
2020-10-23,Uruguay,UY,38,0,3461731,America,2701,53
2020-10-24,Uruguay,UY,58,0,3461731,America,2759,53
2020-10-25,Uruguay,UY,48,0,3461731,America,2807,53
2020-10-26,Uruguay,UY,44,0,3461731,America,2851,53
2020-10-27,Uruguay,UY,21,1,3461731,America,2872,54
2020-10-28,Uruguay,UY,44,0,3461731,America,2916,54
2020-10-29,Uruguay,UY,65,1,3461731,America,2981,55
2020-10-30,Uruguay,UY,63,2,3461731,America,3044,57
2020-10-31,Uruguay,UY,38,1,3461731,America,3082,58
2020-11-01,Uruguay,UY,42,0,3461731,America,3124,58
2020-11-02,Uruguay,UY,25,1,3461731,America,3149,59
2020-11-03,Uruguay,UY,16,1,3461731,America,3165,60
2020-11-04,Uruguay,UY,31,1,3461731,America,3196,61
2020-11-05,Uruguay,UY,49,0,3461731,America,3245,61
2020-11-06,Uruguay,UY,64,0,3461731,America,3309,61
2020-11-07,Uruguay,UY,61,0,3461731,America,3370,61
2020-11-08,Uruguay,UY,71,0,3461731,America,3441,61
2020-11-09,Uruguay,UY,73,1,3461731,America,3514,62
2020-11-10,Uruguay,UY,46,0,3461731,America,3560,62
2020-11-11,Uruguay,UY,60,0,3461731,America,3620,62
2020-11-12,Uruguay,UY,80,1,3461731,America,3700,63
2020-11-13,Uruguay,UY,95,0,3461731,America,3795,63
2020-11-14,Uruguay,UY,88,1,3461731,America,3883,64
2020-11-15,Uruguay,UY,74,0,3461731,America,3957,64
2020-11-16,Uruguay,UY,73,1,3461731,America,4030,65
2020-11-17,Uruguay,UY,74,2,3461731,America,4104,67
2020-11-18,Uruguay,UY,104,1,3461731,America,4208,68
2020-11-19,Uruguay,UY,88,0,3461731,America,4296,68
2020-11-20,Uruguay,UY,81,1,3461731,America,4377,69
2020-11-21,Uruguay,UY,100,0,3461731,America,4477,69
2020-11-22,Uruguay,UY,87,0,3461731,America,4564,69
2020-11-23,Uruguay,UY,135,2,3461731,America,4699,71
2020-11-24,Uruguay,UY,64,0,3461731,America,4763,71
2020-11-25,Uruguay,UY,107,1,3461731,America,4870,72
2020-11-26,Uruguay,UY,118,1,3461731,America,4988,73
2020-11-27,Uruguay,UY,129,1,3461731,America,5117,74
2020-11-28,Uruguay,UY,186,0,3461731,America,5303,74
2020-11-29,Uruguay,UY,208,1,3461731,America,5511,75
2020-11-30,Uruguay,UY,205,1,3461731,America,5716,76
2020-12-01,Uruguay,UY,141,1,3461731,America,5857,77
2020-12-02,Uruguay,UY,167,1,3461731,America,6024,78
2020-12-03,Uruguay,UY,201,2,3461731,America,6225,80
2020-12-04,Uruguay,UY,230,0,3461731,America,6455,80
2020-12-05,Uruguay,UY,276,0,3461731,America,6731,80
2020-12-06,Uruguay,UY,234,1,3461731,America,6965,81
2020-12-07,Uruguay,UY,338,1,3461731,America,7303,82
2020-12-08,Uruguay,UY,202,1,3461731,America,7505,83
2020-12-09,Uruguay,UY,301,3,3461731,America,7806,86
2020-12-10,Uruguay,UY,298,1,3461731,America,8104,87
2020-12-11,Uruguay,UY,383,3,3461731,America,8487,90
2020-12-12,Uruguay,UY,362,0,3461731,America,8849,90
2020-12-13,Uruguay,UY,331,1,3461731,America,9180,91
2020-12-14,Uruguay,UY,528,1,3461731,America,9708,92
2020-03-16,Uzbekistan,UZ,6,0,32981715,Asia,6,0
2020-03-17,Uzbekistan,UZ,2,0,32981715,Asia,8,0
2020-03-18,Uzbekistan,UZ,8,0,32981715,Asia,16,0
2020-03-19,Uzbekistan,UZ,7,0,32981715,Asia,23,0
2020-03-20,Uzbekistan,UZ,0,0,32981715,Asia,23,0
2020-03-21,Uzbekistan,UZ,10,0,32981715,Asia,33,0
2020-03-22,Uzbekistan,UZ,0,0,32981715,Asia,33,0
2020-03-23,Uzbekistan,UZ,13,0,32981715,Asia,46,0
2020-03-24,Uzbekistan,UZ,3,0,32981715,Asia,49,0
2020-03-25,Uzbekistan,UZ,6,0,32981715,Asia,55,0
2020-03-26,Uzbekistan,UZ,10,0,32981715,Asia,65,0
2020-03-27,Uzbekistan,UZ,18,0,32981715,Asia,83,0
2020-03-28,Uzbekistan,UZ,21,0,32981715,Asia,104,0
2020-03-29,Uzbekistan,UZ,29,1,32981715,Asia,133,1
2020-03-30,Uzbekistan,UZ,12,0,32981715,Asia,145,1
2020-03-31,Uzbekistan,UZ,4,1,32981715,Asia,149,2
2020-04-01,Uzbekistan,UZ,24,0,32981715,Asia,173,2
2020-04-02,Uzbekistan,UZ,14,0,32981715,Asia,187,2
2020-04-03,Uzbekistan,UZ,3,0,32981715,Asia,190,2
2020-04-04,Uzbekistan,UZ,37,0,32981715,Asia,227,2
2020-04-05,Uzbekistan,UZ,39,0,32981715,Asia,266,2
2020-04-06,Uzbekistan,UZ,76,0,32981715,Asia,342,2
2020-04-07,Uzbekistan,UZ,55,0,32981715,Asia,397,2
2020-04-08,Uzbekistan,UZ,107,0,32981715,Asia,504,2
2020-04-09,Uzbekistan,UZ,51,1,32981715,Asia,555,3
2020-04-10,Uzbekistan,UZ,27,0,32981715,Asia,582,3
2020-04-11,Uzbekistan,UZ,42,0,32981715,Asia,624,3
2020-04-12,Uzbekistan,UZ,172,1,32981715,Asia,796,4
2020-04-13,Uzbekistan,UZ,69,0,32981715,Asia,865,4
2020-04-14,Uzbekistan,UZ,133,0,32981715,Asia,998,4
2020-04-15,Uzbekistan,UZ,167,0,32981715,Asia,1165,4
2020-04-16,Uzbekistan,UZ,137,0,32981715,Asia,1302,4
2020-04-17,Uzbekistan,UZ,78,0,32981715,Asia,1380,4
2020-04-18,Uzbekistan,UZ,70,0,32981715,Asia,1450,4
2020-04-19,Uzbekistan,UZ,45,1,32981715,Asia,1495,5
2020-04-20,Uzbekistan,UZ,70,0,32981715,Asia,1565,5
2020-04-21,Uzbekistan,UZ,92,0,32981715,Asia,1657,5
2020-04-22,Uzbekistan,UZ,35,1,32981715,Asia,1692,6
2020-04-23,Uzbekistan,UZ,24,1,32981715,Asia,1716,7
2020-04-24,Uzbekistan,UZ,62,0,32981715,Asia,1778,7
2020-04-25,Uzbekistan,UZ,58,1,32981715,Asia,1836,8
2020-04-26,Uzbekistan,UZ,29,0,32981715,Asia,1865,8
2020-04-27,Uzbekistan,UZ,22,0,32981715,Asia,1887,8
2020-04-28,Uzbekistan,UZ,17,0,32981715,Asia,1904,8
2020-04-29,Uzbekistan,UZ,35,0,32981715,Asia,1939,8
2020-04-30,Uzbekistan,UZ,63,1,32981715,Asia,2002,9
2020-05-01,Uzbekistan,UZ,44,0,32981715,Asia,2046,9
2020-05-02,Uzbekistan,UZ,48,0,32981715,Asia,2094,9
2020-05-03,Uzbekistan,UZ,33,0,32981715,Asia,2127,9
2020-05-04,Uzbekistan,UZ,22,1,32981715,Asia,2149,10
2020-05-05,Uzbekistan,UZ,40,0,32981715,Asia,2189,10
2020-05-06,Uzbekistan,UZ,18,0,32981715,Asia,2207,10
2020-05-07,Uzbekistan,UZ,26,0,32981715,Asia,2233,10
2020-05-08,Uzbekistan,UZ,65,0,32981715,Asia,2298,10
2020-05-09,Uzbekistan,UZ,38,0,32981715,Asia,2336,10
2020-05-10,Uzbekistan,UZ,51,0,32981715,Asia,2387,10
2020-05-11,Uzbekistan,UZ,31,0,32981715,Asia,2418,10
2020-05-12,Uzbekistan,UZ,91,0,32981715,Asia,2509,10
2020-05-13,Uzbekistan,UZ,38,0,32981715,Asia,2547,10
2020-05-14,Uzbekistan,UZ,65,1,32981715,Asia,2612,11
2020-05-15,Uzbekistan,UZ,33,0,32981715,Asia,2645,11
2020-05-16,Uzbekistan,UZ,46,0,32981715,Asia,2691,11
2020-05-17,Uzbekistan,UZ,50,0,32981715,Asia,2741,11
2020-05-18,Uzbekistan,UZ,12,1,32981715,Asia,2753,12
2020-05-19,Uzbekistan,UZ,49,1,32981715,Asia,2802,13
2020-05-20,Uzbekistan,UZ,78,0,32981715,Asia,2880,13
2020-05-21,Uzbekistan,UZ,70,0,32981715,Asia,2950,13
2020-05-22,Uzbekistan,UZ,56,0,32981715,Asia,3006,13
2020-05-23,Uzbekistan,UZ,72,0,32981715,Asia,3078,13
2020-05-24,Uzbekistan,UZ,54,0,32981715,Asia,3132,13
2020-05-25,Uzbekistan,UZ,32,0,32981715,Asia,3164,13
2020-05-26,Uzbekistan,UZ,97,0,32981715,Asia,3261,13
2020-05-27,Uzbekistan,UZ,72,1,32981715,Asia,3333,14
2020-05-28,Uzbekistan,UZ,0,0,32981715,Asia,3333,14
2020-05-29,Uzbekistan,UZ,111,0,32981715,Asia,3444,14
2020-05-30,Uzbekistan,UZ,69,0,32981715,Asia,3513,14
2020-05-31,Uzbekistan,UZ,41,0,32981715,Asia,3554,14
2020-06-01,Uzbekistan,UZ,108,1,32981715,Asia,3662,15
2020-06-02,Uzbekistan,UZ,56,0,32981715,Asia,3718,15
2020-06-03,Uzbekistan,UZ,51,0,32981715,Asia,3769,15
2020-06-04,Uzbekistan,UZ,105,1,32981715,Asia,3874,16
2020-06-05,Uzbekistan,UZ,91,0,32981715,Asia,3965,16
2020-06-06,Uzbekistan,UZ,57,0,32981715,Asia,4022,16
2020-06-07,Uzbekistan,UZ,159,1,32981715,Asia,4181,17
2020-06-08,Uzbekistan,UZ,171,0,32981715,Asia,4352,17
2020-06-09,Uzbekistan,UZ,96,1,32981715,Asia,4448,18
2020-06-10,Uzbekistan,UZ,99,0,32981715,Asia,4547,18
2020-06-11,Uzbekistan,UZ,148,1,32981715,Asia,4695,19
2020-06-12,Uzbekistan,UZ,124,0,32981715,Asia,4819,19
2020-06-13,Uzbekistan,UZ,82,0,32981715,Asia,4901,19
2020-06-14,Uzbekistan,UZ,93,0,32981715,Asia,4994,19
2020-06-15,Uzbekistan,UZ,109,0,32981715,Asia,5103,19
2020-06-16,Uzbekistan,UZ,190,0,32981715,Asia,5293,19
2020-06-17,Uzbekistan,UZ,268,0,32981715,Asia,5561,19
2020-06-18,Uzbekistan,UZ,136,0,32981715,Asia,5697,19
2020-06-19,Uzbekistan,UZ,158,0,32981715,Asia,5855,19
2020-06-20,Uzbekistan,UZ,170,0,32981715,Asia,6025,19
2020-06-21,Uzbekistan,UZ,191,0,32981715,Asia,6216,19
2020-06-22,Uzbekistan,UZ,142,0,32981715,Asia,6358,19
2020-06-23,Uzbekistan,UZ,142,0,32981715,Asia,6500,19
2020-06-24,Uzbekistan,UZ,255,0,32981715,Asia,6755,19
2020-06-25,Uzbekistan,UZ,235,0,32981715,Asia,6990,19
2020-06-26,Uzbekistan,UZ,238,1,32981715,Asia,7228,20
2020-06-27,Uzbekistan,UZ,262,0,32981715,Asia,7490,20
2020-06-28,Uzbekistan,UZ,235,0,32981715,Asia,7725,20
2020-06-29,Uzbekistan,UZ,306,2,32981715,Asia,8031,22
2020-06-30,Uzbekistan,UZ,267,2,32981715,Asia,8298,24
2020-07-01,Uzbekistan,UZ,329,2,32981715,Asia,8627,26
2020-07-02,Uzbekistan,UZ,277,0,32981715,Asia,8904,26
2020-07-03,Uzbekistan,UZ,295,1,32981715,Asia,9199,27
2020-07-04,Uzbekistan,UZ,301,2,32981715,Asia,9500,29
2020-07-05,Uzbekistan,UZ,329,2,32981715,Asia,9829,31
2020-07-06,Uzbekistan,UZ,314,4,32981715,Asia,10143,35
2020-07-07,Uzbekistan,UZ,316,3,32981715,Asia,10459,38
2020-07-08,Uzbekistan,UZ,379,3,32981715,Asia,10838,41
2020-07-09,Uzbekistan,UZ,421,6,32981715,Asia,11259,47
2020-07-10,Uzbekistan,UZ,464,5,32981715,Asia,11723,52
2020-07-11,Uzbekistan,UZ,483,3,32981715,Asia,12206,55
2020-07-12,Uzbekistan,UZ,307,2,32981715,Asia,12513,57
2020-07-13,Uzbekistan,UZ,680,4,32981715,Asia,13193,61
2020-07-14,Uzbekistan,UZ,679,3,32981715,Asia,13872,64
2020-07-15,Uzbekistan,UZ,421,4,32981715,Asia,14293,68
2020-07-16,Uzbekistan,UZ,494,4,32981715,Asia,14787,72
2020-07-17,Uzbekistan,UZ,562,4,32981715,Asia,15349,76
2020-07-18,Uzbekistan,UZ,547,4,32981715,Asia,15896,80
2020-07-19,Uzbekistan,UZ,533,4,32981715,Asia,16429,84
2020-07-20,Uzbekistan,UZ,537,4,32981715,Asia,16966,88
2020-07-21,Uzbekistan,UZ,624,4,32981715,Asia,17590,92
2020-07-22,Uzbekistan,UZ,581,4,32981715,Asia,18171,96
2020-07-23,Uzbekistan,UZ,360,3,32981715,Asia,18531,99
2020-07-24,Uzbekistan,UZ,455,4,32981715,Asia,18986,103
2020-07-25,Uzbekistan,UZ,667,4,32981715,Asia,19653,107
2020-07-26,Uzbekistan,UZ,573,5,32981715,Asia,20226,112
2020-07-27,Uzbekistan,UZ,594,5,32981715,Asia,20820,117
2020-07-28,Uzbekistan,UZ,686,5,32981715,Asia,21506,122
2020-07-29,Uzbekistan,UZ,663,5,32981715,Asia,22169,127
2020-07-30,Uzbekistan,UZ,703,5,32981715,Asia,22872,132
2020-07-31,Uzbekistan,UZ,686,5,32981715,Asia,23558,137
2020-08-01,Uzbekistan,UZ,746,6,32981715,Asia,24304,143
2020-08-02,Uzbekistan,UZ,736,6,32981715,Asia,25040,149
2020-08-03,Uzbekistan,UZ,788,6,32981715,Asia,25828,155
2020-08-04,Uzbekistan,UZ,722,6,32981715,Asia,26550,161
2020-08-05,Uzbekistan,UZ,764,6,32981715,Asia,27314,167
2020-08-06,Uzbekistan,UZ,755,6,32981715,Asia,28069,173
2020-08-07,Uzbekistan,UZ,740,6,32981715,Asia,28809,179
2020-08-08,Uzbekistan,UZ,650,6,32981715,Asia,29459,185
2020-08-09,Uzbekistan,UZ,738,5,32981715,Asia,30197,190
2020-08-10,Uzbekistan,UZ,623,6,32981715,Asia,30820,196
2020-08-11,Uzbekistan,UZ,725,6,32981715,Asia,31545,202
2020-08-12,Uzbekistan,UZ,670,6,32981715,Asia,32215,208
2020-08-13,Uzbekistan,UZ,622,5,32981715,Asia,32837,213
2020-08-14,Uzbekistan,UZ,724,5,32981715,Asia,33561,218
2020-08-15,Uzbekistan,UZ,690,5,32981715,Asia,34251,223
2020-08-16,Uzbekistan,UZ,693,5,32981715,Asia,34944,228
2020-08-17,Uzbekistan,UZ,0,0,32981715,Asia,34944,228
2020-08-18,Uzbekistan,UZ,1156,12,32981715,Asia,36100,240
2020-08-19,Uzbekistan,UZ,660,5,32981715,Asia,36760,245
2020-08-20,Uzbekistan,UZ,606,5,32981715,Asia,37366,250
2020-08-21,Uzbekistan,UZ,459,6,32981715,Asia,37825,256
2020-08-22,Uzbekistan,UZ,406,6,32981715,Asia,38231,262
2020-08-23,Uzbekistan,UZ,467,7,32981715,Asia,38698,269
2020-08-24,Uzbekistan,UZ,248,4,32981715,Asia,38946,273
2020-08-25,Uzbekistan,UZ,560,9,32981715,Asia,39506,282
2020-08-26,Uzbekistan,UZ,284,7,32981715,Asia,39790,289
2020-08-27,Uzbekistan,UZ,405,6,32981715,Asia,40195,295
2020-08-28,Uzbekistan,UZ,418,5,32981715,Asia,40613,300
2020-08-29,Uzbekistan,UZ,340,5,32981715,Asia,40953,305
2020-08-30,Uzbekistan,UZ,350,6,32981715,Asia,41303,311
2020-08-31,Uzbekistan,UZ,348,6,32981715,Asia,41651,317
2020-09-01,Uzbekistan,UZ,343,5,32981715,Asia,41994,322
2020-09-02,Uzbekistan,UZ,376,4,32981715,Asia,42370,326
2020-09-03,Uzbekistan,UZ,170,3,32981715,Asia,42540,329
2020-09-04,Uzbekistan,UZ,365,7,32981715,Asia,42905,336
2020-09-05,Uzbekistan,UZ,93,2,32981715,Asia,42998,338
2020-09-06,Uzbekistan,UZ,478,7,32981715,Asia,43476,345
2020-09-07,Uzbekistan,UZ,299,5,32981715,Asia,43775,350
2020-09-08,Uzbekistan,UZ,332,6,32981715,Asia,44107,356
2020-09-09,Uzbekistan,UZ,450,6,32981715,Asia,44557,362
2020-09-10,Uzbekistan,UZ,603,6,32981715,Asia,45160,368
2020-09-11,Uzbekistan,UZ,767,7,32981715,Asia,45927,375
2020-09-12,Uzbekistan,UZ,571,7,32981715,Asia,46498,382
2020-09-13,Uzbekistan,UZ,544,6,32981715,Asia,47042,388
2020-09-14,Uzbekistan,UZ,578,6,32981715,Asia,47620,394
2020-09-15,Uzbekistan,UZ,572,6,32981715,Asia,48192,400
2020-09-16,Uzbekistan,UZ,584,5,32981715,Asia,48776,405
2020-09-17,Uzbekistan,UZ,609,6,32981715,Asia,49385,411
2020-09-18,Uzbekistan,UZ,609,6,32981715,Asia,49994,417
2020-09-19,Uzbekistan,UZ,259,2,32981715,Asia,50253,419
2020-09-20,Uzbekistan,UZ,982,10,32981715,Asia,51235,429
2020-09-21,Uzbekistan,UZ,554,6,32981715,Asia,51789,435
2020-09-22,Uzbekistan,UZ,702,5,32981715,Asia,52491,440
2020-09-23,Uzbekistan,UZ,560,3,32981715,Asia,53051,443
2020-09-24,Uzbekistan,UZ,616,2,32981715,Asia,53667,445
2020-09-25,Uzbekistan,UZ,299,2,32981715,Asia,53966,447
2020-09-26,Uzbekistan,UZ,496,3,32981715,Asia,54462,450
2020-09-27,Uzbekistan,UZ,491,4,32981715,Asia,54953,454
2020-09-28,Uzbekistan,UZ,640,6,32981715,Asia,55593,460
2020-09-29,Uzbekistan,UZ,475,3,32981715,Asia,56068,463
2020-09-30,Uzbekistan,UZ,451,5,32981715,Asia,56519,468
2020-10-01,Uzbekistan,UZ,478,3,32981715,Asia,56997,471
2020-10-02,Uzbekistan,UZ,457,1,32981715,Asia,57454,472
2020-10-03,Uzbekistan,UZ,322,3,32981715,Asia,57776,475
2020-10-04,Uzbekistan,UZ,645,4,32981715,Asia,58421,479
2020-10-05,Uzbekistan,UZ,438,4,32981715,Asia,58859,483
2020-10-06,Uzbekistan,UZ,87,2,32981715,Asia,58946,485
2020-10-07,Uzbekistan,UZ,397,4,32981715,Asia,59343,489
2020-10-08,Uzbekistan,UZ,562,5,32981715,Asia,59905,494
2020-10-09,Uzbekistan,UZ,217,2,32981715,Asia,60122,496
2020-10-10,Uzbekistan,UZ,220,2,32981715,Asia,60342,498
2020-10-11,Uzbekistan,UZ,552,5,32981715,Asia,60894,503
2020-10-12,Uzbekistan,UZ,204,2,32981715,Asia,61098,505
2020-10-13,Uzbekistan,UZ,436,5,32981715,Asia,61534,510
2020-10-14,Uzbekistan,UZ,325,2,32981715,Asia,61859,512
2020-10-15,Uzbekistan,UZ,316,4,32981715,Asia,62175,516
2020-10-16,Uzbekistan,UZ,309,3,32981715,Asia,62484,519
2020-10-17,Uzbekistan,UZ,100,1,32981715,Asia,62584,520
2020-10-18,Uzbekistan,UZ,540,5,32981715,Asia,63124,525
2020-10-19,Uzbekistan,UZ,306,4,32981715,Asia,63430,529
2020-10-20,Uzbekistan,UZ,307,4,32981715,Asia,63737,533
2020-10-21,Uzbekistan,UZ,273,1,32981715,Asia,64010,534
2020-10-22,Uzbekistan,UZ,325,4,32981715,Asia,64335,538
2020-10-23,Uzbekistan,UZ,298,3,32981715,Asia,64633,541
2020-10-24,Uzbekistan,UZ,178,1,32981715,Asia,64811,542
2020-10-25,Uzbekistan,UZ,389,5,32981715,Asia,65200,547
2020-10-26,Uzbekistan,UZ,280,3,32981715,Asia,65480,550
2020-10-27,Uzbekistan,UZ,285,4,32981715,Asia,65765,554
2020-10-28,Uzbekistan,UZ,272,3,32981715,Asia,66037,557
2020-10-29,Uzbekistan,UZ,276,3,32981715,Asia,66313,560
2020-10-30,Uzbekistan,UZ,229,2,32981715,Asia,66542,562
2020-10-31,Uzbekistan,UZ,86,1,32981715,Asia,66628,563
2020-11-01,Uzbekistan,UZ,427,5,32981715,Asia,67055,568
2020-11-02,Uzbekistan,UZ,101,2,32981715,Asia,67156,570
2020-11-03,Uzbekistan,UZ,98,1,32981715,Asia,67254,571
2020-11-04,Uzbekistan,UZ,299,3,32981715,Asia,67553,574
2020-11-05,Uzbekistan,UZ,226,3,32981715,Asia,67779,577
2020-11-06,Uzbekistan,UZ,360,2,32981715,Asia,68139,579
2020-11-07,Uzbekistan,UZ,0,0,32981715,Asia,68139,579
2020-11-08,Uzbekistan,UZ,228,2,32981715,Asia,68367,581
2020-11-09,Uzbekistan,UZ,421,4,32981715,Asia,68788,585
2020-11-10,Uzbekistan,UZ,239,3,32981715,Asia,69027,588
2020-11-11,Uzbekistan,UZ,146,1,32981715,Asia,69173,589
2020-11-12,Uzbekistan,UZ,224,2,32981715,Asia,69397,591
2020-11-13,Uzbekistan,UZ,220,2,32981715,Asia,69617,593
2020-11-14,Uzbekistan,UZ,63,1,32981715,Asia,69680,594
2020-11-15,Uzbekistan,UZ,0,0,32981715,Asia,69680,594
2020-11-16,Uzbekistan,UZ,563,4,32981715,Asia,70243,598
2020-11-17,Uzbekistan,UZ,201,0,32981715,Asia,70444,598
2020-11-18,Uzbekistan,UZ,204,1,32981715,Asia,70648,599
2020-11-19,Uzbekistan,UZ,210,2,32981715,Asia,70858,601
2020-11-20,Uzbekistan,UZ,213,1,32981715,Asia,71071,602
2020-11-21,Uzbekistan,UZ,209,1,32981715,Asia,71280,603
2020-11-22,Uzbekistan,UZ,0,0,32981715,Asia,71280,603
2020-11-23,Uzbekistan,UZ,337,0,32981715,Asia,71617,603
2020-11-24,Uzbekistan,UZ,230,1,32981715,Asia,71847,604
2020-11-25,Uzbekistan,UZ,192,1,32981715,Asia,72039,605
2020-11-26,Uzbekistan,UZ,188,1,32981715,Asia,72227,606
2020-11-27,Uzbekistan,UZ,182,1,32981715,Asia,72409,607
2020-11-28,Uzbekistan,UZ,0,0,32981715,Asia,72409,607
2020-11-29,Uzbekistan,UZ,0,0,32981715,Asia,72409,607
2020-11-30,Uzbekistan,UZ,461,1,32981715,Asia,72870,608
2020-12-01,Uzbekistan,UZ,224,2,32981715,Asia,73094,610
2020-12-02,Uzbekistan,UZ,0,0,32981715,Asia,73094,610
2020-12-03,Uzbekistan,UZ,337,1,32981715,Asia,73431,611
2020-12-04,Uzbekistan,UZ,161,0,32981715,Asia,73592,611
2020-12-05,Uzbekistan,UZ,0,0,32981715,Asia,73592,611
2020-12-06,Uzbekistan,UZ,0,0,32981715,Asia,73592,611
2020-12-07,Uzbekistan,UZ,461,0,32981715,Asia,74053,611
2020-12-08,Uzbekistan,UZ,153,0,32981715,Asia,74206,611
2020-12-09,Uzbekistan,UZ,146,0,32981715,Asia,74352,611
2020-12-10,Uzbekistan,UZ,146,0,32981715,Asia,74498,611
2020-12-11,Uzbekistan,UZ,166,0,32981715,Asia,74664,611
2020-12-12,Uzbekistan,UZ,147,1,32981715,Asia,74811,612
2020-12-13,Uzbekistan,UZ,145,0,32981715,Asia,74956,612
2020-12-14,Uzbekistan,UZ,138,0,32981715,Asia,75094,612
2020-03-07,Holy_See,VA,1,0,815,Europe,1,0
2020-03-16,Holy_See,VA,0,0,815,Europe,1,0
2020-03-17,Holy_See,VA,0,0,815,Europe,1,0
2020-03-18,Holy_See,VA,0,0,815,Europe,1,0
2020-03-19,Holy_See,VA,0,0,815,Europe,1,0
2020-03-20,Holy_See,VA,0,0,815,Europe,1,0
2020-03-21,Holy_See,VA,0,0,815,Europe,1,0
2020-03-22,Holy_See,VA,0,0,815,Europe,1,0
2020-03-23,Holy_See,VA,0,0,815,Europe,1,0
2020-03-24,Holy_See,VA,0,0,815,Europe,1,0
2020-03-25,Holy_See,VA,0,0,815,Europe,1,0
2020-03-26,Holy_See,VA,0,0,815,Europe,1,0
2020-03-27,Holy_See,VA,4,0,815,Europe,5,0
2020-03-28,Holy_See,VA,0,0,815,Europe,5,0
2020-03-29,Holy_See,VA,1,0,815,Europe,6,0
2020-03-30,Holy_See,VA,0,0,815,Europe,6,0
2020-03-31,Holy_See,VA,0,0,815,Europe,6,0
2020-04-01,Holy_See,VA,0,0,815,Europe,6,0
2020-04-02,Holy_See,VA,0,0,815,Europe,6,0
2020-04-03,Holy_See,VA,0,0,815,Europe,6,0
2020-04-04,Holy_See,VA,1,0,815,Europe,7,0
2020-04-05,Holy_See,VA,0,0,815,Europe,7,0
2020-04-06,Holy_See,VA,0,0,815,Europe,7,0
2020-04-07,Holy_See,VA,0,0,815,Europe,7,0
2020-04-08,Holy_See,VA,0,0,815,Europe,7,0
2020-04-09,Holy_See,VA,1,0,815,Europe,8,0
2020-04-10,Holy_See,VA,0,0,815,Europe,8,0
2020-04-11,Holy_See,VA,0,0,815,Europe,8,0
2020-04-12,Holy_See,VA,0,0,815,Europe,8,0
2020-04-13,Holy_See,VA,0,0,815,Europe,8,0
2020-04-14,Holy_See,VA,0,0,815,Europe,8,0
2020-04-15,Holy_See,VA,0,0,815,Europe,8,0
2020-04-16,Holy_See,VA,0,0,815,Europe,8,0
2020-04-17,Holy_See,VA,0,0,815,Europe,8,0
2020-04-18,Holy_See,VA,0,0,815,Europe,8,0
2020-04-19,Holy_See,VA,0,0,815,Europe,8,0
2020-04-20,Holy_See,VA,0,0,815,Europe,8,0
2020-04-21,Holy_See,VA,1,0,815,Europe,9,0
2020-04-22,Holy_See,VA,0,0,815,Europe,9,0
2020-04-23,Holy_See,VA,0,0,815,Europe,9,0
2020-04-24,Holy_See,VA,0,0,815,Europe,9,0
2020-04-25,Holy_See,VA,0,0,815,Europe,9,0
2020-04-26,Holy_See,VA,0,0,815,Europe,9,0
2020-04-27,Holy_See,VA,0,0,815,Europe,9,0
2020-04-28,Holy_See,VA,0,0,815,Europe,9,0
2020-04-29,Holy_See,VA,0,0,815,Europe,9,0
2020-04-30,Holy_See,VA,1,0,815,Europe,10,0
2020-05-01,Holy_See,VA,1,0,815,Europe,11,0
2020-05-02,Holy_See,VA,0,0,815,Europe,11,0
2020-05-03,Holy_See,VA,0,0,815,Europe,11,0
2020-05-04,Holy_See,VA,0,0,815,Europe,11,0
2020-05-05,Holy_See,VA,0,0,815,Europe,11,0
2020-05-06,Holy_See,VA,0,0,815,Europe,11,0
2020-05-07,Holy_See,VA,1,0,815,Europe,12,0
2020-05-08,Holy_See,VA,0,0,815,Europe,12,0
2020-05-09,Holy_See,VA,0,0,815,Europe,12,0
2020-05-10,Holy_See,VA,0,0,815,Europe,12,0
2020-05-11,Holy_See,VA,0,0,815,Europe,12,0
2020-05-12,Holy_See,VA,0,0,815,Europe,12,0
2020-05-13,Holy_See,VA,0,0,815,Europe,12,0
2020-05-14,Holy_See,VA,0,0,815,Europe,12,0
2020-05-15,Holy_See,VA,0,0,815,Europe,12,0
2020-05-16,Holy_See,VA,0,0,815,Europe,12,0
2020-05-17,Holy_See,VA,0,0,815,Europe,12,0
2020-05-18,Holy_See,VA,0,0,815,Europe,12,0
2020-05-19,Holy_See,VA,0,0,815,Europe,12,0
2020-05-20,Holy_See,VA,0,0,815,Europe,12,0
2020-05-21,Holy_See,VA,0,0,815,Europe,12,0
2020-05-22,Holy_See,VA,0,0,815,Europe,12,0
2020-05-23,Holy_See,VA,0,0,815,Europe,12,0
2020-05-24,Holy_See,VA,0,0,815,Europe,12,0
2020-05-25,Holy_See,VA,0,0,815,Europe,12,0
2020-05-26,Holy_See,VA,0,0,815,Europe,12,0
2020-05-27,Holy_See,VA,0,0,815,Europe,12,0
2020-05-28,Holy_See,VA,0,0,815,Europe,12,0
2020-05-29,Holy_See,VA,0,0,815,Europe,12,0
2020-05-30,Holy_See,VA,0,0,815,Europe,12,0
2020-05-31,Holy_See,VA,0,0,815,Europe,12,0
2020-06-01,Holy_See,VA,0,0,815,Europe,12,0
2020-06-02,Holy_See,VA,0,0,815,Europe,12,0
2020-06-03,Holy_See,VA,0,0,815,Europe,12,0
2020-06-04,Holy_See,VA,0,0,815,Europe,12,0
2020-06-05,Holy_See,VA,0,0,815,Europe,12,0
2020-06-06,Holy_See,VA,0,0,815,Europe,12,0
2020-06-07,Holy_See,VA,0,0,815,Europe,12,0
2020-06-08,Holy_See,VA,0,0,815,Europe,12,0
2020-06-09,Holy_See,VA,0,0,815,Europe,12,0
2020-06-10,Holy_See,VA,0,0,815,Europe,12,0
2020-06-11,Holy_See,VA,0,0,815,Europe,12,0
2020-06-12,Holy_See,VA,0,0,815,Europe,12,0
2020-06-13,Holy_See,VA,0,0,815,Europe,12,0
2020-06-14,Holy_See,VA,0,0,815,Europe,12,0
2020-06-15,Holy_See,VA,0,0,815,Europe,12,0
2020-06-16,Holy_See,VA,0,0,815,Europe,12,0
2020-06-17,Holy_See,VA,0,0,815,Europe,12,0
2020-06-18,Holy_See,VA,0,0,815,Europe,12,0
2020-06-19,Holy_See,VA,0,0,815,Europe,12,0
2020-06-20,Holy_See,VA,0,0,815,Europe,12,0
2020-06-21,Holy_See,VA,0,0,815,Europe,12,0
2020-06-22,Holy_See,VA,0,0,815,Europe,12,0
2020-06-23,Holy_See,VA,0,0,815,Europe,12,0
2020-06-24,Holy_See,VA,0,0,815,Europe,12,0
2020-06-25,Holy_See,VA,0,0,815,Europe,12,0
2020-06-26,Holy_See,VA,0,0,815,Europe,12,0
2020-06-27,Holy_See,VA,0,0,815,Europe,12,0
2020-06-28,Holy_See,VA,0,0,815,Europe,12,0
2020-06-29,Holy_See,VA,0,0,815,Europe,12,0
2020-06-30,Holy_See,VA,0,0,815,Europe,12,0
2020-07-01,Holy_See,VA,0,0,815,Europe,12,0
2020-07-02,Holy_See,VA,0,0,815,Europe,12,0
2020-07-03,Holy_See,VA,0,0,815,Europe,12,0
2020-07-04,Holy_See,VA,0,0,815,Europe,12,0
2020-07-05,Holy_See,VA,0,0,815,Europe,12,0
2020-07-06,Holy_See,VA,0,0,815,Europe,12,0
2020-07-07,Holy_See,VA,0,0,815,Europe,12,0
2020-07-08,Holy_See,VA,0,0,815,Europe,12,0
2020-07-09,Holy_See,VA,0,0,815,Europe,12,0
2020-07-10,Holy_See,VA,0,0,815,Europe,12,0
2020-07-11,Holy_See,VA,0,0,815,Europe,12,0
2020-07-12,Holy_See,VA,0,0,815,Europe,12,0
2020-07-13,Holy_See,VA,0,0,815,Europe,12,0
2020-07-14,Holy_See,VA,0,0,815,Europe,12,0
2020-07-15,Holy_See,VA,0,0,815,Europe,12,0
2020-07-16,Holy_See,VA,0,0,815,Europe,12,0
2020-07-17,Holy_See,VA,0,0,815,Europe,12,0
2020-07-18,Holy_See,VA,0,0,815,Europe,12,0
2020-07-19,Holy_See,VA,0,0,815,Europe,12,0
2020-07-20,Holy_See,VA,0,0,815,Europe,12,0
2020-07-21,Holy_See,VA,0,0,815,Europe,12,0
2020-07-22,Holy_See,VA,0,0,815,Europe,12,0
2020-07-23,Holy_See,VA,0,0,815,Europe,12,0
2020-07-24,Holy_See,VA,0,0,815,Europe,12,0
2020-07-25,Holy_See,VA,0,0,815,Europe,12,0
2020-07-26,Holy_See,VA,0,0,815,Europe,12,0
2020-07-27,Holy_See,VA,0,0,815,Europe,12,0
2020-07-28,Holy_See,VA,0,0,815,Europe,12,0
2020-07-29,Holy_See,VA,0,0,815,Europe,12,0
2020-07-30,Holy_See,VA,0,0,815,Europe,12,0
2020-07-31,Holy_See,VA,0,0,815,Europe,12,0
2020-08-01,Holy_See,VA,0,0,815,Europe,12,0
2020-08-02,Holy_See,VA,0,0,815,Europe,12,0
2020-08-03,Holy_See,VA,0,0,815,Europe,12,0
2020-08-04,Holy_See,VA,0,0,815,Europe,12,0
2020-08-05,Holy_See,VA,0,0,815,Europe,12,0
2020-08-06,Holy_See,VA,0,0,815,Europe,12,0
2020-08-07,Holy_See,VA,0,0,815,Europe,12,0
2020-08-08,Holy_See,VA,0,0,815,Europe,12,0
2020-08-09,Holy_See,VA,0,0,815,Europe,12,0
2020-08-10,Holy_See,VA,0,0,815,Europe,12,0
2020-08-11,Holy_See,VA,0,0,815,Europe,12,0
2020-08-12,Holy_See,VA,0,0,815,Europe,12,0
2020-08-13,Holy_See,VA,0,0,815,Europe,12,0
2020-08-14,Holy_See,VA,0,0,815,Europe,12,0
2020-08-15,Holy_See,VA,0,0,815,Europe,12,0
2020-08-16,Holy_See,VA,0,0,815,Europe,12,0
2020-08-17,Holy_See,VA,0,0,815,Europe,12,0
2020-08-18,Holy_See,VA,0,0,815,Europe,12,0
2020-08-19,Holy_See,VA,0,0,815,Europe,12,0
2020-08-20,Holy_See,VA,0,0,815,Europe,12,0
2020-08-21,Holy_See,VA,0,0,815,Europe,12,0
2020-08-22,Holy_See,VA,0,0,815,Europe,12,0
2020-08-23,Holy_See,VA,0,0,815,Europe,12,0
2020-08-24,Holy_See,VA,0,0,815,Europe,12,0
2020-08-25,Holy_See,VA,0,0,815,Europe,12,0
2020-08-26,Holy_See,VA,0,0,815,Europe,12,0
2020-08-27,Holy_See,VA,0,0,815,Europe,12,0
2020-08-28,Holy_See,VA,0,0,815,Europe,12,0
2020-08-29,Holy_See,VA,0,0,815,Europe,12,0
2020-08-30,Holy_See,VA,0,0,815,Europe,12,0
2020-08-31,Holy_See,VA,0,0,815,Europe,12,0
2020-09-01,Holy_See,VA,0,0,815,Europe,12,0
2020-09-02,Holy_See,VA,0,0,815,Europe,12,0
2020-09-03,Holy_See,VA,0,0,815,Europe,12,0
2020-09-04,Holy_See,VA,0,0,815,Europe,12,0
2020-09-05,Holy_See,VA,0,0,815,Europe,12,0
2020-09-06,Holy_See,VA,0,0,815,Europe,12,0
2020-09-07,Holy_See,VA,0,0,815,Europe,12,0
2020-09-08,Holy_See,VA,0,0,815,Europe,12,0
2020-09-09,Holy_See,VA,0,0,815,Europe,12,0
2020-09-10,Holy_See,VA,0,0,815,Europe,12,0
2020-09-11,Holy_See,VA,0,0,815,Europe,12,0
2020-09-12,Holy_See,VA,0,0,815,Europe,12,0
2020-09-13,Holy_See,VA,0,0,815,Europe,12,0
2020-09-14,Holy_See,VA,0,0,815,Europe,12,0
2020-09-15,Holy_See,VA,0,0,815,Europe,12,0
2020-09-16,Holy_See,VA,0,0,815,Europe,12,0
2020-09-17,Holy_See,VA,0,0,815,Europe,12,0
2020-09-18,Holy_See,VA,0,0,815,Europe,12,0
2020-09-19,Holy_See,VA,0,0,815,Europe,12,0
2020-09-20,Holy_See,VA,0,0,815,Europe,12,0
2020-09-21,Holy_See,VA,0,0,815,Europe,12,0
2020-09-22,Holy_See,VA,0,0,815,Europe,12,0
2020-09-23,Holy_See,VA,0,0,815,Europe,12,0
2020-09-24,Holy_See,VA,0,0,815,Europe,12,0
2020-09-25,Holy_See,VA,0,0,815,Europe,12,0
2020-09-26,Holy_See,VA,0,0,815,Europe,12,0
2020-09-27,Holy_See,VA,0,0,815,Europe,12,0
2020-09-28,Holy_See,VA,0,0,815,Europe,12,0
2020-09-29,Holy_See,VA,0,0,815,Europe,12,0
2020-09-30,Holy_See,VA,0,0,815,Europe,12,0
2020-10-01,Holy_See,VA,0,0,815,Europe,12,0
2020-10-02,Holy_See,VA,0,0,815,Europe,12,0
2020-10-03,Holy_See,VA,0,0,815,Europe,12,0
2020-10-04,Holy_See,VA,0,0,815,Europe,12,0
2020-10-05,Holy_See,VA,0,0,815,Europe,12,0
2020-10-06,Holy_See,VA,0,0,815,Europe,12,0
2020-10-07,Holy_See,VA,0,0,815,Europe,12,0
2020-10-08,Holy_See,VA,0,0,815,Europe,12,0
2020-10-09,Holy_See,VA,0,0,815,Europe,12,0
2020-10-10,Holy_See,VA,0,0,815,Europe,12,0
2020-10-11,Holy_See,VA,0,0,815,Europe,12,0
2020-10-12,Holy_See,VA,0,0,815,Europe,12,0
2020-10-13,Holy_See,VA,7,0,815,Europe,19,0
2020-10-14,Holy_See,VA,0,0,815,Europe,19,0
2020-10-15,Holy_See,VA,0,0,815,Europe,19,0
2020-10-16,Holy_See,VA,7,0,815,Europe,26,0
2020-10-17,Holy_See,VA,0,0,815,Europe,26,0
2020-10-18,Holy_See,VA,0,0,815,Europe,26,0
2020-10-19,Holy_See,VA,0,0,815,Europe,26,0
2020-10-20,Holy_See,VA,0,0,815,Europe,26,0
2020-10-21,Holy_See,VA,0,0,815,Europe,26,0
2020-10-22,Holy_See,VA,0,0,815,Europe,26,0
2020-10-23,Holy_See,VA,0,0,815,Europe,26,0
2020-10-24,Holy_See,VA,0,0,815,Europe,26,0
2020-10-25,Holy_See,VA,0,0,815,Europe,26,0
2020-10-26,Holy_See,VA,0,0,815,Europe,26,0
2020-10-27,Holy_See,VA,0,0,815,Europe,26,0
2020-10-28,Holy_See,VA,0,0,815,Europe,26,0
2020-10-29,Holy_See,VA,0,0,815,Europe,26,0
2020-10-30,Holy_See,VA,0,0,815,Europe,26,0
2020-10-31,Holy_See,VA,0,0,815,Europe,26,0
2020-11-01,Holy_See,VA,0,0,815,Europe,26,0
2020-11-02,Holy_See,VA,0,0,815,Europe,26,0
2020-11-03,Holy_See,VA,0,0,815,Europe,26,0
2020-11-04,Holy_See,VA,0,0,815,Europe,26,0
2020-11-05,Holy_See,VA,0,0,815,Europe,26,0
2020-11-06,Holy_See,VA,0,0,815,Europe,26,0
2020-11-07,Holy_See,VA,0,0,815,Europe,26,0
2020-11-08,Holy_See,VA,0,0,815,Europe,26,0
2020-11-09,Holy_See,VA,0,0,815,Europe,26,0
2020-11-10,Holy_See,VA,0,0,815,Europe,26,0
2020-11-11,Holy_See,VA,0,0,815,Europe,26,0
2020-11-12,Holy_See,VA,0,0,815,Europe,26,0
2020-11-13,Holy_See,VA,0,0,815,Europe,26,0
2020-11-14,Holy_See,VA,0,0,815,Europe,26,0
2020-11-15,Holy_See,VA,0,0,815,Europe,26,0
2020-11-16,Holy_See,VA,0,0,815,Europe,26,0
2020-11-17,Holy_See,VA,0,0,815,Europe,26,0
2020-11-18,Holy_See,VA,0,0,815,Europe,26,0
2020-11-19,Holy_See,VA,0,0,815,Europe,26,0
2020-11-20,Holy_See,VA,0,0,815,Europe,26,0
2020-11-21,Holy_See,VA,0,0,815,Europe,26,0
2020-11-22,Holy_See,VA,0,0,815,Europe,26,0
2020-11-23,Holy_See,VA,0,0,815,Europe,26,0
2020-11-24,Holy_See,VA,0,0,815,Europe,26,0
2020-11-25,Holy_See,VA,0,0,815,Europe,26,0
2020-11-26,Holy_See,VA,0,0,815,Europe,26,0
2020-11-27,Holy_See,VA,0,0,815,Europe,26,0
2020-11-28,Holy_See,VA,0,0,815,Europe,26,0
2020-11-29,Holy_See,VA,0,0,815,Europe,26,0
2020-11-30,Holy_See,VA,0,0,815,Europe,26,0
2020-12-01,Holy_See,VA,0,0,815,Europe,26,0
2020-12-02,Holy_See,VA,0,0,815,Europe,26,0
2020-12-03,Holy_See,VA,0,0,815,Europe,26,0
2020-12-04,Holy_See,VA,0,0,815,Europe,26,0
2020-12-05,Holy_See,VA,0,0,815,Europe,26,0
2020-12-06,Holy_See,VA,0,0,815,Europe,26,0
2020-12-07,Holy_See,VA,0,0,815,Europe,26,0
2020-12-08,Holy_See,VA,0,0,815,Europe,26,0
2020-12-09,Holy_See,VA,0,0,815,Europe,26,0
2020-12-10,Holy_See,VA,0,0,815,Europe,26,0
2020-12-11,Holy_See,VA,0,0,815,Europe,26,0
2020-12-12,Holy_See,VA,0,0,815,Europe,26,0
2020-12-13,Holy_See,VA,0,0,815,Europe,26,0
2020-12-14,Holy_See,VA,0,0,815,Europe,26,0
2020-03-13,Saint_Vincent_and_the_Grenadines,VC,1,0,110593,America,1,0
2020-03-25,Saint_Vincent_and_the_Grenadines,VC,0,0,110593,America,1,0
2020-03-26,Saint_Vincent_and_the_Grenadines,VC,0,0,110593,America,1,0
2020-03-27,Saint_Vincent_and_the_Grenadines,VC,0,0,110593,America,1,0
2020-03-28,Saint_Vincent_and_the_Grenadines,VC,0,0,110593,America,1,0
2020-03-29,Saint_Vincent_and_the_Grenadines,VC,0,0,110593,America,1,0
2020-03-30,Saint_Vincent_and_the_Grenadines,VC,0,0,110593,America,1,0
2020-03-31,Saint_Vincent_and_the_Grenadines,VC,0,0,110593,America,1,0
2020-04-01,Saint_Vincent_and_the_Grenadines,VC,0,0,110593,America,1,0
2020-04-02,Saint_Vincent_and_the_Grenadines,VC,1,0,110593,America,2,0
2020-04-03,Saint_Vincent_and_the_Grenadines,VC,0,0,110593,America,2,0
2020-04-04,Saint_Vincent_and_the_Grenadines,VC,5,0,110593,America,7,0
2020-04-05,Saint_Vincent_and_the_Grenadines,VC,0,0,110593,America,7,0
2020-04-06,Saint_Vincent_and_the_Grenadines,VC,0,0,110593,America,7,0
2020-04-07,Saint_Vincent_and_the_Grenadines,VC,0,0,110593,America,7,0
2020-04-08,Saint_Vincent_and_the_Grenadines,VC,1,0,110593,America,8,0
2020-04-09,Saint_Vincent_and_the_Grenadines,VC,0,0,110593,America,8,0
2020-04-10,Saint_Vincent_and_the_Grenadines,VC,4,0,110593,America,12,0
2020-04-11,Saint_Vincent_and_the_Grenadines,VC,0,0,110593,America,12,0
2020-04-12,Saint_Vincent_and_the_Grenadines,VC,0,0,110593,America,12,0
2020-04-13,Saint_Vincent_and_the_Grenadines,VC,0,0,110593,America,12,0
2020-04-14,Saint_Vincent_and_the_Grenadines,VC,0,0,110593,America,12,0
2020-04-15,Saint_Vincent_and_the_Grenadines,VC,0,0,110593,America,12,0
2020-04-16,Saint_Vincent_and_the_Grenadines,VC,0,0,110593,America,12,0
2020-04-17,Saint_Vincent_and_the_Grenadines,VC,0,0,110593,America,12,0
2020-04-18,Saint_Vincent_and_the_Grenadines,VC,0,0,110593,America,12,0
2020-04-19,Saint_Vincent_and_the_Grenadines,VC,0,0,110593,America,12,0
2020-04-20,Saint_Vincent_and_the_Grenadines,VC,0,0,110593,America,12,0
2020-04-21,Saint_Vincent_and_the_Grenadines,VC,0,0,110593,America,12,0
2020-04-22,Saint_Vincent_and_the_Grenadines,VC,0,0,110593,America,12,0
2020-04-23,Saint_Vincent_and_the_Grenadines,VC,1,0,110593,America,13,0
2020-04-24,Saint_Vincent_and_the_Grenadines,VC,0,0,110593,America,13,0
2020-04-25,Saint_Vincent_and_the_Grenadines,VC,1,0,110593,America,14,0
2020-04-26,Saint_Vincent_and_the_Grenadines,VC,0,0,110593,America,14,0
2020-04-27,Saint_Vincent_and_the_Grenadines,VC,0,0,110593,America,14,0
2020-04-28,Saint_Vincent_and_the_Grenadines,VC,1,0,110593,America,15,0
2020-04-29,Saint_Vincent_and_the_Grenadines,VC,1,0,110593,America,16,0
2020-04-30,Saint_Vincent_and_the_Grenadines,VC,0,0,110593,America,16,0
2020-05-01,Saint_Vincent_and_the_Grenadines,VC,0,0,110593,America,16,0
2020-05-02,Saint_Vincent_and_the_Grenadines,VC,0,0,110593,America,16,0
2020-05-03,Saint_Vincent_and_the_Grenadines,VC,0,0,110593,America,16,0
2020-05-04,Saint_Vincent_and_the_Grenadines,VC,1,0,110593,America,17,0
2020-05-05,Saint_Vincent_and_the_Grenadines,VC,0,0,110593,America,17,0
2020-05-06,Saint_Vincent_and_the_Grenadines,VC,0,0,110593,America,17,0
2020-05-07,Saint_Vincent_and_the_Grenadines,VC,0,0,110593,America,17,0
2020-05-08,Saint_Vincent_and_the_Grenadines,VC,0,0,110593,America,17,0
2020-05-09,Saint_Vincent_and_the_Grenadines,VC,0,0,110593,America,17,0
2020-05-10,Saint_Vincent_and_the_Grenadines,VC,0,0,110593,America,17,0
2020-05-11,Saint_Vincent_and_the_Grenadines,VC,0,0,110593,America,17,0
2020-05-12,Saint_Vincent_and_the_Grenadines,VC,0,0,110593,America,17,0
2020-05-13,Saint_Vincent_and_the_Grenadines,VC,0,0,110593,America,17,0
2020-05-14,Saint_Vincent_and_the_Grenadines,VC,0,0,110593,America,17,0
2020-05-15,Saint_Vincent_and_the_Grenadines,VC,0,0,110593,America,17,0
2020-05-16,Saint_Vincent_and_the_Grenadines,VC,0,0,110593,America,17,0
2020-05-17,Saint_Vincent_and_the_Grenadines,VC,0,0,110593,America,17,0
2020-05-18,Saint_Vincent_and_the_Grenadines,VC,0,0,110593,America,17,0
2020-05-19,Saint_Vincent_and_the_Grenadines,VC,0,0,110593,America,17,0
2020-05-20,Saint_Vincent_and_the_Grenadines,VC,0,0,110593,America,17,0
2020-05-21,Saint_Vincent_and_the_Grenadines,VC,1,0,110593,America,18,0
2020-05-22,Saint_Vincent_and_the_Grenadines,VC,0,0,110593,America,18,0
2020-05-23,Saint_Vincent_and_the_Grenadines,VC,0,0,110593,America,18,0
2020-05-24,Saint_Vincent_and_the_Grenadines,VC,0,0,110593,America,18,0
2020-05-25,Saint_Vincent_and_the_Grenadines,VC,0,0,110593,America,18,0
2020-05-26,Saint_Vincent_and_the_Grenadines,VC,0,0,110593,America,18,0
2020-05-27,Saint_Vincent_and_the_Grenadines,VC,0,0,110593,America,18,0
2020-05-28,Saint_Vincent_and_the_Grenadines,VC,0,0,110593,America,18,0
2020-05-29,Saint_Vincent_and_the_Grenadines,VC,7,0,110593,America,25,0
2020-05-30,Saint_Vincent_and_the_Grenadines,VC,1,0,110593,America,26,0
2020-05-31,Saint_Vincent_and_the_Grenadines,VC,0,0,110593,America,26,0
2020-06-01,Saint_Vincent_and_the_Grenadines,VC,0,0,110593,America,26,0
2020-06-02,Saint_Vincent_and_the_Grenadines,VC,0,0,110593,America,26,0
2020-06-03,Saint_Vincent_and_the_Grenadines,VC,0,0,110593,America,26,0
2020-06-04,Saint_Vincent_and_the_Grenadines,VC,0,0,110593,America,26,0
2020-06-05,Saint_Vincent_and_the_Grenadines,VC,0,0,110593,America,26,0
2020-06-06,Saint_Vincent_and_the_Grenadines,VC,0,0,110593,America,26,0
2020-06-07,Saint_Vincent_and_the_Grenadines,VC,0,0,110593,America,26,0
2020-06-08,Saint_Vincent_and_the_Grenadines,VC,0,0,110593,America,26,0
2020-06-09,Saint_Vincent_and_the_Grenadines,VC,1,0,110593,America,27,0
2020-06-10,Saint_Vincent_and_the_Grenadines,VC,0,0,110593,America,27,0
2020-06-11,Saint_Vincent_and_the_Grenadines,VC,0,0,110593,America,27,0
2020-06-12,Saint_Vincent_and_the_Grenadines,VC,0,0,110593,America,27,0
2020-06-13,Saint_Vincent_and_the_Grenadines,VC,0,0,110593,America,27,0
2020-06-14,Saint_Vincent_and_the_Grenadines,VC,0,0,110593,America,27,0
2020-06-15,Saint_Vincent_and_the_Grenadines,VC,0,0,110593,America,27,0
2020-06-16,Saint_Vincent_and_the_Grenadines,VC,0,0,110593,America,27,0
2020-06-17,Saint_Vincent_and_the_Grenadines,VC,2,0,110593,America,29,0
2020-06-18,Saint_Vincent_and_the_Grenadines,VC,0,0,110593,America,29,0
2020-06-19,Saint_Vincent_and_the_Grenadines,VC,0,0,110593,America,29,0
2020-06-20,Saint_Vincent_and_the_Grenadines,VC,0,0,110593,America,29,0
2020-06-21,Saint_Vincent_and_the_Grenadines,VC,0,0,110593,America,29,0
2020-06-22,Saint_Vincent_and_the_Grenadines,VC,0,0,110593,America,29,0
2020-06-23,Saint_Vincent_and_the_Grenadines,VC,0,0,110593,America,29,0
2020-06-24,Saint_Vincent_and_the_Grenadines,VC,0,0,110593,America,29,0
2020-06-25,Saint_Vincent_and_the_Grenadines,VC,0,0,110593,America,29,0
2020-06-26,Saint_Vincent_and_the_Grenadines,VC,0,0,110593,America,29,0
2020-06-27,Saint_Vincent_and_the_Grenadines,VC,0,0,110593,America,29,0
2020-06-28,Saint_Vincent_and_the_Grenadines,VC,0,0,110593,America,29,0
2020-06-29,Saint_Vincent_and_the_Grenadines,VC,0,0,110593,America,29,0
2020-06-30,Saint_Vincent_and_the_Grenadines,VC,0,0,110593,America,29,0
2020-07-01,Saint_Vincent_and_the_Grenadines,VC,0,0,110593,America,29,0
2020-07-02,Saint_Vincent_and_the_Grenadines,VC,0,0,110593,America,29,0
2020-07-03,Saint_Vincent_and_the_Grenadines,VC,0,0,110593,America,29,0
2020-07-04,Saint_Vincent_and_the_Grenadines,VC,0,0,110593,America,29,0
2020-07-05,Saint_Vincent_and_the_Grenadines,VC,0,0,110593,America,29,0
2020-07-06,Saint_Vincent_and_the_Grenadines,VC,0,0,110593,America,29,0
2020-07-07,Saint_Vincent_and_the_Grenadines,VC,0,0,110593,America,29,0
2020-07-08,Saint_Vincent_and_the_Grenadines,VC,0,0,110593,America,29,0
2020-07-09,Saint_Vincent_and_the_Grenadines,VC,0,0,110593,America,29,0
2020-07-10,Saint_Vincent_and_the_Grenadines,VC,0,0,110593,America,29,0
2020-07-11,Saint_Vincent_and_the_Grenadines,VC,0,0,110593,America,29,0
2020-07-12,Saint_Vincent_and_the_Grenadines,VC,0,0,110593,America,29,0
2020-07-13,Saint_Vincent_and_the_Grenadines,VC,6,0,110593,America,35,0
2020-07-14,Saint_Vincent_and_the_Grenadines,VC,0,0,110593,America,35,0
2020-07-15,Saint_Vincent_and_the_Grenadines,VC,0,0,110593,America,35,0
2020-07-16,Saint_Vincent_and_the_Grenadines,VC,0,0,110593,America,35,0
2020-07-17,Saint_Vincent_and_the_Grenadines,VC,0,0,110593,America,35,0
2020-07-18,Saint_Vincent_and_the_Grenadines,VC,3,0,110593,America,38,0
2020-07-19,Saint_Vincent_and_the_Grenadines,VC,6,0,110593,America,44,0
2020-07-20,Saint_Vincent_and_the_Grenadines,VC,6,0,110593,America,50,0
2020-07-21,Saint_Vincent_and_the_Grenadines,VC,0,0,110593,America,50,0
2020-07-22,Saint_Vincent_and_the_Grenadines,VC,0,0,110593,America,50,0
2020-07-23,Saint_Vincent_and_the_Grenadines,VC,0,0,110593,America,50,0
2020-07-24,Saint_Vincent_and_the_Grenadines,VC,2,0,110593,America,52,0
2020-07-25,Saint_Vincent_and_the_Grenadines,VC,0,0,110593,America,52,0
2020-07-26,Saint_Vincent_and_the_Grenadines,VC,0,0,110593,America,52,0
2020-07-27,Saint_Vincent_and_the_Grenadines,VC,0,0,110593,America,52,0
2020-07-28,Saint_Vincent_and_the_Grenadines,VC,0,0,110593,America,52,0
2020-07-29,Saint_Vincent_and_the_Grenadines,VC,0,0,110593,America,52,0
2020-07-30,Saint_Vincent_and_the_Grenadines,VC,0,0,110593,America,52,0
2020-07-31,Saint_Vincent_and_the_Grenadines,VC,0,0,110593,America,52,0
2020-08-01,Saint_Vincent_and_the_Grenadines,VC,2,0,110593,America,54,0
2020-08-02,Saint_Vincent_and_the_Grenadines,VC,1,0,110593,America,55,0
2020-08-03,Saint_Vincent_and_the_Grenadines,VC,0,0,110593,America,55,0
2020-08-04,Saint_Vincent_and_the_Grenadines,VC,0,0,110593,America,55,0
2020-08-05,Saint_Vincent_and_the_Grenadines,VC,0,0,110593,America,55,0
2020-08-06,Saint_Vincent_and_the_Grenadines,VC,1,0,110593,America,56,0
2020-08-07,Saint_Vincent_and_the_Grenadines,VC,0,0,110593,America,56,0
2020-08-08,Saint_Vincent_and_the_Grenadines,VC,0,0,110593,America,56,0
2020-08-09,Saint_Vincent_and_the_Grenadines,VC,0,0,110593,America,56,0
2020-08-10,Saint_Vincent_and_the_Grenadines,VC,1,0,110593,America,57,0
2020-08-11,Saint_Vincent_and_the_Grenadines,VC,0,0,110593,America,57,0
2020-08-12,Saint_Vincent_and_the_Grenadines,VC,0,0,110593,America,57,0
2020-08-13,Saint_Vincent_and_the_Grenadines,VC,0,0,110593,America,57,0
2020-08-14,Saint_Vincent_and_the_Grenadines,VC,0,0,110593,America,57,0
2020-08-15,Saint_Vincent_and_the_Grenadines,VC,0,0,110593,America,57,0
2020-08-16,Saint_Vincent_and_the_Grenadines,VC,0,0,110593,America,57,0
2020-08-17,Saint_Vincent_and_the_Grenadines,VC,0,0,110593,America,57,0
2020-08-18,Saint_Vincent_and_the_Grenadines,VC,1,0,110593,America,58,0
2020-08-19,Saint_Vincent_and_the_Grenadines,VC,0,0,110593,America,58,0
2020-08-20,Saint_Vincent_and_the_Grenadines,VC,0,0,110593,America,58,0
2020-08-21,Saint_Vincent_and_the_Grenadines,VC,0,0,110593,America,58,0
2020-08-22,Saint_Vincent_and_the_Grenadines,VC,0,0,110593,America,58,0
2020-08-23,Saint_Vincent_and_the_Grenadines,VC,0,0,110593,America,58,0
2020-08-24,Saint_Vincent_and_the_Grenadines,VC,0,0,110593,America,58,0
2020-08-25,Saint_Vincent_and_the_Grenadines,VC,0,0,110593,America,58,0
2020-08-26,Saint_Vincent_and_the_Grenadines,VC,0,0,110593,America,58,0
2020-08-27,Saint_Vincent_and_the_Grenadines,VC,0,0,110593,America,58,0
2020-08-28,Saint_Vincent_and_the_Grenadines,VC,2,0,110593,America,60,0
2020-08-29,Saint_Vincent_and_the_Grenadines,VC,0,0,110593,America,60,0
2020-08-30,Saint_Vincent_and_the_Grenadines,VC,0,0,110593,America,60,0
2020-08-31,Saint_Vincent_and_the_Grenadines,VC,0,0,110593,America,60,0
2020-09-01,Saint_Vincent_and_the_Grenadines,VC,0,0,110593,America,60,0
2020-09-02,Saint_Vincent_and_the_Grenadines,VC,1,0,110593,America,61,0
2020-09-03,Saint_Vincent_and_the_Grenadines,VC,0,0,110593,America,61,0
2020-09-04,Saint_Vincent_and_the_Grenadines,VC,0,0,110593,America,61,0
2020-09-05,Saint_Vincent_and_the_Grenadines,VC,0,0,110593,America,61,0
2020-09-06,Saint_Vincent_and_the_Grenadines,VC,0,0,110593,America,61,0
2020-09-07,Saint_Vincent_and_the_Grenadines,VC,0,0,110593,America,61,0
2020-09-08,Saint_Vincent_and_the_Grenadines,VC,1,0,110593,America,62,0
2020-09-09,Saint_Vincent_and_the_Grenadines,VC,0,0,110593,America,62,0
2020-09-10,Saint_Vincent_and_the_Grenadines,VC,0,0,110593,America,62,0
2020-09-11,Saint_Vincent_and_the_Grenadines,VC,0,0,110593,America,62,0
2020-09-12,Saint_Vincent_and_the_Grenadines,VC,2,0,110593,America,64,0
2020-09-13,Saint_Vincent_and_the_Grenadines,VC,0,0,110593,America,64,0
2020-09-14,Saint_Vincent_and_the_Grenadines,VC,0,0,110593,America,64,0
2020-09-15,Saint_Vincent_and_the_Grenadines,VC,0,0,110593,America,64,0
2020-09-16,Saint_Vincent_and_the_Grenadines,VC,0,0,110593,America,64,0
2020-09-17,Saint_Vincent_and_the_Grenadines,VC,0,0,110593,America,64,0
2020-09-18,Saint_Vincent_and_the_Grenadines,VC,0,0,110593,America,64,0
2020-09-19,Saint_Vincent_and_the_Grenadines,VC,0,0,110593,America,64,0
2020-09-20,Saint_Vincent_and_the_Grenadines,VC,0,0,110593,America,64,0
2020-09-21,Saint_Vincent_and_the_Grenadines,VC,0,0,110593,America,64,0
2020-09-22,Saint_Vincent_and_the_Grenadines,VC,0,0,110593,America,64,0
2020-09-23,Saint_Vincent_and_the_Grenadines,VC,0,0,110593,America,64,0
2020-09-24,Saint_Vincent_and_the_Grenadines,VC,0,0,110593,America,64,0
2020-09-25,Saint_Vincent_and_the_Grenadines,VC,0,0,110593,America,64,0
2020-09-26,Saint_Vincent_and_the_Grenadines,VC,0,0,110593,America,64,0
2020-09-27,Saint_Vincent_and_the_Grenadines,VC,0,0,110593,America,64,0
2020-09-28,Saint_Vincent_and_the_Grenadines,VC,0,0,110593,America,64,0
2020-09-29,Saint_Vincent_and_the_Grenadines,VC,0,0,110593,America,64,0
2020-09-30,Saint_Vincent_and_the_Grenadines,VC,0,0,110593,America,64,0
2020-10-01,Saint_Vincent_and_the_Grenadines,VC,0,0,110593,America,64,0
2020-10-02,Saint_Vincent_and_the_Grenadines,VC,0,0,110593,America,64,0
2020-10-03,Saint_Vincent_and_the_Grenadines,VC,0,0,110593,America,64,0
2020-10-04,Saint_Vincent_and_the_Grenadines,VC,0,0,110593,America,64,0
2020-10-05,Saint_Vincent_and_the_Grenadines,VC,0,0,110593,America,64,0
2020-10-06,Saint_Vincent_and_the_Grenadines,VC,0,0,110593,America,64,0
2020-10-07,Saint_Vincent_and_the_Grenadines,VC,0,0,110593,America,64,0
2020-10-08,Saint_Vincent_and_the_Grenadines,VC,0,0,110593,America,64,0
2020-10-09,Saint_Vincent_and_the_Grenadines,VC,0,0,110593,America,64,0
2020-10-10,Saint_Vincent_and_the_Grenadines,VC,0,0,110593,America,64,0
2020-10-11,Saint_Vincent_and_the_Grenadines,VC,0,0,110593,America,64,0
2020-10-12,Saint_Vincent_and_the_Grenadines,VC,0,0,110593,America,64,0
2020-10-13,Saint_Vincent_and_the_Grenadines,VC,0,0,110593,America,64,0
2020-10-14,Saint_Vincent_and_the_Grenadines,VC,0,0,110593,America,64,0
2020-10-15,Saint_Vincent_and_the_Grenadines,VC,0,0,110593,America,64,0
2020-10-16,Saint_Vincent_and_the_Grenadines,VC,0,0,110593,America,64,0
2020-10-17,Saint_Vincent_and_the_Grenadines,VC,1,0,110593,America,65,0
2020-10-18,Saint_Vincent_and_the_Grenadines,VC,2,0,110593,America,67,0
2020-10-19,Saint_Vincent_and_the_Grenadines,VC,0,0,110593,America,67,0
2020-10-20,Saint_Vincent_and_the_Grenadines,VC,0,0,110593,America,67,0
2020-10-21,Saint_Vincent_and_the_Grenadines,VC,1,0,110593,America,68,0
2020-10-22,Saint_Vincent_and_the_Grenadines,VC,0,0,110593,America,68,0
2020-10-23,Saint_Vincent_and_the_Grenadines,VC,0,0,110593,America,68,0
2020-10-24,Saint_Vincent_and_the_Grenadines,VC,5,0,110593,America,73,0
2020-10-25,Saint_Vincent_and_the_Grenadines,VC,0,0,110593,America,73,0
2020-10-26,Saint_Vincent_and_the_Grenadines,VC,0,0,110593,America,73,0
2020-10-27,Saint_Vincent_and_the_Grenadines,VC,0,0,110593,America,73,0
2020-10-28,Saint_Vincent_and_the_Grenadines,VC,1,0,110593,America,74,0
2020-10-29,Saint_Vincent_and_the_Grenadines,VC,0,0,110593,America,74,0
2020-10-30,Saint_Vincent_and_the_Grenadines,VC,0,0,110593,America,74,0
2020-10-31,Saint_Vincent_and_the_Grenadines,VC,0,0,110593,America,74,0
2020-11-01,Saint_Vincent_and_the_Grenadines,VC,0,0,110593,America,74,0
2020-11-02,Saint_Vincent_and_the_Grenadines,VC,1,0,110593,America,75,0
2020-11-03,Saint_Vincent_and_the_Grenadines,VC,0,0,110593,America,75,0
2020-11-04,Saint_Vincent_and_the_Grenadines,VC,0,0,110593,America,75,0
2020-11-05,Saint_Vincent_and_the_Grenadines,VC,0,0,110593,America,75,0
2020-11-06,Saint_Vincent_and_the_Grenadines,VC,1,0,110593,America,76,0
2020-11-07,Saint_Vincent_and_the_Grenadines,VC,0,0,110593,America,76,0
2020-11-08,Saint_Vincent_and_the_Grenadines,VC,0,0,110593,America,76,0
2020-11-09,Saint_Vincent_and_the_Grenadines,VC,0,0,110593,America,76,0
2020-11-10,Saint_Vincent_and_the_Grenadines,VC,0,0,110593,America,76,0
2020-11-11,Saint_Vincent_and_the_Grenadines,VC,0,0,110593,America,76,0
2020-11-12,Saint_Vincent_and_the_Grenadines,VC,1,0,110593,America,77,0
2020-11-13,Saint_Vincent_and_the_Grenadines,VC,0,0,110593,America,77,0
2020-11-14,Saint_Vincent_and_the_Grenadines,VC,1,0,110593,America,78,0
2020-11-15,Saint_Vincent_and_the_Grenadines,VC,0,0,110593,America,78,0
2020-11-16,Saint_Vincent_and_the_Grenadines,VC,0,0,110593,America,78,0
2020-11-17,Saint_Vincent_and_the_Grenadines,VC,0,0,110593,America,78,0
2020-11-18,Saint_Vincent_and_the_Grenadines,VC,5,0,110593,America,83,0
2020-11-19,Saint_Vincent_and_the_Grenadines,VC,0,0,110593,America,83,0
2020-11-20,Saint_Vincent_and_the_Grenadines,VC,1,0,110593,America,84,0
2020-11-21,Saint_Vincent_and_the_Grenadines,VC,0,0,110593,America,84,0
2020-11-22,Saint_Vincent_and_the_Grenadines,VC,0,0,110593,America,84,0
2020-11-23,Saint_Vincent_and_the_Grenadines,VC,0,0,110593,America,84,0
2020-11-24,Saint_Vincent_and_the_Grenadines,VC,0,0,110593,America,84,0
2020-11-25,Saint_Vincent_and_the_Grenadines,VC,0,0,110593,America,84,0
2020-11-26,Saint_Vincent_and_the_Grenadines,VC,0,0,110593,America,84,0
2020-11-27,Saint_Vincent_and_the_Grenadines,VC,0,0,110593,America,84,0
2020-11-28,Saint_Vincent_and_the_Grenadines,VC,1,0,110593,America,85,0
2020-11-29,Saint_Vincent_and_the_Grenadines,VC,0,0,110593,America,85,0
2020-11-30,Saint_Vincent_and_the_Grenadines,VC,0,0,110593,America,85,0
2020-12-01,Saint_Vincent_and_the_Grenadines,VC,0,0,110593,America,85,0
2020-12-02,Saint_Vincent_and_the_Grenadines,VC,0,0,110593,America,85,0
2020-12-03,Saint_Vincent_and_the_Grenadines,VC,0,0,110593,America,85,0
2020-12-04,Saint_Vincent_and_the_Grenadines,VC,2,0,110593,America,87,0
2020-12-05,Saint_Vincent_and_the_Grenadines,VC,0,0,110593,America,87,0
2020-12-06,Saint_Vincent_and_the_Grenadines,VC,0,0,110593,America,87,0
2020-12-07,Saint_Vincent_and_the_Grenadines,VC,0,0,110593,America,87,0
2020-12-08,Saint_Vincent_and_the_Grenadines,VC,0,0,110593,America,87,0
2020-12-09,Saint_Vincent_and_the_Grenadines,VC,0,0,110593,America,87,0
2020-12-10,Saint_Vincent_and_the_Grenadines,VC,4,0,110593,America,91,0
2020-12-11,Saint_Vincent_and_the_Grenadines,VC,0,0,110593,America,91,0
2020-12-12,Saint_Vincent_and_the_Grenadines,VC,3,0,110593,America,94,0
2020-12-13,Saint_Vincent_and_the_Grenadines,VC,0,0,110593,America,94,0
2020-12-14,Saint_Vincent_and_the_Grenadines,VC,4,0,110593,America,98,0
2020-03-15,Venezuela,VE,10,0,28515829,America,10,0
2020-03-16,Venezuela,VE,5,0,28515829,America,15,0
2020-03-17,Venezuela,VE,18,0,28515829,America,33,0
2020-03-18,Venezuela,VE,0,0,28515829,America,33,0
2020-03-19,Venezuela,VE,0,0,28515829,America,33,0
2020-03-20,Venezuela,VE,0,0,28515829,America,33,0
2020-03-21,Venezuela,VE,3,0,28515829,America,36,0
2020-03-22,Venezuela,VE,0,0,28515829,America,36,0
2020-03-23,Venezuela,VE,0,0,28515829,America,36,0
2020-03-24,Venezuela,VE,48,0,28515829,America,84,0
2020-03-25,Venezuela,VE,7,0,28515829,America,91,0
2020-03-26,Venezuela,VE,15,0,28515829,America,106,0
2020-03-27,Venezuela,VE,1,1,28515829,America,107,1
2020-03-28,Venezuela,VE,12,0,28515829,America,119,1
2020-03-29,Venezuela,VE,0,0,28515829,America,119,1
2020-03-30,Venezuela,VE,0,0,28515829,America,119,1
2020-03-31,Venezuela,VE,16,2,28515829,America,135,3
2020-04-01,Venezuela,VE,0,0,28515829,America,135,3
2020-04-02,Venezuela,VE,8,0,28515829,America,143,3
2020-04-03,Venezuela,VE,1,0,28515829,America,144,3
2020-04-04,Venezuela,VE,0,0,28515829,America,144,3
2020-04-05,Venezuela,VE,0,2,28515829,America,144,5
2020-04-06,Venezuela,VE,4,0,28515829,America,148,5
2020-04-07,Venezuela,VE,11,0,28515829,America,159,5
2020-04-08,Venezuela,VE,7,2,28515829,America,166,7
2020-04-09,Venezuela,VE,1,1,28515829,America,167,8
2020-04-10,Venezuela,VE,4,1,28515829,America,171,9
2020-04-11,Venezuela,VE,4,0,28515829,America,175,9
2020-04-12,Venezuela,VE,0,0,28515829,America,175,9
2020-04-13,Venezuela,VE,6,0,28515829,America,181,9
2020-04-14,Venezuela,VE,8,0,28515829,America,189,9
2020-04-15,Venezuela,VE,4,0,28515829,America,193,9
2020-04-16,Venezuela,VE,4,0,28515829,America,197,9
2020-04-17,Venezuela,VE,7,0,28515829,America,204,9
2020-04-18,Venezuela,VE,23,0,28515829,America,227,9
2020-04-19,Venezuela,VE,0,0,28515829,America,227,9
2020-04-20,Venezuela,VE,29,0,28515829,America,256,9
2020-04-21,Venezuela,VE,0,0,28515829,America,256,9
2020-04-22,Venezuela,VE,29,1,28515829,America,285,10
2020-04-23,Venezuela,VE,3,0,28515829,America,288,10
2020-04-24,Venezuela,VE,10,0,28515829,America,298,10
2020-04-25,Venezuela,VE,20,0,28515829,America,318,10
2020-04-26,Venezuela,VE,5,0,28515829,America,323,10
2020-04-27,Venezuela,VE,2,0,28515829,America,325,10
2020-04-28,Venezuela,VE,4,0,28515829,America,329,10
2020-04-29,Venezuela,VE,0,0,28515829,America,329,10
2020-04-30,Venezuela,VE,2,0,28515829,America,331,10
2020-05-01,Venezuela,VE,2,0,28515829,America,333,10
2020-05-02,Venezuela,VE,2,0,28515829,America,335,10
2020-05-03,Venezuela,VE,10,0,28515829,America,345,10
2020-05-04,Venezuela,VE,12,0,28515829,America,357,10
2020-05-05,Venezuela,VE,4,0,28515829,America,361,10
2020-05-06,Venezuela,VE,6,0,28515829,America,367,10
2020-05-07,Venezuela,VE,12,0,28515829,America,379,10
2020-05-08,Venezuela,VE,2,0,28515829,America,381,10
2020-05-09,Venezuela,VE,7,0,28515829,America,388,10
2020-05-10,Venezuela,VE,14,0,28515829,America,402,10
2020-05-11,Venezuela,VE,12,0,28515829,America,414,10
2020-05-12,Venezuela,VE,8,0,28515829,America,422,10
2020-05-13,Venezuela,VE,1,0,28515829,America,423,10
2020-05-14,Venezuela,VE,17,0,28515829,America,440,10
2020-05-15,Venezuela,VE,15,0,28515829,America,455,10
2020-05-16,Venezuela,VE,4,0,28515829,America,459,10
2020-05-17,Venezuela,VE,45,0,28515829,America,504,10
2020-05-18,Venezuela,VE,37,0,28515829,America,541,10
2020-05-19,Venezuela,VE,77,0,28515829,America,618,10
2020-05-20,Venezuela,VE,131,0,28515829,America,749,10
2020-05-21,Venezuela,VE,75,0,28515829,America,824,10
2020-05-22,Venezuela,VE,58,0,28515829,America,882,10
2020-05-23,Venezuela,VE,62,0,28515829,America,944,10
2020-05-24,Venezuela,VE,0,0,28515829,America,944,10
2020-05-25,Venezuela,VE,177,0,28515829,America,1121,10
2020-05-26,Venezuela,VE,56,0,28515829,America,1177,10
2020-05-27,Venezuela,VE,34,1,28515829,America,1211,11
2020-05-28,Venezuela,VE,34,0,28515829,America,1245,11
2020-05-29,Venezuela,VE,82,0,28515829,America,1327,11
2020-05-30,Venezuela,VE,42,3,28515829,America,1369,14
2020-05-31,Venezuela,VE,90,0,28515829,America,1459,14
2020-06-01,Venezuela,VE,51,0,28515829,America,1510,14
2020-06-02,Venezuela,VE,152,3,28515829,America,1662,17
2020-06-03,Venezuela,VE,157,1,28515829,America,1819,18
2020-06-04,Venezuela,VE,133,2,28515829,America,1952,20
2020-06-05,Venezuela,VE,135,0,28515829,America,2087,20
2020-06-06,Venezuela,VE,58,0,28515829,America,2145,20
2020-06-07,Venezuela,VE,171,2,28515829,America,2316,22
2020-06-08,Venezuela,VE,61,0,28515829,America,2377,22
2020-06-09,Venezuela,VE,96,0,28515829,America,2473,22
2020-06-10,Venezuela,VE,159,1,28515829,America,2632,23
2020-06-11,Venezuela,VE,106,0,28515829,America,2738,23
2020-06-12,Venezuela,VE,76,0,28515829,America,2814,23
2020-06-13,Venezuela,VE,65,0,28515829,America,2879,23
2020-06-14,Venezuela,VE,25,1,28515829,America,2904,24
2020-06-15,Venezuela,VE,74,1,28515829,America,2978,25
2020-06-16,Venezuela,VE,84,1,28515829,America,3062,26
2020-06-17,Venezuela,VE,88,1,28515829,America,3150,27
2020-06-19,Venezuela,VE,334,1,28515829,America,3484,28
2020-06-20,Venezuela,VE,107,2,28515829,America,3591,30
2020-06-21,Venezuela,VE,199,3,28515829,America,3790,33
2020-06-22,Venezuela,VE,128,0,28515829,America,3918,33
2020-06-23,Venezuela,VE,130,2,28515829,America,4048,35
2020-06-24,Venezuela,VE,138,0,28515829,America,4186,35
2020-06-25,Venezuela,VE,179,3,28515829,America,4365,38
2020-06-26,Venezuela,VE,198,1,28515829,America,4563,39
2020-06-27,Venezuela,VE,216,2,28515829,America,4779,41
2020-06-28,Venezuela,VE,351,1,28515829,America,5130,42
2020-06-29,Venezuela,VE,167,2,28515829,America,5297,44
2020-06-30,Venezuela,VE,233,4,28515829,America,5530,48
2020-07-01,Venezuela,VE,302,3,28515829,America,5832,51
2020-07-02,Venezuela,VE,230,3,28515829,America,6062,54
2020-07-03,Venezuela,VE,211,3,28515829,America,6273,57
2020-07-04,Venezuela,VE,264,2,28515829,America,6537,59
2020-07-05,Venezuela,VE,213,3,28515829,America,6750,62
2020-07-06,Venezuela,VE,419,2,28515829,America,7169,64
2020-07-07,Venezuela,VE,242,4,28515829,America,7411,68
2020-07-08,Venezuela,VE,282,3,28515829,America,7693,71
2020-07-09,Venezuela,VE,317,4,28515829,America,8010,75
2020-07-10,Venezuela,VE,362,5,28515829,America,8372,80
2020-07-11,Venezuela,VE,431,3,28515829,America,8803,83
2020-07-12,Venezuela,VE,375,2,28515829,America,9178,85
2020-07-13,Venezuela,VE,287,4,28515829,America,9465,89
2020-07-14,Venezuela,VE,242,4,28515829,America,9707,93
2020-07-15,Venezuela,VE,303,3,28515829,America,10010,96
2020-07-16,Venezuela,VE,418,4,28515829,America,10428,100
2020-07-17,Venezuela,VE,426,4,28515829,America,10854,104
2020-07-18,Venezuela,VE,337,3,28515829,America,11191,107
2020-07-19,Venezuela,VE,292,3,28515829,America,11483,110
2020-07-20,Venezuela,VE,408,2,28515829,America,11891,112
2020-07-21,Venezuela,VE,443,4,28515829,America,12334,116
2020-07-22,Venezuela,VE,440,4,28515829,America,12774,120
2020-07-23,Venezuela,VE,0,0,28515829,America,12774,120
2020-07-24,Venezuela,VE,839,9,28515829,America,13613,129
2020-07-25,Venezuela,VE,650,5,28515829,America,14263,134
2020-07-26,Venezuela,VE,0,0,28515829,America,14263,134
2020-07-27,Venezuela,VE,1200,8,28515829,America,15463,142
2020-07-28,Venezuela,VE,525,4,28515829,America,15988,146
2020-07-29,Venezuela,VE,583,5,28515829,America,16571,151
2020-07-30,Venezuela,VE,0,0,28515829,America,16571,151
2020-07-31,Venezuela,VE,1288,7,28515829,America,17859,158
2020-08-01,Venezuela,VE,715,6,28515829,America,18574,164
2020-08-02,Venezuela,VE,869,5,28515829,America,19443,169
2020-08-03,Venezuela,VE,763,5,28515829,America,20206,174
2020-08-04,Venezuela,VE,0,0,28515829,America,20206,174
2020-08-05,Venezuela,VE,1232,13,28515829,America,21438,187
2020-08-06,Venezuela,VE,861,8,28515829,America,22299,195
2020-08-07,Venezuela,VE,981,7,28515829,America,23280,202
2020-08-08,Venezuela,VE,886,6,28515829,America,24166,208
2020-08-09,Venezuela,VE,0,0,28515829,America,24166,208
2020-08-10,Venezuela,VE,1639,15,28515829,America,25805,223
2020-08-11,Venezuela,VE,0,0,28515829,America,25805,223
2020-08-12,Venezuela,VE,2133,15,28515829,America,27938,238
2020-08-13,Venezuela,VE,1150,9,28515829,America,29088,247
2020-08-14,Venezuela,VE,1281,12,28515829,America,30369,259
2020-08-15,Venezuela,VE,1012,7,28515829,America,31381,266
2020-08-16,Venezuela,VE,1226,10,28515829,America,32607,276
2020-08-17,Venezuela,VE,1148,5,28515829,America,33755,281
2020-08-18,Venezuela,VE,1047,7,28515829,America,34802,288
2020-08-19,Venezuela,VE,895,9,28515829,America,35697,297
2020-08-20,Venezuela,VE,1171,6,28515829,America,36868,303
2020-08-21,Venezuela,VE,699,8,28515829,America,37567,311
2020-08-22,Venezuela,VE,621,6,28515829,America,38188,317
2020-08-23,Venezuela,VE,769,6,28515829,America,38957,323
2020-08-24,Venezuela,VE,607,6,28515829,America,39564,329
2020-08-25,Venezuela,VE,774,8,28515829,America,40338,337
2020-08-26,Venezuela,VE,820,6,28515829,America,41158,343
2020-08-27,Venezuela,VE,0,0,28515829,America,41158,343
2020-08-28,Venezuela,VE,1740,15,28515829,America,42898,358
2020-08-29,Venezuela,VE,981,0,28515829,America,43879,358
2020-08-30,Venezuela,VE,1067,17,28515829,America,44946,375
2020-08-31,Venezuela,VE,922,6,28515829,America,45868,381
2020-09-01,Venezuela,VE,0,0,28515829,America,45868,381
2020-09-02,Venezuela,VE,1888,10,28515829,America,47756,391
2020-09-03,Venezuela,VE,1127,7,28515829,America,48883,398
2020-09-04,Venezuela,VE,994,4,28515829,America,49877,402
2020-09-05,Venezuela,VE,1096,10,28515829,America,50973,412
2020-09-06,Venezuela,VE,1192,8,28515829,America,52165,420
2020-09-07,Venezuela,VE,1124,8,28515829,America,53289,428
2020-09-08,Venezuela,VE,1061,8,28515829,America,54350,436
2020-09-09,Venezuela,VE,1213,8,28515829,America,55563,444
2020-09-10,Venezuela,VE,1188,8,28515829,America,56751,452
2020-09-11,Venezuela,VE,1072,8,28515829,America,57823,460
2020-09-12,Venezuela,VE,840,8,28515829,America,58663,468
2020-09-13,Venezuela,VE,967,9,28515829,America,59630,477
2020-09-14,Venezuela,VE,910,8,28515829,America,60540,485
2020-09-15,Venezuela,VE,1029,9,28515829,America,61569,494
2020-09-16,Venezuela,VE,1086,8,28515829,America,62655,502
2020-09-17,Venezuela,VE,761,9,28515829,America,63416,511
2020-09-18,Venezuela,VE,868,10,28515829,America,64284,521
2020-09-19,Venezuela,VE,890,9,28515829,America,65174,530
2020-09-20,Venezuela,VE,775,9,28515829,America,65949,539
2020-09-21,Venezuela,VE,707,8,28515829,America,66656,547
2020-09-22,Venezuela,VE,787,8,28515829,America,67443,555
2020-09-23,Venezuela,VE,1010,9,28515829,America,68453,564
2020-09-24,Venezuela,VE,986,10,28515829,America,69439,574
2020-09-25,Venezuela,VE,967,7,28515829,America,70406,581
2020-09-26,Venezuela,VE,867,10,28515829,America,71273,591
2020-09-27,Venezuela,VE,667,9,28515829,America,71940,600
2020-09-28,Venezuela,VE,751,6,28515829,America,72691,606
2020-09-29,Venezuela,VE,837,8,28515829,America,73528,614
2020-09-30,Venezuela,VE,835,7,28515829,America,74363,621
2020-10-01,Venezuela,VE,759,7,28515829,America,75122,628
2020-10-02,Venezuela,VE,907,7,28515829,America,76029,635
2020-10-03,Venezuela,VE,791,8,28515829,America,76820,643
2020-10-04,Venezuela,VE,0,0,28515829,America,76820,643
2020-10-05,Venezuela,VE,1614,10,28515829,America,78434,653
2020-10-06,Venezuela,VE,683,5,28515829,America,79117,658
2020-10-07,Venezuela,VE,679,7,28515829,America,79796,665
2020-10-08,Venezuela,VE,608,6,28515829,America,80404,671
2020-10-09,Venezuela,VE,615,7,28515829,America,81019,678
2020-10-10,Venezuela,VE,677,6,28515829,America,81696,684
2020-10-11,Venezuela,VE,757,7,28515829,America,82453,691
2020-10-12,Venezuela,VE,684,6,28515829,America,83137,697
2020-10-13,Venezuela,VE,619,7,28515829,America,83756,704
2020-10-14,Venezuela,VE,635,6,28515829,America,84391,710
2020-10-15,Venezuela,VE,614,4,28515829,America,85005,714
2020-10-16,Venezuela,VE,464,6,28515829,America,85469,720
2020-10-17,Venezuela,VE,0,0,28515829,America,85469,720
2020-10-18,Venezuela,VE,289,5,28515829,America,85758,725
2020-10-19,Venezuela,VE,878,11,28515829,America,86636,736
2020-10-20,Venezuela,VE,0,0,28515829,America,86636,736
2020-10-21,Venezuela,VE,1008,11,28515829,America,87644,747
2020-10-22,Venezuela,VE,391,6,28515829,America,88035,753
2020-10-23,Venezuela,VE,381,6,28515829,America,88416,759
2020-10-24,Venezuela,VE,302,5,28515829,America,88718,764
2020-10-25,Venezuela,VE,424,6,28515829,America,89142,770
2020-10-26,Venezuela,VE,423,3,28515829,America,89565,773
2020-10-27,Venezuela,VE,482,4,28515829,America,90047,777
2020-10-28,Venezuela,VE,353,3,28515829,America,90400,780
2020-10-29,Venezuela,VE,476,4,28515829,America,90876,784
2020-10-30,Venezuela,VE,404,5,28515829,America,91280,789
2020-10-31,Venezuela,VE,309,4,28515829,America,91589,793
2020-11-01,Venezuela,VE,424,5,28515829,America,92013,798
2020-11-02,Venezuela,VE,312,3,28515829,America,92325,801
2020-11-03,Venezuela,VE,380,4,28515829,America,92705,805
2020-11-04,Venezuela,VE,395,5,28515829,America,93100,810
2020-11-05,Venezuela,VE,0,0,28515829,America,93100,810
2020-11-06,Venezuela,VE,821,9,28515829,America,93921,819
2020-11-07,Venezuela,VE,384,2,28515829,America,94305,821
2020-11-08,Venezuela,VE,0,0,28515829,America,94305,821
2020-11-09,Venezuela,VE,578,5,28515829,America,94883,826
2020-11-10,Venezuela,VE,0,0,28515829,America,94883,826
2020-11-11,Venezuela,VE,562,8,28515829,America,95445,834
2020-11-12,Venezuela,VE,0,0,28515829,America,95445,834
2020-11-13,Venezuela,VE,695,7,28515829,America,96140,841
2020-11-14,Venezuela,VE,0,0,28515829,America,96140,841
2020-11-15,Venezuela,VE,301,3,28515829,America,96441,844
2020-11-16,Venezuela,VE,911,7,28515829,America,97352,851
2020-11-17,Venezuela,VE,387,4,28515829,America,97739,855
2020-11-18,Venezuela,VE,311,3,28515829,America,98050,858
2020-11-19,Venezuela,VE,300,2,28515829,America,98350,860
2020-11-20,Venezuela,VE,315,3,28515829,America,98665,863
2020-11-21,Venezuela,VE,0,0,28515829,America,98665,863
2020-11-22,Venezuela,VE,352,3,28515829,America,99017,866
2020-11-23,Venezuela,VE,818,5,28515829,America,99835,871
2020-11-24,Venezuela,VE,308,2,28515829,America,100143,873
2020-11-25,Venezuela,VE,355,3,28515829,America,100498,876
2020-11-26,Venezuela,VE,319,4,28515829,America,100817,880
2020-11-27,Venezuela,VE,0,0,28515829,America,100817,880
2020-11-28,Venezuela,VE,398,4,28515829,America,101215,884
2020-11-29,Venezuela,VE,309,4,28515829,America,101524,888
2020-11-30,Venezuela,VE,516,6,28515829,America,102040,894
2020-12-01,Venezuela,VE,354,3,28515829,America,102394,897
2020-12-02,Venezuela,VE,227,4,28515829,America,102621,901
2020-12-03,Venezuela,VE,446,4,28515829,America,103067,905
2020-12-04,Venezuela,VE,0,0,28515829,America,103067,905
2020-12-05,Venezuela,VE,810,8,28515829,America,103877,913
2020-12-06,Venezuela,VE,300,3,28515829,America,104177,916
2020-12-07,Venezuela,VE,265,3,28515829,America,104442,919
2020-12-08,Venezuela,VE,462,5,28515829,America,104904,924
2020-12-09,Venezuela,VE,480,4,28515829,America,105384,928
2020-12-10,Venezuela,VE,468,5,28515829,America,105852,933
2020-12-11,Venezuela,VE,428,5,28515829,America,106280,938
2020-12-12,Venezuela,VE,435,6,28515829,America,106715,944
2020-12-13,Venezuela,VE,0,0,28515829,America,106715,944
2020-12-14,Venezuela,VE,462,5,28515829,America,107177,949
2020-03-27,British_Virgin_Islands,VG,2,0,30033,America,2,0
2020-03-28,British_Virgin_Islands,VG,0,0,30033,America,2,0
2020-03-29,British_Virgin_Islands,VG,0,0,30033,America,2,0
2020-03-30,British_Virgin_Islands,VG,0,0,30033,America,2,0
2020-03-31,British_Virgin_Islands,VG,1,0,30033,America,3,0
2020-04-01,British_Virgin_Islands,VG,0,0,30033,America,3,0
2020-04-02,British_Virgin_Islands,VG,0,0,30033,America,3,0
2020-04-03,British_Virgin_Islands,VG,0,0,30033,America,3,0
2020-04-04,British_Virgin_Islands,VG,0,0,30033,America,3,0
2020-04-05,British_Virgin_Islands,VG,0,0,30033,America,3,0
2020-04-06,British_Virgin_Islands,VG,0,0,30033,America,3,0
2020-04-07,British_Virgin_Islands,VG,0,0,30033,America,3,0
2020-04-08,British_Virgin_Islands,VG,0,0,30033,America,3,0
2020-04-09,British_Virgin_Islands,VG,0,0,30033,America,3,0
2020-04-10,British_Virgin_Islands,VG,0,0,30033,America,3,0
2020-04-11,British_Virgin_Islands,VG,0,0,30033,America,3,0
2020-04-12,British_Virgin_Islands,VG,0,0,30033,America,3,0
2020-04-13,British_Virgin_Islands,VG,0,0,30033,America,3,0
2020-04-14,British_Virgin_Islands,VG,0,0,30033,America,3,0
2020-04-15,British_Virgin_Islands,VG,0,0,30033,America,3,0
2020-04-16,British_Virgin_Islands,VG,0,0,30033,America,3,0
2020-04-17,British_Virgin_Islands,VG,0,0,30033,America,3,0
2020-04-18,British_Virgin_Islands,VG,0,0,30033,America,3,0
2020-04-19,British_Virgin_Islands,VG,0,0,30033,America,3,0
2020-04-20,British_Virgin_Islands,VG,1,1,30033,America,4,1
2020-04-21,British_Virgin_Islands,VG,1,0,30033,America,5,1
2020-04-22,British_Virgin_Islands,VG,0,0,30033,America,5,1
2020-04-23,British_Virgin_Islands,VG,0,0,30033,America,5,1
2020-04-24,British_Virgin_Islands,VG,0,0,30033,America,5,1
2020-04-25,British_Virgin_Islands,VG,1,0,30033,America,6,1
2020-04-26,British_Virgin_Islands,VG,0,0,30033,America,6,1
2020-04-27,British_Virgin_Islands,VG,0,0,30033,America,6,1
2020-04-28,British_Virgin_Islands,VG,0,0,30033,America,6,1
2020-04-29,British_Virgin_Islands,VG,0,0,30033,America,6,1
2020-04-30,British_Virgin_Islands,VG,0,0,30033,America,6,1
2020-05-01,British_Virgin_Islands,VG,0,0,30033,America,6,1
2020-05-02,British_Virgin_Islands,VG,0,0,30033,America,6,1
2020-05-03,British_Virgin_Islands,VG,0,0,30033,America,6,1
2020-05-04,British_Virgin_Islands,VG,0,0,30033,America,6,1
2020-05-05,British_Virgin_Islands,VG,1,0,30033,America,7,1
2020-05-06,British_Virgin_Islands,VG,0,0,30033,America,7,1
2020-05-07,British_Virgin_Islands,VG,0,0,30033,America,7,1
2020-05-08,British_Virgin_Islands,VG,0,0,30033,America,7,1
2020-05-09,British_Virgin_Islands,VG,0,0,30033,America,7,1
2020-05-10,British_Virgin_Islands,VG,0,0,30033,America,7,1
2020-05-11,British_Virgin_Islands,VG,0,0,30033,America,7,1
2020-05-12,British_Virgin_Islands,VG,0,0,30033,America,7,1
2020-05-13,British_Virgin_Islands,VG,0,0,30033,America,7,1
2020-05-14,British_Virgin_Islands,VG,0,0,30033,America,7,1
2020-05-15,British_Virgin_Islands,VG,1,0,30033,America,8,1
2020-05-16,British_Virgin_Islands,VG,0,0,30033,America,8,1
2020-05-17,British_Virgin_Islands,VG,0,0,30033,America,8,1
2020-05-18,British_Virgin_Islands,VG,0,0,30033,America,8,1
2020-05-19,British_Virgin_Islands,VG,0,0,30033,America,8,1
2020-05-20,British_Virgin_Islands,VG,0,0,30033,America,8,1
2020-05-21,British_Virgin_Islands,VG,0,0,30033,America,8,1
2020-05-22,British_Virgin_Islands,VG,0,0,30033,America,8,1
2020-05-23,British_Virgin_Islands,VG,0,0,30033,America,8,1
2020-05-24,British_Virgin_Islands,VG,0,0,30033,America,8,1
2020-05-25,British_Virgin_Islands,VG,0,0,30033,America,8,1
2020-05-26,British_Virgin_Islands,VG,0,0,30033,America,8,1
2020-05-27,British_Virgin_Islands,VG,0,0,30033,America,8,1
2020-05-28,British_Virgin_Islands,VG,0,0,30033,America,8,1
2020-05-29,British_Virgin_Islands,VG,0,0,30033,America,8,1
2020-05-30,British_Virgin_Islands,VG,0,0,30033,America,8,1
2020-05-31,British_Virgin_Islands,VG,0,0,30033,America,8,1
2020-06-01,British_Virgin_Islands,VG,0,0,30033,America,8,1
2020-06-02,British_Virgin_Islands,VG,0,0,30033,America,8,1
2020-06-03,British_Virgin_Islands,VG,0,0,30033,America,8,1
2020-06-04,British_Virgin_Islands,VG,0,0,30033,America,8,1
2020-06-05,British_Virgin_Islands,VG,0,0,30033,America,8,1
2020-06-06,British_Virgin_Islands,VG,0,0,30033,America,8,1
2020-06-07,British_Virgin_Islands,VG,0,0,30033,America,8,1
2020-06-08,British_Virgin_Islands,VG,0,0,30033,America,8,1
2020-06-09,British_Virgin_Islands,VG,0,0,30033,America,8,1
2020-06-10,British_Virgin_Islands,VG,0,0,30033,America,8,1
2020-06-11,British_Virgin_Islands,VG,0,0,30033,America,8,1
2020-06-12,British_Virgin_Islands,VG,0,0,30033,America,8,1
2020-06-13,British_Virgin_Islands,VG,0,0,30033,America,8,1
2020-06-14,British_Virgin_Islands,VG,0,0,30033,America,8,1
2020-06-15,British_Virgin_Islands,VG,0,0,30033,America,8,1
2020-06-16,British_Virgin_Islands,VG,0,0,30033,America,8,1
2020-06-17,British_Virgin_Islands,VG,0,0,30033,America,8,1
2020-06-18,British_Virgin_Islands,VG,0,0,30033,America,8,1
2020-06-19,British_Virgin_Islands,VG,0,0,30033,America,8,1
2020-06-20,British_Virgin_Islands,VG,0,0,30033,America,8,1
2020-06-21,British_Virgin_Islands,VG,0,0,30033,America,8,1
2020-06-22,British_Virgin_Islands,VG,0,0,30033,America,8,1
2020-06-23,British_Virgin_Islands,VG,0,0,30033,America,8,1
2020-06-24,British_Virgin_Islands,VG,0,0,30033,America,8,1
2020-06-25,British_Virgin_Islands,VG,0,0,30033,America,8,1
2020-06-26,British_Virgin_Islands,VG,0,0,30033,America,8,1
2020-06-27,British_Virgin_Islands,VG,0,0,30033,America,8,1
2020-06-28,British_Virgin_Islands,VG,0,0,30033,America,8,1
2020-06-29,British_Virgin_Islands,VG,0,0,30033,America,8,1
2020-06-30,British_Virgin_Islands,VG,0,0,30033,America,8,1
2020-07-01,British_Virgin_Islands,VG,0,0,30033,America,8,1
2020-07-02,British_Virgin_Islands,VG,0,0,30033,America,8,1
2020-07-03,British_Virgin_Islands,VG,0,0,30033,America,8,1
2020-07-04,British_Virgin_Islands,VG,0,0,30033,America,8,1
2020-07-05,British_Virgin_Islands,VG,0,0,30033,America,8,1
2020-07-06,British_Virgin_Islands,VG,0,0,30033,America,8,1
2020-07-07,British_Virgin_Islands,VG,0,0,30033,America,8,1
2020-07-08,British_Virgin_Islands,VG,0,0,30033,America,8,1
2020-07-09,British_Virgin_Islands,VG,0,0,30033,America,8,1
2020-07-10,British_Virgin_Islands,VG,0,0,30033,America,8,1
2020-07-11,British_Virgin_Islands,VG,0,0,30033,America,8,1
2020-07-12,British_Virgin_Islands,VG,0,0,30033,America,8,1
2020-07-13,British_Virgin_Islands,VG,0,0,30033,America,8,1
2020-07-14,British_Virgin_Islands,VG,0,0,30033,America,8,1
2020-07-15,British_Virgin_Islands,VG,0,0,30033,America,8,1
2020-07-16,British_Virgin_Islands,VG,0,0,30033,America,8,1
2020-07-17,British_Virgin_Islands,VG,0,0,30033,America,8,1
2020-07-18,British_Virgin_Islands,VG,0,0,30033,America,8,1
2020-07-19,British_Virgin_Islands,VG,0,0,30033,America,8,1
2020-07-20,British_Virgin_Islands,VG,0,0,30033,America,8,1
2020-07-21,British_Virgin_Islands,VG,0,0,30033,America,8,1
2020-07-22,British_Virgin_Islands,VG,0,0,30033,America,8,1
2020-07-23,British_Virgin_Islands,VG,0,0,30033,America,8,1
2020-07-24,British_Virgin_Islands,VG,0,0,30033,America,8,1
2020-07-25,British_Virgin_Islands,VG,0,0,30033,America,8,1
2020-07-26,British_Virgin_Islands,VG,0,0,30033,America,8,1
2020-07-27,British_Virgin_Islands,VG,0,0,30033,America,8,1
2020-07-28,British_Virgin_Islands,VG,0,0,30033,America,8,1
2020-07-29,British_Virgin_Islands,VG,0,0,30033,America,8,1
2020-07-30,British_Virgin_Islands,VG,0,0,30033,America,8,1
2020-07-31,British_Virgin_Islands,VG,0,0,30033,America,8,1
2020-08-01,British_Virgin_Islands,VG,0,0,30033,America,8,1
2020-08-02,British_Virgin_Islands,VG,0,0,30033,America,8,1
2020-08-03,British_Virgin_Islands,VG,1,0,30033,America,9,1
2020-08-04,British_Virgin_Islands,VG,0,0,30033,America,9,1
2020-08-05,British_Virgin_Islands,VG,0,0,30033,America,9,1
2020-08-06,British_Virgin_Islands,VG,0,0,30033,America,9,1
2020-08-07,British_Virgin_Islands,VG,0,0,30033,America,9,1
2020-08-08,British_Virgin_Islands,VG,0,0,30033,America,9,1
2020-08-09,British_Virgin_Islands,VG,0,0,30033,America,9,1
2020-08-10,British_Virgin_Islands,VG,0,0,30033,America,9,1
2020-08-11,British_Virgin_Islands,VG,0,0,30033,America,9,1
2020-08-12,British_Virgin_Islands,VG,0,0,30033,America,9,1
2020-08-13,British_Virgin_Islands,VG,0,0,30033,America,9,1
2020-08-14,British_Virgin_Islands,VG,0,0,30033,America,9,1
2020-08-15,British_Virgin_Islands,VG,0,0,30033,America,9,1
2020-08-16,British_Virgin_Islands,VG,0,0,30033,America,9,1
2020-08-17,British_Virgin_Islands,VG,0,0,30033,America,9,1
2020-08-18,British_Virgin_Islands,VG,0,0,30033,America,9,1
2020-08-19,British_Virgin_Islands,VG,2,0,30033,America,11,1
2020-08-20,British_Virgin_Islands,VG,0,0,30033,America,11,1
2020-08-21,British_Virgin_Islands,VG,1,0,30033,America,12,1
2020-08-22,British_Virgin_Islands,VG,9,0,30033,America,21,1
2020-08-23,British_Virgin_Islands,VG,0,0,30033,America,21,1
2020-08-24,British_Virgin_Islands,VG,0,0,30033,America,21,1
2020-08-25,British_Virgin_Islands,VG,5,0,30033,America,26,1
2020-08-26,British_Virgin_Islands,VG,0,0,30033,America,26,1
2020-08-27,British_Virgin_Islands,VG,0,0,30033,America,26,1
2020-08-28,British_Virgin_Islands,VG,0,0,30033,America,26,1
2020-08-29,British_Virgin_Islands,VG,9,0,30033,America,35,1
2020-08-30,British_Virgin_Islands,VG,0,0,30033,America,35,1
2020-08-31,British_Virgin_Islands,VG,2,0,30033,America,37,1
2020-09-01,British_Virgin_Islands,VG,10,0,30033,America,47,1
2020-09-02,British_Virgin_Islands,VG,0,0,30033,America,47,1
2020-09-03,British_Virgin_Islands,VG,0,0,30033,America,47,1
2020-09-04,British_Virgin_Islands,VG,0,0,30033,America,47,1
2020-09-05,British_Virgin_Islands,VG,16,0,30033,America,63,1
2020-09-06,British_Virgin_Islands,VG,0,0,30033,America,63,1
2020-09-07,British_Virgin_Islands,VG,0,0,30033,America,63,1
2020-09-08,British_Virgin_Islands,VG,0,0,30033,America,63,1
2020-09-09,British_Virgin_Islands,VG,0,0,30033,America,63,1
2020-09-10,British_Virgin_Islands,VG,0,0,30033,America,63,1
2020-09-11,British_Virgin_Islands,VG,0,0,30033,America,63,1
2020-09-12,British_Virgin_Islands,VG,1,0,30033,America,64,1
2020-09-13,British_Virgin_Islands,VG,2,0,30033,America,66,1
2020-09-14,British_Virgin_Islands,VG,0,0,30033,America,66,1
2020-09-15,British_Virgin_Islands,VG,0,0,30033,America,66,1
2020-09-16,British_Virgin_Islands,VG,0,0,30033,America,66,1
2020-09-17,British_Virgin_Islands,VG,0,0,30033,America,66,1
2020-09-18,British_Virgin_Islands,VG,3,0,30033,America,69,1
2020-09-19,British_Virgin_Islands,VG,0,0,30033,America,69,1
2020-09-20,British_Virgin_Islands,VG,2,0,30033,America,71,1
2020-09-21,British_Virgin_Islands,VG,0,0,30033,America,71,1
2020-09-22,British_Virgin_Islands,VG,0,0,30033,America,71,1
2020-09-23,British_Virgin_Islands,VG,0,0,30033,America,71,1
2020-09-24,British_Virgin_Islands,VG,0,0,30033,America,71,1
2020-09-25,British_Virgin_Islands,VG,0,0,30033,America,71,1
2020-09-26,British_Virgin_Islands,VG,0,0,30033,America,71,1
2020-09-27,British_Virgin_Islands,VG,0,0,30033,America,71,1
2020-09-28,British_Virgin_Islands,VG,0,0,30033,America,71,1
2020-09-29,British_Virgin_Islands,VG,0,0,30033,America,71,1
2020-09-30,British_Virgin_Islands,VG,0,0,30033,America,71,1
2020-10-01,British_Virgin_Islands,VG,0,0,30033,America,71,1
2020-10-02,British_Virgin_Islands,VG,0,0,30033,America,71,1
2020-10-03,British_Virgin_Islands,VG,0,0,30033,America,71,1
2020-10-04,British_Virgin_Islands,VG,0,0,30033,America,71,1
2020-10-05,British_Virgin_Islands,VG,0,0,30033,America,71,1
2020-10-06,British_Virgin_Islands,VG,0,0,30033,America,71,1
2020-10-07,British_Virgin_Islands,VG,0,0,30033,America,71,1
2020-10-08,British_Virgin_Islands,VG,0,0,30033,America,71,1
2020-10-09,British_Virgin_Islands,VG,0,0,30033,America,71,1
2020-10-10,British_Virgin_Islands,VG,0,0,30033,America,71,1
2020-10-11,British_Virgin_Islands,VG,0,0,30033,America,71,1
2020-10-12,British_Virgin_Islands,VG,0,0,30033,America,71,1
2020-10-13,British_Virgin_Islands,VG,0,0,30033,America,71,1
2020-10-14,British_Virgin_Islands,VG,0,0,30033,America,71,1
2020-10-15,British_Virgin_Islands,VG,0,0,30033,America,71,1
2020-10-16,British_Virgin_Islands,VG,0,0,30033,America,71,1
2020-10-17,British_Virgin_Islands,VG,0,0,30033,America,71,1
2020-10-18,British_Virgin_Islands,VG,0,0,30033,America,71,1
2020-10-19,British_Virgin_Islands,VG,0,0,30033,America,71,1
2020-10-20,British_Virgin_Islands,VG,1,0,30033,America,72,1
2020-10-21,British_Virgin_Islands,VG,0,0,30033,America,72,1
2020-10-22,British_Virgin_Islands,VG,0,0,30033,America,72,1
2020-10-23,British_Virgin_Islands,VG,0,0,30033,America,72,1
2020-10-24,British_Virgin_Islands,VG,0,0,30033,America,72,1
2020-10-25,British_Virgin_Islands,VG,0,0,30033,America,72,1
2020-10-26,British_Virgin_Islands,VG,0,0,30033,America,72,1
2020-10-27,British_Virgin_Islands,VG,0,0,30033,America,72,1
2020-10-28,British_Virgin_Islands,VG,0,0,30033,America,72,1
2020-10-29,British_Virgin_Islands,VG,0,0,30033,America,72,1
2020-10-30,British_Virgin_Islands,VG,0,0,30033,America,72,1
2020-10-31,British_Virgin_Islands,VG,0,0,30033,America,72,1
2020-11-01,British_Virgin_Islands,VG,0,0,30033,America,72,1
2020-11-02,British_Virgin_Islands,VG,0,0,30033,America,72,1
2020-11-03,British_Virgin_Islands,VG,0,0,30033,America,72,1
2020-11-04,British_Virgin_Islands,VG,0,0,30033,America,72,1
2020-11-05,British_Virgin_Islands,VG,0,0,30033,America,72,1
2020-11-06,British_Virgin_Islands,VG,0,0,30033,America,72,1
2020-11-07,British_Virgin_Islands,VG,0,0,30033,America,72,1
2020-11-08,British_Virgin_Islands,VG,0,0,30033,America,72,1
2020-11-09,British_Virgin_Islands,VG,0,0,30033,America,72,1
2020-11-10,British_Virgin_Islands,VG,0,0,30033,America,72,1
2020-11-11,British_Virgin_Islands,VG,0,0,30033,America,72,1
2020-11-12,British_Virgin_Islands,VG,0,0,30033,America,72,1
2020-11-13,British_Virgin_Islands,VG,0,0,30033,America,72,1
2020-11-14,British_Virgin_Islands,VG,0,0,30033,America,72,1
2020-11-15,British_Virgin_Islands,VG,0,0,30033,America,72,1
2020-11-16,British_Virgin_Islands,VG,0,0,30033,America,72,1
2020-11-17,British_Virgin_Islands,VG,0,0,30033,America,72,1
2020-11-18,British_Virgin_Islands,VG,0,0,30033,America,72,1
2020-11-19,British_Virgin_Islands,VG,0,0,30033,America,72,1
2020-11-20,British_Virgin_Islands,VG,0,0,30033,America,72,1
2020-11-21,British_Virgin_Islands,VG,0,0,30033,America,72,1
2020-11-22,British_Virgin_Islands,VG,0,0,30033,America,72,1
2020-11-23,British_Virgin_Islands,VG,0,0,30033,America,72,1
2020-11-24,British_Virgin_Islands,VG,0,0,30033,America,72,1
2020-11-25,British_Virgin_Islands,VG,0,0,30033,America,72,1
2020-11-26,British_Virgin_Islands,VG,0,0,30033,America,72,1
2020-11-27,British_Virgin_Islands,VG,0,0,30033,America,72,1
2020-11-28,British_Virgin_Islands,VG,0,0,30033,America,72,1
2020-11-29,British_Virgin_Islands,VG,0,0,30033,America,72,1
2020-11-30,British_Virgin_Islands,VG,1,0,30033,America,73,1
2020-12-01,British_Virgin_Islands,VG,0,0,30033,America,73,1
2020-12-02,British_Virgin_Islands,VG,0,0,30033,America,73,1
2020-12-03,British_Virgin_Islands,VG,0,0,30033,America,73,1
2020-12-04,British_Virgin_Islands,VG,0,0,30033,America,73,1
2020-12-05,British_Virgin_Islands,VG,0,0,30033,America,73,1
2020-12-06,British_Virgin_Islands,VG,0,0,30033,America,73,1
2020-12-07,British_Virgin_Islands,VG,0,0,30033,America,73,1
2020-12-08,British_Virgin_Islands,VG,0,0,30033,America,73,1
2020-12-09,British_Virgin_Islands,VG,0,0,30033,America,73,1
2020-12-10,British_Virgin_Islands,VG,0,0,30033,America,73,1
2020-12-11,British_Virgin_Islands,VG,2,0,30033,America,75,1
2020-12-12,British_Virgin_Islands,VG,1,0,30033,America,76,1
2020-12-13,British_Virgin_Islands,VG,0,0,30033,America,76,1
2020-12-14,British_Virgin_Islands,VG,0,0,30033,America,76,1
2020-03-24,United_States_Virgin_Islands,VI,17,0,104579,America,17,0
2020-03-25,United_States_Virgin_Islands,VI,0,0,104579,America,17,0
2020-03-26,United_States_Virgin_Islands,VI,0,0,104579,America,17,0
2020-03-27,United_States_Virgin_Islands,VI,0,0,104579,America,17,0
2020-03-28,United_States_Virgin_Islands,VI,2,0,104579,America,19,0
2020-03-29,United_States_Virgin_Islands,VI,3,0,104579,America,22,0
2020-03-30,United_States_Virgin_Islands,VI,8,0,104579,America,30,0
2020-04-01,United_States_Virgin_Islands,VI,0,0,104579,America,30,0
2020-04-02,United_States_Virgin_Islands,VI,0,0,104579,America,30,0
2020-04-03,United_States_Virgin_Islands,VI,3,0,104579,America,33,0
2020-04-04,United_States_Virgin_Islands,VI,7,0,104579,America,40,0
2020-04-05,United_States_Virgin_Islands,VI,0,0,104579,America,40,0
2020-04-06,United_States_Virgin_Islands,VI,2,1,104579,America,42,1
2020-04-07,United_States_Virgin_Islands,VI,0,0,104579,America,42,1
2020-04-08,United_States_Virgin_Islands,VI,3,0,104579,America,45,1
2020-04-09,United_States_Virgin_Islands,VI,0,0,104579,America,45,1
2020-04-10,United_States_Virgin_Islands,VI,5,0,104579,America,50,1
2020-04-11,United_States_Virgin_Islands,VI,0,0,104579,America,50,1
2020-04-12,United_States_Virgin_Islands,VI,1,0,104579,America,51,1
2020-04-13,United_States_Virgin_Islands,VI,0,0,104579,America,51,1
2020-04-14,United_States_Virgin_Islands,VI,0,0,104579,America,51,1
2020-04-15,United_States_Virgin_Islands,VI,0,0,104579,America,51,1
2020-04-16,United_States_Virgin_Islands,VI,0,0,104579,America,51,1
2020-04-17,United_States_Virgin_Islands,VI,0,0,104579,America,51,1
2020-04-18,United_States_Virgin_Islands,VI,0,1,104579,America,51,2
2020-04-19,United_States_Virgin_Islands,VI,2,1,104579,America,53,3
2020-04-20,United_States_Virgin_Islands,VI,0,0,104579,America,53,3
2020-04-21,United_States_Virgin_Islands,VI,1,0,104579,America,54,3
2020-04-22,United_States_Virgin_Islands,VI,0,0,104579,America,54,3
2020-04-23,United_States_Virgin_Islands,VI,0,0,104579,America,54,3
2020-04-24,United_States_Virgin_Islands,VI,0,0,104579,America,54,3
2020-04-25,United_States_Virgin_Islands,VI,0,0,104579,America,54,3
2020-04-26,United_States_Virgin_Islands,VI,1,0,104579,America,55,3
2020-04-27,United_States_Virgin_Islands,VI,0,0,104579,America,55,3
2020-04-28,United_States_Virgin_Islands,VI,4,1,104579,America,59,4
2020-04-29,United_States_Virgin_Islands,VI,0,0,104579,America,59,4
2020-04-30,United_States_Virgin_Islands,VI,7,0,104579,America,66,4
2020-05-01,United_States_Virgin_Islands,VI,0,0,104579,America,66,4
2020-05-02,United_States_Virgin_Islands,VI,0,0,104579,America,66,4
2020-05-03,United_States_Virgin_Islands,VI,0,0,104579,America,66,4
2020-05-04,United_States_Virgin_Islands,VI,0,0,104579,America,66,4
2020-05-05,United_States_Virgin_Islands,VI,0,0,104579,America,66,4
2020-05-06,United_States_Virgin_Islands,VI,0,0,104579,America,66,4
2020-05-07,United_States_Virgin_Islands,VI,0,0,104579,America,66,4
2020-05-08,United_States_Virgin_Islands,VI,0,0,104579,America,66,4
2020-05-09,United_States_Virgin_Islands,VI,2,0,104579,America,68,4
2020-05-10,United_States_Virgin_Islands,VI,1,0,104579,America,69,4
2020-05-11,United_States_Virgin_Islands,VI,0,0,104579,America,69,4
2020-05-12,United_States_Virgin_Islands,VI,0,1,104579,America,69,5
2020-05-13,United_States_Virgin_Islands,VI,0,0,104579,America,69,5
2020-05-14,United_States_Virgin_Islands,VI,0,1,104579,America,69,6
2020-05-15,United_States_Virgin_Islands,VI,0,0,104579,America,69,6
2020-05-16,United_States_Virgin_Islands,VI,0,0,104579,America,69,6
2020-05-17,United_States_Virgin_Islands,VI,0,0,104579,America,69,6
2020-05-18,United_States_Virgin_Islands,VI,0,0,104579,America,69,6
2020-05-19,United_States_Virgin_Islands,VI,0,0,104579,America,69,6
2020-05-20,United_States_Virgin_Islands,VI,0,0,104579,America,69,6
2020-05-21,United_States_Virgin_Islands,VI,0,0,104579,America,69,6
2020-05-22,United_States_Virgin_Islands,VI,0,0,104579,America,69,6
2020-05-23,United_States_Virgin_Islands,VI,0,0,104579,America,69,6
2020-05-24,United_States_Virgin_Islands,VI,0,0,104579,America,69,6
2020-05-25,United_States_Virgin_Islands,VI,0,0,104579,America,69,6
2020-05-26,United_States_Virgin_Islands,VI,0,0,104579,America,69,6
2020-05-27,United_States_Virgin_Islands,VI,0,0,104579,America,69,6
2020-05-28,United_States_Virgin_Islands,VI,0,0,104579,America,69,6
2020-05-29,United_States_Virgin_Islands,VI,0,0,104579,America,69,6
2020-05-30,United_States_Virgin_Islands,VI,0,0,104579,America,69,6
2020-05-31,United_States_Virgin_Islands,VI,0,0,104579,America,69,6
2020-06-01,United_States_Virgin_Islands,VI,0,0,104579,America,69,6
2020-06-02,United_States_Virgin_Islands,VI,1,0,104579,America,70,6
2020-06-03,United_States_Virgin_Islands,VI,0,0,104579,America,70,6
2020-06-04,United_States_Virgin_Islands,VI,0,0,104579,America,70,6
2020-06-05,United_States_Virgin_Islands,VI,1,0,104579,America,71,6
2020-06-06,United_States_Virgin_Islands,VI,0,0,104579,America,71,6
2020-06-07,United_States_Virgin_Islands,VI,0,0,104579,America,71,6
2020-06-08,United_States_Virgin_Islands,VI,0,0,104579,America,71,6
2020-06-09,United_States_Virgin_Islands,VI,0,0,104579,America,71,6
2020-06-10,United_States_Virgin_Islands,VI,0,0,104579,America,71,6
2020-06-11,United_States_Virgin_Islands,VI,1,0,104579,America,72,6
2020-06-12,United_States_Virgin_Islands,VI,0,0,104579,America,72,6
2020-06-13,United_States_Virgin_Islands,VI,0,0,104579,America,72,6
2020-06-14,United_States_Virgin_Islands,VI,0,0,104579,America,72,6
2020-06-15,United_States_Virgin_Islands,VI,1,0,104579,America,73,6
2020-06-16,United_States_Virgin_Islands,VI,0,0,104579,America,73,6
2020-06-17,United_States_Virgin_Islands,VI,0,0,104579,America,73,6
2020-06-18,United_States_Virgin_Islands,VI,0,0,104579,America,73,6
2020-06-19,United_States_Virgin_Islands,VI,0,0,104579,America,73,6
2020-06-20,United_States_Virgin_Islands,VI,1,0,104579,America,74,6
2020-06-21,United_States_Virgin_Islands,VI,0,0,104579,America,74,6
2020-06-22,United_States_Virgin_Islands,VI,2,0,104579,America,76,6
2020-06-23,United_States_Virgin_Islands,VI,0,0,104579,America,76,6
2020-06-24,United_States_Virgin_Islands,VI,0,0,104579,America,76,6
2020-06-25,United_States_Virgin_Islands,VI,4,0,104579,America,80,6
2020-06-26,United_States_Virgin_Islands,VI,1,0,104579,America,81,6
2020-06-27,United_States_Virgin_Islands,VI,0,0,104579,America,81,6
2020-06-28,United_States_Virgin_Islands,VI,0,0,104579,America,81,6
2020-06-29,United_States_Virgin_Islands,VI,0,0,104579,America,81,6
2020-06-30,United_States_Virgin_Islands,VI,3,0,104579,America,84,6
2020-07-01,United_States_Virgin_Islands,VI,0,0,104579,America,84,6
2020-07-02,United_States_Virgin_Islands,VI,8,0,104579,America,92,6
2020-07-03,United_States_Virgin_Islands,VI,6,0,104579,America,98,6
2020-07-04,United_States_Virgin_Islands,VI,13,0,104579,America,111,6
2020-07-05,United_States_Virgin_Islands,VI,0,0,104579,America,111,6
2020-07-06,United_States_Virgin_Islands,VI,1,0,104579,America,112,6
2020-07-07,United_States_Virgin_Islands,VI,4,0,104579,America,116,6
2020-07-08,United_States_Virgin_Islands,VI,6,0,104579,America,122,6
2020-07-09,United_States_Virgin_Islands,VI,22,0,104579,America,144,6
2020-07-10,United_States_Virgin_Islands,VI,9,0,104579,America,153,6
2020-07-11,United_States_Virgin_Islands,VI,14,0,104579,America,167,6
2020-07-12,United_States_Virgin_Islands,VI,14,0,104579,America,181,6
2020-07-13,United_States_Virgin_Islands,VI,0,0,104579,America,181,6
2020-07-14,United_States_Virgin_Islands,VI,36,0,104579,America,217,6
2020-07-15,United_States_Virgin_Islands,VI,0,0,104579,America,217,6
2020-07-16,United_States_Virgin_Islands,VI,32,0,104579,America,249,6
2020-07-17,United_States_Virgin_Islands,VI,14,0,104579,America,263,6
2020-07-18,United_States_Virgin_Islands,VI,20,0,104579,America,283,6
2020-07-19,United_States_Virgin_Islands,VI,14,0,104579,America,297,6
2020-07-20,United_States_Virgin_Islands,VI,0,0,104579,America,297,6
2020-07-21,United_States_Virgin_Islands,VI,11,0,104579,America,308,6
2020-07-22,United_States_Virgin_Islands,VI,12,1,104579,America,320,7
2020-07-23,United_States_Virgin_Islands,VI,16,0,104579,America,336,7
2020-07-24,United_States_Virgin_Islands,VI,0,0,104579,America,336,7
2020-07-25,United_States_Virgin_Islands,VI,16,0,104579,America,352,7
2020-07-26,United_States_Virgin_Islands,VI,0,0,104579,America,352,7
2020-07-27,United_States_Virgin_Islands,VI,9,0,104579,America,361,7
2020-07-28,United_States_Virgin_Islands,VI,3,0,104579,America,364,7
2020-07-29,United_States_Virgin_Islands,VI,21,1,104579,America,385,8
2020-07-30,United_States_Virgin_Islands,VI,0,0,104579,America,385,8
2020-07-31,United_States_Virgin_Islands,VI,0,0,104579,America,385,8
2020-08-01,United_States_Virgin_Islands,VI,21,0,104579,America,406,8
2020-08-02,United_States_Virgin_Islands,VI,15,0,104579,America,421,8
2020-08-03,United_States_Virgin_Islands,VI,0,0,104579,America,421,8
2020-08-04,United_States_Virgin_Islands,VI,18,0,104579,America,439,8
2020-08-05,United_States_Virgin_Islands,VI,24,0,104579,America,463,8
2020-08-06,United_States_Virgin_Islands,VI,38,1,104579,America,501,9
2020-08-07,United_States_Virgin_Islands,VI,21,0,104579,America,522,9
2020-08-08,United_States_Virgin_Islands,VI,6,0,104579,America,528,9
2020-08-09,United_States_Virgin_Islands,VI,19,0,104579,America,547,9
2020-08-10,United_States_Virgin_Islands,VI,0,0,104579,America,547,9
2020-08-11,United_States_Virgin_Islands,VI,0,0,104579,America,547,9
2020-08-12,United_States_Virgin_Islands,VI,92,0,104579,America,639,9
2020-08-13,United_States_Virgin_Islands,VI,0,0,104579,America,639,9
2020-08-14,United_States_Virgin_Islands,VI,65,0,104579,America,704,9
2020-08-15,United_States_Virgin_Islands,VI,30,0,104579,America,734,9
2020-08-16,United_States_Virgin_Islands,VI,0,0,104579,America,734,9
2020-08-17,United_States_Virgin_Islands,VI,7,0,104579,America,741,9
2020-08-18,United_States_Virgin_Islands,VI,55,0,104579,America,796,9
2020-08-19,United_States_Virgin_Islands,VI,0,0,104579,America,796,9
2020-08-20,United_States_Virgin_Islands,VI,32,0,104579,America,828,9
2020-08-21,United_States_Virgin_Islands,VI,41,1,104579,America,869,10
2020-08-22,United_States_Virgin_Islands,VI,63,0,104579,America,932,10
2020-08-23,United_States_Virgin_Islands,VI,0,0,104579,America,932,10
2020-08-24,United_States_Virgin_Islands,VI,52,1,104579,America,984,11
2020-08-25,United_States_Virgin_Islands,VI,14,1,104579,America,998,12
2020-08-26,United_States_Virgin_Islands,VI,32,2,104579,America,1030,14
2020-08-27,United_States_Virgin_Islands,VI,0,0,104579,America,1030,14
2020-08-28,United_States_Virgin_Islands,VI,45,0,104579,America,1075,14
2020-08-29,United_States_Virgin_Islands,VI,0,0,104579,America,1075,14
2020-08-30,United_States_Virgin_Islands,VI,54,0,104579,America,1129,14
2020-08-31,United_States_Virgin_Islands,VI,5,0,104579,America,1134,14
2020-09-01,United_States_Virgin_Islands,VI,5,1,104579,America,1139,15
2020-09-02,United_States_Virgin_Islands,VI,4,0,104579,America,1143,15
2020-09-03,United_States_Virgin_Islands,VI,1,0,104579,America,1144,15
2020-09-04,United_States_Virgin_Islands,VI,6,1,104579,America,1150,16
2020-09-05,United_States_Virgin_Islands,VI,0,0,104579,America,1150,16
2020-09-06,United_States_Virgin_Islands,VI,17,0,104579,America,1167,16
2020-09-07,United_States_Virgin_Islands,VI,14,1,104579,America,1181,17
2020-09-08,United_States_Virgin_Islands,VI,9,0,104579,America,1190,17
2020-09-09,United_States_Virgin_Islands,VI,1,1,104579,America,1191,18
2020-09-10,United_States_Virgin_Islands,VI,6,0,104579,America,1197,18
2020-09-11,United_States_Virgin_Islands,VI,4,0,104579,America,1201,18
2020-09-12,United_States_Virgin_Islands,VI,0,0,104579,America,1201,18
2020-09-13,United_States_Virgin_Islands,VI,19,1,104579,America,1220,19
2020-09-14,United_States_Virgin_Islands,VI,0,0,104579,America,1220,19
2020-09-15,United_States_Virgin_Islands,VI,1,0,104579,America,1221,19
2020-09-16,United_States_Virgin_Islands,VI,11,0,104579,America,1232,19
2020-09-17,United_States_Virgin_Islands,VI,6,0,104579,America,1238,19
2020-09-18,United_States_Virgin_Islands,VI,0,0,104579,America,1238,19
2020-09-19,United_States_Virgin_Islands,VI,4,0,104579,America,1242,19
2020-09-20,United_States_Virgin_Islands,VI,0,0,104579,America,1242,19
2020-09-21,United_States_Virgin_Islands,VI,27,0,104579,America,1269,19
2020-09-22,United_States_Virgin_Islands,VI,0,0,104579,America,1269,19
2020-09-23,United_States_Virgin_Islands,VI,9,0,104579,America,1278,19
2020-09-24,United_States_Virgin_Islands,VI,12,0,104579,America,1290,19
2020-09-25,United_States_Virgin_Islands,VI,6,0,104579,America,1296,19
2020-09-26,United_States_Virgin_Islands,VI,18,0,104579,America,1314,19
2020-09-27,United_States_Virgin_Islands,VI,3,0,104579,America,1317,19
2020-09-28,United_States_Virgin_Islands,VI,0,0,104579,America,1317,19
2020-09-29,United_States_Virgin_Islands,VI,1,1,104579,America,1318,20
2020-09-30,United_States_Virgin_Islands,VI,0,0,104579,America,1318,20
2020-10-01,United_States_Virgin_Islands,VI,0,0,104579,America,1318,20
2020-10-02,United_States_Virgin_Islands,VI,3,0,104579,America,1321,20
2020-10-03,United_States_Virgin_Islands,VI,0,0,104579,America,1321,20
2020-10-04,United_States_Virgin_Islands,VI,0,0,104579,America,1321,20
2020-10-05,United_States_Virgin_Islands,VI,0,0,104579,America,1321,20
2020-10-06,United_States_Virgin_Islands,VI,0,0,104579,America,1321,20
2020-10-07,United_States_Virgin_Islands,VI,0,0,104579,America,1321,20
2020-10-08,United_States_Virgin_Islands,VI,1,0,104579,America,1322,20
2020-10-09,United_States_Virgin_Islands,VI,2,0,104579,America,1324,20
2020-10-10,United_States_Virgin_Islands,VI,1,0,104579,America,1325,20
2020-10-11,United_States_Virgin_Islands,VI,0,0,104579,America,1325,20
2020-10-12,United_States_Virgin_Islands,VI,0,0,104579,America,1325,20
2020-10-13,United_States_Virgin_Islands,VI,0,0,104579,America,1325,20
2020-10-14,United_States_Virgin_Islands,VI,3,0,104579,America,1328,20
2020-10-15,United_States_Virgin_Islands,VI,0,0,104579,America,1328,20
2020-10-16,United_States_Virgin_Islands,VI,1,1,104579,America,1329,21
2020-10-17,United_States_Virgin_Islands,VI,0,0,104579,America,1329,21
2020-10-18,United_States_Virgin_Islands,VI,6,0,104579,America,1335,21
2020-10-19,United_States_Virgin_Islands,VI,0,0,104579,America,1335,21
2020-10-20,United_States_Virgin_Islands,VI,1,0,104579,America,1336,21
2020-10-21,United_States_Virgin_Islands,VI,1,0,104579,America,1337,21
2020-10-22,United_States_Virgin_Islands,VI,6,0,104579,America,1343,21
2020-10-23,United_States_Virgin_Islands,VI,0,0,104579,America,1343,21
2020-10-24,United_States_Virgin_Islands,VI,3,0,104579,America,1346,21
2020-10-25,United_States_Virgin_Islands,VI,2,0,104579,America,1348,21
2020-10-26,United_States_Virgin_Islands,VI,0,0,104579,America,1348,21
2020-10-27,United_States_Virgin_Islands,VI,0,0,104579,America,1348,21
2020-10-28,United_States_Virgin_Islands,VI,5,0,104579,America,1353,21
2020-10-29,United_States_Virgin_Islands,VI,0,0,104579,America,1353,21
2020-10-30,United_States_Virgin_Islands,VI,0,0,104579,America,1353,21
2020-10-31,United_States_Virgin_Islands,VI,9,0,104579,America,1362,21
2020-11-01,United_States_Virgin_Islands,VI,14,0,104579,America,1376,21
2020-11-02,United_States_Virgin_Islands,VI,0,0,104579,America,1376,21
2020-11-03,United_States_Virgin_Islands,VI,2,0,104579,America,1378,21
2020-11-04,United_States_Virgin_Islands,VI,7,1,104579,America,1385,22
2020-11-05,United_States_Virgin_Islands,VI,3,1,104579,America,1388,23
2020-11-06,United_States_Virgin_Islands,VI,2,0,104579,America,1390,23
2020-11-07,United_States_Virgin_Islands,VI,0,0,104579,America,1390,23
2020-11-08,United_States_Virgin_Islands,VI,15,0,104579,America,1405,23
2020-11-09,United_States_Virgin_Islands,VI,0,0,104579,America,1405,23
2020-11-10,United_States_Virgin_Islands,VI,0,0,104579,America,1405,23
2020-11-11,United_States_Virgin_Islands,VI,5,0,104579,America,1410,23
2020-11-12,United_States_Virgin_Islands,VI,0,0,104579,America,1410,23
2020-11-13,United_States_Virgin_Islands,VI,0,0,104579,America,1410,23
2020-11-14,United_States_Virgin_Islands,VI,0,0,104579,America,1410,23
2020-11-15,United_States_Virgin_Islands,VI,24,0,104579,America,1434,23
2020-11-16,United_States_Virgin_Islands,VI,0,0,104579,America,1434,23
2020-11-17,United_States_Virgin_Islands,VI,0,0,104579,America,1434,23
2020-11-18,United_States_Virgin_Islands,VI,16,0,104579,America,1450,23
2020-11-19,United_States_Virgin_Islands,VI,13,0,104579,America,1463,23
2020-11-20,United_States_Virgin_Islands,VI,6,0,104579,America,1469,23
2020-11-21,United_States_Virgin_Islands,VI,13,0,104579,America,1482,23
2020-11-22,United_States_Virgin_Islands,VI,9,0,104579,America,1491,23
2020-11-23,United_States_Virgin_Islands,VI,13,0,104579,America,1504,23
2020-11-24,United_States_Virgin_Islands,VI,3,0,104579,America,1507,23
2020-11-25,United_States_Virgin_Islands,VI,14,0,104579,America,1521,23
2020-11-26,United_States_Virgin_Islands,VI,0,0,104579,America,1521,23
2020-11-27,United_States_Virgin_Islands,VI,0,0,104579,America,1521,23
2020-11-28,United_States_Virgin_Islands,VI,0,0,104579,America,1521,23
2020-11-29,United_States_Virgin_Islands,VI,17,0,104579,America,1538,23
2020-11-30,United_States_Virgin_Islands,VI,6,0,104579,America,1544,23
2020-12-01,United_States_Virgin_Islands,VI,6,0,104579,America,1550,23
2020-12-02,United_States_Virgin_Islands,VI,13,0,104579,America,1563,23
2020-12-03,United_States_Virgin_Islands,VI,26,0,104579,America,1589,23
2020-12-04,United_States_Virgin_Islands,VI,24,0,104579,America,1613,23
2020-12-05,United_States_Virgin_Islands,VI,20,0,104579,America,1633,23
2020-12-06,United_States_Virgin_Islands,VI,16,0,104579,America,1649,23
2020-12-07,United_States_Virgin_Islands,VI,0,0,104579,America,1649,23
2020-12-08,United_States_Virgin_Islands,VI,0,0,104579,America,1649,23
2020-12-09,United_States_Virgin_Islands,VI,31,0,104579,America,1680,23
2020-12-10,United_States_Virgin_Islands,VI,18,0,104579,America,1698,23
2020-12-11,United_States_Virgin_Islands,VI,35,0,104579,America,1733,23
2020-12-12,United_States_Virgin_Islands,VI,58,0,104579,America,1791,23
2020-12-13,United_States_Virgin_Islands,VI,16,0,104579,America,1807,23
2020-12-14,United_States_Virgin_Islands,VI,0,0,104579,America,1807,23
2019-12-31,Vietnam,VN,0,0,96462108,Asia,0,0
2020-01-01,Vietnam,VN,0,0,96462108,Asia,0,0
2020-01-02,Vietnam,VN,0,0,96462108,Asia,0,0
2020-01-03,Vietnam,VN,0,0,96462108,Asia,0,0
2020-01-04,Vietnam,VN,0,0,96462108,Asia,0,0
2020-01-05,Vietnam,VN,0,0,96462108,Asia,0,0
2020-01-06,Vietnam,VN,0,0,96462108,Asia,0,0
2020-01-07,Vietnam,VN,0,0,96462108,Asia,0,0
2020-01-08,Vietnam,VN,0,0,96462108,Asia,0,0
2020-01-09,Vietnam,VN,0,0,96462108,Asia,0,0
2020-01-10,Vietnam,VN,0,0,96462108,Asia,0,0
2020-01-11,Vietnam,VN,0,0,96462108,Asia,0,0
2020-01-12,Vietnam,VN,0,0,96462108,Asia,0,0
2020-01-13,Vietnam,VN,0,0,96462108,Asia,0,0
2020-01-14,Vietnam,VN,0,0,96462108,Asia,0,0
2020-01-15,Vietnam,VN,0,0,96462108,Asia,0,0
2020-01-16,Vietnam,VN,0,0,96462108,Asia,0,0
2020-01-17,Vietnam,VN,0,0,96462108,Asia,0,0
2020-01-18,Vietnam,VN,0,0,96462108,Asia,0,0
2020-01-19,Vietnam,VN,0,0,96462108,Asia,0,0
2020-01-20,Vietnam,VN,0,0,96462108,Asia,0,0
2020-01-21,Vietnam,VN,0,0,96462108,Asia,0,0
2020-01-22,Vietnam,VN,0,0,96462108,Asia,0,0
2020-01-23,Vietnam,VN,0,0,96462108,Asia,0,0
2020-01-24,Vietnam,VN,2,0,96462108,Asia,2,0
2020-01-25,Vietnam,VN,0,0,96462108,Asia,2,0
2020-01-26,Vietnam,VN,0,0,96462108,Asia,2,0
2020-01-27,Vietnam,VN,0,0,96462108,Asia,2,0
2020-01-28,Vietnam,VN,0,0,96462108,Asia,2,0
2020-01-29,Vietnam,VN,0,0,96462108,Asia,2,0
2020-01-30,Vietnam,VN,0,0,96462108,Asia,2,0
2020-01-31,Vietnam,VN,3,0,96462108,Asia,5,0
2020-02-01,Vietnam,VN,0,0,96462108,Asia,5,0
2020-02-02,Vietnam,VN,2,0,96462108,Asia,7,0
2020-02-03,Vietnam,VN,1,0,96462108,Asia,8,0
2020-02-04,Vietnam,VN,1,0,96462108,Asia,9,0
2020-02-05,Vietnam,VN,1,0,96462108,Asia,10,0
2020-02-06,Vietnam,VN,0,0,96462108,Asia,10,0
2020-02-07,Vietnam,VN,2,0,96462108,Asia,12,0
2020-02-08,Vietnam,VN,1,0,96462108,Asia,13,0
2020-02-09,Vietnam,VN,1,0,96462108,Asia,14,0
2020-02-10,Vietnam,VN,0,0,96462108,Asia,14,0
2020-02-11,Vietnam,VN,1,0,96462108,Asia,15,0
2020-02-12,Vietnam,VN,0,0,96462108,Asia,15,0
2020-02-13,Vietnam,VN,1,0,96462108,Asia,16,0
2020-02-14,Vietnam,VN,0,0,96462108,Asia,16,0
2020-02-15,Vietnam,VN,0,0,96462108,Asia,16,0
2020-02-16,Vietnam,VN,0,0,96462108,Asia,16,0
2020-02-17,Vietnam,VN,0,0,96462108,Asia,16,0
2020-02-18,Vietnam,VN,0,0,96462108,Asia,16,0
2020-02-19,Vietnam,VN,0,0,96462108,Asia,16,0
2020-02-20,Vietnam,VN,0,0,96462108,Asia,16,0
2020-02-21,Vietnam,VN,0,0,96462108,Asia,16,0
2020-02-22,Vietnam,VN,0,0,96462108,Asia,16,0
2020-02-23,Vietnam,VN,0,0,96462108,Asia,16,0
2020-02-24,Vietnam,VN,0,0,96462108,Asia,16,0
2020-02-25,Vietnam,VN,0,0,96462108,Asia,16,0
2020-02-26,Vietnam,VN,0,0,96462108,Asia,16,0
2020-02-27,Vietnam,VN,0,0,96462108,Asia,16,0
2020-02-28,Vietnam,VN,0,0,96462108,Asia,16,0
2020-02-29,Vietnam,VN,0,0,96462108,Asia,16,0
2020-03-01,Vietnam,VN,0,0,96462108,Asia,16,0
2020-03-02,Vietnam,VN,0,0,96462108,Asia,16,0
2020-03-07,Vietnam,VN,1,0,96462108,Asia,17,0
2020-03-08,Vietnam,VN,4,0,96462108,Asia,21,0
2020-03-09,Vietnam,VN,9,0,96462108,Asia,30,0
2020-03-10,Vietnam,VN,4,0,96462108,Asia,34,0
2020-03-11,Vietnam,VN,4,0,96462108,Asia,38,0
2020-03-12,Vietnam,VN,1,0,96462108,Asia,39,0
2020-03-13,Vietnam,VN,5,0,96462108,Asia,44,0
2020-03-14,Vietnam,VN,9,0,96462108,Asia,53,0
2020-03-15,Vietnam,VN,0,0,96462108,Asia,53,0
2020-03-16,Vietnam,VN,4,0,96462108,Asia,57,0
2020-03-17,Vietnam,VN,4,0,96462108,Asia,61,0
2020-03-18,Vietnam,VN,7,0,96462108,Asia,68,0
2020-03-19,Vietnam,VN,8,0,96462108,Asia,76,0
2020-03-20,Vietnam,VN,11,0,96462108,Asia,87,0
2020-03-21,Vietnam,VN,1,0,96462108,Asia,88,0
2020-03-22,Vietnam,VN,7,0,96462108,Asia,95,0
2020-03-23,Vietnam,VN,26,0,96462108,Asia,121,0
2020-03-24,Vietnam,VN,11,0,96462108,Asia,132,0
2020-03-25,Vietnam,VN,5,0,96462108,Asia,137,0
2020-03-26,Vietnam,VN,16,0,96462108,Asia,153,0
2020-03-27,Vietnam,VN,10,0,96462108,Asia,163,0
2020-03-28,Vietnam,VN,8,0,96462108,Asia,171,0
2020-03-29,Vietnam,VN,17,0,96462108,Asia,188,0
2020-03-30,Vietnam,VN,15,0,96462108,Asia,203,0
2020-03-31,Vietnam,VN,3,0,96462108,Asia,206,0
2020-04-01,Vietnam,VN,6,0,96462108,Asia,212,0
2020-04-02,Vietnam,VN,21,0,96462108,Asia,233,0
2020-04-03,Vietnam,VN,3,0,96462108,Asia,236,0
2020-04-04,Vietnam,VN,4,0,96462108,Asia,240,0
2020-04-05,Vietnam,VN,1,0,96462108,Asia,241,0
2020-04-06,Vietnam,VN,4,0,96462108,Asia,245,0
2020-04-07,Vietnam,VN,6,0,96462108,Asia,251,0
2020-04-08,Vietnam,VN,0,0,96462108,Asia,251,0
2020-04-09,Vietnam,VN,4,0,96462108,Asia,255,0
2020-04-10,Vietnam,VN,2,0,96462108,Asia,257,0
2020-04-11,Vietnam,VN,1,0,96462108,Asia,258,0
2020-04-12,Vietnam,VN,4,0,96462108,Asia,262,0
2020-04-13,Vietnam,VN,2,0,96462108,Asia,264,0
2020-04-14,Vietnam,VN,3,0,96462108,Asia,267,0
2020-04-15,Vietnam,VN,1,0,96462108,Asia,268,0
2020-04-16,Vietnam,VN,0,0,96462108,Asia,268,0
2020-04-17,Vietnam,VN,0,0,96462108,Asia,268,0
2020-04-18,Vietnam,VN,0,0,96462108,Asia,268,0
2020-04-19,Vietnam,VN,0,0,96462108,Asia,268,0
2020-04-20,Vietnam,VN,0,0,96462108,Asia,268,0
2020-04-21,Vietnam,VN,0,0,96462108,Asia,268,0
2020-04-22,Vietnam,VN,0,0,96462108,Asia,268,0
2020-04-23,Vietnam,VN,0,0,96462108,Asia,268,0
2020-04-24,Vietnam,VN,2,0,96462108,Asia,270,0
2020-04-25,Vietnam,VN,0,0,96462108,Asia,270,0
2020-04-26,Vietnam,VN,0,0,96462108,Asia,270,0
2020-04-27,Vietnam,VN,0,0,96462108,Asia,270,0
2020-04-28,Vietnam,VN,0,0,96462108,Asia,270,0
2020-04-29,Vietnam,VN,0,0,96462108,Asia,270,0
2020-04-30,Vietnam,VN,0,0,96462108,Asia,270,0
2020-05-01,Vietnam,VN,0,0,96462108,Asia,270,0
2020-05-02,Vietnam,VN,0,0,96462108,Asia,270,0
2020-05-03,Vietnam,VN,0,0,96462108,Asia,270,0
2020-05-04,Vietnam,VN,1,0,96462108,Asia,271,0
2020-05-05,Vietnam,VN,0,0,96462108,Asia,271,0
2020-05-06,Vietnam,VN,0,0,96462108,Asia,271,0
2020-05-07,Vietnam,VN,0,0,96462108,Asia,271,0
2020-05-08,Vietnam,VN,17,0,96462108,Asia,288,0
2020-05-09,Vietnam,VN,0,0,96462108,Asia,288,0
2020-05-10,Vietnam,VN,0,0,96462108,Asia,288,0
2020-05-11,Vietnam,VN,0,0,96462108,Asia,288,0
2020-05-12,Vietnam,VN,0,0,96462108,Asia,288,0
2020-05-13,Vietnam,VN,0,0,96462108,Asia,288,0
2020-05-14,Vietnam,VN,0,0,96462108,Asia,288,0
2020-05-15,Vietnam,VN,24,0,96462108,Asia,312,0
2020-05-16,Vietnam,VN,1,0,96462108,Asia,313,0
2020-05-17,Vietnam,VN,5,0,96462108,Asia,318,0
2020-05-18,Vietnam,VN,2,0,96462108,Asia,320,0
2020-05-19,Vietnam,VN,4,0,96462108,Asia,324,0
2020-05-20,Vietnam,VN,0,0,96462108,Asia,324,0
2020-05-21,Vietnam,VN,0,0,96462108,Asia,324,0
2020-05-22,Vietnam,VN,0,0,96462108,Asia,324,0
2020-05-23,Vietnam,VN,0,0,96462108,Asia,324,0
2020-05-24,Vietnam,VN,0,0,96462108,Asia,324,0
2020-05-25,Vietnam,VN,1,0,96462108,Asia,325,0
2020-05-26,Vietnam,VN,1,0,96462108,Asia,326,0
2020-05-27,Vietnam,VN,1,0,96462108,Asia,327,0
2020-05-28,Vietnam,VN,0,0,96462108,Asia,327,0
2020-05-29,Vietnam,VN,0,0,96462108,Asia,327,0
2020-05-30,Vietnam,VN,0,0,96462108,Asia,327,0
2020-05-31,Vietnam,VN,0,0,96462108,Asia,327,0
2020-06-01,Vietnam,VN,1,0,96462108,Asia,328,0
2020-06-02,Vietnam,VN,0,0,96462108,Asia,328,0
2020-06-03,Vietnam,VN,0,0,96462108,Asia,328,0
2020-06-04,Vietnam,VN,0,0,96462108,Asia,328,0
2020-06-05,Vietnam,VN,0,0,96462108,Asia,328,0
2020-06-06,Vietnam,VN,1,0,96462108,Asia,329,0
2020-06-07,Vietnam,VN,0,0,96462108,Asia,329,0
2020-06-08,Vietnam,VN,2,0,96462108,Asia,331,0
2020-06-09,Vietnam,VN,1,0,96462108,Asia,332,0
2020-06-10,Vietnam,VN,0,0,96462108,Asia,332,0
2020-06-11,Vietnam,VN,0,0,96462108,Asia,332,0
2020-06-12,Vietnam,VN,0,0,96462108,Asia,332,0
2020-06-13,Vietnam,VN,1,0,96462108,Asia,333,0
2020-06-14,Vietnam,VN,1,0,96462108,Asia,334,0
2020-06-15,Vietnam,VN,0,0,96462108,Asia,334,0
2020-06-16,Vietnam,VN,0,0,96462108,Asia,334,0
2020-06-17,Vietnam,VN,1,0,96462108,Asia,335,0
2020-06-18,Vietnam,VN,0,0,96462108,Asia,335,0
2020-06-19,Vietnam,VN,7,0,96462108,Asia,342,0
2020-06-20,Vietnam,VN,7,0,96462108,Asia,349,0
2020-06-21,Vietnam,VN,0,0,96462108,Asia,349,0
2020-06-22,Vietnam,VN,0,0,96462108,Asia,349,0
2020-06-23,Vietnam,VN,0,0,96462108,Asia,349,0
2020-06-24,Vietnam,VN,0,0,96462108,Asia,349,0
2020-06-25,Vietnam,VN,3,0,96462108,Asia,352,0
2020-06-26,Vietnam,VN,0,0,96462108,Asia,352,0
2020-06-27,Vietnam,VN,1,0,96462108,Asia,353,0
2020-06-28,Vietnam,VN,1,0,96462108,Asia,354,0
2020-06-29,Vietnam,VN,1,0,96462108,Asia,355,0
2020-06-30,Vietnam,VN,0,0,96462108,Asia,355,0
2020-07-01,Vietnam,VN,0,0,96462108,Asia,355,0
2020-07-02,Vietnam,VN,0,0,96462108,Asia,355,0
2020-07-03,Vietnam,VN,0,0,96462108,Asia,355,0
2020-07-04,Vietnam,VN,0,0,96462108,Asia,355,0
2020-07-05,Vietnam,VN,0,0,96462108,Asia,355,0
2020-07-06,Vietnam,VN,0,0,96462108,Asia,355,0
2020-07-07,Vietnam,VN,14,0,96462108,Asia,369,0
2020-07-08,Vietnam,VN,0,0,96462108,Asia,369,0
2020-07-09,Vietnam,VN,0,0,96462108,Asia,369,0
2020-07-10,Vietnam,VN,0,0,96462108,Asia,369,0
2020-07-11,Vietnam,VN,1,0,96462108,Asia,370,0
2020-07-12,Vietnam,VN,0,0,96462108,Asia,370,0
2020-07-13,Vietnam,VN,2,0,96462108,Asia,372,0
2020-07-14,Vietnam,VN,1,0,96462108,Asia,373,0
2020-07-15,Vietnam,VN,0,0,96462108,Asia,373,0
2020-07-16,Vietnam,VN,0,0,96462108,Asia,373,0
2020-07-17,Vietnam,VN,0,0,96462108,Asia,373,0
2020-07-18,Vietnam,VN,0,0,96462108,Asia,373,0
2020-07-19,Vietnam,VN,0,0,96462108,Asia,373,0
2020-07-20,Vietnam,VN,0,0,96462108,Asia,373,0
2020-07-21,Vietnam,VN,0,0,96462108,Asia,373,0
2020-07-22,Vietnam,VN,28,0,96462108,Asia,401,0
2020-07-23,Vietnam,VN,7,0,96462108,Asia,408,0
2020-07-24,Vietnam,VN,4,0,96462108,Asia,412,0
2020-07-25,Vietnam,VN,3,0,96462108,Asia,415,0
2020-07-26,Vietnam,VN,0,0,96462108,Asia,415,0
2020-07-27,Vietnam,VN,5,0,96462108,Asia,420,0
2020-07-28,Vietnam,VN,11,0,96462108,Asia,431,0
2020-07-29,Vietnam,VN,2,0,96462108,Asia,433,0
2020-07-30,Vietnam,VN,26,0,96462108,Asia,459,0
2020-07-31,Vietnam,VN,50,0,96462108,Asia,509,0
2020-08-01,Vietnam,VN,49,3,96462108,Asia,558,3
2020-08-02,Vietnam,VN,32,2,96462108,Asia,590,5
2020-08-03,Vietnam,VN,31,1,96462108,Asia,621,6
2020-08-04,Vietnam,VN,31,2,96462108,Asia,652,8
2020-08-05,Vietnam,VN,20,0,96462108,Asia,672,8
2020-08-06,Vietnam,VN,45,1,96462108,Asia,717,9
2020-08-07,Vietnam,VN,33,1,96462108,Asia,750,10
2020-08-08,Vietnam,VN,39,0,96462108,Asia,789,10
2020-08-09,Vietnam,VN,23,0,96462108,Asia,812,10
2020-08-10,Vietnam,VN,29,3,96462108,Asia,841,13
2020-08-11,Vietnam,VN,5,0,96462108,Asia,846,13
2020-08-12,Vietnam,VN,20,4,96462108,Asia,866,17
2020-08-13,Vietnam,VN,17,1,96462108,Asia,883,18
2020-08-14,Vietnam,VN,28,3,96462108,Asia,911,21
2020-08-15,Vietnam,VN,19,0,96462108,Asia,930,21
2020-08-16,Vietnam,VN,4,1,96462108,Asia,934,22
2020-08-17,Vietnam,VN,30,2,96462108,Asia,964,24
2020-08-18,Vietnam,VN,19,1,96462108,Asia,983,25
2020-08-19,Vietnam,VN,6,0,96462108,Asia,989,25
2020-08-20,Vietnam,VN,5,0,96462108,Asia,994,25
2020-08-21,Vietnam,VN,13,0,96462108,Asia,1007,25
2020-08-22,Vietnam,VN,2,0,96462108,Asia,1009,25
2020-08-23,Vietnam,VN,5,1,96462108,Asia,1014,26
2020-08-24,Vietnam,VN,2,1,96462108,Asia,1016,27
2020-08-25,Vietnam,VN,6,0,96462108,Asia,1022,27
2020-08-26,Vietnam,VN,7,0,96462108,Asia,1029,27
2020-08-27,Vietnam,VN,5,3,96462108,Asia,1034,30
2020-08-28,Vietnam,VN,2,0,96462108,Asia,1036,30
2020-08-29,Vietnam,VN,2,1,96462108,Asia,1038,31
2020-08-30,Vietnam,VN,2,1,96462108,Asia,1040,32
2020-08-31,Vietnam,VN,0,0,96462108,Asia,1040,32
2020-09-01,Vietnam,VN,4,2,96462108,Asia,1044,34
2020-09-02,Vietnam,VN,0,0,96462108,Asia,1044,34
2020-09-03,Vietnam,VN,2,1,96462108,Asia,1046,35
2020-09-04,Vietnam,VN,0,0,96462108,Asia,1046,35
2020-09-05,Vietnam,VN,0,0,96462108,Asia,1046,35
2020-09-06,Vietnam,VN,3,0,96462108,Asia,1049,35
2020-09-07,Vietnam,VN,0,0,96462108,Asia,1049,35
2020-09-08,Vietnam,VN,0,0,96462108,Asia,1049,35
2020-09-09,Vietnam,VN,5,0,96462108,Asia,1054,35
2020-09-10,Vietnam,VN,5,0,96462108,Asia,1059,35
2020-09-11,Vietnam,VN,0,0,96462108,Asia,1059,35
2020-09-12,Vietnam,VN,1,0,96462108,Asia,1060,35
2020-09-13,Vietnam,VN,0,0,96462108,Asia,1060,35
2020-09-14,Vietnam,VN,3,0,96462108,Asia,1063,35
2020-09-15,Vietnam,VN,0,0,96462108,Asia,1063,35
2020-09-16,Vietnam,VN,0,0,96462108,Asia,1063,35
2020-09-17,Vietnam,VN,0,0,96462108,Asia,1063,35
2020-09-18,Vietnam,VN,3,0,96462108,Asia,1066,35
2020-09-19,Vietnam,VN,2,0,96462108,Asia,1068,35
2020-09-20,Vietnam,VN,0,0,96462108,Asia,1068,35
2020-09-21,Vietnam,VN,0,0,96462108,Asia,1068,35
2020-09-22,Vietnam,VN,0,0,96462108,Asia,1068,35
2020-09-23,Vietnam,VN,0,0,96462108,Asia,1068,35
2020-09-24,Vietnam,VN,1,0,96462108,Asia,1069,35
2020-09-25,Vietnam,VN,0,0,96462108,Asia,1069,35
2020-09-26,Vietnam,VN,0,0,96462108,Asia,1069,35
2020-09-27,Vietnam,VN,0,0,96462108,Asia,1069,35
2020-09-28,Vietnam,VN,5,0,96462108,Asia,1074,35
2020-09-29,Vietnam,VN,3,0,96462108,Asia,1077,35
2020-09-30,Vietnam,VN,17,0,96462108,Asia,1094,35
2020-10-01,Vietnam,VN,0,0,96462108,Asia,1094,35
2020-10-02,Vietnam,VN,1,0,96462108,Asia,1095,35
2020-10-03,Vietnam,VN,1,0,96462108,Asia,1096,35
2020-10-04,Vietnam,VN,0,0,96462108,Asia,1096,35
2020-10-05,Vietnam,VN,0,0,96462108,Asia,1096,35
2020-10-06,Vietnam,VN,1,0,96462108,Asia,1097,35
2020-10-07,Vietnam,VN,1,0,96462108,Asia,1098,35
2020-10-08,Vietnam,VN,1,0,96462108,Asia,1099,35
2020-10-09,Vietnam,VN,1,0,96462108,Asia,1100,35
2020-10-10,Vietnam,VN,5,0,96462108,Asia,1105,35
2020-10-11,Vietnam,VN,2,0,96462108,Asia,1107,35
2020-10-12,Vietnam,VN,2,0,96462108,Asia,1109,35
2020-10-13,Vietnam,VN,1,0,96462108,Asia,1110,35
2020-10-14,Vietnam,VN,3,0,96462108,Asia,1113,35
2020-10-15,Vietnam,VN,9,0,96462108,Asia,1122,35
2020-10-16,Vietnam,VN,2,0,96462108,Asia,1124,35
2020-10-17,Vietnam,VN,0,0,96462108,Asia,1124,35
2020-10-18,Vietnam,VN,2,0,96462108,Asia,1126,35
2020-10-19,Vietnam,VN,8,0,96462108,Asia,1134,35
2020-10-20,Vietnam,VN,6,0,96462108,Asia,1140,35
2020-10-21,Vietnam,VN,1,0,96462108,Asia,1141,35
2020-10-22,Vietnam,VN,4,0,96462108,Asia,1145,35
2020-10-23,Vietnam,VN,3,0,96462108,Asia,1148,35
2020-10-24,Vietnam,VN,0,0,96462108,Asia,1148,35
2020-10-25,Vietnam,VN,12,0,96462108,Asia,1160,35
2020-10-26,Vietnam,VN,8,0,96462108,Asia,1168,35
2020-10-27,Vietnam,VN,1,0,96462108,Asia,1169,35
2020-10-28,Vietnam,VN,3,0,96462108,Asia,1172,35
2020-10-29,Vietnam,VN,1,0,96462108,Asia,1173,35
2020-10-30,Vietnam,VN,4,0,96462108,Asia,1177,35
2020-10-31,Vietnam,VN,0,0,96462108,Asia,1177,35
2020-11-01,Vietnam,VN,3,0,96462108,Asia,1180,35
2020-11-02,Vietnam,VN,0,0,96462108,Asia,1180,35
2020-11-03,Vietnam,VN,12,0,96462108,Asia,1192,35
2020-11-04,Vietnam,VN,11,0,96462108,Asia,1203,35
2020-11-05,Vietnam,VN,4,0,96462108,Asia,1207,35
2020-11-06,Vietnam,VN,0,0,96462108,Asia,1207,35
2020-11-07,Vietnam,VN,6,0,96462108,Asia,1213,35
2020-11-08,Vietnam,VN,0,0,96462108,Asia,1213,35
2020-11-09,Vietnam,VN,0,0,96462108,Asia,1213,35
2020-11-10,Vietnam,VN,3,0,96462108,Asia,1216,35
2020-11-11,Vietnam,VN,10,0,96462108,Asia,1226,35
2020-11-12,Vietnam,VN,26,0,96462108,Asia,1252,35
2020-11-13,Vietnam,VN,1,0,96462108,Asia,1253,35
2020-11-14,Vietnam,VN,3,0,96462108,Asia,1256,35
2020-11-15,Vietnam,VN,9,0,96462108,Asia,1265,35
2020-11-16,Vietnam,VN,16,0,96462108,Asia,1281,35
2020-11-17,Vietnam,VN,2,0,96462108,Asia,1283,35
2020-11-18,Vietnam,VN,5,0,96462108,Asia,1288,35
2020-11-19,Vietnam,VN,12,0,96462108,Asia,1300,35
2020-11-20,Vietnam,VN,4,0,96462108,Asia,1304,35
2020-11-21,Vietnam,VN,1,0,96462108,Asia,1305,35
2020-11-22,Vietnam,VN,1,0,96462108,Asia,1306,35
2020-11-23,Vietnam,VN,0,0,96462108,Asia,1306,35
2020-11-24,Vietnam,VN,6,0,96462108,Asia,1312,35
2020-11-25,Vietnam,VN,4,0,96462108,Asia,1316,35
2020-11-26,Vietnam,VN,5,0,96462108,Asia,1321,35
2020-11-27,Vietnam,VN,10,0,96462108,Asia,1331,35
2020-11-28,Vietnam,VN,8,0,96462108,Asia,1339,35
2020-11-29,Vietnam,VN,2,0,96462108,Asia,1341,35
2020-11-30,Vietnam,VN,2,0,96462108,Asia,1343,35
2020-12-01,Vietnam,VN,3,0,96462108,Asia,1346,35
2020-12-02,Vietnam,VN,5,0,96462108,Asia,1351,35
2020-12-03,Vietnam,VN,7,0,96462108,Asia,1358,35
2020-12-04,Vietnam,VN,3,0,96462108,Asia,1361,35
2020-12-05,Vietnam,VN,0,0,96462108,Asia,1361,35
2020-12-06,Vietnam,VN,4,0,96462108,Asia,1365,35
2020-12-07,Vietnam,VN,1,0,96462108,Asia,1366,35
2020-12-08,Vietnam,VN,1,0,96462108,Asia,1367,35
2020-12-09,Vietnam,VN,10,0,96462108,Asia,1377,35
2020-12-10,Vietnam,VN,4,0,96462108,Asia,1381,35
2020-12-11,Vietnam,VN,4,0,96462108,Asia,1385,35
2020-12-12,Vietnam,VN,6,0,96462108,Asia,1391,35
2020-12-13,Vietnam,VN,4,0,96462108,Asia,1395,35
2020-12-14,Vietnam,VN,2,0,96462108,Asia,1397,35
2020-11-11,Vanuatu,VU,1,0,299882,Oceania,1,0
2020-11-12,Vanuatu,VU,0,0,299882,Oceania,1,0
2020-11-13,Vanuatu,VU,0,0,299882,Oceania,1,0
2020-11-14,Vanuatu,VU,0,0,299882,Oceania,1,0
2020-11-15,Vanuatu,VU,0,0,299882,Oceania,1,0
2020-11-16,Vanuatu,VU,0,0,299882,Oceania,1,0
2020-11-17,Vanuatu,VU,0,0,299882,Oceania,1,0
2020-11-18,Vanuatu,VU,0,0,299882,Oceania,1,0
2020-11-19,Vanuatu,VU,0,0,299882,Oceania,1,0
2020-11-20,Vanuatu,VU,0,0,299882,Oceania,1,0
2020-11-21,Vanuatu,VU,0,0,299882,Oceania,1,0
2020-11-22,Vanuatu,VU,0,0,299882,Oceania,1,0
2020-11-23,Vanuatu,VU,0,0,299882,Oceania,1,0
2020-11-24,Vanuatu,VU,0,0,299882,Oceania,1,0
2020-11-25,Vanuatu,VU,0,0,299882,Oceania,1,0
2020-11-26,Vanuatu,VU,0,0,299882,Oceania,1,0
2020-11-27,Vanuatu,VU,0,0,299882,Oceania,1,0
2020-11-28,Vanuatu,VU,0,0,299882,Oceania,1,0
2020-11-29,Vanuatu,VU,0,0,299882,Oceania,1,0
2020-11-30,Vanuatu,VU,0,0,299882,Oceania,1,0
2020-12-01,Vanuatu,VU,0,0,299882,Oceania,1,0
2020-12-02,Vanuatu,VU,0,0,299882,Oceania,1,0
2020-12-03,Vanuatu,VU,0,0,299882,Oceania,1,0
2020-12-04,Vanuatu,VU,0,0,299882,Oceania,1,0
2020-12-05,Vanuatu,VU,0,0,299882,Oceania,1,0
2020-12-06,Vanuatu,VU,0,0,299882,Oceania,1,0
2020-12-07,Vanuatu,VU,0,0,299882,Oceania,1,0
2020-12-08,Vanuatu,VU,0,0,299882,Oceania,1,0
2020-12-09,Vanuatu,VU,0,0,299882,Oceania,1,0
2020-12-10,Vanuatu,VU,0,0,299882,Oceania,1,0
2020-12-11,Vanuatu,VU,0,0,299882,Oceania,1,0
2020-12-12,Vanuatu,VU,0,0,299882,Oceania,1,0
2020-12-13,Vanuatu,VU,0,0,299882,Oceania,1,0
2020-12-14,Vanuatu,VU,0,0,299882,Oceania,1,0
2020-10-17,Wallis_and_Futuna,WF,1,0,0,Oceania,1,0
2020-10-18,Wallis_and_Futuna,WF,0,0,0,Oceania,1,0
2020-10-19,Wallis_and_Futuna,WF,0,0,0,Oceania,1,0
2020-10-20,Wallis_and_Futuna,WF,0,0,0,Oceania,1,0
2020-10-21,Wallis_and_Futuna,WF,0,0,0,Oceania,1,0
2020-10-22,Wallis_and_Futuna,WF,0,0,0,Oceania,1,0
2020-10-23,Wallis_and_Futuna,WF,0,0,0,Oceania,1,0
2020-10-24,Wallis_and_Futuna,WF,0,0,0,Oceania,1,0
2020-10-25,Wallis_and_Futuna,WF,0,0,0,Oceania,1,0
2020-10-26,Wallis_and_Futuna,WF,0,0,0,Oceania,1,0
2020-10-27,Wallis_and_Futuna,WF,0,0,0,Oceania,1,0
2020-10-28,Wallis_and_Futuna,WF,0,0,0,Oceania,1,0
2020-10-29,Wallis_and_Futuna,WF,0,0,0,Oceania,1,0
2020-10-30,Wallis_and_Futuna,WF,0,0,0,Oceania,1,0
2020-10-31,Wallis_and_Futuna,WF,0,0,0,Oceania,1,0
2020-11-01,Wallis_and_Futuna,WF,0,0,0,Oceania,1,0
2020-11-02,Wallis_and_Futuna,WF,0,0,0,Oceania,1,0
2020-11-03,Wallis_and_Futuna,WF,0,0,0,Oceania,1,0
2020-11-04,Wallis_and_Futuna,WF,0,0,0,Oceania,1,0
2020-11-05,Wallis_and_Futuna,WF,0,0,0,Oceania,1,0
2020-11-06,Wallis_and_Futuna,WF,0,0,0,Oceania,1,0
2020-11-07,Wallis_and_Futuna,WF,0,0,0,Oceania,1,0
2020-11-08,Wallis_and_Futuna,WF,0,0,0,Oceania,1,0
2020-11-09,Wallis_and_Futuna,WF,0,0,0,Oceania,1,0
2020-11-10,Wallis_and_Futuna,WF,0,0,0,Oceania,1,0
2020-11-11,Wallis_and_Futuna,WF,0,0,0,Oceania,1,0
2020-11-12,Wallis_and_Futuna,WF,0,0,0,Oceania,1,0
2020-11-13,Wallis_and_Futuna,WF,0,0,0,Oceania,1,0
2020-11-14,Wallis_and_Futuna,WF,0,0,0,Oceania,1,0
2020-11-15,Wallis_and_Futuna,WF,0,0,0,Oceania,1,0
2020-11-16,Wallis_and_Futuna,WF,0,0,0,Oceania,1,0
2020-11-17,Wallis_and_Futuna,WF,0,0,0,Oceania,1,0
2020-11-18,Wallis_and_Futuna,WF,0,0,0,Oceania,1,0
2020-11-19,Wallis_and_Futuna,WF,0,0,0,Oceania,1,0
2020-11-20,Wallis_and_Futuna,WF,1,0,0,Oceania,2,0
2020-11-21,Wallis_and_Futuna,WF,0,0,0,Oceania,2,0
2020-11-22,Wallis_and_Futuna,WF,0,0,0,Oceania,2,0
2020-11-23,Wallis_and_Futuna,WF,0,0,0,Oceania,2,0
2020-11-24,Wallis_and_Futuna,WF,0,0,0,Oceania,2,0
2020-11-25,Wallis_and_Futuna,WF,0,0,0,Oceania,2,0
2020-11-26,Wallis_and_Futuna,WF,1,0,0,Oceania,3,0
2020-11-27,Wallis_and_Futuna,WF,0,0,0,Oceania,3,0
2020-11-28,Wallis_and_Futuna,WF,0,0,0,Oceania,3,0
2020-11-29,Wallis_and_Futuna,WF,0,0,0,Oceania,3,0
2020-11-30,Wallis_and_Futuna,WF,0,0,0,Oceania,3,0
2020-12-01,Wallis_and_Futuna,WF,0,0,0,Oceania,3,0
2020-12-02,Wallis_and_Futuna,WF,0,0,0,Oceania,3,0
2020-12-03,Wallis_and_Futuna,WF,0,0,0,Oceania,3,0
2020-12-04,Wallis_and_Futuna,WF,0,0,0,Oceania,3,0
2020-12-05,Wallis_and_Futuna,WF,0,0,0,Oceania,3,0
2020-12-06,Wallis_and_Futuna,WF,0,0,0,Oceania,3,0
2020-12-07,Wallis_and_Futuna,WF,0,0,0,Oceania,3,0
2020-12-08,Wallis_and_Futuna,WF,0,0,0,Oceania,3,0
2020-12-09,Wallis_and_Futuna,WF,0,0,0,Oceania,3,0
2020-12-10,Wallis_and_Futuna,WF,0,0,0,Oceania,3,0
2020-12-11,Wallis_and_Futuna,WF,0,0,0,Oceania,3,0
2020-12-12,Wallis_and_Futuna,WF,0,0,0,Oceania,3,0
2020-12-13,Wallis_and_Futuna,WF,0,0,0,Oceania,3,0
2020-12-14,Wallis_and_Futuna,WF,0,0,0,Oceania,3,0
2020-03-14,Kosovo,XK,2,0,1798506,Europe,2,0
2020-03-15,Kosovo,XK,3,0,1798506,Europe,5,0
2020-03-16,Kosovo,XK,8,0,1798506,Europe,13,0
2020-03-17,Kosovo,XK,3,0,1798506,Europe,16,0
2020-03-18,Kosovo,XK,3,0,1798506,Europe,19,0
2020-03-19,Kosovo,XK,1,0,1798506,Europe,20,0
2020-03-20,Kosovo,XK,1,0,1798506,Europe,21,0
2020-03-21,Kosovo,XK,3,0,1798506,Europe,24,0
2020-03-22,Kosovo,XK,7,0,1798506,Europe,31,0
2020-03-23,Kosovo,XK,2,1,1798506,Europe,33,1
2020-03-24,Kosovo,XK,28,0,1798506,Europe,61,1
2020-03-25,Kosovo,XK,2,0,1798506,Europe,63,1
2020-03-26,Kosovo,XK,8,0,1798506,Europe,71,1
2020-03-27,Kosovo,XK,15,0,1798506,Europe,86,1
2020-03-28,Kosovo,XK,6,0,1798506,Europe,92,1
2020-03-29,Kosovo,XK,3,0,1798506,Europe,95,1
2020-03-30,Kosovo,XK,3,0,1798506,Europe,98,1
2020-03-31,Kosovo,XK,12,0,1798506,Europe,110,1
2020-04-01,Kosovo,XK,7,0,1798506,Europe,117,1
2020-04-02,Kosovo,XK,13,0,1798506,Europe,130,1
2020-04-03,Kosovo,XK,8,0,1798506,Europe,138,1
2020-04-04,Kosovo,XK,9,0,1798506,Europe,147,1
2020-04-05,Kosovo,XK,8,0,1798506,Europe,155,1
2020-04-06,Kosovo,XK,10,0,1798506,Europe,165,1
2020-04-07,Kosovo,XK,26,2,1798506,Europe,191,3
2020-04-08,Kosovo,XK,19,2,1798506,Europe,210,5
2020-04-09,Kosovo,XK,14,1,1798506,Europe,224,6
2020-04-10,Kosovo,XK,3,1,1798506,Europe,227,7
2020-04-11,Kosovo,XK,23,0,1798506,Europe,250,7
2020-04-12,Kosovo,XK,33,0,1798506,Europe,283,7
2020-04-13,Kosovo,XK,79,0,1798506,Europe,362,7
2020-04-14,Kosovo,XK,18,1,1798506,Europe,380,8
2020-04-15,Kosovo,XK,15,0,1798506,Europe,395,8
2020-04-16,Kosovo,XK,41,1,1798506,Europe,436,9
2020-04-17,Kosovo,XK,30,2,1798506,Europe,466,11
2020-04-18,Kosovo,XK,36,1,1798506,Europe,502,12
2020-04-19,Kosovo,XK,31,0,1798506,Europe,533,12
2020-04-20,Kosovo,XK,28,2,1798506,Europe,561,14
2020-04-21,Kosovo,XK,37,0,1798506,Europe,598,14
2020-04-22,Kosovo,XK,6,3,1798506,Europe,604,17
2020-04-23,Kosovo,XK,26,0,1798506,Europe,630,17
2020-04-24,Kosovo,XK,39,1,1798506,Europe,669,18
2020-04-25,Kosovo,XK,34,0,1798506,Europe,703,18
2020-04-26,Kosovo,XK,28,0,1798506,Europe,731,18
2020-04-27,Kosovo,XK,33,2,1798506,Europe,764,20
2020-04-28,Kosovo,XK,22,1,1798506,Europe,786,21
2020-04-29,Kosovo,XK,12,0,1798506,Europe,798,21
2020-04-30,Kosovo,XK,10,0,1798506,Europe,808,21
2020-05-01,Kosovo,XK,12,3,1798506,Europe,820,24
2020-05-02,Kosovo,XK,9,0,1798506,Europe,829,24
2020-05-03,Kosovo,XK,11,1,1798506,Europe,840,25
2020-05-04,Kosovo,XK,11,0,1798506,Europe,851,25
2020-05-05,Kosovo,XK,4,1,1798506,Europe,855,26
2020-05-06,Kosovo,XK,1,0,1798506,Europe,856,26
2020-05-07,Kosovo,XK,4,0,1798506,Europe,860,26
2020-05-08,Kosovo,XK,1,1,1798506,Europe,861,27
2020-05-09,Kosovo,XK,1,1,1798506,Europe,862,28
2020-05-10,Kosovo,XK,8,0,1798506,Europe,870,28
2020-05-11,Kosovo,XK,14,0,1798506,Europe,884,28
2020-05-12,Kosovo,XK,11,0,1798506,Europe,895,28
2020-05-13,Kosovo,XK,24,1,1798506,Europe,919,29
2020-05-14,Kosovo,XK,8,0,1798506,Europe,927,29
2020-05-15,Kosovo,XK,18,0,1798506,Europe,945,29
2020-05-16,Kosovo,XK,10,0,1798506,Europe,955,29
2020-05-17,Kosovo,XK,23,0,1798506,Europe,978,29
2020-05-18,Kosovo,XK,7,0,1798506,Europe,985,29
2020-05-19,Kosovo,XK,3,0,1798506,Europe,988,29
2020-05-20,Kosovo,XK,1,0,1798506,Europe,989,29
2020-05-21,Kosovo,XK,14,0,1798506,Europe,1003,29
2020-05-22,Kosovo,XK,1,0,1798506,Europe,1004,29
2020-05-23,Kosovo,XK,21,0,1798506,Europe,1025,29
2020-05-24,Kosovo,XK,7,0,1798506,Europe,1032,29
2020-05-25,Kosovo,XK,0,0,1798506,Europe,1032,29
2020-05-26,Kosovo,XK,6,1,1798506,Europe,1038,30
2020-05-27,Kosovo,XK,9,0,1798506,Europe,1047,30
2020-05-28,Kosovo,XK,1,0,1798506,Europe,1048,30
2020-05-29,Kosovo,XK,4,0,1798506,Europe,1052,30
2020-05-30,Kosovo,XK,12,0,1798506,Europe,1064,30
2020-05-31,Kosovo,XK,6,0,1798506,Europe,1070,30
2020-06-01,Kosovo,XK,13,0,1798506,Europe,1083,30
2020-06-02,Kosovo,XK,27,0,1798506,Europe,1110,30
2020-06-03,Kosovo,XK,13,0,1798506,Europe,1123,30
2020-06-04,Kosovo,XK,19,0,1798506,Europe,1142,30
2020-06-05,Kosovo,XK,5,0,1798506,Europe,1147,30
2020-06-06,Kosovo,XK,11,0,1798506,Europe,1158,30
2020-06-07,Kosovo,XK,36,0,1798506,Europe,1194,30
2020-06-08,Kosovo,XK,40,1,1798506,Europe,1234,31
2020-06-09,Kosovo,XK,29,0,1798506,Europe,1263,31
2020-06-10,Kosovo,XK,6,0,1798506,Europe,1269,31
2020-06-11,Kosovo,XK,29,0,1798506,Europe,1298,31
2020-06-12,Kosovo,XK,28,0,1798506,Europe,1326,31
2020-06-13,Kosovo,XK,58,0,1798506,Europe,1384,31
2020-06-14,Kosovo,XK,53,1,1798506,Europe,1437,32
2020-06-15,Kosovo,XK,49,1,1798506,Europe,1486,33
2020-06-16,Kosovo,XK,129,0,1798506,Europe,1615,33
2020-06-17,Kosovo,XK,141,1,1798506,Europe,1756,34
2020-06-18,Kosovo,XK,77,0,1798506,Europe,1833,34
2020-06-19,Kosovo,XK,83,0,1798506,Europe,1916,34
2020-06-20,Kosovo,XK,82,0,1798506,Europe,1998,34
2020-06-21,Kosovo,XK,75,1,1798506,Europe,2073,35
2020-06-22,Kosovo,XK,96,1,1798506,Europe,2169,36
2020-06-23,Kosovo,XK,47,1,1798506,Europe,2216,37
2020-06-24,Kosovo,XK,52,1,1798506,Europe,2268,38
2020-06-25,Kosovo,XK,95,2,1798506,Europe,2363,40
2020-06-26,Kosovo,XK,69,2,1798506,Europe,2432,42
2020-06-27,Kosovo,XK,62,2,1798506,Europe,2494,44
2020-06-28,Kosovo,XK,96,4,1798506,Europe,2590,48
2020-06-29,Kosovo,XK,87,1,1798506,Europe,2677,49
2020-06-30,Kosovo,XK,122,0,1798506,Europe,2799,49
2020-07-01,Kosovo,XK,79,2,1798506,Europe,2878,51
2020-07-02,Kosovo,XK,113,3,1798506,Europe,2991,54
2020-07-03,Kosovo,XK,73,1,1798506,Europe,3064,55
2020-07-04,Kosovo,XK,0,0,1798506,Europe,3064,55
2020-07-05,Kosovo,XK,0,0,1798506,Europe,3064,55
2020-07-06,Kosovo,XK,292,11,1798506,Europe,3356,66
2020-07-07,Kosovo,XK,152,9,1798506,Europe,3508,75
2020-07-08,Kosovo,XK,195,4,1798506,Europe,3703,79
2020-07-09,Kosovo,XK,183,3,1798506,Europe,3886,82
2020-07-10,Kosovo,XK,214,4,1798506,Europe,4100,86
2020-07-11,Kosovo,XK,207,8,1798506,Europe,4307,94
2020-07-12,Kosovo,XK,408,7,1798506,Europe,4715,101
2020-07-13,Kosovo,XK,216,1,1798506,Europe,4931,102
2020-07-14,Kosovo,XK,187,6,1798506,Europe,5118,108
2020-07-15,Kosovo,XK,0,0,1798506,Europe,5118,108
2020-07-16,Kosovo,XK,119,4,1798506,Europe,5237,112
2020-07-17,Kosovo,XK,0,0,1798506,Europe,5237,112
2020-07-18,Kosovo,XK,235,12,1798506,Europe,5472,124
2020-07-19,Kosovo,XK,145,6,1798506,Europe,5617,130
2020-07-20,Kosovo,XK,118,5,1798506,Europe,5735,135
2020-07-21,Kosovo,XK,142,4,1798506,Europe,5877,139
2020-07-22,Kosovo,XK,0,0,1798506,Europe,5877,139
2020-07-23,Kosovo,XK,409,11,1798506,Europe,6286,150
2020-07-24,Kosovo,XK,181,8,1798506,Europe,6467,158
2020-07-25,Kosovo,XK,213,6,1798506,Europe,6680,164
2020-07-26,Kosovo,XK,237,5,1798506,Europe,6917,169
2020-07-27,Kosovo,XK,0,0,1798506,Europe,6917,169
2020-07-28,Kosovo,XK,496,16,1798506,Europe,7413,185
2020-07-29,Kosovo,XK,239,7,1798506,Europe,7652,192
2020-07-30,Kosovo,XK,194,4,1798506,Europe,7846,196
2020-07-31,Kosovo,XK,258,16,1798506,Europe,8104,212
2020-08-01,Kosovo,XK,226,15,1798506,Europe,8330,227
2020-08-02,Kosovo,XK,224,9,1798506,Europe,8554,236
2020-08-03,Kosovo,XK,245,13,1798506,Europe,8799,249
2020-08-04,Kosovo,XK,250,7,1798506,Europe,9049,256
2020-08-05,Kosovo,XK,225,40,1798506,Europe,9274,296
2020-08-06,Kosovo,XK,218,-12,1798506,Europe,9492,284
2020-08-07,Kosovo,XK,196,16,1798506,Europe,9688,300
2020-08-08,Kosovo,XK,181,3,1798506,Europe,9869,303
2020-08-09,Kosovo,XK,190,12,1798506,Europe,10059,315
2020-08-10,Kosovo,XK,188,12,1798506,Europe,10247,327
2020-08-11,Kosovo,XK,172,14,1798506,Europe,10419,341
2020-08-12,Kosovo,XK,171,13,1798506,Europe,10590,354
2020-08-13,Kosovo,XK,205,11,1798506,Europe,10795,365
2020-08-14,Kosovo,XK,193,8,1798506,Europe,10988,373
2020-08-15,Kosovo,XK,142,8,1798506,Europe,11130,381
2020-08-16,Kosovo,XK,145,9,1798506,Europe,11275,390
2020-08-17,Kosovo,XK,141,11,1798506,Europe,11416,401
2020-08-18,Kosovo,XK,129,9,1798506,Europe,11545,410
2020-08-19,Kosovo,XK,141,6,1798506,Europe,11686,416
2020-08-20,Kosovo,XK,162,9,1798506,Europe,11848,425
2020-08-21,Kosovo,XK,158,13,1798506,Europe,12006,438
2020-08-22,Kosovo,XK,162,10,1798506,Europe,12168,448
2020-08-23,Kosovo,XK,169,9,1798506,Europe,12337,457
2020-08-24,Kosovo,XK,111,10,1798506,Europe,12448,467
2020-08-25,Kosovo,XK,99,13,1798506,Europe,12547,480
2020-08-26,Kosovo,XK,136,8,1798506,Europe,12683,488
2020-08-27,Kosovo,XK,157,4,1798506,Europe,12840,492
2020-08-28,Kosovo,XK,141,6,1798506,Europe,12981,498
2020-08-29,Kosovo,XK,119,1,1798506,Europe,13100,499
2020-08-30,Kosovo,XK,115,9,1798506,Europe,13215,508
2020-08-31,Kosovo,XK,119,8,1798506,Europe,13334,516
2020-09-01,Kosovo,XK,120,9,1798506,Europe,13454,525
2020-09-02,Kosovo,XK,147,8,1798506,Europe,13601,533
2020-09-03,Kosovo,XK,112,6,1798506,Europe,13713,539
2020-09-04,Kosovo,XK,78,9,1798506,Europe,13791,548
2020-09-05,Kosovo,XK,119,3,1798506,Europe,13910,551
2020-09-06,Kosovo,XK,117,5,1798506,Europe,14027,556
2020-09-07,Kosovo,XK,92,7,1798506,Europe,14119,563
2020-09-08,Kosovo,XK,85,5,1798506,Europe,14204,568
2020-09-09,Kosovo,XK,97,0,1798506,Europe,14301,568
2020-09-10,Kosovo,XK,76,6,1798506,Europe,14377,574
2020-09-11,Kosovo,XK,69,7,1798506,Europe,14446,581
2020-09-12,Kosovo,XK,50,5,1798506,Europe,14496,586
2020-09-13,Kosovo,XK,70,3,1798506,Europe,14566,589
2020-09-14,Kosovo,XK,71,7,1798506,Europe,14637,596
2020-09-15,Kosovo,XK,55,4,1798506,Europe,14692,600
2020-09-16,Kosovo,XK,71,1,1798506,Europe,14763,601
2020-09-17,Kosovo,XK,76,3,1798506,Europe,14839,604
2020-09-18,Kosovo,XK,43,3,1798506,Europe,14882,607
2020-09-19,Kosovo,XK,57,4,1798506,Europe,14939,611
2020-09-20,Kosovo,XK,63,0,1798506,Europe,15002,611
2020-09-21,Kosovo,XK,61,2,1798506,Europe,15063,613
2020-09-22,Kosovo,XK,79,2,1798506,Europe,15142,615
2020-09-23,Kosovo,XK,66,0,1798506,Europe,15208,615
2020-09-24,Kosovo,XK,62,1,1798506,Europe,15270,616
2020-09-25,Kosovo,XK,63,0,1798506,Europe,15333,616
2020-09-26,Kosovo,XK,46,1,1798506,Europe,15379,617
2020-09-27,Kosovo,XK,46,2,1798506,Europe,15425,619
2020-09-28,Kosovo,XK,47,3,1798506,Europe,15472,622
2020-09-29,Kosovo,XK,48,3,1798506,Europe,15520,625
2020-09-30,Kosovo,XK,54,0,1798506,Europe,15574,625
2020-10-01,Kosovo,XK,46,0,1798506,Europe,15620,625
2020-10-02,Kosovo,XK,43,2,1798506,Europe,15663,627
2020-10-03,Kosovo,XK,40,0,1798506,Europe,15703,627
2020-10-04,Kosovo,XK,55,3,1798506,Europe,15758,630
2020-10-05,Kosovo,XK,56,0,1798506,Europe,15814,630
2020-10-06,Kosovo,XK,0,0,1798506,Europe,15814,630
2020-10-07,Kosovo,XK,75,5,1798506,Europe,15889,635
2020-10-08,Kosovo,XK,49,3,1798506,Europe,15938,638
2020-10-09,Kosovo,XK,33,0,1798506,Europe,15971,638
2020-10-10,Kosovo,XK,79,3,1798506,Europe,16050,641
2020-10-11,Kosovo,XK,80,4,1798506,Europe,16130,645
2020-10-12,Kosovo,XK,49,2,1798506,Europe,16179,647
2020-10-13,Kosovo,XK,68,1,1798506,Europe,16247,648
2020-10-14,Kosovo,XK,98,1,1798506,Europe,16345,649
2020-10-15,Kosovo,XK,80,1,1798506,Europe,16425,650
2020-10-16,Kosovo,XK,77,0,1798506,Europe,16502,650
2020-10-17,Kosovo,XK,104,2,1798506,Europe,16606,652
2020-10-18,Kosovo,XK,148,0,1798506,Europe,16754,652
2020-10-19,Kosovo,XK,137,1,1798506,Europe,16891,653
2020-10-20,Kosovo,XK,118,3,1798506,Europe,17009,656
2020-10-21,Kosovo,XK,130,1,1798506,Europe,17139,657
2020-10-22,Kosovo,XK,124,0,1798506,Europe,17263,657
2020-10-23,Kosovo,XK,159,0,1798506,Europe,17422,657
2020-10-24,Kosovo,XK,169,2,1798506,Europe,17591,659
2020-10-25,Kosovo,XK,166,2,1798506,Europe,17757,661
2020-10-26,Kosovo,XK,186,2,1798506,Europe,17943,663
2020-10-27,Kosovo,XK,205,3,1798506,Europe,18148,666
2020-10-28,Kosovo,XK,197,3,1798506,Europe,18345,669
2020-10-29,Kosovo,XK,281,4,1798506,Europe,18626,673
2020-10-30,Kosovo,XK,284,1,1798506,Europe,18910,674
2020-10-31,Kosovo,XK,418,4,1798506,Europe,19328,678
2020-11-01,Kosovo,XK,514,3,1798506,Europe,19842,681
2020-11-02,Kosovo,XK,337,7,1798506,Europe,20179,688
2020-11-03,Kosovo,XK,476,9,1798506,Europe,20655,697
2020-11-04,Kosovo,XK,344,8,1798506,Europe,20999,705
2020-11-05,Kosovo,XK,546,9,1798506,Europe,21545,714
2020-11-06,Kosovo,XK,661,6,1798506,Europe,22206,720
2020-11-07,Kosovo,XK,728,12,1798506,Europe,22934,732
2020-11-08,Kosovo,XK,491,12,1798506,Europe,23425,744
2020-11-09,Kosovo,XK,730,11,1798506,Europe,24155,755
2020-11-10,Kosovo,XK,637,13,1798506,Europe,24792,768
2020-11-11,Kosovo,XK,596,5,1798506,Europe,25388,773
2020-11-12,Kosovo,XK,733,4,1798506,Europe,26121,777
2020-11-13,Kosovo,XK,767,7,1798506,Europe,26888,784
2020-11-14,Kosovo,XK,963,14,1798506,Europe,27851,798
2020-11-15,Kosovo,XK,765,11,1798506,Europe,28616,809
2020-11-16,Kosovo,XK,501,13,1798506,Europe,29117,822
2020-11-17,Kosovo,XK,688,11,1798506,Europe,29805,833
2020-11-18,Kosovo,XK,690,16,1798506,Europe,30495,849
2020-11-19,Kosovo,XK,720,11,1798506,Europe,31215,860
2020-11-20,Kosovo,XK,807,14,1798506,Europe,32022,874
2020-11-21,Kosovo,XK,855,11,1798506,Europe,32877,885
2020-11-22,Kosovo,XK,711,19,1798506,Europe,33588,904
2020-11-23,Kosovo,XK,707,10,1798506,Europe,34295,914
2020-11-24,Kosovo,XK,645,12,1798506,Europe,34940,926
2020-11-25,Kosovo,XK,609,13,1798506,Europe,35549,939
2020-11-26,Kosovo,XK,704,9,1798506,Europe,36253,948
2020-11-27,Kosovo,XK,775,15,1798506,Europe,37028,963
2020-11-28,Kosovo,XK,764,12,1798506,Europe,37792,975
2020-11-29,Kosovo,XK,639,14,1798506,Europe,38431,989
2020-11-30,Kosovo,XK,626,16,1798506,Europe,39057,1005
2020-12-01,Kosovo,XK,539,11,1798506,Europe,39596,1016
2020-12-02,Kosovo,XK,521,10,1798506,Europe,40117,1026
2020-12-03,Kosovo,XK,555,14,1798506,Europe,40672,1040
2020-12-04,Kosovo,XK,627,22,1798506,Europe,41299,1062
2020-12-05,Kosovo,XK,478,11,1798506,Europe,41777,1073
2020-12-06,Kosovo,XK,560,14,1798506,Europe,42337,1087
2020-12-07,Kosovo,XK,468,19,1798506,Europe,42805,1106
2020-12-08,Kosovo,XK,519,14,1798506,Europe,43324,1120
2020-12-09,Kosovo,XK,557,17,1798506,Europe,43881,1137
2020-12-10,Kosovo,XK,561,11,1798506,Europe,44442,1148
2020-12-11,Kosovo,XK,562,13,1798506,Europe,45004,1161
2020-12-12,Kosovo,XK,590,13,1798506,Europe,45594,1174
2020-12-13,Kosovo,XK,524,12,1798506,Europe,46118,1186
2020-12-14,Kosovo,XK,462,12,1798506,Europe,46580,1198
2020-04-10,Yemen,YE,1,0,29161922,Asia,1,0
2020-04-11,Yemen,YE,0,0,29161922,Asia,1,0
2020-04-12,Yemen,YE,0,0,29161922,Asia,1,0
2020-04-13,Yemen,YE,0,0,29161922,Asia,1,0
2020-04-14,Yemen,YE,0,0,29161922,Asia,1,0
2020-04-15,Yemen,YE,0,0,29161922,Asia,1,0
2020-04-16,Yemen,YE,0,0,29161922,Asia,1,0
2020-04-17,Yemen,YE,0,0,29161922,Asia,1,0
2020-04-18,Yemen,YE,0,0,29161922,Asia,1,0
2020-04-19,Yemen,YE,0,0,29161922,Asia,1,0
2020-04-20,Yemen,YE,0,0,29161922,Asia,1,0
2020-04-21,Yemen,YE,0,0,29161922,Asia,1,0
2020-04-22,Yemen,YE,0,0,29161922,Asia,1,0
2020-04-23,Yemen,YE,0,0,29161922,Asia,1,0
2020-04-24,Yemen,YE,0,0,29161922,Asia,1,0
2020-04-25,Yemen,YE,0,0,29161922,Asia,1,0
2020-04-26,Yemen,YE,0,0,29161922,Asia,1,0
2020-04-27,Yemen,YE,0,0,29161922,Asia,1,0
2020-04-28,Yemen,YE,0,0,29161922,Asia,1,0
2020-04-29,Yemen,YE,0,0,29161922,Asia,1,0
2020-04-30,Yemen,YE,5,0,29161922,Asia,6,0
2020-05-01,Yemen,YE,0,2,29161922,Asia,6,2
2020-05-02,Yemen,YE,1,0,29161922,Asia,7,2
2020-05-03,Yemen,YE,3,0,29161922,Asia,10,2
2020-05-04,Yemen,YE,0,0,29161922,Asia,10,2
2020-05-05,Yemen,YE,2,0,29161922,Asia,12,2
2020-05-06,Yemen,YE,9,1,29161922,Asia,21,3
2020-05-07,Yemen,YE,4,2,29161922,Asia,25,5
2020-05-08,Yemen,YE,1,1,29161922,Asia,26,6
2020-05-09,Yemen,YE,8,1,29161922,Asia,34,7
2020-05-10,Yemen,YE,0,0,29161922,Asia,34,7
2020-05-11,Yemen,YE,17,1,29161922,Asia,51,8
2020-05-12,Yemen,YE,5,1,29161922,Asia,56,9
2020-05-13,Yemen,YE,11,2,29161922,Asia,67,11
2020-05-14,Yemen,YE,3,1,29161922,Asia,70,12
2020-05-15,Yemen,YE,17,1,29161922,Asia,87,13
2020-05-16,Yemen,YE,19,2,29161922,Asia,106,15
2020-05-17,Yemen,YE,18,4,29161922,Asia,124,19
2020-05-18,Yemen,YE,4,1,29161922,Asia,128,20
2020-05-19,Yemen,YE,2,0,29161922,Asia,130,20
2020-05-20,Yemen,YE,37,8,29161922,Asia,167,28
2020-05-21,Yemen,YE,13,1,29161922,Asia,180,29
2020-05-22,Yemen,YE,13,4,29161922,Asia,193,33
2020-05-23,Yemen,YE,12,0,29161922,Asia,205,33
2020-05-24,Yemen,YE,7,6,29161922,Asia,212,39
2020-05-25,Yemen,YE,10,3,29161922,Asia,222,42
2020-05-26,Yemen,YE,15,3,29161922,Asia,237,45
2020-05-27,Yemen,YE,12,4,29161922,Asia,249,49
2020-05-28,Yemen,YE,6,4,29161922,Asia,255,53
2020-05-29,Yemen,YE,23,4,29161922,Asia,278,57
2020-05-30,Yemen,YE,9,9,29161922,Asia,287,66
2020-05-31,Yemen,YE,23,11,29161922,Asia,310,77
2020-06-01,Yemen,YE,13,3,29161922,Asia,323,80
2020-06-02,Yemen,YE,31,4,29161922,Asia,354,84
2020-06-03,Yemen,YE,45,3,29161922,Asia,399,87
2020-06-04,Yemen,YE,4,1,29161922,Asia,403,88
2020-06-05,Yemen,YE,50,15,29161922,Asia,453,103
2020-06-06,Yemen,YE,16,8,29161922,Asia,469,111
2020-06-07,Yemen,YE,4,1,29161922,Asia,473,112
2020-06-08,Yemen,YE,13,0,29161922,Asia,486,112
2020-06-09,Yemen,YE,10,0,29161922,Asia,496,112
2020-06-10,Yemen,YE,28,15,29161922,Asia,524,127
2020-06-11,Yemen,YE,36,2,29161922,Asia,560,129
2020-06-12,Yemen,YE,31,7,29161922,Asia,591,136
2020-06-13,Yemen,YE,41,3,29161922,Asia,632,139
2020-06-14,Yemen,YE,73,21,29161922,Asia,705,160
2020-06-15,Yemen,YE,23,4,29161922,Asia,728,164
2020-06-16,Yemen,YE,116,44,29161922,Asia,844,208
2020-06-17,Yemen,YE,45,7,29161922,Asia,889,215
2020-06-18,Yemen,YE,13,29,29161922,Asia,902,244
2020-06-19,Yemen,YE,4,4,29161922,Asia,906,248
2020-06-20,Yemen,YE,13,3,29161922,Asia,919,251
2020-06-21,Yemen,YE,4,3,29161922,Asia,923,254
2020-06-22,Yemen,YE,18,2,29161922,Asia,941,256
2020-06-23,Yemen,YE,26,1,29161922,Asia,967,257
2020-06-24,Yemen,YE,25,4,29161922,Asia,992,261
2020-06-25,Yemen,YE,23,13,29161922,Asia,1015,274
2020-06-26,Yemen,YE,61,14,29161922,Asia,1076,288
2020-06-27,Yemen,YE,13,5,29161922,Asia,1089,293
2020-06-28,Yemen,YE,14,3,29161922,Asia,1103,296
2020-06-29,Yemen,YE,15,6,29161922,Asia,1118,302
2020-06-30,Yemen,YE,10,2,29161922,Asia,1128,304
2020-07-01,Yemen,YE,30,8,29161922,Asia,1158,312
2020-07-02,Yemen,YE,32,6,29161922,Asia,1190,318
2020-07-03,Yemen,YE,31,7,29161922,Asia,1221,325
2020-07-04,Yemen,YE,19,10,29161922,Asia,1240,335
2020-07-05,Yemen,YE,8,2,29161922,Asia,1248,337
2020-07-06,Yemen,YE,17,1,29161922,Asia,1265,338
2020-07-07,Yemen,YE,25,7,29161922,Asia,1290,345
2020-07-08,Yemen,YE,7,3,29161922,Asia,1297,348
2020-07-09,Yemen,YE,21,3,29161922,Asia,1318,351
2020-07-10,Yemen,YE,38,10,29161922,Asia,1356,361
2020-07-11,Yemen,YE,24,3,29161922,Asia,1380,364
2020-07-12,Yemen,YE,9,1,29161922,Asia,1389,365
2020-07-13,Yemen,YE,76,52,29161922,Asia,1465,417
2020-07-14,Yemen,YE,33,7,29161922,Asia,1498,424
2020-07-15,Yemen,YE,4,6,29161922,Asia,1502,430
2020-07-16,Yemen,YE,24,3,29161922,Asia,1526,433
2020-07-17,Yemen,YE,26,5,29161922,Asia,1552,438
2020-07-18,Yemen,YE,24,2,29161922,Asia,1576,440
2020-07-19,Yemen,YE,5,3,29161922,Asia,1581,443
2020-07-20,Yemen,YE,25,2,29161922,Asia,1606,445
2020-07-21,Yemen,YE,13,2,29161922,Asia,1619,447
2020-07-22,Yemen,YE,10,9,29161922,Asia,1629,456
2020-07-23,Yemen,YE,11,2,29161922,Asia,1640,458
2020-07-24,Yemen,YE,14,3,29161922,Asia,1654,461
2020-07-25,Yemen,YE,0,0,29161922,Asia,1654,461
2020-07-26,Yemen,YE,20,13,29161922,Asia,1674,474
2020-07-27,Yemen,YE,7,5,29161922,Asia,1681,479
2020-07-28,Yemen,YE,10,4,29161922,Asia,1691,483
2020-07-29,Yemen,YE,4,1,29161922,Asia,1695,484
2020-07-30,Yemen,YE,16,1,29161922,Asia,1711,485
2020-07-31,Yemen,YE,15,2,29161922,Asia,1726,487
2020-08-01,Yemen,YE,2,6,29161922,Asia,1728,493
2020-08-02,Yemen,YE,2,1,29161922,Asia,1730,494
2020-08-03,Yemen,YE,4,3,29161922,Asia,1734,497
2020-08-04,Yemen,YE,4,2,29161922,Asia,1738,499
2020-08-05,Yemen,YE,22,7,29161922,Asia,1760,506
2020-08-06,Yemen,YE,4,2,29161922,Asia,1764,508
2020-08-07,Yemen,YE,3,1,29161922,Asia,1767,509
2020-08-08,Yemen,YE,29,3,29161922,Asia,1796,512
2020-08-09,Yemen,YE,4,1,29161922,Asia,1800,513
2020-08-10,Yemen,YE,4,2,29161922,Asia,1804,515
2020-08-11,Yemen,YE,27,3,29161922,Asia,1831,518
2020-08-12,Yemen,YE,0,5,29161922,Asia,1831,523
2020-08-13,Yemen,YE,10,5,29161922,Asia,1841,528
2020-08-14,Yemen,YE,6,0,29161922,Asia,1847,528
2020-08-15,Yemen,YE,11,0,29161922,Asia,1858,528
2020-08-16,Yemen,YE,4,1,29161922,Asia,1862,529
2020-08-17,Yemen,YE,7,1,29161922,Asia,1869,530
2020-08-18,Yemen,YE,13,5,29161922,Asia,1882,535
2020-08-19,Yemen,YE,4,1,29161922,Asia,1886,536
2020-08-20,Yemen,YE,7,3,29161922,Asia,1893,539
2020-08-21,Yemen,YE,6,2,29161922,Asia,1899,541
2020-08-22,Yemen,YE,7,1,29161922,Asia,1906,542
2020-08-23,Yemen,YE,1,4,29161922,Asia,1907,546
2020-08-24,Yemen,YE,4,1,29161922,Asia,1911,547
2020-08-25,Yemen,YE,5,8,29161922,Asia,1916,555
2020-08-26,Yemen,YE,8,2,29161922,Asia,1924,557
2020-08-27,Yemen,YE,6,3,29161922,Asia,1930,560
2020-08-28,Yemen,YE,4,2,29161922,Asia,1934,562
2020-08-29,Yemen,YE,9,1,29161922,Asia,1943,563
2020-08-30,Yemen,YE,4,1,29161922,Asia,1947,564
2020-08-31,Yemen,YE,6,0,29161922,Asia,1953,564
2020-09-01,Yemen,YE,5,2,29161922,Asia,1958,566
2020-09-02,Yemen,YE,4,4,29161922,Asia,1962,570
2020-09-03,Yemen,YE,14,1,29161922,Asia,1976,571
2020-09-04,Yemen,YE,4,1,29161922,Asia,1980,572
2020-09-05,Yemen,YE,3,0,29161922,Asia,1983,572
2020-09-06,Yemen,YE,4,0,29161922,Asia,1987,572
2020-09-07,Yemen,YE,0,0,29161922,Asia,1987,572
2020-09-08,Yemen,YE,4,1,29161922,Asia,1991,573
2020-09-09,Yemen,YE,3,3,29161922,Asia,1994,576
2020-09-10,Yemen,YE,5,1,29161922,Asia,1999,577
2020-09-11,Yemen,YE,4,3,29161922,Asia,2003,580
2020-09-12,Yemen,YE,4,2,29161922,Asia,2007,582
2020-09-13,Yemen,YE,4,1,29161922,Asia,2011,583
2020-09-14,Yemen,YE,2,0,29161922,Asia,2013,583
2020-09-15,Yemen,YE,0,0,29161922,Asia,2013,583
2020-09-16,Yemen,YE,3,0,29161922,Asia,2016,583
2020-09-17,Yemen,YE,4,1,29161922,Asia,2020,584
2020-09-18,Yemen,YE,3,0,29161922,Asia,2023,584
2020-09-19,Yemen,YE,1,1,29161922,Asia,2024,585
2020-09-20,Yemen,YE,4,1,29161922,Asia,2028,586
2020-09-21,Yemen,YE,2,0,29161922,Asia,2030,586
2020-09-22,Yemen,YE,0,1,29161922,Asia,2030,587
2020-09-23,Yemen,YE,2,0,29161922,Asia,2032,587
2020-09-24,Yemen,YE,0,0,29161922,Asia,2032,587
2020-09-25,Yemen,YE,1,0,29161922,Asia,2033,587
2020-09-26,Yemen,YE,0,0,29161922,Asia,2033,587
2020-09-27,Yemen,YE,0,1,29161922,Asia,2033,588
2020-09-28,Yemen,YE,1,0,29161922,Asia,2034,588
2020-09-29,Yemen,YE,1,0,29161922,Asia,2035,588
2020-09-30,Yemen,YE,0,0,29161922,Asia,2035,588
2020-10-01,Yemen,YE,0,0,29161922,Asia,2035,588
2020-10-02,Yemen,YE,3,0,29161922,Asia,2038,588
2020-10-03,Yemen,YE,5,0,29161922,Asia,2043,588
2020-10-04,Yemen,YE,1,2,29161922,Asia,2044,590
2020-10-05,Yemen,YE,1,1,29161922,Asia,2045,591
2020-10-06,Yemen,YE,0,1,29161922,Asia,2045,592
2020-10-07,Yemen,YE,0,1,29161922,Asia,2045,593
2020-10-08,Yemen,YE,8,1,29161922,Asia,2053,594
2020-10-09,Yemen,YE,1,0,29161922,Asia,2054,594
2020-10-10,Yemen,YE,0,0,29161922,Asia,2054,594
2020-10-11,Yemen,YE,1,1,29161922,Asia,2055,595
2020-10-12,Yemen,YE,0,1,29161922,Asia,2055,596
2020-10-13,Yemen,YE,1,0,29161922,Asia,2056,596
2020-10-14,Yemen,YE,0,1,29161922,Asia,2056,597
2020-10-15,Yemen,YE,1,0,29161922,Asia,2057,597
2020-10-16,Yemen,YE,0,0,29161922,Asia,2057,597
2020-10-17,Yemen,YE,0,0,29161922,Asia,2057,597
2020-10-18,Yemen,YE,2,0,29161922,Asia,2059,597
2020-10-19,Yemen,YE,0,0,29161922,Asia,2059,597
2020-10-20,Yemen,YE,1,2,29161922,Asia,2060,599
2020-10-21,Yemen,YE,0,0,29161922,Asia,2060,599
2020-10-22,Yemen,YE,1,0,29161922,Asia,2061,599
2020-10-23,Yemen,YE,0,0,29161922,Asia,2061,599
2020-10-24,Yemen,YE,0,0,29161922,Asia,2061,599
2020-10-25,Yemen,YE,2,0,29161922,Asia,2063,599
2020-10-26,Yemen,YE,0,0,29161922,Asia,2063,599
2020-10-27,Yemen,YE,0,0,29161922,Asia,2063,599
2020-10-28,Yemen,YE,0,0,29161922,Asia,2063,599
2020-10-29,Yemen,YE,0,1,29161922,Asia,2063,600
2020-10-30,Yemen,YE,0,0,29161922,Asia,2063,600
2020-10-31,Yemen,YE,0,0,29161922,Asia,2063,600
2020-11-01,Yemen,YE,0,0,29161922,Asia,2063,600
2020-11-02,Yemen,YE,0,0,29161922,Asia,2063,600
2020-11-03,Yemen,YE,0,0,29161922,Asia,2063,600
2020-11-04,Yemen,YE,0,2,29161922,Asia,2063,602
2020-11-05,Yemen,YE,0,0,29161922,Asia,2063,602
2020-11-06,Yemen,YE,0,0,29161922,Asia,2063,602
2020-11-07,Yemen,YE,0,0,29161922,Asia,2063,602
2020-11-08,Yemen,YE,0,0,29161922,Asia,2063,602
2020-11-09,Yemen,YE,0,0,29161922,Asia,2063,602
2020-11-10,Yemen,YE,0,0,29161922,Asia,2063,602
2020-11-11,Yemen,YE,0,0,29161922,Asia,2063,602
2020-11-12,Yemen,YE,0,0,29161922,Asia,2063,602
2020-11-13,Yemen,YE,5,0,29161922,Asia,2068,602
2020-11-14,Yemen,YE,0,0,29161922,Asia,2068,602
2020-11-15,Yemen,YE,0,0,29161922,Asia,2068,602
2020-11-16,Yemen,YE,0,0,29161922,Asia,2068,602
2020-11-17,Yemen,YE,0,0,29161922,Asia,2068,602
2020-11-18,Yemen,YE,0,0,29161922,Asia,2068,602
2020-11-19,Yemen,YE,0,1,29161922,Asia,2068,603
2020-11-20,Yemen,YE,0,0,29161922,Asia,2068,603
2020-11-21,Yemen,YE,0,0,29161922,Asia,2068,603
2020-11-22,Yemen,YE,1,1,29161922,Asia,2069,604
2020-11-23,Yemen,YE,0,0,29161922,Asia,2069,604
2020-11-24,Yemen,YE,3,0,29161922,Asia,2072,604
2020-11-25,Yemen,YE,0,0,29161922,Asia,2072,604
2020-11-26,Yemen,YE,1,0,29161922,Asia,2073,604
2020-11-27,Yemen,YE,1,0,29161922,Asia,2074,604
2020-11-28,Yemen,YE,0,0,29161922,Asia,2074,604
2020-11-29,Yemen,YE,0,0,29161922,Asia,2074,604
2020-11-30,Yemen,YE,3,1,29161922,Asia,2077,605
2020-12-01,Yemen,YE,0,0,29161922,Asia,2077,605
2020-12-02,Yemen,YE,0,0,29161922,Asia,2077,605
2020-12-03,Yemen,YE,0,0,29161922,Asia,2077,605
2020-12-04,Yemen,YE,0,1,29161922,Asia,2077,606
2020-12-05,Yemen,YE,0,0,29161922,Asia,2077,606
2020-12-06,Yemen,YE,0,0,29161922,Asia,2077,606
2020-12-07,Yemen,YE,0,0,29161922,Asia,2077,606
2020-12-08,Yemen,YE,1,0,29161922,Asia,2078,606
2020-12-09,Yemen,YE,1,0,29161922,Asia,2079,606
2020-12-10,Yemen,YE,0,0,29161922,Asia,2079,606
2020-12-11,Yemen,YE,2,0,29161922,Asia,2081,606
2020-12-12,Yemen,YE,1,0,29161922,Asia,2082,606
2020-12-13,Yemen,YE,1,0,29161922,Asia,2083,606
2020-12-14,Yemen,YE,0,0,29161922,Asia,2083,606
2020-03-06,South_Africa,ZA,1,0,58558267,Africa,1,0
2020-03-08,South_Africa,ZA,1,0,58558267,Africa,2,0
2020-03-09,South_Africa,ZA,1,0,58558267,Africa,3,0
2020-03-10,South_Africa,ZA,4,0,58558267,Africa,7,0
2020-03-12,South_Africa,ZA,6,0,58558267,Africa,13,0
2020-03-13,South_Africa,ZA,4,0,58558267,Africa,17,0
2020-03-14,South_Africa,ZA,7,0,58558267,Africa,24,0
2020-03-15,South_Africa,ZA,0,0,58558267,Africa,24,0
2020-03-16,South_Africa,ZA,27,0,58558267,Africa,51,0
2020-03-17,South_Africa,ZA,11,0,58558267,Africa,62,0
2020-03-18,South_Africa,ZA,23,0,58558267,Africa,85,0
2020-03-19,South_Africa,ZA,31,0,58558267,Africa,116,0
2020-03-20,South_Africa,ZA,34,0,58558267,Africa,150,0
2020-03-21,South_Africa,ZA,55,0,58558267,Africa,205,0
2020-03-22,South_Africa,ZA,35,0,58558267,Africa,240,0
2020-03-23,South_Africa,ZA,34,0,58558267,Africa,274,0
2020-03-24,South_Africa,ZA,128,0,58558267,Africa,402,0
2020-03-25,South_Africa,ZA,155,0,58558267,Africa,557,0
2020-03-26,South_Africa,ZA,152,0,58558267,Africa,709,0
2020-03-27,South_Africa,ZA,218,2,58558267,Africa,927,2
2020-03-28,South_Africa,ZA,243,0,58558267,Africa,1170,2
2020-03-29,South_Africa,ZA,17,0,58558267,Africa,1187,2
2020-03-30,South_Africa,ZA,93,0,58558267,Africa,1280,2
2020-03-31,South_Africa,ZA,46,1,58558267,Africa,1326,3
2020-04-01,South_Africa,ZA,27,2,58558267,Africa,1353,5
2020-04-02,South_Africa,ZA,27,0,58558267,Africa,1380,5
2020-04-03,South_Africa,ZA,82,0,58558267,Africa,1462,5
2020-04-04,South_Africa,ZA,43,2,58558267,Africa,1505,7
2020-04-05,South_Africa,ZA,80,2,58558267,Africa,1585,9
2020-04-06,South_Africa,ZA,70,2,58558267,Africa,1655,11
2020-04-07,South_Africa,ZA,31,1,58558267,Africa,1686,12
2020-04-08,South_Africa,ZA,63,1,58558267,Africa,1749,13
2020-04-09,South_Africa,ZA,96,5,58558267,Africa,1845,18
2020-04-10,South_Africa,ZA,89,0,58558267,Africa,1934,18
2020-04-11,South_Africa,ZA,69,6,58558267,Africa,2003,24
2020-04-12,South_Africa,ZA,25,1,58558267,Africa,2028,25
2020-04-13,South_Africa,ZA,145,0,58558267,Africa,2173,25
2020-04-14,South_Africa,ZA,99,2,58558267,Africa,2272,27
2020-04-15,South_Africa,ZA,143,0,58558267,Africa,2415,27
2020-04-16,South_Africa,ZA,91,7,58558267,Africa,2506,34
2020-04-17,South_Africa,ZA,99,14,58558267,Africa,2605,48
2020-04-18,South_Africa,ZA,178,2,58558267,Africa,2783,50
2020-04-19,South_Africa,ZA,251,2,58558267,Africa,3034,52
2020-04-20,South_Africa,ZA,124,2,58558267,Africa,3158,54
2020-04-21,South_Africa,ZA,142,4,58558267,Africa,3300,58
2020-04-22,South_Africa,ZA,165,0,58558267,Africa,3465,58
2020-04-23,South_Africa,ZA,170,7,58558267,Africa,3635,65
2020-04-24,South_Africa,ZA,318,10,58558267,Africa,3953,75
2020-04-25,South_Africa,ZA,267,4,58558267,Africa,4220,79
2020-04-26,South_Africa,ZA,141,7,58558267,Africa,4361,86
2020-04-27,South_Africa,ZA,185,1,58558267,Africa,4546,87
2020-04-28,South_Africa,ZA,247,3,58558267,Africa,4793,90
2020-04-29,South_Africa,ZA,203,3,58558267,Africa,4996,93
2020-04-30,South_Africa,ZA,354,10,58558267,Africa,5350,103
2020-05-01,South_Africa,ZA,297,0,58558267,Africa,5647,103
2020-05-02,South_Africa,ZA,304,13,58558267,Africa,5951,116
2020-05-03,South_Africa,ZA,385,7,58558267,Africa,6336,123
2020-05-04,South_Africa,ZA,447,8,58558267,Africa,6783,131
2020-05-05,South_Africa,ZA,437,7,58558267,Africa,7220,138
2020-05-06,South_Africa,ZA,352,10,58558267,Africa,7572,148
2020-05-07,South_Africa,ZA,236,5,58558267,Africa,7808,153
2020-05-08,South_Africa,ZA,424,8,58558267,Africa,8232,161
2020-05-09,South_Africa,ZA,663,17,58558267,Africa,8895,178
2020-05-10,South_Africa,ZA,525,8,58558267,Africa,9420,186
2020-05-11,South_Africa,ZA,595,8,58558267,Africa,10015,194
2020-05-12,South_Africa,ZA,637,12,58558267,Africa,10652,206
2020-05-13,South_Africa,ZA,698,0,58558267,Africa,11350,206
2020-05-14,South_Africa,ZA,724,13,58558267,Africa,12074,219
2020-05-15,South_Africa,ZA,665,19,58558267,Africa,12739,238
2020-05-16,South_Africa,ZA,785,9,58558267,Africa,13524,247
2020-05-17,South_Africa,ZA,831,14,58558267,Africa,14355,261
2020-05-18,South_Africa,ZA,1160,3,58558267,Africa,15515,264
2020-05-19,South_Africa,ZA,918,22,58558267,Africa,16433,286
2020-05-20,South_Africa,ZA,767,26,58558267,Africa,17200,312
2020-05-21,South_Africa,ZA,803,27,58558267,Africa,18003,339
2020-05-22,South_Africa,ZA,1134,30,58558267,Africa,19137,369
2020-05-23,South_Africa,ZA,988,28,58558267,Africa,20125,397
2020-05-24,South_Africa,ZA,1218,10,58558267,Africa,21343,407
2020-05-25,South_Africa,ZA,1240,22,58558267,Africa,22583,429
2020-05-26,South_Africa,ZA,1032,52,58558267,Africa,23615,481
2020-05-27,South_Africa,ZA,649,43,58558267,Africa,24264,524
2020-05-28,South_Africa,ZA,1673,28,58558267,Africa,25937,552
2020-05-29,South_Africa,ZA,1466,25,58558267,Africa,27403,577
2020-05-30,South_Africa,ZA,1837,34,58558267,Africa,29240,611
2020-05-31,South_Africa,ZA,1727,32,58558267,Africa,30967,643
2020-06-01,South_Africa,ZA,1716,40,58558267,Africa,32683,683
2020-06-02,South_Africa,ZA,1674,22,58558267,Africa,34357,705
2020-06-03,South_Africa,ZA,1455,50,58558267,Africa,35812,755
2020-06-04,South_Africa,ZA,1713,37,58558267,Africa,37525,792
2020-06-05,South_Africa,ZA,3267,56,58558267,Africa,40792,848
2020-06-06,South_Africa,ZA,2642,60,58558267,Africa,43434,908
2020-06-07,South_Africa,ZA,2539,44,58558267,Africa,45973,952
2020-06-08,South_Africa,ZA,2312,46,58558267,Africa,48285,998
2020-06-09,South_Africa,ZA,2594,82,58558267,Africa,50879,1080
2020-06-10,South_Africa,ZA,2112,82,58558267,Africa,52991,1162
2020-06-11,South_Africa,ZA,2430,48,58558267,Africa,55421,1210
2020-06-12,South_Africa,ZA,3147,79,58558267,Africa,58568,1289
2020-06-13,South_Africa,ZA,3359,65,58558267,Africa,61927,1354
2020-06-14,South_Africa,ZA,3809,69,58558267,Africa,65736,1423
2020-06-15,South_Africa,ZA,4302,57,58558267,Africa,70038,1480
2020-06-16,South_Africa,ZA,3495,88,58558267,Africa,73533,1568
2020-06-17,South_Africa,ZA,2801,57,58558267,Africa,76334,1625
2020-06-18,South_Africa,ZA,4078,49,58558267,Africa,80412,1674
2020-06-19,South_Africa,ZA,3478,63,58558267,Africa,83890,1737
2020-06-20,South_Africa,ZA,3825,94,58558267,Africa,87715,1831
2020-06-21,South_Africa,ZA,4966,46,58558267,Africa,92681,1877
2020-06-22,South_Africa,ZA,4621,53,58558267,Africa,97302,1930
2020-06-23,South_Africa,ZA,4288,61,58558267,Africa,101590,1991
2020-06-24,South_Africa,ZA,4518,111,58558267,Africa,106108,2102
2020-06-25,South_Africa,ZA,5688,103,58558267,Africa,111796,2205
2020-06-26,South_Africa,ZA,6579,87,58558267,Africa,118375,2292
2020-06-27,South_Africa,ZA,6215,48,58558267,Africa,124590,2340
2020-06-28,South_Africa,ZA,7210,73,58558267,Africa,131800,2413
2020-06-29,South_Africa,ZA,6334,43,58558267,Africa,138134,2456
2020-06-30,South_Africa,ZA,6130,73,58558267,Africa,144264,2529
2020-07-01,South_Africa,ZA,6945,128,58558267,Africa,151209,2657
2020-07-02,South_Africa,ZA,8124,92,58558267,Africa,159333,2749
2020-07-03,South_Africa,ZA,8728,95,58558267,Africa,168061,2844
2020-07-04,South_Africa,ZA,9063,108,58558267,Africa,177124,2952
2020-07-05,South_Africa,ZA,10853,74,58558267,Africa,187977,3026
2020-07-06,South_Africa,ZA,8773,173,58558267,Africa,196750,3199
2020-07-07,South_Africa,ZA,8971,111,58558267,Africa,205721,3310
2020-07-08,South_Africa,ZA,10134,192,58558267,Africa,215855,3502
2020-07-09,South_Africa,ZA,8810,100,58558267,Africa,224665,3602
2020-07-10,South_Africa,ZA,13674,118,58558267,Africa,238339,3720
2020-07-11,South_Africa,ZA,12348,140,58558267,Africa,250687,3860
2020-07-12,South_Africa,ZA,13497,111,58558267,Africa,264184,3971
2020-07-13,South_Africa,ZA,12058,108,58558267,Africa,276242,4079
2020-07-14,South_Africa,ZA,11554,93,58558267,Africa,287796,4172
2020-07-15,South_Africa,ZA,10496,174,58558267,Africa,298292,4346
2020-07-16,South_Africa,ZA,12757,107,58558267,Africa,311049,4453
2020-07-17,South_Africa,ZA,13172,216,58558267,Africa,324221,4669
2020-07-18,South_Africa,ZA,13373,135,58558267,Africa,337594,4804
2020-07-19,South_Africa,ZA,13285,144,58558267,Africa,350879,4948
2020-07-20,South_Africa,ZA,13449,85,58558267,Africa,364328,5033
2020-07-21,South_Africa,ZA,9300,140,58558267,Africa,373628,5173
2020-07-22,South_Africa,ZA,8170,195,58558267,Africa,381798,5368
2020-07-23,South_Africa,ZA,13150,572,58558267,Africa,394948,5940
2020-07-24,South_Africa,ZA,13104,153,58558267,Africa,408052,6093
2020-07-25,South_Africa,ZA,13944,250,58558267,Africa,421996,6343
2020-07-26,South_Africa,ZA,12204,312,58558267,Africa,434200,6655
2020-07-27,South_Africa,ZA,11233,114,58558267,Africa,445433,6769
2020-07-28,South_Africa,ZA,7096,298,58558267,Africa,452529,7067
2020-07-29,South_Africa,ZA,7232,190,58558267,Africa,459761,7257
2020-07-30,South_Africa,ZA,11362,240,58558267,Africa,471123,7497
2020-07-31,South_Africa,ZA,11046,315,58558267,Africa,482169,7812
2020-08-01,South_Africa,ZA,11014,193,58558267,Africa,493183,8005
2020-08-02,South_Africa,ZA,10107,148,58558267,Africa,503290,8153
2020-08-03,South_Africa,ZA,8195,213,58558267,Africa,511485,8366
2020-08-04,South_Africa,ZA,5377,173,58558267,Africa,516862,8539
2020-08-05,South_Africa,ZA,4456,345,58558267,Africa,521318,8884
2020-08-06,South_Africa,ZA,8559,414,58558267,Africa,529877,9298
2020-08-07,South_Africa,ZA,8307,306,58558267,Africa,538184,9604
2020-08-08,South_Africa,ZA,7292,305,58558267,Africa,545476,9909
2020-08-09,South_Africa,ZA,7712,301,58558267,Africa,553188,10210
2020-08-10,South_Africa,ZA,6670,198,58558267,Africa,559858,10408
2020-08-11,South_Africa,ZA,3740,213,58558267,Africa,563598,10621
2020-08-12,South_Africa,ZA,2511,130,58558267,Africa,566109,10751
2020-08-13,South_Africa,ZA,2810,259,58558267,Africa,568919,11010
2020-08-14,South_Africa,ZA,3946,260,58558267,Africa,572865,11270
2020-08-15,South_Africa,ZA,6275,286,58558267,Africa,579140,11556
2020-08-16,South_Africa,ZA,4513,121,58558267,Africa,583653,11677
2020-08-17,South_Africa,ZA,3692,162,58558267,Africa,587345,11839
2020-08-18,South_Africa,ZA,2541,143,58558267,Africa,589886,11982
2020-08-19,South_Africa,ZA,2258,282,58558267,Africa,592144,12264
2020-08-20,South_Africa,ZA,3916,159,58558267,Africa,596060,12423
2020-08-21,South_Africa,ZA,3880,195,58558267,Africa,599940,12618
2020-08-22,South_Africa,ZA,3398,225,58558267,Africa,603338,12843
2020-08-23,South_Africa,ZA,3707,144,58558267,Africa,607045,12987
2020-08-24,South_Africa,ZA,2728,72,58558267,Africa,609773,13059
2020-08-25,South_Africa,ZA,1677,100,58558267,Africa,611450,13159
2020-08-26,South_Africa,ZA,1567,149,58558267,Africa,613017,13308
2020-08-27,South_Africa,ZA,2684,194,58558267,Africa,615701,13502
2020-08-28,South_Africa,ZA,2585,126,58558267,Africa,618286,13628
2020-08-29,South_Africa,ZA,1837,115,58558267,Africa,620123,13743
2020-08-30,South_Africa,ZA,2428,238,58558267,Africa,622551,13981
2020-08-31,South_Africa,ZA,2505,47,58558267,Africa,625056,14028
2020-09-01,South_Africa,ZA,1985,121,58558267,Africa,627041,14149
2020-09-02,South_Africa,ZA,1218,114,58558267,Africa,628259,14263
2020-09-03,South_Africa,ZA,2336,126,58558267,Africa,630595,14389
2020-09-04,South_Africa,ZA,2420,174,58558267,Africa,633015,14563
2020-09-05,South_Africa,ZA,2063,115,58558267,Africa,635078,14678
2020-09-06,South_Africa,ZA,1806,101,58558267,Africa,636884,14779
2020-09-07,South_Africa,ZA,1633,110,58558267,Africa,638517,14889
2020-09-08,South_Africa,ZA,845,115,58558267,Africa,639362,15004
2020-09-09,South_Africa,ZA,1079,82,58558267,Africa,640441,15086
2020-09-10,South_Africa,ZA,1990,82,58558267,Africa,642431,15168
2020-09-11,South_Africa,ZA,2007,97,58558267,Africa,644438,15265
2020-09-12,South_Africa,ZA,1960,113,58558267,Africa,646398,15378
2020-09-13,South_Africa,ZA,1816,49,58558267,Africa,648214,15427
2020-09-14,South_Africa,ZA,1579,20,58558267,Africa,649793,15447
2020-09-15,South_Africa,ZA,956,52,58558267,Africa,650749,15499
2020-09-16,South_Africa,ZA,772,142,58558267,Africa,651521,15641
2020-09-17,South_Africa,ZA,1923,64,58558267,Africa,653444,15705
2020-09-18,South_Africa,ZA,2128,67,58558267,Africa,655572,15772
2020-09-19,South_Africa,ZA,2055,85,58558267,Africa,657627,15857
2020-09-20,South_Africa,ZA,2029,83,58558267,Africa,659656,15940
2020-09-21,South_Africa,ZA,1555,13,58558267,Africa,661211,15953
2020-09-22,South_Africa,ZA,725,39,58558267,Africa,661936,15992
2020-09-23,South_Africa,ZA,1346,126,58558267,Africa,663282,16118
2020-09-24,South_Africa,ZA,1906,88,58558267,Africa,665188,16206
2020-09-25,South_Africa,ZA,1861,77,58558267,Africa,667049,16283
2020-09-26,South_Africa,ZA,1480,29,58558267,Africa,668529,16312
2020-09-27,South_Africa,ZA,969,64,58558267,Africa,669498,16376
2020-09-28,South_Africa,ZA,1268,22,58558267,Africa,670766,16398
2020-09-29,South_Africa,ZA,903,188,58558267,Africa,671669,16586
2020-09-30,South_Africa,ZA,903,81,58558267,Africa,672572,16667
2020-10-01,South_Africa,ZA,1767,67,58558267,Africa,674339,16734
2020-10-02,South_Africa,ZA,1745,132,58558267,Africa,676084,16866
2020-10-03,South_Africa,ZA,1749,43,58558267,Africa,677833,16909
2020-10-04,South_Africa,ZA,1883,29,58558267,Africa,679716,16938
2020-10-05,South_Africa,ZA,1573,38,58558267,Africa,681289,16976
2020-10-06,South_Africa,ZA,926,40,58558267,Africa,682215,17016
2020-10-07,South_Africa,ZA,1027,87,58558267,Africa,683242,17103
2020-10-08,South_Africa,ZA,1913,145,58558267,Africa,685155,17248
2020-10-09,South_Africa,ZA,1736,160,58558267,Africa,686891,17408
2020-10-10,South_Africa,ZA,1641,139,58558267,Africa,688532,17547
2020-10-11,South_Africa,ZA,2364,126,58558267,Africa,690896,17673
2020-10-12,South_Africa,ZA,1575,107,58558267,Africa,692471,17780
2020-10-13,South_Africa,ZA,0,0,58558267,Africa,692471,17780
2020-10-14,South_Africa,ZA,2066,248,58558267,Africa,694537,18028
2020-10-15,South_Africa,ZA,1877,123,58558267,Africa,696414,18151
2020-10-16,South_Africa,ZA,1770,158,58558267,Africa,698184,18309
2020-10-17,South_Africa,ZA,2019,61,58558267,Africa,700203,18370
2020-10-18,South_Africa,ZA,1928,38,58558267,Africa,702131,18408
2020-10-19,South_Africa,ZA,1662,63,58558267,Africa,703793,18471
2020-10-20,South_Africa,ZA,1461,21,58558267,Africa,705254,18492
2020-10-21,South_Africa,ZA,1050,164,58558267,Africa,706304,18656
2020-10-22,South_Africa,ZA,2055,85,58558267,Africa,708359,18741
2020-10-23,South_Africa,ZA,2156,102,58558267,Africa,710515,18843
2020-10-24,South_Africa,ZA,1897,48,58558267,Africa,712412,18891
2020-10-25,South_Africa,ZA,1834,53,58558267,Africa,714246,18944
2020-10-26,South_Africa,ZA,1622,24,58558267,Africa,715868,18968
2020-10-27,South_Africa,ZA,891,40,58558267,Africa,716759,19008
2020-10-28,South_Africa,ZA,1092,45,58558267,Africa,717851,19053
2020-10-29,South_Africa,ZA,1863,58,58558267,Africa,719714,19111
2020-10-30,South_Africa,ZA,2056,53,58558267,Africa,721770,19164
2020-10-31,South_Africa,ZA,1912,66,58558267,Africa,723682,19230
2020-11-01,South_Africa,ZA,1770,46,58558267,Africa,725452,19276
2020-11-02,South_Africa,ZA,1371,135,58558267,Africa,726823,19411
2020-11-03,South_Africa,ZA,772,54,58558267,Africa,727595,19465
2020-11-04,South_Africa,ZA,1241,74,58558267,Africa,728836,19539
2020-11-05,South_Africa,ZA,1712,46,58558267,Africa,730548,19585
2020-11-06,South_Africa,ZA,1866,92,58558267,Africa,732414,19677
2020-11-07,South_Africa,ZA,1761,72,58558267,Africa,734175,19749
2020-11-08,South_Africa,ZA,1731,40,58558267,Africa,735906,19789
2020-11-09,South_Africa,ZA,1372,20,58558267,Africa,737278,19809
2020-11-10,South_Africa,ZA,1247,36,58558267,Africa,738525,19845
2020-11-11,South_Africa,ZA,1729,106,58558267,Africa,740254,19951
2020-11-12,South_Africa,ZA,2140,60,58558267,Africa,742394,20011
2020-11-13,South_Africa,ZA,2338,65,58558267,Africa,744732,20076
2020-11-14,South_Africa,ZA,2213,77,58558267,Africa,746945,20153
2020-11-15,South_Africa,ZA,2237,53,58558267,Africa,749182,20206
2020-11-16,South_Africa,ZA,1842,35,58558267,Africa,751024,20241
2020-11-17,South_Africa,ZA,1245,73,58558267,Africa,752269,20314
2020-11-18,South_Africa,ZA,1987,119,58558267,Africa,754256,20433
2020-11-19,South_Africa,ZA,2888,123,58558267,Africa,757144,20556
2020-11-20,South_Africa,ZA,2514,115,58558267,Africa,759658,20671
2020-11-21,South_Africa,ZA,3105,88,58558267,Africa,762763,20759
2020-11-22,South_Africa,ZA,2646,86,58558267,Africa,765409,20845
2020-11-23,South_Africa,ZA,2270,58,58558267,Africa,767679,20903
2020-11-24,South_Africa,ZA,2080,65,58558267,Africa,769759,20968
2020-11-25,South_Africa,ZA,2493,115,58558267,Africa,772252,21083
2020-11-26,South_Africa,ZA,3250,118,58558267,Africa,775502,21201
2020-11-27,South_Africa,ZA,3069,88,58558267,Africa,778571,21289
2020-11-28,South_Africa,ZA,3370,89,58558267,Africa,781941,21378
2020-11-29,South_Africa,ZA,3198,61,58558267,Africa,785139,21439
2020-11-30,South_Africa,ZA,2563,38,58558267,Africa,787702,21477
2020-12-01,South_Africa,ZA,2302,58,58558267,Africa,790004,21535
2020-12-02,South_Africa,ZA,2295,109,58558267,Africa,792299,21644
2020-12-03,South_Africa,ZA,4173,65,58558267,Africa,796472,21709
2020-12-04,South_Africa,ZA,4400,94,58558267,Africa,800872,21803
2020-12-05,South_Africa,ZA,4932,160,58558267,Africa,805804,21963
2020-12-06,South_Africa,ZA,4645,104,58558267,Africa,810449,22067
2020-12-07,South_Africa,ZA,4116,139,58558267,Africa,814565,22206
2020-12-08,South_Africa,ZA,3313,43,58558267,Africa,817878,22249
2020-12-09,South_Africa,ZA,4011,183,58558267,Africa,821889,22432
2020-12-10,South_Africa,ZA,6709,142,58558267,Africa,828598,22574
2020-12-11,South_Africa,ZA,8166,173,58558267,Africa,836764,22747
2020-12-12,South_Africa,ZA,8319,205,58558267,Africa,845083,22952
2020-12-13,South_Africa,ZA,7882,154,58558267,Africa,852965,23106
2020-12-14,South_Africa,ZA,7999,170,58558267,Africa,860964,23276
2020-03-19,Zambia,ZM,2,0,17861034,Africa,2,0
2020-03-20,Zambia,ZM,0,0,17861034,Africa,2,0
2020-03-21,Zambia,ZM,0,0,17861034,Africa,2,0
2020-03-22,Zambia,ZM,0,0,17861034,Africa,2,0
2020-03-23,Zambia,ZM,1,0,17861034,Africa,3,0
2020-03-24,Zambia,ZM,0,0,17861034,Africa,3,0
2020-03-25,Zambia,ZM,0,0,17861034,Africa,3,0
2020-03-26,Zambia,ZM,9,0,17861034,Africa,12,0
2020-03-27,Zambia,ZM,2,0,17861034,Africa,14,0
2020-03-28,Zambia,ZM,2,0,17861034,Africa,16,0
2020-03-29,Zambia,ZM,12,0,17861034,Africa,28,0
2020-03-30,Zambia,ZM,1,0,17861034,Africa,29,0
2020-03-31,Zambia,ZM,6,0,17861034,Africa,35,0
2020-04-01,Zambia,ZM,0,0,17861034,Africa,35,0
2020-04-02,Zambia,ZM,1,0,17861034,Africa,36,0
2020-04-03,Zambia,ZM,3,1,17861034,Africa,39,1
2020-04-04,Zambia,ZM,0,0,17861034,Africa,39,1
2020-04-05,Zambia,ZM,0,0,17861034,Africa,39,1
2020-04-06,Zambia,ZM,0,0,17861034,Africa,39,1
2020-04-07,Zambia,ZM,0,0,17861034,Africa,39,1
2020-04-08,Zambia,ZM,0,0,17861034,Africa,39,1
2020-04-09,Zambia,ZM,0,0,17861034,Africa,39,1
2020-04-10,Zambia,ZM,0,0,17861034,Africa,39,1
2020-04-11,Zambia,ZM,1,1,17861034,Africa,40,2
2020-04-12,Zambia,ZM,0,0,17861034,Africa,40,2
2020-04-13,Zambia,ZM,3,0,17861034,Africa,43,2
2020-04-14,Zambia,ZM,2,0,17861034,Africa,45,2
2020-04-15,Zambia,ZM,0,0,17861034,Africa,45,2
2020-04-16,Zambia,ZM,3,0,17861034,Africa,48,2
2020-04-17,Zambia,ZM,0,0,17861034,Africa,48,2
2020-04-18,Zambia,ZM,4,0,17861034,Africa,52,2
2020-04-19,Zambia,ZM,5,0,17861034,Africa,57,2
2020-04-20,Zambia,ZM,4,1,17861034,Africa,61,3
2020-04-21,Zambia,ZM,4,0,17861034,Africa,65,3
2020-04-22,Zambia,ZM,0,0,17861034,Africa,65,3
2020-04-23,Zambia,ZM,9,0,17861034,Africa,74,3
2020-04-24,Zambia,ZM,2,0,17861034,Africa,76,3
2020-04-25,Zambia,ZM,8,0,17861034,Africa,84,3
2020-04-26,Zambia,ZM,0,0,17861034,Africa,84,3
2020-04-27,Zambia,ZM,4,0,17861034,Africa,88,3
2020-04-28,Zambia,ZM,1,0,17861034,Africa,89,3
2020-04-29,Zambia,ZM,6,0,17861034,Africa,95,3
2020-04-30,Zambia,ZM,2,0,17861034,Africa,97,3
2020-05-01,Zambia,ZM,9,0,17861034,Africa,106,3
2020-05-02,Zambia,ZM,3,0,17861034,Africa,109,3
2020-05-03,Zambia,ZM,10,0,17861034,Africa,119,3
2020-05-04,Zambia,ZM,5,0,17861034,Africa,124,3
2020-05-05,Zambia,ZM,13,0,17861034,Africa,137,3
2020-05-06,Zambia,ZM,2,1,17861034,Africa,139,4
2020-05-07,Zambia,ZM,7,0,17861034,Africa,146,4
2020-05-08,Zambia,ZM,7,0,17861034,Africa,153,4
2020-05-09,Zambia,ZM,14,0,17861034,Africa,167,4
2020-05-10,Zambia,ZM,85,3,17861034,Africa,252,7
2020-05-11,Zambia,ZM,15,0,17861034,Africa,267,7
2020-05-12,Zambia,ZM,0,0,17861034,Africa,267,7
2020-05-13,Zambia,ZM,174,0,17861034,Africa,441,7
2020-05-14,Zambia,ZM,5,0,17861034,Africa,446,7
2020-05-15,Zambia,ZM,208,0,17861034,Africa,654,7
2020-05-16,Zambia,ZM,14,0,17861034,Africa,668,7
2020-05-17,Zambia,ZM,11,0,17861034,Africa,679,7
2020-05-18,Zambia,ZM,74,0,17861034,Africa,753,7
2020-05-19,Zambia,ZM,8,0,17861034,Africa,761,7
2020-05-20,Zambia,ZM,11,0,17861034,Africa,772,7
2020-05-21,Zambia,ZM,60,0,17861034,Africa,832,7
2020-05-22,Zambia,ZM,34,0,17861034,Africa,866,7
2020-05-23,Zambia,ZM,54,0,17861034,Africa,920,7
2020-05-24,Zambia,ZM,0,0,17861034,Africa,920,7
2020-05-25,Zambia,ZM,0,0,17861034,Africa,920,7
2020-05-26,Zambia,ZM,0,0,17861034,Africa,920,7
2020-05-27,Zambia,ZM,0,0,17861034,Africa,920,7
2020-05-28,Zambia,ZM,137,0,17861034,Africa,1057,7
2020-05-29,Zambia,ZM,0,0,17861034,Africa,1057,7
2020-05-30,Zambia,ZM,0,0,17861034,Africa,1057,7
2020-05-31,Zambia,ZM,0,0,17861034,Africa,1057,7
2020-06-01,Zambia,ZM,0,0,17861034,Africa,1057,7
2020-06-02,Zambia,ZM,32,0,17861034,Africa,1089,7
2020-06-03,Zambia,ZM,0,0,17861034,Africa,1089,7
2020-06-04,Zambia,ZM,0,0,17861034,Africa,1089,7
2020-06-05,Zambia,ZM,22,0,17861034,Africa,1111,7
2020-06-06,Zambia,ZM,0,0,17861034,Africa,1111,7
2020-06-07,Zambia,ZM,43,0,17861034,Africa,1154,7
2020-06-08,Zambia,ZM,0,0,17861034,Africa,1154,7
2020-06-09,Zambia,ZM,46,3,17861034,Africa,1200,10
2020-06-10,Zambia,ZM,0,0,17861034,Africa,1200,10
2020-06-11,Zambia,ZM,52,0,17861034,Africa,1252,10
2020-06-12,Zambia,ZM,0,0,17861034,Africa,1252,10
2020-06-13,Zambia,ZM,69,0,17861034,Africa,1321,10
2020-06-14,Zambia,ZM,36,0,17861034,Africa,1357,10
2020-06-15,Zambia,ZM,1,1,17861034,Africa,1358,11
2020-06-16,Zambia,ZM,24,0,17861034,Africa,1382,11
2020-06-17,Zambia,ZM,23,0,17861034,Africa,1405,11
2020-06-18,Zambia,ZM,7,0,17861034,Africa,1412,11
2020-06-19,Zambia,ZM,4,0,17861034,Africa,1416,11
2020-06-20,Zambia,ZM,14,0,17861034,Africa,1430,11
2020-06-21,Zambia,ZM,0,0,17861034,Africa,1430,11
2020-06-22,Zambia,ZM,0,0,17861034,Africa,1430,11
2020-06-23,Zambia,ZM,0,0,17861034,Africa,1430,11
2020-06-24,Zambia,ZM,47,7,17861034,Africa,1477,18
2020-06-25,Zambia,ZM,12,0,17861034,Africa,1489,18
2020-06-26,Zambia,ZM,8,0,17861034,Africa,1497,18
2020-06-27,Zambia,ZM,34,3,17861034,Africa,1531,21
2020-06-28,Zambia,ZM,0,0,17861034,Africa,1531,21
2020-06-29,Zambia,ZM,26,1,17861034,Africa,1557,22
2020-06-30,Zambia,ZM,11,0,17861034,Africa,1568,22
2020-07-01,Zambia,ZM,26,2,17861034,Africa,1594,24
2020-07-02,Zambia,ZM,38,6,17861034,Africa,1632,30
2020-07-03,Zambia,ZM,0,0,17861034,Africa,1632,30
2020-07-04,Zambia,ZM,0,0,17861034,Africa,1632,30
2020-07-05,Zambia,ZM,0,0,17861034,Africa,1632,30
2020-07-06,Zambia,ZM,0,0,17861034,Africa,1632,30
2020-07-07,Zambia,ZM,0,0,17861034,Africa,1632,30
2020-07-08,Zambia,ZM,263,12,17861034,Africa,1895,42
2020-07-09,Zambia,ZM,0,0,17861034,Africa,1895,42
2020-07-10,Zambia,ZM,0,0,17861034,Africa,1895,42
2020-07-11,Zambia,ZM,0,0,17861034,Africa,1895,42
2020-07-12,Zambia,ZM,0,0,17861034,Africa,1895,42
2020-07-13,Zambia,ZM,0,0,17861034,Africa,1895,42
2020-07-14,Zambia,ZM,0,0,17861034,Africa,1895,42
2020-07-15,Zambia,ZM,388,40,17861034,Africa,2283,82
2020-07-16,Zambia,ZM,0,0,17861034,Africa,2283,82
2020-07-17,Zambia,ZM,0,0,17861034,Africa,2283,82
2020-07-18,Zambia,ZM,527,27,17861034,Africa,2810,109
2020-07-19,Zambia,ZM,170,0,17861034,Africa,2980,109
2020-07-20,Zambia,ZM,0,0,17861034,Africa,2980,109
2020-07-21,Zambia,ZM,346,11,17861034,Africa,3326,120
2020-07-22,Zambia,ZM,0,0,17861034,Africa,3326,120
2020-07-23,Zambia,ZM,257,8,17861034,Africa,3583,128
2020-07-24,Zambia,ZM,0,0,17861034,Africa,3583,128
2020-07-25,Zambia,ZM,273,2,17861034,Africa,3856,130
2020-07-26,Zambia,ZM,472,0,17861034,Africa,4328,130
2020-07-27,Zambia,ZM,153,9,17861034,Africa,4481,139
2020-07-28,Zambia,ZM,71,1,17861034,Africa,4552,140
2020-07-29,Zambia,ZM,450,2,17861034,Africa,5002,142
2020-07-30,Zambia,ZM,247,4,17861034,Africa,5249,146
2020-07-31,Zambia,ZM,306,3,17861034,Africa,5555,149
2020-08-01,Zambia,ZM,408,2,17861034,Africa,5963,151
2020-08-02,Zambia,ZM,265,14,17861034,Africa,6228,165
2020-08-03,Zambia,ZM,119,5,17861034,Africa,6347,170
2020-08-04,Zambia,ZM,233,1,17861034,Africa,6580,171
2020-08-05,Zambia,ZM,0,0,17861034,Africa,6580,171
2020-08-06,Zambia,ZM,442,5,17861034,Africa,7022,176
2020-08-07,Zambia,ZM,142,23,17861034,Africa,7164,199
2020-08-08,Zambia,ZM,322,1,17861034,Africa,7486,200
2020-08-09,Zambia,ZM,417,3,17861034,Africa,7903,203
2020-08-10,Zambia,ZM,182,32,17861034,Africa,8085,235
2020-08-11,Zambia,ZM,125,6,17861034,Africa,8210,241
2020-08-12,Zambia,ZM,65,0,17861034,Africa,8275,241
2020-08-13,Zambia,ZM,226,5,17861034,Africa,8501,246
2020-08-14,Zambia,ZM,162,0,17861034,Africa,8663,246
2020-08-15,Zambia,ZM,358,10,17861034,Africa,9021,256
2020-08-16,Zambia,ZM,165,4,17861034,Africa,9186,260
2020-08-17,Zambia,ZM,157,0,17861034,Africa,9343,260
2020-08-18,Zambia,ZM,496,4,17861034,Africa,9839,264
2020-08-19,Zambia,ZM,142,0,17861034,Africa,9981,264
2020-08-20,Zambia,ZM,237,5,17861034,Africa,10218,269
2020-08-21,Zambia,ZM,154,5,17861034,Africa,10372,274
2020-08-22,Zambia,ZM,255,3,17861034,Africa,10627,277
2020-08-23,Zambia,ZM,0,0,17861034,Africa,10627,277
2020-08-24,Zambia,ZM,455,3,17861034,Africa,11082,280
2020-08-25,Zambia,ZM,66,0,17861034,Africa,11148,280
2020-08-26,Zambia,ZM,137,2,17861034,Africa,11285,282
2020-08-27,Zambia,ZM,91,0,17861034,Africa,11376,282
2020-08-28,Zambia,ZM,225,0,17861034,Africa,11601,282
2020-08-29,Zambia,ZM,178,1,17861034,Africa,11779,283
2020-08-30,Zambia,ZM,123,1,17861034,Africa,11902,284
2020-08-31,Zambia,ZM,123,3,17861034,Africa,12025,287
2020-09-01,Zambia,ZM,72,1,17861034,Africa,12097,288
2020-09-02,Zambia,ZM,284,2,17861034,Africa,12381,290
2020-09-03,Zambia,ZM,34,2,17861034,Africa,12415,292
2020-09-04,Zambia,ZM,108,0,17861034,Africa,12523,292
2020-09-05,Zambia,ZM,116,0,17861034,Africa,12639,292
2020-09-06,Zambia,ZM,70,0,17861034,Africa,12709,292
2020-09-07,Zambia,ZM,67,3,17861034,Africa,12776,295
2020-09-08,Zambia,ZM,60,0,17861034,Africa,12836,295
2020-09-09,Zambia,ZM,116,1,17861034,Africa,12952,296
2020-09-10,Zambia,ZM,160,4,17861034,Africa,13112,300
2020-09-11,Zambia,ZM,102,0,17861034,Africa,13214,300
2020-09-12,Zambia,ZM,109,6,17861034,Africa,13323,306
2020-09-13,Zambia,ZM,143,6,17861034,Africa,13466,312
2020-09-14,Zambia,ZM,73,0,17861034,Africa,13539,312
2020-09-15,Zambia,ZM,181,8,17861034,Africa,13720,320
2020-09-16,Zambia,ZM,99,4,17861034,Africa,13819,324
2020-09-17,Zambia,ZM,68,2,17861034,Africa,13887,326
2020-09-18,Zambia,ZM,41,0,17861034,Africa,13928,326
2020-09-19,Zambia,ZM,94,3,17861034,Africa,14022,329
2020-09-20,Zambia,ZM,2,0,17861034,Africa,14024,329
2020-09-21,Zambia,ZM,107,1,17861034,Africa,14131,330
2020-09-22,Zambia,ZM,44,1,17861034,Africa,14175,331
2020-09-23,Zambia,ZM,214,0,17861034,Africa,14389,331
2020-09-24,Zambia,ZM,54,1,17861034,Africa,14443,332
2020-09-25,Zambia,ZM,48,0,17861034,Africa,14491,332
2020-09-26,Zambia,ZM,24,0,17861034,Africa,14515,332
2020-09-27,Zambia,ZM,97,0,17861034,Africa,14612,332
2020-09-28,Zambia,ZM,29,0,17861034,Africa,14641,332
2020-09-29,Zambia,ZM,19,0,17861034,Africa,14660,332
2020-09-30,Zambia,ZM,55,0,17861034,Africa,14715,332
2020-10-01,Zambia,ZM,44,0,17861034,Africa,14759,332
2020-10-02,Zambia,ZM,43,1,17861034,Africa,14802,333
2020-10-03,Zambia,ZM,28,0,17861034,Africa,14830,333
2020-10-04,Zambia,ZM,144,0,17861034,Africa,14974,333
2020-10-05,Zambia,ZM,78,0,17861034,Africa,15052,333
2020-10-06,Zambia,ZM,37,0,17861034,Africa,15089,333
2020-10-07,Zambia,ZM,81,1,17861034,Africa,15170,334
2020-10-08,Zambia,ZM,54,0,17861034,Africa,15224,334
2020-10-09,Zambia,ZM,0,0,17861034,Africa,15224,334
2020-10-10,Zambia,ZM,77,1,17861034,Africa,15301,335
2020-10-11,Zambia,ZM,38,1,17861034,Africa,15339,336
2020-10-12,Zambia,ZM,119,0,17861034,Africa,15458,336
2020-10-13,Zambia,ZM,91,9,17861034,Africa,15549,345
2020-10-14,Zambia,ZM,38,0,17861034,Africa,15587,345
2020-10-15,Zambia,ZM,29,0,17861034,Africa,15616,345
2020-10-16,Zambia,ZM,43,1,17861034,Africa,15659,346
2020-10-17,Zambia,ZM,0,0,17861034,Africa,15659,346
2020-10-18,Zambia,ZM,130,0,17861034,Africa,15789,346
2020-10-19,Zambia,ZM,64,0,17861034,Africa,15853,346
2020-10-20,Zambia,ZM,44,0,17861034,Africa,15897,346
2020-10-21,Zambia,ZM,85,0,17861034,Africa,15982,346
2020-10-22,Zambia,ZM,18,0,17861034,Africa,16000,346
2020-10-23,Zambia,ZM,35,0,17861034,Africa,16035,346
2020-10-24,Zambia,ZM,60,0,17861034,Africa,16095,346
2020-10-25,Zambia,ZM,22,2,17861034,Africa,16117,348
2020-10-26,Zambia,ZM,0,0,17861034,Africa,16117,348
2020-10-27,Zambia,ZM,83,0,17861034,Africa,16200,348
2020-10-28,Zambia,ZM,43,0,17861034,Africa,16243,348
2020-10-29,Zambia,ZM,82,0,17861034,Africa,16325,348
2020-10-30,Zambia,ZM,0,0,17861034,Africa,16325,348
2020-10-31,Zambia,ZM,90,1,17861034,Africa,16415,349
2020-11-01,Zambia,ZM,17,0,17861034,Africa,16432,349
2020-11-02,Zambia,ZM,48,0,17861034,Africa,16480,349
2020-11-03,Zambia,ZM,63,0,17861034,Africa,16543,349
2020-11-04,Zambia,ZM,118,0,17861034,Africa,16661,349
2020-11-05,Zambia,ZM,37,0,17861034,Africa,16698,349
2020-11-06,Zambia,ZM,72,0,17861034,Africa,16770,349
2020-11-07,Zambia,ZM,49,0,17861034,Africa,16819,349
2020-11-08,Zambia,ZM,89,0,17861034,Africa,16908,349
2020-11-09,Zambia,ZM,46,0,17861034,Africa,16954,349
2020-11-10,Zambia,ZM,17,0,17861034,Africa,16971,349
2020-11-11,Zambia,ZM,26,1,17861034,Africa,16997,350
2020-11-12,Zambia,ZM,39,0,17861034,Africa,17036,350
2020-11-13,Zambia,ZM,0,0,17861034,Africa,17036,350
2020-11-14,Zambia,ZM,57,0,17861034,Africa,17093,350
2020-11-15,Zambia,ZM,4,0,17861034,Africa,17097,350
2020-11-16,Zambia,ZM,26,3,17861034,Africa,17123,353
2020-11-17,Zambia,ZM,64,0,17861034,Africa,17187,353
2020-11-18,Zambia,ZM,56,0,17861034,Africa,17243,353
2020-11-19,Zambia,ZM,37,3,17861034,Africa,17280,356
2020-11-20,Zambia,ZM,70,0,17861034,Africa,17350,356
2020-11-21,Zambia,ZM,23,0,17861034,Africa,17373,356
2020-11-22,Zambia,ZM,21,0,17861034,Africa,17394,356
2020-11-23,Zambia,ZM,30,1,17861034,Africa,17424,357
2020-11-24,Zambia,ZM,30,0,17861034,Africa,17454,357
2020-11-25,Zambia,ZM,12,0,17861034,Africa,17466,357
2020-11-26,Zambia,ZM,69,0,17861034,Africa,17535,357
2020-11-27,Zambia,ZM,18,0,17861034,Africa,17553,357
2020-11-28,Zambia,ZM,16,0,17861034,Africa,17569,357
2020-11-29,Zambia,ZM,20,0,17861034,Africa,17589,357
2020-11-30,Zambia,ZM,19,0,17861034,Africa,17608,357
2020-12-01,Zambia,ZM,39,0,17861034,Africa,17647,357
2020-12-02,Zambia,ZM,18,0,17861034,Africa,17665,357
2020-12-03,Zambia,ZM,35,0,17861034,Africa,17700,357
2020-12-04,Zambia,ZM,30,0,17861034,Africa,17730,357
2020-12-05,Zambia,ZM,127,7,17861034,Africa,17857,364
2020-12-06,Zambia,ZM,41,0,17861034,Africa,17898,364
2020-12-07,Zambia,ZM,18,0,17861034,Africa,17916,364
2020-12-08,Zambia,ZM,15,0,17861034,Africa,17931,364
2020-12-09,Zambia,ZM,32,0,17861034,Africa,17963,364
2020-12-10,Zambia,ZM,99,0,17861034,Africa,18062,364
2020-12-11,Zambia,ZM,29,0,17861034,Africa,18091,364
2020-12-12,Zambia,ZM,70,1,17861034,Africa,18161,365
2020-12-13,Zambia,ZM,56,1,17861034,Africa,18217,366
2020-12-14,Zambia,ZM,57,1,17861034,Africa,18274,367
2020-03-21,Zimbabwe,ZW,1,0,14645473,Africa,1,0
2020-03-22,Zimbabwe,ZW,1,0,14645473,Africa,2,0
2020-03-23,Zimbabwe,ZW,0,0,14645473,Africa,2,0
2020-03-24,Zimbabwe,ZW,0,1,14645473,Africa,2,1
2020-03-25,Zimbabwe,ZW,0,0,14645473,Africa,2,1
2020-03-26,Zimbabwe,ZW,1,0,14645473,Africa,3,1
2020-03-27,Zimbabwe,ZW,0,0,14645473,Africa,3,1
2020-03-28,Zimbabwe,ZW,2,0,14645473,Africa,5,1
2020-03-29,Zimbabwe,ZW,2,0,14645473,Africa,7,1
2020-03-30,Zimbabwe,ZW,0,0,14645473,Africa,7,1
2020-03-31,Zimbabwe,ZW,0,0,14645473,Africa,7,1
2020-04-01,Zimbabwe,ZW,1,0,14645473,Africa,8,1
2020-04-02,Zimbabwe,ZW,0,0,14645473,Africa,8,1
2020-04-03,Zimbabwe,ZW,0,0,14645473,Africa,8,1
2020-04-04,Zimbabwe,ZW,1,0,14645473,Africa,9,1
2020-04-05,Zimbabwe,ZW,0,0,14645473,Africa,9,1
2020-04-06,Zimbabwe,ZW,0,0,14645473,Africa,9,1
2020-04-07,Zimbabwe,ZW,0,0,14645473,Africa,9,1
2020-04-08,Zimbabwe,ZW,1,0,14645473,Africa,10,1
2020-04-09,Zimbabwe,ZW,1,1,14645473,Africa,11,2
2020-04-10,Zimbabwe,ZW,0,1,14645473,Africa,11,3
2020-04-11,Zimbabwe,ZW,0,0,14645473,Africa,11,3
2020-04-12,Zimbabwe,ZW,3,0,14645473,Africa,14,3
2020-04-13,Zimbabwe,ZW,0,0,14645473,Africa,14,3
2020-04-14,Zimbabwe,ZW,3,0,14645473,Africa,17,3
2020-04-15,Zimbabwe,ZW,0,0,14645473,Africa,17,3
2020-04-16,Zimbabwe,ZW,6,0,14645473,Africa,23,3
2020-04-17,Zimbabwe,ZW,1,0,14645473,Africa,24,3
2020-04-18,Zimbabwe,ZW,0,0,14645473,Africa,24,3
2020-04-19,Zimbabwe,ZW,1,0,14645473,Africa,25,3
2020-04-20,Zimbabwe,ZW,0,0,14645473,Africa,25,3
2020-04-21,Zimbabwe,ZW,0,0,14645473,Africa,25,3
2020-04-22,Zimbabwe,ZW,3,0,14645473,Africa,28,3
2020-04-23,Zimbabwe,ZW,0,0,14645473,Africa,28,3
2020-04-24,Zimbabwe,ZW,1,0,14645473,Africa,29,3
2020-04-25,Zimbabwe,ZW,0,1,14645473,Africa,29,4
2020-04-26,Zimbabwe,ZW,2,0,14645473,Africa,31,4
2020-04-27,Zimbabwe,ZW,0,0,14645473,Africa,31,4
2020-04-28,Zimbabwe,ZW,1,0,14645473,Africa,32,4
2020-04-29,Zimbabwe,ZW,0,0,14645473,Africa,32,4
2020-04-30,Zimbabwe,ZW,2,0,14645473,Africa,34,4
2020-05-01,Zimbabwe,ZW,0,0,14645473,Africa,34,4
2020-05-02,Zimbabwe,ZW,0,0,14645473,Africa,34,4
2020-05-03,Zimbabwe,ZW,0,0,14645473,Africa,34,4
2020-05-04,Zimbabwe,ZW,0,0,14645473,Africa,34,4
2020-05-05,Zimbabwe,ZW,0,0,14645473,Africa,34,4
2020-05-06,Zimbabwe,ZW,0,0,14645473,Africa,34,4
2020-05-07,Zimbabwe,ZW,0,0,14645473,Africa,34,4
2020-05-08,Zimbabwe,ZW,0,0,14645473,Africa,34,4
2020-05-09,Zimbabwe,ZW,1,0,14645473,Africa,35,4
2020-05-10,Zimbabwe,ZW,1,0,14645473,Africa,36,4
2020-05-11,Zimbabwe,ZW,0,0,14645473,Africa,36,4
2020-05-12,Zimbabwe,ZW,1,0,14645473,Africa,37,4
2020-05-13,Zimbabwe,ZW,0,0,14645473,Africa,37,4
2020-05-14,Zimbabwe,ZW,0,0,14645473,Africa,37,4
2020-05-15,Zimbabwe,ZW,0,0,14645473,Africa,37,4
2020-05-16,Zimbabwe,ZW,5,0,14645473,Africa,42,4
2020-05-17,Zimbabwe,ZW,2,0,14645473,Africa,44,4
2020-05-18,Zimbabwe,ZW,2,0,14645473,Africa,46,4
2020-05-19,Zimbabwe,ZW,0,0,14645473,Africa,46,4
2020-05-20,Zimbabwe,ZW,0,0,14645473,Africa,46,4
2020-05-21,Zimbabwe,ZW,2,0,14645473,Africa,48,4
2020-05-22,Zimbabwe,ZW,3,0,14645473,Africa,51,4
2020-05-23,Zimbabwe,ZW,5,0,14645473,Africa,56,4
2020-05-24,Zimbabwe,ZW,0,0,14645473,Africa,56,4
2020-05-25,Zimbabwe,ZW,0,0,14645473,Africa,56,4
2020-05-26,Zimbabwe,ZW,0,0,14645473,Africa,56,4
2020-05-27,Zimbabwe,ZW,0,0,14645473,Africa,56,4
2020-05-28,Zimbabwe,ZW,76,0,14645473,Africa,132,4
2020-05-29,Zimbabwe,ZW,17,0,14645473,Africa,149,4
2020-05-30,Zimbabwe,ZW,11,0,14645473,Africa,160,4
2020-05-31,Zimbabwe,ZW,14,0,14645473,Africa,174,4
2020-06-01,Zimbabwe,ZW,4,0,14645473,Africa,178,4
2020-06-02,Zimbabwe,ZW,25,0,14645473,Africa,203,4
2020-06-03,Zimbabwe,ZW,3,0,14645473,Africa,206,4
2020-06-04,Zimbabwe,ZW,16,0,14645473,Africa,222,4
2020-06-05,Zimbabwe,ZW,15,0,14645473,Africa,237,4
2020-06-06,Zimbabwe,ZW,28,0,14645473,Africa,265,4
2020-06-07,Zimbabwe,ZW,14,0,14645473,Africa,279,4
2020-06-08,Zimbabwe,ZW,3,0,14645473,Africa,282,4
2020-06-09,Zimbabwe,ZW,5,0,14645473,Africa,287,4
2020-06-10,Zimbabwe,ZW,27,0,14645473,Africa,314,4
2020-06-11,Zimbabwe,ZW,6,0,14645473,Africa,320,4
2020-06-12,Zimbabwe,ZW,12,0,14645473,Africa,332,4
2020-06-13,Zimbabwe,ZW,11,0,14645473,Africa,343,4
2020-06-14,Zimbabwe,ZW,13,0,14645473,Africa,356,4
2020-06-15,Zimbabwe,ZW,27,0,14645473,Africa,383,4
2020-06-16,Zimbabwe,ZW,4,0,14645473,Africa,387,4
2020-06-17,Zimbabwe,ZW,7,0,14645473,Africa,394,4
2020-06-18,Zimbabwe,ZW,7,0,14645473,Africa,401,4
2020-06-19,Zimbabwe,ZW,62,0,14645473,Africa,463,4
2020-06-20,Zimbabwe,ZW,16,0,14645473,Africa,479,4
2020-06-21,Zimbabwe,ZW,7,2,14645473,Africa,486,6
2020-06-22,Zimbabwe,ZW,3,0,14645473,Africa,489,6
2020-06-23,Zimbabwe,ZW,23,0,14645473,Africa,512,6
2020-06-24,Zimbabwe,ZW,13,0,14645473,Africa,525,6
2020-06-25,Zimbabwe,ZW,5,0,14645473,Africa,530,6
2020-06-26,Zimbabwe,ZW,21,0,14645473,Africa,551,6
2020-06-27,Zimbabwe,ZW,10,0,14645473,Africa,561,6
2020-06-28,Zimbabwe,ZW,6,0,14645473,Africa,567,6
2020-06-29,Zimbabwe,ZW,0,0,14645473,Africa,567,6
2020-06-30,Zimbabwe,ZW,7,1,14645473,Africa,574,7
2020-07-01,Zimbabwe,ZW,17,0,14645473,Africa,591,7
2020-07-02,Zimbabwe,ZW,14,0,14645473,Africa,605,7
2020-07-03,Zimbabwe,ZW,12,0,14645473,Africa,617,7
2020-07-04,Zimbabwe,ZW,8,0,14645473,Africa,625,7
2020-07-05,Zimbabwe,ZW,73,1,14645473,Africa,698,8
2020-07-06,Zimbabwe,ZW,18,0,14645473,Africa,716,8
2020-07-07,Zimbabwe,ZW,18,1,14645473,Africa,734,9
2020-07-08,Zimbabwe,ZW,53,0,14645473,Africa,787,9
2020-07-09,Zimbabwe,ZW,98,0,14645473,Africa,885,9
2020-07-10,Zimbabwe,ZW,41,3,14645473,Africa,926,12
2020-07-11,Zimbabwe,ZW,16,1,14645473,Africa,942,13
2020-07-12,Zimbabwe,ZW,40,5,14645473,Africa,982,18
2020-07-13,Zimbabwe,ZW,3,0,14645473,Africa,985,18
2020-07-14,Zimbabwe,ZW,49,1,14645473,Africa,1034,19
2020-07-15,Zimbabwe,ZW,0,0,14645473,Africa,1034,19
2020-07-16,Zimbabwe,ZW,55,1,14645473,Africa,1089,20
2020-07-17,Zimbabwe,ZW,273,3,14645473,Africa,1362,23
2020-07-18,Zimbabwe,ZW,58,1,14645473,Africa,1420,24
2020-07-19,Zimbabwe,ZW,58,1,14645473,Africa,1478,25
2020-07-20,Zimbabwe,ZW,133,0,14645473,Africa,1611,25
2020-07-21,Zimbabwe,ZW,102,1,14645473,Africa,1713,26
2020-07-22,Zimbabwe,ZW,107,0,14645473,Africa,1820,26
2020-07-23,Zimbabwe,ZW,214,0,14645473,Africa,2034,26
2020-07-24,Zimbabwe,ZW,90,2,14645473,Africa,2124,28
2020-07-25,Zimbabwe,ZW,172,4,14645473,Africa,2296,32
2020-07-26,Zimbabwe,ZW,138,2,14645473,Africa,2434,34
2020-07-27,Zimbabwe,ZW,78,0,14645473,Africa,2512,34
2020-07-28,Zimbabwe,ZW,192,2,14645473,Africa,2704,36
2020-07-29,Zimbabwe,ZW,113,4,14645473,Africa,2817,40
2020-07-30,Zimbabwe,ZW,62,1,14645473,Africa,2879,41
2020-07-31,Zimbabwe,ZW,213,12,14645473,Africa,3092,53
2020-08-01,Zimbabwe,ZW,77,14,14645473,Africa,3169,67
2020-08-02,Zimbabwe,ZW,490,2,14645473,Africa,3659,69
2020-08-03,Zimbabwe,ZW,262,1,14645473,Africa,3921,70
2020-08-04,Zimbabwe,ZW,154,10,14645473,Africa,4075,80
2020-08-05,Zimbabwe,ZW,146,1,14645473,Africa,4221,81
2020-08-06,Zimbabwe,ZW,118,3,14645473,Africa,4339,84
2020-08-07,Zimbabwe,ZW,56,13,14645473,Africa,4395,97
2020-08-08,Zimbabwe,ZW,56,5,14645473,Africa,4451,102
2020-08-09,Zimbabwe,ZW,124,0,14645473,Africa,4575,102
2020-08-10,Zimbabwe,ZW,74,2,14645473,Africa,4649,104
2020-08-11,Zimbabwe,ZW,99,0,14645473,Africa,4748,104
2020-08-12,Zimbabwe,ZW,70,0,14645473,Africa,4818,104
2020-08-13,Zimbabwe,ZW,75,18,14645473,Africa,4893,122
2020-08-14,Zimbabwe,ZW,97,6,14645473,Africa,4990,128
2020-08-15,Zimbabwe,ZW,82,0,14645473,Africa,5072,128
2020-08-16,Zimbabwe,ZW,104,2,14645473,Africa,5176,130
2020-08-17,Zimbabwe,ZW,85,2,14645473,Africa,5261,132
2020-08-18,Zimbabwe,ZW,47,3,14645473,Africa,5308,135
2020-08-19,Zimbabwe,ZW,70,6,14645473,Africa,5378,141
2020-08-20,Zimbabwe,ZW,265,9,14645473,Africa,5643,150
2020-08-21,Zimbabwe,ZW,102,1,14645473,Africa,5745,151
2020-08-22,Zimbabwe,ZW,70,1,14645473,Africa,5815,152
2020-08-23,Zimbabwe,ZW,78,1,14645473,Africa,5893,153
2020-08-24,Zimbabwe,ZW,37,2,14645473,Africa,5930,155
2020-08-25,Zimbabwe,ZW,140,0,14645473,Africa,6070,155
2020-08-26,Zimbabwe,ZW,126,11,14645473,Africa,6196,166
2020-08-27,Zimbabwe,ZW,55,13,14645473,Africa,6251,179
2020-08-28,Zimbabwe,ZW,41,10,14645473,Africa,6292,189
2020-08-29,Zimbabwe,ZW,96,6,14645473,Africa,6388,195
2020-08-30,Zimbabwe,ZW,18,1,14645473,Africa,6406,196
2020-08-31,Zimbabwe,ZW,6,0,14645473,Africa,6412,196
2020-09-01,Zimbabwe,ZW,85,6,14645473,Africa,6497,202
2020-09-02,Zimbabwe,ZW,62,1,14645473,Africa,6559,203
2020-09-03,Zimbabwe,ZW,79,3,14645473,Africa,6638,206
2020-09-04,Zimbabwe,ZW,40,0,14645473,Africa,6678,206
2020-09-05,Zimbabwe,ZW,159,0,14645473,Africa,6837,206
2020-09-06,Zimbabwe,ZW,0,0,14645473,Africa,6837,206
2020-09-07,Zimbabwe,ZW,140,1,14645473,Africa,6977,207
2020-09-08,Zimbabwe,ZW,321,3,14645473,Africa,7298,210
2020-09-09,Zimbabwe,ZW,90,8,14645473,Africa,7388,218
2020-09-10,Zimbabwe,ZW,41,4,14645473,Africa,7429,222
2020-09-11,Zimbabwe,ZW,24,0,14645473,Africa,7453,222
2020-09-12,Zimbabwe,ZW,26,2,14645473,Africa,7479,224
2020-09-13,Zimbabwe,ZW,29,0,14645473,Africa,7508,224
2020-09-14,Zimbabwe,ZW,18,0,14645473,Africa,7526,224
2020-09-15,Zimbabwe,ZW,5,0,14645473,Africa,7531,224
2020-09-16,Zimbabwe,ZW,45,0,14645473,Africa,7576,224
2020-09-17,Zimbabwe,ZW,22,0,14645473,Africa,7598,224
2020-09-18,Zimbabwe,ZW,35,0,14645473,Africa,7633,224
2020-09-19,Zimbabwe,ZW,14,0,14645473,Africa,7647,224
2020-09-20,Zimbabwe,ZW,25,1,14645473,Africa,7672,225
2020-09-21,Zimbabwe,ZW,11,0,14645473,Africa,7683,225
2020-09-22,Zimbabwe,ZW,23,1,14645473,Africa,7706,226
2020-09-23,Zimbabwe,ZW,5,0,14645473,Africa,7711,226
2020-09-24,Zimbabwe,ZW,14,1,14645473,Africa,7725,227
2020-09-25,Zimbabwe,ZW,27,0,14645473,Africa,7752,227
2020-09-26,Zimbabwe,ZW,35,0,14645473,Africa,7787,227
2020-09-27,Zimbabwe,ZW,16,0,14645473,Africa,7803,227
2020-09-28,Zimbabwe,ZW,9,0,14645473,Africa,7812,227
2020-09-29,Zimbabwe,ZW,4,1,14645473,Africa,7816,228
2020-09-30,Zimbabwe,ZW,21,0,14645473,Africa,7837,228
2020-10-01,Zimbabwe,ZW,1,0,14645473,Africa,7838,228
2020-10-02,Zimbabwe,ZW,12,0,14645473,Africa,7850,228
2020-10-03,Zimbabwe,ZW,8,0,14645473,Africa,7858,228
2020-10-04,Zimbabwe,ZW,27,0,14645473,Africa,7885,228
2020-10-05,Zimbabwe,ZW,0,0,14645473,Africa,7885,228
2020-10-06,Zimbabwe,ZW,13,0,14645473,Africa,7898,228
2020-10-07,Zimbabwe,ZW,17,1,14645473,Africa,7915,229
2020-10-08,Zimbabwe,ZW,4,0,14645473,Africa,7919,229
2020-10-09,Zimbabwe,ZW,32,0,14645473,Africa,7951,229
2020-10-10,Zimbabwe,ZW,43,0,14645473,Africa,7994,229
2020-10-11,Zimbabwe,ZW,16,1,14645473,Africa,8010,230
2020-10-12,Zimbabwe,ZW,1,0,14645473,Africa,8011,230
2020-10-13,Zimbabwe,ZW,10,0,14645473,Africa,8021,230
2020-10-14,Zimbabwe,ZW,15,0,14645473,Africa,8036,230
2020-10-15,Zimbabwe,ZW,19,1,14645473,Africa,8055,231
2020-10-16,Zimbabwe,ZW,20,0,14645473,Africa,8075,231
2020-10-17,Zimbabwe,ZW,24,0,14645473,Africa,8099,231
2020-10-18,Zimbabwe,ZW,11,0,14645473,Africa,8110,231
2020-10-19,Zimbabwe,ZW,37,0,14645473,Africa,8147,231
2020-10-20,Zimbabwe,ZW,12,1,14645473,Africa,8159,232
2020-10-21,Zimbabwe,ZW,28,1,14645473,Africa,8187,233
2020-10-22,Zimbabwe,ZW,28,3,14645473,Africa,8215,236
2020-10-23,Zimbabwe,ZW,27,0,14645473,Africa,8242,236
2020-10-24,Zimbabwe,ZW,15,0,14645473,Africa,8257,236
2020-10-25,Zimbabwe,ZW,12,0,14645473,Africa,8269,236
2020-10-26,Zimbabwe,ZW,7,1,14645473,Africa,8276,237
2020-10-27,Zimbabwe,ZW,27,5,14645473,Africa,8303,242
2020-10-28,Zimbabwe,ZW,12,0,14645473,Africa,8315,242
2020-10-29,Zimbabwe,ZW,5,0,14645473,Africa,8320,242
2020-10-30,Zimbabwe,ZW,29,0,14645473,Africa,8349,242
2020-10-31,Zimbabwe,ZW,13,0,14645473,Africa,8362,242
2020-11-01,Zimbabwe,ZW,0,0,14645473,Africa,8362,242
2020-11-02,Zimbabwe,ZW,12,1,14645473,Africa,8374,243
2020-11-03,Zimbabwe,ZW,15,2,14645473,Africa,8389,245
2020-11-04,Zimbabwe,ZW,21,1,14645473,Africa,8410,246
2020-11-05,Zimbabwe,ZW,17,2,14645473,Africa,8427,248
2020-11-06,Zimbabwe,ZW,17,0,14645473,Africa,8444,248
2020-11-07,Zimbabwe,ZW,27,2,14645473,Africa,8471,250
2020-11-08,Zimbabwe,ZW,27,1,14645473,Africa,8498,251
2020-11-09,Zimbabwe,ZW,33,2,14645473,Africa,8531,253
2020-11-10,Zimbabwe,ZW,30,1,14645473,Africa,8561,254
2020-11-11,Zimbabwe,ZW,49,1,14645473,Africa,8610,255
2020-11-12,Zimbabwe,ZW,57,0,14645473,Africa,8667,255
2020-11-13,Zimbabwe,ZW,29,0,14645473,Africa,8696,255
2020-11-14,Zimbabwe,ZW,69,2,14645473,Africa,8765,257
2020-11-15,Zimbabwe,ZW,21,0,14645473,Africa,8786,257
2020-11-16,Zimbabwe,ZW,0,0,14645473,Africa,8786,257
2020-11-17,Zimbabwe,ZW,111,0,14645473,Africa,8897,257
2020-11-18,Zimbabwe,ZW,48,3,14645473,Africa,8945,260
2020-11-19,Zimbabwe,ZW,36,1,14645473,Africa,8981,261
2020-11-20,Zimbabwe,ZW,65,4,14645473,Africa,9046,265
2020-11-21,Zimbabwe,ZW,74,0,14645473,Africa,9120,265
2020-11-22,Zimbabwe,ZW,52,0,14645473,Africa,9172,265
2020-11-23,Zimbabwe,ZW,48,3,14645473,Africa,9220,268
2020-11-24,Zimbabwe,ZW,88,5,14645473,Africa,9308,273
2020-11-25,Zimbabwe,ZW,90,1,14645473,Africa,9398,274
2020-11-26,Zimbabwe,ZW,110,0,14645473,Africa,9508,274
2020-11-27,Zimbabwe,ZW,115,0,14645473,Africa,9623,274
2020-11-28,Zimbabwe,ZW,91,1,14645473,Africa,9714,275
2020-11-29,Zimbabwe,ZW,108,0,14645473,Africa,9822,275
2020-11-30,Zimbabwe,ZW,128,1,14645473,Africa,9950,276
2020-12-01,Zimbabwe,ZW,84,1,14645473,Africa,10034,277
2020-12-02,Zimbabwe,ZW,95,0,14645473,Africa,10129,277
2020-12-03,Zimbabwe,ZW,114,0,14645473,Africa,10243,277
2020-12-04,Zimbabwe,ZW,181,3,14645473,Africa,10424,280
2020-12-05,Zimbabwe,ZW,123,0,14645473,Africa,10547,280
2020-12-06,Zimbabwe,ZW,70,11,14645473,Africa,10617,291
2020-12-07,Zimbabwe,ZW,101,0,14645473,Africa,10718,291
2020-12-08,Zimbabwe,ZW,121,3,14645473,Africa,10839,294
2020-12-09,Zimbabwe,ZW,73,9,14645473,Africa,10912,303
2020-12-10,Zimbabwe,ZW,95,1,14645473,Africa,11007,304
2020-12-11,Zimbabwe,ZW,74,1,14645473,Africa,11081,305
2020-12-12,Zimbabwe,ZW,81,1,14645473,Africa,11162,306
2020-12-13,Zimbabwe,ZW,57,1,14645473,Africa,11219,307
2020-12-14,Zimbabwe,ZW,27,0,14645473,Africa,11246,307
2019-12-31,Africa,W_AF,0,0,344404733,Africa,0,0
2020-01-01,Africa,W_AF,0,0,344404733,Africa,0,0
2020-01-02,Africa,W_AF,0,0,344404733,Africa,0,0
2020-01-03,Africa,W_AF,0,0,344404733,Africa,0,0
2020-01-04,Africa,W_AF,0,0,344404733,Africa,0,0
2020-01-05,Africa,W_AF,0,0,344404733,Africa,0,0
2020-01-06,Africa,W_AF,0,0,344404733,Africa,0,0
2020-01-07,Africa,W_AF,0,0,344404733,Africa,0,0
2020-01-08,Africa,W_AF,0,0,344404733,Africa,0,0
2020-01-09,Africa,W_AF,0,0,344404733,Africa,0,0
2020-01-10,Africa,W_AF,0,0,344404733,Africa,0,0
2020-01-11,Africa,W_AF,0,0,344404733,Africa,0,0
2020-01-12,Africa,W_AF,0,0,344404733,Africa,0,0
2020-01-13,Africa,W_AF,0,0,344404733,Africa,0,0
2020-01-14,Africa,W_AF,0,0,344404733,Africa,0,0
2020-01-15,Africa,W_AF,0,0,344404733,Africa,0,0
2020-01-16,Africa,W_AF,0,0,344404733,Africa,0,0
2020-01-17,Africa,W_AF,0,0,344404733,Africa,0,0
2020-01-18,Africa,W_AF,0,0,344404733,Africa,0,0
2020-01-19,Africa,W_AF,0,0,344404733,Africa,0,0
2020-01-20,Africa,W_AF,0,0,344404733,Africa,0,0
2020-01-21,Africa,W_AF,0,0,344404733,Africa,0,0
2020-01-22,Africa,W_AF,0,0,344404733,Africa,0,0
2020-01-23,Africa,W_AF,0,0,344404733,Africa,0,0
2020-01-24,Africa,W_AF,0,0,344404733,Africa,0,0
2020-01-25,Africa,W_AF,0,0,344404733,Africa,0,0
2020-01-26,Africa,W_AF,0,0,344404733,Africa,0,0
2020-01-27,Africa,W_AF,0,0,344404733,Africa,0,0
2020-01-28,Africa,W_AF,0,0,344404733,Africa,0,0
2020-01-29,Africa,W_AF,0,0,344404733,Africa,0,0
2020-01-30,Africa,W_AF,0,0,344404733,Africa,0,0
2020-01-31,Africa,W_AF,0,0,344404733,Africa,0,0
2020-02-01,Africa,W_AF,0,0,344404733,Africa,0,0
2020-02-02,Africa,W_AF,0,0,344404733,Africa,0,0
2020-02-03,Africa,W_AF,0,0,344404733,Africa,0,0
2020-02-04,Africa,W_AF,0,0,344404733,Africa,0,0
2020-02-05,Africa,W_AF,0,0,344404733,Africa,0,0
2020-02-06,Africa,W_AF,0,0,344404733,Africa,0,0
2020-02-07,Africa,W_AF,0,0,344404733,Africa,0,0
2020-02-08,Africa,W_AF,0,0,344404733,Africa,0,0
2020-02-09,Africa,W_AF,0,0,344404733,Africa,0,0
2020-02-10,Africa,W_AF,0,0,344404733,Africa,0,0
2020-02-11,Africa,W_AF,0,0,344404733,Africa,0,0
2020-02-12,Africa,W_AF,0,0,344404733,Africa,0,0
2020-02-13,Africa,W_AF,0,0,344404733,Africa,0,0
2020-02-14,Africa,W_AF,0,0,344404733,Africa,0,0
2020-02-15,Africa,W_AF,1,0,344404733,Africa,1,0
2020-02-16,Africa,W_AF,0,0,344404733,Africa,1,0
2020-02-17,Africa,W_AF,0,0,344404733,Africa,1,0
2020-02-18,Africa,W_AF,0,0,344404733,Africa,1,0
2020-02-19,Africa,W_AF,0,0,344404733,Africa,1,0
2020-02-20,Africa,W_AF,0,0,344404733,Africa,1,0
2020-02-21,Africa,W_AF,0,0,344404733,Africa,1,0
2020-02-22,Africa,W_AF,0,0,344404733,Africa,1,0
2020-02-23,Africa,W_AF,0,0,344404733,Africa,1,0
2020-02-24,Africa,W_AF,0,0,344404733,Africa,1,0
2020-02-25,Africa,W_AF,0,0,344404733,Africa,1,0
2020-02-26,Africa,W_AF,1,0,344404733,Africa,2,0
2020-02-27,Africa,W_AF,0,0,344404733,Africa,2,0
2020-02-28,Africa,W_AF,1,0,344404733,Africa,3,0
2020-02-29,Africa,W_AF,0,0,344404733,Africa,3,0
2020-03-01,Africa,W_AF,2,0,344404733,Africa,5,0
2020-03-02,Africa,W_AF,1,0,344404733,Africa,6,0
2020-03-03,Africa,W_AF,3,0,64462849,Africa,9,0
2020-03-04,Africa,W_AF,2,0,43053054,Africa,11,0
2020-03-05,Africa,W_AF,9,0,59349416,Africa,20,0
2020-03-06,Africa,W_AF,9,0,254767525,Africa,29,0
2020-03-07,Africa,W_AF,14,0,134346822,Africa,43,0
2020-03-08,Africa,W_AF,1,0,58558267,Africa,44,0
2020-03-09,Africa,W_AF,39,1,227875784,Africa,83,1
2020-03-10,Africa,W_AF,12,0,371604667,Africa,95,1
2020-03-11,Africa,W_AF,10,0,219194748,Africa,105,1
2020-03-12,Africa,W_AF,13,1,296203821,Africa,118,2
2020-03-13,Africa,W_AF,41,2,299052682,Africa,159,4
2020-03-14,Africa,W_AF,43,1,573489991,Africa,202,5
2020-03-15,Africa,W_AF,37,1,909289729,Africa,239,6
2020-03-16,Africa,W_AF,85,2,906644166,Africa,324,8
2020-03-17,Africa,W_AF,78,0,1009602304,Africa,402,8
2020-03-18,Africa,W_AF,92,4,1011950000,Africa,494,12
2020-03-19,Africa,W_AF,139,4,1030784591,Africa,633,16
2020-03-20,Africa,W_AF,111,1,1048001143,Africa,744,17
2020-03-21,Africa,W_AF,231,7,1113476577,Africa,975,24
2020-03-22,Africa,W_AF,201,11,1193068580,Africa,1176,35
2020-03-23,Africa,W_AF,213,9,1223434623,Africa,1389,44
2020-03-24,Africa,W_AF,349,8,1223434623,Africa,1738,52
2020-03-25,Africa,W_AF,465,12,1230212076,Africa,2203,64
2020-03-26,Africa,W_AF,487,8,1249870099,Africa,2690,72
2020-03-27,Africa,W_AF,588,12,1251791016,Africa,3278,84
2020-03-28,Africa,W_AF,526,19,1251791016,Africa,3804,103
2020-03-29,Africa,W_AF,320,21,1251791016,Africa,4124,124
2020-03-30,Africa,W_AF,505,19,1251791016,Africa,4629,143
2020-03-31,Africa,W_AF,508,23,1251791016,Africa,5137,166
2020-04-01,Africa,W_AF,489,23,1273438503,Africa,5626,189
2020-04-02,Africa,W_AF,622,35,1273438503,Africa,6248,224
2020-04-03,Africa,W_AF,635,32,1292067252,Africa,6883,256
2020-04-04,Africa,W_AF,625,49,1292067252,Africa,7508,305
2020-04-05,Africa,W_AF,932,74,1292067252,Africa,8440,379
2020-04-06,Africa,W_AF,735,55,1303129366,Africa,9175,434
2020-04-07,Africa,W_AF,627,43,1303129366,Africa,9802,477
2020-04-08,Africa,W_AF,722,45,1303129366,Africa,10524,522
2020-04-09,Africa,W_AF,922,51,1303344414,Africa,11446,573
2020-04-10,Africa,W_AF,834,57,1303344414,Africa,12280,630
2020-04-11,Africa,W_AF,672,61,1303344414,Africa,12952,691
2020-04-12,Africa,W_AF,714,52,1303344414,Africa,13666,743
2020-04-13,Africa,W_AF,856,46,1303344414,Africa,14522,789
2020-04-14,Africa,W_AF,769,46,1303344414,Africa,15291,835
2020-04-15,Africa,W_AF,990,41,1303344414,Africa,16281,876
2020-04-16,Africa,W_AF,962,35,1303344414,Africa,17243,911
2020-04-17,Africa,W_AF,1086,54,1303344414,Africa,18329,965
2020-04-18,Africa,W_AF,1568,51,1303344414,Africa,19897,1016
2020-04-19,Africa,W_AF,1160,41,1303344414,Africa,21057,1057
2020-04-20,Africa,W_AF,1246,63,1303344414,Africa,22303,1120
2020-04-21,Africa,W_AF,964,35,1303344414,Africa,23267,1155
2020-04-22,Africa,W_AF,1350,34,1303344414,Africa,24617,1189
2020-04-23,Africa,W_AF,1069,43,1303344414,Africa,25686,1232
2020-04-24,Africa,W_AF,1535,54,1303344414,Africa,27221,1286
2020-04-25,Africa,W_AF,1854,48,1303344414,Africa,29075,1334
2020-04-26,Africa,W_AF,1241,44,1303926872,Africa,30316,1378
2020-04-27,Africa,W_AF,1432,37,1303926872,Africa,31748,1415
2020-04-28,Africa,W_AF,1414,55,1303926872,Africa,33162,1470
2020-04-29,Africa,W_AF,1770,54,1303926872,Africa,34932,1524
2020-04-30,Africa,W_AF,1803,67,1303926872,Africa,36735,1591
2020-05-01,Africa,W_AF,2115,44,1303926872,Africa,38850,1635
2020-05-02,Africa,W_AF,1907,55,1304777763,Africa,40757,1690
2020-05-03,Africa,W_AF,2019,70,1304777763,Africa,42776,1760
2020-05-04,Africa,W_AF,1659,39,1304777763,Africa,44435,1799
2020-05-05,Africa,W_AF,2687,46,1304777763,Africa,47122,1845
2020-05-06,Africa,W_AF,2086,69,1304777763,Africa,49208,1914
2020-05-07,Africa,W_AF,2469,97,1304777763,Africa,51677,2011
2020-05-08,Africa,W_AF,2429,67,1304777763,Africa,54106,2078
2020-05-09,Africa,W_AF,3730,77,1304777763,Africa,57836,2155
2020-05-10,Africa,W_AF,2801,68,1304777763,Africa,60637,2223
2020-05-11,Africa,W_AF,2754,67,1304777763,Africa,63391,2290
2020-05-12,Africa,W_AF,3119,57,1304777763,Africa,66510,2347
2020-05-13,Africa,W_AF,2994,56,1304777763,Africa,69504,2403
2020-05-14,Africa,W_AF,3029,87,1304777763,Africa,72533,2490
2020-05-15,Africa,W_AF,3146,73,1306903030,Africa,75679,2563
2020-05-16,Africa,W_AF,2753,71,1306903030,Africa,78432,2634
2020-05-17,Africa,W_AF,3003,65,1306903030,Africa,81435,2699
2020-05-18,Africa,W_AF,3381,60,1306903030,Africa,84816,2759
2020-05-19,Africa,W_AF,3269,72,1306903030,Africa,88085,2831
2020-05-20,Africa,W_AF,3280,72,1306903030,Africa,91365,2903
2020-05-21,Africa,W_AF,3620,89,1306903030,Africa,94985,2992
2020-05-22,Africa,W_AF,4870,108,1306903030,Africa,99855,3100
2020-05-23,Africa,W_AF,3857,83,1306903030,Africa,103712,3183
2020-05-24,Africa,W_AF,4439,74,1306903030,Africa,108151,3257
2020-05-25,Africa,W_AF,3758,82,1306903030,Africa,111909,3339
2020-05-26,Africa,W_AF,3855,139,1306903030,Africa,115764,3478
2020-05-27,Africa,W_AF,3917,112,1306903030,Africa,119681,3590
2020-05-28,Africa,W_AF,4851,101,1306903030,Africa,124532,3691
2020-05-29,Africa,W_AF,4749,98,1306903030,Africa,129281,3789
2020-05-30,Africa,W_AF,5868,134,1306903030,Africa,135149,3923
2020-05-31,Africa,W_AF,6473,148,1306903030,Africa,141622,4071
2020-06-01,Africa,W_AF,5374,151,1306903030,Africa,146996,4222
2020-06-02,Africa,W_AF,5489,122,1306903030,Africa,152485,4344
2020-06-03,Africa,W_AF,4965,151,1306903030,Africa,157450,4495
2020-06-04,Africa,W_AF,4725,88,1306903030,Africa,162175,4583
2020-06-05,Africa,W_AF,7648,160,1306903030,Africa,169823,4743
2020-06-06,Africa,W_AF,7386,161,1306903030,Africa,177209,4904
2020-06-07,Africa,W_AF,6418,129,1306903030,Africa,183627,5033
2020-06-08,Africa,W_AF,5971,138,1306903030,Africa,189598,5171
2020-06-09,Africa,W_AF,6972,175,1306903030,Africa,196570,5346
2020-06-10,Africa,W_AF,6572,171,1306903030,Africa,203142,5517
2020-06-11,Africa,W_AF,6481,154,1306903030,Africa,209623,5671
2020-06-12,Africa,W_AF,7247,173,1306903030,Africa,216870,5844
2020-06-13,Africa,W_AF,8620,256,1306903030,Africa,225490,6100
2020-06-14,Africa,W_AF,8333,197,1306903030,Africa,233823,6297
2020-06-15,Africa,W_AF,9302,226,1306903030,Africa,243125,6523
2020-06-16,Africa,W_AF,8152,237,1306903030,Africa,251277,6760
2020-06-17,Africa,W_AF,7460,238,1306903030,Africa,258737,6998
2020-06-18,Africa,W_AF,8505,199,1306903030,Africa,267242,7197
2020-06-19,Africa,W_AF,8379,204,1306903030,Africa,275621,7401
2020-06-20,Africa,W_AF,10027,287,1306903030,Africa,285648,7688
2020-06-21,Africa,W_AF,10905,232,1306903030,Africa,296553,7920
2020-06-22,Africa,W_AF,9514,191,1306903030,Africa,306067,8111
2020-06-23,Africa,W_AF,9194,218,1306903030,Africa,315261,8329
2020-06-24,Africa,W_AF,9131,284,1306903030,Africa,324392,8613
2020-06-25,Africa,W_AF,10724,235,1306903030,Africa,335116,8848
2020-06-26,Africa,W_AF,12663,221,1306903030,Africa,347779,9069
2020-06-27,Africa,W_AF,11299,207,1306903030,Africa,359078,9276
2020-06-28,Africa,W_AF,12370,204,1306903030,Africa,371448,9480
2020-06-29,Africa,W_AF,11282,180,1306903030,Africa,382730,9660
2020-06-30,Africa,W_AF,10714,218,1306903030,Africa,393444,9878
2020-07-01,Africa,W_AF,11632,269,1306903030,Africa,405076,10147
2020-07-02,Africa,W_AF,13238,253,1306903030,Africa,418314,10400
2020-07-03,Africa,W_AF,14386,244,1306903030,Africa,432700,10644
2020-07-04,Africa,W_AF,14812,234,1306903030,Africa,447512,10878
2020-07-05,Africa,W_AF,15909,201,1306903030,Africa,463421,11079
2020-07-06,Africa,W_AF,14650,293,1306903030,Africa,478071,11372
2020-07-07,Africa,W_AF,14699,258,1306903030,Africa,492770,11630
2020-07-08,Africa,W_AF,16233,358,1306903030,Africa,509003,11988
2020-07-09,Africa,W_AF,14543,247,1306903030,Africa,523546,12235
2020-07-10,Africa,W_AF,18766,226,1306903030,Africa,542312,12461
2020-07-11,Africa,W_AF,17554,307,1306903030,Africa,559866,12768
2020-07-12,Africa,W_AF,18694,221,1306903030,Africa,578560,12989
2020-07-13,Africa,W_AF,17001,255,1306903030,Africa,595561,13244
2020-07-14,Africa,W_AF,16245,217,1306903030,Africa,611806,13461
2020-07-15,Africa,W_AF,14920,339,1306903030,Africa,626726,13800
2020-07-16,Africa,W_AF,18174,244,1306903030,Africa,644900,14044
2020-07-17,Africa,W_AF,19773,345,1306903030,Africa,664673,14389
2020-07-18,Africa,W_AF,19293,280,1306903030,Africa,683966,14669
2020-07-19,Africa,W_AF,19149,275,1306903030,Africa,703115,14944
2020-07-20,Africa,W_AF,18764,204,1306903030,Africa,721879,15148
2020-07-21,Africa,W_AF,15497,270,1306903030,Africa,737376,15418
2020-07-22,Africa,W_AF,12997,314,1306903030,Africa,750373,15732
2020-07-23,Africa,W_AF,19574,698,1306903030,Africa,769947,16430
2020-07-24,Africa,W_AF,19898,275,1306903030,Africa,789845,16705
2020-07-25,Africa,W_AF,20650,381,1306903030,Africa,810495,17086
2020-07-26,Africa,W_AF,18379,411,1306903030,Africa,828874,17497
2020-07-27,Africa,W_AF,18804,267,1306903030,Africa,847678,17764
2020-07-28,Africa,W_AF,13171,409,1306903030,Africa,860849,18173
2020-07-29,Africa,W_AF,13142,310,1306903030,Africa,873991,18483
2020-07-30,Africa,W_AF,18125,374,1306903030,Africa,892116,18857
2020-07-31,Africa,W_AF,17619,454,1306903030,Africa,909735,19311
2020-08-01,Africa,W_AF,17186,333,1306903030,Africa,926921,19644
2020-08-02,Africa,W_AF,18914,312,1306903030,Africa,945835,19956
2020-08-03,Africa,W_AF,11995,315,1306903030,Africa,957830,20271
2020-08-04,Africa,W_AF,11366,349,1306903030,Africa,969196,20620
2020-08-05,Africa,W_AF,9548,469,1306903030,Africa,978744,21089
2020-08-06,Africa,W_AF,15661,542,1306903030,Africa,994405,21631
2020-08-07,Africa,W_AF,14678,449,1306903030,Africa,1009083,22080
2020-08-08,Africa,W_AF,13318,421,1306903030,Africa,1022401,22501
2020-08-09,Africa,W_AF,13866,412,1306903030,Africa,1036267,22913
2020-08-10,Africa,W_AF,12554,347,1306903030,Africa,1048821,23260
2020-08-11,Africa,W_AF,8828,330,1306903030,Africa,1057649,23590
2020-08-12,Africa,W_AF,7895,268,1306903030,Africa,1065544,23858
2020-08-13,Africa,W_AF,9529,426,1306903030,Africa,1075073,24284
2020-08-14,Africa,W_AF,10580,400,1306903030,Africa,1085653,24684
2020-08-15,Africa,W_AF,12689,422,1306903030,Africa,1098342,25106
2020-08-16,Africa,W_AF,11639,235,1306903030,Africa,1109981,25341
2020-08-17,Africa,W_AF,9598,292,1306903030,Africa,1119579,25633
2020-08-18,Africa,W_AF,9017,263,1306903030,Africa,1128596,25896
2020-08-19,Africa,W_AF,7848,397,1306903030,Africa,1136444,26293
2020-08-20,Africa,W_AF,11420,339,1306903030,Africa,1147864,26632
2020-08-21,Africa,W_AF,10749,339,1306903030,Africa,1158613,26971
2020-08-22,Africa,W_AF,10122,349,1306903030,Africa,1168735,27320
2020-08-23,Africa,W_AF,10008,267,1306903030,Africa,1178743,27587
2020-08-24,Africa,W_AF,9444,170,1306903030,Africa,1188187,27757
2020-08-25,Africa,W_AF,7765,243,1306903030,Africa,1195952,28000
2020-08-26,Africa,W_AF,7877,288,1306903030,Africa,1203829,28288
2020-08-27,Africa,W_AF,8870,321,1306903030,Africa,1212699,28609
2020-08-28,Africa,W_AF,8513,253,1306903030,Africa,1221212,28862
2020-08-29,Africa,W_AF,7962,231,1306903030,Africa,1229174,29093
2020-08-30,Africa,W_AF,8631,331,1306903030,Africa,1237805,29424
2020-08-31,Africa,W_AF,8380,161,1306903030,Africa,1246185,29585
2020-09-01,Africa,W_AF,6881,225,1306903030,Africa,1253066,29810
2020-09-02,Africa,W_AF,7519,243,1306903030,Africa,1260585,30053
2020-09-03,Africa,W_AF,8247,239,1306903030,Africa,1268832,30292
2020-09-04,Africa,W_AF,7716,302,1306903030,Africa,1276548,30594
2020-09-05,Africa,W_AF,8359,231,1306903030,Africa,1284907,30825
2020-09-06,Africa,W_AF,7206,213,1306903030,Africa,1292113,31038
2020-09-07,Africa,W_AF,8030,244,1306903030,Africa,1300143,31282
2020-09-08,Africa,W_AF,7217,214,1306903030,Africa,1307360,31496
2020-09-09,Africa,W_AF,7253,213,1306903030,Africa,1314613,31709
2020-09-10,Africa,W_AF,8516,195,1306903030,Africa,1323129,31904
2020-09-11,Africa,W_AF,7969,214,1306903030,Africa,1331098,32118
2020-09-12,Africa,W_AF,8708,234,1306903030,Africa,1339806,32352
2020-09-13,Africa,W_AF,7547,149,1306903030,Africa,1347353,32501
2020-09-14,Africa,W_AF,6674,119,1306903030,Africa,1354027,32620
2020-09-15,Africa,W_AF,6339,169,1306903030,Africa,1360366,32789
2020-09-16,Africa,W_AF,6518,267,1306903030,Africa,1366884,33056
2020-09-17,Africa,W_AF,7490,190,1306903030,Africa,1374374,33246
2020-09-18,Africa,W_AF,8751,184,1306903030,Africa,1383125,33430
2020-09-19,Africa,W_AF,8116,193,1306903030,Africa,1391241,33623
2020-09-20,Africa,W_AF,9368,208,1306903030,Africa,1400609,33831
2020-09-21,Africa,W_AF,7831,119,1306903030,Africa,1408440,33950
2020-09-22,Africa,W_AF,6156,138,1306903030,Africa,1414596,34088
2020-09-23,Africa,W_AF,6779,238,1306903030,Africa,1421375,34326
2020-09-24,Africa,W_AF,8536,203,1306903030,Africa,1429911,34529
2020-09-25,Africa,W_AF,8275,174,1306903030,Africa,1438186,34703
2020-09-26,Africa,W_AF,7946,152,1306903030,Africa,1446132,34855
2020-09-27,Africa,W_AF,7322,185,1306903030,Africa,1453454,35040
2020-09-28,Africa,W_AF,7582,119,1306903030,Africa,1461036,35159
2020-09-29,Africa,W_AF,5848,299,1306903030,Africa,1466884,35458
2020-09-30,Africa,W_AF,7437,215,1306903030,Africa,1474321,35673
2020-10-01,Africa,W_AF,8390,188,1306903030,Africa,1482711,35861
2020-10-02,Africa,W_AF,7098,225,1306903030,Africa,1489809,36086
2020-10-03,Africa,W_AF,8852,138,1306903030,Africa,1498661,36224
2020-10-04,Africa,W_AF,8964,111,1306903030,Africa,1507625,36335
2020-10-05,Africa,W_AF,9281,172,1306903030,Africa,1516906,36507
2020-10-06,Africa,W_AF,4578,124,1306903030,Africa,1521484,36631
2020-10-07,Africa,W_AF,6729,192,1306903030,Africa,1528213,36823
2020-10-08,Africa,W_AF,10504,270,1306903030,Africa,1538717,37093
2020-10-09,Africa,W_AF,9758,249,1306903030,Africa,1548475,37342
2020-10-10,Africa,W_AF,11220,280,1306903030,Africa,1559695,37622
2020-10-11,Africa,W_AF,11839,269,1306903030,Africa,1571534,37891
2020-10-12,Africa,W_AF,7776,184,1306903030,Africa,1579310,38075
2020-10-13,Africa,W_AF,6333,141,1306903030,Africa,1585643,38216
2020-10-14,Africa,W_AF,9107,354,1306903030,Africa,1594750,38570
2020-10-15,Africa,W_AF,11383,260,1306903030,Africa,1606133,38830
2020-10-16,Africa,W_AF,8693,267,1306903030,Africa,1614826,39097
2020-10-17,Africa,W_AF,9586,194,1306903030,Africa,1624412,39291
2020-10-18,Africa,W_AF,14155,263,1306903030,Africa,1638567,39554
2020-10-19,Africa,W_AF,8295,187,1306903030,Africa,1646862,39741
2020-10-20,Africa,W_AF,9618,190,1306903030,Africa,1656480,39931
2020-10-21,Africa,W_AF,9724,285,1306903030,Africa,1666204,40216
2020-10-22,Africa,W_AF,10534,279,1306903030,Africa,1676738,40495
2020-10-23,Africa,W_AF,10961,196,1306903030,Africa,1687699,40691
2020-10-24,Africa,W_AF,10409,224,1306903030,Africa,1698108,40915
2020-10-25,Africa,W_AF,11864,226,1306903030,Africa,1709972,41141
2020-10-26,Africa,W_AF,8931,118,1306903030,Africa,1718903,41259
2020-10-27,Africa,W_AF,10808,346,1306903030,Africa,1729711,41605
2020-10-28,Africa,W_AF,8671,183,1306903030,Africa,1738382,41788
2020-10-29,Africa,W_AF,11949,343,1306903030,Africa,1750331,42131
2020-10-30,Africa,W_AF,14758,306,1306903030,Africa,1765089,42437
2020-10-31,Africa,W_AF,11506,251,1306903030,Africa,1776595,42688
2020-11-01,Africa,W_AF,10580,204,1306903030,Africa,1787175,42892
2020-11-02,Africa,W_AF,9573,310,1306903030,Africa,1796748,43202
2020-11-03,Africa,W_AF,6846,181,1306903030,Africa,1803594,43383
2020-11-04,Africa,W_AF,11048,327,1306903030,Africa,1814642,43710
2020-11-05,Africa,W_AF,14179,223,1306903030,Africa,1828821,43933
2020-11-06,Africa,W_AF,15255,306,1306903030,Africa,1844076,44239
2020-11-07,Africa,W_AF,11959,230,1306903030,Africa,1856035,44469
2020-11-08,Africa,W_AF,14972,376,1306903030,Africa,1871007,44845
2020-11-09,Africa,W_AF,12552,510,1306903030,Africa,1883559,45355
2020-11-10,Africa,W_AF,8581,250,1306903030,Africa,1892140,45605
2020-11-11,Africa,W_AF,13110,342,1306903030,Africa,1905250,45947
2020-11-12,Africa,W_AF,12847,305,1306903030,Africa,1918097,46252
2020-11-13,Africa,W_AF,17167,294,1306903030,Africa,1935264,46546
2020-11-14,Africa,W_AF,14266,283,1306903030,Africa,1949530,46829
2020-11-15,Africa,W_AF,13401,254,1306903030,Africa,1962931,47083
2020-11-16,Africa,W_AF,13350,277,1306903030,Africa,1976281,47360
2020-11-17,Africa,W_AF,9992,267,1306903030,Africa,1986273,47627
2020-11-18,Africa,W_AF,13290,402,1306903030,Africa,1999563,48029
2020-11-19,Africa,W_AF,15091,389,1306903030,Africa,2014654,48418
2020-11-20,Africa,W_AF,14012,344,1306903030,Africa,2028666,48762
2020-11-21,Africa,W_AF,15679,350,1306903030,Africa,2044345,49112
2020-11-22,Africa,W_AF,13574,293,1306903030,Africa,2057919,49405
2020-11-23,Africa,W_AF,8797,250,1306903030,Africa,2066716,49655
2020-11-24,Africa,W_AF,13238,331,1306903030,Africa,2079954,49986
2020-11-25,Africa,W_AF,13101,339,1306903030,Africa,2093055,50325
2020-11-26,Africa,W_AF,14451,304,1306903030,Africa,2107506,50629
2020-11-27,Africa,W_AF,13312,297,1306903030,Africa,2120818,50926
2020-11-28,Africa,W_AF,16521,336,1306903030,Africa,2137339,51262
2020-11-29,Africa,W_AF,13324,221,1306903030,Africa,2150663,51483
2020-11-30,Africa,W_AF,13500,243,1306903030,Africa,2164163,51726
2020-12-01,Africa,W_AF,9864,266,1306903030,Africa,2174027,51992
2020-12-02,Africa,W_AF,12704,326,1306903030,Africa,2186731,52318
2020-12-03,Africa,W_AF,15408,258,1306903030,Africa,2202139,52576
2020-12-04,Africa,W_AF,13893,268,1306903030,Africa,2216032,52844
2020-12-05,Africa,W_AF,17358,428,1306903030,Africa,2233390,53272
2020-12-06,Africa,W_AF,16702,287,1306903030,Africa,2250092,53559
2020-12-07,Africa,W_AF,13068,300,1306903030,Africa,2263160,53859
2020-12-08,Africa,W_AF,10780,251,1306903030,Africa,2273940,54110
2020-12-09,Africa,W_AF,14316,414,1306903030,Africa,2288256,54524
2020-12-10,Africa,W_AF,18892,343,1306903030,Africa,2307148,54867
2020-12-11,Africa,W_AF,19111,399,1306903030,Africa,2326259,55266
2020-12-12,Africa,W_AF,18909,380,1306903030,Africa,2345168,55646
2020-12-13,Africa,W_AF,18517,341,1306903030,Africa,2363685,55987
2020-12-14,Africa,W_AF,16142,347,1306903030,Africa,2379827,56334
2019-12-31,America,W_AM,0,0,733213617,America,0,0
2020-01-01,America,W_AM,0,0,733213617,America,0,0
2020-01-02,America,W_AM,0,0,733213617,America,0,0
2020-01-03,America,W_AM,0,0,733213617,America,0,0
2020-01-04,America,W_AM,0,0,733213617,America,0,0
2020-01-05,America,W_AM,0,0,733213617,America,0,0
2020-01-06,America,W_AM,0,0,733213617,America,0,0
2020-01-07,America,W_AM,0,0,733213617,America,0,0
2020-01-08,America,W_AM,0,0,733213617,America,0,0
2020-01-09,America,W_AM,0,0,733213617,America,0,0
2020-01-10,America,W_AM,0,0,733213617,America,0,0
2020-01-11,America,W_AM,0,0,733213617,America,0,0
2020-01-12,America,W_AM,0,0,733213617,America,0,0
2020-01-13,America,W_AM,0,0,733213617,America,0,0
2020-01-14,America,W_AM,1,0,733213617,America,1,0
2020-01-15,America,W_AM,0,0,733213617,America,1,0
2020-01-16,America,W_AM,0,0,733213617,America,1,0
2020-01-17,America,W_AM,0,0,733213617,America,1,0
2020-01-18,America,W_AM,0,0,733213617,America,1,0
2020-01-19,America,W_AM,0,0,733213617,America,1,0
2020-01-20,America,W_AM,0,0,733213617,America,1,0
2020-01-21,America,W_AM,1,0,733213617,America,2,0
2020-01-22,America,W_AM,0,0,733213617,America,2,0
2020-01-23,America,W_AM,0,0,733213617,America,2,0
2020-01-24,America,W_AM,0,0,733213617,America,2,0
2020-01-25,America,W_AM,1,0,733213617,America,3,0
2020-01-26,America,W_AM,1,0,733213617,America,4,0
2020-01-27,America,W_AM,3,0,733213617,America,7,0
2020-01-28,America,W_AM,1,0,733213617,America,8,0
2020-01-29,America,W_AM,1,0,733213617,America,9,0
2020-01-30,America,W_AM,1,0,733213617,America,10,0
2020-01-31,America,W_AM,1,0,733213617,America,11,0
2020-02-01,America,W_AM,2,0,733213617,America,13,0
2020-02-02,America,W_AM,1,0,733213617,America,14,0
2020-02-03,America,W_AM,3,0,733213617,America,17,0
2020-02-04,America,W_AM,0,0,733213617,America,17,0
2020-02-05,America,W_AM,1,0,733213617,America,18,0
2020-02-06,America,W_AM,1,0,733213617,America,19,0
2020-02-07,America,W_AM,2,0,733213617,America,21,0
2020-02-08,America,W_AM,0,0,733213617,America,21,0
2020-02-09,America,W_AM,0,0,733213617,America,21,0
2020-02-10,America,W_AM,0,0,733213617,America,21,0
2020-02-11,America,W_AM,2,0,733213617,America,23,0
2020-02-12,America,W_AM,0,0,733213617,America,23,0
2020-02-13,America,W_AM,1,0,733213617,America,24,0
2020-02-14,America,W_AM,1,0,733213617,America,25,0
2020-02-15,America,W_AM,1,0,733213617,America,26,0
2020-02-16,America,W_AM,0,0,733213617,America,26,0
2020-02-17,America,W_AM,0,0,733213617,America,26,0
2020-02-18,America,W_AM,0,0,733213617,America,26,0
2020-02-19,America,W_AM,0,0,733213617,America,26,0
2020-02-20,America,W_AM,0,0,733213617,America,26,0
2020-02-21,America,W_AM,2,0,733213617,America,28,0
2020-02-22,America,W_AM,19,0,733213617,America,47,0
2020-02-23,America,W_AM,1,0,733213617,America,48,0
2020-02-24,America,W_AM,0,0,733213617,America,48,0
2020-02-25,America,W_AM,22,0,733213617,America,70,0
2020-02-26,America,W_AM,1,0,733213617,America,71,0
2020-02-27,America,W_AM,7,0,733213617,America,78,0
2020-02-28,America,W_AM,8,0,733213617,America,86,0
2020-02-29,America,W_AM,11,0,733213617,America,97,0
2020-03-01,America,W_AM,10,1,733213617,America,107,1
2020-03-02,America,W_AM,30,1,733213617,America,137,2
2020-03-03,America,W_AM,20,4,722517049,America,157,6
2020-03-04,America,W_AM,30,3,768833713,America,187,9
2020-03-05,America,W_AM,46,2,741426695,America,233,11
2020-03-06,America,W_AM,98,1,786207370,America,331,12
2020-03-07,America,W_AM,127,2,867470136,America,458,14
2020-03-08,America,W_AM,104,4,756926317,America,562,18
2020-03-09,America,W_AM,161,4,823765393,America,723,22
2020-03-10,America,W_AM,233,6,844309558,America,956,28
2020-03-11,America,W_AM,336,3,835056472,America,1292,31
2020-03-12,America,W_AM,386,2,851737922,America,1678,33
2020-03-13,America,W_AM,492,11,834702264,America,2170,44
2020-03-14,America,W_AM,704,9,933070819,America,2874,53
2020-03-15,America,W_AM,1004,11,963752097,America,3878,64
2020-03-16,America,W_AM,1098,13,961138325,America,4976,77
2020-03-17,America,W_AM,1329,19,972651427,America,6305,96
2020-03-18,America,W_AM,2276,28,983882446,America,8581,124
2020-03-19,America,W_AM,3625,49,996881499,America,12206,173
2020-03-20,America,W_AM,5712,6,1008987913,America,17918,179
2020-03-21,America,W_AM,6461,129,1009401649,America,24379,308
2020-03-22,America,W_AM,8348,100,1009401649,America,32727,408
2020-03-23,America,W_AM,9745,149,1009585459,America,42472,557
2020-03-24,America,W_AM,12580,143,1010350122,America,55052,700
2020-03-25,America,W_AM,10329,246,1010335486,America,65381,946
2020-03-26,America,W_AM,16831,281,1010594132,America,82212,1227
2020-03-27,America,W_AM,18956,292,1010639037,America,101168,1519
2020-03-28,America,W_AM,21199,478,1013572441,America,122367,1997
2020-03-29,America,W_AM,22467,546,1013572441,America,144834,2543
2020-03-30,America,W_AM,20818,389,1013572441,America,165652,2932
2020-03-31,America,W_AM,24445,755,1013155740,America,190097,3687
2020-04-01,America,W_AM,28876,1011,1013567450,America,218973,4698
2020-04-02,America,W_AM,31511,1216,1013598424,America,250484,5914
2020-04-03,America,W_AM,33266,1045,1013598424,America,283750,6959
2020-04-04,America,W_AM,36684,1287,1013601796,America,320434,8246
2020-04-05,America,W_AM,38511,1566,1013601796,America,358945,9812
2020-04-06,America,W_AM,29865,1325,1013601796,America,388810,11137
2020-04-07,America,W_AM,34466,1541,1013601796,America,423276,12678
2020-04-08,America,W_AM,35696,2184,1013601796,America,458972,14862
2020-04-09,America,W_AM,40800,2220,1013601796,America,499772,17082
2020-04-10,America,W_AM,40637,2227,1013601796,America,540409,19309
2020-04-11,America,W_AM,43579,2406,1013601796,America,583988,21715
2020-04-12,America,W_AM,33570,2111,1013601796,America,617558,23826
2020-04-13,America,W_AM,32508,1795,1013601796,America,650066,25621
2020-04-14,America,W_AM,29461,1793,1013601796,America,679527,27414
2020-04-15,America,W_AM,34965,2894,1013601796,America,714492,30308
2020-04-16,America,W_AM,38123,5380,1013601796,America,752615,35688
2020-04-17,America,W_AM,39247,2804,1013601796,America,791862,38492
2020-04-18,America,W_AM,39750,4259,1013601796,America,831612,42751
2020-04-19,America,W_AM,40898,2467,1013601796,America,872510,45218
2020-04-20,America,W_AM,31943,2151,1013601796,America,904453,47369
2020-04-21,America,W_AM,36221,2236,1013601796,America,940674,49605
2020-04-22,America,W_AM,45581,3081,1013601796,America,986255,52686
2020-04-23,America,W_AM,26665,2264,1013601796,America,1012920,54950
2020-04-24,America,W_AM,37049,3967,1013601796,America,1049969,58917
2020-04-25,America,W_AM,30537,1843,1013601796,America,1080506,60760
2020-04-26,America,W_AM,62102,2903,1013601796,America,1142608,63663
2020-04-27,America,W_AM,47968,2089,1013601796,America,1190576,65752
2020-04-28,America,W_AM,33670,2117,1013601796,America,1224246,67869
2020-04-29,America,W_AM,38070,3216,1013601796,America,1262316,71085
2020-04-30,America,W_AM,41714,3506,1013601796,America,1304030,74591
2020-05-01,America,W_AM,46273,2987,1013601796,America,1350303,77578
2020-05-02,America,W_AM,50738,3106,1013601796,America,1401041,80684
2020-05-03,America,W_AM,43725,2451,1013601796,America,1444766,83135
2020-05-04,America,W_AM,41664,2125,1013601796,America,1486430,85260
2020-05-05,America,W_AM,39059,1972,1013601796,America,1525489,87232
2020-05-06,America,W_AM,40879,3334,1013601796,America,1566368,90566
2020-05-07,America,W_AM,42146,3556,1013601796,America,1608514,94122
2020-05-08,America,W_AM,49874,3480,1013601796,America,1658388,97602
2020-05-09,America,W_AM,46351,2828,1013601796,America,1704739,100430
2020-05-10,America,W_AM,45604,2830,1013601796,America,1750343,103260
2020-05-11,America,W_AM,35752,2057,1013601796,America,1786095,105317
2020-05-12,America,W_AM,32294,1933,1013601796,America,1818389,107250
2020-05-13,America,W_AM,43259,3464,1013601796,America,1861648,110714
2020-05-14,America,W_AM,45452,3113,1013601796,America,1907100,113827
2020-05-15,America,W_AM,54245,3242,1013601796,America,1961345,117069
2020-05-16,America,W_AM,55067,3337,1013601796,America,2016412,120406
2020-05-17,America,W_AM,52095,2685,1013601796,America,2068507,123091
2020-05-18,America,W_AM,38080,1771,1013601796,America,2106587,124862
2020-05-19,America,W_AM,47941,1970,1013601796,America,2154528,126832
2020-05-20,America,W_AM,53286,3411,1013601796,America,2207814,130243
2020-05-21,America,W_AM,59963,3198,1013601796,America,2267777,133441
2020-05-22,America,W_AM,60875,3284,1013601796,America,2328652,136725
2020-05-23,America,W_AM,61335,3235,1013601796,America,2389987,139960
2020-05-24,America,W_AM,52855,2620,1013601796,America,2442842,142580
2020-05-25,America,W_AM,51233,1767,1013601796,America,2494075,144347
2020-05-26,America,W_AM,49470,2044,1013601796,America,2543545,146391
2020-05-27,America,W_AM,53981,2632,1013601796,America,2597526,149023
2020-05-28,America,W_AM,59876,3575,1013601796,America,2657402,152598
2020-05-29,America,W_AM,68489,3166,1013601796,America,2725891,155764
2020-05-30,America,W_AM,71958,3102,1013601796,America,2797849,158866
2020-05-31,America,W_AM,76859,2648,1013601796,America,2874708,161514
2020-06-01,America,W_AM,57084,1767,1013601796,America,2931792,163281
2020-06-02,America,W_AM,54444,1981,1013601796,America,2986236,165262
2020-06-03,America,W_AM,63397,3096,1013601796,America,3049633,168358
2020-06-04,America,W_AM,73106,4049,1013601796,America,3122739,172407
2020-06-05,America,W_AM,70967,3781,1013601796,America,3193706,176188
2020-06-06,America,W_AM,76235,3090,1013601796,America,3269941,179278
2020-06-07,America,W_AM,69275,2429,1013601796,America,3339216,181707
2020-06-08,America,W_AM,59887,2401,1013601796,America,3399103,184108
2020-06-09,America,W_AM,53935,1882,1013601796,America,3453038,185990
2020-06-10,America,W_AM,70713,3310,1013601796,America,3523751,189300
2020-06-11,America,W_AM,77084,3533,1013601796,America,3600835,192833
2020-06-12,America,W_AM,75460,3236,1013601796,America,3676295,196069
2020-06-13,America,W_AM,79667,3050,1013601796,America,3755962,199119
2020-06-14,America,W_AM,69407,2755,1013601796,America,3825369,201874
2020-06-15,America,W_AM,57970,1818,1013601796,America,3883339,203692
2020-06-16,America,W_AM,62667,1893,1013601796,America,3946006,205585
2020-06-17,America,W_AM,81650,3335,1013601796,America,4027656,208920
2020-06-18,America,W_AM,111912,3479,985085967,America,4139568,212399
2020-06-19,America,W_AM,72752,3338,1013601796,America,4212320,215737
2020-06-20,America,W_AM,112668,3335,1013601796,America,4324988,219072
2020-06-21,America,W_AM,90957,2711,1013601796,America,4415945,221783
2020-06-22,America,W_AM,64221,2564,1013601796,America,4480166,224347
2020-06-23,America,W_AM,73451,2098,1013601796,America,4553617,226445
2020-06-24,America,W_AM,98335,3634,1013601796,America,4651952,230079
2020-06-25,America,W_AM,104664,3606,1013601796,America,4756616,233685
2020-06-26,America,W_AM,107436,5005,1013601796,America,4864052,238690
2020-06-27,America,W_AM,115845,3096,1013601796,America,4979897,241786
2020-06-28,America,W_AM,109030,2997,1013601796,America,5088927,244783
2020-06-29,America,W_AM,88849,1725,1013601796,America,5177776,246508
2020-06-30,America,W_AM,93140,2164,1013601796,America,5270916,248672
2020-07-01,America,W_AM,102705,3813,1013601796,America,5373621,252485
2020-07-02,America,W_AM,126279,3114,1013601796,America,5499900,255599
2020-07-03,America,W_AM,128921,3474,1013601796,America,5628821,259073
2020-07-04,America,W_AM,124911,3384,1013601796,America,5753732,262457
2020-07-05,America,W_AM,105193,2608,1013601796,America,5858925,265065
2020-07-06,America,W_AM,99194,1759,1013601796,America,5958119,266824
2020-07-07,America,W_AM,96515,2088,1013601796,America,6054634,268912
2020-07-08,America,W_AM,129870,4018,1013601796,America,6184504,272930
2020-07-09,America,W_AM,130998,3590,1013601796,America,6315502,276520
2020-07-10,America,W_AM,135868,3670,1013601796,America,6451370,280190
2020-07-11,America,W_AM,143695,3503,1013601796,America,6595065,283693
2020-07-12,America,W_AM,128167,3103,1013601796,America,6723232,286796
2020-07-13,America,W_AM,107713,1963,1013601796,America,6830945,288759
2020-07-14,America,W_AM,106944,2210,1013601796,America,6937889,290969
2020-07-15,America,W_AM,141315,3690,1013601796,America,7079204,294659
2020-07-16,America,W_AM,139783,3607,1013601796,America,7218987,298266
2020-07-17,America,W_AM,158247,3731,1013601796,America,7377234,301997
2020-07-18,America,W_AM,142288,4580,1013601796,America,7519522,306577
2020-07-19,America,W_AM,128361,3153,1013601796,America,7647883,309730
2020-07-20,America,W_AM,113774,2138,1013601796,America,7761657,311868
2020-07-21,America,W_AM,110963,2145,1013601796,America,7872620,314013
2020-07-22,America,W_AM,147946,4182,1013601796,America,8020566,318195
2020-07-23,America,W_AM,172314,3983,1013601796,America,8192880,322178
2020-07-24,America,W_AM,161299,7740,1013601796,America,8354179,329918
2020-07-25,America,W_AM,172457,4152,1013601796,America,8526636,334070
2020-07-26,America,W_AM,149869,3775,1013601796,America,8676505,337845
2020-07-27,America,W_AM,117951,2180,1013601796,America,8794456,340025
2020-07-28,America,W_AM,111683,2775,1013601796,America,8906139,342800
2020-07-29,America,W_AM,139519,3989,1013601796,America,9045658,346789
2020-07-30,America,W_AM,183371,4602,1013601796,America,9229029,351391
2020-07-31,America,W_AM,168501,4191,1013601796,America,9397530,355582
2020-08-01,America,W_AM,161293,4156,1013601796,America,9558823,359738
2020-08-02,America,W_AM,144232,3861,1013601796,America,9703055,363599
2020-08-03,America,W_AM,108821,2089,1013601796,America,9811876,365688
2020-08-04,America,W_AM,97792,2270,1013601796,America,9909668,367958
2020-08-05,America,W_AM,146562,4430,1013601796,America,10056230,372388
2020-08-06,America,W_AM,153945,4702,1013601796,America,10210175,377090
2020-08-07,America,W_AM,158312,4919,1013601796,America,10368487,382009
2020-08-08,America,W_AM,153422,4115,1013601796,America,10521909,386124
2020-08-09,America,W_AM,144853,3569,1013601796,America,10666762,389693
2020-08-10,America,W_AM,107305,2286,1013601796,America,10774067,391979
2020-08-11,America,W_AM,108030,2765,1013601796,America,10882097,394744
2020-08-12,America,W_AM,144804,4197,1013601796,America,11026901,398941
2020-08-13,America,W_AM,157910,4556,1013601796,America,11184811,403497
2020-08-14,America,W_AM,156969,7631,1013601796,America,11341780,411128
2020-08-15,America,W_AM,161367,4002,1013601796,America,11503147,415130
2020-08-16,America,W_AM,133793,3417,1013601796,America,11636940,418547
2020-08-17,America,W_AM,106332,2206,1013601796,America,11743272,420753
2020-08-18,America,W_AM,89149,2214,1013601796,America,11832421,422967
2020-08-19,America,W_AM,134009,4240,1013601796,America,11966430,427207
2020-08-20,America,W_AM,144202,4319,1013601796,America,12110632,431526
2020-08-21,America,W_AM,132138,3942,1013601796,America,12242770,435468
2020-08-22,America,W_AM,123873,3774,1013601796,America,12366643,439242
2020-08-23,America,W_AM,136275,3646,1013601796,America,12502918,442888
2020-08-24,America,W_AM,94224,2044,1013601796,America,12597142,444932
2020-08-25,America,W_AM,93881,2313,1013601796,America,12691023,447245
2020-08-26,America,W_AM,127090,4199,1013601796,America,12818113,451444
2020-08-27,America,W_AM,131843,3936,1013601796,America,12949956,455380
2020-08-28,America,W_AM,137211,3725,1013601796,America,13087167,459105
2020-08-29,America,W_AM,137844,3326,1013601796,America,13225011,462431
2020-08-30,America,W_AM,130236,3568,1013601796,America,13355247,465999
2020-08-31,America,W_AM,87006,1768,1013601796,America,13442253,467767
2020-09-01,America,W_AM,114600,2130,1013601796,America,13556853,469897
2020-09-02,America,W_AM,127774,4154,1013601796,America,13684627,474051
2020-09-03,America,W_AM,129444,3858,1013601796,America,13814071,477909
2020-09-04,America,W_AM,122248,3263,1013601796,America,13936319,481172
2020-09-05,America,W_AM,146019,3505,1013601796,America,14082338,484677
2020-09-06,America,W_AM,115479,3094,1013601796,America,14197817,487771
2020-09-07,America,W_AM,70115,6926,1013601796,America,14267932,494697
2020-09-08,America,W_AM,64223,1532,1013601796,America,14332155,496229
2020-09-09,America,W_AM,80162,2561,1013601796,America,14412317,498790
2020-09-10,America,W_AM,111001,3704,1013601796,America,14523318,502494
2020-09-11,America,W_AM,121846,3403,1013601796,America,14645164,505897
2020-09-12,America,W_AM,134262,3612,1013601796,America,14779426,509509
2020-09-13,America,W_AM,114625,2712,1013601796,America,14894051,512221
2020-09-14,America,W_AM,85283,1639,1013601796,America,14979334,513860
2020-09-15,America,W_AM,85454,1724,1013601796,America,15064788,515584
2020-09-16,America,W_AM,122491,3955,1013601796,America,15187279,519539
2020-09-17,America,W_AM,101577,2881,1013601796,America,15288856,522420
2020-09-18,America,W_AM,121251,2768,1013601796,America,15410107,525188
2020-09-19,America,W_AM,134017,3320,1013601796,America,15544124,528508
2020-09-20,America,W_AM,115082,2641,1013601796,America,15659206,531149
2020-09-21,America,W_AM,88209,1391,1013601796,America,15747415,532540
2020-09-22,America,W_AM,109384,2006,1013601796,America,15856799,534546
2020-09-23,America,W_AM,110004,3385,1013601796,America,15966803,537931
2020-09-24,America,W_AM,113718,3693,1013601796,America,16080521,541624
2020-09-25,America,W_AM,120766,3177,1013601796,America,16201287,544801
2020-09-26,America,W_AM,131386,3071,1013601796,America,16332673,547872
2020-09-27,America,W_AM,112081,2887,1013601796,America,16444754,550759
2020-09-28,America,W_AM,82579,1462,1013601796,America,16527333,552221
2020-09-29,America,W_AM,83566,1596,1013601796,America,16610899,553817
2020-09-30,America,W_AM,114059,3253,1013601796,America,16724958,557070
2020-10-01,America,W_AM,115386,3320,1013601796,America,16840344,560390
2020-10-02,America,W_AM,120998,5986,1013601796,America,16961342,566376
2020-10-03,America,W_AM,127924,2956,1013601796,America,17089266,569332
2020-10-04,America,W_AM,111204,2437,1013601796,America,17200470,571769
2020-10-05,America,W_AM,73231,1670,1013601796,America,17273701,573439
2020-10-06,America,W_AM,89235,1839,1013601796,America,17362936,575278
2020-10-07,America,W_AM,126616,2801,1013601796,America,17489552,578079
2020-10-08,America,W_AM,122709,2893,1013601796,America,17612261,580972
2020-10-09,America,W_AM,128852,6075,1013601796,America,17741113,587047
2020-10-10,America,W_AM,130668,3105,1013601796,America,17871781,590152
2020-10-11,America,W_AM,116543,2070,1013601796,America,17988324,592222
2020-10-12,America,W_AM,86549,1364,1013601796,America,18074873,593586
2020-10-13,America,W_AM,86517,1593,1013601796,America,18161390,595179
2020-10-14,America,W_AM,100068,2382,1013601796,America,18261458,597561
2020-10-15,America,W_AM,125343,2982,1013601796,America,18386801,600543
2020-10-16,America,W_AM,131739,2818,1013601796,America,18518540,603361
2020-10-17,America,W_AM,140135,2987,1013601796,America,18658675,606348
2020-10-18,America,W_AM,117538,2368,1013601796,America,18776213,608716
2020-10-19,America,W_AM,90581,1265,1013601796,America,18866794,609981
2020-10-20,America,W_AM,111039,1720,1013601796,America,18977833,611701
2020-10-21,America,W_AM,126033,2925,1013601796,America,19103866,614626
2020-10-22,America,W_AM,134502,3136,1013601796,America,19238368,617762
2020-10-23,America,W_AM,142348,2759,1013601796,America,19380716,620521
2020-10-24,America,W_AM,163098,2748,1013601796,America,19543814,623269
2020-10-25,America,W_AM,151430,2504,1013601796,America,19695244,625773
2020-10-26,America,W_AM,107325,1425,1013601796,America,19802569,627198
2020-10-27,America,W_AM,122084,1850,1013601796,America,19924653,629048
2020-10-28,America,W_AM,145162,3056,1013601796,America,20069815,632104
2020-10-29,America,W_AM,148901,2767,1013601796,America,20218716,634871
2020-10-30,America,W_AM,159001,2781,1013601796,America,20377717,637652
2020-10-31,America,W_AM,168863,2861,1013601796,America,20546580,640513
2020-11-01,America,W_AM,137950,2381,1013601796,America,20684530,642894
2020-11-02,America,W_AM,122885,1326,1013601796,America,20807415,644220
2020-11-03,America,W_AM,127560,1818,1013601796,America,20934975,646038
2020-11-04,America,W_AM,141388,2653,1013601796,America,21076363,648691
2020-11-05,America,W_AM,163312,3210,1013601796,America,21239675,651901
2020-11-06,America,W_AM,185980,3115,1013601796,America,21425655,655016
2020-11-07,America,W_AM,195968,2865,1013601796,America,21621623,657881
2020-11-08,America,W_AM,179060,2417,1013601796,America,21800683,660298
2020-11-09,America,W_AM,153743,1420,1013601796,America,21954426,661718
2020-11-10,America,W_AM,179789,1893,1013601796,America,22134215,663611
2020-11-11,America,W_AM,210745,2943,1013601796,America,22344960,666554
2020-11-12,America,W_AM,232233,4046,1013601796,America,22577193,670600
2020-11-13,America,W_AM,230810,2890,1013601796,America,22808003,673490
2020-11-14,America,W_AM,256806,3678,1013601796,America,23064809,677168
2020-11-15,America,W_AM,242005,3531,1013601796,America,23306814,680699
2020-11-16,America,W_AM,177041,1616,1013601796,America,23483855,682315
2020-11-17,America,W_AM,213704,2287,1013601796,America,23697559,684602
2020-11-18,America,W_AM,221192,3076,1013601796,America,23918751,687678
2020-11-19,America,W_AM,240138,3901,1013601796,America,24158889,691579
2020-11-20,America,W_AM,261706,3911,1013601796,America,24420595,695490
2020-11-21,America,W_AM,273839,3805,1013601796,America,24694434,699295
2020-11-22,America,W_AM,244742,3005,1013601796,America,24939176,702300
2020-11-23,America,W_AM,213218,1904,1013601796,America,25152394,704204
2020-11-24,America,W_AM,225357,2062,1013601796,America,25377751,706266
2020-11-25,America,W_AM,241100,4492,1013601796,America,25618851,710758
2020-11-26,America,W_AM,277712,4586,1013601796,America,25896563,715344
2020-11-27,America,W_AM,188688,3295,1013601796,America,26085251,718639
2020-11-28,America,W_AM,279377,2704,1013601796,America,26364628,721343
2020-11-29,America,W_AM,261560,3557,1013601796,America,26626188,724900
2020-11-30,America,W_AM,196761,1891,1013601796,America,26822949,726791
2020-12-01,America,W_AM,218356,2524,1013601796,America,27041305,729315
2020-12-02,America,W_AM,271916,4800,1013601796,America,27313221,734115
2020-12-03,America,W_AM,299768,5423,1013601796,America,27612989,739538
2020-12-04,America,W_AM,313158,4553,1013601796,America,27926147,744091
2020-12-05,America,W_AM,325436,4841,1013601796,America,28251583,748932
2020-12-06,America,W_AM,301391,4077,1013601796,America,28552974,753009
2020-12-07,America,W_AM,236855,2253,1013601796,America,28789829,755262
2020-12-08,America,W_AM,252880,2808,1013601796,America,29042709,758070
2020-12-09,America,W_AM,298869,4802,1013601796,America,29341578,762872
2020-12-10,America,W_AM,325238,5429,1013601796,America,29666816,768301
2020-12-11,America,W_AM,325486,5010,1013601796,America,29992302,773311
2020-12-12,America,W_AM,339515,5385,1013601796,America,30331817,778696
2020-12-13,America,W_AM,304854,4291,1013601796,America,30636671,782987
2020-12-14,America,W_AM,250922,2433,1013601796,America,30887593,785420
2019-12-31,Asia,W_AS,27,0,4066695618,Asia,27,0
2020-01-01,Asia,W_AS,0,0,4066695618,Asia,27,0
2020-01-02,Asia,W_AS,0,0,4066695618,Asia,27,0
2020-01-03,Asia,W_AS,17,0,4066695618,Asia,44,0
2020-01-04,Asia,W_AS,0,0,4066695618,Asia,44,0
2020-01-05,Asia,W_AS,15,0,4066695618,Asia,59,0
2020-01-06,Asia,W_AS,0,0,4066695618,Asia,59,0
2020-01-07,Asia,W_AS,0,0,4066695618,Asia,59,0
2020-01-08,Asia,W_AS,0,0,4066695618,Asia,59,0
2020-01-09,Asia,W_AS,0,0,4066695618,Asia,59,0
2020-01-10,Asia,W_AS,0,0,4066695618,Asia,59,0
2020-01-11,Asia,W_AS,0,1,4066695618,Asia,59,1
2020-01-12,Asia,W_AS,0,0,4066695618,Asia,59,1
2020-01-13,Asia,W_AS,1,0,4066695618,Asia,60,1
2020-01-14,Asia,W_AS,0,0,4066695618,Asia,60,1
2020-01-15,Asia,W_AS,1,1,4066695618,Asia,61,2
2020-01-16,Asia,W_AS,0,0,4066695618,Asia,61,2
2020-01-17,Asia,W_AS,5,0,4066695618,Asia,66,2
2020-01-18,Asia,W_AS,17,0,4066695618,Asia,83,2
2020-01-19,Asia,W_AS,136,1,4066695618,Asia,219,3
2020-01-20,Asia,W_AS,20,0,4066695618,Asia,239,3
2020-01-21,Asia,W_AS,152,3,4066695618,Asia,391,6
2020-01-22,Asia,W_AS,142,11,4066695618,Asia,533,17
2020-01-23,Asia,W_AS,97,0,4066695618,Asia,630,17
2020-01-24,Asia,W_AS,266,9,4066695618,Asia,896,26
2020-01-25,Asia,W_AS,448,15,4066695618,Asia,1344,41
2020-01-26,Asia,W_AS,669,15,4066695618,Asia,2013,56
2020-01-27,Asia,W_AS,794,25,4066695618,Asia,2807,81
2020-01-28,Asia,W_AS,1765,25,4066695618,Asia,4572,106
2020-01-29,Asia,W_AS,1475,26,4066695618,Asia,6047,132
2020-01-30,Asia,W_AS,1752,38,4066695618,Asia,7799,170
2020-01-31,Asia,W_AS,1994,43,4066695618,Asia,9793,213
2020-02-01,Asia,W_AS,2110,46,4066695618,Asia,11903,259
2020-02-02,Asia,W_AS,2604,46,4066695618,Asia,14507,305
2020-02-03,Asia,W_AS,2814,57,4066695618,Asia,17321,362
2020-02-04,Asia,W_AS,3240,65,4066695618,Asia,20561,427
2020-02-05,Asia,W_AS,3895,66,4066695618,Asia,24456,493
2020-02-06,Asia,W_AS,3739,72,4066695618,Asia,28195,565
2020-02-07,Asia,W_AS,3172,73,4066695618,Asia,31367,638
2020-02-08,Asia,W_AS,3433,86,4066695618,Asia,34800,724
2020-02-09,Asia,W_AS,2618,89,4066695618,Asia,37418,813
2020-02-10,Asia,W_AS,2981,97,4066695618,Asia,40399,910
2020-02-11,Asia,W_AS,2495,108,4066695618,Asia,42894,1018
2020-02-12,Asia,W_AS,2031,97,4066695618,Asia,44925,1115
2020-02-13,Asia,W_AS,15149,255,4066695618,Asia,60074,1370
2020-02-14,Asia,W_AS,4166,13,4066695618,Asia,64240,1383
2020-02-15,Asia,W_AS,2558,143,4066695618,Asia,66798,1526
2020-02-16,Asia,W_AS,2028,142,4066695618,Asia,68826,1668
2020-02-17,Asia,W_AS,2066,106,4066695618,Asia,70892,1774
2020-02-18,Asia,W_AS,1896,98,4066695618,Asia,72788,1872
2020-02-19,Asia,W_AS,1776,139,4066695618,Asia,74564,2011
2020-02-20,Asia,W_AS,453,114,4066695618,Asia,75017,2125
2020-02-21,Asia,W_AS,979,119,4066695618,Asia,75996,2244
2020-02-22,Asia,W_AS,1048,112,4066695618,Asia,77044,2356
2020-02-23,Asia,W_AS,945,102,4066695618,Asia,77989,2458
2020-02-24,Asia,W_AS,413,155,4066695618,Asia,78402,2613
2020-02-25,Asia,W_AS,675,75,4066695618,Asia,79077,2688
2020-02-26,Asia,W_AS,756,58,4066695618,Asia,79833,2746
2020-02-27,Asia,W_AS,985,36,4066695618,Asia,80818,2782
2020-02-28,Asia,W_AS,920,52,4066695618,Asia,81738,2834
2020-02-29,Asia,W_AS,1525,58,4066695618,Asia,83263,2892
2020-03-01,Asia,W_AS,1401,48,4066695618,Asia,84664,2940
2020-03-02,Asia,W_AS,1326,59,4066695618,Asia,85990,2999
2020-03-03,Asia,W_AS,1273,50,3190496978,Asia,87263,3049
2020-03-04,Asia,W_AS,1514,52,3392847841,Asia,88777,3101
2020-03-05,Asia,W_AS,1253,49,3246799873,Asia,90030,3150
2020-03-06,Asia,W_AS,1348,54,3238020649,Asia,91378,3204
2020-03-07,Asia,W_AS,1959,47,3908953908,Asia,93337,3251
2020-03-08,Asia,W_AS,1622,54,3497998608,Asia,94959,3305
2020-03-09,Asia,W_AS,1164,78,2492726357,Asia,96123,3383
2020-03-10,Asia,W_AS,913,65,3617062973,Asia,97036,3448
2020-03-11,Asia,W_AS,1335,86,4040057535,Asia,98371,3534
2020-03-12,Asia,W_AS,1623,88,4025513832,Asia,99994,3622
2020-03-13,Asia,W_AS,1369,88,3687451854,Asia,101363,3710
2020-03-14,Asia,W_AS,1813,116,4007146573,Asia,103176,3826
2020-03-15,Asia,W_AS,1791,111,4302597380,Asia,104967,3937
2020-03-16,Asia,W_AS,1928,135,4139935947,Asia,106895,4072
2020-03-17,Asia,W_AS,1757,150,4386399351,Asia,108652,4222
2020-03-18,Asia,W_AS,1865,162,4335579095,Asia,110517,4384
2020-03-19,Asia,W_AS,1965,166,4341994946,Asia,112482,4550
2020-03-20,Asia,W_AS,2214,184,4341994946,Asia,114696,4734
2020-03-21,Asia,W_AS,2211,171,4341994946,Asia,116907,4905
2020-03-22,Asia,W_AS,2663,162,4343288066,Asia,119570,5067
2020-03-23,Asia,W_AS,2402,178,4360358198,Asia,121972,5245
2020-03-24,Asia,W_AS,2903,165,4414403620,Asia,124875,5410
2020-03-25,Asia,W_AS,3689,152,4421573076,Asia,128564,5562
2020-03-26,Asia,W_AS,4022,177,4421573076,Asia,132586,5739
2020-03-27,Asia,W_AS,4116,223,4421573076,Asia,136702,5962
2020-03-28,Asia,W_AS,4884,186,4421573076,Asia,141586,6148
2020-03-29,Asia,W_AS,5598,207,4421573076,Asia,147184,6355
2020-03-30,Asia,W_AS,5363,178,4421573076,Asia,152547,6533
2020-03-31,Asia,W_AS,5760,181,4421573076,Asia,158307,6714
2020-04-01,Asia,W_AS,5002,188,4421573076,Asia,163309,6902
2020-04-02,Asia,W_AS,6326,217,4421573076,Asia,169635,7119
2020-04-03,Asia,W_AS,6130,213,4421573076,Asia,175765,7332
2020-04-04,Asia,W_AS,3616,79,4421573076,Asia,179381,7411
2020-04-05,Asia,W_AS,8957,367,4416591654,Asia,188338,7778
2020-04-06,Asia,W_AS,6926,251,4421573076,Asia,195264,8029
2020-04-07,Asia,W_AS,6212,203,4421573076,Asia,201476,8232
2020-04-08,Asia,W_AS,5868,239,4421573076,Asia,207344,8471
2020-04-09,Asia,W_AS,5405,203,4421573076,Asia,212749,8674
2020-04-10,Asia,W_AS,6120,252,4450734998,Asia,218869,8926
2020-04-11,Asia,W_AS,6164,232,4450734998,Asia,225033,9158
2020-04-12,Asia,W_AS,7163,282,4450734998,Asia,232196,9440
2020-04-13,Asia,W_AS,6610,291,4450734998,Asia,238806,9731
2020-04-14,Asia,W_AS,7555,242,4450734998,Asia,246361,9973
2020-04-15,Asia,W_AS,7001,278,4450734998,Asia,253362,10251
2020-04-16,Asia,W_AS,7003,224,4450734998,Asia,260365,10475
2020-04-17,Asia,W_AS,8050,1505,4450734998,Asia,268415,11980
2020-04-18,Asia,W_AS,7800,237,4450734998,Asia,276215,12217
2020-04-19,Asia,W_AS,8389,182,4450734998,Asia,284604,12399
2020-04-20,Asia,W_AS,8229,247,4450734998,Asia,292833,12646
2020-04-21,Asia,W_AS,9385,226,4450734998,Asia,302218,12872
2020-04-22,Asia,W_AS,8528,225,4450734998,Asia,310746,13097
2020-04-23,Asia,W_AS,8279,308,4450734998,Asia,319025,13405
2020-04-24,Asia,W_AS,10277,243,4450734998,Asia,329302,13648
2020-04-25,Asia,W_AS,9822,270,4450734998,Asia,339124,13918
2020-04-26,Asia,W_AS,9451,248,4450734998,Asia,348575,14166
2020-04-27,Asia,W_AS,8965,180,4450734998,Asia,357540,14346
2020-04-28,Asia,W_AS,8866,266,4450734998,Asia,366406,14612
2020-04-29,Asia,W_AS,9193,242,4450734998,Asia,375599,14854
2020-04-30,Asia,W_AS,9767,268,4450734998,Asia,385366,15122
2020-05-01,Asia,W_AS,10239,259,4460056021,Asia,395605,15381
2020-05-02,Asia,W_AS,11025,244,4460056021,Asia,406630,15625
2020-05-03,Asia,W_AS,10014,298,4460056021,Asia,416644,15923
2020-05-04,Asia,W_AS,10855,227,4460056021,Asia,427499,16150
2020-05-05,Asia,W_AS,12704,380,4460056021,Asia,440203,16530
2020-05-06,Asia,W_AS,12199,311,4460056021,Asia,452402,16841
2020-05-07,Asia,W_AS,13833,305,4460056021,Asia,466235,17146
2020-05-08,Asia,W_AS,13515,313,4460056021,Asia,479750,17459
2020-05-09,Asia,W_AS,13874,284,4460056021,Asia,493624,17743
2020-05-10,Asia,W_AS,14364,288,4460056021,Asia,507988,18031
2020-05-11,Asia,W_AS,15640,270,4460056021,Asia,523628,18301
2020-05-12,Asia,W_AS,14193,265,4460056021,Asia,537821,18566
2020-05-13,Asia,W_AS,16550,314,4460056021,Asia,554371,18880
2020-05-14,Asia,W_AS,16255,333,4460056021,Asia,570626,19213
2020-05-15,Asia,W_AS,16689,311,4460056021,Asia,587315,19524
2020-05-16,Asia,W_AS,18090,327,4460056021,Asia,605405,19851
2020-05-17,Asia,W_AS,17816,298,4460056021,Asia,623221,20149
2020-05-18,Asia,W_AS,19337,359,4460056021,Asia,642558,20508
2020-05-19,Asia,W_AS,19198,358,4460056021,Asia,661756,20866
2020-05-20,Asia,W_AS,20066,352,4460056021,Asia,681822,21218
2020-05-21,Asia,W_AS,21399,318,4460056021,Asia,703221,21536
2020-05-22,Asia,W_AS,22877,386,4460056021,Asia,726098,21922
2020-05-23,Asia,W_AS,22501,369,4460056021,Asia,748599,22291
2020-05-24,Asia,W_AS,23177,359,4460056021,Asia,771776,22650
2020-05-25,Asia,W_AS,21716,352,4460056021,Asia,793492,23002
2020-05-26,Asia,W_AS,20632,309,4460056021,Asia,814124,23311
2020-05-27,Asia,W_AS,19491,369,4460056021,Asia,833615,23680
2020-05-28,Asia,W_AS,21248,421,4460056021,Asia,854863,24101
2020-05-29,Asia,W_AS,24697,421,4460056021,Asia,879560,24522
2020-05-30,Asia,W_AS,26864,531,4460056021,Asia,906424,25053
2020-05-31,Asia,W_AS,26259,497,4460056021,Asia,932683,25550
2020-06-01,Asia,W_AS,27267,512,4460056021,Asia,959950,26062
2020-06-02,Asia,W_AS,26918,485,4460056021,Asia,986868,26547
2020-06-03,Asia,W_AS,29115,505,4460056021,Asia,1015983,27052
2020-06-04,Asia,W_AS,31136,594,4460056021,Asia,1047119,27646
2020-06-05,Asia,W_AS,30386,559,4460056021,Asia,1077505,28205
2020-06-06,Asia,W_AS,31713,628,4460056021,Asia,1109218,28833
2020-06-07,Asia,W_AS,31876,614,4460056021,Asia,1141094,29447
2020-06-08,Asia,W_AS,31940,566,4460056021,Asia,1173034,30013
2020-06-09,Asia,W_AS,31217,684,4460056021,Asia,1204251,30697
2020-06-10,Asia,W_AS,32580,643,4460056021,Asia,1236831,31340
2020-06-11,Asia,W_AS,34248,735,4460056021,Asia,1271079,32075
2020-06-12,Asia,W_AS,35393,787,4460056021,Asia,1306472,32862
2020-06-13,Asia,W_AS,37787,782,4460056021,Asia,1344259,33644
2020-06-14,Asia,W_AS,36694,711,4460056021,Asia,1380953,34355
2020-06-15,Asia,W_AS,35333,768,4460056021,Asia,1416286,35123
2020-06-16,Asia,W_AS,34212,872,4460056021,Asia,1450498,35995
2020-06-17,Asia,W_AS,36339,2500,4460056021,Asia,1486837,38495
2020-06-18,Asia,W_AS,38612,839,4460056021,Asia,1525449,39334
2020-06-19,Asia,W_AS,39367,871,4460056021,Asia,1564816,40205
2020-06-20,Asia,W_AS,40326,911,4460056021,Asia,1605142,41116
2020-06-21,Asia,W_AS,39661,835,4460056021,Asia,1644803,41951
2020-06-22,Asia,W_AS,37327,908,4460056021,Asia,1682130,42859
2020-06-23,Asia,W_AS,38138,768,4460056021,Asia,1720268,43627
2020-06-24,Asia,W_AS,39534,909,4460056021,Asia,1759802,44536
2020-06-25,Asia,W_AS,42120,970,4460056021,Asia,1801922,45506
2020-06-26,Asia,W_AS,41372,919,4460056021,Asia,1843294,46425
2020-06-27,Asia,W_AS,43729,791,4460056021,Asia,1887023,47216
2020-06-28,Asia,W_AS,43977,1011,4460056021,Asia,1931000,48227
2020-06-29,Asia,W_AS,44181,853,4460056021,Asia,1975181,49080
2020-06-30,Asia,W_AS,41990,999,4460056021,Asia,2017171,50079
2020-07-01,Asia,W_AS,63572,1093,4460056021,Asia,2080743,51172
2020-07-02,Asia,W_AS,46382,973,4460056021,Asia,2127125,52145
2020-07-03,Asia,W_AS,48845,936,4460056021,Asia,2175970,53081
2020-07-04,Asia,W_AS,50073,960,4460056021,Asia,2226043,54041
2020-07-05,Asia,W_AS,51655,1158,4460056021,Asia,2277698,55199
2020-07-06,Asia,W_AS,47752,1016,4460056021,Asia,2325450,56215
2020-07-07,Asia,W_AS,51099,1157,4460056021,Asia,2376549,57372
2020-07-08,Asia,W_AS,47708,1116,4460056021,Asia,2424257,58488
2020-07-09,Asia,W_AS,53833,980,4460056021,Asia,2478090,59468
2020-07-10,Asia,W_AS,53747,1081,4460056021,Asia,2531837,60549
2020-07-11,Asia,W_AS,54191,1057,4460056021,Asia,2586028,61606
2020-07-12,Asia,W_AS,53393,1090,4460056021,Asia,2639421,62696
2020-07-13,Asia,W_AS,54183,1396,4460056021,Asia,2693604,64092
2020-07-14,Asia,W_AS,53641,1117,4460056021,Asia,2747245,65209
2020-07-15,Asia,W_AS,53646,1148,4460056021,Asia,2800891,66357
2020-07-16,Asia,W_AS,58742,1203,4460056021,Asia,2859633,67560
2020-07-17,Asia,W_AS,60839,1276,4460056021,Asia,2920472,68836
2020-07-18,Asia,W_AS,70744,1986,4460056021,Asia,2991216,70822
2020-07-19,Asia,W_AS,64848,1256,4460056021,Asia,3056064,72078
2020-07-20,Asia,W_AS,63148,1360,4460056021,Asia,3119212,73438
2020-07-21,Asia,W_AS,61329,1413,4460056021,Asia,3180541,74851
2020-07-22,Asia,W_AS,64063,1250,4460056021,Asia,3244604,76101
2020-07-23,Asia,W_AS,71913,1809,4460056021,Asia,3316517,77910
2020-07-24,Asia,W_AS,74858,1411,4460056021,Asia,3391375,79321
2020-07-25,Asia,W_AS,73778,1356,4460056021,Asia,3465153,80677
2020-07-26,Asia,W_AS,73339,1240,4460056021,Asia,3538492,81917
2020-07-27,Asia,W_AS,72245,1299,4460056021,Asia,3610737,83216
2020-07-28,Asia,W_AS,70955,1189,4460056021,Asia,3681692,84405
2020-07-29,Asia,W_AS,74240,1509,4460056021,Asia,3755932,85914
2020-07-30,Asia,W_AS,77887,1274,4460056021,Asia,3833819,87188
2020-07-31,Asia,W_AS,81802,1365,4460056021,Asia,3915621,88553
2020-08-01,Asia,W_AS,80021,1246,4460056021,Asia,3995642,89799
2020-08-02,Asia,W_AS,82904,1318,4460056021,Asia,4078546,91117
2020-08-03,Asia,W_AS,77127,1543,4460056021,Asia,4155673,92660
2020-08-04,Asia,W_AS,74062,1324,4460056021,Asia,4229735,93984
2020-08-05,Asia,W_AS,80289,1412,4460056021,Asia,4310024,95396
2020-08-06,Asia,W_AS,83733,1446,4460056021,Asia,4393757,96842
2020-08-07,Asia,W_AS,89379,1205,4460056021,Asia,4483136,98047
2020-08-08,Asia,W_AS,88174,1564,4460056021,Asia,4571310,99611
2020-08-09,Asia,W_AS,89950,1321,4460056021,Asia,4661260,100932
2020-08-10,Asia,W_AS,82934,1839,4460056021,Asia,4744194,102771
2020-08-11,Asia,W_AS,80088,1349,4460056021,Asia,4824282,104120
2020-08-12,Asia,W_AS,86745,1354,4460056021,Asia,4911027,105474
2020-08-13,Asia,W_AS,92824,1516,4460056021,Asia,5003851,106990
2020-08-14,Asia,W_AS,90418,1482,4460056021,Asia,5094269,108472
2020-08-15,Asia,W_AS,94311,1488,4460056021,Asia,5188580,109960
2020-08-16,Asia,W_AS,90129,1524,4460056021,Asia,5278709,111484
2020-08-17,Asia,W_AS,78192,1448,4460056021,Asia,5356901,112932
2020-08-18,Asia,W_AS,79509,1510,4460056021,Asia,5436410,114442
2020-08-19,Asia,W_AS,91248,1575,4460056021,Asia,5527658,116017
2020-08-20,Asia,W_AS,94486,1478,4460056021,Asia,5622144,117495
2020-08-21,Asia,W_AS,98553,1697,4460056021,Asia,5720697,119192
2020-08-22,Asia,W_AS,94918,1419,4460056021,Asia,5815615,120611
2020-08-23,Asia,W_AS,94794,1386,4460056021,Asia,5910409,121997
2020-08-24,Asia,W_AS,79067,833,4460056021,Asia,5989476,122830
2020-08-25,Asia,W_AS,84793,1360,4460056021,Asia,6074269,124190
2020-08-26,Asia,W_AS,90725,1553,4460056021,Asia,6164994,125743
2020-08-27,Asia,W_AS,101769,1577,4460056021,Asia,6266763,127320
2020-08-28,Asia,W_AS,104178,1732,4460056021,Asia,6370941,129052
2020-08-29,Asia,W_AS,102392,1547,4460056021,Asia,6473333,130599
2020-08-30,Asia,W_AS,102551,1448,4460056021,Asia,6575884,132047
2020-08-31,Asia,W_AS,100348,1497,4460056021,Asia,6676232,133544
2020-09-01,Asia,W_AS,94106,1255,4460056021,Asia,6770338,134799
2020-09-02,Asia,W_AS,101424,1641,4460056021,Asia,6871762,136440
2020-09-03,Asia,W_AS,108920,1530,4460056021,Asia,6980682,137970
2020-09-04,Asia,W_AS,109455,1645,4460056021,Asia,7090137,139615
2020-09-05,Asia,W_AS,107395,1498,4460056021,Asia,7197532,141113
2020-09-06,Asia,W_AS,119788,1591,4460056021,Asia,7317320,142704
2020-09-07,Asia,W_AS,113428,1533,4460056021,Asia,7430748,144237
2020-09-08,Asia,W_AS,101070,1626,4460056021,Asia,7531818,145863
2020-09-09,Asia,W_AS,116342,1653,4460056021,Asia,7648160,147516
2020-09-10,Asia,W_AS,123176,1701,4460056021,Asia,7771336,149217
2020-09-11,Asia,W_AS,126451,1782,4460056021,Asia,7897787,150999
2020-09-12,Asia,W_AS,124997,1649,4460056021,Asia,8022784,152648
2020-09-13,Asia,W_AS,124194,1724,4460056021,Asia,8146978,154372
2020-09-14,Asia,W_AS,119113,1648,4460056021,Asia,8266091,156020
2020-09-15,Asia,W_AS,112357,1829,4460056021,Asia,8378448,157849
2020-09-16,Asia,W_AS,122166,1871,4460056021,Asia,8500614,159720
2020-09-17,Asia,W_AS,129077,1754,4460056021,Asia,8629691,161474
2020-09-18,Asia,W_AS,127377,1756,4460056021,Asia,8757068,163230
2020-09-19,Asia,W_AS,120899,1797,4460056021,Asia,8877967,165027
2020-09-20,Asia,W_AS,122967,1747,4460056021,Asia,9000934,166774
2020-09-21,Asia,W_AS,116734,1712,4460056021,Asia,9117668,168486
2020-09-22,Asia,W_AS,104703,1605,4460056021,Asia,9222371,170091
2020-09-23,Asia,W_AS,109921,1700,4460056021,Asia,9332292,171791
2020-09-24,Asia,W_AS,125671,1766,4460056021,Asia,9457963,173557
2020-09-25,Asia,W_AS,122513,1721,4460056021,Asia,9580476,175278
2020-09-26,Asia,W_AS,112594,1693,4460056021,Asia,9693070,176971
2020-09-27,Asia,W_AS,125646,1725,4460056021,Asia,9818716,178696
2020-09-28,Asia,W_AS,111651,1633,4460056021,Asia,9930367,180329
2020-09-29,Asia,W_AS,98472,1358,4460056021,Asia,10028839,181687
2020-09-30,Asia,W_AS,110812,1859,4460056021,Asia,10139651,183546
2020-10-01,Asia,W_AS,122450,1744,4460056021,Asia,10262101,185290
2020-10-02,Asia,W_AS,120271,1775,4460056021,Asia,10382372,187065
2020-10-03,Asia,W_AS,110539,1671,4460056021,Asia,10492911,188736
2020-10-04,Asia,W_AS,108376,1505,4460056021,Asia,10601287,190241
2020-10-05,Asia,W_AS,105706,1575,4460056021,Asia,10706993,191816
2020-10-06,Asia,W_AS,93335,1556,4460056021,Asia,10800328,193372
2020-10-07,Asia,W_AS,105874,1658,4460056021,Asia,10906202,195030
2020-10-08,Asia,W_AS,114580,1658,4460056021,Asia,11020782,196688
2020-10-09,Asia,W_AS,107046,1720,4460056021,Asia,11127828,198408
2020-10-10,Asia,W_AS,102624,1568,4460056021,Asia,11230452,199976
2020-10-11,Asia,W_AS,106070,1559,4460056021,Asia,11336522,201535
2020-10-12,Asia,W_AS,94022,1517,4460056021,Asia,11430544,203052
2020-10-13,Asia,W_AS,90313,1371,4460056021,Asia,11520857,204423
2020-10-14,Asia,W_AS,96750,1412,4460056021,Asia,11617607,205835
2020-10-15,Asia,W_AS,100710,1460,4460056021,Asia,11718317,207295
2020-10-16,Asia,W_AS,96989,1580,4460056021,Asia,11815306,208875
2020-10-17,Asia,W_AS,95877,1474,4460056021,Asia,11911183,210349
2020-10-18,Asia,W_AS,92206,1726,4460056021,Asia,12003389,212075
2020-10-19,Asia,W_AS,86442,1225,4460056021,Asia,12089831,213300
2020-10-20,Asia,W_AS,76847,1358,4460056021,Asia,12166678,214658
2020-10-21,Asia,W_AS,87241,1461,4460056021,Asia,12253919,216119
2020-10-22,Asia,W_AS,92328,1460,4460056021,Asia,12346247,217579
2020-10-23,Asia,W_AS,90453,1431,4460056021,Asia,12436700,219010
2020-10-24,Asia,W_AS,89610,1474,4460056021,Asia,12526310,220484
2020-10-25,Asia,W_AS,82192,1316,4460056021,Asia,12608502,221800
2020-10-26,Asia,W_AS,77656,1171,4460056021,Asia,12686158,222971
2020-10-27,Asia,W_AS,66554,1304,4460056021,Asia,12752712,224275
2020-10-28,Asia,W_AS,79359,1284,4460056021,Asia,12832071,225559
2020-10-29,Asia,W_AS,86070,1334,4460056021,Asia,12918141,226893
2020-10-30,Asia,W_AS,86129,1340,4460056021,Asia,13004270,228233
2020-10-31,Asia,W_AS,83868,1265,4460056021,Asia,13088138,229498
2020-11-01,Asia,W_AS,80265,1256,4460056021,Asia,13168403,230754
2020-11-02,Asia,W_AS,80133,1283,4460056021,Asia,13248536,232037
2020-11-03,Asia,W_AS,76627,1395,4460056021,Asia,13325163,233432
2020-11-04,Asia,W_AS,85660,1384,4460056021,Asia,13410823,234816
2020-11-05,Asia,W_AS,89345,1596,4460056021,Asia,13500168,236412
2020-11-06,Asia,W_AS,88531,1505,4460056021,Asia,13588699,237917
2020-11-07,Asia,W_AS,92312,1427,4460056021,Asia,13681011,239344
2020-11-08,Asia,W_AS,84897,1334,4460056021,Asia,13765908,240678
2020-11-09,Asia,W_AS,85500,1351,4460056021,Asia,13851408,242029
2020-11-10,Asia,W_AS,78356,1389,4460056021,Asia,13929764,243418
2020-11-11,Asia,W_AS,86975,1381,4460056021,Asia,14016739,244799
2020-11-12,Asia,W_AS,92299,1504,4460056021,Asia,14109038,246303
2020-11-13,Asia,W_AS,89774,1431,4460056021,Asia,14198812,247734
2020-11-14,Asia,W_AS,89410,1416,4460056021,Asia,14288222,249150
2020-11-15,Asia,W_AS,84661,1327,4460056021,Asia,14372883,250477
2020-11-16,Asia,W_AS,69853,1281,4460056021,Asia,14442736,251758
2020-11-17,Asia,W_AS,73795,1331,4460056021,Asia,14516531,253089
2020-11-18,Asia,W_AS,84480,1396,4460056021,Asia,14601011,254485
2020-11-19,Asia,W_AS,94577,1595,4460056021,Asia,14695588,256080
2020-11-20,Asia,W_AS,81821,1337,4460056021,Asia,14777409,257417
2020-11-21,Asia,W_AS,107551,1946,4460056021,Asia,14884960,259363
2020-11-22,Asia,W_AS,90061,1404,4460056021,Asia,14975021,260767
2020-11-23,Asia,W_AS,89382,1492,4460056021,Asia,15064403,262259
2020-11-24,Asia,W_AS,85765,1417,4460056021,Asia,15150168,263676
2020-11-25,Asia,W_AS,78272,978,4460056021,Asia,15228440,264654
2020-11-26,Asia,W_AS,107857,2020,4460056021,Asia,15336297,266674
2020-11-27,Asia,W_AS,92038,1503,4460056021,Asia,15428335,268177
2020-11-28,Asia,W_AS,89333,1382,4460056021,Asia,15517668,269559
2020-11-29,Asia,W_AS,86417,1399,4460056021,Asia,15604085,270958
2020-11-30,Asia,W_AS,90091,1412,4460056021,Asia,15694176,272370
2020-12-01,Asia,W_AS,78947,1346,4460056021,Asia,15773123,273716
2020-12-02,Asia,W_AS,83119,1463,4460056021,Asia,15856242,275179
2020-12-03,Asia,W_AS,86030,1363,4460056021,Asia,15942272,276542
2020-12-04,Asia,W_AS,89352,1403,4460056021,Asia,16031624,277945
2020-12-05,Asia,W_AS,82635,1405,4460056021,Asia,16114259,279350
2020-12-06,Asia,W_AS,80499,1249,4460056021,Asia,16194758,280599
2020-12-07,Asia,W_AS,79723,1178,4460056021,Asia,16274481,281777
2020-12-08,Asia,W_AS,71121,1211,4460056021,Asia,16345602,282988
2020-12-09,Asia,W_AS,75541,1345,4460056021,Asia,16421143,284333
2020-12-10,Asia,W_AS,76203,1234,4460056021,Asia,16497346,285567
2020-12-11,Asia,W_AS,75131,1245,4460056021,Asia,16572477,286812
2020-12-12,Asia,W_AS,71851,1166,4460056021,Asia,16644328,287978
2020-12-13,Asia,W_AS,72723,1124,4460056021,Asia,16717051,289102
2020-12-14,Asia,W_AS,64995,1027,4460056021,Asia,16782046,290129
2019-12-31,Europe,W_EU,0,0,626329975,Europe,0,0
2020-01-01,Europe,W_EU,0,0,626329975,Europe,0,0
2020-01-02,Europe,W_EU,0,0,626329975,Europe,0,0
2020-01-03,Europe,W_EU,0,0,626329975,Europe,0,0
2020-01-04,Europe,W_EU,0,0,626329975,Europe,0,0
2020-01-05,Europe,W_EU,0,0,626329975,Europe,0,0
2020-01-06,Europe,W_EU,0,0,626329975,Europe,0,0
2020-01-07,Europe,W_EU,0,0,626329975,Europe,0,0
2020-01-08,Europe,W_EU,0,0,626329975,Europe,0,0
2020-01-09,Europe,W_EU,0,0,626329975,Europe,0,0
2020-01-10,Europe,W_EU,0,0,626329975,Europe,0,0
2020-01-11,Europe,W_EU,0,0,626329975,Europe,0,0
2020-01-12,Europe,W_EU,0,0,626329975,Europe,0,0
2020-01-13,Europe,W_EU,0,0,626329975,Europe,0,0
2020-01-14,Europe,W_EU,0,0,626329975,Europe,0,0
2020-01-15,Europe,W_EU,0,0,626329975,Europe,0,0
2020-01-16,Europe,W_EU,0,0,626329975,Europe,0,0
2020-01-17,Europe,W_EU,0,0,626329975,Europe,0,0
2020-01-18,Europe,W_EU,0,0,626329975,Europe,0,0
2020-01-19,Europe,W_EU,0,0,626329975,Europe,0,0
2020-01-20,Europe,W_EU,0,0,626329975,Europe,0,0
2020-01-21,Europe,W_EU,0,0,626329975,Europe,0,0
2020-01-22,Europe,W_EU,0,0,626329975,Europe,0,0
2020-01-23,Europe,W_EU,0,0,626329975,Europe,0,0
2020-01-24,Europe,W_EU,0,0,626329975,Europe,0,0
2020-01-25,Europe,W_EU,3,0,626329975,Europe,3,0
2020-01-26,Europe,W_EU,0,0,626329975,Europe,3,0
2020-01-27,Europe,W_EU,0,0,626329975,Europe,3,0
2020-01-28,Europe,W_EU,1,0,626329975,Europe,4,0
2020-01-29,Europe,W_EU,4,0,626329975,Europe,8,0
2020-01-30,Europe,W_EU,2,0,626329975,Europe,10,0
2020-01-31,Europe,W_EU,5,0,626329975,Europe,15,0
2020-02-01,Europe,W_EU,7,0,626329975,Europe,22,0
2020-02-02,Europe,W_EU,1,0,626329975,Europe,23,0
2020-02-03,Europe,W_EU,1,0,626329975,Europe,24,0
2020-02-04,Europe,W_EU,3,0,626329975,Europe,27,0
2020-02-05,Europe,W_EU,2,0,626329975,Europe,29,0
2020-02-06,Europe,W_EU,0,0,626329975,Europe,29,0
2020-02-07,Europe,W_EU,2,0,626329975,Europe,31,0
2020-02-08,Europe,W_EU,6,0,626329975,Europe,37,0
2020-02-09,Europe,W_EU,0,0,626329975,Europe,37,0
2020-02-10,Europe,W_EU,5,0,626329975,Europe,42,0
2020-02-11,Europe,W_EU,1,0,626329975,Europe,43,0
2020-02-12,Europe,W_EU,2,0,626329975,Europe,45,0
2020-02-13,Europe,W_EU,1,0,626329975,Europe,46,0
2020-02-14,Europe,W_EU,0,0,626329975,Europe,46,0
2020-02-15,Europe,W_EU,0,1,626329975,Europe,46,1
2020-02-16,Europe,W_EU,0,0,626329975,Europe,46,1
2020-02-17,Europe,W_EU,1,0,626329975,Europe,47,1
2020-02-18,Europe,W_EU,0,0,626329975,Europe,47,1
2020-02-19,Europe,W_EU,0,0,626329975,Europe,47,1
2020-02-20,Europe,W_EU,0,0,626329975,Europe,47,1
2020-02-21,Europe,W_EU,0,0,626329975,Europe,47,1
2020-02-22,Europe,W_EU,14,0,626329975,Europe,61,1
2020-02-23,Europe,W_EU,63,2,626329975,Europe,124,3
2020-02-24,Europe,W_EU,53,0,626329975,Europe,177,3
2020-02-25,Europe,W_EU,98,4,626329975,Europe,275,7
2020-02-26,Europe,W_EU,109,5,626329975,Europe,384,12
2020-02-27,Europe,W_EU,107,2,626329975,Europe,491,14
2020-02-28,Europe,W_EU,341,5,626329975,Europe,832,19
2020-02-29,Europe,W_EU,322,4,626329975,Europe,1154,23
2020-03-01,Europe,W_EU,429,8,626329975,Europe,1583,31
2020-03-02,Europe,W_EU,708,7,626329975,Europe,2291,38
2020-03-03,Europe,W_EU,558,18,564709335,Europe,2849,56
2020-03-04,Europe,W_EU,760,29,685327944,Europe,3609,85
2020-03-05,Europe,W_EU,1037,28,599641449,Europe,4646,113
2020-03-06,Europe,W_EU,1597,47,624108743,Europe,6243,160
2020-03-07,Europe,W_EU,2015,55,680156136,Europe,8258,215
2020-03-08,Europe,W_EU,2242,38,670570100,Europe,10500,253
2020-03-09,Europe,W_EU,2807,145,671444836,Europe,13307,398
2020-03-10,Europe,W_EU,3651,137,652271233,Europe,16958,535
2020-03-11,Europe,W_EU,3424,183,699706410,Europe,20382,718
2020-03-12,Europe,W_EU,5886,254,799324121,Europe,26268,972
2020-03-13,Europe,W_EU,7543,249,841724813,Europe,33811,1221
2020-03-14,Europe,W_EU,7862,317,698470928,Europe,41673,1538
2020-03-15,Europe,W_EU,9305,244,705784529,Europe,50978,1782
2020-03-16,Europe,W_EU,9329,599,847303479,Europe,60307,2381
2020-03-17,Europe,W_EU,10997,438,847303479,Europe,71304,2819
2020-03-18,Europe,W_EU,12770,617,847925661,Europe,84074,3436
2020-03-19,Europe,W_EU,14435,743,847925661,Europe,98509,4179
2020-03-20,Europe,W_EU,23002,884,848131631,Europe,121511,5063
2020-03-21,Europe,W_EU,22886,1079,848216220,Europe,144397,6142
2020-03-22,Europe,W_EU,22779,1442,848216220,Europe,167176,7584
2020-03-23,Europe,W_EU,21248,1355,848216220,Europe,188424,8939
2020-03-24,Europe,W_EU,28564,1538,848216220,Europe,216988,10477
2020-03-25,Europe,W_EU,27406,1905,848216220,Europe,244394,12382
2020-03-26,Europe,W_EU,32026,2176,848216220,Europe,276420,14558
2020-03-27,Europe,W_EU,36988,2285,848216220,Europe,313408,16843
2020-03-28,Europe,W_EU,38291,2809,848216220,Europe,351699,19652
2020-03-29,Europe,W_EU,33963,2814,848216220,Europe,385662,22466
2020-03-30,Europe,W_EU,30321,2643,848216220,Europe,415983,25109
2020-03-31,Europe,W_EU,33442,3031,848216220,Europe,449425,28140
2020-04-01,Europe,W_EU,40316,3452,848216220,Europe,489741,31592
2020-04-02,Europe,W_EU,38822,3546,848216220,Europe,528563,35138
2020-04-03,Europe,W_EU,37312,3734,848216220,Europe,565875,38872
2020-04-04,Europe,W_EU,40688,5363,848216220,Europe,606563,44235
2020-04-05,Europe,W_EU,36680,4288,848216220,Europe,643243,48523
2020-04-06,Europe,W_EU,28620,3139,848216220,Europe,671863,51662
2020-04-07,Europe,W_EU,31867,3552,848216220,Europe,703730,55214
2020-04-08,Europe,W_EU,34907,5104,848216220,Europe,738637,60318
2020-04-09,Europe,W_EU,37834,4093,848216220,Europe,776471,64411
2020-04-10,Europe,W_EU,39692,4886,848216220,Europe,816163,69297
2020-04-11,Europe,W_EU,39106,4312,848216220,Europe,855269,73609
2020-04-12,Europe,W_EU,33841,3615,848216220,Europe,889110,77224
2020-04-13,Europe,W_EU,28497,3197,848216220,Europe,917607,80421
2020-04-14,Europe,W_EU,27419,3305,848216220,Europe,945026,83726
2020-04-15,Europe,W_EU,33960,4406,848216220,Europe,978986,88132
2020-04-16,Europe,W_EU,32683,4850,848216220,Europe,1011669,92982
2020-04-17,Europe,W_EU,35998,4162,848216220,Europe,1047667,97144
2020-04-18,Europe,W_EU,33108,3912,848216220,Europe,1080775,101056
2020-04-19,Europe,W_EU,29189,3680,848216220,Europe,1109964,104736
2020-04-20,Europe,W_EU,29056,2526,848216220,Europe,1139020,107262
2020-04-21,Europe,W_EU,28079,2951,848216220,Europe,1167099,110213
2020-04-22,Europe,W_EU,31823,3899,848216220,Europe,1198922,114112
2020-04-23,Europe,W_EU,30582,3318,848216220,Europe,1229504,117430
2020-04-24,Europe,W_EU,29910,3069,848216220,Europe,1259414,120499
2020-04-25,Europe,W_EU,30912,3193,848216220,Europe,1290326,123692
2020-04-26,Europe,W_EU,27034,2964,848216220,Europe,1317360,126656
2020-04-27,Europe,W_EU,23455,1603,848216220,Europe,1340815,128259
2020-04-28,Europe,W_EU,22814,2460,848216220,Europe,1363629,130719
2020-04-29,Europe,W_EU,23776,3050,848216220,Europe,1387405,133769
2020-04-30,Europe,W_EU,26212,2719,848216220,Europe,1413617,136488
2020-05-01,Europe,W_EU,27027,2358,848216220,Europe,1440644,138846
2020-05-02,Europe,W_EU,24853,2170,848216220,Europe,1465497,141016
2020-05-03,Europe,W_EU,24861,1989,848216220,Europe,1490358,143005
2020-05-04,Europe,W_EU,22819,1313,848216220,Europe,1513177,144318
2020-05-05,Europe,W_EU,23133,1588,848216220,Europe,1536310,145906
2020-05-06,Europe,W_EU,24367,2241,848216220,Europe,1560677,148147
2020-05-07,Europe,W_EU,29824,2165,848216220,Europe,1590501,150312
2020-05-08,Europe,W_EU,26976,1782,848216220,Europe,1617477,152094
2020-05-09,Europe,W_EU,25722,1923,848216220,Europe,1643199,154017
2020-05-10,Europe,W_EU,25636,1220,848216220,Europe,1668835,155237
2020-05-11,Europe,W_EU,20374,1032,848216220,Europe,1689209,156269
2020-05-12,Europe,W_EU,21750,1335,848216220,Europe,1710959,157604
2020-05-13,Europe,W_EU,24299,1924,848216220,Europe,1735258,159528
2020-05-14,Europe,W_EU,22755,1483,848216220,Europe,1758013,161011
2020-05-15,Europe,W_EU,23083,1630,848216220,Europe,1781096,162641
2020-05-16,Europe,W_EU,22296,1324,848216220,Europe,1803392,163965
2020-05-17,Europe,W_EU,20033,1176,848216220,Europe,1823425,165141
2020-05-18,Europe,W_EU,18242,708,848216220,Europe,1841667,165849
2020-05-19,Europe,W_EU,17530,897,848216220,Europe,1859197,166746
2020-05-20,Europe,W_EU,19742,1349,848216220,Europe,1878939,168095
2020-05-21,Europe,W_EU,19968,1112,848216220,Europe,1898907,169207
2020-05-22,Europe,W_EU,20146,1611,848216220,Europe,1919053,170818
2020-05-23,Europe,W_EU,19104,958,848216220,Europe,1938157,171776
2020-05-24,Europe,W_EU,18463,862,848216220,Europe,1956620,172638
2020-05-25,Europe,W_EU,15542,-1095,848216220,Europe,1972162,171543
2020-05-26,Europe,W_EU,16984,876,848216220,Europe,1989146,172419
2020-05-27,Europe,W_EU,17234,758,848216220,Europe,2006380,173177
2020-05-28,Europe,W_EU,17833,1045,848216220,Europe,2024213,174222
2020-05-29,Europe,W_EU,21380,956,848216220,Europe,2045593,175178
2020-05-30,Europe,W_EU,18475,889,848216220,Europe,2064068,176067
2020-05-31,Europe,W_EU,18160,717,848216220,Europe,2082228,176784
2020-06-01,Europe,W_EU,15889,484,848216220,Europe,2098117,177268
2020-06-02,Europe,W_EU,15911,557,848216220,Europe,2114028,177825
2020-06-03,Europe,W_EU,15717,792,848216220,Europe,2129745,178617
2020-06-04,Europe,W_EU,17536,785,848216220,Europe,2147281,179402
2020-06-05,Europe,W_EU,18340,630,848216220,Europe,2165621,180032
2020-06-06,Europe,W_EU,18511,760,848216220,Europe,2184132,180792
2020-06-07,Europe,W_EU,17813,615,848216220,Europe,2201945,181407
2020-06-08,Europe,W_EU,15864,406,848216220,Europe,2217809,181813
2020-06-09,Europe,W_EU,16621,473,848216220,Europe,2234430,182286
2020-06-10,Europe,W_EU,16903,729,848216220,Europe,2251333,183015
2020-06-11,Europe,W_EU,17839,709,848216220,Europe,2269172,183724
2020-06-12,Europe,W_EU,18619,499,848216220,Europe,2287791,184223
2020-06-13,Europe,W_EU,18904,559,848216220,Europe,2306695,184782
2020-06-14,Europe,W_EU,18524,476,848216220,Europe,2325219,185258
2020-06-15,Europe,W_EU,16993,345,848216220,Europe,2342212,185603
2020-06-16,Europe,W_EU,16547,375,848216220,Europe,2358759,185978
2020-06-17,Europe,W_EU,17788,646,848216220,Europe,2376547,186624
2020-06-18,Europe,W_EU,18966,582,848216220,Europe,2395513,187206
2020-06-19,Europe,W_EU,18282,1862,848216220,Europe,2413795,189068
2020-06-20,Europe,W_EU,18314,499,848216220,Europe,2432109,189567
2020-06-21,Europe,W_EU,17562,338,848216220,Europe,2449671,189905
2020-06-22,Europe,W_EU,15195,304,848216220,Europe,2464866,190209
2020-06-23,Europe,W_EU,15693,311,848216220,Europe,2480559,190520
2020-06-24,Europe,W_EU,17157,523,848216220,Europe,2497716,191043
2020-06-25,Europe,W_EU,18278,403,848216220,Europe,2515994,191446
2020-06-26,Europe,W_EU,17341,431,848216220,Europe,2533335,191877
2020-06-27,Europe,W_EU,18783,466,848216220,Europe,2552118,192343
2020-06-28,Europe,W_EU,15820,379,848216220,Europe,2567938,192722
2020-06-29,Europe,W_EU,14706,312,848216220,Europe,2582644,193034
2020-06-30,Europe,W_EU,15886,323,848216220,Europe,2598530,193357
2020-07-01,Europe,W_EU,15812,448,848216220,Europe,2614342,193805
2020-07-02,Europe,W_EU,16237,499,848216220,Europe,2630579,194304
2020-07-03,Europe,W_EU,16645,423,848216220,Europe,2647224,194727
2020-07-04,Europe,W_EU,15747,434,848216220,Europe,2662971,195161
2020-07-05,Europe,W_EU,14906,372,848216220,Europe,2677877,195533
2020-07-06,Europe,W_EU,14853,310,848216220,Europe,2692730,195843
2020-07-07,Europe,W_EU,14707,336,848216220,Europe,2707437,196179
2020-07-08,Europe,W_EU,14529,504,848216220,Europe,2721966,196683
2020-07-09,Europe,W_EU,16397,460,848216220,Europe,2738363,197143
2020-07-10,Europe,W_EU,16403,406,848216220,Europe,2754766,197549
2020-07-11,Europe,W_EU,15977,410,848216220,Europe,2770743,197959
2020-07-12,Europe,W_EU,15268,378,848216220,Europe,2786011,198337
2020-07-13,Europe,W_EU,15047,274,848216220,Europe,2801058,198611
2020-07-14,Europe,W_EU,15539,295,848216220,Europe,2816597,198906
2020-07-15,Europe,W_EU,14895,401,848216220,Europe,2831492,199307
2020-07-16,Europe,W_EU,17343,444,848216220,Europe,2848835,199751
2020-07-17,Europe,W_EU,16975,390,848216220,Europe,2865810,200141
2020-07-18,Europe,W_EU,16072,384,848216220,Europe,2881882,200525
2020-07-19,Europe,W_EU,14452,292,848216220,Europe,2896334,200817
2020-07-20,Europe,W_EU,17575,229,848216220,Europe,2913909,201046
2020-07-21,Europe,W_EU,16567,263,848216220,Europe,2930476,201309
2020-07-22,Europe,W_EU,16161,374,848216220,Europe,2946637,201683
2020-07-23,Europe,W_EU,19615,385,848216220,Europe,2966252,202068
2020-07-24,Europe,W_EU,19370,348,848216220,Europe,2985622,202416
2020-07-25,Europe,W_EU,17114,361,848216220,Europe,3002736,202777
2020-07-26,Europe,W_EU,15049,301,848216220,Europe,3017785,203078
2020-07-27,Europe,W_EU,19845,207,848216220,Europe,3037630,203285
2020-07-28,Europe,W_EU,19007,277,848216220,Europe,3056637,203562
2020-07-29,Europe,W_EU,17436,345,848216220,Europe,3074073,203907
2020-07-30,Europe,W_EU,20305,381,848216220,Europe,3094378,204288
2020-07-31,Europe,W_EU,21571,360,848216220,Europe,3115949,204648
2020-08-01,Europe,W_EU,18166,379,848216220,Europe,3134115,205027
2020-08-02,Europe,W_EU,15567,263,848216220,Europe,3149682,205290
2020-08-03,Europe,W_EU,22297,278,848216220,Europe,3171979,205568
2020-08-04,Europe,W_EU,23699,270,848216220,Europe,3195678,205838
2020-08-05,Europe,W_EU,19987,408,848216220,Europe,3215665,206246
2020-08-06,Europe,W_EU,23747,393,848216220,Europe,3239412,206639
2020-08-07,Europe,W_EU,23154,313,848216220,Europe,3262566,206952
2020-08-08,Europe,W_EU,20491,356,848216220,Europe,3283057,207308
2020-08-09,Europe,W_EU,16608,320,848216220,Europe,3299665,207628
2020-08-10,Europe,W_EU,24292,335,848216220,Europe,3323957,207963
2020-08-11,Europe,W_EU,23910,355,848216220,Europe,3347867,208318
2020-08-12,Europe,W_EU,21782,300,848216220,Europe,3369649,208618
2020-08-13,Europe,W_EU,28969,381,848216220,Europe,3398618,208999
2020-08-14,Europe,W_EU,27269,387,848216220,Europe,3425887,209386
2020-08-15,Europe,W_EU,20665,314,848216220,Europe,3446552,209700
2020-08-16,Europe,W_EU,20450,477,848216220,Europe,3467002,210177
2020-08-17,Europe,W_EU,35756,270,848216220,Europe,3502758,210447
2020-08-18,Europe,W_EU,21573,285,848216220,Europe,3524331,210732
2020-08-19,Europe,W_EU,24742,467,848216220,Europe,3549073,211199
2020-08-20,Europe,W_EU,30285,364,848216220,Europe,3579358,211563
2020-08-21,Europe,W_EU,32648,360,848216220,Europe,3612006,211923
2020-08-22,Europe,W_EU,25159,318,848216220,Europe,3637165,212241
2020-08-23,Europe,W_EU,21987,330,848216220,Europe,3659152,212571
2020-08-24,Europe,W_EU,41250,276,848216220,Europe,3700402,212847
2020-08-25,Europe,W_EU,26451,316,848216220,Europe,3726853,213163
2020-08-26,Europe,W_EU,30638,427,848216220,Europe,3757491,213590
2020-08-27,Europe,W_EU,35433,436,848216220,Europe,3792924,214026
2020-08-28,Europe,W_EU,33479,348,848216220,Europe,3826403,214374
2020-08-29,Europe,W_EU,28487,340,848216220,Europe,3854890,214714
2020-08-30,Europe,W_EU,24456,334,848216220,Europe,3879346,215048
2020-08-31,Europe,W_EU,47359,336,848216220,Europe,3926705,215384
2020-09-01,Europe,W_EU,29689,401,848216220,Europe,3956394,215785
2020-09-02,Europe,W_EU,32104,467,848216220,Europe,3988498,216252
2020-09-03,Europe,W_EU,38238,444,848216220,Europe,4026736,216696
2020-09-04,Europe,W_EU,40382,567,848216220,Europe,4067118,217263
2020-09-05,Europe,W_EU,32963,330,848216220,Europe,4100081,217593
2020-09-06,Europe,W_EU,30804,414,848216220,Europe,4130885,218007
2020-09-07,Europe,W_EU,54383,325,848216220,Europe,4185268,218332
2020-09-08,Europe,W_EU,36374,438,848216220,Europe,4221642,218770
2020-09-09,Europe,W_EU,41873,525,848216220,Europe,4263515,219295
2020-09-10,Europe,W_EU,46244,481,848216220,Europe,4309759,219776
2020-09-11,Europe,W_EU,49286,485,848216220,Europe,4359045,220261
2020-09-12,Europe,W_EU,36546,377,848216220,Europe,4395591,220638
2020-09-13,Europe,W_EU,37745,333,848216220,Europe,4433336,220971
2020-09-14,Europe,W_EU,58802,467,848216220,Europe,4492138,221438
2020-09-15,Europe,W_EU,41142,506,848216220,Europe,4533280,221944
2020-09-16,Europe,W_EU,52286,862,848216220,Europe,4585566,222806
2020-09-17,Europe,W_EU,51384,602,848216220,Europe,4636950,223408
2020-09-18,Europe,W_EU,60643,602,848216220,Europe,4697593,224010
2020-09-19,Europe,W_EU,48894,637,848216220,Europe,4746487,224647
2020-09-20,Europe,W_EU,45887,470,848216220,Europe,4792374,225117
2020-09-21,Europe,W_EU,71506,515,848216220,Europe,4863880,225632
2020-09-22,Europe,W_EU,48623,640,848216220,Europe,4912503,226272
2020-09-23,Europe,W_EU,55932,738,848216220,Europe,4968435,227010
2020-09-24,Europe,W_EU,63474,696,848216220,Europe,5031909,227706
2020-09-25,Europe,W_EU,69313,709,848216220,Europe,5101222,228415
2020-09-26,Europe,W_EU,59603,649,848216220,Europe,5160825,229064
2020-09-27,Europe,W_EU,54153,624,848216220,Europe,5214978,229688
2020-09-28,Europe,W_EU,78047,608,848216220,Europe,5293025,230296
2020-09-29,Europe,W_EU,50192,661,848216220,Europe,5343217,230957
2020-09-30,Europe,W_EU,61551,883,848216220,Europe,5404768,231840
2020-10-01,Europe,W_EU,69800,857,848216220,Europe,5474568,232697
2020-10-02,Europe,W_EU,74529,779,848216220,Europe,5549097,233476
2020-10-03,Europe,W_EU,71305,766,848216220,Europe,5620402,234242
2020-10-04,Europe,W_EU,73271,666,848216220,Europe,5693673,234908
2020-10-05,Europe,W_EU,92842,547,848216220,Europe,5786515,235455
2020-10-06,Europe,W_EU,82791,929,848216220,Europe,5869306,236384
2020-10-07,Europe,W_EU,87465,966,848216220,Europe,5956771,237350
2020-10-08,Europe,W_EU,105760,1025,848216220,Europe,6062531,238375
2020-10-09,Europe,W_EU,117250,1075,848216220,Europe,6179781,239450
2020-10-10,Europe,W_EU,104262,788,848216220,Europe,6284043,240238
2020-10-11,Europe,W_EU,114867,967,848216220,Europe,6398910,241205
2020-10-12,Europe,W_EU,115685,907,848216220,Europe,6514595,242112
2020-10-13,Europe,W_EU,101282,833,848216220,Europe,6615877,242945
2020-10-14,Europe,W_EU,124663,1381,848216220,Europe,6740540,244326
2020-10-15,Europe,W_EU,150533,1330,848216220,Europe,6891073,245656
2020-10-16,Europe,W_EU,165020,1444,848216220,Europe,7056093,247100
2020-10-17,Europe,W_EU,151471,1291,848216220,Europe,7207564,248391
2020-10-18,Europe,W_EU,146499,1183,848216220,Europe,7354063,249574
2020-10-19,Europe,W_EU,176627,1277,848216220,Europe,7530690,250851
2020-10-20,Europe,W_EU,151103,1403,848216220,Europe,7681793,252254
2020-10-21,Europe,W_EU,171052,1741,848216220,Europe,7852845,253995
2020-10-22,Europe,W_EU,214717,1877,848216220,Europe,8067562,255872
2020-10-23,Europe,W_EU,228134,1978,848216220,Europe,8295696,257850
2020-10-24,Europe,W_EU,224844,1892,848216220,Europe,8520540,259742
2020-10-25,Europe,W_EU,214032,1750,848216220,Europe,8734572,261492
2020-10-26,Europe,W_EU,244983,1734,848216220,Europe,8979555,263226
2020-10-27,Europe,W_EU,216279,1969,848216220,Europe,9195834,265195
2020-10-28,Europe,W_EU,245430,2807,848216220,Europe,9441264,268002
2020-10-29,Europe,W_EU,266487,2706,848216220,Europe,9707751,270708
2020-10-30,Europe,W_EU,287424,2755,848216220,Europe,9995175,273463
2020-10-31,Europe,W_EU,277687,2942,848216220,Europe,10272862,276405
2020-11-01,Europe,W_EU,229181,2585,848216220,Europe,10502043,278990
2020-11-02,Europe,W_EU,274628,2419,848216220,Europe,10776671,281409
2020-11-03,Europe,W_EU,259450,2720,848216220,Europe,11036121,284129
2020-11-04,Europe,W_EU,265372,5484,848216220,Europe,11301493,289613
2020-11-05,Europe,W_EU,302646,4051,848216220,Europe,11604139,293664
2020-11-06,Europe,W_EU,322167,3855,848216220,Europe,11926306,297519
2020-11-07,Europe,W_EU,305188,4152,848216220,Europe,12231494,301671
2020-11-08,Europe,W_EU,314090,3332,848216220,Europe,12545584,305003
2020-11-09,Europe,W_EU,276910,3008,848216220,Europe,12822494,308011
2020-11-10,Europe,W_EU,235548,3747,848216220,Europe,13058042,311758
2020-11-11,Europe,W_EU,254982,5452,848216220,Europe,13313024,317210
2020-11-12,Europe,W_EU,285728,4753,848216220,Europe,13598752,321963
2020-11-13,Europe,W_EU,309293,4535,848216220,Europe,13908045,326498
2020-11-14,Europe,W_EU,275091,4618,848216220,Europe,14183136,331116
2020-11-15,Europe,W_EU,254128,3862,848216220,Europe,14437264,334978
2020-11-16,Europe,W_EU,254122,3515,848216220,Europe,14691386,338493
2020-11-17,Europe,W_EU,224547,4256,848216220,Europe,14915933,342749
2020-11-18,Europe,W_EU,264902,5829,848216220,Europe,15180835,348578
2020-11-19,Europe,W_EU,272725,5215,848216220,Europe,15453560,353793
2020-11-20,Europe,W_EU,282632,5139,848216220,Europe,15736192,358932
2020-11-21,Europe,W_EU,281899,5909,848216220,Europe,16018091,364841
2020-11-22,Europe,W_EU,223616,3835,848216220,Europe,16241707,368676
2020-11-23,Europe,W_EU,206846,3515,848216220,Europe,16448553,372191
2020-11-24,Europe,W_EU,209942,5076,848216220,Europe,16658495,377267
2020-11-25,Europe,W_EU,229442,6391,848216220,Europe,16887937,383658
2020-11-26,Europe,W_EU,247604,5719,848216220,Europe,17135541,389377
2020-11-27,Europe,W_EU,277445,5616,848216220,Europe,17412986,394993
2020-11-28,Europe,W_EU,263998,6001,848216220,Europe,17676984,400994
2020-11-29,Europe,W_EU,234243,4368,848216220,Europe,17911227,405362
2020-11-30,Europe,W_EU,216198,3864,848216220,Europe,18127425,409226
2020-12-01,Europe,W_EU,194721,4666,848216220,Europe,18322146,413892
2020-12-02,Europe,W_EU,223726,6195,848216220,Europe,18545872,420087
2020-12-03,Europe,W_EU,256272,5728,848216220,Europe,18802144,425815
2020-12-04,Europe,W_EU,264508,5716,848216220,Europe,19066652,431531
2020-12-05,Europe,W_EU,257715,5783,848216220,Europe,19324367,437314
2020-12-06,Europe,W_EU,235422,4310,848216220,Europe,19559789,441624
2020-12-07,Europe,W_EU,216714,3769,848216220,Europe,19776503,445393
2020-12-08,Europe,W_EU,191410,4090,848216220,Europe,19967913,449483
2020-12-09,Europe,W_EU,237363,6074,848216220,Europe,20205276,455557
2020-12-10,Europe,W_EU,255762,5370,848216220,Europe,20461038,460927
2020-12-11,Europe,W_EU,273397,5666,848216220,Europe,20734435,466593
2020-12-12,Europe,W_EU,226696,5421,848216220,Europe,20961131,472014
2020-12-13,Europe,W_EU,230310,4498,848216220,Europe,21191441,476512
2020-12-14,Europe,W_EU,208571,3277,801279160,Europe,21400012,479789
2019-12-31,Oceania,W_OC,0,0,29986262,Oceania,0,0
2020-01-01,Oceania,W_OC,0,0,29986262,Oceania,0,0
2020-01-02,Oceania,W_OC,0,0,29986262,Oceania,0,0
2020-01-03,Oceania,W_OC,0,0,29986262,Oceania,0,0
2020-01-04,Oceania,W_OC,0,0,29986262,Oceania,0,0
2020-01-05,Oceania,W_OC,0,0,29986262,Oceania,0,0
2020-01-06,Oceania,W_OC,0,0,29986262,Oceania,0,0
2020-01-07,Oceania,W_OC,0,0,29986262,Oceania,0,0
2020-01-08,Oceania,W_OC,0,0,29986262,Oceania,0,0
2020-01-09,Oceania,W_OC,0,0,29986262,Oceania,0,0
2020-01-10,Oceania,W_OC,0,0,29986262,Oceania,0,0
2020-01-11,Oceania,W_OC,0,0,29986262,Oceania,0,0
2020-01-12,Oceania,W_OC,0,0,29986262,Oceania,0,0
2020-01-13,Oceania,W_OC,0,0,29986262,Oceania,0,0
2020-01-14,Oceania,W_OC,0,0,29986262,Oceania,0,0
2020-01-15,Oceania,W_OC,0,0,29986262,Oceania,0,0
2020-01-16,Oceania,W_OC,0,0,29986262,Oceania,0,0
2020-01-17,Oceania,W_OC,0,0,29986262,Oceania,0,0
2020-01-18,Oceania,W_OC,0,0,29986262,Oceania,0,0
2020-01-19,Oceania,W_OC,0,0,29986262,Oceania,0,0
2020-01-20,Oceania,W_OC,0,0,29986262,Oceania,0,0
2020-01-21,Oceania,W_OC,0,0,29986262,Oceania,0,0
2020-01-22,Oceania,W_OC,0,0,29986262,Oceania,0,0
2020-01-23,Oceania,W_OC,0,0,29986262,Oceania,0,0
2020-01-24,Oceania,W_OC,0,0,29986262,Oceania,0,0
2020-01-25,Oceania,W_OC,1,0,29986262,Oceania,1,0
2020-01-26,Oceania,W_OC,3,0,29986262,Oceania,4,0
2020-01-27,Oceania,W_OC,0,0,29986262,Oceania,4,0
2020-01-28,Oceania,W_OC,0,0,29986262,Oceania,4,0
2020-01-29,Oceania,W_OC,0,0,29986262,Oceania,4,0
2020-01-30,Oceania,W_OC,2,0,29986262,Oceania,6,0
2020-01-31,Oceania,W_OC,1,0,29986262,Oceania,7,0
2020-02-01,Oceania,W_OC,2,0,29986262,Oceania,9,0
2020-02-02,Oceania,W_OC,2,0,29986262,Oceania,11,0
2020-02-03,Oceania,W_OC,0,0,29986262,Oceania,11,0
2020-02-04,Oceania,W_OC,0,0,29986262,Oceania,11,0
2020-02-05,Oceania,W_OC,1,0,29986262,Oceania,12,0
2020-02-06,Oceania,W_OC,1,0,29986262,Oceania,13,0
2020-02-07,Oceania,W_OC,1,0,29986262,Oceania,14,0
2020-02-08,Oceania,W_OC,0,0,29986262,Oceania,14,0
2020-02-09,Oceania,W_OC,0,0,29986262,Oceania,14,0
2020-02-10,Oceania,W_OC,0,0,29986262,Oceania,14,0
2020-02-11,Oceania,W_OC,0,0,29986262,Oceania,14,0
2020-02-12,Oceania,W_OC,0,0,29986262,Oceania,14,0
2020-02-13,Oceania,W_OC,0,0,29986262,Oceania,14,0
2020-02-14,Oceania,W_OC,1,0,29986262,Oceania,15,0
2020-02-15,Oceania,W_OC,0,0,29986262,Oceania,15,0
2020-02-16,Oceania,W_OC,0,0,29986262,Oceania,15,0
2020-02-17,Oceania,W_OC,0,0,29986262,Oceania,15,0
2020-02-18,Oceania,W_OC,0,0,29986262,Oceania,15,0
2020-02-19,Oceania,W_OC,0,0,29986262,Oceania,15,0
2020-02-20,Oceania,W_OC,0,0,29986262,Oceania,15,0
2020-02-21,Oceania,W_OC,2,0,29986262,Oceania,17,0
2020-02-22,Oceania,W_OC,4,0,29986262,Oceania,21,0
2020-02-23,Oceania,W_OC,1,0,29986262,Oceania,22,0
2020-02-24,Oceania,W_OC,0,0,29986262,Oceania,22,0
2020-02-25,Oceania,W_OC,0,0,29986262,Oceania,22,0
2020-02-26,Oceania,W_OC,0,0,29986262,Oceania,22,0
2020-02-27,Oceania,W_OC,1,0,29986262,Oceania,23,0
2020-02-28,Oceania,W_OC,1,0,29986262,Oceania,24,0
2020-02-29,Oceania,W_OC,2,0,29986262,Oceania,26,0
2020-03-01,Oceania,W_OC,1,1,29986262,Oceania,27,1
2020-03-02,Oceania,W_OC,3,0,29986262,Oceania,30,1
2020-03-03,Oceania,W_OC,4,0,25203200,Oceania,34,1
2020-03-04,Oceania,W_OC,9,0,29986262,Oceania,43,1
2020-03-05,Oceania,W_OC,12,1,29986262,Oceania,55,2
2020-03-06,Oceania,W_OC,8,0,29986262,Oceania,63,2
2020-03-07,Oceania,W_OC,5,0,29986262,Oceania,68,2
2020-03-08,Oceania,W_OC,11,1,25203200,Oceania,79,3
2020-03-09,Oceania,W_OC,6,0,25203200,Oceania,85,3
2020-03-10,Oceania,W_OC,20,0,25203200,Oceania,105,3
2020-03-11,Oceania,W_OC,12,0,25203200,Oceania,117,3
2020-03-12,Oceania,W_OC,14,0,25203200,Oceania,131,3
2020-03-13,Oceania,W_OC,30,0,25203200,Oceania,161,3
2020-03-14,Oceania,W_OC,42,0,29986262,Oceania,203,3
2020-03-15,Oceania,W_OC,54,0,29986262,Oceania,257,3
2020-03-16,Oceania,W_OC,49,2,25203200,Oceania,306,5
2020-03-17,Oceania,W_OC,77,0,25203200,Oceania,383,5
2020-03-18,Oceania,W_OC,91,0,29986262,Oceania,474,5
2020-03-19,Oceania,W_OC,125,1,30432842,Oceania,599,6
2020-03-20,Oceania,W_OC,165,0,31322797,Oceania,764,6
2020-03-21,Oceania,W_OC,196,1,40381673,Oceania,960,7
2020-03-22,Oceania,W_OC,243,1,40381673,Oceania,1203,8
2020-03-23,Oceania,W_OC,662,0,40381673,Oceania,1865,8
2020-03-24,Oceania,W_OC,164,0,40381673,Oceania,2029,8
2020-03-25,Oceania,W_OC,655,1,40381673,Oceania,2684,9
2020-03-26,Oceania,W_OC,459,3,40381673,Oceania,3143,12
2020-03-27,Oceania,W_OC,461,2,40381673,Oceania,3604,14
2020-03-28,Oceania,W_OC,292,0,40381673,Oceania,3896,14
2020-03-29,Oceania,W_OC,499,2,40381673,Oceania,4395,16
2020-03-30,Oceania,W_OC,362,2,40381673,Oceania,4757,18
2020-03-31,Oceania,W_OC,567,3,40438886,Oceania,5324,21
2020-04-01,Oceania,W_OC,164,3,40438886,Oceania,5488,24
2020-04-02,Oceania,W_OC,355,2,40438886,Oceania,5843,26
2020-04-03,Oceania,W_OC,304,2,40438886,Oceania,6147,28
2020-04-04,Oceania,W_OC,390,8,40438886,Oceania,6537,36
2020-04-05,Oceania,W_OC,194,4,40438886,Oceania,6731,40
2020-04-06,Oceania,W_OC,116,2,40438886,Oceania,6847,42
2020-04-07,Oceania,W_OC,134,6,40438886,Oceania,6981,48
2020-04-08,Oceania,W_OC,155,4,40438886,Oceania,7136,52
2020-04-09,Oceania,W_OC,130,5,40438886,Oceania,7266,57
2020-04-10,Oceania,W_OC,126,3,40438886,Oceania,7392,60
2020-04-11,Oceania,W_OC,109,4,40438886,Oceania,7501,64
2020-04-12,Oceania,W_OC,68,4,40438886,Oceania,7569,68
2020-04-13,Oceania,W_OC,50,5,40438886,Oceania,7619,73
2020-04-14,Oceania,W_OC,55,4,40438886,Oceania,7674,77
2020-04-15,Oceania,W_OC,59,0,40438886,Oceania,7733,77
2020-04-16,Oceania,W_OC,48,2,40438886,Oceania,7781,79
2020-04-17,Oceania,W_OC,47,2,40438886,Oceania,7828,81
2020-04-18,Oceania,W_OC,46,4,40438886,Oceania,7874,85
2020-04-19,Oceania,W_OC,57,3,40438886,Oceania,7931,88
2020-04-20,Oceania,W_OC,33,1,40438886,Oceania,7964,89
2020-04-21,Oceania,W_OC,17,2,40438886,Oceania,7981,91
2020-04-22,Oceania,W_OC,28,4,40438886,Oceania,8009,95
2020-04-23,Oceania,W_OC,9,2,40438886,Oceania,8018,97
2020-04-24,Oceania,W_OC,18,2,40438886,Oceania,8036,99
2020-04-25,Oceania,W_OC,24,5,40438886,Oceania,8060,104
2020-04-26,Oceania,W_OC,20,2,40438886,Oceania,8080,106
2020-04-27,Oceania,W_OC,12,3,40438886,Oceania,8092,109
2020-04-28,Oceania,W_OC,17,1,40438886,Oceania,8109,110
2020-04-29,Oceania,W_OC,16,4,40438886,Oceania,8125,114
2020-04-30,Oceania,W_OC,11,2,40438886,Oceania,8136,116
2020-05-01,Oceania,W_OC,20,2,40438886,Oceania,8156,118
2020-05-02,Oceania,W_OC,7,2,40438886,Oceania,8163,120
2020-05-03,Oceania,W_OC,20,0,40438886,Oceania,8183,120
2020-05-04,Oceania,W_OC,20,2,40438886,Oceania,8203,122
2020-05-05,Oceania,W_OC,24,0,40438886,Oceania,8227,122
2020-05-06,Oceania,W_OC,27,2,40438886,Oceania,8254,124
2020-05-07,Oceania,W_OC,30,1,40438886,Oceania,8284,125
2020-05-08,Oceania,W_OC,23,0,40438886,Oceania,8307,125
2020-05-09,Oceania,W_OC,19,0,40438886,Oceania,8326,125
2020-05-10,Oceania,W_OC,18,0,40438886,Oceania,8344,125
2020-05-11,Oceania,W_OC,15,0,40438886,Oceania,8359,125
2020-05-12,Oceania,W_OC,11,0,40438886,Oceania,8370,125
2020-05-13,Oceania,W_OC,16,0,40438886,Oceania,8386,125
2020-05-14,Oceania,W_OC,11,1,40438886,Oceania,8397,126
2020-05-15,Oceania,W_OC,17,0,40438886,Oceania,8414,126
2020-05-16,Oceania,W_OC,30,0,40438886,Oceania,8444,126
2020-05-17,Oceania,W_OC,20,0,40438886,Oceania,8464,126
2020-05-18,Oceania,W_OC,9,0,40438886,Oceania,8473,126
2020-05-19,Oceania,W_OC,19,1,40438886,Oceania,8492,127
2020-05-20,Oceania,W_OC,8,0,40438886,Oceania,8500,127
2020-05-21,Oceania,W_OC,23,1,40438886,Oceania,8523,128
2020-05-22,Oceania,W_OC,3,0,40438886,Oceania,8526,128
2020-05-23,Oceania,W_OC,14,1,40438886,Oceania,8540,129
2020-05-24,Oceania,W_OC,12,1,40438886,Oceania,8552,130
2020-05-25,Oceania,W_OC,3,0,40438886,Oceania,8555,130
2020-05-26,Oceania,W_OC,9,0,40438886,Oceania,8564,130
2020-05-27,Oceania,W_OC,18,0,40438886,Oceania,8582,130
2020-05-28,Oceania,W_OC,8,1,40438886,Oceania,8590,131
2020-05-29,Oceania,W_OC,13,0,40438886,Oceania,8603,131
2020-05-30,Oceania,W_OC,23,0,40438886,Oceania,8626,131
2020-05-31,Oceania,W_OC,13,0,40438886,Oceania,8639,131
2020-06-01,Oceania,W_OC,12,0,40438886,Oceania,8651,131
2020-06-02,Oceania,W_OC,10,0,40438886,Oceania,8661,131
2020-06-03,Oceania,W_OC,20,0,40438886,Oceania,8681,131
2020-06-04,Oceania,W_OC,11,0,40438886,Oceania,8692,131
2020-06-05,Oceania,W_OC,13,0,40438886,Oceania,8705,131
2020-06-06,Oceania,W_OC,11,0,40438886,Oceania,8716,131
2020-06-07,Oceania,W_OC,5,0,40438886,Oceania,8721,131
2020-06-08,Oceania,W_OC,5,0,40438886,Oceania,8726,131
2020-06-09,Oceania,W_OC,7,0,40438886,Oceania,8733,131
2020-06-10,Oceania,W_OC,5,0,40438886,Oceania,8738,131
2020-06-11,Oceania,W_OC,11,0,40438886,Oceania,8749,131
2020-06-12,Oceania,W_OC,9,0,40438886,Oceania,8758,131
2020-06-13,Oceania,W_OC,8,0,40438886,Oceania,8766,131
2020-06-14,Oceania,W_OC,12,0,40438886,Oceania,8778,131
2020-06-15,Oceania,W_OC,18,0,40438886,Oceania,8796,131
2020-06-16,Oceania,W_OC,18,0,40438886,Oceania,8814,131
2020-06-17,Oceania,W_OC,14,0,40438886,Oceania,8828,131
2020-06-18,Oceania,W_OC,28,0,40438886,Oceania,8856,131
2020-06-19,Oceania,W_OC,29,0,40438886,Oceania,8885,131
2020-06-20,Oceania,W_OC,20,0,40438886,Oceania,8905,131
2020-06-21,Oceania,W_OC,51,0,40438886,Oceania,8956,131
2020-06-22,Oceania,W_OC,28,0,40438886,Oceania,8984,131
2020-06-23,Oceania,W_OC,18,0,40438886,Oceania,9002,131
2020-06-24,Oceania,W_OC,20,0,40438886,Oceania,9022,131
2020-06-25,Oceania,W_OC,38,1,40438886,Oceania,9060,132
2020-06-26,Oceania,W_OC,55,1,40438886,Oceania,9115,133
2020-06-27,Oceania,W_OC,42,0,40438886,Oceania,9157,133
2020-06-28,Oceania,W_OC,50,0,40438886,Oceania,9207,133
2020-06-29,Oceania,W_OC,52,0,40438886,Oceania,9259,133
2020-06-30,Oceania,W_OC,85,0,40438886,Oceania,9344,133
2020-07-01,Oceania,W_OC,77,0,40438886,Oceania,9421,133
2020-07-02,Oceania,W_OC,101,0,40438886,Oceania,9522,133
2020-07-03,Oceania,W_OC,88,0,40438886,Oceania,9610,133
2020-07-04,Oceania,W_OC,256,0,40438886,Oceania,9866,133
2020-07-05,Oceania,W_OC,110,0,40438886,Oceania,9976,133
2020-07-06,Oceania,W_OC,100,0,40438886,Oceania,10076,133
2020-07-07,Oceania,W_OC,143,2,40438886,Oceania,10219,135
2020-07-08,Oceania,W_OC,170,0,40438886,Oceania,10389,135
2020-07-09,Oceania,W_OC,142,0,40438886,Oceania,10531,135
2020-07-10,Oceania,W_OC,176,0,40438886,Oceania,10707,135
2020-07-11,Oceania,W_OC,303,0,40438886,Oceania,11010,135
2020-07-12,Oceania,W_OC,197,1,40438886,Oceania,11207,136
2020-07-13,Oceania,W_OC,249,1,40438886,Oceania,11456,137
2020-07-14,Oceania,W_OC,184,0,40438886,Oceania,11640,137
2020-07-15,Oceania,W_OC,278,0,40438886,Oceania,11918,137
2020-07-16,Oceania,W_OC,246,3,40438886,Oceania,12164,140
2020-07-17,Oceania,W_OC,317,2,40438886,Oceania,12481,142
2020-07-18,Oceania,W_OC,431,3,40438886,Oceania,12912,145
2020-07-19,Oceania,W_OC,209,2,40438886,Oceania,13121,147
2020-07-20,Oceania,W_OC,368,4,40438886,Oceania,13489,151
2020-07-21,Oceania,W_OC,279,1,40438886,Oceania,13768,152
2020-07-22,Oceania,W_OC,371,3,40438886,Oceania,14139,155
2020-07-23,Oceania,W_OC,473,2,40438886,Oceania,14612,157
2020-07-24,Oceania,W_OC,417,5,40438886,Oceania,15029,162
2020-07-25,Oceania,W_OC,290,6,40438886,Oceania,15319,168
2020-07-26,Oceania,W_OC,364,6,40438886,Oceania,15683,174
2020-07-27,Oceania,W_OC,485,10,40438886,Oceania,16168,184
2020-07-28,Oceania,W_OC,536,6,40438886,Oceania,16704,190
2020-07-29,Oceania,W_OC,374,7,40438886,Oceania,17078,197
2020-07-30,Oceania,W_OC,284,10,40438886,Oceania,17362,207
2020-07-31,Oceania,W_OC,732,13,40438886,Oceania,18094,220
2020-08-01,Oceania,W_OC,607,8,40438886,Oceania,18701,228
2020-08-02,Oceania,W_OC,402,4,40438886,Oceania,19103,232
2020-08-03,Oceania,W_OC,672,8,40438886,Oceania,19775,240
2020-08-04,Oceania,W_OC,403,13,40438886,Oceania,20178,253
2020-08-05,Oceania,W_OC,430,11,40438886,Oceania,20608,264
2020-08-06,Oceania,W_OC,762,15,40438886,Oceania,21370,279
2020-08-07,Oceania,W_OC,443,9,40438886,Oceania,21813,288
2020-08-08,Oceania,W_OC,437,11,40438886,Oceania,22250,299
2020-08-09,Oceania,W_OC,427,12,40438886,Oceania,22677,311
2020-08-10,Oceania,W_OC,418,17,40438886,Oceania,23095,328
2020-08-11,Oceania,W_OC,331,18,40438886,Oceania,23426,346
2020-08-12,Oceania,W_OC,402,18,40438886,Oceania,23828,364
2020-08-13,Oceania,W_OC,493,21,40438886,Oceania,24321,385
2020-08-14,Oceania,W_OC,285,9,40438886,Oceania,24606,394
2020-08-15,Oceania,W_OC,434,14,40438886,Oceania,25040,408
2020-08-16,Oceania,W_OC,319,4,40438886,Oceania,25359,412
2020-08-17,Oceania,W_OC,383,17,40438886,Oceania,25742,429
2020-08-18,Oceania,W_OC,376,25,40438886,Oceania,26118,454
2020-08-19,Oceania,W_OC,216,17,40438886,Oceania,26334,471
2020-08-20,Oceania,W_OC,258,12,40438886,Oceania,26592,483
2020-08-21,Oceania,W_OC,361,15,40438886,Oceania,26953,498
2020-08-22,Oceania,W_OC,244,10,40438886,Oceania,27197,508
2020-08-23,Oceania,W_OC,251,13,40438886,Oceania,27448,521
2020-08-24,Oceania,W_OC,258,17,40438886,Oceania,27706,538
2020-08-25,Oceania,W_OC,272,15,40438886,Oceania,27978,553
2020-08-26,Oceania,W_OC,237,10,40438886,Oceania,28215,563
2020-08-27,Oceania,W_OC,338,24,40438886,Oceania,28553,587
2020-08-28,Oceania,W_OC,246,24,40438886,Oceania,28799,611
2020-08-29,Oceania,W_OC,292,13,40438886,Oceania,29091,624
2020-08-30,Oceania,W_OC,167,17,40438886,Oceania,29258,641
2020-08-31,Oceania,W_OC,132,11,40438886,Oceania,29390,652
2020-09-01,Oceania,W_OC,245,41,40438886,Oceania,29635,693
2020-09-02,Oceania,W_OC,179,8,40438886,Oceania,29814,701
2020-09-03,Oceania,W_OC,140,6,40438886,Oceania,29954,707
2020-09-04,Oceania,W_OC,249,15,40438886,Oceania,30203,722
2020-09-05,Oceania,W_OC,182,60,40438886,Oceania,30385,782
2020-09-06,Oceania,W_OC,159,13,40438886,Oceania,30544,795
2020-09-07,Oceania,W_OC,85,5,40438886,Oceania,30629,800
2020-09-08,Oceania,W_OC,119,10,40438886,Oceania,30748,810
2020-09-09,Oceania,W_OC,106,12,40438886,Oceania,30854,822
2020-09-10,Oceania,W_OC,226,12,40438886,Oceania,31080,834
2020-09-11,Oceania,W_OC,140,9,40438886,Oceania,31220,843
2020-09-12,Oceania,W_OC,167,12,40438886,Oceania,31387,855
2020-09-13,Oceania,W_OC,76,9,40438886,Oceania,31463,864
2020-09-14,Oceania,W_OC,46,7,40438886,Oceania,31509,871
2020-09-15,Oceania,W_OC,227,8,40438886,Oceania,31736,879
2020-09-16,Oceania,W_OC,119,1,40438886,Oceania,31855,880
2020-09-17,Oceania,W_OC,118,10,40438886,Oceania,31973,890
2020-09-18,Oceania,W_OC,169,10,40438886,Oceania,32142,900
2020-09-19,Oceania,W_OC,69,8,40438886,Oceania,32211,908
2020-09-20,Oceania,W_OC,168,7,40438886,Oceania,32379,915
2020-09-21,Oceania,W_OC,62,6,40438886,Oceania,32441,921
2020-09-22,Oceania,W_OC,67,5,40438886,Oceania,32508,926
2020-09-23,Oceania,W_OC,78,6,40438886,Oceania,32586,932
2020-09-24,Oceania,W_OC,83,6,40438886,Oceania,32669,938
2020-09-25,Oceania,W_OC,12,2,40438886,Oceania,32681,940
2020-09-26,Oceania,W_OC,72,12,40438886,Oceania,32753,952
2020-09-27,Oceania,W_OC,86,1,40438886,Oceania,32839,953
2020-09-28,Oceania,W_OC,25,2,40438886,Oceania,32864,955
2020-09-29,Oceania,W_OC,376,9,40438886,Oceania,33240,964
2020-09-30,Oceania,W_OC,75,8,40438886,Oceania,33315,972
2020-10-01,Oceania,W_OC,0,0,40438886,Oceania,33315,972
2020-10-02,Oceania,W_OC,284,8,40438886,Oceania,33599,980
2020-10-03,Oceania,W_OC,192,3,40438886,Oceania,33791,983
2020-10-04,Oceania,W_OC,163,5,40438886,Oceania,33954,988
2020-10-05,Oceania,W_OC,16,2,40438886,Oceania,33970,990
2020-10-06,Oceania,W_OC,337,4,40438886,Oceania,34307,994
2020-10-07,Oceania,W_OC,93,1,40438886,Oceania,34400,995
2020-10-08,Oceania,W_OC,73,5,40438886,Oceania,34473,1000
2020-10-09,Oceania,W_OC,150,0,40438886,Oceania,34623,1000
2020-10-10,Oceania,W_OC,484,1,40438886,Oceania,35107,1001
2020-10-11,Oceania,W_OC,107,2,40438886,Oceania,35214,1003
2020-10-12,Oceania,W_OC,25,1,40438886,Oceania,35239,1004
2020-10-13,Oceania,W_OC,623,1,40438886,Oceania,35862,1005
2020-10-14,Oceania,W_OC,139,2,40438886,Oceania,36001,1007
2020-10-15,Oceania,W_OC,426,7,40438886,Oceania,36427,1014
2020-10-16,Oceania,W_OC,178,2,41108707,Oceania,36605,1016
2020-10-17,Oceania,W_OC,366,1,41108707,Oceania,36971,1017
2020-10-18,Oceania,W_OC,86,3,41108707,Oceania,37057,1020
2020-10-19,Oceania,W_OC,65,0,41108707,Oceania,37122,1020
2020-10-20,Oceania,W_OC,93,1,41108707,Oceania,37215,1021
2020-10-21,Oceania,W_OC,938,3,41108707,Oceania,38153,1024
2020-10-22,Oceania,W_OC,162,2,41108707,Oceania,38315,1026
2020-10-23,Oceania,W_OC,608,3,41108707,Oceania,38923,1029
2020-10-24,Oceania,W_OC,812,1,41108707,Oceania,39735,1030
2020-10-25,Oceania,W_OC,92,2,41108707,Oceania,39827,1032
2020-10-26,Oceania,W_OC,35,1,41108707,Oceania,39862,1033
2020-10-27,Oceania,W_OC,190,3,41108707,Oceania,40052,1036
2020-10-28,Oceania,W_OC,750,7,41108707,Oceania,40802,1043
2020-10-29,Oceania,W_OC,54,3,41167498,Oceania,40856,1046
2020-10-30,Oceania,W_OC,788,4,41167498,Oceania,41644,1050
2020-10-31,Oceania,W_OC,235,1,41167498,Oceania,41879,1051
2020-11-01,Oceania,W_OC,23,0,41167498,Oceania,41902,1051
2020-11-02,Oceania,W_OC,13,0,41167498,Oceania,41915,1051
2020-11-03,Oceania,W_OC,12,0,41167498,Oceania,41927,1051
2020-11-04,Oceania,W_OC,1526,11,41167498,Oceania,43453,1062
2020-11-05,Oceania,W_OC,408,2,41167498,Oceania,43861,1064
2020-11-06,Oceania,W_OC,454,3,41167498,Oceania,44315,1067
2020-11-07,Oceania,W_OC,590,4,41167498,Oceania,44905,1071
2020-11-08,Oceania,W_OC,254,0,41167498,Oceania,45159,1071
2020-11-09,Oceania,W_OC,132,0,41167498,Oceania,45291,1071
2020-11-10,Oceania,W_OC,13,2,41167498,Oceania,45304,1073
2020-11-11,Oceania,W_OC,1122,10,41467380,Oceania,46426,1083
2020-11-12,Oceania,W_OC,404,3,41467380,Oceania,46830,1086
2020-11-13,Oceania,W_OC,456,1,41467380,Oceania,47286,1087
2020-11-14,Oceania,W_OC,252,1,41467380,Oceania,47538,1088
2020-11-15,Oceania,W_OC,273,1,41467380,Oceania,47811,1089
2020-11-16,Oceania,W_OC,172,5,41467380,Oceania,47983,1094
2020-11-17,Oceania,W_OC,32,0,41467380,Oceania,48015,1094
2020-11-18,Oceania,W_OC,540,5,41467380,Oceania,48555,1099
2020-11-19,Oceania,W_OC,603,6,41467380,Oceania,49158,1105
2020-11-20,Oceania,W_OC,81,1,41467380,Oceania,49239,1106
2020-11-21,Oceania,W_OC,278,2,41467380,Oceania,49517,1108
2020-11-22,Oceania,W_OC,286,4,41467380,Oceania,49803,1112
2020-11-23,Oceania,W_OC,17,0,41467380,Oceania,49820,1112
2020-11-24,Oceania,W_OC,68,0,41467380,Oceania,49888,1112
2020-11-25,Oceania,W_OC,444,8,41467380,Oceania,50332,1120
2020-11-26,Oceania,W_OC,257,2,41467380,Oceania,50589,1122
2020-11-27,Oceania,W_OC,344,2,41467380,Oceania,50933,1124
2020-11-28,Oceania,W_OC,144,3,41467380,Oceania,51077,1127
2020-11-29,Oceania,W_OC,224,1,41467380,Oceania,51301,1128
2020-11-30,Oceania,W_OC,66,0,41467380,Oceania,51367,1128
2020-12-01,Oceania,W_OC,49,1,41467380,Oceania,51416,1129
2020-12-02,Oceania,W_OC,336,2,41467380,Oceania,51752,1131
2020-12-03,Oceania,W_OC,239,1,41467380,Oceania,51991,1132
2020-12-04,Oceania,W_OC,198,1,41467380,Oceania,52189,1133
2020-12-05,Oceania,W_OC,219,2,41467380,Oceania,52408,1135
2020-12-06,Oceania,W_OC,262,1,41467380,Oceania,52670,1136
2020-12-07,Oceania,W_OC,13,0,41467380,Oceania,52683,1136
2020-12-08,Oceania,W_OC,30,0,41467380,Oceania,52713,1136
2020-12-09,Oceania,W_OC,266,7,41467380,Oceania,52979,1143
2020-12-10,Oceania,W_OC,19,0,41467380,Oceania,52998,1143
2020-12-11,Oceania,W_OC,227,7,41467380,Oceania,53225,1150
2020-12-12,Oceania,W_OC,169,3,41467380,Oceania,53394,1153
2020-12-13,Oceania,W_OC,17,0,41467380,Oceania,53411,1153
2020-12-14,Oceania,W_OC,29,1,41467380,Oceania,53440,1154
2019-12-31,Other,W_OT,0,0,0,Other,0,0
2020-01-01,Other,W_OT,0,0,0,Other,0,0
2020-01-02,Other,W_OT,0,0,0,Other,0,0
2020-01-03,Other,W_OT,0,0,0,Other,0,0
2020-01-04,Other,W_OT,0,0,0,Other,0,0
2020-01-05,Other,W_OT,0,0,0,Other,0,0
2020-01-06,Other,W_OT,0,0,0,Other,0,0
2020-01-07,Other,W_OT,0,0,0,Other,0,0
2020-01-08,Other,W_OT,0,0,0,Other,0,0
2020-01-09,Other,W_OT,0,0,0,Other,0,0
2020-01-10,Other,W_OT,0,0,0,Other,0,0
2020-01-11,Other,W_OT,0,0,0,Other,0,0
2020-01-12,Other,W_OT,0,0,0,Other,0,0
2020-01-13,Other,W_OT,0,0,0,Other,0,0
2020-01-14,Other,W_OT,0,0,0,Other,0,0
2020-01-15,Other,W_OT,0,0,0,Other,0,0
2020-01-16,Other,W_OT,0,0,0,Other,0,0
2020-01-17,Other,W_OT,0,0,0,Other,0,0
2020-01-18,Other,W_OT,0,0,0,Other,0,0
2020-01-19,Other,W_OT,0,0,0,Other,0,0
2020-01-20,Other,W_OT,0,0,0,Other,0,0
2020-01-21,Other,W_OT,0,0,0,Other,0,0
2020-01-22,Other,W_OT,0,0,0,Other,0,0
2020-01-23,Other,W_OT,0,0,0,Other,0,0
2020-01-24,Other,W_OT,0,0,0,Other,0,0
2020-01-25,Other,W_OT,0,0,0,Other,0,0
2020-01-26,Other,W_OT,0,0,0,Other,0,0
2020-01-27,Other,W_OT,0,0,0,Other,0,0
2020-01-28,Other,W_OT,0,0,0,Other,0,0
2020-01-29,Other,W_OT,0,0,0,Other,0,0
2020-01-30,Other,W_OT,0,0,0,Other,0,0
2020-01-31,Other,W_OT,0,0,0,Other,0,0
2020-02-01,Other,W_OT,0,0,0,Other,0,0
2020-02-02,Other,W_OT,0,0,0,Other,0,0
2020-02-03,Other,W_OT,0,0,0,Other,0,0
2020-02-04,Other,W_OT,0,0,0,Other,0,0
2020-02-05,Other,W_OT,10,0,0,Other,10,0
2020-02-06,Other,W_OT,10,0,0,Other,20,0
2020-02-07,Other,W_OT,41,0,0,Other,61,0
2020-02-08,Other,W_OT,3,0,0,Other,64,0
2020-02-09,Other,W_OT,0,0,0,Other,64,0
2020-02-10,Other,W_OT,6,0,0,Other,70,0
2020-02-11,Other,W_OT,65,0,0,Other,135,0
2020-02-12,Other,W_OT,39,0,0,Other,174,0
2020-02-13,Other,W_OT,0,0,0,Other,174,0
2020-02-14,Other,W_OT,47,0,0,Other,221,0
2020-02-15,Other,W_OT,0,0,0,Other,221,0
2020-02-16,Other,W_OT,134,0,0,Other,355,0
2020-02-17,Other,W_OT,0,0,0,Other,355,0
2020-02-18,Other,W_OT,99,0,0,Other,454,0
2020-02-19,Other,W_OT,88,0,0,Other,542,0
2020-02-20,Other,W_OT,79,2,0,Other,621,2
2020-02-21,Other,W_OT,13,0,0,Other,634,2
2020-02-22,Other,W_OT,0,0,0,Other,634,2
2020-02-23,Other,W_OT,0,0,0,Other,634,2
2020-02-24,Other,W_OT,57,1,0,Other,691,3
2020-02-25,Other,W_OT,0,0,0,Other,691,3
2020-02-26,Other,W_OT,0,1,0,Other,691,4
2020-02-27,Other,W_OT,14,0,0,Other,705,4
2020-02-28,Other,W_OT,0,0,0,Other,705,4
2020-02-29,Other,W_OT,0,2,0,Other,705,6
2020-03-01,Other,W_OT,0,0,0,Other,705,6
2020-03-02,Other,W_OT,0,0,0,Other,705,6
2020-03-10,Other,W_OT,-9,1,0,Other,696,7
2019-12-31,World,W_WW,27,0,5800630205,World,27,0
2020-01-01,World,W_WW,0,0,5800630205,World,27,0
2020-01-02,World,W_WW,0,0,5800630205,World,27,0
2020-01-03,World,W_WW,17,0,5800630205,World,44,0
2020-01-04,World,W_WW,0,0,5800630205,World,44,0
2020-01-05,World,W_WW,15,0,5800630205,World,59,0
2020-01-06,World,W_WW,0,0,5800630205,World,59,0
2020-01-07,World,W_WW,0,0,5800630205,World,59,0
2020-01-08,World,W_WW,0,0,5800630205,World,59,0
2020-01-09,World,W_WW,0,0,5800630205,World,59,0
2020-01-10,World,W_WW,0,0,5800630205,World,59,0
2020-01-11,World,W_WW,0,1,5800630205,World,59,1
2020-01-12,World,W_WW,0,0,5800630205,World,59,1
2020-01-13,World,W_WW,1,0,5800630205,World,60,1
2020-01-14,World,W_WW,1,0,5800630205,World,61,1
2020-01-15,World,W_WW,1,1,5800630205,World,62,2
2020-01-16,World,W_WW,0,0,5800630205,World,62,2
2020-01-17,World,W_WW,5,0,5800630205,World,67,2
2020-01-18,World,W_WW,17,0,5800630205,World,84,2
2020-01-19,World,W_WW,136,1,5800630205,World,220,3
2020-01-20,World,W_WW,20,0,5800630205,World,240,3
2020-01-21,World,W_WW,153,3,5800630205,World,393,6
2020-01-22,World,W_WW,142,11,5800630205,World,535,17
2020-01-23,World,W_WW,97,0,5800630205,World,632,17
2020-01-24,World,W_WW,266,9,5800630205,World,898,26
2020-01-25,World,W_WW,453,15,5800630205,World,1351,41
2020-01-26,World,W_WW,673,15,5800630205,World,2024,56
2020-01-27,World,W_WW,797,25,5800630205,World,2821,81
2020-01-28,World,W_WW,1767,25,5800630205,World,4588,106
2020-01-29,World,W_WW,1480,26,5800630205,World,6068,132
2020-01-30,World,W_WW,1757,38,5800630205,World,7825,170
2020-01-31,World,W_WW,2001,43,5800630205,World,9826,213
2020-02-01,World,W_WW,2121,46,5800630205,World,11947,259
2020-02-02,World,W_WW,2608,46,5800630205,World,14555,305
2020-02-03,World,W_WW,2818,57,5800630205,World,17373,362
2020-02-04,World,W_WW,3243,65,5800630205,World,20616,427
2020-02-05,World,W_WW,3909,66,5800630205,World,24525,493
2020-02-06,World,W_WW,3751,72,5800630205,World,28276,565
2020-02-07,World,W_WW,3218,73,5800630205,World,31494,638
2020-02-08,World,W_WW,3442,86,5800630205,World,34936,724
2020-02-09,World,W_WW,2618,89,5800630205,World,37554,813
2020-02-10,World,W_WW,2992,97,5800630205,World,40546,910
2020-02-11,World,W_WW,2563,108,5800630205,World,43109,1018
2020-02-12,World,W_WW,2072,97,5800630205,World,45181,1115
2020-02-13,World,W_WW,15151,255,5800630205,World,60332,1370
2020-02-14,World,W_WW,4215,13,5800630205,World,64547,1383
2020-02-15,World,W_WW,2560,144,5800630205,World,67107,1527
2020-02-16,World,W_WW,2162,142,5800630205,World,69269,1669
2020-02-17,World,W_WW,2067,106,5800630205,World,71336,1775
2020-02-18,World,W_WW,1995,98,5800630205,World,73331,1873
2020-02-19,World,W_WW,1864,139,5800630205,World,75195,2012
2020-02-20,World,W_WW,532,116,5800630205,World,75727,2128
2020-02-21,World,W_WW,996,119,5800630205,World,76723,2247
2020-02-22,World,W_WW,1085,112,5800630205,World,77808,2359
2020-02-23,World,W_WW,1010,104,5800630205,World,78818,2463
2020-02-24,World,W_WW,523,156,5800630205,World,79341,2619
2020-02-25,World,W_WW,795,79,5800630205,World,80136,2698
2020-02-26,World,W_WW,867,64,5800630205,World,81003,2762
2020-02-27,World,W_WW,1114,38,5800630205,World,82117,2800
2020-02-28,World,W_WW,1271,57,5800630205,World,83388,2857
2020-02-29,World,W_WW,1860,64,5800630205,World,85248,2921
2020-03-01,World,W_WW,1843,58,5800630205,World,87091,2979
2020-03-02,World,W_WW,2068,67,5800630205,World,89159,3046
2020-03-03,World,W_WW,1858,72,4567389411,World,91017,3118
2020-03-04,World,W_WW,2315,84,4920048814,World,93332,3202
2020-03-05,World,W_WW,2357,80,4677203695,World,95689,3282
2020-03-06,World,W_WW,3060,102,4933090549,World,98749,3384
2020-03-07,World,W_WW,4120,104,5620913264,World,102869,3488
2020-03-08,World,W_WW,3980,97,5009256492,World,106849,3585
2020-03-09,World,W_WW,4177,228,4241015570,World,111026,3813
2020-03-10,World,W_WW,4820,209,5510451631,World,115846,4022
2020-03-11,World,W_WW,5117,272,5819218365,World,120963,4294
2020-03-12,World,W_WW,7922,345,5997982896,World,128885,4639
2020-03-13,World,W_WW,9475,350,5688134813,World,138360,4989
2020-03-14,World,W_WW,10464,443,6242164573,World,148824,5432
2020-03-15,World,W_WW,12191,367,6911409997,World,161015,5799
2020-03-16,World,W_WW,12489,751,6880225117,World,173504,6550
2020-03-17,World,W_WW,14238,607,7241159761,World,187742,7157
2020-03-18,World,W_WW,17094,811,7209323464,World,204836,7968
2020-03-19,World,W_WW,20289,963,7248019539,World,225125,8931
2020-03-20,World,W_WW,31204,1075,7278438430,World,256329,10006
2020-03-21,World,W_WW,31985,1387,7353471065,World,288314,11393
2020-03-22,World,W_WW,34234,1716,7434356188,World,322548,13109
2020-03-23,World,W_WW,34270,1691,7481976173,World,356818,14800
2020-03-24,World,W_WW,44560,1854,7536786258,World,401378,16654
2020-03-25,World,W_WW,42544,2316,7550718531,World,443922,18970
2020-03-26,World,W_WW,53825,2645,7570635200,World,497747,21615
2020-03-27,World,W_WW,61109,2814,7572601022,World,558856,24429
2020-03-28,World,W_WW,65192,3492,7575534426,World,624048,27921
2020-03-29,World,W_WW,62847,3590,7575534426,World,686895,31511
2020-03-30,World,W_WW,57369,3231,7575534426,World,744264,34742
2020-03-31,World,W_WW,64722,3993,7575174938,World,808986,38735
2020-04-01,World,W_WW,74847,4677,7597234135,World,883833,43412
2020-04-02,World,W_WW,77636,5016,7597265109,World,961469,48428
2020-04-03,World,W_WW,77647,5026,7615893858,World,1039116,53454
2020-04-04,World,W_WW,82003,6786,7615897230,World,1121119,60240
2020-04-05,World,W_WW,85274,6299,7610915808,World,1206393,66539
2020-04-06,World,W_WW,66262,4772,7626959344,World,1272655,71311
2020-04-07,World,W_WW,73306,5345,7626959344,World,1345961,76656
2020-04-08,World,W_WW,77348,7576,7626959344,World,1423309,84232
2020-04-09,World,W_WW,85091,6572,7627174392,World,1508400,90804
2020-04-10,World,W_WW,87409,7425,7656336314,World,1595809,98229
2020-04-11,World,W_WW,89630,7015,7656336314,World,1685439,105244
2020-04-12,World,W_WW,75356,6064,7656336314,World,1760795,111308
2020-04-13,World,W_WW,68521,5334,7656336314,World,1829316,116642
2020-04-14,World,W_WW,65259,5390,7656336314,World,1894575,122032
2020-04-15,World,W_WW,76975,7619,7656336314,World,1971550,129651
2020-04-16,World,W_WW,78819,10491,7656336314,World,2050369,140142
2020-04-17,World,W_WW,84428,8527,7656336314,World,2134797,148669
2020-04-18,World,W_WW,82272,8463,7656336314,World,2217069,157132
2020-04-19,World,W_WW,79693,6373,7656336314,World,2296762,163505
2020-04-20,World,W_WW,70507,4988,7656336314,World,2367269,168493
2020-04-21,World,W_WW,74666,5450,7656336314,World,2441935,173943
2020-04-22,World,W_WW,87310,7243,7656336314,World,2529245,181186
2020-04-23,World,W_WW,66604,5935,7656336314,World,2595849,187121
2020-04-24,World,W_WW,78789,7335,7656336314,World,2674638,194456
2020-04-25,World,W_WW,73149,5359,7656336314,World,2747787,199815
2020-04-26,World,W_WW,99848,6161,7656918772,World,2847635,205976
2020-04-27,World,W_WW,81832,3912,7656918772,World,2929467,209888
2020-04-28,World,W_WW,66781,4899,7656918772,World,2996248,214787
2020-04-29,World,W_WW,72825,6566,7656918772,World,3069073,221353
2020-04-30,World,W_WW,79507,6562,7656918772,World,3148580,227915
2020-05-01,World,W_WW,85674,5650,7666239795,World,3234254,233565
2020-05-02,World,W_WW,88530,5577,7667090686,World,3322784,239142
2020-05-03,World,W_WW,80639,4808,7667090686,World,3403423,243950
2020-05-04,World,W_WW,77017,3706,7667090686,World,3480440,247656
2020-05-05,World,W_WW,77607,3986,7667090686,World,3558047,251642
2020-05-06,World,W_WW,79558,5957,7667090686,World,3637605,257599
2020-05-07,World,W_WW,88302,6124,7667090686,World,3725907,263723
2020-05-08,World,W_WW,92817,5642,7667090686,World,3818724,269365
2020-05-09,World,W_WW,89696,5112,7667090686,World,3908420,274477
2020-05-10,World,W_WW,88423,4406,7667090686,World,3996843,278883
2020-05-11,World,W_WW,74535,3426,7667090686,World,4071378,282309
2020-05-12,World,W_WW,71367,3590,7667090686,World,4142745,285899
2020-05-13,World,W_WW,87118,5758,7667090686,World,4229863,291657
2020-05-14,World,W_WW,87502,5017,7667090686,World,4317365,296674
2020-05-15,World,W_WW,97180,5256,7669215953,World,4414545,301930
2020-05-16,World,W_WW,98236,5059,7669215953,World,4512781,306989
2020-05-17,World,W_WW,92967,4224,7669215953,World,4605748,311213
2020-05-18,World,W_WW,79049,2898,7669215953,World,4684797,314111
2020-05-19,World,W_WW,87957,3298,7669215953,World,4772754,317409
2020-05-20,World,W_WW,96382,5184,7669215953,World,4869136,322593
2020-05-21,World,W_WW,104973,4718,7669215953,World,4974109,327311
2020-05-22,World,W_WW,108771,5389,7669215953,World,5082880,332700
2020-05-23,World,W_WW,106811,4646,7669215953,World,5189691,337346
2020-05-24,World,W_WW,98946,3916,7669215953,World,5288637,341262
2020-05-25,World,W_WW,92252,1106,7669215953,World,5380889,342368
2020-05-26,World,W_WW,90950,3368,7669215953,World,5471839,345736
2020-05-27,World,W_WW,94641,3871,7669215953,World,5566480,349607
2020-05-28,World,W_WW,103816,5143,7669215953,World,5670296,354750
2020-05-29,World,W_WW,119328,4641,7669215953,World,5789624,359391
2020-05-30,World,W_WW,123188,4656,7669215953,World,5912812,364047
2020-05-31,World,W_WW,127764,4010,7669215953,World,6040576,368057
2020-06-01,World,W_WW,105626,2914,7669215953,World,6146202,370971
2020-06-02,World,W_WW,102772,3145,7669215953,World,6248974,374116
2020-06-03,World,W_WW,113214,4544,7669215953,World,6362188,378660
2020-06-04,World,W_WW,126514,5516,7669215953,World,6488702,384176
2020-06-05,World,W_WW,127354,5130,7669215953,World,6616056,389306
2020-06-06,World,W_WW,133856,4639,7669215953,World,6749912,393945
2020-06-07,World,W_WW,125387,3787,7669215953,World,6875299,397732
2020-06-08,World,W_WW,113667,3511,7669215953,World,6988966,401243
2020-06-09,World,W_WW,108752,3214,7669215953,World,7097718,404457
2020-06-10,World,W_WW,126773,4853,7669215953,World,7224491,409310
2020-06-11,World,W_WW,135663,5131,7669215953,World,7360154,414441
2020-06-12,World,W_WW,136728,4695,7669215953,World,7496882,419136
2020-06-13,World,W_WW,144986,4647,7669215953,World,7641868,423783
2020-06-14,World,W_WW,132970,4139,7669215953,World,7774838,427922
2020-06-15,World,W_WW,119616,3157,7669215953,World,7894454,431079
2020-06-16,World,W_WW,121596,3377,7669215953,World,8016050,434456
2020-06-17,World,W_WW,143251,6719,7669215953,World,8159301,441175
2020-06-18,World,W_WW,178023,5099,7640700124,World,8337324,446274
2020-06-19,World,W_WW,138809,6275,7669215953,World,8476133,452549
2020-06-20,World,W_WW,181355,5032,7669215953,World,8657488,457581
2020-06-21,World,W_WW,159136,4116,7669215953,World,8816624,461697
2020-06-22,World,W_WW,126285,3967,7669215953,World,8942909,465664
2020-06-23,World,W_WW,136494,3395,7669215953,World,9079403,469059
2020-06-24,World,W_WW,164177,5350,7669215953,World,9243580,474409
2020-06-25,World,W_WW,175824,5215,7669215953,World,9419404,479624
2020-06-26,World,W_WW,178867,6577,7669215953,World,9598271,486201
2020-06-27,World,W_WW,189698,4560,7669215953,World,9787969,490761
2020-06-28,World,W_WW,181247,4591,7669215953,World,9969216,495352
2020-06-29,World,W_WW,159070,3070,7669215953,World,10128286,498422
2020-06-30,World,W_WW,161815,3704,7669215953,World,10290101,502126
2020-07-01,World,W_WW,193798,5623,7669215953,World,10483899,507749
2020-07-02,World,W_WW,202237,4839,7669215953,World,10686136,512588
2020-07-03,World,W_WW,208885,5077,7669215953,World,10895021,517665
2020-07-04,World,W_WW,205799,5012,7669215953,World,11100820,522677
2020-07-05,World,W_WW,187773,4339,7669215953,World,11288593,527016
2020-07-06,World,W_WW,176549,3378,7669215953,World,11465142,530394
2020-07-07,World,W_WW,177163,3841,7669215953,World,11642305,534235
2020-07-08,World,W_WW,208510,5996,7669215953,World,11850815,540231
2020-07-09,World,W_WW,215913,5277,7669215953,World,12066728,545508
2020-07-10,World,W_WW,224960,5383,7669215953,World,12291688,550891
2020-07-11,World,W_WW,231720,5277,7669215953,World,12523408,556168
2020-07-12,World,W_WW,215719,4793,7669215953,World,12739127,560961
2020-07-13,World,W_WW,194193,3889,7669215953,World,12933320,564850
2020-07-14,World,W_WW,192553,3839,7669215953,World,13125873,568689
2020-07-15,World,W_WW,225054,5578,7669215953,World,13350927,574267
2020-07-16,World,W_WW,234288,5501,7669215953,World,13585215,579768
2020-07-17,World,W_WW,256151,5744,7669215953,World,13841366,585512
2020-07-18,World,W_WW,248828,7233,7669215953,World,14090194,592745
2020-07-19,World,W_WW,227019,4978,7669215953,World,14317213,597723
2020-07-20,World,W_WW,213629,3935,7669215953,World,14530842,601658
2020-07-21,World,W_WW,204635,4092,7669215953,World,14735477,605750
2020-07-22,World,W_WW,241538,6123,7669215953,World,14977015,611873
2020-07-23,World,W_WW,283889,6877,7669215953,World,15260904,618750
2020-07-24,World,W_WW,275842,9779,7669215953,World,15536746,628529
2020-07-25,World,W_WW,284289,6256,7669215953,World,15821035,634785
2020-07-26,World,W_WW,257000,5733,7669215953,World,16078035,640518
2020-07-27,World,W_WW,229330,3963,7669215953,World,16307365,644481
2020-07-28,World,W_WW,215352,4656,7669215953,World,16522717,649137
2020-07-29,World,W_WW,244711,6160,7669215953,World,16767428,655297
2020-07-30,World,W_WW,299972,6641,7669215953,World,17067400,661938
2020-07-31,World,W_WW,290225,6383,7669215953,World,17357625,668321
2020-08-01,World,W_WW,277273,6122,7669215953,World,17634898,674443
2020-08-02,World,W_WW,262019,5758,7669215953,World,17896917,680201
2020-08-03,World,W_WW,220912,4233,7669215953,World,18117829,684434
2020-08-04,World,W_WW,207322,4226,7669215953,World,18325151,688660
2020-08-05,World,W_WW,256816,6730,7669215953,World,18581967,695390
2020-08-06,World,W_WW,277848,7098,7669215953,World,18859815,702488
2020-08-07,World,W_WW,285966,6895,7669215953,World,19145781,709383
2020-08-08,World,W_WW,275842,6467,7669215953,World,19421623,715850
2020-08-09,World,W_WW,265704,5634,7669215953,World,19687327,721484
2020-08-10,World,W_WW,227503,4824,7669215953,World,19914830,726308
2020-08-11,World,W_WW,221187,4817,7669215953,World,20136017,731125
2020-08-12,World,W_WW,261628,6137,7669215953,World,20397645,737262
2020-08-13,World,W_WW,289725,6900,7669215953,World,20687370,744162
2020-08-14,World,W_WW,285521,9909,7669215953,World,20972891,754071
2020-08-15,World,W_WW,289466,6240,7669215953,World,21262357,760311
2020-08-16,World,W_WW,256330,5657,7669215953,World,21518687,765968
2020-08-17,World,W_WW,230261,4233,7669215953,World,21748948,770201
2020-08-18,World,W_WW,199624,4297,7669215953,World,21948572,774498
2020-08-19,World,W_WW,258063,6696,7669215953,World,22206635,781194
2020-08-20,World,W_WW,280651,6512,7669215953,World,22487286,787706
2020-08-21,World,W_WW,274449,6353,7669215953,World,22761735,794059
2020-08-22,World,W_WW,254316,5870,7669215953,World,23016051,799929
2020-08-23,World,W_WW,263315,5642,7669215953,World,23279366,805571
2020-08-24,World,W_WW,224243,3340,7669215953,World,23503609,808911
2020-08-25,World,W_WW,213162,4247,7669215953,World,23716771,813158
2020-08-26,World,W_WW,256567,6477,7669215953,World,23973338,819635
2020-08-27,World,W_WW,278253,6294,7669215953,World,24251591,825929
2020-08-28,World,W_WW,283627,6082,7669215953,World,24535218,832011
2020-08-29,World,W_WW,276977,5457,7669215953,World,24812195,837468
2020-08-30,World,W_WW,266041,5698,7669215953,World,25078236,843166
2020-08-31,World,W_WW,243225,3773,7669215953,World,25321461,846939
2020-09-01,World,W_WW,245521,4052,7669215953,World,25566982,850991
2020-09-02,World,W_WW,269000,6513,7669215953,World,25835982,857504
2020-09-03,World,W_WW,284989,6077,7669215953,World,26120971,863581
2020-09-04,World,W_WW,280050,5792,7669215953,World,26401021,869373
2020-09-05,World,W_WW,294918,5624,7669215953,World,26695939,874997
2020-09-06,World,W_WW,273436,5325,7669215953,World,26969375,880322
2020-09-07,World,W_WW,246041,9033,7669215953,World,27215416,889355
2020-09-08,World,W_WW,209003,3820,7669215953,World,27424419,893175
2020-09-09,World,W_WW,245736,4964,7669215953,World,27670155,898139
2020-09-10,World,W_WW,289163,6093,7669215953,World,27959318,904232
2020-09-11,World,W_WW,305692,5893,7669215953,World,28265010,910125
2020-09-12,World,W_WW,304680,5884,7669215953,World,28569690,916009
2020-09-13,World,W_WW,284187,4927,7669215953,World,28853877,920936
2020-09-14,World,W_WW,269918,3880,7669215953,World,29123795,924816
2020-09-15,World,W_WW,245519,4236,7669215953,World,29369314,929052
2020-09-16,World,W_WW,303580,6956,7669215953,World,29672894,936008
2020-09-17,World,W_WW,289646,5437,7669215953,World,29962540,941445
2020-09-18,World,W_WW,318191,5320,7669215953,World,30280731,946765
2020-09-19,World,W_WW,311995,5955,7669215953,World,30592726,952720
2020-09-20,World,W_WW,293472,5073,7669215953,World,30886198,957793
2020-09-21,World,W_WW,284342,3743,7669215953,World,31170540,961536
2020-09-22,World,W_WW,268933,4394,7669215953,World,31439473,965930
2020-09-23,World,W_WW,282714,6067,7669215953,World,31722187,971997
2020-09-24,World,W_WW,311482,6364,7669215953,World,32033669,978361
2020-09-25,World,W_WW,320879,5783,7669215953,World,32354548,984144
2020-09-26,World,W_WW,311601,5577,7669215953,World,32666149,989721
2020-09-27,World,W_WW,299288,5422,7669215953,World,32965437,995143
2020-09-28,World,W_WW,279884,3824,7669215953,World,33245321,998967
2020-09-29,World,W_WW,238454,3923,7669215953,World,33483775,1002890
2020-09-30,World,W_WW,293934,6218,7669215953,World,33777709,1009108
2020-10-01,World,W_WW,316026,6109,7669215953,World,34093735,1015217
2020-10-02,World,W_WW,323180,8773,7669215953,World,34416915,1023990
2020-10-03,World,W_WW,318812,5534,7669215953,World,34735727,1029524
2020-10-04,World,W_WW,301978,4724,7669215953,World,35037705,1034248
2020-10-05,World,W_WW,281076,3966,7669215953,World,35318781,1038214
2020-10-06,World,W_WW,270276,4452,7669215953,World,35589057,1042666
2020-10-07,World,W_WW,326777,5618,7669215953,World,35915834,1048284
2020-10-08,World,W_WW,353626,5851,7669215953,World,36269460,1054135
2020-10-09,World,W_WW,363056,9119,7669215953,World,36632516,1063254
2020-10-10,World,W_WW,349258,5742,7669215953,World,36981774,1068996
2020-10-11,World,W_WW,349426,4867,7669215953,World,37331200,1073863
2020-10-12,World,W_WW,304057,3973,7669215953,World,37635257,1077836
2020-10-13,World,W_WW,285068,3939,7669215953,World,37920325,1081775
2020-10-14,World,W_WW,330727,5531,7669215953,World,38251052,1087306
2020-10-15,World,W_WW,388395,6039,7669215953,World,38639447,1093345
2020-10-16,World,W_WW,402619,6111,7669885774,World,39042066,1099456
2020-10-17,World,W_WW,397435,5947,7669885774,World,39439501,1105403
2020-10-18,World,W_WW,370484,5543,7669885774,World,39809985,1110946
2020-10-19,World,W_WW,362010,3954,7669885774,World,40171995,1114900
2020-10-20,World,W_WW,348700,4672,7669885774,World,40520695,1119572
2020-10-21,World,W_WW,394988,6415,7669885774,World,40915683,1125987
2020-10-22,World,W_WW,452243,6754,7669885774,World,41367926,1132741
2020-10-23,World,W_WW,472504,6367,7669885774,World,41840430,1139108
2020-10-24,World,W_WW,488773,6339,7669885774,World,42329203,1145447
2020-10-25,World,W_WW,459610,5798,7669885774,World,42788813,1151245
2020-10-26,World,W_WW,438930,4449,7669885774,World,43227743,1155694
2020-10-27,World,W_WW,415915,5472,7669885774,World,43643658,1161166
2020-10-28,World,W_WW,479372,7337,7669885774,World,44123030,1168503
2020-10-29,World,W_WW,513461,7153,7669944565,World,44636491,1175656
2020-10-30,World,W_WW,548100,7186,7669944565,World,45184591,1182842
2020-10-31,World,W_WW,542159,7320,7669944565,World,45726750,1190162
2020-11-01,World,W_WW,457999,6426,7669944565,World,46184749,1196588
2020-11-02,World,W_WW,487232,5338,7669944565,World,46671981,1201926
2020-11-03,World,W_WW,470495,6114,7669944565,World,47142476,1208040
2020-11-04,World,W_WW,504994,9859,7669944565,World,47647470,1217899
2020-11-05,World,W_WW,569890,9082,7669944565,World,48217360,1226981
2020-11-06,World,W_WW,612387,8784,7669944565,World,48829747,1235765
2020-11-07,World,W_WW,606017,8678,7669944565,World,49435764,1244443
2020-11-08,World,W_WW,593273,7459,7669944565,World,50029037,1251902
2020-11-09,World,W_WW,528837,6289,7669944565,World,50557874,1258191
2020-11-10,World,W_WW,502287,7281,7669944565,World,51060161,1265472
2020-11-11,World,W_WW,566934,10128,7670244447,World,51627095,1275600
2020-11-12,World,W_WW,623511,10611,7670244447,World,52250606,1286211
2020-11-13,World,W_WW,647500,9151,7670244447,World,52898106,1295362
2020-11-14,World,W_WW,635825,9996,7670244447,World,53533931,1305358
2020-11-15,World,W_WW,594468,8975,7670244447,World,54128399,1314333
2020-11-16,World,W_WW,514538,6694,7670244447,World,54642937,1321027
2020-11-17,World,W_WW,522070,8141,7670244447,World,55165007,1329168
2020-11-18,World,W_WW,584404,10708,7670244447,World,55749411,1339876
2020-11-19,World,W_WW,623134,11106,7670244447,World,56372545,1350982
2020-11-20,World,W_WW,640252,10732,7670244447,World,57012797,1361714
2020-11-21,World,W_WW,679246,12012,7670244447,World,57692043,1373726
2020-11-22,World,W_WW,572279,8541,7670244447,World,58264322,1382267
2020-11-23,World,W_WW,518260,7161,7670244447,World,58782582,1389428
2020-11-24,World,W_WW,534370,8886,7670244447,World,59316952,1398314
2020-11-25,World,W_WW,562359,12208,7670244447,World,59879311,1410522
2020-11-26,World,W_WW,647881,12631,7670244447,World,60527192,1423153
2020-11-27,World,W_WW,571827,10713,7670244447,World,61099019,1433866
2020-11-28,World,W_WW,649373,10426,7670244447,World,61748392,1444292
2020-11-29,World,W_WW,595768,9546,7670244447,World,62344160,1453838
2020-11-30,World,W_WW,516616,7410,7670244447,World,62860776,1461248
2020-12-01,World,W_WW,501937,8803,7670244447,World,63362713,1470051
2020-12-02,World,W_WW,591801,12786,7670244447,World,63954514,1482837
2020-12-03,World,W_WW,657717,12773,7670244447,World,64612231,1495610
2020-12-04,World,W_WW,681109,11941,7670244447,World,65293340,1507551
2020-12-05,World,W_WW,683363,12459,7670244447,World,65976703,1520010
2020-12-06,World,W_WW,634276,9924,7670244447,World,66610979,1529934
2020-12-07,World,W_WW,546373,7500,7670244447,World,67157352,1537434
2020-12-08,World,W_WW,526221,8360,7670244447,World,67683573,1545794
2020-12-09,World,W_WW,626355,12642,7670244447,World,68309928,1558436
2020-12-10,World,W_WW,676114,12376,7670244447,World,68986042,1570812
2020-12-11,World,W_WW,693352,12327,7670244447,World,69679394,1583139
2020-12-12,World,W_WW,657140,12355,7670244447,World,70336534,1595494
2020-12-13,World,W_WW,626421,10254,7670244447,World,70962955,1605748
2020-12-14,World,W_WW,540659,7085,7623307387,World,71503614,1612833
