cid,week,cases,deaths,country,population,continent,cum_cases,cum_deaths
ABW,2020-14,14,0,Aruba,106766,America,14,0
ABW,2020-15,28,0,Aruba,106766,America,42,0
ABW,2020-16,5,2,Aruba,106766,America,47,2
ABW,2020-17,3,0,Aruba,106766,America,50,2
ABW,2020-18,0,0,Aruba,106766,America,50,2
ABW,2020-19,1,1,Aruba,106766,America,51,3
ABW,2020-20,0,0,Aruba,106766,America,51,3
ABW,2020-21,0,0,Aruba,106766,America,51,3
ABW,2020-22,0,0,Aruba,106766,America,51,3
ABW,2020-23,0,0,Aruba,106766,America,51,3
ABW,2020-24,0,0,Aruba,106766,America,51,3
ABW,2020-25,0,0,Aruba,106766,America,51,3
ABW,2020-26,0,0,Aruba,106766,America,51,3
ABW,2020-27,4,0,Aruba,106766,America,55,3
ABW,2020-28,0,0,Aruba,106766,America,55,3
ABW,2020-29,8,0,Aruba,106766,America,63,3
ABW,2020-30,6,0,Aruba,106766,America,69,3
ABW,2020-31,3,0,Aruba,106766,America,72,3
ABW,2020-32,441,0,Aruba,106766,America,513,3
ABW,2020-33,539,1,Aruba,106766,America,1052,4
ABW,2020-34,466,3,Aruba,106766,America,1518,7
ABW,2020-35,429,3,Aruba,106766,America,1947,10
ABW,2020-36,452,4,Aruba,106766,America,2399,14
ABW,2020-37,597,4,Aruba,106766,America,2996,18
ABW,2020-38,505,5,Aruba,106766,America,3501,23
ABW,2020-39,293,2,Aruba,106766,America,3794,25
ABW,2020-40,235,5,Aruba,106766,America,4029,30
ABW,2020-41,115,2,Aruba,106766,America,4144,32
ABW,2020-42,128,2,Aruba,106766,America,4272,34
ABW,2020-43,98,2,Aruba,106766,America,4370,36
ABW,2020-44,99,2,Aruba,106766,America,4469,38
ABW,2020-45,81,2,Aruba,106766,America,4550,40
ABW,2020-46,62,4,Aruba,106766,America,4612,44
ABW,2020-47,69,1,Aruba,106766,America,4681,45
ABW,2020-48,107,0,Aruba,106766,America,4788,45
ABW,2020-49,127,0,Aruba,106766,America,4915,45
ABW,2020-50,84,1,Aruba,106766,America,4999,46
ABW,2020-51,127,1,Aruba,106766,America,5126,47
ABW,2020-52,147,2,Aruba,106766,America,5273,49
ABW,2020-53,241,0,Aruba,106766,America,5514,49
ABW,2021-01,504,3,Aruba,106766,America,6018,52
ABW,2021-02,367,0,Aruba,106766,America,6385,52
ABW,2021-03,307,5,Aruba,106766,America,6692,57
ABW,2021-04,244,2,Aruba,106766,America,6936,59
ABW,2021-05,252,5,Aruba,106766,America,7188,64
ABW,2021-06,200,4,Aruba,106766,America,7388,68
ABW,2021-07,254,3,Aruba,106766,America,7642,71
ABW,2021-08,216,3,Aruba,106766,America,7858,74
ABW,2021-09,219,3,Aruba,106766,America,8077,77
ABW,2021-10,294,2,Aruba,106766,America,8371,79
ABW,2021-11,379,3,Aruba,106766,America,8750,82
ABW,2021-12,494,0,Aruba,106766,America,9244,82
ABW,2021-13,387,8,Aruba,106766,America,9631,90
ABW,2021-14,369,2,Aruba,106766,America,10000,92
ABW,2021-15,295,0,Aruba,106766,America,10295,92
ABW,2021-16,210,6,Aruba,106766,America,10505,98
ABW,2021-17,124,2,Aruba,106766,America,10629,100
ABW,2021-18,91,1,Aruba,106766,America,10720,101
ABW,2021-19,87,4,Aruba,106766,America,10807,105
ABW,2021-20,65,2,Aruba,106766,America,10872,107
ABW,2021-21,63,0,Aruba,106766,America,10935,107
ABW,2021-22,74,0,Aruba,106766,America,11009,107
ABW,2021-23,21,0,Aruba,106766,America,11030,107
ABW,2021-24,28,0,Aruba,106766,America,11058,107
ABW,2021-25,24,0,Aruba,106766,America,11082,107
ABW,2021-26,12,0,Aruba,106766,America,11094,107
ABW,2021-27,33,0,Aruba,106766,America,11127,107
ABW,2021-28,57,1,Aruba,106766,America,11184,108
ABW,2021-29,171,1,Aruba,106766,America,11355,109
ABW,2021-30,402,2,Aruba,106766,America,11757,111
ABW,2021-31,722,0,Aruba,106766,America,12479,111
ABW,2021-32,877,10,Aruba,106766,America,13356,121
AFG,2020-02,0,0,Afghanistan,38928341,Asia,0,0
AFG,2020-03,0,0,Afghanistan,38928341,Asia,0,0
AFG,2020-04,0,0,Afghanistan,38928341,Asia,0,0
AFG,2020-05,0,0,Afghanistan,38928341,Asia,0,0
AFG,2020-06,0,0,Afghanistan,38928341,Asia,0,0
AFG,2020-07,0,0,Afghanistan,38928341,Asia,0,0
AFG,2020-08,0,0,Afghanistan,38928341,Asia,0,0
AFG,2020-09,1,0,Afghanistan,38928341,Asia,1,0
AFG,2020-10,3,0,Afghanistan,38928341,Asia,4,0
AFG,2020-11,12,0,Afghanistan,38928341,Asia,16,0
AFG,2020-12,18,0,Afghanistan,38928341,Asia,34,0
AFG,2020-13,80,4,Afghanistan,38928341,Asia,114,4
AFG,2020-14,185,3,Afghanistan,38928341,Asia,299,7
AFG,2020-15,308,11,Afghanistan,38928341,Asia,607,18
AFG,2020-16,389,15,Afghanistan,38928341,Asia,996,33
AFG,2020-17,535,24,Afghanistan,38928341,Asia,1531,57
AFG,2020-18,1173,28,Afghanistan,38928341,Asia,2704,85
AFG,2020-19,1698,35,Afghanistan,38928341,Asia,4402,120
AFG,2020-20,2262,49,Afghanistan,38928341,Asia,6664,169
AFG,2020-21,3918,49,Afghanistan,38928341,Asia,10582,218
AFG,2020-22,4623,39,Afghanistan,38928341,Asia,15205,257
AFG,2020-23,5137,100,Afghanistan,38928341,Asia,20342,357
AFG,2020-24,4424,114,Afghanistan,38928341,Asia,24766,471
AFG,2020-25,4067,110,Afghanistan,38928341,Asia,28833,581
AFG,2020-26,2134,140,Afghanistan,38928341,Asia,30967,721
AFG,2020-27,1984,143,Afghanistan,38928341,Asia,32951,864
AFG,2020-28,1500,146,Afghanistan,38928341,Asia,34451,1010
AFG,2020-29,1024,171,Afghanistan,38928341,Asia,35475,1181
AFG,2020-30,788,88,Afghanistan,38928341,Asia,36263,1269
AFG,2020-31,447,15,Afghanistan,38928341,Asia,36710,1284
AFG,2020-32,344,28,Afghanistan,38928341,Asia,37054,1312
AFG,2020-33,542,63,Afghanistan,38928341,Asia,37596,1375
AFG,2020-34,403,12,Afghanistan,38928341,Asia,37999,1387
AFG,2020-35,163,15,Afghanistan,38928341,Asia,38162,1402
AFG,2020-36,236,10,Afghanistan,38928341,Asia,38398,1412
AFG,2020-37,318,8,Afghanistan,38928341,Asia,38716,1420
AFG,2020-38,328,21,Afghanistan,38928341,Asia,39044,1441
AFG,2020-39,183,12,Afghanistan,38928341,Asia,39227,1453
AFG,2020-40,114,9,Afghanistan,38928341,Asia,39341,1462
AFG,2020-41,458,15,Afghanistan,38928341,Asia,39799,1477
AFG,2020-42,401,15,Afghanistan,38928341,Asia,40200,1492
AFG,2020-43,633,22,Afghanistan,38928341,Asia,40833,1514
AFG,2020-44,800,27,Afghanistan,38928341,Asia,41633,1541
AFG,2020-45,606,24,Afghanistan,38928341,Asia,42239,1565
AFG,2020-46,1164,61,Afghanistan,38928341,Asia,43403,1626
AFG,2020-47,1368,69,Afghanistan,38928341,Asia,44771,1695
AFG,2020-48,1073,68,Afghanistan,38928341,Asia,45844,1763
AFG,2020-49,1672,137,Afghanistan,38928341,Asia,47516,1900
AFG,2020-50,1757,71,Afghanistan,38928341,Asia,49273,1971
AFG,2020-51,740,111,Afghanistan,38928341,Asia,50013,2082
AFG,2020-52,1994,88,Afghanistan,38928341,Asia,52007,2170
AFG,2020-53,902,60,Afghanistan,38928341,Asia,52909,2230
AFG,2021-01,675,71,Afghanistan,38928341,Asia,53584,2301
AFG,2021-02,557,45,Afghanistan,38928341,Asia,54141,2346
AFG,2021-03,713,43,Afghanistan,38928341,Asia,54854,2389
AFG,2021-04,267,16,Afghanistan,38928341,Asia,55121,2405
AFG,2021-05,238,8,Afghanistan,38928341,Asia,55359,2413
AFG,2021-06,155,14,Afghanistan,38928341,Asia,55514,2427
AFG,2021-07,0,0,Afghanistan,38928341,Asia,55514,2427
AFG,2021-08,245,19,Afghanistan,38928341,Asia,55759,2446
AFG,2021-09,117,5,Afghanistan,38928341,Asia,55876,2451
AFG,2021-10,119,9,Afghanistan,38928341,Asia,55995,2460
AFG,2021-11,182,6,Afghanistan,38928341,Asia,56177,2466
AFG,2021-12,117,4,Afghanistan,38928341,Asia,56294,2470
AFG,2021-13,485,42,Afghanistan,38928341,Asia,56779,2512
AFG,2021-14,474,18,Afghanistan,38928341,Asia,57253,2530
AFG,2021-15,645,16,Afghanistan,38928341,Asia,57898,2546
AFG,2021-16,1117,46,Afghanistan,38928341,Asia,59015,2592
AFG,2021-17,1555,56,Afghanistan,38928341,Asia,60570,2648
AFG,2021-18,1272,38,Afghanistan,38928341,Asia,61842,2686
AFG,2021-19,1757,68,Afghanistan,38928341,Asia,63599,2754
AFG,2021-20,2676,58,Afghanistan,38928341,Asia,66275,2812
AFG,2021-21,6706,162,Afghanistan,38928341,Asia,72981,2974
AFG,2021-22,7860,213,Afghanistan,38928341,Asia,80841,3187
AFG,2021-23,10627,425,Afghanistan,38928341,Asia,91468,3612
AFG,2021-24,14281,681,Afghanistan,38928341,Asia,105749,4293
AFG,2021-25,10002,437,Afghanistan,38928341,Asia,115751,4730
AFG,2021-26,11714,630,Afghanistan,38928341,Asia,127465,5360
AFG,2021-27,6113,364,Afghanistan,38928341,Asia,133578,5724
AFG,2021-28,8836,542,Afghanistan,38928341,Asia,142414,6266
AFG,2021-29,2594,249,Afghanistan,38928341,Asia,145008,6515
AFG,2021-30,3564,289,Afghanistan,38928341,Asia,148572,6804
AFG,2021-31,2441,157,Afghanistan,38928341,Asia,151013,6961
AFG,2021-32,1350,82,Afghanistan,38928341,Asia,152363,7043
AGO,2020-13,5,2,Angola,32866268,Africa,5,2
AGO,2020-14,7,0,Angola,32866268,Africa,12,2
AGO,2020-15,5,0,Angola,32866268,Africa,17,2
AGO,2020-16,5,0,Angola,32866268,Africa,22,2
AGO,2020-17,2,0,Angola,32866268,Africa,24,2
AGO,2020-18,9,0,Angola,32866268,Africa,33,2
AGO,2020-19,10,0,Angola,32866268,Africa,43,2
AGO,2020-20,3,0,Angola,32866268,Africa,46,2
AGO,2020-21,21,2,Angola,32866268,Africa,67,4
AGO,2020-22,17,0,Angola,32866268,Africa,84,4
AGO,2020-23,5,0,Angola,32866268,Africa,89,4
AGO,2020-24,49,2,Angola,32866268,Africa,138,6
AGO,2020-25,36,3,Angola,32866268,Africa,174,9
AGO,2020-26,91,2,Angola,32866268,Africa,265,11
AGO,2020-27,79,8,Angola,32866268,Africa,344,19
AGO,2020-28,160,7,Angola,32866268,Africa,504,26
AGO,2020-29,199,3,Angola,32866268,Africa,703,29
AGO,2020-30,225,11,Angola,32866268,Africa,928,40
AGO,2020-31,218,12,Angola,32866268,Africa,1146,52
AGO,2020-32,424,18,Angola,32866268,Africa,1570,70
AGO,2020-33,307,16,Angola,32866268,Africa,1877,86
AGO,2020-34,292,10,Angola,32866268,Africa,2169,96
AGO,2020-35,453,11,Angola,32866268,Africa,2622,107
AGO,2020-36,311,10,Angola,32866268,Africa,2933,117
AGO,2020-37,400,15,Angola,32866268,Africa,3333,132
AGO,2020-38,656,20,Angola,32866268,Africa,3989,152
AGO,2020-39,681,19,Angola,32866268,Africa,4670,171
AGO,2020-40,698,22,Angola,32866268,Africa,5368,193
AGO,2020-41,876,25,Angola,32866268,Africa,6244,218
AGO,2020-42,1216,23,Angola,32866268,Africa,7460,241
AGO,2020-43,1564,26,Angola,32866268,Africa,9024,267
AGO,2020-44,1779,17,Angola,32866268,Africa,10803,284
AGO,2020-45,1530,19,Angola,32866268,Africa,12333,303
AGO,2020-46,1039,19,Angola,32866268,Africa,13372,322
AGO,2020-47,1119,15,Angola,32866268,Africa,14491,337
AGO,2020-48,610,9,Angola,32866268,Africa,15101,346
AGO,2020-49,433,8,Angola,32866268,Africa,15534,354
AGO,2020-50,652,17,Angola,32866268,Africa,16186,371
AGO,2020-51,456,16,Angola,32866268,Africa,16642,387
AGO,2020-52,652,16,Angola,32866268,Africa,17294,403
AGO,2020-53,346,5,Angola,32866268,Africa,17640,408
AGO,2021-01,551,8,Angola,32866268,Africa,18191,416
AGO,2021-02,682,20,Angola,32866268,Africa,18873,436
AGO,2021-03,524,23,Angola,32866268,Africa,19397,459
AGO,2021-04,397,7,Angola,32866268,Africa,19794,466
AGO,2021-05,290,9,Angola,32866268,Africa,20084,475
AGO,2021-06,280,17,Angola,32866268,Africa,20364,492
AGO,2021-07,153,7,Angola,32866268,Africa,20517,499
AGO,2021-08,288,9,Angola,32866268,Africa,20805,508
AGO,2021-09,279,6,Angola,32866268,Africa,21084,514
AGO,2021-10,294,7,Angola,32866268,Africa,21378,521
AGO,2021-11,353,6,Angola,32866268,Africa,21731,527
AGO,2021-12,330,6,Angola,32866268,Africa,22061,533
AGO,2021-13,568,9,Angola,32866268,Africa,22629,542
AGO,2021-14,700,8,Angola,32866268,Africa,23329,550
AGO,2021-15,1058,11,Angola,32866268,Africa,24387,561
AGO,2021-16,1103,16,Angola,32866268,Africa,25490,577
AGO,2021-17,1501,23,Angola,32866268,Africa,26991,600
AGO,2021-18,1484,30,Angola,32866268,Africa,28475,630
AGO,2021-19,1877,25,Angola,32866268,Africa,30352,655
AGO,2021-20,2087,70,Angola,32866268,Africa,32439,725
AGO,2021-21,1739,32,Angola,32866268,Africa,34178,757
AGO,2021-22,1414,37,Angola,32866268,Africa,35592,794
AGO,2021-23,1006,31,Angola,32866268,Africa,36598,825
AGO,2021-24,1078,34,Angola,32866268,Africa,37676,859
AGO,2021-25,850,28,Angola,32866268,Africa,38526,887
AGO,2021-26,702,26,Angola,32866268,Africa,39228,913
AGO,2021-27,651,16,Angola,32866268,Africa,39879,929
AGO,2021-28,826,25,Angola,32866268,Africa,40705,954
AGO,2021-29,1029,28,Angola,32866268,Africa,41734,982
AGO,2021-30,1041,29,Angola,32866268,Africa,42775,1011
AGO,2021-31,815,33,Angola,32866268,Africa,43590,1044
AGO,2021-32,1025,56,Angola,32866268,Africa,44615,1100
AIA,2020-14,1,0,Anguilla,15002,America,1,0
AIA,2020-15,0,0,Anguilla,15002,America,1,0
AIA,2020-16,0,0,Anguilla,15002,America,1,0
AIA,2020-17,0,0,Anguilla,15002,America,1,0
AIA,2020-18,0,0,Anguilla,15002,America,1,0
AIA,2020-19,0,0,Anguilla,15002,America,1,0
AIA,2020-20,0,0,Anguilla,15002,America,1,0
AIA,2020-21,0,0,Anguilla,15002,America,1,0
AIA,2020-22,0,0,Anguilla,15002,America,1,0
AIA,2020-23,0,0,Anguilla,15002,America,1,0
AIA,2020-24,0,0,Anguilla,15002,America,1,0
AIA,2020-25,0,0,Anguilla,15002,America,1,0
AIA,2020-26,0,0,Anguilla,15002,America,1,0
AIA,2020-27,0,0,Anguilla,15002,America,1,0
AIA,2020-28,0,0,Anguilla,15002,America,1,0
AIA,2020-29,0,0,Anguilla,15002,America,1,0
AIA,2020-30,0,0,Anguilla,15002,America,1,0
AIA,2020-31,0,0,Anguilla,15002,America,1,0
AIA,2020-32,0,0,Anguilla,15002,America,1,0
AIA,2020-33,0,0,Anguilla,15002,America,1,0
AIA,2020-34,0,0,Anguilla,15002,America,1,0
AIA,2020-35,0,0,Anguilla,15002,America,1,0
AIA,2020-36,0,0,Anguilla,15002,America,1,0
AIA,2020-37,0,0,Anguilla,15002,America,1,0
AIA,2020-38,0,0,Anguilla,15002,America,1,0
AIA,2020-39,0,0,Anguilla,15002,America,1,0
AIA,2020-40,0,0,Anguilla,15002,America,1,0
AIA,2020-41,0,0,Anguilla,15002,America,1,0
AIA,2020-42,0,0,Anguilla,15002,America,1,0
AIA,2020-43,0,0,Anguilla,15002,America,1,0
AIA,2020-44,0,0,Anguilla,15002,America,1,0
AIA,2020-45,0,0,Anguilla,15002,America,1,0
AIA,2020-46,0,0,Anguilla,15002,America,1,0
AIA,2020-47,1,0,Anguilla,15002,America,2,0
AIA,2020-48,0,0,Anguilla,15002,America,2,0
AIA,2020-49,5,0,Anguilla,15002,America,7,0
AIA,2020-50,1,0,Anguilla,15002,America,8,0
AIA,2020-51,0,0,Anguilla,15002,America,8,0
AIA,2020-52,3,0,Anguilla,15002,America,11,0
AIA,2020-53,2,0,Anguilla,15002,America,13,0
AIA,2021-01,0,0,Anguilla,15002,America,13,0
AIA,2021-02,0,0,Anguilla,15002,America,13,0
AIA,2021-03,1,0,Anguilla,15002,America,14,0
AIA,2021-04,1,0,Anguilla,15002,America,15,0
AIA,2021-05,0,0,Anguilla,15002,America,15,0
AIA,2021-06,1,0,Anguilla,15002,America,16,0
AIA,2021-07,0,0,Anguilla,15002,America,16,0
AIA,2021-08,0,0,Anguilla,15002,America,16,0
AIA,2021-09,0,0,Anguilla,15002,America,16,0
AIA,2021-10,3,0,Anguilla,15002,America,19,0
AIA,2021-11,1,0,Anguilla,15002,America,20,0
AIA,2021-12,3,0,Anguilla,15002,America,23,0
AIA,2021-13,0,0,Anguilla,15002,America,23,0
AIA,2021-14,0,0,Anguilla,15002,America,23,0
AIA,2021-15,4,0,Anguilla,15002,America,27,0
AIA,2021-16,44,0,Anguilla,15002,America,71,0
AIA,2021-17,22,0,Anguilla,15002,America,93,0
AIA,2021-18,14,0,Anguilla,15002,America,107,0
AIA,2021-19,0,0,Anguilla,15002,America,107,0
AIA,2021-20,0,0,Anguilla,15002,America,107,0
AIA,2021-21,0,0,Anguilla,15002,America,107,0
AIA,2021-22,0,0,Anguilla,15002,America,107,0
AIA,2021-23,0,0,Anguilla,15002,America,107,0
AIA,2021-24,0,0,Anguilla,15002,America,107,0
AIA,2021-25,0,0,Anguilla,15002,America,107,0
AIA,2021-26,2,0,Anguilla,15002,America,109,0
AIA,2021-27,0,0,Anguilla,15002,America,109,0
AIA,2021-28,1,0,Anguilla,15002,America,110,0
AIA,2021-29,1,0,Anguilla,15002,America,111,0
AIA,2021-30,1,0,Anguilla,15002,America,112,0
AIA,2021-31,0,0,Anguilla,15002,America,112,0
AIA,2021-32,23,0,Anguilla,15002,America,135,0
ALB,2020-11,40,1,Albania,2845955,Europe,40,1
ALB,2020-12,47,1,Albania,2845955,Europe,87,2
ALB,2020-13,123,8,Albania,2845955,Europe,210,10
ALB,2020-14,149,11,Albania,2845955,Europe,359,21
ALB,2020-15,85,2,Albania,2845955,Europe,444,23
ALB,2020-16,116,3,Albania,2845955,Europe,560,26
ALB,2020-17,164,2,Albania,2845955,Europe,724,28
ALB,2020-18,69,3,Albania,2845955,Europe,793,31
ALB,2020-19,73,0,Albania,2845955,Europe,866,31
ALB,2020-20,78,0,Albania,2845955,Europe,944,31
ALB,2020-21,52,1,Albania,2845955,Europe,996,32
ALB,2020-22,139,1,Albania,2845955,Europe,1135,33
ALB,2020-23,109,1,Albania,2845955,Europe,1244,34
ALB,2020-24,275,2,Albania,2845955,Europe,1519,36
ALB,2020-25,406,8,Albania,2845955,Europe,1925,44
ALB,2020-26,475,11,Albania,2845955,Europe,2400,55
ALB,2020-27,491,21,Albania,2845955,Europe,2891,76
ALB,2020-28,561,17,Albania,2845955,Europe,3452,93
ALB,2020-29,636,19,Albania,2845955,Europe,4088,112
ALB,2020-30,673,26,Albania,2845955,Europe,4761,138
ALB,2020-31,756,28,Albania,2845955,Europe,5517,166
ALB,2020-32,892,33,Albania,2845955,Europe,6409,199
ALB,2020-33,969,29,Albania,2845955,Europe,7378,228
ALB,2020-34,1047,22,Albania,2845955,Europe,8425,250
ALB,2020-35,953,30,Albania,2845955,Europe,9378,280
ALB,2020-36,875,36,Albania,2845955,Europe,10253,316
ALB,2020-37,1098,18,Albania,2845955,Europe,11351,334
ALB,2020-38,1032,28,Albania,2845955,Europe,12383,362
ALB,2020-39,874,15,Albania,2845955,Europe,13257,377
ALB,2020-40,1007,19,Albania,2845955,Europe,14264,396
ALB,2020-41,1133,24,Albania,2845955,Europe,15397,420
ALB,2020-42,1656,31,Albania,2845955,Europe,17053,451
ALB,2020-43,2102,26,Albania,2845955,Europe,19155,477
ALB,2020-44,2045,41,Albania,2845955,Europe,21200,518
ALB,2020-45,3004,41,Albania,2845955,Europe,24204,559
ALB,2020-46,3624,64,Albania,2845955,Europe,27828,623
ALB,2020-47,4931,76,Albania,2845955,Europe,32759,699
ALB,2020-48,4864,99,Albania,2845955,Europe,37623,798
ALB,2020-49,5363,107,Albania,2845955,Europe,42986,905
ALB,2020-50,5542,98,Albania,2845955,Europe,48528,1003
ALB,2020-51,4473,85,Albania,2845955,Europe,53001,1088
ALB,2020-52,3569,76,Albania,2845955,Europe,56570,1164
ALB,2020-53,2866,29,Albania,2845955,Europe,59436,1193
ALB,2021-01,4157,48,Albania,2845955,Europe,63593,1241
ALB,2021-02,4095,36,Albania,2845955,Europe,67688,1277
ALB,2021-03,4584,38,Albania,2845955,Europe,72272,1315
ALB,2021-04,5853,65,Albania,2845955,Europe,78125,1380
ALB,2021-05,7209,80,Albania,2845955,Europe,85334,1460
ALB,2021-06,7739,95,Albania,2845955,Europe,93073,1555
ALB,2021-07,7171,111,Albania,2845955,Europe,100244,1666
ALB,2021-08,6921,130,Albania,2845955,Europe,107165,1796
ALB,2021-09,5730,143,Albania,2845955,Europe,112895,1939
ALB,2021-10,4577,106,Albania,2845955,Europe,117472,2045
ALB,2021-11,3726,92,Albania,2845955,Europe,121198,2137
ALB,2021-12,2934,73,Albania,2845955,Europe,124132,2210
ALB,2021-13,2397,55,Albania,2845955,Europe,126529,2265
ALB,2021-14,1862,52,Albania,2845955,Europe,128391,2317
ALB,2021-15,1201,25,Albania,2845955,Europe,129592,2342
ALB,2021-16,943,36,Albania,2845955,Europe,130535,2378
ALB,2021-17,701,19,Albania,2845955,Europe,131236,2397
ALB,2021-18,485,15,Albania,2845955,Europe,131721,2412
ALB,2021-19,292,20,Albania,2845955,Europe,132013,2432
ALB,2021-20,194,12,Albania,2845955,Europe,132207,2444
ALB,2021-21,100,6,Albania,2845955,Europe,132307,2450
ALB,2021-22,70,1,Albania,2845955,Europe,132377,2451
ALB,2021-23,82,2,Albania,2845955,Europe,132459,2453
ALB,2021-24,29,1,Albania,2845955,Europe,132488,2454
ALB,2021-25,22,2,Albania,2845955,Europe,132510,2456
ALB,2021-26,23,0,Albania,2845955,Europe,132533,2456
ALB,2021-27,57,0,Albania,2845955,Europe,132590,2456
ALB,2021-28,94,0,Albania,2845955,Europe,132684,2456
ALB,2021-29,171,0,Albania,2845955,Europe,132855,2456
ALB,2021-30,264,1,Albania,2845955,Europe,133119,2457
ALB,2021-31,791,2,Albania,2845955,Europe,133910,2459
ALB,2021-32,2035,5,Albania,2845955,Europe,135945,2464
AND,2020-12,108,0,Andorra,76177,Europe,108,0
AND,2020-13,221,6,Andorra,76177,Europe,329,6
AND,2020-14,167,12,Andorra,76177,Europe,496,18
AND,2020-15,137,11,Andorra,76177,Europe,633,29
AND,2020-16,75,7,Andorra,76177,Europe,708,36
AND,2020-17,27,4,Andorra,76177,Europe,735,40
AND,2020-18,8,5,Andorra,76177,Europe,743,45
AND,2020-19,7,3,Andorra,76177,Europe,750,48
AND,2020-20,6,3,Andorra,76177,Europe,756,51
AND,2020-21,2,0,Andorra,76177,Europe,758,51
AND,2020-22,1,0,Andorra,76177,Europe,759,51
AND,2020-23,88,0,Andorra,76177,Europe,847,51
AND,2020-24,1,0,Andorra,76177,Europe,848,51
AND,2020-25,2,1,Andorra,76177,Europe,850,52
AND,2020-26,0,0,Andorra,76177,Europe,850,52
AND,2020-27,0,0,Andorra,76177,Europe,850,52
AND,2020-28,0,0,Andorra,76177,Europe,850,52
AND,2020-29,25,0,Andorra,76177,Europe,875,52
AND,2020-30,17,0,Andorra,76177,Europe,892,52
AND,2020-31,28,0,Andorra,76177,Europe,920,52
AND,2020-32,31,0,Andorra,76177,Europe,951,52
AND,2020-33,33,1,Andorra,76177,Europe,984,53
AND,2020-34,56,0,Andorra,76177,Europe,1040,53
AND,2020-35,79,0,Andorra,76177,Europe,1119,53
AND,2020-36,91,0,Andorra,76177,Europe,1210,53
AND,2020-37,129,0,Andorra,76177,Europe,1339,53
AND,2020-38,220,0,Andorra,76177,Europe,1559,53
AND,2020-39,272,0,Andorra,76177,Europe,1831,53
AND,2020-40,274,0,Andorra,76177,Europe,2105,53
AND,2020-41,586,2,Andorra,76177,Europe,2691,55
AND,2020-42,681,4,Andorra,76177,Europe,3372,59
AND,2020-43,661,10,Andorra,76177,Europe,4033,69
AND,2020-44,787,6,Andorra,76177,Europe,4820,75
AND,2020-45,558,0,Andorra,76177,Europe,5378,75
AND,2020-46,489,1,Andorra,76177,Europe,5867,76
AND,2020-47,384,0,Andorra,76177,Europe,6251,76
AND,2020-48,456,0,Andorra,76177,Europe,6707,76
AND,2020-49,338,2,Andorra,76177,Europe,7045,78
AND,2020-50,288,1,Andorra,76177,Europe,7333,79
AND,2020-51,239,2,Andorra,76177,Europe,7572,81
AND,2020-52,10,1,Andorra,76177,Europe,7582,82
AND,2020-53,605,2,Andorra,76177,Europe,8187,84
AND,2021-01,490,2,Andorra,76177,Europe,8677,86
AND,2021-02,401,5,Andorra,76177,Europe,9078,91
AND,2021-03,466,5,Andorra,76177,Europe,9544,96
AND,2021-04,388,5,Andorra,76177,Europe,9932,101
AND,2021-05,314,5,Andorra,76177,Europe,10246,106
AND,2021-06,287,1,Andorra,76177,Europe,10533,107
AND,2021-07,161,0,Andorra,76177,Europe,10694,107
AND,2021-08,190,3,Andorra,76177,Europe,10884,110
AND,2021-09,180,2,Andorra,76177,Europe,11064,112
AND,2021-10,157,1,Andorra,76177,Europe,11221,113
AND,2021-11,319,0,Andorra,76177,Europe,11540,113
AND,2021-12,305,2,Andorra,76177,Europe,11845,115
AND,2021-13,381,2,Andorra,76177,Europe,12226,117
AND,2021-14,350,4,Andorra,76177,Europe,12576,121
AND,2021-15,224,2,Andorra,76177,Europe,12800,123
AND,2021-16,278,1,Andorra,76177,Europe,13078,124
AND,2021-17,212,3,Andorra,76177,Europe,13290,127
AND,2021-18,128,0,Andorra,76177,Europe,13418,127
AND,2021-19,87,0,Andorra,76177,Europe,13505,127
AND,2021-20,99,0,Andorra,76177,Europe,13604,127
AND,2021-21,118,0,Andorra,76177,Europe,13722,127
AND,2021-22,50,0,Andorra,76177,Europe,13772,127
AND,2021-23,36,0,Andorra,76177,Europe,13808,127
AND,2021-24,51,0,Andorra,76177,Europe,13859,127
AND,2021-25,18,0,Andorra,76177,Europe,13877,127
AND,2021-26,109,0,Andorra,76177,Europe,13986,127
AND,2021-27,164,0,Andorra,76177,Europe,14150,127
AND,2021-28,204,0,Andorra,76177,Europe,14354,127
AND,2021-29,218,0,Andorra,76177,Europe,14572,127
AND,2021-30,170,1,Andorra,76177,Europe,14742,128
AND,2021-31,129,1,Andorra,76177,Europe,14871,129
AND,2021-32,78,0,Andorra,76177,Europe,14949,129
ARE,2020-02,0,0,United Arab Emirates,9890400,Asia,0,0
ARE,2020-03,0,0,United Arab Emirates,9890400,Asia,0,0
ARE,2020-04,1,0,United Arab Emirates,9890400,Asia,1,0
ARE,2020-05,4,0,United Arab Emirates,9890400,Asia,5,0
ARE,2020-06,2,0,United Arab Emirates,9890400,Asia,7,0
ARE,2020-07,2,0,United Arab Emirates,9890400,Asia,9,0
ARE,2020-08,4,0,United Arab Emirates,9890400,Asia,13,0
ARE,2020-09,8,0,United Arab Emirates,9890400,Asia,21,0
ARE,2020-10,24,0,United Arab Emirates,9890400,Asia,45,0
ARE,2020-11,53,0,United Arab Emirates,9890400,Asia,98,0
ARE,2020-12,55,2,United Arab Emirates,9890400,Asia,153,2
ARE,2020-13,417,1,United Arab Emirates,9890400,Asia,570,3
ARE,2020-14,1213,7,United Arab Emirates,9890400,Asia,1783,10
ARE,2020-15,2199,12,United Arab Emirates,9890400,Asia,3982,22
ARE,2020-16,2961,19,United Arab Emirates,9890400,Asia,6943,41
ARE,2020-17,3406,35,United Arab Emirates,9890400,Asia,10349,76
ARE,2020-18,3814,50,United Arab Emirates,9890400,Asia,14163,126
ARE,2020-19,4035,72,United Arab Emirates,9890400,Asia,18198,198
ARE,2020-20,5160,22,United Arab Emirates,9890400,Asia,23358,220
ARE,2020-21,6127,25,United Arab Emirates,9890400,Asia,29485,245
ARE,2020-22,5072,19,United Arab Emirates,9890400,Asia,34557,264
ARE,2020-23,4251,12,United Arab Emirates,9890400,Asia,38808,276
ARE,2020-24,3486,13,United Arab Emirates,9890400,Asia,42294,289
ARE,2020-25,2631,13,United Arab Emirates,9890400,Asia,44925,302
ARE,2020-26,2872,11,United Arab Emirates,9890400,Asia,47797,313
ARE,2020-27,3743,10,United Arab Emirates,9890400,Asia,51540,323
ARE,2020-28,3314,10,United Arab Emirates,9890400,Asia,54854,333
ARE,2020-29,2068,6,United Arab Emirates,9890400,Asia,56922,339
ARE,2020-30,1991,5,United Arab Emirates,9890400,Asia,58913,344
ARE,2020-31,2086,7,United Arab Emirates,9890400,Asia,60999,351
ARE,2020-32,1526,6,United Arab Emirates,9890400,Asia,62525,357
ARE,2020-33,1787,7,United Arab Emirates,9890400,Asia,64312,364
ARE,2020-34,2695,11,United Arab Emirates,9890400,Asia,67007,375
ARE,2020-35,2683,7,United Arab Emirates,9890400,Asia,69690,382
ARE,2020-36,4294,6,United Arab Emirates,9890400,Asia,73984,388
ARE,2020-37,5505,11,United Arab Emirates,9890400,Asia,79489,399
ARE,2020-38,5427,5,United Arab Emirates,9890400,Asia,84916,404
ARE,2020-39,6553,8,United Arab Emirates,9890400,Asia,91469,412
ARE,2020-40,7332,14,United Arab Emirates,9890400,Asia,98801,426
ARE,2020-41,7428,19,United Arab Emirates,9890400,Asia,106229,445
ARE,2020-42,9373,18,United Arab Emirates,9890400,Asia,115602,463
ARE,2020-43,9521,14,United Arab Emirates,9890400,Asia,125123,477
ARE,2020-44,8784,19,United Arab Emirates,9890400,Asia,133907,496
ARE,2020-45,8236,18,United Arab Emirates,9890400,Asia,142143,514
ARE,2020-46,8202,16,United Arab Emirates,9890400,Asia,150345,530
ARE,2020-47,8645,22,United Arab Emirates,9890400,Asia,158990,552
ARE,2020-48,8763,18,United Arab Emirates,9890400,Asia,167753,570
ARE,2020-49,8676,22,United Arab Emirates,9890400,Asia,176429,592
ARE,2020-50,8520,25,United Arab Emirates,9890400,Asia,184949,617
ARE,2020-51,8626,20,United Arab Emirates,9890400,Asia,193575,637
ARE,2020-52,8261,20,United Arab Emirates,9890400,Asia,201836,657
ARE,2020-53,12896,25,United Arab Emirates,9890400,Asia,214732,682
ARE,2021-01,18250,29,United Arab Emirates,9890400,Asia,232982,711
ARE,2021-02,20279,34,United Arab Emirates,9890400,Asia,253261,745
ARE,2021-03,24694,47,United Arab Emirates,9890400,Asia,277955,792
ARE,2021-04,25654,58,United Arab Emirates,9890400,Asia,303609,850
ARE,2021-05,22886,71,United Arab Emirates,9890400,Asia,326495,921
ARE,2021-06,22277,93,United Arab Emirates,9890400,Asia,348772,1014
ARE,2021-07,23758,126,United Arab Emirates,9890400,Asia,372530,1140
ARE,2021-08,18994,81,United Arab Emirates,9890400,Asia,391524,1221
ARE,2021-09,19325,101,United Arab Emirates,9890400,Asia,410849,1322
ARE,2021-10,15548,73,United Arab Emirates,9890400,Asia,426397,1395
ARE,2021-11,13958,43,United Arab Emirates,9890400,Asia,440355,1438
ARE,2021-12,376,48,United Arab Emirates,9890400,Asia,440731,1486
ARE,2021-13,29405,24,United Arab Emirates,9890400,Asia,470136,1510
ARE,2021-14,13611,21,United Arab Emirates,9890400,Asia,483747,1531
ARE,2021-15,13407,23,United Arab Emirates,9890400,Asia,497154,1554
ARE,2021-16,13584,17,United Arab Emirates,9890400,Asia,510738,1571
ARE,2021-17,13057,22,United Arab Emirates,9890400,Asia,523795,1593
ARE,2021-18,12222,20,United Arab Emirates,9890400,Asia,536017,1613
ARE,2021-19,10165,18,United Arab Emirates,9890400,Asia,546182,1631
ARE,2021-20,9925,20,United Arab Emirates,9890400,Asia,556107,1651
ARE,2021-21,12966,26,United Arab Emirates,9890400,Asia,569073,1677
ARE,2021-22,13998,22,United Arab Emirates,9890400,Asia,583071,1699
ARE,2021-23,14915,27,United Arab Emirates,9890400,Asia,597986,1726
ARE,2021-24,14043,31,United Arab Emirates,9890400,Asia,612029,1757
ARE,2021-25,14907,39,United Arab Emirates,9890400,Asia,626936,1796
ARE,2021-26,12540,38,United Arab Emirates,9890400,Asia,639476,1834
ARE,2021-27,10744,32,United Arab Emirates,9890400,Asia,650220,1866
ARE,2021-28,12266,34,United Arab Emirates,9890400,Asia,662486,1900
ARE,2021-29,9150,20,United Arab Emirates,9890400,Asia,671636,1920
ARE,2021-30,10741,31,United Arab Emirates,9890400,Asia,682377,1951
ARE,2021-31,11908,27,United Arab Emirates,9890400,Asia,694285,1978
ARE,2021-32,7491,23,United Arab Emirates,9890400,Asia,701776,2001
ARG,2020-11,44,1,Argentina,45195777,America,44,1
ARG,2020-12,210,2,Argentina,45195777,America,254,3
ARG,2020-13,554,16,Argentina,45195777,America,808,19
ARG,2020-14,734,26,Argentina,45195777,America,1542,45
ARG,2020-15,649,49,Argentina,45195777,America,2191,94
ARG,2020-16,727,39,Argentina,45195777,America,2918,133
ARG,2020-17,837,52,Argentina,45195777,America,3755,185
ARG,2020-18,1003,60,Argentina,45195777,America,4758,245
ARG,2020-19,1006,54,Argentina,45195777,America,5764,299
ARG,2020-20,2016,66,Argentina,45195777,America,7780,365
ARG,2020-21,4271,86,Argentina,45195777,America,12051,451
ARG,2020-22,4775,87,Argentina,45195777,America,16826,538
ARG,2020-23,5943,125,Argentina,45195777,America,22769,663
ARG,2020-24,8783,169,Argentina,45195777,America,31552,832
ARG,2020-25,11208,178,Argentina,45195777,America,42760,1010
ARG,2020-26,14959,206,Argentina,45195777,America,57719,1216
ARG,2020-27,17632,273,Argentina,45195777,America,75351,1489
ARG,2020-28,22133,328,Argentina,45195777,America,97484,1817
ARG,2020-29,25015,428,Argentina,45195777,America,122499,2245
ARG,2020-30,40002,693,Argentina,45195777,America,162501,2938
ARG,2020-31,34017,673,Argentina,45195777,America,196518,3611
ARG,2020-32,45268,944,Argentina,45195777,America,241786,4555
ARG,2020-33,47289,1101,Argentina,45195777,America,289075,5656
ARG,2020-34,47702,1191,Argentina,45195777,America,336777,6847
ARG,2020-35,64437,1553,Argentina,45195777,America,401214,8400
ARG,2020-36,70567,1406,Argentina,45195777,America,471781,9806
ARG,2020-37,74675,1500,Argentina,45195777,America,546456,11306
ARG,2020-38,76453,1602,Argentina,45195777,America,622909,12908
ARG,2020-39,88391,2840,Argentina,45195777,America,711300,15748
ARG,2020-40,87161,5269,Argentina,45195777,America,798461,21017
ARG,2020-41,95720,2850,Argentina,45195777,America,894181,23867
ARG,2020-42,95474,2399,Argentina,45195777,America,989655,26266
ARG,2020-43,100909,2629,Argentina,45195777,America,1090564,28895
ARG,2020-44,82944,2244,Argentina,45195777,America,1173508,31139
ARG,2020-45,68649,2420,Argentina,45195777,America,1242157,33559
ARG,2020-46,68307,1876,Argentina,45195777,America,1310464,35435
ARG,2020-47,59874,1566,Argentina,45195777,America,1370338,37001
ARG,2020-48,48444,1471,Argentina,45195777,America,1418782,38472
ARG,2020-49,44299,1297,Argentina,45195777,America,1463081,39769
ARG,2020-50,35067,996,Argentina,45195777,America,1498148,40765
ARG,2020-51,48955,1231,Argentina,45195777,America,1547103,41996
ARG,2020-52,43370,871,Argentina,45195777,America,1590473,42867
ARG,2020-53,50220,614,Argentina,45195777,America,1640693,43481
ARG,2021-01,90203,1172,Argentina,45195777,America,1730896,44653
ARG,2021-02,76488,1178,Argentina,45195777,America,1807384,45831
ARG,2021-03,67388,1202,Argentina,45195777,America,1874772,47033
ARG,2021-04,59056,1215,Argentina,45195777,America,1933828,48248
ARG,2021-05,51661,1149,Argentina,45195777,America,1985489,49397
ARG,2021-06,43507,929,Argentina,45195777,America,2028996,50326
ARG,2021-07,40694,1032,Argentina,45195777,America,2069690,51358
ARG,2021-08,42270,718,Argentina,45195777,America,2111960,52076
ARG,2021-09,42722,1044,Argentina,45195777,America,2154682,53120
ARG,2021-10,47138,715,Argentina,45195777,America,2201820,53835
ARG,2021-11,43885,709,Argentina,45195777,America,2245705,54544
ARG,2021-12,76840,1066,Argentina,45195777,America,2322545,55610
ARG,2021-13,84548,860,Argentina,45195777,America,2407093,56470
ARG,2021-14,144834,1486,Argentina,45195777,America,2551927,57956
ARG,2021-15,162474,1519,Argentina,45195777,America,2714401,59475
ARG,2021-16,165264,2611,Argentina,45195777,America,2879665,62086
ARG,2021-17,141502,2705,Argentina,45195777,America,3021167,64791
ARG,2021-18,143879,3029,Argentina,45195777,America,3165046,67820
ARG,2021-19,170844,3206,Argentina,45195777,America,3335890,71026
ARG,2021-20,226170,3453,Argentina,45195777,America,3562060,74479
ARG,2021-21,219649,3613,Argentina,45195777,America,3781709,78092
ARG,2021-22,195913,3853,Argentina,45195777,America,3977622,81945
ARG,2021-23,167785,4083,Argentina,45195777,America,4145407,86028
ARG,2021-24,131913,3461,Argentina,45195777,America,4277320,89489
ARG,2021-25,146241,3652,Argentina,45195777,America,4423561,93141
ARG,2021-26,129114,3379,Argentina,45195777,America,4552675,96520
ARG,2021-27,110187,2734,Argentina,45195777,America,4662862,99254
ARG,2021-28,106268,2700,Argentina,45195777,America,4769130,101954
ARG,2021-29,90028,2150,Argentina,45195777,America,4859158,104104
ARG,2021-30,87797,1940,Argentina,45195777,America,4946955,106044
ARG,2021-31,82108,1916,Argentina,45195777,America,5029063,107960
ARG,2021-32,59196,1144,Argentina,45195777,America,5088259,109104
ARM,2020-02,0,0,Armenia,2963234,Europe,0,0
ARM,2020-03,0,0,Armenia,2963234,Europe,0,0
ARM,2020-04,0,0,Armenia,2963234,Europe,0,0
ARM,2020-05,0,0,Armenia,2963234,Europe,0,0
ARM,2020-06,0,0,Armenia,2963234,Europe,0,0
ARM,2020-07,0,0,Armenia,2963234,Europe,0,0
ARM,2020-08,0,0,Armenia,2963234,Europe,0,0
ARM,2020-09,1,0,Armenia,2963234,Europe,1,0
ARM,2020-10,0,0,Armenia,2963234,Europe,1,0
ARM,2020-11,27,0,Armenia,2963234,Europe,28,0
ARM,2020-12,166,0,Armenia,2963234,Europe,194,0
ARM,2020-13,288,3,Armenia,2963234,Europe,482,3
ARM,2020-14,351,5,Armenia,2963234,Europe,833,8
ARM,2020-15,206,6,Armenia,2963234,Europe,1039,14
ARM,2020-16,300,8,Armenia,2963234,Europe,1339,22
ARM,2020-17,469,7,Armenia,2963234,Europe,1808,29
ARM,2020-18,699,10,Armenia,2963234,Europe,2507,39
ARM,2020-19,885,7,Armenia,2963234,Europe,3392,46
ARM,2020-20,1431,15,Armenia,2963234,Europe,4823,61
ARM,2020-21,2290,26,Armenia,2963234,Europe,7113,87
ARM,2020-22,2379,52,Armenia,2963234,Europe,9492,139
ARM,2020-23,3833,72,Armenia,2963234,Europe,13325,211
ARM,2020-24,3739,74,Armenia,2963234,Europe,17064,285
ARM,2020-25,3524,75,Armenia,2963234,Europe,20588,360
ARM,2020-26,4539,73,Armenia,2963234,Europe,25127,433
ARM,2020-27,3809,58,Armenia,2963234,Europe,28936,491
ARM,2020-28,3215,82,Armenia,2963234,Europe,32151,573
ARM,2020-29,2830,77,Armenia,2963234,Europe,34981,650
ARM,2020-30,2409,61,Armenia,2963234,Europe,37390,711
ARM,2020-31,1712,51,Armenia,2963234,Europe,39102,762
ARM,2020-32,1308,29,Armenia,2963234,Europe,40410,791
ARM,2020-33,1253,27,Armenia,2963234,Europe,41663,818
ARM,2020-34,1129,34,Armenia,2963234,Europe,42792,852
ARM,2020-35,958,25,Armenia,2963234,Europe,43750,877
ARM,2020-36,1033,20,Armenia,2963234,Europe,44783,897
ARM,2020-37,1079,19,Armenia,2963234,Europe,45862,916
ARM,2020-38,1569,14,Armenia,2963234,Europe,47431,930
ARM,2020-39,1969,21,Armenia,2963234,Europe,49400,951
ARM,2020-40,3096,26,Armenia,2963234,Europe,52496,977
ARM,2020-41,3955,43,Armenia,2963234,Europe,56451,1020
ARM,2020-42,8243,61,Armenia,2963234,Europe,64694,1081
ARM,2020-43,14116,115,Armenia,2963234,Europe,78810,1196
ARM,2020-44,14638,195,Armenia,2963234,Europe,93448,1391
ARM,2020-45,14018,189,Armenia,2963234,Europe,107466,1580
ARM,2020-46,10420,208,Armenia,2963234,Europe,117886,1788
ARM,2020-47,8823,188,Armenia,2963234,Europe,126709,1976
ARM,2020-48,8415,188,Armenia,2963234,Europe,135124,2164
ARM,2020-49,7220,180,Armenia,2963234,Europe,142344,2344
ARM,2020-50,6338,159,Armenia,2963234,Europe,148682,2503
ARM,2020-51,5383,153,Armenia,2963234,Europe,154065,2656
ARM,2020-52,3883,119,Armenia,2963234,Europe,157948,2775
ARM,2020-53,2272,89,Armenia,2963234,Europe,160220,2864
ARM,2021-01,2068,67,Armenia,2963234,Europe,162288,2931
ARM,2021-02,2388,67,Armenia,2963234,Europe,164676,2998
ARM,2021-03,1418,49,Armenia,2963234,Europe,166094,3047
ARM,2021-04,994,37,Armenia,2963234,Europe,167088,3084
ARM,2021-05,1089,39,Armenia,2963234,Europe,168177,3123
ARM,2021-06,1078,24,Armenia,2963234,Europe,169255,3147
ARM,2021-07,1147,17,Armenia,2963234,Europe,170402,3164
ARM,2021-08,1814,31,Armenia,2963234,Europe,172216,3195
ARM,2021-09,2800,30,Armenia,2963234,Europe,175016,3225
ARM,2021-10,3686,40,Armenia,2963234,Europe,178702,3265
ARM,2021-11,5517,95,Armenia,2963234,Europe,184219,3360
ARM,2021-12,6522,116,Armenia,2963234,Europe,190741,3476
ARM,2021-13,6372,138,Armenia,2963234,Europe,197113,3614
ARM,2021-14,6214,139,Armenia,2963234,Europe,203327,3753
ARM,2021-15,5491,142,Armenia,2963234,Europe,208818,3895
ARM,2021-16,4651,145,Armenia,2963234,Europe,213469,4040
ARM,2021-17,3539,109,Armenia,2963234,Europe,217008,4149
ARM,2021-18,2345,100,Armenia,2963234,Europe,219353,4249
ARM,2021-19,1574,84,Armenia,2963234,Europe,220927,4333
ARM,2021-20,1055,61,Armenia,2963234,Europe,221982,4394
ARM,2021-21,688,44,Armenia,2963234,Europe,222670,4438
ARM,2021-22,542,25,Armenia,2963234,Europe,223212,4463
ARM,2021-23,511,25,Armenia,2963234,Europe,223723,4488
ARM,2021-24,530,11,Armenia,2963234,Europe,224253,4499
ARM,2021-25,598,11,Armenia,2963234,Europe,224851,4510
ARM,2021-26,755,17,Armenia,2963234,Europe,225606,4527
ARM,2021-27,853,20,Armenia,2963234,Europe,226459,4547
ARM,2021-28,1063,22,Armenia,2963234,Europe,227522,4569
ARM,2021-29,1388,21,Armenia,2963234,Europe,228910,4590
ARM,2021-30,1566,31,Armenia,2963234,Europe,230476,4621
ARM,2021-31,1821,32,Armenia,2963234,Europe,232297,4653
ARM,2021-32,2517,49,Armenia,2963234,Europe,234814,4702
ATG,2020-13,6,0,Antigua And Barbuda,97928,America,6,0
ATG,2020-14,8,0,Antigua And Barbuda,97928,America,14,0
ATG,2020-15,6,2,Antigua And Barbuda,97928,America,20,2
ATG,2020-16,2,0,Antigua And Barbuda,97928,America,22,2
ATG,2020-17,1,1,Antigua And Barbuda,97928,America,23,3
ATG,2020-18,1,0,Antigua And Barbuda,97928,America,24,3
ATG,2020-19,0,0,Antigua And Barbuda,97928,America,24,3
ATG,2020-20,0,0,Antigua And Barbuda,97928,America,24,3
ATG,2020-21,0,0,Antigua And Barbuda,97928,America,24,3
ATG,2020-22,0,0,Antigua And Barbuda,97928,America,24,3
ATG,2020-23,1,0,Antigua And Barbuda,97928,America,25,3
ATG,2020-24,0,0,Antigua And Barbuda,97928,America,25,3
ATG,2020-25,0,0,Antigua And Barbuda,97928,America,25,3
ATG,2020-26,39,0,Antigua And Barbuda,97928,America,64,3
ATG,2020-27,3,0,Antigua And Barbuda,97928,America,67,3
ATG,2020-28,6,0,Antigua And Barbuda,97928,America,73,3
ATG,2020-29,2,0,Antigua And Barbuda,97928,America,75,3
ATG,2020-30,6,0,Antigua And Barbuda,97928,America,81,3
ATG,2020-31,9,0,Antigua And Barbuda,97928,America,90,3
ATG,2020-32,1,0,Antigua And Barbuda,97928,America,91,3
ATG,2020-33,1,0,Antigua And Barbuda,97928,America,92,3
ATG,2020-34,1,0,Antigua And Barbuda,97928,America,93,3
ATG,2020-35,0,0,Antigua And Barbuda,97928,America,93,3
ATG,2020-36,1,0,Antigua And Barbuda,97928,America,94,3
ATG,2020-37,0,0,Antigua And Barbuda,97928,America,94,3
ATG,2020-38,1,0,Antigua And Barbuda,97928,America,95,3
ATG,2020-39,5,0,Antigua And Barbuda,97928,America,100,3
ATG,2020-40,6,0,Antigua And Barbuda,97928,America,106,3
ATG,2020-41,4,0,Antigua And Barbuda,97928,America,110,3
ATG,2020-42,8,0,Antigua And Barbuda,97928,America,118,3
ATG,2020-43,5,0,Antigua And Barbuda,97928,America,123,3
ATG,2020-44,4,0,Antigua And Barbuda,97928,America,127,3
ATG,2020-45,3,0,Antigua And Barbuda,97928,America,130,3
ATG,2020-46,3,1,Antigua And Barbuda,97928,America,133,4
ATG,2020-47,5,0,Antigua And Barbuda,97928,America,138,4
ATG,2020-48,2,0,Antigua And Barbuda,97928,America,140,4
ATG,2020-49,5,0,Antigua And Barbuda,97928,America,145,4
ATG,2020-50,2,1,Antigua And Barbuda,97928,America,147,5
ATG,2020-51,5,0,Antigua And Barbuda,97928,America,152,5
ATG,2020-52,5,0,Antigua And Barbuda,97928,America,157,5
ATG,2020-53,2,0,Antigua And Barbuda,97928,America,159,5
ATG,2021-01,16,0,Antigua And Barbuda,97928,America,175,5
ATG,2021-02,13,0,Antigua And Barbuda,97928,America,188,5
ATG,2021-03,12,0,Antigua And Barbuda,97928,America,200,5
ATG,2021-04,33,0,Antigua And Barbuda,97928,America,233,5
ATG,2021-05,82,2,Antigua And Barbuda,97928,America,315,7
ATG,2021-06,127,0,Antigua And Barbuda,97928,America,442,7
ATG,2021-07,171,7,Antigua And Barbuda,97928,America,613,14
ATG,2021-08,155,0,Antigua And Barbuda,97928,America,768,14
ATG,2021-09,93,8,Antigua And Barbuda,97928,America,861,22
ATG,2021-10,121,5,Antigua And Barbuda,97928,America,982,27
ATG,2021-11,89,1,Antigua And Barbuda,97928,America,1071,28
ATG,2021-12,64,0,Antigua And Barbuda,97928,America,1135,28
ATG,2021-13,34,0,Antigua And Barbuda,97928,America,1169,28
ATG,2021-14,28,2,Antigua And Barbuda,97928,America,1197,30
ATG,2021-15,18,1,Antigua And Barbuda,97928,America,1215,31
ATG,2021-16,16,0,Antigua And Barbuda,97928,America,1231,31
ATG,2021-17,0,1,Antigua And Barbuda,97928,America,1231,32
ATG,2021-18,5,0,Antigua And Barbuda,97928,America,1236,32
ATG,2021-19,14,10,Antigua And Barbuda,97928,America,1250,42
ATG,2021-20,7,0,Antigua And Barbuda,97928,America,1257,42
ATG,2021-21,2,0,Antigua And Barbuda,97928,America,1259,42
ATG,2021-22,3,0,Antigua And Barbuda,97928,America,1262,42
ATG,2021-23,0,0,Antigua And Barbuda,97928,America,1262,42
ATG,2021-24,0,0,Antigua And Barbuda,97928,America,1262,42
ATG,2021-25,0,0,Antigua And Barbuda,97928,America,1262,42
ATG,2021-26,1,0,Antigua And Barbuda,97928,America,1263,42
ATG,2021-27,2,0,Antigua And Barbuda,97928,America,1265,42
ATG,2021-28,2,0,Antigua And Barbuda,97928,America,1267,42
ATG,2021-29,12,1,Antigua And Barbuda,97928,America,1279,43
ATG,2021-30,23,0,Antigua And Barbuda,97928,America,1302,43
ATG,2021-31,45,0,Antigua And Barbuda,97928,America,1347,43
ATG,2021-32,49,0,Antigua And Barbuda,97928,America,1396,43
AUS,2020-02,0,0,Australia,25499881,Oceania,0,0
AUS,2020-03,0,0,Australia,25499881,Oceania,0,0
AUS,2020-04,4,0,Australia,25499881,Oceania,4,0
AUS,2020-05,7,0,Australia,25499881,Oceania,11,0
AUS,2020-06,3,0,Australia,25499881,Oceania,14,0
AUS,2020-07,1,0,Australia,25499881,Oceania,15,0
AUS,2020-08,7,0,Australia,25499881,Oceania,22,0
AUS,2020-09,7,1,Australia,25499881,Oceania,29,1
AUS,2020-10,51,2,Australia,25499881,Oceania,80,3
AUS,2020-11,218,2,Australia,25499881,Oceania,298,5
AUS,2020-12,1411,2,Australia,25499881,Oceania,1709,7
AUS,2020-13,2384,9,Australia,25499881,Oceania,4093,16
AUS,2020-14,1651,20,Australia,25499881,Oceania,5744,36
AUS,2020-15,578,25,Australia,25499881,Oceania,6322,61
AUS,2020-16,290,9,Australia,25499881,Oceania,6612,70
AUS,2020-17,101,13,Australia,25499881,Oceania,6713,83
AUS,2020-18,88,12,Australia,25499881,Oceania,6801,95
AUS,2020-19,140,2,Australia,25499881,Oceania,6941,97
AUS,2020-20,104,1,Australia,25499881,Oceania,7045,98
AUS,2020-21,64,4,Australia,25499881,Oceania,7109,102
AUS,2020-22,86,0,Australia,25499881,Oceania,7195,102
AUS,2020-23,65,0,Australia,25499881,Oceania,7260,102
AUS,2020-24,60,0,Australia,25499881,Oceania,7320,102
AUS,2020-25,141,0,Australia,25499881,Oceania,7461,102
AUS,2020-26,225,2,Australia,25499881,Oceania,7686,104
AUS,2020-27,763,0,Australia,25499881,Oceania,8449,104
AUS,2020-28,1348,4,Australia,25499881,Oceania,9797,108
AUS,2020-29,2005,14,Australia,25499881,Oceania,11802,122
AUS,2020-30,2601,33,Australia,25499881,Oceania,14403,155
AUS,2020-31,3520,53,Australia,25499881,Oceania,17923,208
AUS,2020-32,3161,87,Australia,25499881,Oceania,21084,295
AUS,2020-33,2204,101,Australia,25499881,Oceania,23288,396
AUS,2020-34,1524,106,Australia,25499881,Oceania,24812,502
AUS,2020-35,858,109,Australia,25499881,Oceania,25670,611
AUS,2020-36,609,142,Australia,25499881,Oceania,26279,753
AUS,2020-37,372,57,Australia,25499881,Oceania,26651,810
AUS,2020-38,247,39,Australia,25499881,Oceania,26898,849
AUS,2020-39,142,23,Australia,25499881,Oceania,27040,872
AUS,2020-40,96,22,Australia,25499881,Oceania,27136,894
AUS,2020-41,128,4,Australia,25499881,Oceania,27264,898
AUS,2020-42,126,6,Australia,25499881,Oceania,27390,904
AUS,2020-43,130,1,Australia,25499881,Oceania,27520,905
AUS,2020-44,75,2,Australia,25499881,Oceania,27595,907
AUS,2020-45,63,0,Australia,25499881,Oceania,27658,907
AUS,2020-46,67,0,Australia,25499881,Oceania,27725,907
AUS,2020-47,96,0,Australia,25499881,Oceania,27821,907
AUS,2020-48,72,0,Australia,25499881,Oceania,27893,907
AUS,2020-49,72,1,Australia,25499881,Oceania,27965,908
AUS,2020-50,66,0,Australia,25499881,Oceania,28031,908
AUS,2020-51,167,0,Australia,25499881,Oceania,28198,908
AUS,2020-52,114,0,Australia,25499881,Oceania,28312,908
AUS,2020-53,192,1,Australia,25499881,Oceania,28504,909
AUS,2021-01,110,0,Australia,25499881,Oceania,28614,909
AUS,2021-02,94,0,Australia,25499881,Oceania,28708,909
AUS,2021-03,58,0,Australia,25499881,Oceania,28766,909
AUS,2021-04,52,0,Australia,25499881,Oceania,28818,909
AUS,2021-05,32,0,Australia,25499881,Oceania,28850,909
AUS,2021-06,50,0,Australia,25499881,Oceania,28900,909
AUS,2021-07,30,0,Australia,25499881,Oceania,28930,909
AUS,2021-08,40,0,Australia,25499881,Oceania,28970,909
AUS,2021-09,67,0,Australia,25499881,Oceania,29037,909
AUS,2021-10,80,0,Australia,25499881,Oceania,29117,909
AUS,2021-11,89,0,Australia,25499881,Oceania,29206,909
AUS,2021-12,54,0,Australia,25499881,Oceania,29260,909
AUS,2021-13,88,0,Australia,25499881,Oceania,29348,909
AUS,2021-14,57,0,Australia,25499881,Oceania,29405,909
AUS,2021-15,114,1,Australia,25499881,Oceania,29519,910
AUS,2021-16,147,0,Australia,25499881,Oceania,29666,910
AUS,2021-17,160,0,Australia,25499881,Oceania,29826,910
AUS,2021-18,97,0,Australia,25499881,Oceania,29923,910
AUS,2021-19,52,0,Australia,25499881,Oceania,29975,910
AUS,2021-20,36,0,Australia,25499881,Oceania,30011,910
AUS,2021-21,87,0,Australia,25499881,Oceania,30098,910
AUS,2021-22,77,0,Australia,25499881,Oceania,30175,910
AUS,2021-23,73,0,Australia,25499881,Oceania,30248,910
AUS,2021-24,83,0,Australia,25499881,Oceania,30331,910
AUS,2021-25,168,0,Australia,25499881,Oceania,30499,910
AUS,2021-26,258,0,Australia,25499881,Oceania,30757,910
AUS,2021-27,346,1,Australia,25499881,Oceania,31103,911
AUS,2021-28,795,3,Australia,25499881,Oceania,31898,914
AUS,2021-29,1019,4,Australia,25499881,Oceania,32917,918
AUS,2021-30,1467,6,Australia,25499881,Oceania,34384,924
AUS,2021-31,1946,12,Australia,25499881,Oceania,36330,936
AUS,2021-32,2766,22,Australia,25499881,Oceania,39096,958
AUT,2020-02,0,0,Austria,8901064,Europe,0,0
AUT,2020-03,0,0,Austria,8901064,Europe,0,0
AUT,2020-04,0,0,Austria,8901064,Europe,0,0
AUT,2020-05,0,0,Austria,8901064,Europe,0,0
AUT,2020-06,0,0,Austria,8901064,Europe,0,0
AUT,2020-07,0,0,Austria,8901064,Europe,0,0
AUT,2020-08,0,0,Austria,8901064,Europe,0,0
AUT,2020-09,14,0,Austria,8901064,Europe,14,0
AUT,2020-10,88,0,Austria,8901064,Europe,102,0
AUT,2020-11,758,1,Austria,8901064,Europe,860,1
AUT,2020-12,2771,15,Austria,8901064,Europe,3631,16
AUT,2020-13,5182,70,Austria,8901064,Europe,8813,86
AUT,2020-14,3170,118,Austria,8901064,Europe,11983,204
AUT,2020-15,1954,146,Austria,8901064,Europe,13937,350
AUT,2020-16,773,102,Austria,8901064,Europe,14710,452
AUT,2020-17,479,90,Austria,8901064,Europe,15189,542
AUT,2020-18,349,56,Austria,8901064,Europe,15538,598
AUT,2020-19,249,20,Austria,8901064,Europe,15787,618
AUT,2020-20,367,11,Austria,8901064,Europe,16154,629
AUT,2020-21,285,11,Austria,8901064,Europe,16439,640
AUT,2020-22,203,28,Austria,8901064,Europe,16642,668
AUT,2020-23,226,4,Austria,8901064,Europe,16868,672
AUT,2020-24,170,5,Austria,8901064,Europe,17038,677
AUT,2020-25,247,13,Austria,8901064,Europe,17285,690
AUT,2020-26,340,12,Austria,8901064,Europe,17625,702
AUT,2020-27,644,4,Austria,8901064,Europe,18269,706
AUT,2020-28,578,2,Austria,8901064,Europe,18847,708
AUT,2020-29,724,2,Austria,8901064,Europe,19571,710
AUT,2020-30,915,2,Austria,8901064,Europe,20486,712
AUT,2020-31,823,6,Austria,8901064,Europe,21309,718
AUT,2020-32,702,3,Austria,8901064,Europe,22011,721
AUT,2020-33,1362,7,Austria,8901064,Europe,23373,728
AUT,2020-34,1866,4,Austria,8901064,Europe,25239,732
AUT,2020-35,1979,1,Austria,8901064,Europe,27218,733
AUT,2020-36,1976,3,Austria,8901064,Europe,29194,736
AUT,2020-37,4141,20,Austria,8901064,Europe,33335,756
AUT,2020-38,5222,10,Austria,8901064,Europe,38557,766
AUT,2020-39,4909,21,Austria,8901064,Europe,43466,787
AUT,2020-40,5152,26,Austria,8901064,Europe,48618,813
AUT,2020-41,7365,51,Austria,8901064,Europe,55983,864
AUT,2020-42,9574,46,Austria,8901064,Europe,65557,910
AUT,2020-43,16979,74,Austria,8901064,Europe,82536,984
AUT,2020-44,28574,130,Austria,8901064,Europe,111110,1114
AUT,2020-45,41398,221,Austria,8901064,Europe,152508,1335
AUT,2020-46,50986,344,Austria,8901064,Europe,203494,1679
AUT,2020-47,42630,520,Austria,8901064,Europe,246124,2199
AUT,2020-48,32058,705,Austria,8901064,Europe,278182,2904
AUT,2020-49,22794,828,Austria,8901064,Europe,300976,3732
AUT,2020-50,19060,668,Austria,8901064,Europe,320036,4400
AUT,2020-51,16186,816,Austria,8901064,Europe,336222,5216
AUT,2020-52,15164,656,Austria,8901064,Europe,351386,5872
AUT,2020-53,13188,381,Austria,8901064,Europe,364574,6253
AUT,2021-01,15133,378,Austria,8901064,Europe,379707,6631
AUT,2021-02,11406,383,Austria,8901064,Europe,391113,7014
AUT,2021-03,10421,348,Austria,8901064,Europe,401534,7362
AUT,2021-04,9451,291,Austria,8901064,Europe,410985,7653
AUT,2021-05,10467,287,Austria,8901064,Europe,421452,7940
AUT,2021-06,8442,161,Austria,8901064,Europe,429894,8101
AUT,2021-07,11848,157,Austria,8901064,Europe,441742,8258
AUT,2021-08,14370,156,Austria,8901064,Europe,456112,8414
AUT,2021-09,15708,124,Austria,8901064,Europe,471820,8538
AUT,2021-10,18851,131,Austria,8901064,Europe,490671,8669
AUT,2021-11,20991,167,Austria,8901064,Europe,511662,8836
AUT,2021-12,21849,170,Austria,8901064,Europe,533511,9006
AUT,2021-13,21900,183,Austria,8901064,Europe,555411,9189
AUT,2021-14,18533,222,Austria,8901064,Europe,573944,9411
AUT,2021-15,16316,239,Austria,8901064,Europe,590260,9650
AUT,2021-16,15250,182,Austria,8901064,Europe,605510,9832
AUT,2021-17,12836,157,Austria,8901064,Europe,618346,9989
AUT,2021-18,8730,132,Austria,8901064,Europe,627076,10121
AUT,2021-19,5998,92,Austria,8901064,Europe,633074,10213
AUT,2021-20,4307,70,Austria,8901064,Europe,637381,10283
AUT,2021-21,3147,56,Austria,8901064,Europe,640528,10339
AUT,2021-22,2256,37,Austria,8901064,Europe,642784,10376
AUT,2021-23,1793,23,Austria,8901064,Europe,644577,10399
AUT,2021-24,635,18,Austria,8901064,Europe,645212,10417
AUT,2021-25,759,54,Austria,8901064,Europe,645971,10471
AUT,2021-26,647,21,Austria,8901064,Europe,646618,10492
AUT,2021-27,674,20,Austria,8901064,Europe,647292,10512
AUT,2021-28,2067,9,Austria,8901064,Europe,649359,10521
AUT,2021-29,2514,3,Austria,8901064,Europe,651873,10524
AUT,2021-30,3272,12,Austria,8901064,Europe,655145,10536
AUT,2021-31,3603,12,Austria,8901064,Europe,658748,10548
AUT,2021-32,5535,10,Austria,8901064,Europe,664283,10558
AZE,2020-02,0,0,Azerbaijan,10139175,Europe,0,0
AZE,2020-03,0,0,Azerbaijan,10139175,Europe,0,0
AZE,2020-04,0,0,Azerbaijan,10139175,Europe,0,0
AZE,2020-05,0,0,Azerbaijan,10139175,Europe,0,0
AZE,2020-06,0,0,Azerbaijan,10139175,Europe,0,0
AZE,2020-07,0,0,Azerbaijan,10139175,Europe,0,0
AZE,2020-08,0,0,Azerbaijan,10139175,Europe,0,0
AZE,2020-09,3,0,Azerbaijan,10139175,Europe,3,0
AZE,2020-10,6,0,Azerbaijan,10139175,Europe,9,0
AZE,2020-11,10,0,Azerbaijan,10139175,Europe,19,0
AZE,2020-12,46,1,Azerbaijan,10139175,Europe,65,1
AZE,2020-13,144,3,Azerbaijan,10139175,Europe,209,4
AZE,2020-14,375,3,Azerbaijan,10139175,Europe,584,7
AZE,2020-15,514,4,Azerbaijan,10139175,Europe,1098,11
AZE,2020-16,300,8,Azerbaijan,10139175,Europe,1398,19
AZE,2020-17,247,2,Azerbaijan,10139175,Europe,1645,21
AZE,2020-18,287,4,Azerbaijan,10139175,Europe,1932,25
AZE,2020-19,587,7,Azerbaijan,10139175,Europe,2519,32
AZE,2020-20,755,7,Azerbaijan,10139175,Europe,3274,39
AZE,2020-21,848,10,Azerbaijan,10139175,Europe,4122,49
AZE,2020-22,1372,14,Azerbaijan,10139175,Europe,5494,63
AZE,2020-23,2059,25,Azerbaijan,10139175,Europe,7553,88
AZE,2020-24,2404,31,Azerbaijan,10139175,Europe,9957,119
AZE,2020-25,2772,35,Azerbaijan,10139175,Europe,12729,154
AZE,2020-26,3695,44,Azerbaijan,10139175,Europe,16424,198
AZE,2020-27,3900,52,Azerbaijan,10139175,Europe,20324,250
AZE,2020-28,3717,56,Azerbaijan,10139175,Europe,24041,306
AZE,2020-29,3480,48,Azerbaijan,10139175,Europe,27521,354
AZE,2020-30,2529,63,Azerbaijan,10139175,Europe,30050,417
AZE,2020-31,2393,45,Azerbaijan,10139175,Europe,32443,462
AZE,2020-32,1125,28,Azerbaijan,10139175,Europe,33568,490
AZE,2020-33,651,16,Azerbaijan,10139175,Europe,34219,506
AZE,2020-34,1055,12,Azerbaijan,10139175,Europe,35274,518
AZE,2020-35,1035,13,Azerbaijan,10139175,Europe,36309,531
AZE,2020-36,1020,17,Azerbaijan,10139175,Europe,37329,548
AZE,2020-37,998,14,Azerbaijan,10139175,Europe,38327,562
AZE,2020-38,861,13,Azerbaijan,10139175,Europe,39188,575
AZE,2020-39,835,11,Azerbaijan,10139175,Europe,40023,586
AZE,2020-40,668,10,Azerbaijan,10139175,Europe,40691,596
AZE,2020-41,1291,13,Azerbaijan,10139175,Europe,41982,609
AZE,2020-42,2982,17,Azerbaijan,10139175,Europe,44964,626
AZE,2020-43,4995,45,Azerbaijan,10139175,Europe,49959,671
AZE,2020-44,6485,69,Azerbaijan,10139175,Europe,56444,740
AZE,2020-45,8967,100,Azerbaijan,10139175,Europe,65411,840
AZE,2020-46,10277,127,Azerbaijan,10139175,Europe,75688,967
AZE,2020-47,17406,164,Azerbaijan,10139175,Europe,93094,1131
AZE,2020-48,25101,230,Azerbaijan,10139175,Europe,118195,1361
AZE,2020-49,28484,271,Azerbaijan,10139175,Europe,146679,1632
AZE,2020-50,29195,290,Azerbaijan,10139175,Europe,175874,1922
AZE,2020-51,26214,288,Azerbaijan,10139175,Europe,202088,2210
AZE,2020-52,13395,328,Azerbaijan,10139175,Europe,215483,2538
AZE,2020-53,4782,195,Azerbaijan,10139175,Europe,220265,2733
AZE,2021-01,4562,193,Azerbaijan,10139175,Europe,224827,2926
AZE,2021-02,2564,96,Azerbaijan,10139175,Europe,227391,3022
AZE,2021-03,1641,71,Azerbaijan,10139175,Europe,229032,3093
AZE,2021-04,1187,39,Azerbaijan,10139175,Europe,230219,3132
AZE,2021-05,935,26,Azerbaijan,10139175,Europe,231154,3158
AZE,2021-06,1043,25,Azerbaijan,10139175,Europe,232197,3183
AZE,2021-07,1004,19,Azerbaijan,10139175,Europe,233201,3202
AZE,2021-08,1461,21,Azerbaijan,10139175,Europe,234662,3223
AZE,2021-09,2301,24,Azerbaijan,10139175,Europe,236963,3247
AZE,2021-10,3332,35,Azerbaijan,10139175,Europe,240295,3282
AZE,2021-11,6679,84,Azerbaijan,10139175,Europe,246974,3366
AZE,2021-12,10356,147,Azerbaijan,10139175,Europe,257330,3513
AZE,2021-13,14504,198,Azerbaijan,10139175,Europe,271834,3711
AZE,2021-14,15310,233,Azerbaijan,10139175,Europe,287144,3944
AZE,2021-15,14517,225,Azerbaijan,10139175,Europe,301661,4169
AZE,2021-16,12151,233,Azerbaijan,10139175,Europe,313812,4402
AZE,2021-17,7986,178,Azerbaijan,10139175,Europe,321798,4580
AZE,2021-18,5289,118,Azerbaijan,10139175,Europe,327087,4698
AZE,2021-19,3182,94,Azerbaijan,10139175,Europe,330269,4792
AZE,2021-20,2185,68,Azerbaijan,10139175,Europe,332454,4860
AZE,2021-21,1410,47,Azerbaijan,10139175,Europe,333864,4907
AZE,2021-22,851,34,Azerbaijan,10139175,Europe,334715,4941
AZE,2021-23,456,12,Azerbaijan,10139175,Europe,335171,4953
AZE,2021-24,322,9,Azerbaijan,10139175,Europe,335493,4962
AZE,2021-25,343,6,Azerbaijan,10139175,Europe,335836,4968
AZE,2021-26,581,10,Azerbaijan,10139175,Europe,336417,4978
AZE,2021-27,837,6,Azerbaijan,10139175,Europe,337254,4984
AZE,2021-28,1332,10,Azerbaijan,10139175,Europe,338586,4994
AZE,2021-29,1857,12,Azerbaijan,10139175,Europe,340443,5006
AZE,2021-30,4077,21,Azerbaijan,10139175,Europe,344520,5027
AZE,2021-31,7305,36,Azerbaijan,10139175,Europe,351825,5063
AZE,2021-32,16177,90,Azerbaijan,10139175,Europe,368002,5153
BDI,2020-15,2,0,Burundi,11890781,Africa,2,0
BDI,2020-16,1,1,Burundi,11890781,Africa,3,1
BDI,2020-17,9,0,Burundi,11890781,Africa,12,1
BDI,2020-18,4,0,Burundi,11890781,Africa,16,1
BDI,2020-19,0,0,Burundi,11890781,Africa,16,1
BDI,2020-20,23,0,Burundi,11890781,Africa,39,1
BDI,2020-21,0,0,Burundi,11890781,Africa,39,1
BDI,2020-22,21,0,Burundi,11890781,Africa,60,1
BDI,2020-23,20,0,Burundi,11890781,Africa,80,1
BDI,2020-24,11,0,Burundi,11890781,Africa,91,1
BDI,2020-25,50,0,Burundi,11890781,Africa,141,1
BDI,2020-26,26,0,Burundi,11890781,Africa,167,1
BDI,2020-27,21,0,Burundi,11890781,Africa,188,1
BDI,2020-28,59,0,Burundi,11890781,Africa,247,1
BDI,2020-29,60,0,Burundi,11890781,Africa,307,1
BDI,2020-30,51,0,Burundi,11890781,Africa,358,1
BDI,2020-31,34,0,Burundi,11890781,Africa,392,1
BDI,2020-32,13,0,Burundi,11890781,Africa,405,1
BDI,2020-33,5,0,Burundi,11890781,Africa,410,1
BDI,2020-34,16,0,Burundi,11890781,Africa,426,1
BDI,2020-35,16,0,Burundi,11890781,Africa,442,1
BDI,2020-36,17,0,Burundi,11890781,Africa,459,1
BDI,2020-37,10,0,Burundi,11890781,Africa,469,1
BDI,2020-38,1,0,Burundi,11890781,Africa,470,1
BDI,2020-39,12,0,Burundi,11890781,Africa,482,1
BDI,2020-40,28,0,Burundi,11890781,Africa,510,1
BDI,2020-41,11,0,Burundi,11890781,Africa,521,1
BDI,2020-42,18,0,Burundi,11890781,Africa,539,1
BDI,2020-43,14,0,Burundi,11890781,Africa,553,1
BDI,2020-44,33,0,Burundi,11890781,Africa,586,1
BDI,2020-45,25,0,Burundi,11890781,Africa,611,1
BDI,2020-46,14,0,Burundi,11890781,Africa,625,1
BDI,2020-47,34,0,Burundi,11890781,Africa,659,1
BDI,2020-48,19,0,Burundi,11890781,Africa,678,1
BDI,2020-49,13,0,Burundi,11890781,Africa,691,1
BDI,2020-50,35,0,Burundi,11890781,Africa,726,1
BDI,2020-51,32,1,Burundi,11890781,Africa,758,2
BDI,2020-52,48,0,Burundi,11890781,Africa,806,2
BDI,2020-53,24,0,Burundi,11890781,Africa,830,2
BDI,2021-01,186,0,Burundi,11890781,Africa,1016,2
BDI,2021-02,217,0,Burundi,11890781,Africa,1233,2
BDI,2021-03,243,0,Burundi,11890781,Africa,1476,2
BDI,2021-04,156,0,Burundi,11890781,Africa,1632,2
BDI,2021-05,93,1,Burundi,11890781,Africa,1725,3
BDI,2021-06,96,0,Burundi,11890781,Africa,1821,3
BDI,2021-07,210,0,Burundi,11890781,Africa,2031,3
BDI,2021-08,175,0,Burundi,11890781,Africa,2206,3
BDI,2021-09,130,0,Burundi,11890781,Africa,2336,3
BDI,2021-10,122,0,Burundi,11890781,Africa,2458,3
BDI,2021-11,152,0,Burundi,11890781,Africa,2610,3
BDI,2021-12,144,3,Burundi,11890781,Africa,2754,6
BDI,2021-13,154,0,Burundi,11890781,Africa,2908,6
BDI,2021-14,351,0,Burundi,11890781,Africa,3259,6
BDI,2021-15,350,0,Burundi,11890781,Africa,3609,6
BDI,2021-16,241,0,Burundi,11890781,Africa,3850,6
BDI,2021-17,185,0,Burundi,11890781,Africa,4035,6
BDI,2021-18,139,0,Burundi,11890781,Africa,4174,6
BDI,2021-19,152,0,Burundi,11890781,Africa,4326,6
BDI,2021-20,165,0,Burundi,11890781,Africa,4491,6
BDI,2021-21,260,0,Burundi,11890781,Africa,4751,6
BDI,2021-22,151,2,Burundi,11890781,Africa,4902,8
BDI,2021-23,108,0,Burundi,11890781,Africa,5010,8
BDI,2021-24,213,0,Burundi,11890781,Africa,5223,8
BDI,2021-25,182,0,Burundi,11890781,Africa,5405,8
BDI,2021-26,103,0,Burundi,11890781,Africa,5508,8
BDI,2021-27,175,0,Burundi,11890781,Africa,5683,8
BDI,2021-28,148,0,Burundi,11890781,Africa,5831,8
BDI,2021-29,585,0,Burundi,11890781,Africa,6416,8
BDI,2021-30,953,1,Burundi,11890781,Africa,7369,9
BDI,2021-31,1428,1,Burundi,11890781,Africa,8797,10
BDI,2021-32,1055,0,Burundi,11890781,Africa,9852,10
BEL,2020-02,0,0,Belgium,11522440,Europe,0,0
BEL,2020-03,0,0,Belgium,11522440,Europe,0,0
BEL,2020-04,0,0,Belgium,11522440,Europe,0,0
BEL,2020-05,0,0,Belgium,11522440,Europe,0,0
BEL,2020-06,0,0,Belgium,11522440,Europe,0,0
BEL,2020-07,0,0,Belgium,11522440,Europe,0,0
BEL,2020-08,343,0,Belgium,11522440,Europe,343,0
BEL,2020-09,-324,0,Belgium,11522440,Europe,19,0
BEL,2020-10,388,0,Belgium,11522440,Europe,407,0
BEL,2020-11,1348,18,Belgium,11522440,Europe,1755,18
BEL,2020-12,3673,203,Belgium,11522440,Europe,5428,221
BEL,2020-13,8130,785,Belgium,11522440,Europe,13558,1006
BEL,2020-14,9694,1585,Belgium,11522440,Europe,23252,2591
BEL,2020-15,11175,1980,Belgium,11522440,Europe,34427,4571
BEL,2020-16,7963,1668,Belgium,11522440,Europe,42390,6239
BEL,2020-17,5703,1192,Belgium,11522440,Europe,48093,7431
BEL,2020-18,3095,701,Belgium,11522440,Europe,51188,8132
BEL,2020-19,3051,537,Belgium,11522440,Europe,54239,8669
BEL,2020-20,2071,315,Belgium,11522440,Europe,56310,8984
BEL,2020-21,1510,234,Belgium,11522440,Europe,57820,9218
BEL,2020-22,1144,162,Belgium,11522440,Europe,58964,9380
BEL,2020-23,847,113,Belgium,11522440,Europe,59811,9493
BEL,2020-24,671,59,Belgium,11522440,Europe,60482,9552
BEL,2020-25,668,43,Belgium,11522440,Europe,61150,9595
BEL,2020-26,607,40,Belgium,11522440,Europe,61757,9635
BEL,2020-27,637,25,Belgium,11522440,Europe,62394,9660
BEL,2020-28,704,13,Belgium,11522440,Europe,63098,9673
BEL,2020-29,1385,20,Belgium,11522440,Europe,64483,9693
BEL,2020-30,2489,15,Belgium,11522440,Europe,66972,9708
BEL,2020-31,3759,22,Belgium,11522440,Europe,70731,9730
BEL,2020-32,4340,33,Belgium,11522440,Europe,75071,9763
BEL,2020-33,3751,77,Belgium,11522440,Europe,78822,9840
BEL,2020-34,3453,43,Belgium,11522440,Europe,82275,9883
BEL,2020-35,3121,28,Belgium,11522440,Europe,85396,9911
BEL,2020-36,3655,19,Belgium,11522440,Europe,89051,9930
BEL,2020-37,6158,19,Belgium,11522440,Europe,95209,9949
BEL,2020-38,10108,28,Belgium,11522440,Europe,105317,9977
BEL,2020-39,11274,40,Belgium,11522440,Europe,116591,10017
BEL,2020-40,18895,85,Belgium,11522440,Europe,135486,10102
BEL,2020-41,38851,144,Belgium,11522440,Europe,174337,10246
BEL,2020-42,72232,240,Belgium,11522440,Europe,246569,10486
BEL,2020-43,105383,512,Belgium,11522440,Europe,351952,10998
BEL,2020-44,99582,1066,Belgium,11522440,Europe,451534,12064
BEL,2020-45,54005,1435,Belgium,11522440,Europe,505539,13499
BEL,2020-46,33967,1337,Belgium,11522440,Europe,539506,14836
BEL,2020-47,22312,1132,Belgium,11522440,Europe,561818,15968
BEL,2020-48,16261,883,Belgium,11522440,Europe,578079,16851
BEL,2020-49,15289,705,Belgium,11522440,Europe,593368,17556
BEL,2020-50,16840,668,Belgium,11522440,Europe,610208,18224
BEL,2020-51,17714,657,Belgium,11522440,Europe,627922,18881
BEL,2020-52,12607,538,Belgium,11522440,Europe,640529,19419
BEL,2020-53,11436,457,Belgium,11522440,Europe,651965,19876
BEL,2021-01,14920,389,Belgium,11522440,Europe,666885,20265
BEL,2021-02,14183,344,Belgium,11522440,Europe,681068,20609
BEL,2021-03,15424,376,Belgium,11522440,Europe,696492,20985
BEL,2021-04,16997,297,Belgium,11522440,Europe,713489,21282
BEL,2021-05,15377,301,Belgium,11522440,Europe,728866,21583
BEL,2021-06,12932,281,Belgium,11522440,Europe,741798,21864
BEL,2021-07,15661,213,Belgium,11522440,Europe,757459,22077
BEL,2021-08,16954,176,Belgium,11522440,Europe,774413,22253
BEL,2021-09,16698,173,Belgium,11522440,Europe,791111,22426
BEL,2021-10,21552,173,Belgium,11522440,Europe,812663,22599
BEL,2021-11,29607,182,Belgium,11522440,Europe,842270,22781
BEL,2021-12,34284,190,Belgium,11522440,Europe,876554,22971
BEL,2021-13,30207,257,Belgium,11522440,Europe,906761,23228
BEL,2021-14,24433,292,Belgium,11522440,Europe,931194,23520
BEL,2021-15,24651,270,Belgium,11522440,Europe,955845,23790
BEL,2021-16,24682,282,Belgium,11522440,Europe,980527,24072
BEL,2021-17,21014,260,Belgium,11522440,Europe,1001541,24332
BEL,2021-18,21230,259,Belgium,11522440,Europe,1022771,24591
BEL,2021-19,14900,144,Belgium,11522440,Europe,1037671,24735
BEL,2021-20,17289,129,Belgium,11522440,Europe,1054960,24864
BEL,2021-21,12212,100,Belgium,11522440,Europe,1067172,24964
BEL,2021-22,9116,86,Belgium,11522440,Europe,1076288,25050
BEL,2021-23,5274,50,Belgium,11522440,Europe,1081562,25100
BEL,2021-24,3021,42,Belgium,11522440,Europe,1084583,25142
BEL,2021-25,2453,28,Belgium,11522440,Europe,1087036,25170
BEL,2021-26,4083,22,Belgium,11522440,Europe,1091119,25192
BEL,2021-27,7503,13,Belgium,11522440,Europe,1098622,25205
BEL,2021-28,9524,9,Belgium,11522440,Europe,1108146,25214
BEL,2021-29,10363,14,Belgium,11522440,Europe,1118509,25228
BEL,2021-30,11245,22,Belgium,11522440,Europe,1129754,25250
BEL,2021-31,12177,26,Belgium,11522440,Europe,1141931,25276
BEL,2021-32,13254,22,Belgium,11522440,Europe,1155185,25298
BEN,2020-13,4,0,Benin,12123198,Africa,4,0
BEN,2020-14,16,0,Benin,12123198,Africa,20,0
BEN,2020-15,13,1,Benin,12123198,Africa,33,1
BEN,2020-16,2,0,Benin,12123198,Africa,35,1
BEN,2020-17,27,0,Benin,12123198,Africa,62,1
BEN,2020-18,26,1,Benin,12123198,Africa,88,2
BEN,2020-19,229,0,Benin,12123198,Africa,317,2
BEN,2020-20,20,0,Benin,12123198,Africa,337,2
BEN,2020-21,-148,1,Benin,12123198,Africa,189,3
BEN,2020-22,41,0,Benin,12123198,Africa,230,3
BEN,2020-23,36,1,Benin,12123198,Africa,266,4
BEN,2020-24,202,3,Benin,12123198,Africa,468,7
BEN,2020-25,295,6,Benin,12123198,Africa,763,13
BEN,2020-26,384,3,Benin,12123198,Africa,1147,16
BEN,2020-27,50,5,Benin,12123198,Africa,1197,21
BEN,2020-28,179,5,Benin,12123198,Africa,1376,26
BEN,2020-29,224,5,Benin,12123198,Africa,1600,31
BEN,2020-30,168,4,Benin,12123198,Africa,1768,35
BEN,2020-31,35,1,Benin,12123198,Africa,1803,36
BEN,2020-32,131,2,Benin,12123198,Africa,1934,38
BEN,2020-33,127,1,Benin,12123198,Africa,2061,39
BEN,2020-34,52,0,Benin,12123198,Africa,2113,39
BEN,2020-35,30,1,Benin,12123198,Africa,2143,40
BEN,2020-36,68,0,Benin,12123198,Africa,2211,40
BEN,2020-37,54,0,Benin,12123198,Africa,2265,40
BEN,2020-38,13,0,Benin,12123198,Africa,2278,40
BEN,2020-39,60,0,Benin,12123198,Africa,2338,40
BEN,2020-40,17,1,Benin,12123198,Africa,2355,41
BEN,2020-41,54,0,Benin,12123198,Africa,2409,41
BEN,2020-42,85,0,Benin,12123198,Africa,2494,41
BEN,2020-43,61,0,Benin,12123198,Africa,2555,41
BEN,2020-44,86,0,Benin,12123198,Africa,2641,41
BEN,2020-45,102,2,Benin,12123198,Africa,2743,43
BEN,2020-46,99,0,Benin,12123198,Africa,2842,43
BEN,2020-47,72,0,Benin,12123198,Africa,2914,43
BEN,2020-48,58,0,Benin,12123198,Africa,2972,43
BEN,2020-49,81,1,Benin,12123198,Africa,3053,44
BEN,2020-50,35,0,Benin,12123198,Africa,3088,44
BEN,2020-51,77,0,Benin,12123198,Africa,3165,44
BEN,2020-52,38,0,Benin,12123198,Africa,3203,44
BEN,2020-53,46,0,Benin,12123198,Africa,3249,44
BEN,2021-01,53,0,Benin,12123198,Africa,3302,44
BEN,2021-02,109,2,Benin,12123198,Africa,3411,46
BEN,2021-03,230,2,Benin,12123198,Africa,3641,48
BEN,2021-04,250,4,Benin,12123198,Africa,3891,52
BEN,2021-05,300,3,Benin,12123198,Africa,4191,55
BEN,2021-06,367,1,Benin,12123198,Africa,4558,56
BEN,2021-07,874,14,Benin,12123198,Africa,5432,70
BEN,2021-08,200,0,Benin,12123198,Africa,5632,70
BEN,2021-09,704,11,Benin,12123198,Africa,6336,81
BEN,2021-10,163,0,Benin,12123198,Africa,6499,81
BEN,2021-11,317,9,Benin,12123198,Africa,6816,90
BEN,2021-12,282,0,Benin,12123198,Africa,7098,90
BEN,2021-13,213,3,Benin,12123198,Africa,7311,93
BEN,2021-14,202,0,Benin,12123198,Africa,7513,93
BEN,2021-15,96,3,Benin,12123198,Africa,7609,96
BEN,2021-16,109,1,Benin,12123198,Africa,7718,97
BEN,2021-17,101,2,Benin,12123198,Africa,7819,99
BEN,2021-18,63,1,Benin,12123198,Africa,7882,100
BEN,2021-19,100,1,Benin,12123198,Africa,7982,101
BEN,2021-20,41,0,Benin,12123198,Africa,8023,101
BEN,2021-21,33,0,Benin,12123198,Africa,8056,101
BEN,2021-22,24,1,Benin,12123198,Africa,8080,102
BEN,2021-23,27,0,Benin,12123198,Africa,8107,102
BEN,2021-24,31,1,Benin,12123198,Africa,8138,103
BEN,2021-25,30,1,Benin,12123198,Africa,8168,104
BEN,2021-26,29,0,Benin,12123198,Africa,8197,104
BEN,2021-27,28,1,Benin,12123198,Africa,8225,105
BEN,2021-28,17,2,Benin,12123198,Africa,8242,107
BEN,2021-29,80,0,Benin,12123198,Africa,8322,107
BEN,2021-30,70,1,Benin,12123198,Africa,8392,108
BEN,2021-31,214,2,Benin,12123198,Africa,8606,110
BEN,2021-32,457,3,Benin,12123198,Africa,9063,113
BES,2020-15,1,0,"Bonaire, Saint Eustatius And Saba",26221,America,1,0
BES,2020-16,2,0,"Bonaire, Saint Eustatius And Saba",26221,America,3,0
BES,2020-17,1,0,"Bonaire, Saint Eustatius And Saba",26221,America,4,0
BES,2020-18,0,0,"Bonaire, Saint Eustatius And Saba",26221,America,4,0
BES,2020-19,0,0,"Bonaire, Saint Eustatius And Saba",26221,America,4,0
BES,2020-20,0,0,"Bonaire, Saint Eustatius And Saba",26221,America,4,0
BES,2020-21,1,0,"Bonaire, Saint Eustatius And Saba",26221,America,5,0
BES,2020-22,0,0,"Bonaire, Saint Eustatius And Saba",26221,America,5,0
BES,2020-23,0,0,"Bonaire, Saint Eustatius And Saba",26221,America,5,0
BES,2020-24,0,0,"Bonaire, Saint Eustatius And Saba",26221,America,5,0
BES,2020-25,0,0,"Bonaire, Saint Eustatius And Saba",26221,America,5,0
BES,2020-26,0,0,"Bonaire, Saint Eustatius And Saba",26221,America,5,0
BES,2020-27,0,0,"Bonaire, Saint Eustatius And Saba",26221,America,5,0
BES,2020-28,0,0,"Bonaire, Saint Eustatius And Saba",26221,America,5,0
BES,2020-29,3,0,"Bonaire, Saint Eustatius And Saba",26221,America,8,0
BES,2020-30,1,0,"Bonaire, Saint Eustatius And Saba",26221,America,9,0
BES,2020-31,0,0,"Bonaire, Saint Eustatius And Saba",26221,America,9,0
BES,2020-32,2,0,"Bonaire, Saint Eustatius And Saba",26221,America,11,0
BES,2020-33,0,0,"Bonaire, Saint Eustatius And Saba",26221,America,11,0
BES,2020-34,0,0,"Bonaire, Saint Eustatius And Saba",26221,America,11,0
BES,2020-35,2,0,"Bonaire, Saint Eustatius And Saba",26221,America,13,0
BES,2020-36,3,0,"Bonaire, Saint Eustatius And Saba",26221,America,16,0
BES,2020-37,8,0,"Bonaire, Saint Eustatius And Saba",26221,America,24,0
BES,2020-38,10,1,"Bonaire, Saint Eustatius And Saba",26221,America,34,1
BES,2020-39,49,0,"Bonaire, Saint Eustatius And Saba",26221,America,83,1
BES,2020-40,39,0,"Bonaire, Saint Eustatius And Saba",26221,America,122,1
BES,2020-41,24,1,"Bonaire, Saint Eustatius And Saba",26221,America,146,2
BES,2020-42,2,0,"Bonaire, Saint Eustatius And Saba",26221,America,148,2
BES,2020-43,0,1,"Bonaire, Saint Eustatius And Saba",26221,America,148,3
BES,2020-44,3,0,"Bonaire, Saint Eustatius And Saba",26221,America,151,3
BES,2020-45,1,0,"Bonaire, Saint Eustatius And Saba",26221,America,152,3
BES,2020-46,1,0,"Bonaire, Saint Eustatius And Saba",26221,America,153,3
BES,2020-47,6,0,"Bonaire, Saint Eustatius And Saba",26221,America,159,3
BES,2020-48,0,0,"Bonaire, Saint Eustatius And Saba",26221,America,159,3
BES,2020-49,3,0,"Bonaire, Saint Eustatius And Saba",26221,America,162,3
BES,2020-50,9,0,"Bonaire, Saint Eustatius And Saba",26221,America,171,3
BES,2020-51,6,0,"Bonaire, Saint Eustatius And Saba",26221,America,177,3
BES,2020-52,4,0,"Bonaire, Saint Eustatius And Saba",26221,America,181,3
BES,2020-53,58,0,"Bonaire, Saint Eustatius And Saba",26221,America,239,3
BES,2021-01,93,0,"Bonaire, Saint Eustatius And Saba",26221,America,332,3
BES,2021-02,31,0,"Bonaire, Saint Eustatius And Saba",26221,America,363,3
BES,2021-03,17,0,"Bonaire, Saint Eustatius And Saba",26221,America,380,3
BES,2021-04,10,0,"Bonaire, Saint Eustatius And Saba",26221,America,390,3
BES,2021-05,2,0,"Bonaire, Saint Eustatius And Saba",26221,America,392,3
BES,2021-06,10,1,"Bonaire, Saint Eustatius And Saba",26221,America,402,4
BES,2021-07,25,0,"Bonaire, Saint Eustatius And Saba",26221,America,427,4
BES,2021-08,16,0,"Bonaire, Saint Eustatius And Saba",26221,America,443,4
BES,2021-09,119,1,"Bonaire, Saint Eustatius And Saba",26221,America,562,5
BES,2021-10,240,1,"Bonaire, Saint Eustatius And Saba",26221,America,802,6
BES,2021-11,314,3,"Bonaire, Saint Eustatius And Saba",26221,America,1116,9
BES,2021-12,223,1,"Bonaire, Saint Eustatius And Saba",26221,America,1339,10
BES,2021-13,127,4,"Bonaire, Saint Eustatius And Saba",26221,America,1466,14
BES,2021-14,27,0,"Bonaire, Saint Eustatius And Saba",26221,America,1493,14
BES,2021-15,53,1,"Bonaire, Saint Eustatius And Saba",26221,America,1546,15
BES,2021-16,6,0,"Bonaire, Saint Eustatius And Saba",26221,America,1552,15
BES,2021-17,6,1,"Bonaire, Saint Eustatius And Saba",26221,America,1558,16
BES,2021-18,22,1,"Bonaire, Saint Eustatius And Saba",26221,America,1580,17
BES,2021-19,18,0,"Bonaire, Saint Eustatius And Saba",26221,America,1598,17
BES,2021-20,10,0,"Bonaire, Saint Eustatius And Saba",26221,America,1608,17
BES,2021-21,4,0,"Bonaire, Saint Eustatius And Saba",26221,America,1612,17
BES,2021-22,3,0,"Bonaire, Saint Eustatius And Saba",26221,America,1615,17
BES,2021-23,3,0,"Bonaire, Saint Eustatius And Saba",26221,America,1618,17
BES,2021-24,13,0,"Bonaire, Saint Eustatius And Saba",26221,America,1631,17
BES,2021-25,12,0,"Bonaire, Saint Eustatius And Saba",26221,America,1643,17
BES,2021-26,8,0,"Bonaire, Saint Eustatius And Saba",26221,America,1651,17
BES,2021-27,8,0,"Bonaire, Saint Eustatius And Saba",26221,America,1659,17
BES,2021-28,15,0,"Bonaire, Saint Eustatius And Saba",26221,America,1674,17
BES,2021-29,17,0,"Bonaire, Saint Eustatius And Saba",26221,America,1691,17
BES,2021-30,17,0,"Bonaire, Saint Eustatius And Saba",26221,America,1708,17
BES,2021-31,19,0,"Bonaire, Saint Eustatius And Saba",26221,America,1727,17
BES,2021-32,27,0,"Bonaire, Saint Eustatius And Saba",26221,America,1754,17
BFA,2020-12,61,3,Burkina Faso,20903278,Africa,61,3
BFA,2020-13,116,6,Burkina Faso,20903278,Africa,177,9
BFA,2020-14,165,8,Burkina Faso,20903278,Africa,342,17
BFA,2020-15,152,10,Burkina Faso,20903278,Africa,494,27
BFA,2020-16,79,9,Burkina Faso,20903278,Africa,573,36
BFA,2020-17,56,6,Burkina Faso,20903278,Africa,629,42
BFA,2020-18,30,3,Burkina Faso,20903278,Africa,659,45
BFA,2020-19,89,4,Burkina Faso,20903278,Africa,748,49
BFA,2020-20,45,2,Burkina Faso,20903278,Africa,793,51
BFA,2020-21,36,1,Burkina Faso,20903278,Africa,829,52
BFA,2020-22,49,1,Burkina Faso,20903278,Africa,878,53
BFA,2020-23,8,0,Burkina Faso,20903278,Africa,886,53
BFA,2020-24,5,0,Burkina Faso,20903278,Africa,891,53
BFA,2020-25,9,0,Burkina Faso,20903278,Africa,900,53
BFA,2020-26,56,0,Burkina Faso,20903278,Africa,956,53
BFA,2020-27,28,0,Burkina Faso,20903278,Africa,984,53
BFA,2020-28,49,0,Burkina Faso,20903278,Africa,1033,53
BFA,2020-29,29,0,Burkina Faso,20903278,Africa,1062,53
BFA,2020-30,35,0,Burkina Faso,20903278,Africa,1097,53
BFA,2020-31,50,0,Burkina Faso,20903278,Africa,1147,53
BFA,2020-32,54,1,Burkina Faso,20903278,Africa,1201,54
BFA,2020-33,63,1,Burkina Faso,20903278,Africa,1264,55
BFA,2020-34,61,0,Burkina Faso,20903278,Africa,1325,55
BFA,2020-35,40,0,Burkina Faso,20903278,Africa,1365,55
BFA,2020-36,84,0,Burkina Faso,20903278,Africa,1449,55
BFA,2020-37,255,1,Burkina Faso,20903278,Africa,1704,56
BFA,2020-38,139,0,Burkina Faso,20903278,Africa,1843,56
BFA,2020-39,162,0,Burkina Faso,20903278,Africa,2005,56
BFA,2020-40,159,3,Burkina Faso,20903278,Africa,2164,59
BFA,2020-41,113,4,Burkina Faso,20903278,Africa,2277,63
BFA,2020-42,101,2,Burkina Faso,20903278,Africa,2378,65
BFA,2020-43,70,0,Burkina Faso,20903278,Africa,2448,65
BFA,2020-44,49,2,Burkina Faso,20903278,Africa,2497,67
BFA,2020-45,69,0,Burkina Faso,20903278,Africa,2566,67
BFA,2020-46,72,1,Burkina Faso,20903278,Africa,2638,68
BFA,2020-47,94,0,Burkina Faso,20903278,Africa,2732,68
BFA,2020-48,121,0,Burkina Faso,20903278,Africa,2853,68
BFA,2020-49,356,0,Burkina Faso,20903278,Africa,3209,68
BFA,2020-50,818,3,Burkina Faso,20903278,Africa,4027,71
BFA,2020-51,1130,5,Burkina Faso,20903278,Africa,5157,76
BFA,2020-52,1184,2,Burkina Faso,20903278,Africa,6341,78
BFA,2020-53,707,8,Burkina Faso,20903278,Africa,7048,86
BFA,2021-01,1224,3,Burkina Faso,20903278,Africa,8272,89
BFA,2021-02,913,13,Burkina Faso,20903278,Africa,9185,102
BFA,2021-03,915,15,Burkina Faso,20903278,Africa,10100,117
BFA,2021-04,665,4,Burkina Faso,20903278,Africa,10765,121
BFA,2021-05,517,13,Burkina Faso,20903278,Africa,11282,134
BFA,2021-06,345,4,Burkina Faso,20903278,Africa,11627,138
BFA,2021-07,167,1,Burkina Faso,20903278,Africa,11794,139
BFA,2021-08,185,3,Burkina Faso,20903278,Africa,11979,142
BFA,2021-09,199,1,Burkina Faso,20903278,Africa,12178,143
BFA,2021-10,197,1,Burkina Faso,20903278,Africa,12375,144
BFA,2021-11,157,1,Burkina Faso,20903278,Africa,12532,145
BFA,2021-12,157,0,Burkina Faso,20903278,Africa,12689,145
BFA,2021-13,125,5,Burkina Faso,20903278,Africa,12814,150
BFA,2021-14,172,3,Burkina Faso,20903278,Africa,12986,153
BFA,2021-15,140,1,Burkina Faso,20903278,Africa,13126,154
BFA,2021-16,134,2,Burkina Faso,20903278,Africa,13260,156
BFA,2021-17,61,1,Burkina Faso,20903278,Africa,13321,157
BFA,2021-18,58,5,Burkina Faso,20903278,Africa,13379,162
BFA,2021-19,15,2,Burkina Faso,20903278,Africa,13394,164
BFA,2021-20,18,1,Burkina Faso,20903278,Africa,13412,165
BFA,2021-21,16,1,Burkina Faso,20903278,Africa,13428,166
BFA,2021-22,22,1,Burkina Faso,20903278,Africa,13450,167
BFA,2021-23,6,0,Burkina Faso,20903278,Africa,13456,167
BFA,2021-24,9,0,Burkina Faso,20903278,Africa,13465,167
BFA,2021-25,11,1,Burkina Faso,20903278,Africa,13476,168
BFA,2021-26,15,0,Burkina Faso,20903278,Africa,13491,168
BFA,2021-27,15,0,Burkina Faso,20903278,Africa,13506,168
BFA,2021-28,27,1,Burkina Faso,20903278,Africa,13533,169
BFA,2021-29,14,0,Burkina Faso,20903278,Africa,13547,169
BFA,2021-30,38,0,Burkina Faso,20903278,Africa,13585,169
BFA,2021-31,37,0,Burkina Faso,20903278,Africa,13622,169
BFA,2021-32,50,1,Burkina Faso,20903278,Africa,13672,170
BGD,2020-11,0,0,Bangladesh,164689383,Asia,0,0
BGD,2020-12,24,3,Bangladesh,164689383,Asia,24,3
BGD,2020-13,22,2,Bangladesh,164689383,Asia,46,5
BGD,2020-14,39,4,Bangladesh,164689383,Asia,85,9
BGD,2020-15,533,25,Bangladesh,164689383,Asia,618,34
BGD,2020-16,1835,57,Bangladesh,164689383,Asia,2453,91
BGD,2020-17,2960,54,Bangladesh,164689383,Asia,5413,145
BGD,2020-18,4039,32,Bangladesh,164689383,Asia,9452,177
BGD,2020-19,5202,51,Bangladesh,164689383,Asia,14654,228
BGD,2020-20,7611,100,Bangladesh,164689383,Asia,22265,328
BGD,2020-21,11342,152,Bangladesh,164689383,Asia,33607,480
BGD,2020-22,13543,170,Bangladesh,164689383,Asia,47150,650
BGD,2020-23,18616,238,Bangladesh,164689383,Asia,65766,888
BGD,2020-24,21751,283,Bangladesh,164689383,Asia,87517,1171
BGD,2020-25,24786,293,Bangladesh,164689383,Asia,112303,1464
BGD,2020-26,25481,274,Bangladesh,164689383,Asia,137784,1738
BGD,2020-27,24630,314,Bangladesh,164689383,Asia,162414,2052
BGD,2020-28,21378,300,Bangladesh,164689383,Asia,183792,2352
BGD,2020-29,20730,266,Bangladesh,164689383,Asia,204522,2618
BGD,2020-30,18928,310,Bangladesh,164689383,Asia,223450,2928
BGD,2020-31,17293,226,Bangladesh,164689383,Asia,240743,3154
BGD,2020-32,16854,245,Bangladesh,164689383,Asia,257597,3399
BGD,2020-33,18949,258,Bangladesh,164689383,Asia,276546,3657
BGD,2020-34,18049,284,Bangladesh,164689383,Asia,294595,3941
BGD,2020-35,16224,307,Bangladesh,164689383,Asia,310819,4248
BGD,2020-36,14335,201,Bangladesh,164689383,Asia,325154,4449
BGD,2020-37,12363,284,Bangladesh,164689383,Asia,337517,4733
BGD,2020-38,11396,206,Bangladesh,164689383,Asia,348913,4939
BGD,2020-39,10232,222,Bangladesh,164689383,Asia,359145,5161
BGD,2020-40,9542,187,Bangladesh,164689383,Asia,368687,5348
BGD,2020-41,9576,176,Bangladesh,164689383,Asia,378263,5524
BGD,2020-42,10303,136,Bangladesh,164689383,Asia,388566,5660
BGD,2020-43,10246,143,Bangladesh,164689383,Asia,398812,5803
BGD,2020-44,10437,138,Bangladesh,164689383,Asia,409249,5941
BGD,2020-45,10986,126,Bangladesh,164689383,Asia,420235,6067
BGD,2020-46,12095,127,Bangladesh,164689383,Asia,432330,6194
BGD,2020-47,15008,194,Bangladesh,164689383,Asia,447338,6388
BGD,2020-48,15066,221,Bangladesh,164689383,Asia,462404,6609
BGD,2020-49,15138,229,Bangladesh,164689383,Asia,477542,6838
BGD,2020-50,12988,214,Bangladesh,164689383,Asia,490530,7052
BGD,2020-51,10180,228,Bangladesh,164689383,Asia,500710,7280
BGD,2020-52,8435,172,Bangladesh,164689383,Asia,509145,7452
BGD,2020-53,6871,174,Bangladesh,164689383,Asia,516016,7626
BGD,2021-01,6434,155,Bangladesh,164689383,Asia,522450,7781
BGD,2021-02,5179,125,Bangladesh,164689383,Asia,527629,7906
BGD,2021-03,4167,117,Bangladesh,164689383,Asia,531796,8023
BGD,2021-04,3340,104,Bangladesh,164689383,Asia,535136,8127
BGD,2021-05,2923,78,Bangladesh,164689383,Asia,538059,8205
BGD,2021-06,2566,80,Bangladesh,164689383,Asia,540625,8285
BGD,2021-07,2723,71,Bangladesh,164689383,Asia,543348,8356
BGD,2021-08,2865,52,Bangladesh,164689383,Asia,546213,8408
BGD,2021-09,4114,54,Bangladesh,164689383,Asia,550327,8462
BGD,2021-10,7065,83,Bangladesh,164689383,Asia,557392,8545
BGD,2021-11,12873,155,Bangladesh,164689383,Asia,570265,8700
BGD,2021-12,25446,207,Bangladesh,164689383,Asia,595711,8907
BGD,2021-13,41650,359,Bangladesh,164689383,Asia,637361,9266
BGD,2021-14,47392,473,Bangladesh,164689383,Asia,684753,9739
BGD,2021-15,34194,646,Bangladesh,164689383,Asia,718947,10385
BGD,2021-16,26372,668,Bangladesh,164689383,Asia,745319,11053
BGD,2021-17,16621,526,Bangladesh,164689383,Asia,761940,11579
BGD,2021-18,11570,355,Bangladesh,164689383,Asia,773510,11934
BGD,2021-19,6646,215,Bangladesh,164689383,Asia,780156,12149
BGD,2021-20,8921,227,Bangladesh,164689383,Asia,789077,12376
BGD,2021-21,9750,207,Bangladesh,164689383,Asia,798827,12583
BGD,2021-22,12160,256,Bangladesh,164689383,Asia,810987,12839
BGD,2021-23,15932,279,Bangladesh,164689383,Asia,826919,13118
BGD,2021-24,24746,430,Bangladesh,164689383,Asia,851665,13548
BGD,2021-25,36738,624,Bangladesh,164689383,Asia,888403,14172
BGD,2021-26,56511,893,Bangladesh,164689383,Asia,944914,15065
BGD,2021-27,77272,1354,Bangladesh,164689383,Asia,1022186,16419
BGD,2021-28,82800,1475,Bangladesh,164689383,Asia,1104986,17894
BGD,2021-29,46655,1152,Bangladesh,164689383,Asia,1151641,19046
BGD,2021-30,112684,1870,Bangladesh,164689383,Asia,1264325,20916
BGD,2021-31,89367,1736,Bangladesh,164689383,Asia,1353692,22652
BGD,2021-32,65207,1523,Bangladesh,164689383,Asia,1418899,24175
BGR,2020-11,47,2,Bulgaria,6951482,Europe,47,2
BGR,2020-12,134,1,Bulgaria,6951482,Europe,181,3
BGR,2020-13,161,5,Bulgaria,6951482,Europe,342,8
BGR,2020-14,185,12,Bulgaria,6951482,Europe,527,20
BGR,2020-15,144,9,Bulgaria,6951482,Europe,671,29
BGR,2020-16,240,14,Bulgaria,6951482,Europe,911,43
BGR,2020-17,385,13,Bulgaria,6951482,Europe,1296,56
BGR,2020-18,318,17,Bulgaria,6951482,Europe,1614,73
BGR,2020-19,347,18,Bulgaria,6951482,Europe,1961,91
BGR,2020-20,270,19,Bulgaria,6951482,Europe,2231,110
BGR,2020-21,198,20,Bulgaria,6951482,Europe,2429,130
BGR,2020-22,80,10,Bulgaria,6951482,Europe,2509,140
BGR,2020-23,214,20,Bulgaria,6951482,Europe,2723,160
BGR,2020-24,563,14,Bulgaria,6951482,Europe,3286,174
BGR,2020-25,615,25,Bulgaria,6951482,Europe,3901,199
BGR,2020-26,786,20,Bulgaria,6951482,Europe,4687,219
BGR,2020-27,1049,27,Bulgaria,6951482,Europe,5736,246
BGR,2020-28,1512,22,Bulgaria,6951482,Europe,7248,268
BGR,2020-29,1481,32,Bulgaria,6951482,Europe,8729,300
BGR,2020-30,1694,40,Bulgaria,6951482,Europe,10423,340
BGR,2020-31,1528,48,Bulgaria,6951482,Europe,11951,388
BGR,2020-32,1441,59,Bulgaria,6951482,Europe,13392,447
BGR,2020-33,969,51,Bulgaria,6951482,Europe,14361,498
BGR,2020-34,922,47,Bulgaria,6951482,Europe,15283,545
BGR,2020-35,903,68,Bulgaria,6951482,Europe,16186,613
BGR,2020-36,860,58,Bulgaria,6951482,Europe,17046,671
BGR,2020-37,868,49,Bulgaria,6951482,Europe,17914,720
BGR,2020-38,945,41,Bulgaria,6951482,Europe,18859,761
BGR,2020-39,1192,35,Bulgaria,6951482,Europe,20051,796
BGR,2020-40,1532,48,Bulgaria,6951482,Europe,21583,844
BGR,2020-41,2815,48,Bulgaria,6951482,Europe,24398,892
BGR,2020-42,5101,94,Bulgaria,6951482,Europe,29499,986
BGR,2020-43,8386,108,Bulgaria,6951482,Europe,37885,1094
BGR,2020-44,16180,204,Bulgaria,6951482,Europe,54065,1298
BGR,2020-45,21091,367,Bulgaria,6951482,Europe,75156,1665
BGR,2020-46,23091,465,Bulgaria,6951482,Europe,98247,2130
BGR,2020-47,23569,750,Bulgaria,6951482,Europe,121816,2880
BGR,2020-48,20666,934,Bulgaria,6951482,Europe,142482,3814
BGR,2020-49,18935,983,Bulgaria,6951482,Europe,161417,4797
BGR,2020-50,18028,891,Bulgaria,6951482,Europe,179445,5688
BGR,2020-51,11746,921,Bulgaria,6951482,Europe,191191,6609
BGR,2020-52,6521,555,Bulgaria,6951482,Europe,197712,7164
BGR,2020-53,5335,514,Bulgaria,6951482,Europe,203047,7678
BGR,2021-01,5460,448,Bulgaria,6951482,Europe,208507,8126
BGR,2021-02,3302,357,Bulgaria,6951482,Europe,211809,8483
BGR,2021-03,3004,337,Bulgaria,6951482,Europe,214813,8820
BGR,2021-04,3931,225,Bulgaria,6951482,Europe,218744,9045
BGR,2021-05,4986,286,Bulgaria,6951482,Europe,223730,9331
BGR,2021-06,5945,293,Bulgaria,6951482,Europe,229675,9624
BGR,2021-07,6987,230,Bulgaria,6951482,Europe,236662,9854
BGR,2021-08,10372,337,Bulgaria,6951482,Europe,247034,10191
BGR,2021-09,13270,423,Bulgaria,6951482,Europe,260304,10614
BGR,2021-10,18249,671,Bulgaria,6951482,Europe,278553,11285
BGR,2021-11,24866,734,Bulgaria,6951482,Europe,303419,12019
BGR,2021-12,25330,691,Bulgaria,6951482,Europe,328749,12710
BGR,2021-13,24246,879,Bulgaria,6951482,Europe,352995,13589
BGR,2021-14,18994,829,Bulgaria,6951482,Europe,371989,14418
BGR,2021-15,14388,777,Bulgaria,6951482,Europe,386377,15195
BGR,2021-16,11119,712,Bulgaria,6951482,Europe,397496,15907
BGR,2021-17,7694,585,Bulgaria,6951482,Europe,405190,16492
BGR,2021-18,5008,437,Bulgaria,6951482,Europe,410198,16929
BGR,2021-19,3990,330,Bulgaria,6951482,Europe,414188,17259
BGR,2021-20,2454,237,Bulgaria,6951482,Europe,416642,17496
BGR,2021-21,1628,166,Bulgaria,6951482,Europe,418270,17662
BGR,2021-22,1199,158,Bulgaria,6951482,Europe,419469,17820
BGR,2021-23,863,80,Bulgaria,6951482,Europe,420332,17900
BGR,2021-24,696,90,Bulgaria,6951482,Europe,421028,17990
BGR,2021-25,499,37,Bulgaria,6951482,Europe,421527,18027
BGR,2021-26,522,57,Bulgaria,6951482,Europe,422049,18084
BGR,2021-27,409,56,Bulgaria,6951482,Europe,422458,18140
BGR,2021-28,503,34,Bulgaria,6951482,Europe,422961,18174
BGR,2021-29,721,20,Bulgaria,6951482,Europe,423682,18194
BGR,2021-30,1462,21,Bulgaria,6951482,Europe,425144,18215
BGR,2021-31,2901,40,Bulgaria,6951482,Europe,428045,18255
BGR,2021-32,5185,89,Bulgaria,6951482,Europe,433230,18344
BHR,2020-02,0,0,Bahrain,1701583,Asia,0,0
BHR,2020-03,0,0,Bahrain,1701583,Asia,0,0
BHR,2020-04,0,0,Bahrain,1701583,Asia,0,0
BHR,2020-05,0,0,Bahrain,1701583,Asia,0,0
BHR,2020-06,0,0,Bahrain,1701583,Asia,0,0
BHR,2020-07,0,0,Bahrain,1701583,Asia,0,0
BHR,2020-08,1,0,Bahrain,1701583,Asia,1,0
BHR,2020-09,46,0,Bahrain,1701583,Asia,47,0
BHR,2020-10,32,0,Bahrain,1701583,Asia,79,0
BHR,2020-11,135,0,Bahrain,1701583,Asia,214,0
BHR,2020-12,120,2,Bahrain,1701583,Asia,334,2
BHR,2020-13,166,2,Bahrain,1701583,Asia,500,4
BHR,2020-14,200,0,Bahrain,1701583,Asia,700,4
BHR,2020-15,436,2,Bahrain,1701583,Asia,1136,6
BHR,2020-16,737,1,Bahrain,1701583,Asia,1873,7
BHR,2020-17,774,1,Bahrain,1701583,Asia,2647,8
BHR,2020-18,736,0,Bahrain,1701583,Asia,3383,8
BHR,2020-19,1558,0,Bahrain,1701583,Asia,4941,8
BHR,2020-20,2015,4,Bahrain,1701583,Asia,6956,12
BHR,2020-21,2182,2,Bahrain,1701583,Asia,9138,14
BHR,2020-22,2260,5,Bahrain,1701583,Asia,11398,19
BHR,2020-23,3365,7,Bahrain,1701583,Asia,14763,26
BHR,2020-24,3781,17,Bahrain,1701583,Asia,18544,43
BHR,2020-25,3220,20,Bahrain,1701583,Asia,21764,63
BHR,2020-26,3941,20,Bahrain,1701583,Asia,25705,83
BHR,2020-27,3662,14,Bahrain,1701583,Asia,29367,97
BHR,2020-28,3574,12,Bahrain,1701583,Asia,32941,109
BHR,2020-29,3481,17,Bahrain,1701583,Asia,36422,126
BHR,2020-30,2709,14,Bahrain,1701583,Asia,39131,140
BHR,2020-31,2405,7,Bahrain,1701583,Asia,41536,147
BHR,2020-32,2475,15,Bahrain,1701583,Asia,44011,162
BHR,2020-33,2419,8,Bahrain,1701583,Asia,46430,170
BHR,2020-34,2608,14,Bahrain,1701583,Asia,49038,184
BHR,2020-35,2536,5,Bahrain,1701583,Asia,51574,189
BHR,2020-36,3197,9,Bahrain,1701583,Asia,54771,198
BHR,2020-37,4815,14,Bahrain,1701583,Asia,59586,212
BHR,2020-38,4913,9,Bahrain,1701583,Asia,64499,221
BHR,2020-39,4276,21,Bahrain,1701583,Asia,68775,242
BHR,2020-40,3887,18,Bahrain,1701583,Asia,72662,260
BHR,2020-41,2625,13,Bahrain,1701583,Asia,75287,273
BHR,2020-42,2615,27,Bahrain,1701583,Asia,77902,300
BHR,2020-43,2353,12,Bahrain,1701583,Asia,80255,312
BHR,2020-44,1668,9,Bahrain,1701583,Asia,81923,321
BHR,2020-45,1533,8,Bahrain,1701583,Asia,83456,329
BHR,2020-46,1247,6,Bahrain,1701583,Asia,84703,335
BHR,2020-47,1002,3,Bahrain,1701583,Asia,85705,338
BHR,2020-48,1082,3,Bahrain,1701583,Asia,86787,341
BHR,2020-49,1143,0,Bahrain,1701583,Asia,87930,341
BHR,2020-50,1213,7,Bahrain,1701583,Asia,89143,348
BHR,2020-51,1139,1,Bahrain,1701583,Asia,90282,349
BHR,2020-52,1451,2,Bahrain,1701583,Asia,91733,351
BHR,2020-53,1745,1,Bahrain,1701583,Asia,93478,352
BHR,2021-01,2080,4,Bahrain,1701583,Asia,95558,356
BHR,2021-02,2049,4,Bahrain,1701583,Asia,97607,360
BHR,2021-03,1849,7,Bahrain,1701583,Asia,99456,367
BHR,2021-04,3601,8,Bahrain,1701583,Asia,103057,375
BHR,2021-05,3891,6,Bahrain,1701583,Asia,106948,381
BHR,2021-06,5794,22,Bahrain,1701583,Asia,112742,403
BHR,2021-07,5067,23,Bahrain,1701583,Asia,117809,426
BHR,2021-08,4585,23,Bahrain,1701583,Asia,122394,449
BHR,2021-09,4208,23,Bahrain,1701583,Asia,126602,472
BHR,2021-10,4399,12,Bahrain,1701583,Asia,131001,484
BHR,2021-11,4981,16,Bahrain,1701583,Asia,135982,500
BHR,2021-12,5350,13,Bahrain,1701583,Asia,141332,513
BHR,2021-13,7485,23,Bahrain,1701583,Asia,148817,536
BHR,2021-14,7645,21,Bahrain,1701583,Asia,156462,557
BHR,2021-15,7648,37,Bahrain,1701583,Asia,164110,594
BHR,2021-16,7260,31,Bahrain,1701583,Asia,171370,625
BHR,2021-17,7927,27,Bahrain,1701583,Asia,179297,652
BHR,2021-18,10059,33,Bahrain,1701583,Asia,189356,685
BHR,2021-19,11621,61,Bahrain,1701583,Asia,200977,746
BHR,2021-20,17070,74,Bahrain,1701583,Asia,218047,820
BHR,2021-21,20109,143,Bahrain,1701583,Asia,238156,963
BHR,2021-22,12922,156,Bahrain,1701583,Asia,251078,1119
BHR,2021-23,7653,102,Bahrain,1701583,Asia,258731,1221
BHR,2021-24,4161,85,Bahrain,1701583,Asia,262892,1306
BHR,2021-25,2355,39,Bahrain,1701583,Asia,265247,1345
BHR,2021-26,1179,15,Bahrain,1701583,Asia,266426,1360
BHR,2021-27,786,17,Bahrain,1701583,Asia,267212,1377
BHR,2021-28,670,3,Bahrain,1701583,Asia,267882,1380
BHR,2021-29,659,3,Bahrain,1701583,Asia,268541,1383
BHR,2021-30,762,1,Bahrain,1701583,Asia,269303,1384
BHR,2021-31,757,0,Bahrain,1701583,Asia,270060,1384
BHR,2021-32,859,0,Bahrain,1701583,Asia,270919,1384
BHS,2020-12,3,0,Bahamas,393248,America,3,0
BHS,2020-13,10,0,Bahamas,393248,America,13,0
BHS,2020-14,15,5,Bahamas,393248,America,28,5
BHS,2020-15,18,3,Bahamas,393248,America,46,8
BHS,2020-16,13,1,Bahamas,393248,America,59,9
BHS,2020-17,20,2,Bahamas,393248,America,79,11
BHS,2020-18,3,0,Bahamas,393248,America,82,11
BHS,2020-19,9,0,Bahamas,393248,America,91,11
BHS,2020-20,4,0,Bahamas,393248,America,95,11
BHS,2020-21,4,0,Bahamas,393248,America,99,11
BHS,2020-22,2,0,Bahamas,393248,America,101,11
BHS,2020-23,1,0,Bahamas,393248,America,102,11
BHS,2020-24,0,0,Bahamas,393248,America,102,11
BHS,2020-25,1,0,Bahamas,393248,America,103,11
BHS,2020-26,0,0,Bahamas,393248,America,103,11
BHS,2020-27,0,0,Bahamas,393248,America,103,11
BHS,2020-28,7,0,Bahamas,393248,America,110,11
BHS,2020-29,42,0,Bahamas,393248,America,152,11
BHS,2020-30,189,0,Bahamas,393248,America,341,11
BHS,2020-31,306,3,Bahamas,393248,America,647,14
BHS,2020-32,250,1,Bahamas,393248,America,897,15
BHS,2020-33,417,3,Bahamas,393248,America,1314,18
BHS,2020-34,450,11,Bahamas,393248,America,1764,29
BHS,2020-35,402,14,Bahamas,393248,America,2166,43
BHS,2020-36,379,15,Bahamas,393248,America,2545,58
BHS,2020-37,382,9,Bahamas,393248,America,2927,67
BHS,2020-38,442,7,Bahamas,393248,America,3369,74
BHS,2020-39,420,13,Bahamas,393248,America,3789,87
BHS,2020-40,619,9,Bahamas,393248,America,4408,96
BHS,2020-41,669,11,Bahamas,393248,America,5077,107
BHS,2020-42,625,15,Bahamas,393248,America,5702,122
BHS,2020-43,707,10,Bahamas,393248,America,6409,132
BHS,2020-44,304,12,Bahamas,393248,America,6713,144
BHS,2020-45,233,8,Bahamas,393248,America,6946,152
BHS,2020-46,239,4,Bahamas,393248,America,7185,156
BHS,2020-47,227,7,Bahamas,393248,America,7412,163
BHS,2020-48,83,0,Bahamas,393248,America,7495,163
BHS,2020-49,83,0,Bahamas,393248,America,7578,163
BHS,2020-50,95,0,Bahamas,393248,America,7673,163
BHS,2020-51,91,1,Bahamas,393248,America,7764,164
BHS,2020-52,69,6,Bahamas,393248,America,7833,170
BHS,2020-53,90,5,Bahamas,393248,America,7923,175
BHS,2021-01,80,0,Bahamas,393248,America,8003,175
BHS,2021-02,63,0,Bahamas,393248,America,8066,175
BHS,2021-03,66,0,Bahamas,393248,America,8132,175
BHS,2021-04,41,1,Bahamas,393248,America,8173,176
BHS,2021-05,115,0,Bahamas,393248,America,8288,176
BHS,2021-06,87,3,Bahamas,393248,America,8375,179
BHS,2021-07,95,0,Bahamas,393248,America,8470,179
BHS,2021-08,48,0,Bahamas,393248,America,8518,179
BHS,2021-09,81,2,Bahamas,393248,America,8599,181
BHS,2021-10,165,5,Bahamas,393248,America,8764,186
BHS,2021-11,0,0,Bahamas,393248,America,8764,186
BHS,2021-12,311,2,Bahamas,393248,America,9075,188
BHS,2021-13,187,1,Bahamas,393248,America,9262,189
BHS,2021-14,176,0,Bahamas,393248,America,9438,189
BHS,2021-15,352,5,Bahamas,393248,America,9790,194
BHS,2021-16,259,2,Bahamas,393248,America,10049,196
BHS,2021-17,499,13,Bahamas,393248,America,10548,209
BHS,2021-18,359,5,Bahamas,393248,America,10907,214
BHS,2021-19,165,3,Bahamas,393248,America,11072,217
BHS,2021-20,479,9,Bahamas,393248,America,11551,226
BHS,2021-21,244,4,Bahamas,393248,America,11795,230
BHS,2021-22,134,2,Bahamas,393248,America,11929,232
BHS,2021-23,269,5,Bahamas,393248,America,12198,237
BHS,2021-24,165,6,Bahamas,393248,America,12363,243
BHS,2021-25,179,2,Bahamas,393248,America,12542,245
BHS,2021-26,192,1,Bahamas,393248,America,12734,246
BHS,2021-27,289,6,Bahamas,393248,America,13023,252
BHS,2021-28,380,21,Bahamas,393248,America,13403,273
BHS,2021-29,848,11,Bahamas,393248,America,14251,284
BHS,2021-30,759,7,Bahamas,393248,America,15010,291
BHS,2021-31,783,16,Bahamas,393248,America,15793,307
BHS,2021-32,347,4,Bahamas,393248,America,16140,311
BIH,2020-12,113,1,Bosnia And Herzegovina,3280815,Europe,113,1
BIH,2020-13,221,8,Bosnia And Herzegovina,3280815,Europe,334,9
BIH,2020-14,296,12,Bosnia And Herzegovina,3280815,Europe,630,21
BIH,2020-15,352,17,Bosnia And Herzegovina,3280815,Europe,982,38
BIH,2020-16,285,10,Bosnia And Herzegovina,3280815,Europe,1267,48
BIH,2020-17,231,11,Bosnia And Herzegovina,3280815,Europe,1498,59
BIH,2020-18,341,18,Bosnia And Herzegovina,3280815,Europe,1839,77
BIH,2020-19,260,30,Bosnia And Herzegovina,3280815,Europe,2099,107
BIH,2020-20,173,26,Bosnia And Herzegovina,3280815,Europe,2272,133
BIH,2020-21,111,11,Bosnia And Herzegovina,3280815,Europe,2383,144
BIH,2020-22,109,9,Bosnia And Herzegovina,3280815,Europe,2492,153
BIH,2020-23,164,7,Bosnia And Herzegovina,3280815,Europe,2656,160
BIH,2020-24,328,4,Bosnia And Herzegovina,3280815,Europe,2984,164
BIH,2020-25,430,6,Bosnia And Herzegovina,3280815,Europe,3414,170
BIH,2020-26,774,13,Bosnia And Herzegovina,3280815,Europe,4188,183
BIH,2020-27,1188,13,Bosnia And Herzegovina,3280815,Europe,5376,196
BIH,2020-28,1490,26,Bosnia And Herzegovina,3280815,Europe,6866,222
BIH,2020-29,1568,31,Bosnia And Herzegovina,3280815,Europe,8434,253
BIH,2020-30,1863,34,Bosnia And Herzegovina,3280815,Europe,10297,287
BIH,2020-31,1857,64,Bosnia And Herzegovina,3280815,Europe,12154,351
BIH,2020-32,2153,57,Bosnia And Herzegovina,3280815,Europe,14307,408
BIH,2020-33,1684,72,Bosnia And Herzegovina,3280815,Europe,15991,480
BIH,2020-34,1893,56,Bosnia And Herzegovina,3280815,Europe,17884,536
BIH,2020-35,1891,62,Bosnia And Herzegovina,3280815,Europe,19775,598
BIH,2020-36,1767,57,Bosnia And Herzegovina,3280815,Europe,21542,655
BIH,2020-37,1907,41,Bosnia And Herzegovina,3280815,Europe,23449,696
BIH,2020-38,1962,68,Bosnia And Herzegovina,3280815,Europe,25411,764
BIH,2020-39,1492,53,Bosnia And Herzegovina,3280815,Europe,26903,817
BIH,2020-40,1384,62,Bosnia And Herzegovina,3280815,Europe,28287,879
BIH,2020-41,2342,49,Bosnia And Herzegovina,3280815,Europe,30629,928
BIH,2020-42,3469,58,Bosnia And Herzegovina,3280815,Europe,34098,986
BIH,2020-43,6777,100,Bosnia And Herzegovina,3280815,Europe,40875,1086
BIH,2020-44,10612,162,Bosnia And Herzegovina,3280815,Europe,51487,1248
BIH,2020-45,10918,262,Bosnia And Herzegovina,3280815,Europe,62405,1510
BIH,2020-46,9533,388,Bosnia And Herzegovina,3280815,Europe,71938,1898
BIH,2020-47,8050,378,Bosnia And Herzegovina,3280815,Europe,79988,2276
BIH,2020-48,7268,344,Bosnia And Herzegovina,3280815,Europe,87256,2620
BIH,2020-49,7233,332,Bosnia And Herzegovina,3280815,Europe,94489,2952
BIH,2020-50,6610,384,Bosnia And Herzegovina,3280815,Europe,101099,3336
BIH,2020-51,4889,317,Bosnia And Herzegovina,3280815,Europe,105988,3653
BIH,2020-52,3685,300,Bosnia And Herzegovina,3280815,Europe,109673,3953
BIH,2020-53,2954,178,Bosnia And Herzegovina,3280815,Europe,112627,4131
BIH,2021-01,2988,199,Bosnia And Herzegovina,3280815,Europe,115615,4330
BIH,2021-02,2340,142,Bosnia And Herzegovina,3280815,Europe,117955,4472
BIH,2021-03,2070,102,Bosnia And Herzegovina,3280815,Europe,120025,4574
BIH,2021-04,2043,131,Bosnia And Herzegovina,3280815,Europe,122068,4705
BIH,2021-05,1858,95,Bosnia And Herzegovina,3280815,Europe,123926,4800
BIH,2021-06,2079,96,Bosnia And Herzegovina,3280815,Europe,126005,4896
BIH,2021-07,2295,111,Bosnia And Herzegovina,3280815,Europe,128300,5007
BIH,2021-08,3820,89,Bosnia And Herzegovina,3280815,Europe,132120,5096
BIH,2021-09,4760,163,Bosnia And Herzegovina,3280815,Europe,136880,5259
BIH,2021-10,7351,262,Bosnia And Herzegovina,3280815,Europe,144231,5521
BIH,2021-11,9560,344,Bosnia And Herzegovina,3280815,Europe,153791,5865
BIH,2021-12,11122,463,Bosnia And Herzegovina,3280815,Europe,164913,6328
BIH,2021-13,10846,541,Bosnia And Herzegovina,3280815,Europe,175759,6869
BIH,2021-14,8477,518,Bosnia And Herzegovina,3280815,Europe,184236,7387
BIH,2021-15,6513,465,Bosnia And Herzegovina,3280815,Europe,190749,7852
BIH,2021-16,5024,411,Bosnia And Herzegovina,3280815,Europe,195773,8263
BIH,2021-17,3148,313,Bosnia And Herzegovina,3280815,Europe,198921,8576
BIH,2021-18,2177,240,Bosnia And Herzegovina,3280815,Europe,201098,8816
BIH,2021-19,1303,192,Bosnia And Herzegovina,3280815,Europe,202401,9008
BIH,2021-20,917,105,Bosnia And Herzegovina,3280815,Europe,203318,9113
BIH,2021-21,642,102,Bosnia And Herzegovina,3280815,Europe,203960,9215
BIH,2021-22,408,166,Bosnia And Herzegovina,3280815,Europe,204368,9381
BIH,2021-23,276,92,Bosnia And Herzegovina,3280815,Europe,204644,9473
BIH,2021-24,189,146,Bosnia And Herzegovina,3280815,Europe,204833,9619
BIH,2021-25,133,21,Bosnia And Herzegovina,3280815,Europe,204966,9640
BIH,2021-26,80,10,Bosnia And Herzegovina,3280815,Europe,205046,9650
BIH,2021-27,106,6,Bosnia And Herzegovina,3280815,Europe,205152,9656
BIH,2021-28,108,12,Bosnia And Herzegovina,3280815,Europe,205260,9668
BIH,2021-29,204,7,Bosnia And Herzegovina,3280815,Europe,205464,9675
BIH,2021-30,303,14,Bosnia And Herzegovina,3280815,Europe,205767,9689
BIH,2021-31,532,5,Bosnia And Herzegovina,3280815,Europe,206299,9694
BIH,2021-32,1254,17,Bosnia And Herzegovina,3280815,Europe,207553,9711
BLR,2020-02,0,0,Belarus,9449321,Europe,0,0
BLR,2020-03,0,0,Belarus,9449321,Europe,0,0
BLR,2020-04,0,0,Belarus,9449321,Europe,0,0
BLR,2020-05,0,0,Belarus,9449321,Europe,0,0
BLR,2020-06,0,0,Belarus,9449321,Europe,0,0
BLR,2020-07,0,0,Belarus,9449321,Europe,0,0
BLR,2020-08,0,0,Belarus,9449321,Europe,0,0
BLR,2020-09,1,0,Belarus,9449321,Europe,1,0
BLR,2020-10,5,0,Belarus,9449321,Europe,6,0
BLR,2020-11,21,0,Belarus,9449321,Europe,27,0
BLR,2020-12,49,0,Belarus,9449321,Europe,76,0
BLR,2020-13,18,0,Belarus,9449321,Europe,94,0
BLR,2020-14,470,8,Belarus,9449321,Europe,564,8
BLR,2020-15,2014,18,Belarus,9449321,Europe,2578,26
BLR,2020-16,3229,21,Belarus,9449321,Europe,5807,47
BLR,2020-17,4656,25,Belarus,9449321,Europe,10463,72
BLR,2020-18,6242,27,Belarus,9449321,Europe,16705,99
BLR,2020-19,6268,32,Belarus,9449321,Europe,22973,131
BLR,2020-20,6677,34,Belarus,9449321,Europe,29650,165
BLR,2020-21,6548,34,Belarus,9449321,Europe,36198,199
BLR,2020-22,6358,36,Belarus,9449321,Europe,42556,235
BLR,2020-23,6074,34,Belarus,9449321,Europe,48630,269
BLR,2020-24,5343,39,Belarus,9449321,Europe,53973,308
BLR,2020-25,4532,38,Belarus,9449321,Europe,58505,346
BLR,2020-26,2970,37,Belarus,9449321,Europe,61475,383
BLR,2020-27,2079,40,Belarus,9449321,Europe,63554,423
BLR,2020-28,1378,41,Belarus,9449321,Europe,64932,464
BLR,2020-29,1163,35,Belarus,9449321,Europe,66095,499
BLR,2020-30,1037,35,Belarus,9449321,Europe,67132,534
BLR,2020-31,935,33,Belarus,9449321,Europe,68067,567
BLR,2020-32,783,20,Belarus,9449321,Europe,68850,587
BLR,2020-33,666,23,Belarus,9449321,Europe,69516,610
BLR,2020-34,952,32,Belarus,9449321,Europe,70468,642
BLR,2020-35,1219,34,Belarus,9449321,Europe,71687,676
BLR,2020-36,1172,35,Belarus,9449321,Europe,72859,711
BLR,2020-37,1314,39,Belarus,9449321,Europe,74173,750
BLR,2020-38,1501,30,Belarus,9449321,Europe,75674,780
BLR,2020-39,1935,38,Belarus,9449321,Europe,77609,818
BLR,2020-40,2686,39,Belarus,9449321,Europe,80295,857
BLR,2020-41,3239,39,Belarus,9449321,Europe,83534,896
BLR,2020-42,4164,33,Belarus,9449321,Europe,87698,929
BLR,2020-43,5125,28,Belarus,9449321,Europe,92823,957
BLR,2020-44,6636,28,Belarus,9449321,Europe,99459,985
BLR,2020-45,6820,22,Belarus,9449321,Europe,106279,1007
BLR,2020-46,7906,39,Belarus,9449321,Europe,114185,1046
BLR,2020-47,9814,50,Belarus,9449321,Europe,123999,1096
BLR,2020-48,11009,55,Belarus,9449321,Europe,135008,1151
BLR,2020-49,12149,56,Belarus,9449321,Europe,147157,1207
BLR,2020-50,13138,56,Belarus,9449321,Europe,160295,1263
BLR,2020-51,13228,61,Belarus,9449321,Europe,173523,1324
BLR,2020-52,15065,70,Belarus,9449321,Europe,188588,1394
BLR,2020-53,11374,57,Belarus,9449321,Europe,199962,1451
BLR,2021-01,14031,75,Belarus,9449321,Europe,213993,1526
BLR,2021-02,13367,65,Belarus,9449321,Europe,227360,1591
BLR,2021-03,10251,58,Belarus,9449321,Europe,237611,1649
BLR,2021-04,10725,69,Belarus,9449321,Europe,248336,1718
BLR,2021-05,10163,65,Belarus,9449321,Europe,258499,1783
BLR,2021-06,10188,66,Belarus,9449321,Europe,268687,1849
BLR,2021-07,10769,72,Belarus,9449321,Europe,279456,1921
BLR,2021-08,8811,64,Belarus,9449321,Europe,288267,1985
BLR,2021-09,8174,62,Belarus,9449321,Europe,296441,2047
BLR,2021-10,5882,48,Belarus,9449321,Europe,302323,2095
BLR,2021-11,8122,62,Belarus,9449321,Europe,310445,2157
BLR,2021-12,8236,62,Belarus,9449321,Europe,318681,2219
BLR,2021-13,8623,66,Belarus,9449321,Europe,327304,2285
BLR,2021-14,9577,78,Belarus,9449321,Europe,336881,2363
BLR,2021-15,7342,60,Belarus,9449321,Europe,344223,2423
BLR,2021-16,9623,79,Belarus,9449321,Europe,353846,2502
BLR,2021-17,8051,70,Belarus,9449321,Europe,361897,2572
BLR,2021-18,6991,60,Belarus,9449321,Europe,368888,2632
BLR,2021-19,8644,79,Belarus,9449321,Europe,377532,2711
BLR,2021-20,8493,60,Belarus,9449321,Europe,386025,2771
BLR,2021-21,8414,80,Belarus,9449321,Europe,394439,2851
BLR,2021-22,5983,68,Belarus,9449321,Europe,400422,2919
BLR,2021-23,5241,59,Belarus,9449321,Europe,405663,2978
BLR,2021-24,5490,75,Belarus,9449321,Europe,411153,3053
BLR,2021-25,4627,69,Belarus,9449321,Europe,415780,3122
BLR,2021-26,5570,63,Belarus,9449321,Europe,421350,3185
BLR,2021-27,7245,81,Belarus,9449321,Europe,428595,3266
BLR,2021-28,6425,68,Belarus,9449321,Europe,435020,3334
BLR,2021-29,6336,69,Belarus,9449321,Europe,441356,3403
BLR,2021-30,6398,69,Belarus,9449321,Europe,447754,3472
BLR,2021-31,6920,69,Belarus,9449321,Europe,454674,3541
BLR,2021-32,7523,72,Belarus,9449321,Europe,462197,3613
BLZ,2020-14,3,1,Belize,397621,America,3,1
BLZ,2020-15,9,1,Belize,397621,America,12,2
BLZ,2020-16,4,0,Belize,397621,America,16,2
BLZ,2020-17,0,0,Belize,397621,America,16,2
BLZ,2020-18,0,0,Belize,397621,America,16,2
BLZ,2020-19,0,0,Belize,397621,America,16,2
BLZ,2020-20,0,0,Belize,397621,America,16,2
BLZ,2020-21,0,0,Belize,397621,America,16,2
BLZ,2020-22,0,0,Belize,397621,America,16,2
BLZ,2020-23,0,0,Belize,397621,America,16,2
BLZ,2020-24,3,0,Belize,397621,America,19,2
BLZ,2020-25,1,0,Belize,397621,America,20,2
BLZ,2020-26,2,0,Belize,397621,America,22,2
BLZ,2020-27,6,0,Belize,397621,America,28,2
BLZ,2020-28,7,0,Belize,397621,America,35,2
BLZ,2020-29,3,0,Belize,397621,America,38,2
BLZ,2020-30,8,0,Belize,397621,America,46,2
BLZ,2020-31,9,0,Belize,397621,America,55,2
BLZ,2020-32,97,0,Belize,397621,America,152,2
BLZ,2020-33,298,1,Belize,397621,America,450,3
BLZ,2020-34,234,3,Belize,397621,America,684,6
BLZ,2020-35,308,7,Belize,397621,America,992,13
BLZ,2020-36,267,2,Belize,397621,America,1259,15
BLZ,2020-37,219,4,Belize,397621,America,1478,19
BLZ,2020-38,147,2,Belize,397621,America,1625,21
BLZ,2020-39,227,3,Belize,397621,America,1852,24
BLZ,2020-40,342,6,Belize,397621,America,2194,30
BLZ,2020-41,231,5,Belize,397621,America,2425,35
BLZ,2020-42,386,9,Belize,397621,America,2811,44
BLZ,2020-43,332,6,Belize,397621,America,3143,50
BLZ,2020-44,317,8,Belize,397621,America,3460,58
BLZ,2020-45,714,12,Belize,397621,America,4174,70
BLZ,2020-46,685,20,Belize,397621,America,4859,90
BLZ,2020-47,322,26,Belize,397621,America,5181,116
BLZ,2020-48,560,31,Belize,397621,America,5741,147
BLZ,2020-49,2026,26,Belize,397621,America,7767,173
BLZ,2020-50,1526,22,Belize,397621,America,9293,195
BLZ,2020-51,850,29,Belize,397621,America,10143,224
BLZ,2020-52,416,9,Belize,397621,America,10559,233
BLZ,2020-53,340,17,Belize,397621,America,10899,250
BLZ,2021-01,402,24,Belize,397621,America,11301,274
BLZ,2021-02,205,7,Belize,397621,America,11506,281
BLZ,2021-03,262,12,Belize,397621,America,11768,293
BLZ,2021-04,175,9,Belize,397621,America,11943,302
BLZ,2021-05,125,5,Belize,397621,America,12068,307
BLZ,2021-06,105,6,Belize,397621,America,12173,313
BLZ,2021-07,80,1,Belize,397621,America,12253,314
BLZ,2021-08,58,0,Belize,397621,America,12311,314
BLZ,2021-09,22,1,Belize,397621,America,12333,315
BLZ,2021-10,48,1,Belize,397621,America,12381,316
BLZ,2021-11,24,0,Belize,397621,America,12405,316
BLZ,2021-12,4,1,Belize,397621,America,12409,317
BLZ,2021-13,45,0,Belize,397621,America,12454,317
BLZ,2021-14,47,1,Belize,397621,America,12501,318
BLZ,2021-15,55,0,Belize,397621,America,12556,318
BLZ,2021-16,41,3,Belize,397621,America,12597,321
BLZ,2021-17,75,2,Belize,397621,America,12672,323
BLZ,2021-18,26,0,Belize,397621,America,12698,323
BLZ,2021-19,42,0,Belize,397621,America,12740,323
BLZ,2021-20,22,0,Belize,397621,America,12762,323
BLZ,2021-21,27,1,Belize,397621,America,12789,324
BLZ,2021-22,108,1,Belize,397621,America,12897,325
BLZ,2021-23,72,1,Belize,397621,America,12969,326
BLZ,2021-24,68,3,Belize,397621,America,13037,329
BLZ,2021-25,98,0,Belize,397621,America,13135,329
BLZ,2021-26,254,1,Belize,397621,America,13389,330
BLZ,2021-27,170,1,Belize,397621,America,13559,331
BLZ,2021-28,211,1,Belize,397621,America,13770,332
BLZ,2021-29,211,1,Belize,397621,America,13981,333
BLZ,2021-30,180,4,Belize,397621,America,14161,337
BLZ,2021-31,336,3,Belize,397621,America,14497,340
BLZ,2021-32,348,4,Belize,397621,America,14845,344
BMU,2020-13,16,0,Bermuda,62273,America,16,0
BMU,2020-14,15,0,Bermuda,62273,America,31,0
BMU,2020-15,20,4,Bermuda,62273,America,51,4
BMU,2020-16,29,1,Bermuda,62273,America,80,5
BMU,2020-17,23,0,Bermuda,62273,America,103,5
BMU,2020-18,6,2,Bermuda,62273,America,109,7
BMU,2020-19,3,0,Bermuda,62273,America,112,7
BMU,2020-20,5,2,Bermuda,62273,America,117,9
BMU,2020-21,10,0,Bermuda,62273,America,127,9
BMU,2020-22,7,0,Bermuda,62273,America,134,9
BMU,2020-23,1,0,Bermuda,62273,America,135,9
BMU,2020-24,3,0,Bermuda,62273,America,138,9
BMU,2020-25,2,0,Bermuda,62273,America,140,9
BMU,2020-26,0,0,Bermuda,62273,America,140,9
BMU,2020-27,0,0,Bermuda,62273,America,140,9
BMU,2020-28,4,0,Bermuda,62273,America,144,9
BMU,2020-29,3,0,Bermuda,62273,America,147,9
BMU,2020-30,1,0,Bermuda,62273,America,148,9
BMU,2020-31,2,0,Bermuda,62273,America,150,9
BMU,2020-32,2,0,Bermuda,62273,America,152,9
BMU,2020-33,4,0,Bermuda,62273,America,156,9
BMU,2020-34,5,0,Bermuda,62273,America,161,9
BMU,2020-35,2,0,Bermuda,62273,America,163,9
BMU,2020-36,6,0,Bermuda,62273,America,169,9
BMU,2020-37,2,0,Bermuda,62273,America,171,9
BMU,2020-38,3,0,Bermuda,62273,America,174,9
BMU,2020-39,1,0,Bermuda,62273,America,175,9
BMU,2020-40,0,0,Bermuda,62273,America,175,9
BMU,2020-41,3,0,Bermuda,62273,America,178,9
BMU,2020-42,1,0,Bermuda,62273,America,179,9
BMU,2020-43,6,0,Bermuda,62273,America,185,9
BMU,2020-44,8,0,Bermuda,62273,America,193,9
BMU,2020-45,10,0,Bermuda,62273,America,203,9
BMU,2020-46,13,0,Bermuda,62273,America,216,9
BMU,2020-47,5,0,Bermuda,62273,America,221,9
BMU,2020-48,24,0,Bermuda,62273,America,245,9
BMU,2020-49,37,0,Bermuda,62273,America,282,9
BMU,2020-50,143,0,Bermuda,62273,America,425,9
BMU,2020-51,96,0,Bermuda,62273,America,521,9
BMU,2020-52,54,1,Bermuda,62273,America,575,10
BMU,2020-53,41,0,Bermuda,62273,America,616,10
BMU,2021-01,34,2,Bermuda,62273,America,650,12
BMU,2021-02,27,0,Bermuda,62273,America,677,12
BMU,2021-03,3,0,Bermuda,62273,America,680,12
BMU,2021-04,6,0,Bermuda,62273,America,686,12
BMU,2021-05,2,0,Bermuda,62273,America,688,12
BMU,2021-06,1,0,Bermuda,62273,America,689,12
BMU,2021-07,8,0,Bermuda,62273,America,697,12
BMU,2021-08,10,0,Bermuda,62273,America,707,12
BMU,2021-09,11,0,Bermuda,62273,America,718,12
BMU,2021-10,16,0,Bermuda,62273,America,734,12
BMU,2021-11,90,0,Bermuda,62273,America,824,12
BMU,2021-12,306,0,Bermuda,62273,America,1130,12
BMU,2021-13,264,0,Bermuda,62273,America,1394,12
BMU,2021-14,512,4,Bermuda,62273,America,1906,16
BMU,2021-15,302,4,Bermuda,62273,America,2208,20
BMU,2021-16,143,4,Bermuda,62273,America,2351,24
BMU,2021-17,65,6,Bermuda,62273,America,2416,30
BMU,2021-18,29,1,Bermuda,62273,America,2445,31
BMU,2021-19,26,1,Bermuda,62273,America,2471,32
BMU,2021-20,13,0,Bermuda,62273,America,2484,32
BMU,2021-21,4,1,Bermuda,62273,America,2488,33
BMU,2021-22,3,0,Bermuda,62273,America,2491,33
BMU,2021-23,1,0,Bermuda,62273,America,2492,33
BMU,2021-24,6,0,Bermuda,62273,America,2498,33
BMU,2021-25,6,0,Bermuda,62273,America,2504,33
BMU,2021-26,11,0,Bermuda,62273,America,2515,33
BMU,2021-27,0,0,Bermuda,62273,America,2515,33
BMU,2021-28,9,0,Bermuda,62273,America,2524,33
BMU,2021-29,8,0,Bermuda,62273,America,2532,33
BMU,2021-30,30,0,Bermuda,62273,America,2562,33
BMU,2021-31,77,0,Bermuda,62273,America,2639,33
BMU,2021-32,18,0,Bermuda,62273,America,2657,33
BOL,2020-13,69,3,Bolivia,11673029,America,69,3
BOL,2020-14,87,8,Bolivia,11673029,America,156,11
BOL,2020-15,147,16,Bolivia,11673029,America,303,27
BOL,2020-16,234,6,Bolivia,11673029,America,537,33
BOL,2020-17,386,17,Bolivia,11673029,America,923,50
BOL,2020-18,644,26,Bolivia,11673029,America,1567,76
BOL,2020-19,962,42,Bolivia,11673029,America,2529,118
BOL,2020-20,1532,51,Bolivia,11673029,America,4061,169
BOL,2020-21,2175,81,Bolivia,11673029,America,6236,250
BOL,2020-22,3719,63,Bolivia,11673029,America,9955,313
BOL,2020-23,3661,152,Bolivia,11673029,America,13616,465
BOL,2020-24,4816,146,Bolivia,11673029,America,18432,611
BOL,2020-25,5929,162,Bolivia,11673029,America,24361,773
BOL,2020-26,7136,241,Bolivia,11673029,America,31497,1014
BOL,2020-27,7773,420,Bolivia,11673029,America,39270,1434
BOL,2020-28,8890,373,Bolivia,11673029,America,48160,1807
BOL,2020-29,11395,344,Bolivia,11673029,America,59555,2151
BOL,2020-30,9847,432,Bolivia,11673029,America,69402,2583
BOL,2020-31,10724,570,Bolivia,11673029,America,80126,3153
BOL,2020-32,9846,487,Bolivia,11673029,America,89972,3640
BOL,2020-33,10345,408,Bolivia,11673029,America,100317,4048
BOL,2020-34,8805,461,Bolivia,11673029,America,109122,4509
BOL,2020-35,6819,457,Bolivia,11673029,America,115941,4966
BOL,2020-36,4801,2042,Bolivia,11673029,America,120742,7008
BOL,2020-37,6022,336,Bolivia,11673029,America,126764,7344
BOL,2020-38,3885,273,Bolivia,11673029,America,130649,7617
BOL,2020-39,3225,241,Bolivia,11673029,America,133874,7858
BOL,2020-40,2967,243,Bolivia,11673029,America,136841,8101
BOL,2020-41,1706,207,Bolivia,11673029,America,138547,8308
BOL,2020-42,1197,173,Bolivia,11673029,America,139744,8481
BOL,2020-43,1082,164,Bolivia,11673029,America,140826,8645
BOL,2020-44,980,86,Bolivia,11673029,America,141806,8731
BOL,2020-45,642,64,Bolivia,11673029,America,142448,8795
BOL,2020-46,771,54,Bolivia,11673029,America,143219,8849
BOL,2020-47,676,55,Bolivia,11673029,America,143895,8904
BOL,2020-48,700,48,Bolivia,11673029,America,144595,8952
BOL,2020-49,938,43,Bolivia,11673029,America,145533,8995
BOL,2020-50,1590,23,Bolivia,11673029,America,147123,9018
BOL,2020-51,3235,25,Bolivia,11673029,America,150358,9043
BOL,2020-52,4458,55,Bolivia,11673029,America,154816,9098
BOL,2020-53,7818,103,Bolivia,11673029,America,162634,9201
BOL,2021-01,11235,175,Bolivia,11673029,America,173869,9376
BOL,2021-02,13287,260,Bolivia,11673029,America,187156,9636
BOL,2021-03,15635,415,Bolivia,11673029,America,202791,10051
BOL,2021-04,14017,328,Bolivia,11673029,America,216808,10379
BOL,2021-05,11132,417,Bolivia,11673029,America,227940,10796
BOL,2021-06,8765,406,Bolivia,11673029,America,236705,11202
BOL,2021-07,5560,239,Bolivia,11673029,America,242265,11441
BOL,2021-08,6718,208,Bolivia,11673029,America,248983,11649
BOL,2021-09,5263,174,Bolivia,11673029,America,254246,11823
BOL,2021-10,5786,151,Bolivia,11673029,America,260032,11974
BOL,2021-11,4575,86,Bolivia,11673029,America,264607,12060
BOL,2021-12,4994,126,Bolivia,11673029,America,269601,12186
BOL,2021-13,5306,138,Bolivia,11673029,America,274907,12324
BOL,2021-14,8150,145,Bolivia,11673029,America,283057,12469
BOL,2021-15,5982,179,Bolivia,11673029,America,289039,12648
BOL,2021-16,8593,176,Bolivia,11673029,America,297632,12824
BOL,2021-17,8868,185,Bolivia,11673029,America,306500,13009
BOL,2021-18,12083,219,Bolivia,11673029,America,318583,13228
BOL,2021-19,16214,338,Bolivia,11673029,America,334797,13566
BOL,2021-20,14829,399,Bolivia,11673029,America,349626,13965
BOL,2021-21,21626,559,Bolivia,11673029,America,371252,14524
BOL,2021-22,15883,500,Bolivia,11673029,America,387135,15024
BOL,2021-23,19792,518,Bolivia,11673029,America,406927,15542
BOL,2021-24,15093,590,Bolivia,11673029,America,422020,16132
BOL,2021-25,10966,419,Bolivia,11673029,America,432986,16551
BOL,2021-26,11955,400,Bolivia,11673029,America,444941,16951
BOL,2021-27,9273,268,Bolivia,11673029,America,454214,17219
BOL,2021-28,7473,224,Bolivia,11673029,America,461687,17443
BOL,2021-29,6709,208,Bolivia,11673029,America,468396,17651
BOL,2021-30,5476,188,Bolivia,11673029,America,473872,17839
BOL,2021-31,4164,144,Bolivia,11673029,America,478036,17983
BOL,2021-32,4068,169,Bolivia,11673029,America,482104,18152
BRA,2020-02,0,0,Brazil,212559409,America,0,0
BRA,2020-03,0,0,Brazil,212559409,America,0,0
BRA,2020-04,0,0,Brazil,212559409,America,0,0
BRA,2020-05,0,0,Brazil,212559409,America,0,0
BRA,2020-06,0,0,Brazil,212559409,America,0,0
BRA,2020-07,0,0,Brazil,212559409,America,0,0
BRA,2020-08,0,0,Brazil,212559409,America,0,0
BRA,2020-09,2,0,Brazil,212559409,America,2,0
BRA,2020-10,23,0,Brazil,212559409,America,25,0
BRA,2020-11,175,0,Brazil,212559409,America,200,0
BRA,2020-12,1346,25,Brazil,212559409,America,1546,25
BRA,2020-13,2710,111,Brazil,212559409,America,4256,136
BRA,2020-14,6874,350,Brazil,212559409,America,11130,486
BRA,2020-15,11039,737,Brazil,212559409,America,22169,1223
BRA,2020-16,16485,1239,Brazil,212559409,America,38654,2462
BRA,2020-17,23234,1743,Brazil,212559409,America,61888,4205
BRA,2020-18,39259,2820,Brazil,212559409,America,101147,7025
BRA,2020-19,61552,4098,Brazil,212559409,America,162699,11123
BRA,2020-20,78381,4995,Brazil,212559409,America,241080,16118
BRA,2020-21,122131,6548,Brazil,212559409,America,363211,22666
BRA,2020-22,151638,6648,Brazil,212559409,America,514849,29314
BRA,2020-23,176909,7141,Brazil,212559409,America,691758,36455
BRA,2020-24,175866,6877,Brazil,212559409,America,867624,43332
BRA,2020-25,217414,7285,Brazil,212559409,America,1085038,50617
BRA,2020-26,259105,7005,Brazil,212559409,America,1344143,57622
BRA,2020-27,258912,7245,Brazil,212559409,America,1603055,64867
BRA,2020-28,261626,7233,Brazil,212559409,America,1864681,72100
BRA,2020-29,233708,7388,Brazil,212559409,America,2098389,79488
BRA,2020-30,320702,7516,Brazil,212559409,America,2419091,87004
BRA,2020-31,314586,7100,Brazil,212559409,America,2733677,94104
BRA,2020-32,301745,6945,Brazil,212559409,America,3035422,101049
BRA,2020-33,304775,6803,Brazil,212559409,America,3340197,107852
BRA,2020-34,265586,6892,Brazil,212559409,America,3605783,114744
BRA,2020-35,256528,6084,Brazil,212559409,America,3862311,120828
BRA,2020-36,275210,5822,Brazil,212559409,America,4137521,126650
BRA,2020-37,192934,4975,Brazil,212559409,America,4330455,131625
BRA,2020-38,214174,5270,Brazil,212559409,America,4544629,136895
BRA,2020-39,187680,4846,Brazil,212559409,America,4732309,141741
BRA,2020-40,182980,4611,Brazil,212559409,America,4915289,146352
BRA,2020-41,179693,4136,Brazil,212559409,America,5094982,150488
BRA,2020-42,140362,3417,Brazil,212559409,America,5235344,153905
BRA,2020-43,158784,3229,Brazil,212559409,America,5394128,157134
BRA,2020-44,151577,2940,Brazil,212559409,America,5545705,160074
BRA,2020-45,118410,2323,Brazil,212559409,America,5664115,162397
BRA,2020-46,198978,3401,Brazil,212559409,America,5863093,165798
BRA,2020-47,208308,3385,Brazil,212559409,America,6071401,169183
BRA,2020-48,243339,3650,Brazil,212559409,America,6314740,172833
BRA,2020-49,288800,4108,Brazil,212559409,America,6603540,176941
BRA,2020-50,298412,4461,Brazil,212559409,America,6901952,181402
BRA,2020-51,361667,5889,Brazil,212559409,America,7263619,187291
BRA,2020-52,220666,3848,Brazil,212559409,America,7484285,191139
BRA,2020-53,249461,4879,Brazil,212559409,America,7733746,196018
BRA,2021-01,397866,7562,Brazil,212559409,America,8131612,203580
BRA,2021-02,380158,6719,Brazil,212559409,America,8511770,210299
BRA,2021-03,359623,7365,Brazil,212559409,America,8871393,217664
BRA,2021-04,357929,7435,Brazil,212559409,America,9229322,225099
BRA,2021-05,318757,7071,Brazil,212559409,America,9548079,232170
BRA,2021-06,318631,7603,Brazil,212559409,America,9866710,239773
BRA,2021-07,328450,7370,Brazil,212559409,America,10195160,247143
BRA,2021-08,391841,8577,Brazil,212559409,America,10587001,255720
BRA,2021-09,464664,10678,Brazil,212559409,America,11051665,266398
BRA,2021-10,467944,12888,Brazil,212559409,America,11519609,279286
BRA,2021-11,527917,16139,Brazil,212559409,America,12047526,295425
BRA,2021-12,526089,18441,Brazil,212559409,America,12573615,313866
BRA,2021-13,439986,18886,Brazil,212559409,America,13013601,332752
BRA,2021-14,504207,21865,Brazil,212559409,America,13517808,354617
BRA,2021-15,455887,20065,Brazil,212559409,America,13973695,374682
BRA,2021-16,395728,17254,Brazil,212559409,America,14369423,391936
BRA,2021-17,410106,16686,Brazil,212559409,America,14779529,408622
BRA,2021-18,430461,14607,Brazil,212559409,America,15209990,423229
BRA,2021-19,376544,11486,Brazil,212559409,America,15586534,434715
BRA,2021-20,460905,13493,Brazil,212559409,America,16047439,448208
BRA,2021-21,424161,12849,Brazil,212559409,America,16471600,461057
BRA,2021-22,475462,12347,Brazil,212559409,America,16947062,473404
BRA,2021-23,465704,13997,Brazil,212559409,America,17412766,487401
BRA,2021-24,508962,15424,Brazil,212559409,America,17921728,502825
BRA,2021-25,498870,10649,Brazil,212559409,America,18420598,513474
BRA,2021-26,349210,10943,Brazil,212559409,America,18769808,524417
BRA,2021-27,337163,9816,Brazil,212559409,America,19106971,534233
BRA,2021-28,269603,7981,Brazil,212559409,America,19376574,542214
BRA,2021-29,312089,7710,Brazil,212559409,America,19688663,549924
BRA,2021-30,249695,6910,Brazil,212559409,America,19938358,556834
BRA,2021-31,227314,6317,Brazil,212559409,America,20165672,563151
BRA,2021-32,198427,5907,Brazil,212559409,America,20364099,569058
BRB,2020-13,16,0,Barbados,287371,America,16,0
BRB,2020-14,23,1,Barbados,287371,America,39,1
BRB,2020-15,15,3,Barbados,287371,America,54,4
BRB,2020-16,4,1,Barbados,287371,America,58,5
BRB,2020-17,4,1,Barbados,287371,America,62,6
BRB,2020-18,3,1,Barbados,287371,America,65,7
BRB,2020-19,2,0,Barbados,287371,America,67,7
BRB,2020-20,4,0,Barbados,287371,America,71,7
BRB,2020-21,4,0,Barbados,287371,America,75,7
BRB,2020-22,0,0,Barbados,287371,America,75,7
BRB,2020-23,0,0,Barbados,287371,America,75,7
BRB,2020-24,4,0,Barbados,287371,America,79,7
BRB,2020-25,1,0,Barbados,287371,America,80,7
BRB,2020-26,0,0,Barbados,287371,America,80,7
BRB,2020-27,1,0,Barbados,287371,America,81,7
BRB,2020-28,5,0,Barbados,287371,America,86,7
BRB,2020-29,2,0,Barbados,287371,America,88,7
BRB,2020-30,5,0,Barbados,287371,America,93,7
BRB,2020-31,22,0,Barbados,287371,America,115,7
BRB,2020-32,10,0,Barbados,287371,America,125,7
BRB,2020-33,9,0,Barbados,287371,America,134,7
BRB,2020-34,10,0,Barbados,287371,America,144,7
BRB,2020-35,12,0,Barbados,287371,America,156,7
BRB,2020-36,6,0,Barbados,287371,America,162,7
BRB,2020-37,2,0,Barbados,287371,America,164,7
BRB,2020-38,8,0,Barbados,287371,America,172,7
BRB,2020-39,1,0,Barbados,287371,America,173,7
BRB,2020-40,9,0,Barbados,287371,America,182,7
BRB,2020-41,9,0,Barbados,287371,America,191,7
BRB,2020-42,14,0,Barbados,287371,America,205,7
BRB,2020-43,5,0,Barbados,287371,America,210,7
BRB,2020-44,10,0,Barbados,287371,America,220,7
BRB,2020-45,5,0,Barbados,287371,America,225,7
BRB,2020-46,8,0,Barbados,287371,America,233,7
BRB,2020-47,9,0,Barbados,287371,America,242,7
BRB,2020-48,16,0,Barbados,287371,America,258,7
BRB,2020-49,12,0,Barbados,287371,America,270,7
BRB,2020-50,9,0,Barbados,287371,America,279,7
BRB,2020-51,26,0,Barbados,287371,America,305,7
BRB,2020-52,40,0,Barbados,287371,America,345,7
BRB,2020-53,244,0,Barbados,287371,America,589,7
BRB,2021-01,278,0,Barbados,287371,America,867,7
BRB,2021-02,211,0,Barbados,287371,America,1078,7
BRB,2021-03,306,3,Barbados,287371,America,1384,10
BRB,2021-04,157,4,Barbados,287371,America,1541,14
BRB,2021-05,174,4,Barbados,287371,America,1715,18
BRB,2021-06,536,6,Barbados,287371,America,2251,24
BRB,2021-07,523,7,Barbados,287371,America,2774,31
BRB,2021-08,324,5,Barbados,287371,America,3098,36
BRB,2021-09,188,1,Barbados,287371,America,3286,37
BRB,2021-10,139,1,Barbados,287371,America,3425,38
BRB,2021-11,117,2,Barbados,287371,America,3542,40
BRB,2021-12,75,1,Barbados,287371,America,3617,41
BRB,2021-13,51,2,Barbados,287371,America,3668,43
BRB,2021-14,49,1,Barbados,287371,America,3717,44
BRB,2021-15,50,0,Barbados,287371,America,3767,44
BRB,2021-16,40,0,Barbados,287371,America,3807,44
BRB,2021-17,57,0,Barbados,287371,America,3864,44
BRB,2021-18,65,1,Barbados,287371,America,3929,45
BRB,2021-19,21,1,Barbados,287371,America,3950,46
BRB,2021-20,33,1,Barbados,287371,America,3983,47
BRB,2021-21,17,0,Barbados,287371,America,4000,47
BRB,2021-22,15,0,Barbados,287371,America,4015,47
BRB,2021-23,5,0,Barbados,287371,America,4020,47
BRB,2021-24,8,0,Barbados,287371,America,4028,47
BRB,2021-25,32,0,Barbados,287371,America,4060,47
BRB,2021-26,19,0,Barbados,287371,America,4079,47
BRB,2021-27,90,1,Barbados,287371,America,4169,48
BRB,2021-28,83,0,Barbados,287371,America,4252,48
BRB,2021-29,84,0,Barbados,287371,America,4336,48
BRB,2021-30,64,0,Barbados,287371,America,4400,48
BRB,2021-31,63,0,Barbados,287371,America,4463,48
BRB,2021-32,80,0,Barbados,287371,America,4543,48
BRN,2020-12,38,0,Brunei Darussalam,437483,Asia,38,0
BRN,2020-13,38,1,Brunei Darussalam,437483,Asia,76,1
BRN,2020-14,9,0,Brunei Darussalam,437483,Asia,85,1
BRN,2020-15,1,0,Brunei Darussalam,437483,Asia,86,1
BRN,2020-16,2,0,Brunei Darussalam,437483,Asia,88,1
BRN,2020-17,0,0,Brunei Darussalam,437483,Asia,88,1
BRN,2020-18,0,0,Brunei Darussalam,437483,Asia,88,1
BRN,2020-19,3,0,Brunei Darussalam,437483,Asia,91,1
BRN,2020-20,0,0,Brunei Darussalam,437483,Asia,91,1
BRN,2020-21,0,0,Brunei Darussalam,437483,Asia,91,1
BRN,2020-22,0,1,Brunei Darussalam,437483,Asia,91,2
BRN,2020-23,0,0,Brunei Darussalam,437483,Asia,91,2
BRN,2020-24,0,0,Brunei Darussalam,437483,Asia,91,2
BRN,2020-25,0,1,Brunei Darussalam,437483,Asia,91,3
BRN,2020-26,0,0,Brunei Darussalam,437483,Asia,91,3
BRN,2020-27,0,0,Brunei Darussalam,437483,Asia,91,3
BRN,2020-28,0,0,Brunei Darussalam,437483,Asia,91,3
BRN,2020-29,0,0,Brunei Darussalam,437483,Asia,91,3
BRN,2020-30,0,0,Brunei Darussalam,437483,Asia,91,3
BRN,2020-31,0,0,Brunei Darussalam,437483,Asia,91,3
BRN,2020-32,1,0,Brunei Darussalam,437483,Asia,92,3
BRN,2020-33,0,0,Brunei Darussalam,437483,Asia,92,3
BRN,2020-34,1,0,Brunei Darussalam,437483,Asia,93,3
BRN,2020-35,1,0,Brunei Darussalam,437483,Asia,94,3
BRN,2020-36,1,0,Brunei Darussalam,437483,Asia,95,3
BRN,2020-37,0,0,Brunei Darussalam,437483,Asia,95,3
BRN,2020-38,0,0,Brunei Darussalam,437483,Asia,95,3
BRN,2020-39,1,0,Brunei Darussalam,437483,Asia,96,3
BRN,2020-40,0,0,Brunei Darussalam,437483,Asia,96,3
BRN,2020-41,0,0,Brunei Darussalam,437483,Asia,96,3
BRN,2020-42,1,0,Brunei Darussalam,437483,Asia,97,3
BRN,2020-43,1,0,Brunei Darussalam,437483,Asia,98,3
BRN,2020-44,0,0,Brunei Darussalam,437483,Asia,98,3
BRN,2020-45,0,0,Brunei Darussalam,437483,Asia,98,3
BRN,2020-46,0,0,Brunei Darussalam,437483,Asia,98,3
BRN,2020-47,0,0,Brunei Darussalam,437483,Asia,98,3
BRN,2020-48,2,0,Brunei Darussalam,437483,Asia,100,3
BRN,2020-49,1,0,Brunei Darussalam,437483,Asia,101,3
BRN,2020-50,1,0,Brunei Darussalam,437483,Asia,102,3
BRN,2020-51,0,0,Brunei Darussalam,437483,Asia,102,3
BRN,2020-52,0,0,Brunei Darussalam,437483,Asia,102,3
BRN,2020-53,20,0,Brunei Darussalam,437483,Asia,122,3
BRN,2021-01,1,0,Brunei Darussalam,437483,Asia,123,3
BRN,2021-02,1,0,Brunei Darussalam,437483,Asia,124,3
BRN,2021-03,1,0,Brunei Darussalam,437483,Asia,125,3
BRN,2021-04,5,0,Brunei Darussalam,437483,Asia,130,3
BRN,2021-05,1,0,Brunei Darussalam,437483,Asia,131,3
BRN,2021-06,3,0,Brunei Darussalam,437483,Asia,134,3
BRN,2021-07,1,0,Brunei Darussalam,437483,Asia,135,3
BRN,2021-08,1,0,Brunei Darussalam,437483,Asia,136,3
BRN,2021-09,4,0,Brunei Darussalam,437483,Asia,140,3
BRN,2021-10,2,0,Brunei Darussalam,437483,Asia,142,3
BRN,2021-11,14,0,Brunei Darussalam,437483,Asia,156,3
BRN,2021-12,0,0,Brunei Darussalam,437483,Asia,156,3
BRN,2021-13,8,0,Brunei Darussalam,437483,Asia,164,3
BRN,2021-14,5,0,Brunei Darussalam,437483,Asia,169,3
BRN,2021-15,2,0,Brunei Darussalam,437483,Asia,171,3
BRN,2021-16,2,0,Brunei Darussalam,437483,Asia,173,3
BRN,2021-17,4,0,Brunei Darussalam,437483,Asia,177,3
BRN,2021-18,3,0,Brunei Darussalam,437483,Asia,180,3
BRN,2021-19,2,0,Brunei Darussalam,437483,Asia,182,3
BRN,2021-20,4,0,Brunei Darussalam,437483,Asia,186,3
BRN,2021-21,5,0,Brunei Darussalam,437483,Asia,191,3
BRN,2021-22,3,0,Brunei Darussalam,437483,Asia,194,3
BRN,2021-23,6,0,Brunei Darussalam,437483,Asia,200,3
BRN,2021-24,5,0,Brunei Darussalam,437483,Asia,205,3
BRN,2021-25,4,0,Brunei Darussalam,437483,Asia,209,3
BRN,2021-26,2,0,Brunei Darussalam,437483,Asia,211,3
BRN,2021-27,14,0,Brunei Darussalam,437483,Asia,225,3
BRN,2021-28,16,0,Brunei Darussalam,437483,Asia,241,3
BRN,2021-29,20,0,Brunei Darussalam,437483,Asia,261,3
BRN,2021-30,27,0,Brunei Darussalam,437483,Asia,288,3
BRN,2021-31,26,0,Brunei Darussalam,437483,Asia,314,3
BRN,2021-32,423,0,Brunei Darussalam,437483,Asia,737,3
BTN,2020-13,2,0,Bhutan,771612,Asia,2,0
BTN,2020-14,1,0,Bhutan,771612,Asia,3,0
BTN,2020-15,0,0,Bhutan,771612,Asia,3,0
BTN,2020-16,0,0,Bhutan,771612,Asia,3,0
BTN,2020-17,2,0,Bhutan,771612,Asia,5,0
BTN,2020-18,0,0,Bhutan,771612,Asia,5,0
BTN,2020-19,2,0,Bhutan,771612,Asia,7,0
BTN,2020-20,12,0,Bhutan,771612,Asia,19,0
BTN,2020-21,6,0,Bhutan,771612,Asia,25,0
BTN,2020-22,16,0,Bhutan,771612,Asia,41,0
BTN,2020-23,16,0,Bhutan,771612,Asia,57,0
BTN,2020-24,7,0,Bhutan,771612,Asia,64,0
BTN,2020-25,2,0,Bhutan,771612,Asia,66,0
BTN,2020-26,8,0,Bhutan,771612,Asia,74,0
BTN,2020-27,4,0,Bhutan,771612,Asia,78,0
BTN,2020-28,4,0,Bhutan,771612,Asia,82,0
BTN,2020-29,5,0,Bhutan,771612,Asia,87,0
BTN,2020-30,6,0,Bhutan,771612,Asia,93,0
BTN,2020-31,8,0,Bhutan,771612,Asia,101,0
BTN,2020-32,7,0,Bhutan,771612,Asia,108,0
BTN,2020-33,31,0,Bhutan,771612,Asia,139,0
BTN,2020-34,14,0,Bhutan,771612,Asia,153,0
BTN,2020-35,69,0,Bhutan,771612,Asia,222,0
BTN,2020-36,6,0,Bhutan,771612,Asia,228,0
BTN,2020-37,15,0,Bhutan,771612,Asia,243,0
BTN,2020-38,16,0,Bhutan,771612,Asia,259,0
BTN,2020-39,12,0,Bhutan,771612,Asia,271,0
BTN,2020-40,25,0,Bhutan,771612,Asia,296,0
BTN,2020-41,11,0,Bhutan,771612,Asia,307,0
BTN,2020-42,18,0,Bhutan,771612,Asia,325,0
BTN,2020-43,15,0,Bhutan,771612,Asia,340,0
BTN,2020-44,12,0,Bhutan,771612,Asia,352,0
BTN,2020-45,5,0,Bhutan,771612,Asia,357,0
BTN,2020-46,16,0,Bhutan,771612,Asia,373,0
BTN,2020-47,7,0,Bhutan,771612,Asia,380,0
BTN,2020-48,14,0,Bhutan,771612,Asia,394,0
BTN,2020-49,34,0,Bhutan,771612,Asia,428,0
BTN,2020-50,8,0,Bhutan,771612,Asia,436,0
BTN,2020-51,29,0,Bhutan,771612,Asia,465,0
BTN,2020-52,156,0,Bhutan,771612,Asia,621,0
BTN,2020-53,93,0,Bhutan,771612,Asia,714,0
BTN,2021-01,97,1,Bhutan,771612,Asia,811,1
BTN,2021-02,29,0,Bhutan,771612,Asia,840,1
BTN,2021-03,13,0,Bhutan,771612,Asia,853,1
BTN,2021-04,4,0,Bhutan,771612,Asia,857,1
BTN,2021-05,2,0,Bhutan,771612,Asia,859,1
BTN,2021-06,3,0,Bhutan,771612,Asia,862,1
BTN,2021-07,2,0,Bhutan,771612,Asia,864,1
BTN,2021-08,1,0,Bhutan,771612,Asia,865,1
BTN,2021-09,1,0,Bhutan,771612,Asia,866,1
BTN,2021-10,0,0,Bhutan,771612,Asia,866,1
BTN,2021-11,1,0,Bhutan,771612,Asia,867,1
BTN,2021-12,3,0,Bhutan,771612,Asia,870,1
BTN,2021-13,19,0,Bhutan,771612,Asia,889,1
BTN,2021-14,27,0,Bhutan,771612,Asia,916,1
BTN,2021-15,39,0,Bhutan,771612,Asia,955,1
BTN,2021-16,65,0,Bhutan,771612,Asia,1020,1
BTN,2021-17,89,0,Bhutan,771612,Asia,1109,1
BTN,2021-18,110,0,Bhutan,771612,Asia,1219,1
BTN,2021-19,65,0,Bhutan,771612,Asia,1284,1
BTN,2021-20,108,0,Bhutan,771612,Asia,1392,1
BTN,2021-21,218,0,Bhutan,771612,Asia,1610,1
BTN,2021-22,75,0,Bhutan,771612,Asia,1685,1
BTN,2021-23,126,0,Bhutan,771612,Asia,1811,1
BTN,2021-24,111,0,Bhutan,771612,Asia,1922,1
BTN,2021-25,128,0,Bhutan,771612,Asia,2050,1
BTN,2021-26,107,0,Bhutan,771612,Asia,2157,1
BTN,2021-27,116,0,Bhutan,771612,Asia,2273,1
BTN,2021-28,146,1,Bhutan,771612,Asia,2419,2
BTN,2021-29,65,0,Bhutan,771612,Asia,2484,2
BTN,2021-30,32,0,Bhutan,771612,Asia,2516,2
BTN,2021-31,26,0,Bhutan,771612,Asia,2542,2
BTN,2021-32,27,1,Bhutan,771612,Asia,2569,3
BWA,2020-15,7,0,Botswana,2351625,Africa,7,0
BWA,2020-16,7,0,Botswana,2351625,Africa,14,0
BWA,2020-17,2,0,Botswana,2351625,Africa,16,0
BWA,2020-18,1,0,Botswana,2351625,Africa,17,0
BWA,2020-19,0,0,Botswana,2351625,Africa,17,0
BWA,2020-20,2,0,Botswana,2351625,Africa,19,0
BWA,2020-21,10,0,Botswana,2351625,Africa,29,0
BWA,2020-22,3,0,Botswana,2351625,Africa,32,0
BWA,2020-23,2,0,Botswana,2351625,Africa,34,0
BWA,2020-24,20,0,Botswana,2351625,Africa,54,0
BWA,2020-25,29,0,Botswana,2351625,Africa,83,0
BWA,2020-26,36,0,Botswana,2351625,Africa,119,0
BWA,2020-27,150,0,Botswana,2351625,Africa,269,0
BWA,2020-28,124,0,Botswana,2351625,Africa,393,0
BWA,2020-29,123,0,Botswana,2351625,Africa,516,0
BWA,2020-30,164,0,Botswana,2351625,Africa,680,0
BWA,2020-31,118,1,Botswana,2351625,Africa,798,1
BWA,2020-32,105,0,Botswana,2351625,Africa,903,1
BWA,2020-33,305,1,Botswana,2351625,Africa,1208,2
BWA,2020-34,94,0,Botswana,2351625,Africa,1302,2
BWA,2020-35,325,3,Botswana,2351625,Africa,1627,5
BWA,2020-36,369,2,Botswana,2351625,Africa,1996,7
BWA,2020-37,250,2,Botswana,2351625,Africa,2246,9
BWA,2020-38,315,3,Botswana,2351625,Africa,2561,12
BWA,2020-39,354,3,Botswana,2351625,Africa,2915,15
BWA,2020-40,251,0,Botswana,2351625,Africa,3166,15
BWA,2020-41,1348,2,Botswana,2351625,Africa,4514,17
BWA,2020-42,722,2,Botswana,2351625,Africa,5236,19
BWA,2020-43,681,1,Botswana,2351625,Africa,5917,20
BWA,2020-44,719,3,Botswana,2351625,Africa,6636,23
BWA,2020-45,1193,3,Botswana,2351625,Africa,7829,26
BWA,2020-46,390,0,Botswana,2351625,Africa,8219,26
BWA,2020-47,1369,4,Botswana,2351625,Africa,9588,30
BWA,2020-48,398,0,Botswana,2351625,Africa,9986,30
BWA,2020-49,1539,3,Botswana,2351625,Africa,11525,33
BWA,2020-50,1342,4,Botswana,2351625,Africa,12867,37
BWA,2020-51,141,0,Botswana,2351625,Africa,13008,37
BWA,2020-52,1011,2,Botswana,2351625,Africa,14019,39
BWA,2020-53,740,5,Botswana,2351625,Africa,14759,44
BWA,2021-01,1285,3,Botswana,2351625,Africa,16044,47
BWA,2021-02,1315,23,Botswana,2351625,Africa,17359,70
BWA,2021-03,2289,34,Botswana,2351625,Africa,19648,104
BWA,2021-04,1639,29,Botswana,2351625,Africa,21287,133
BWA,2021-05,3142,45,Botswana,2351625,Africa,24429,178
BWA,2021-06,491,23,Botswana,2351625,Africa,24920,201
BWA,2021-07,2805,98,Botswana,2351625,Africa,27725,299
BWA,2021-08,650,10,Botswana,2351625,Africa,28375,309
BWA,2021-09,3375,49,Botswana,2351625,Africa,31750,358
BWA,2021-10,3253,88,Botswana,2351625,Africa,35003,446
BWA,2021-11,2238,38,Botswana,2351625,Africa,37241,484
BWA,2021-12,696,21,Botswana,2351625,Africa,37937,505
BWA,2021-13,1375,62,Botswana,2351625,Africa,39312,567
BWA,2021-14,3576,95,Botswana,2351625,Africa,42888,662
BWA,2021-15,1258,21,Botswana,2351625,Africa,44146,683
BWA,2021-16,1703,7,Botswana,2351625,Africa,45849,690
BWA,2021-17,1079,21,Botswana,2351625,Africa,46928,711
BWA,2021-18,1483,22,Botswana,2351625,Africa,48411,733
BWA,2021-19,3745,27,Botswana,2351625,Africa,52156,760
BWA,2021-20,1989,23,Botswana,2351625,Africa,54145,783
BWA,2021-21,2162,47,Botswana,2351625,Africa,56307,830
BWA,2021-22,2451,35,Botswana,2351625,Africa,58758,865
BWA,2021-23,3276,30,Botswana,2351625,Africa,62034,895
BWA,2021-24,3775,44,Botswana,2351625,Africa,65809,939
BWA,2021-25,4256,185,Botswana,2351625,Africa,70065,1124
BWA,2021-26,1372,33,Botswana,2351625,Africa,71437,1157
BWA,2021-27,3945,44,Botswana,2351625,Africa,75382,1201
BWA,2021-28,10745,72,Botswana,2351625,Africa,86127,1273
BWA,2021-29,11524,101,Botswana,2351625,Africa,97651,1374
BWA,2021-30,9033,194,Botswana,2351625,Africa,106684,1568
BWA,2021-31,15884,135,Botswana,2351625,Africa,122568,1703
BWA,2021-32,14184,269,Botswana,2351625,Africa,136752,1972
CAF,2020-12,3,0,Central African Republic,4829764,Africa,3,0
CAF,2020-13,2,0,Central African Republic,4829764,Africa,5,0
CAF,2020-14,3,0,Central African Republic,4829764,Africa,8,0
CAF,2020-15,2,0,Central African Republic,4829764,Africa,10,0
CAF,2020-16,1,0,Central African Republic,4829764,Africa,11,0
CAF,2020-17,7,0,Central African Republic,4829764,Africa,18,0
CAF,2020-18,53,0,Central African Republic,4829764,Africa,71,0
CAF,2020-19,107,0,Central African Republic,4829764,Africa,178,0
CAF,2020-20,148,0,Central African Republic,4829764,Africa,326,0
CAF,2020-21,277,1,Central African Republic,4829764,Africa,603,1
CAF,2020-22,407,1,Central African Republic,4829764,Africa,1010,2
CAF,2020-23,623,3,Central African Republic,4829764,Africa,1633,5
CAF,2020-24,588,2,Central African Republic,4829764,Africa,2221,7
CAF,2020-25,586,16,Central African Republic,4829764,Africa,2807,23
CAF,2020-26,621,22,Central African Republic,4829764,Africa,3428,45
CAF,2020-27,540,3,Central African Republic,4829764,Africa,3968,48
CAF,2020-28,319,5,Central African Republic,4829764,Africa,4287,53
CAF,2020-29,197,2,Central African Republic,4829764,Africa,4484,55
CAF,2020-30,114,4,Central African Republic,4829764,Africa,4598,59
CAF,2020-31,15,0,Central African Republic,4829764,Africa,4613,59
CAF,2020-32,27,1,Central African Republic,4829764,Africa,4640,60
CAF,2020-33,11,1,Central African Republic,4829764,Africa,4651,61
CAF,2020-34,27,0,Central African Republic,4829764,Africa,4678,61
CAF,2020-35,21,0,Central African Republic,4829764,Africa,4699,61
CAF,2020-36,29,1,Central African Republic,4829764,Africa,4728,62
CAF,2020-37,20,0,Central African Republic,4829764,Africa,4748,62
CAF,2020-38,44,0,Central African Republic,4829764,Africa,4792,62
CAF,2020-39,13,0,Central African Republic,4829764,Africa,4805,62
CAF,2020-40,39,0,Central African Republic,4829764,Africa,4844,62
CAF,2020-41,9,0,Central African Republic,4829764,Africa,4853,62
CAF,2020-42,1,0,Central African Republic,4829764,Africa,4854,62
CAF,2020-43,7,0,Central African Republic,4829764,Africa,4861,62
CAF,2020-44,4,0,Central African Republic,4829764,Africa,4865,62
CAF,2020-45,13,0,Central African Republic,4829764,Africa,4878,62
CAF,2020-46,21,1,Central African Republic,4829764,Africa,4899,63
CAF,2020-47,11,0,Central African Republic,4829764,Africa,4910,63
CAF,2020-48,2,0,Central African Republic,4829764,Africa,4912,63
CAF,2020-49,9,0,Central African Republic,4829764,Africa,4921,63
CAF,2020-50,14,0,Central African Republic,4829764,Africa,4935,63
CAF,2020-51,2,0,Central African Republic,4829764,Africa,4937,63
CAF,2020-52,23,0,Central African Republic,4829764,Africa,4960,63
CAF,2020-53,2,0,Central African Republic,4829764,Africa,4962,63
CAF,2021-01,10,0,Central African Republic,4829764,Africa,4972,63
CAF,2021-02,1,0,Central African Republic,4829764,Africa,4973,63
CAF,2021-03,6,0,Central African Republic,4829764,Africa,4979,63
CAF,2021-04,9,0,Central African Republic,4829764,Africa,4988,63
CAF,2021-05,0,0,Central African Republic,4829764,Africa,4988,63
CAF,2021-06,7,0,Central African Republic,4829764,Africa,4995,63
CAF,2021-07,1,0,Central African Republic,4829764,Africa,4996,63
CAF,2021-08,0,0,Central African Republic,4829764,Africa,4996,63
CAF,2021-09,24,0,Central African Republic,4829764,Africa,5020,63
CAF,2021-10,4,0,Central African Republic,4829764,Africa,5024,63
CAF,2021-11,39,0,Central African Republic,4829764,Africa,5063,63
CAF,2021-12,23,1,Central African Republic,4829764,Africa,5086,64
CAF,2021-13,158,8,Central African Republic,4829764,Africa,5244,72
CAF,2021-14,220,2,Central African Republic,4829764,Africa,5464,74
CAF,2021-15,322,1,Central African Republic,4829764,Africa,5786,75
CAF,2021-16,437,10,Central African Republic,4829764,Africa,6223,85
CAF,2021-17,187,3,Central African Republic,4829764,Africa,6410,88
CAF,2021-18,263,5,Central African Republic,4829764,Africa,6673,93
CAF,2021-19,192,2,Central African Republic,4829764,Africa,6865,95
CAF,2021-20,213,2,Central African Republic,4829764,Africa,7078,97
CAF,2021-21,12,1,Central African Republic,4829764,Africa,7090,98
CAF,2021-22,3861,0,Central African Republic,4829764,Africa,10951,98
CAF,2021-23,35,0,Central African Republic,4829764,Africa,10986,98
CAF,2021-24,57,0,Central African Republic,4829764,Africa,11043,98
CAF,2021-25,14,0,Central African Republic,4829764,Africa,11057,98
CAF,2021-26,6,0,Central African Republic,4829764,Africa,11063,98
CAF,2021-27,6,0,Central African Republic,4829764,Africa,11069,98
CAF,2021-28,13,0,Central African Republic,4829764,Africa,11082,98
CAF,2021-29,52,0,Central African Republic,4829764,Africa,11134,98
CAF,2021-30,18,0,Central African Republic,4829764,Africa,11152,98
CAF,2021-31,54,1,Central African Republic,4829764,Africa,11206,99
CAF,2021-32,44,0,Central African Republic,4829764,Africa,11250,99
CAN,2020-02,0,0,Canada,37742157,America,0,0
CAN,2020-03,0,0,Canada,37742157,America,0,0
CAN,2020-04,1,0,Canada,37742157,America,1,0
CAN,2020-05,3,0,Canada,37742157,America,4,0
CAN,2020-06,3,0,Canada,37742157,America,7,0
CAN,2020-07,1,0,Canada,37742157,America,8,0
CAN,2020-08,1,0,Canada,37742157,America,9,0
CAN,2020-09,15,0,Canada,37742157,America,24,0
CAN,2020-10,38,0,Canada,37742157,America,62,0
CAN,2020-11,242,1,Canada,37742157,America,304,1
CAN,2020-12,1126,19,Canada,37742157,America,1430,20
CAN,2020-13,4825,41,Canada,37742157,America,6255,61
CAN,2020-14,9241,219,Canada,37742157,America,15496,280
CAN,2020-15,8869,437,Canada,37742157,America,24365,717
CAN,2020-16,10412,863,Canada,37742157,America,34777,1580
CAN,2020-17,12107,980,Canada,37742157,America,46884,2560
CAN,2020-18,12590,1122,Canada,37742157,America,59474,3682
CAN,2020-19,9374,1189,Canada,37742157,America,68848,4871
CAN,2020-20,8143,911,Canada,37742157,America,76991,5782
CAN,2020-21,7697,642,Canada,37742157,America,84688,6424
CAN,2020-22,6248,871,Canada,37742157,America,90936,7295
CAN,2020-23,4752,505,Canada,37742157,America,95688,7800
CAN,2020-24,3088,346,Canada,37742157,America,98776,8146
CAN,2020-25,2550,284,Canada,37742157,America,101326,8430
CAN,2020-26,1913,92,Canada,37742157,America,103239,8522
CAN,2020-27,2285,162,Canada,37742157,America,105524,8684
CAN,2020-28,2055,99,Canada,37742157,America,107579,8783
CAN,2020-29,2759,69,Canada,37742157,America,110338,8852
CAN,2020-30,3560,38,Canada,37742157,America,113898,8890
CAN,2020-31,2972,55,Canada,37742157,America,116870,8945
CAN,2020-32,2581,36,Canada,37742157,America,119451,8981
CAN,2020-33,2636,45,Canada,37742157,America,122087,9026
CAN,2020-34,2809,47,Canada,37742157,America,124896,9073
CAN,2020-35,3044,44,Canada,37742157,America,127940,9117
CAN,2020-36,3955,28,Canada,37742157,America,131895,9145
CAN,2020-37,4764,26,Canada,37742157,America,136659,9171
CAN,2020-38,6990,46,Canada,37742157,America,143649,9217
CAN,2020-39,9476,51,Canada,37742157,America,153125,9268
CAN,2020-40,13031,213,Canada,37742157,America,166156,9481
CAN,2020-41,11961,104,Canada,37742157,America,178117,9585
CAN,2020-42,20031,175,Canada,37742157,America,198148,9760
CAN,2020-43,17956,186,Canada,37742157,America,216104,9946
CAN,2020-44,20737,233,Canada,37742157,America,236841,10179
CAN,2020-45,27272,343,Canada,37742157,America,264113,10522
CAN,2020-46,31964,431,Canada,37742157,America,296077,10953
CAN,2020-47,34426,502,Canada,37742157,America,330503,11455
CAN,2020-48,39775,577,Canada,37742157,America,370278,12032
CAN,2020-49,44904,633,Canada,37742157,America,415182,12665
CAN,2020-50,45561,766,Canada,37742157,America,460743,13431
CAN,2020-51,54571,901,Canada,37742157,America,515314,14332
CAN,2020-52,36706,632,Canada,37742157,America,552020,14964
CAN,2020-53,49643,901,Canada,37742157,America,601663,15865
CAN,2021-01,66518,1221,Canada,37742157,America,668181,17086
CAN,2021-02,46891,1034,Canada,37742157,America,715072,18120
CAN,2021-03,37939,1118,Canada,37742157,America,753011,19238
CAN,2021-04,30578,898,Canada,37742157,America,783589,20136
CAN,2021-05,24531,699,Canada,37742157,America,808120,20835
CAN,2021-06,18804,476,Canada,37742157,America,826924,21311
CAN,2021-07,22593,412,Canada,37742157,America,849517,21723
CAN,2021-08,20516,294,Canada,37742157,America,870033,22017
CAN,2021-09,20665,259,Canada,37742157,America,890698,22276
CAN,2021-10,22349,219,Canada,37742157,America,913047,22495
CAN,2021-11,25672,221,Canada,37742157,America,938719,22716
CAN,2021-12,32996,184,Canada,37742157,America,971715,22900
CAN,2021-13,42658,218,Canada,37742157,America,1014373,23118
CAN,2021-14,56643,238,Canada,37742157,America,1071016,23356
CAN,2021-15,60757,311,Canada,37742157,America,1131773,23667
CAN,2021-16,56145,357,Canada,37742157,America,1187918,24024
CAN,2021-17,55324,318,Canada,37742157,America,1243242,24342
CAN,2021-18,50944,344,Canada,37742157,America,1294186,24686
CAN,2021-19,34396,262,Canada,37742157,America,1328582,24948
CAN,2021-20,32982,317,Canada,37742157,America,1361564,25265
CAN,2021-21,20018,282,Canada,37742157,America,1381582,25547
CAN,2021-22,12563,214,Canada,37742157,America,1394145,25761
CAN,2021-23,9140,183,Canada,37742157,America,1403285,25944
CAN,2021-24,6322,143,Canada,37742157,America,1409607,26087
CAN,2021-25,4527,151,Canada,37742157,America,1414134,26238
CAN,2021-26,3505,130,Canada,37742157,America,1417639,26368
CAN,2021-27,3469,70,Canada,37742157,America,1421108,26438
CAN,2021-28,2451,61,Canada,37742157,America,1423559,26499
CAN,2021-29,3783,54,Canada,37742157,America,1427342,26553
CAN,2021-30,3141,39,Canada,37742157,America,1430483,26592
CAN,2021-31,11604,86,Canada,37742157,America,1442087,26678
CAN,2021-32,13886,26,Canada,37742157,America,1455973,26704
CHE,2020-02,0,0,Switzerland,8606033,Europe,0,0
CHE,2020-03,0,0,Switzerland,8606033,Europe,0,0
CHE,2020-04,0,0,Switzerland,8606033,Europe,0,0
CHE,2020-05,0,0,Switzerland,8606033,Europe,0,0
CHE,2020-06,0,0,Switzerland,8606033,Europe,0,0
CHE,2020-07,0,0,Switzerland,8606033,Europe,0,0
CHE,2020-08,0,0,Switzerland,8606033,Europe,0,0
CHE,2020-09,24,0,Switzerland,8606033,Europe,24,0
CHE,2020-10,308,2,Switzerland,8606033,Europe,332,2
CHE,2020-11,1868,11,Switzerland,8606033,Europe,2200,13
CHE,2020-12,4771,47,Switzerland,8606033,Europe,6971,60
CHE,2020-13,7303,197,Switzerland,8606033,Europe,14274,257
CHE,2020-14,6748,302,Switzerland,8606033,Europe,21022,559
CHE,2020-15,4198,299,Switzerland,8606033,Europe,25220,858
CHE,2020-16,2438,276,Switzerland,8606033,Europe,27658,1134
CHE,2020-17,1320,202,Switzerland,8606033,Europe,28978,1336
CHE,2020-18,844,136,Switzerland,8606033,Europe,29822,1472
CHE,2020-19,400,65,Switzerland,8606033,Europe,30222,1537
CHE,2020-20,282,65,Switzerland,8606033,Europe,30504,1602
CHE,2020-21,149,39,Switzerland,8606033,Europe,30653,1641
CHE,2020-22,126,15,Switzerland,8606033,Europe,30779,1656
CHE,2020-23,103,4,Switzerland,8606033,Europe,30882,1660
CHE,2020-24,152,16,Switzerland,8606033,Europe,31034,1676
CHE,2020-25,175,3,Switzerland,8606033,Europe,31209,1679
CHE,2020-26,325,2,Switzerland,8606033,Europe,31534,1681
CHE,2020-27,650,4,Switzerland,8606033,Europe,32184,1685
CHE,2020-28,614,0,Switzerland,8606033,Europe,32798,1685
CHE,2020-29,706,2,Switzerland,8606033,Europe,33504,1687
CHE,2020-30,821,13,Switzerland,8606033,Europe,34325,1700
CHE,2020-31,1136,5,Switzerland,8606033,Europe,35461,1705
CHE,2020-32,1053,6,Switzerland,8606033,Europe,36514,1711
CHE,2020-33,1517,4,Switzerland,8606033,Europe,38031,1715
CHE,2020-34,1771,4,Switzerland,8606033,Europe,39802,1719
CHE,2020-35,2104,5,Switzerland,8606033,Europe,41906,1724
CHE,2020-36,2387,8,Switzerland,8606033,Europe,44293,1732
CHE,2020-37,2775,14,Switzerland,8606033,Europe,47068,1746
CHE,2020-38,2103,18,Switzerland,8606033,Europe,49171,1764
CHE,2020-39,2693,14,Switzerland,8606033,Europe,51864,1778
CHE,2020-40,2399,5,Switzerland,8606033,Europe,54263,1783
CHE,2020-41,5967,10,Switzerland,8606033,Europe,60230,1793
CHE,2020-42,14192,30,Switzerland,8606033,Europe,74422,1823
CHE,2020-43,28901,53,Switzerland,8606033,Europe,103323,1876
CHE,2020-44,50405,159,Switzerland,8606033,Europe,153728,2035
CHE,2020-45,57432,369,Switzerland,8606033,Europe,211160,2404
CHE,2020-46,45026,552,Switzerland,8606033,Europe,256186,2956
CHE,2020-47,33297,611,Switzerland,8606033,Europe,289483,3567
CHE,2020-48,27534,669,Switzerland,8606033,Europe,317017,4236
CHE,2020-49,26084,596,Switzerland,8606033,Europe,343101,4832
CHE,2020-50,29228,546,Switzerland,8606033,Europe,372329,5378
CHE,2020-51,39833,802,Switzerland,8606033,Europe,412162,6180
CHE,2020-52,24084,563,Switzerland,8606033,Europe,436246,6743
CHE,2020-53,23414,495,Switzerland,8606033,Europe,459660,7238
CHE,2021-01,22434,417,Switzerland,8606033,Europe,482094,7655
CHE,2021-02,15378,392,Switzerland,8606033,Europe,497472,8047
CHE,2021-03,13605,337,Switzerland,8606033,Europe,511077,8384
CHE,2021-04,11451,295,Switzerland,8606033,Europe,522528,8679
CHE,2021-05,10027,193,Switzerland,8606033,Europe,532555,8872
CHE,2021-06,8038,148,Switzerland,8606033,Europe,540593,9020
CHE,2021-07,7007,154,Switzerland,8606033,Europe,547600,9174
CHE,2021-08,7240,61,Switzerland,8606033,Europe,554840,9235
CHE,2021-09,7524,59,Switzerland,8606033,Europe,562364,9294
CHE,2021-10,8759,86,Switzerland,8606033,Europe,571123,9380
CHE,2021-11,10416,87,Switzerland,8606033,Europe,581539,9467
CHE,2021-12,12504,122,Switzerland,8606033,Europe,594043,9589
CHE,2021-13,14020,88,Switzerland,8606033,Europe,608063,9677
CHE,2021-14,15063,89,Switzerland,8606033,Europe,623126,9766
CHE,2021-15,11268,64,Switzerland,8606033,Europe,634394,9830
CHE,2021-16,14453,85,Switzerland,8606033,Europe,648847,9915
CHE,2021-17,12069,72,Switzerland,8606033,Europe,660916,9987
CHE,2021-18,10314,85,Switzerland,8606033,Europe,671230,10072
CHE,2021-19,7848,58,Switzerland,8606033,Europe,679078,10130
CHE,2021-20,7951,52,Switzerland,8606033,Europe,687029,10182
CHE,2021-21,4607,23,Switzerland,8606033,Europe,691636,10205
CHE,2021-22,3620,22,Switzerland,8606033,Europe,695256,10227
CHE,2021-23,2361,22,Switzerland,8606033,Europe,697617,10249
CHE,2021-24,1255,21,Switzerland,8606033,Europe,698872,10270
CHE,2021-25,747,19,Switzerland,8606033,Europe,699619,10289
CHE,2021-26,1026,16,Switzerland,8606033,Europe,700645,10305
CHE,2021-27,1969,9,Switzerland,8606033,Europe,702614,10314
CHE,2021-28,4116,7,Switzerland,8606033,Europe,706730,10321
CHE,2021-29,4507,11,Switzerland,8606033,Europe,711237,10332
CHE,2021-30,5257,14,Switzerland,8606033,Europe,716494,10346
CHE,2021-31,7413,8,Switzerland,8606033,Europe,723907,10354
CHE,2021-32,13779,16,Switzerland,8606033,Europe,737686,10370
CHL,2020-11,65,0,Chile,19116209,America,65,0
CHL,2020-12,557,1,Chile,19116209,America,622,1
CHL,2020-13,1507,6,Chile,19116209,America,2129,7
CHL,2020-14,2332,27,Chile,19116209,America,4461,34
CHL,2020-15,2742,46,Chile,19116209,America,7203,80
CHL,2020-16,2875,53,Chile,19116209,America,10078,133
CHL,2020-17,3243,56,Chile,19116209,America,13321,189
CHL,2020-18,6332,71,Chile,19116209,America,19653,260
CHL,2020-19,9203,52,Chile,19116209,America,28856,312
CHL,2020-20,14915,138,Chile,19116209,America,43771,450
CHL,2020-21,25321,268,Chile,19116209,America,69092,718
CHL,2020-22,30586,336,Chile,19116209,America,99678,1054
CHL,2020-23,34462,1136,Chile,19116209,America,134140,2190
CHL,2020-24,40143,1133,Chile,19116209,America,174283,3323
CHL,2020-25,68062,1156,Chile,19116209,America,242345,4479
CHL,2020-26,29627,1030,Chile,19116209,America,271972,5509
CHL,2020-27,23550,799,Chile,19116209,America,295522,6308
CHL,2020-28,19509,671,Chile,19116209,America,315031,6979
CHL,2020-29,15889,1524,Chile,19116209,America,330920,8503
CHL,2020-30,14860,609,Chile,19116209,America,345780,9112
CHL,2020-31,13941,496,Chile,19116209,America,359721,9608
CHL,2020-32,13325,469,Chile,19116209,America,373046,10077
CHL,2020-33,12890,375,Chile,19116209,America,385936,10452
CHL,2020-34,11719,400,Chile,19116209,America,397655,10852
CHL,2020-35,12309,392,Chile,19116209,America,409964,11244
CHL,2020-36,12536,348,Chile,19116209,America,422500,11592
CHL,2020-37,12238,357,Chile,19116209,America,434738,11949
CHL,2020-38,11526,337,Chile,19116209,America,446264,12286
CHL,2020-39,11627,355,Chile,19116209,America,457891,12641
CHL,2020-40,12278,338,Chile,19116209,America,470169,12979
CHL,2020-41,11192,339,Chile,19116209,America,481361,13318
CHL,2020-42,10389,317,Chile,19116209,America,491750,13635
CHL,2020-43,10303,309,Chile,19116209,America,502053,13944
CHL,2020-44,9801,303,Chile,19116209,America,511854,14247
CHL,2020-45,9694,296,Chile,19116209,America,521548,14543
CHL,2020-46,9715,276,Chile,19116209,America,531263,14819
CHL,2020-47,9367,250,Chile,19116209,America,540630,15069
CHL,2020-48,9790,287,Chile,19116209,America,550420,15356
CHL,2020-49,9952,272,Chile,19116209,America,560372,15628
CHL,2020-50,11537,258,Chile,19116209,America,571909,15886
CHL,2020-51,15569,311,Chile,19116209,America,587478,16197
CHL,2020-52,14540,246,Chile,19116209,America,602018,16443
CHL,2020-53,16163,324,Chile,19116209,America,618181,16767
CHL,2021-01,27701,395,Chile,19116209,America,645882,17162
CHL,2021-02,27858,385,Chile,19116209,America,673740,17547
CHL,2021-03,29428,452,Chile,19116209,America,703168,17999
CHL,2021-04,27710,538,Chile,19116209,America,730878,18537
CHL,2021-05,24462,519,Chile,19116209,America,755340,19056
CHL,2021-06,24191,568,Chile,19116209,America,779531,19624
CHL,2021-07,23468,502,Chile,19116209,America,802999,20126
CHL,2021-08,26761,534,Chile,19116209,America,829760,20660
CHL,2021-09,30763,503,Chile,19116209,America,860523,21163
CHL,2021-10,35698,609,Chile,19116209,America,896221,21772
CHL,2021-11,41863,587,Chile,19116209,America,938084,22359
CHL,2021-12,46390,711,Chile,19116209,America,984474,23070
CHL,2021-13,48128,607,Chile,19116209,America,1032602,23677
CHL,2021-14,50308,806,Chile,19116209,America,1082910,24483
CHL,2021-15,48420,794,Chile,19116209,America,1131330,25277
CHL,2021-16,44274,698,Chile,19116209,America,1175604,25975
CHL,2021-17,40201,684,Chile,19116209,America,1215805,26659
CHL,2021-18,36993,659,Chile,19116209,America,1252798,27318
CHL,2021-19,33740,514,Chile,19116209,America,1286538,27832
CHL,2021-20,48713,716,Chile,19116209,America,1335251,28548
CHL,2021-21,49085,752,Chile,19116209,America,1384336,29300
CHL,2021-22,50538,758,Chile,19116209,America,1434874,30058
CHL,2021-23,47779,746,Chile,19116209,America,1482653,30804
CHL,2021-24,34355,709,Chile,19116209,America,1517008,31513
CHL,2021-25,34119,941,Chile,19116209,America,1551127,32454
CHL,2021-26,21471,795,Chile,19116209,America,1572598,33249
CHL,2021-27,17015,731,Chile,19116209,America,1589613,33980
CHL,2021-28,11260,559,Chile,19116209,America,1600873,34539
CHL,2021-29,9462,580,Chile,19116209,America,1610335,35119
CHL,2021-30,7507,497,Chile,19116209,America,1617842,35616
CHL,2021-31,6464,491,Chile,19116209,America,1624306,36107
CHL,2021-32,5616,313,Chile,19116209,America,1629922,36420
CHN,2020-02,0,1,China,1439323774,Asia,0,1
CHN,2020-03,176,2,China,1439323774,Asia,176,3
CHN,2020-04,2540,78,China,1439323774,Asia,2716,81
CHN,2020-05,14436,280,China,1439323774,Asia,17152,361
CHN,2020-06,22995,548,China,1439323774,Asia,40147,909
CHN,2020-07,30412,862,China,1439323774,Asia,70559,1771
CHN,2020-08,6616,824,China,1439323774,Asia,77175,2595
CHN,2020-09,2900,319,China,1439323774,Asia,80075,2914
CHN,2020-10,725,208,China,1439323774,Asia,80800,3122
CHN,2020-11,161,94,China,1439323774,Asia,80961,3216
CHN,2020-12,464,58,China,1439323774,Asia,81425,3274
CHN,2020-13,673,32,China,1439323774,Asia,82098,3306
CHN,2020-14,485,29,China,1439323774,Asia,82583,3335
CHN,2020-15,567,10,China,1439323774,Asia,83150,3345
CHN,2020-16,608,1291,China,1439323774,Asia,83758,4636
CHN,2020-17,95,1,China,1439323774,Asia,83853,4637
CHN,2020-18,52,0,China,1439323774,Asia,83905,4637
CHN,2020-19,46,0,China,1439323774,Asia,83951,4637
CHN,2020-20,44,1,China,1439323774,Asia,83995,4638
CHN,2020-21,41,0,China,1439323774,Asia,84036,4638
CHN,2020-22,52,0,China,1439323774,Asia,84088,4638
CHN,2020-23,44,0,China,1439323774,Asia,84132,4638
CHN,2020-24,144,0,China,1439323774,Asia,84276,4638
CHN,2020-25,237,1,China,1439323774,Asia,84513,4639
CHN,2020-26,185,2,China,1439323774,Asia,84698,4641
CHN,2020-27,114,0,China,1439323774,Asia,84812,4641
CHN,2020-28,246,0,China,1439323774,Asia,85058,4641
CHN,2020-29,496,5,China,1439323774,Asia,85554,4646
CHN,2020-30,957,6,China,1439323774,Asia,86511,4652
CHN,2020-31,1415,17,China,1439323774,Asia,87926,4669
CHN,2020-32,808,17,China,1439323774,Asia,88734,4686
CHN,2020-33,582,17,China,1439323774,Asia,89316,4703
CHN,2020-34,320,8,China,1439323774,Asia,89636,4711
CHN,2020-35,200,11,China,1439323774,Asia,89836,4722
CHN,2020-36,163,8,China,1439323774,Asia,89999,4730
CHN,2020-37,139,4,China,1439323774,Asia,90138,4734
CHN,2020-38,172,3,China,1439323774,Asia,90310,4737
CHN,2020-39,114,2,China,1439323774,Asia,90424,4739
CHN,2020-40,146,0,China,1439323774,Asia,90570,4739
CHN,2020-41,183,0,China,1439323774,Asia,90753,4739
CHN,2020-42,160,0,China,1439323774,Asia,90913,4739
CHN,2020-43,179,0,China,1439323774,Asia,91092,4739
CHN,2020-44,196,0,China,1439323774,Asia,91288,4739
CHN,2020-45,213,0,China,1439323774,Asia,91501,4739
CHN,2020-46,76,0,China,1439323774,Asia,91577,4739
CHN,2020-47,95,0,China,1439323774,Asia,91672,4739
CHN,2020-48,83,0,China,1439323774,Asia,91755,4739
CHN,2020-49,104,0,China,1439323774,Asia,91859,4739
CHN,2020-50,103,0,China,1439323774,Asia,91962,4739
CHN,2020-51,3029,25,China,1439323774,Asia,94991,4764
CHN,2020-52,245,7,China,1439323774,Asia,95236,4771
CHN,2020-53,918,14,China,1439323774,Asia,96154,4785
CHN,2021-01,611,2,China,1439323774,Asia,96765,4787
CHN,2021-02,1115,10,China,1439323774,Asia,97880,4797
CHN,2021-03,1308,7,China,1439323774,Asia,99188,4804
CHN,2021-04,816,13,China,1439323774,Asia,100004,4817
CHN,2021-05,325,5,China,1439323774,Asia,100329,4822
CHN,2021-06,211,7,China,1439323774,Asia,100540,4829
CHN,2021-07,175,4,China,1439323774,Asia,100715,4833
CHN,2021-08,191,2,China,1439323774,Asia,100906,4835
CHN,2021-09,167,3,China,1439323774,Asia,101073,4838
CHN,2021-10,241,1,China,1439323774,Asia,101314,4839
CHN,2021-11,178,0,China,1439323774,Asia,101492,4839
CHN,2021-12,125,2,China,1439323774,Asia,101617,4841
CHN,2021-13,184,0,China,1439323774,Asia,101801,4841
CHN,2021-14,196,2,China,1439323774,Asia,101997,4843
CHN,2021-15,186,2,China,1439323774,Asia,102183,4845
CHN,2021-16,142,0,China,1439323774,Asia,102325,4845
CHN,2021-17,146,1,China,1439323774,Asia,102471,4846
CHN,2021-18,95,0,China,1439323774,Asia,102566,4846
CHN,2021-19,121,0,China,1439323774,Asia,102687,4846
CHN,2021-20,127,0,China,1439323774,Asia,102814,4846
CHN,2021-21,114,0,China,1439323774,Asia,102928,4846
CHN,2021-22,189,0,China,1439323774,Asia,103117,4846
CHN,2021-23,204,0,China,1439323774,Asia,103321,4846
CHN,2021-24,166,0,China,1439323774,Asia,103487,4846
CHN,2021-25,178,0,China,1439323774,Asia,103665,4846
CHN,2021-26,142,1,China,1439323774,Asia,103807,4847
CHN,2021-27,206,1,China,1439323774,Asia,104013,4848
CHN,2021-28,218,0,China,1439323774,Asia,104231,4848
CHN,2021-29,352,0,China,1439323774,Asia,104583,4848
CHN,2021-30,415,0,China,1439323774,Asia,104998,4848
CHN,2021-31,845,0,China,1439323774,Asia,105843,4848
CHN,2021-32,624,0,China,1439323774,Asia,106467,4848
CIV,2020-12,21,0,Cote Divoire,26378275,Africa,21,0
CIV,2020-13,140,1,Cote Divoire,26378275,Africa,161,1
CIV,2020-14,96,2,Cote Divoire,26378275,Africa,257,3
CIV,2020-15,313,2,Cote Divoire,26378275,Africa,570,5
CIV,2020-16,273,4,Cote Divoire,26378275,Africa,843,9
CIV,2020-17,303,5,Cote Divoire,26378275,Africa,1146,14
CIV,2020-18,248,3,Cote Divoire,26378275,Africa,1394,17
CIV,2020-19,302,4,Cote Divoire,26378275,Africa,1696,21
CIV,2020-20,409,6,Cote Divoire,26378275,Africa,2105,27
CIV,2020-21,267,3,Cote Divoire,26378275,Africa,2372,30
CIV,2020-22,457,3,Cote Divoire,26378275,Africa,2829,33
CIV,2020-23,906,3,Cote Divoire,26378275,Africa,3735,36
CIV,2020-24,1345,9,Cote Divoire,26378275,Africa,5080,45
CIV,2020-25,2408,6,Cote Divoire,26378275,Africa,7488,51
CIV,2020-26,1452,15,Cote Divoire,26378275,Africa,8940,66
CIV,2020-27,1828,8,Cote Divoire,26378275,Africa,10768,74
CIV,2020-28,1994,10,Cote Divoire,26378275,Africa,12762,84
CIV,2020-29,1353,8,Cote Divoire,26378275,Africa,14115,92
CIV,2020-30,1477,4,Cote Divoire,26378275,Africa,15592,96
CIV,2020-31,586,6,Cote Divoire,26378275,Africa,16178,102
CIV,2020-32,533,3,Cote Divoire,26378275,Africa,16711,105
CIV,2020-33,311,5,Cote Divoire,26378275,Africa,17022,110
CIV,2020-34,445,3,Cote Divoire,26378275,Africa,17467,113
CIV,2020-35,477,2,Cote Divoire,26378275,Africa,17944,115
CIV,2020-36,640,4,Cote Divoire,26378275,Africa,18584,119
CIV,2020-37,425,1,Cote Divoire,26378275,Africa,19009,120
CIV,2020-38,307,0,Cote Divoire,26378275,Africa,19316,120
CIV,2020-39,309,0,Cote Divoire,26378275,Africa,19625,120
CIV,2020-40,253,0,Cote Divoire,26378275,Africa,19878,120
CIV,2020-41,272,0,Cote Divoire,26378275,Africa,20150,120
CIV,2020-42,169,1,Cote Divoire,26378275,Africa,20319,121
CIV,2020-43,147,1,Cote Divoire,26378275,Africa,20466,122
CIV,2020-44,246,4,Cote Divoire,26378275,Africa,20712,126
CIV,2020-45,116,0,Cote Divoire,26378275,Africa,20828,126
CIV,2020-46,144,2,Cote Divoire,26378275,Africa,20972,128
CIV,2020-47,162,3,Cote Divoire,26378275,Africa,21134,131
CIV,2020-48,172,0,Cote Divoire,26378275,Africa,21306,131
CIV,2020-49,175,1,Cote Divoire,26378275,Africa,21481,132
CIV,2020-50,195,1,Cote Divoire,26378275,Africa,21676,133
CIV,2020-51,238,0,Cote Divoire,26378275,Africa,21914,133
CIV,2020-52,258,4,Cote Divoire,26378275,Africa,22172,137
CIV,2020-53,472,1,Cote Divoire,26378275,Africa,22644,138
CIV,2021-01,1102,1,Cote Divoire,26378275,Africa,23746,139
CIV,2021-02,1491,2,Cote Divoire,26378275,Africa,25237,141
CIV,2021-03,1609,5,Cote Divoire,26378275,Africa,26846,146
CIV,2021-04,844,5,Cote Divoire,26378275,Africa,27690,151
CIV,2021-05,1873,11,Cote Divoire,26378275,Africa,29563,162
CIV,2021-06,1573,12,Cote Divoire,26378275,Africa,31136,174
CIV,2021-07,886,12,Cote Divoire,26378275,Africa,32022,186
CIV,2021-08,605,6,Cote Divoire,26378275,Africa,32627,192
CIV,2021-09,2556,10,Cote Divoire,26378275,Africa,35183,202
CIV,2021-10,2466,9,Cote Divoire,26378275,Africa,37649,211
CIV,2021-11,2657,9,Cote Divoire,26378275,Africa,40306,220
CIV,2021-12,2870,17,Cote Divoire,26378275,Africa,43176,237
CIV,2021-13,1569,18,Cote Divoire,26378275,Africa,44745,255
CIV,2021-14,457,8,Cote Divoire,26378275,Africa,45202,263
CIV,2021-15,354,11,Cote Divoire,26378275,Africa,45556,274
CIV,2021-16,303,9,Cote Divoire,26378275,Africa,45859,283
CIV,2021-17,287,4,Cote Divoire,26378275,Africa,46146,287
CIV,2021-18,292,4,Cote Divoire,26378275,Africa,46438,291
CIV,2021-19,214,7,Cote Divoire,26378275,Africa,46652,298
CIV,2021-20,286,0,Cote Divoire,26378275,Africa,46938,298
CIV,2021-21,350,7,Cote Divoire,26378275,Africa,47288,305
CIV,2021-22,198,1,Cote Divoire,26378275,Africa,47486,306
CIV,2021-23,172,0,Cote Divoire,26378275,Africa,47658,306
CIV,2021-24,382,2,Cote Divoire,26378275,Africa,48040,308
CIV,2021-25,148,4,Cote Divoire,26378275,Africa,48188,312
CIV,2021-26,372,3,Cote Divoire,26378275,Africa,48560,315
CIV,2021-27,303,4,Cote Divoire,26378275,Africa,48863,319
CIV,2021-28,258,1,Cote Divoire,26378275,Africa,49121,320
CIV,2021-29,467,4,Cote Divoire,26378275,Africa,49588,324
CIV,2021-30,686,6,Cote Divoire,26378275,Africa,50274,330
CIV,2021-31,1102,11,Cote Divoire,26378275,Africa,51376,341
CIV,2021-32,168,6,Cote Divoire,26378275,Africa,51544,347
CMR,2020-11,2,0,Cameroon,26545864,Africa,2,0
CMR,2020-12,23,0,Cameroon,26545864,Africa,25,0
CMR,2020-13,72,2,Cameroon,26545864,Africa,97,2
CMR,2020-14,551,7,Cameroon,26545864,Africa,648,9
CMR,2020-15,170,3,Cameroon,26545864,Africa,818,12
CMR,2020-16,196,30,Cameroon,26545864,Africa,1014,42
CMR,2020-17,605,14,Cameroon,26545864,Africa,1619,56
CMR,2020-18,456,8,Cameroon,26545864,Africa,2075,64
CMR,2020-19,502,50,Cameroon,26545864,Africa,2577,114
CMR,2020-20,713,26,Cameroon,26545864,Africa,3290,140
CMR,2020-21,1598,25,Cameroon,26545864,Africa,4888,165
CMR,2020-22,1014,26,Cameroon,26545864,Africa,5902,191
CMR,2020-23,2004,12,Cameroon,26545864,Africa,7906,203
CMR,2020-24,1956,73,Cameroon,26545864,Africa,9862,276
CMR,2020-25,1746,25,Cameroon,26545864,Africa,11608,301
CMR,2020-26,982,12,Cameroon,26545864,Africa,12590,313
CMR,2020-27,1119,15,Cameroon,26545864,Africa,13709,328
CMR,2020-28,1462,31,Cameroon,26545864,Africa,15171,359
CMR,2020-29,984,14,Cameroon,26545864,Africa,16155,373
CMR,2020-30,551,12,Cameroon,26545864,Africa,16706,385
CMR,2020-31,547,2,Cameroon,26545864,Africa,17253,387
CMR,2020-32,787,8,Cameroon,26545864,Africa,18040,395
CMR,2020-33,427,6,Cameroon,26545864,Africa,18467,401
CMR,2020-34,293,7,Cameroon,26545864,Africa,18760,408
CMR,2020-35,380,3,Cameroon,26545864,Africa,19140,411
CMR,2020-36,462,3,Cameroon,26545864,Africa,19602,414
CMR,2020-37,563,1,Cameroon,26545864,Africa,20165,415
CMR,2020-38,264,1,Cameroon,26545864,Africa,20429,416
CMR,2020-39,304,2,Cameroon,26545864,Africa,20733,418
CMR,2020-40,189,2,Cameroon,26545864,Africa,20922,420
CMR,2020-41,279,3,Cameroon,26545864,Africa,21201,423
CMR,2020-42,238,0,Cameroon,26545864,Africa,21439,423
CMR,2020-43,129,2,Cameroon,26545864,Africa,21568,425
CMR,2020-44,223,1,Cameroon,26545864,Africa,21791,426
CMR,2020-45,628,7,Cameroon,26545864,Africa,22419,433
CMR,2020-46,271,0,Cameroon,26545864,Africa,22690,433
CMR,2020-47,836,2,Cameroon,26545864,Africa,23526,435
CMR,2020-48,589,2,Cameroon,26545864,Africa,24115,437
CMR,2020-49,635,6,Cameroon,26545864,Africa,24750,443
CMR,2020-50,607,2,Cameroon,26545864,Africa,25357,445
CMR,2020-51,490,3,Cameroon,26545864,Africa,25847,448
CMR,2020-52,428,0,Cameroon,26545864,Africa,26275,448
CMR,2020-53,571,0,Cameroon,26545864,Africa,26846,448
CMR,2021-01,0,0,Cameroon,26545864,Africa,26846,448
CMR,2021-02,1162,7,Cameroon,26545864,Africa,28008,455
CMR,2021-03,1607,7,Cameroon,26545864,Africa,29615,462
CMR,2021-04,696,12,Cameroon,26545864,Africa,30311,474
CMR,2021-05,1081,0,Cameroon,26545864,Africa,31392,474
CMR,2021-06,0,0,Cameroon,26545864,Africa,31392,474
CMR,2021-07,2355,49,Cameroon,26545864,Africa,33747,523
CMR,2021-08,1965,28,Cameroon,26545864,Africa,35712,551
CMR,2021-09,3274,37,Cameroon,26545864,Africa,38986,588
CMR,2021-10,0,0,Cameroon,26545864,Africa,38986,588
CMR,2021-11,0,0,Cameroon,26545864,Africa,38986,588
CMR,2021-12,8681,133,Cameroon,26545864,Africa,47667,721
CMR,2021-13,6251,58,Cameroon,26545864,Africa,53918,779
CMR,2021-14,3417,72,Cameroon,26545864,Africa,57335,851
CMR,2021-15,4394,68,Cameroon,26545864,Africa,61729,919
CMR,2021-16,4267,72,Cameroon,26545864,Africa,65996,991
CMR,2021-17,4609,73,Cameroon,26545864,Africa,70605,1064
CMR,2021-18,4126,80,Cameroon,26545864,Africa,74731,1144
CMR,2021-19,2696,45,Cameroon,26545864,Africa,77427,1189
CMR,2021-20,304,50,Cameroon,26545864,Africa,77731,1239
CMR,2021-21,249,31,Cameroon,26545864,Africa,77980,1270
CMR,2021-22,947,5,Cameroon,26545864,Africa,78927,1275
CMR,2021-23,975,27,Cameroon,26545864,Africa,79902,1302
CMR,2021-24,186,8,Cameroon,26545864,Africa,80088,1310
CMR,2021-25,397,10,Cameroon,26545864,Africa,80485,1320
CMR,2021-26,371,4,Cameroon,26545864,Africa,80856,1324
CMR,2021-27,0,0,Cameroon,26545864,Africa,80856,1324
CMR,2021-28,609,6,Cameroon,26545864,Africa,81465,1330
CMR,2021-29,597,4,Cameroon,26545864,Africa,82062,1334
CMR,2021-30,0,0,Cameroon,26545864,Africa,82062,1334
CMR,2021-31,0,0,Cameroon,26545864,Africa,82062,1334
CMR,2021-32,390,4,Cameroon,26545864,Africa,82452,1338
COD,2020-12,24,2,Democratic Republic Of The Congo,89561404,Africa,24,2
COD,2020-13,55,6,Democratic Republic Of The Congo,89561404,Africa,79,8
COD,2020-14,73,10,Democratic Republic Of The Congo,89561404,Africa,152,18
COD,2020-15,80,2,Democratic Republic Of The Congo,89561404,Africa,232,20
COD,2020-16,98,5,Democratic Republic Of The Congo,89561404,Africa,330,25
COD,2020-17,127,3,Democratic Republic Of The Congo,89561404,Africa,457,28
COD,2020-18,225,6,Democratic Republic Of The Congo,89561404,Africa,682,34
COD,2020-19,340,7,Democratic Republic Of The Congo,89561404,Africa,1022,41
COD,2020-20,430,19,Democratic Republic Of The Congo,89561404,Africa,1452,60
COD,2020-21,843,7,Democratic Republic Of The Congo,89561404,Africa,2295,67
COD,2020-22,752,4,Democratic Republic Of The Congo,89561404,Africa,3047,71
COD,2020-23,967,14,Democratic Republic Of The Congo,89561404,Africa,4014,85
COD,2020-24,761,21,Democratic Republic Of The Congo,89561404,Africa,4775,106
COD,2020-25,1049,24,Democratic Republic Of The Congo,89561404,Africa,5824,130
COD,2020-26,1000,27,Democratic Republic Of The Congo,89561404,Africa,6824,157
COD,2020-27,584,24,Democratic Republic Of The Congo,89561404,Africa,7408,181
COD,2020-28,622,7,Democratic Republic Of The Congo,89561404,Africa,8030,188
COD,2020-29,370,5,Democratic Republic Of The Congo,89561404,Africa,8400,193
COD,2020-30,429,11,Democratic Republic Of The Congo,89561404,Africa,8829,204
COD,2020-31,283,10,Democratic Republic Of The Congo,89561404,Africa,9112,214
COD,2020-32,339,9,Democratic Republic Of The Congo,89561404,Africa,9451,223
COD,2020-33,222,16,Democratic Republic Of The Congo,89561404,Africa,9673,239
COD,2020-34,154,11,Democratic Republic Of The Congo,89561404,Africa,9827,250
COD,2020-35,215,7,Democratic Republic Of The Congo,89561404,Africa,10042,257
COD,2020-36,165,2,Democratic Republic Of The Congo,89561404,Africa,10207,259
COD,2020-37,180,5,Democratic Republic Of The Congo,89561404,Africa,10387,264
COD,2020-38,125,6,Democratic Republic Of The Congo,89561404,Africa,10512,270
COD,2020-39,97,0,Democratic Republic Of The Congo,89561404,Africa,10609,270
COD,2020-40,148,3,Democratic Republic Of The Congo,89561404,Africa,10757,273
COD,2020-41,91,2,Democratic Republic Of The Congo,89561404,Africa,10848,275
COD,2020-42,201,27,Democratic Republic Of The Congo,89561404,Africa,11049,302
COD,2020-43,91,2,Democratic Republic Of The Congo,89561404,Africa,11140,304
COD,2020-44,229,3,Democratic Republic Of The Congo,89561404,Africa,11369,307
COD,2020-45,236,8,Democratic Republic Of The Congo,89561404,Africa,11605,315
COD,2020-46,182,4,Democratic Republic Of The Congo,89561404,Africa,11787,319
COD,2020-47,450,8,Democratic Republic Of The Congo,89561404,Africa,12237,327
COD,2020-48,462,5,Democratic Republic Of The Congo,89561404,Africa,12699,332
COD,2020-49,893,11,Democratic Republic Of The Congo,89561404,Africa,13592,343
COD,2020-50,918,12,Democratic Republic Of The Congo,89561404,Africa,14510,355
COD,2020-51,1297,210,Democratic Republic Of The Congo,89561404,Africa,15807,565
COD,2020-52,1107,13,Democratic Republic Of The Congo,89561404,Africa,16914,578
COD,2020-53,1236,20,Democratic Republic Of The Congo,89561404,Africa,18150,598
COD,2021-01,1343,20,Democratic Republic Of The Congo,89561404,Africa,19493,618
COD,2021-02,1564,15,Democratic Republic Of The Congo,89561404,Africa,21057,633
COD,2021-03,895,28,Democratic Republic Of The Congo,89561404,Africa,21952,661
COD,2021-04,888,12,Democratic Republic Of The Congo,89561404,Africa,22840,673
COD,2021-05,757,8,Democratic Republic Of The Congo,89561404,Africa,23597,681
COD,2021-06,787,12,Democratic Republic Of The Congo,89561404,Africa,24384,693
COD,2021-07,694,7,Democratic Republic Of The Congo,89561404,Africa,25078,700
COD,2021-08,833,7,Democratic Republic Of The Congo,89561404,Africa,25911,707
COD,2021-09,713,4,Democratic Republic Of The Congo,89561404,Africa,26624,711
COD,2021-10,450,6,Democratic Republic Of The Congo,89561404,Africa,27074,717
COD,2021-11,496,9,Democratic Republic Of The Congo,89561404,Africa,27570,726
COD,2021-12,440,13,Democratic Republic Of The Congo,89561404,Africa,28010,739
COD,2021-13,341,6,Democratic Republic Of The Congo,89561404,Africa,28351,745
COD,2021-14,257,0,Democratic Republic Of The Congo,89561404,Africa,28608,745
COD,2021-15,394,0,Democratic Republic Of The Congo,89561404,Africa,29002,745
COD,2021-16,607,11,Democratic Republic Of The Congo,89561404,Africa,29609,756
COD,2021-17,354,12,Democratic Republic Of The Congo,89561404,Africa,29963,768
COD,2021-18,384,4,Democratic Republic Of The Congo,89561404,Africa,30347,772
COD,2021-19,259,4,Democratic Republic Of The Congo,89561404,Africa,30606,776
COD,2021-20,255,3,Democratic Republic Of The Congo,89561404,Africa,30861,779
COD,2021-21,787,3,Democratic Republic Of The Congo,89561404,Africa,31648,782
COD,2021-22,1687,23,Democratic Republic Of The Congo,89561404,Africa,33335,805
COD,2021-23,2331,41,Democratic Republic Of The Congo,89561404,Africa,35666,846
COD,2021-24,2258,33,Democratic Republic Of The Congo,89561404,Africa,37924,879
COD,2021-25,2512,37,Democratic Republic Of The Congo,89561404,Africa,40436,916
COD,2021-26,2179,46,Democratic Republic Of The Congo,89561404,Africa,42615,962
COD,2021-27,1714,22,Democratic Republic Of The Congo,89561404,Africa,44329,984
COD,2021-28,2025,34,Democratic Republic Of The Congo,89561404,Africa,46354,1018
COD,2021-29,2146,5,Democratic Republic Of The Congo,89561404,Africa,48500,1023
COD,2021-30,1690,15,Democratic Republic Of The Congo,89561404,Africa,50190,1038
COD,2021-31,1793,10,Democratic Republic Of The Congo,89561404,Africa,51983,1048
COD,2021-32,1360,2,Democratic Republic Of The Congo,89561404,Africa,53343,1050
COG,2020-12,3,0,Congo,5518092,Africa,3,0
COG,2020-13,15,0,Congo,5518092,Africa,18,0
COG,2020-14,26,5,Congo,5518092,Africa,44,5
COG,2020-15,25,0,Congo,5518092,Africa,69,5
COG,2020-16,90,1,Congo,5518092,Africa,159,6
COG,2020-17,40,2,Congo,5518092,Africa,199,8
COG,2020-18,29,2,Congo,5518092,Africa,228,10
COG,2020-19,58,0,Congo,5518092,Africa,286,10
COG,2020-20,125,5,Congo,5518092,Africa,411,15
COG,2020-21,75,1,Congo,5518092,Africa,486,16
COG,2020-22,124,4,Congo,5518092,Africa,610,20
COG,2020-23,72,2,Congo,5518092,Africa,682,22
COG,2020-24,96,3,Congo,5518092,Africa,778,25
COG,2020-25,234,3,Congo,5518092,Africa,1012,28
COG,2020-26,232,12,Congo,5518092,Africa,1244,40
COG,2020-27,312,4,Congo,5518092,Africa,1556,44
COG,2020-28,546,3,Congo,5518092,Africa,2102,47
COG,2020-29,530,2,Congo,5518092,Africa,2632,49
COG,2020-30,405,2,Congo,5518092,Africa,3037,51
COG,2020-31,349,5,Congo,5518092,Africa,3386,56
COG,2020-32,277,2,Congo,5518092,Africa,3663,58
COG,2020-33,171,18,Congo,5518092,Africa,3834,76
COG,2020-34,15,1,Congo,5518092,Africa,3849,77
COG,2020-35,129,1,Congo,5518092,Africa,3978,78
COG,2020-36,649,4,Congo,5518092,Africa,4627,82
COG,2020-37,306,6,Congo,5518092,Africa,4933,88
COG,2020-38,52,1,Congo,5518092,Africa,4985,89
COG,2020-39,22,0,Congo,5518092,Africa,5007,89
COG,2020-40,81,0,Congo,5518092,Africa,5088,89
COG,2020-41,29,1,Congo,5518092,Africa,5117,90
COG,2020-42,38,2,Congo,5518092,Africa,5155,92
COG,2020-43,97,0,Congo,5518092,Africa,5252,92
COG,2020-44,37,0,Congo,5518092,Africa,5289,92
COG,2020-45,89,0,Congo,5518092,Africa,5378,92
COG,2020-46,0,0,Congo,5518092,Africa,5378,92
COG,2020-47,253,0,Congo,5518092,Africa,5631,92
COG,2020-48,142,2,Congo,5518092,Africa,5773,94
COG,2020-49,0,0,Congo,5518092,Africa,5773,94
COG,2020-50,426,6,Congo,5518092,Africa,6199,100
COG,2020-51,0,0,Congo,5518092,Africa,6199,100
COG,2020-52,371,0,Congo,5518092,Africa,6570,100
COG,2020-53,536,8,Congo,5518092,Africa,7106,108
COG,2021-01,110,0,Congo,5518092,Africa,7216,108
COG,2021-02,492,6,Congo,5518092,Africa,7708,114
COG,2021-03,85,3,Congo,5518092,Africa,7793,117
COG,2021-04,93,1,Congo,5518092,Africa,7886,118
COG,2021-05,173,4,Congo,5518092,Africa,8059,122
COG,2021-06,359,1,Congo,5518092,Africa,8418,123
COG,2021-07,206,4,Congo,5518092,Africa,8624,127
COG,2021-08,195,1,Congo,5518092,Africa,8819,128
COG,2021-09,359,3,Congo,5518092,Africa,9178,131
COG,2021-10,150,0,Congo,5518092,Africa,9328,131
COG,2021-11,235,3,Congo,5518092,Africa,9563,134
COG,2021-12,117,1,Congo,5518092,Africa,9680,135
COG,2021-13,0,0,Congo,5518092,Africa,9680,135
COG,2021-14,403,2,Congo,5518092,Africa,10083,137
COG,2021-15,0,0,Congo,5518092,Africa,10083,137
COG,2021-16,594,7,Congo,5518092,Africa,10677,144
COG,2021-17,0,0,Congo,5518092,Africa,10677,144
COG,2021-18,469,4,Congo,5518092,Africa,11146,148
COG,2021-19,196,0,Congo,5518092,Africa,11342,148
COG,2021-20,133,2,Congo,5518092,Africa,11475,150
COG,2021-21,182,3,Congo,5518092,Africa,11657,153
COG,2021-22,262,2,Congo,5518092,Africa,11919,155
COG,2021-23,0,0,Congo,5518092,Africa,11919,155
COG,2021-24,378,6,Congo,5518092,Africa,12297,161
COG,2021-25,187,4,Congo,5518092,Africa,12484,165
COG,2021-26,210,1,Congo,5518092,Africa,12694,166
COG,2021-27,95,1,Congo,5518092,Africa,12789,167
COG,2021-28,143,5,Congo,5518092,Africa,12932,172
COG,2021-29,184,4,Congo,5518092,Africa,13116,176
COG,2021-30,69,2,Congo,5518092,Africa,13185,178
COG,2021-31,107,1,Congo,5518092,Africa,13292,179
COG,2021-32,63,0,Congo,5518092,Africa,13355,179
COL,2020-12,190,2,Colombia,50882884,America,190,2
COL,2020-13,467,8,Colombia,50882884,America,657,10
COL,2020-14,783,25,Colombia,50882884,America,1440,35
COL,2020-15,1291,74,Colombia,50882884,America,2731,109
COL,2020-16,1016,70,Colombia,50882884,America,3747,179
COL,2020-17,1587,64,Colombia,50882884,America,5334,243
COL,2020-18,2289,97,Colombia,50882884,America,7623,340
COL,2020-19,3395,123,Colombia,50882884,America,11018,463
COL,2020-20,4511,111,Colombia,50882884,America,15529,574
COL,2020-21,5601,153,Colombia,50882884,America,21130,727
COL,2020-22,8208,212,Colombia,50882884,America,29338,939
COL,2020-23,9853,320,Colombia,50882884,America,39191,1259
COL,2020-24,11703,408,Colombia,50882884,America,50894,1667
COL,2020-25,17713,570,Colombia,50882884,America,68607,2237
COL,2020-26,23117,869,Colombia,50882884,America,91724,3106
COL,2020-27,25341,958,Colombia,50882884,America,117065,4064
COL,2020-28,33335,1243,Colombia,50882884,America,150400,5307
COL,2020-29,46833,1429,Colombia,50882884,America,197233,6736
COL,2020-30,51698,1789,Colombia,50882884,America,248931,8525
COL,2020-31,68675,2125,Colombia,50882884,America,317606,10650
COL,2020-32,69830,2192,Colombia,50882884,America,387436,12842
COL,2020-33,80851,2255,Colombia,50882884,America,468287,15097
COL,2020-34,72815,2219,Colombia,50882884,America,541102,17316
COL,2020-35,66791,2048,Colombia,50882884,America,607893,19364
COL,2020-36,58583,2048,Colombia,50882884,America,666476,21412
COL,2020-37,49798,1512,Colombia,50882884,America,716274,22924
COL,2020-38,48757,1284,Colombia,50882884,America,765031,24208
COL,2020-39,47980,1280,Colombia,50882884,America,813011,25488
COL,2020-40,41996,1224,Colombia,50882884,America,855007,26712
COL,2020-41,56264,1122,Colombia,50882884,America,911271,27834
COL,2020-42,48256,1136,Colombia,50882884,America,959527,28970
COL,2020-43,56313,1184,Colombia,50882884,America,1015840,30154
COL,2020-44,67436,1361,Colombia,50882884,America,1083276,31515
COL,2020-45,60566,1276,Colombia,50882884,America,1143842,32791
COL,2020-46,54859,1240,Colombia,50882884,America,1198701,34031
COL,2020-47,49671,1256,Colombia,50882884,America,1248372,35287
COL,2020-48,59959,1297,Colombia,50882884,America,1308331,36584
COL,2020-49,62727,1224,Colombia,50882884,America,1371058,37808
COL,2020-50,54671,1245,Colombia,50882884,America,1425729,39053
COL,2020-51,92293,1627,Colombia,50882884,America,1518022,40680
COL,2020-52,85740,1694,Colombia,50882884,America,1603762,42374
COL,2020-53,72013,1591,Colombia,50882884,America,1675775,43965
COL,2021-01,126083,2486,Colombia,50882884,America,1801858,46451
COL,2021-02,121229,2553,Colombia,50882884,America,1923087,49004
COL,2021-03,104614,2743,Colombia,50882884,America,2027701,51747
COL,2021-04,76760,2525,Colombia,50882884,America,2104461,54272
COL,2021-05,56956,2018,Colombia,50882884,America,2161417,56290
COL,2021-06,37087,1496,Colombia,50882884,America,2198504,57786
COL,2021-07,31114,1188,Colombia,50882884,America,2229618,58974
COL,2021-08,25597,892,Colombia,50882884,America,2255215,59866
COL,2021-09,23601,732,Colombia,50882884,America,2278816,60598
COL,2021-10,27023,645,Colombia,50882884,America,2305839,61243
COL,2021-11,36394,905,Colombia,50882884,America,2342233,62148
COL,2021-12,47501,931,Colombia,50882884,America,2389734,63079
COL,2021-13,66630,1214,Colombia,50882884,America,2456364,64293
COL,2021-14,96528,1863,Colombia,50882884,America,2552892,66156
COL,2021-15,114199,2592,Colombia,50882884,America,2667091,68748
COL,2021-16,120167,3051,Colombia,50882884,America,2787258,71799
COL,2021-17,117951,3365,Colombia,50882884,America,2905209,75164
COL,2021-18,110047,3178,Colombia,50882884,America,3015256,78342
COL,2021-19,103125,2958,Colombia,50882884,America,3118381,81300
COL,2021-20,131007,3907,Colombia,50882884,America,3249388,85207
COL,2021-21,157023,3567,Colombia,50882884,America,3406411,88774
COL,2021-22,186560,3722,Colombia,50882884,America,3592971,92496
COL,2021-23,184584,3870,Colombia,50882884,America,3777555,96366
COL,2021-24,190805,4216,Colombia,50882884,America,3968360,100582
COL,2021-25,218789,4744,Colombia,50882884,America,4187149,105326
COL,2021-26,188667,4140,Colombia,50882884,America,4375816,109466
COL,2021-27,154749,3869,Colombia,50882884,America,4530565,113335
COL,2021-28,125311,3418,Colombia,50882884,America,4655876,116753
COL,2021-29,80428,2429,Colombia,50882884,America,4736304,119182
COL,2021-30,64701,2034,Colombia,50882884,America,4801005,121216
COL,2021-31,41957,1385,Colombia,50882884,America,4842962,122601
COL,2021-32,27915,979,Colombia,50882884,America,4870877,123580
COM,2020-19,8,1,Comoros,869595,Africa,8,1
COM,2020-20,0,0,Comoros,869595,Africa,8,1
COM,2020-21,76,0,Comoros,869595,Africa,84,1
COM,2020-22,19,1,Comoros,869595,Africa,103,2
COM,2020-23,35,0,Comoros,869595,Africa,138,2
COM,2020-24,35,0,Comoros,869595,Africa,173,2
COM,2020-25,71,3,Comoros,869595,Africa,244,5
COM,2020-26,25,2,Comoros,869595,Africa,269,7
COM,2020-27,39,0,Comoros,869595,Africa,308,7
COM,2020-28,6,0,Comoros,869595,Africa,314,7
COM,2020-29,17,0,Comoros,869595,Africa,331,7
COM,2020-30,6,0,Comoros,869595,Africa,337,7
COM,2020-31,46,0,Comoros,869595,Africa,383,7
COM,2020-32,13,0,Comoros,869595,Africa,396,7
COM,2020-33,6,0,Comoros,869595,Africa,402,7
COM,2020-34,12,0,Comoros,869595,Africa,414,7
COM,2020-35,6,0,Comoros,869595,Africa,420,7
COM,2020-36,29,0,Comoros,869595,Africa,449,7
COM,2020-37,4,0,Comoros,869595,Africa,453,7
COM,2020-38,14,0,Comoros,869595,Africa,467,7
COM,2020-39,8,0,Comoros,869595,Africa,475,7
COM,2020-40,9,0,Comoros,869595,Africa,484,7
COM,2020-41,8,0,Comoros,869595,Africa,492,7
COM,2020-42,7,0,Comoros,869595,Africa,499,7
COM,2020-43,15,0,Comoros,869595,Africa,514,7
COM,2020-44,28,0,Comoros,869595,Africa,542,7
COM,2020-45,18,0,Comoros,869595,Africa,560,7
COM,2020-46,16,0,Comoros,869595,Africa,576,7
COM,2020-47,17,0,Comoros,869595,Africa,593,7
COM,2020-48,15,0,Comoros,869595,Africa,608,7
COM,2020-49,5,0,Comoros,869595,Africa,613,7
COM,2020-50,12,0,Comoros,869595,Africa,625,7
COM,2020-51,38,0,Comoros,869595,Africa,663,7
COM,2020-52,65,0,Comoros,869595,Africa,728,7
COM,2020-53,133,6,Comoros,869595,Africa,861,13
COM,2021-01,296,5,Comoros,869595,Africa,1157,18
COM,2021-02,432,27,Comoros,869595,Africa,1589,45
COM,2021-03,676,26,Comoros,869595,Africa,2265,71
COM,2021-04,543,27,Comoros,869595,Africa,2808,98
COM,2021-05,277,14,Comoros,869595,Africa,3085,112
COM,2021-06,246,17,Comoros,869595,Africa,3331,129
COM,2021-07,168,14,Comoros,869595,Africa,3499,143
COM,2021-08,69,1,Comoros,869595,Africa,3568,144
COM,2021-09,30,2,Comoros,869595,Africa,3598,146
COM,2021-10,34,0,Comoros,869595,Africa,3632,146
COM,2021-11,31,0,Comoros,869595,Africa,3663,146
COM,2021-12,24,0,Comoros,869595,Africa,3687,146
COM,2021-13,29,0,Comoros,869595,Africa,3716,146
COM,2021-14,70,0,Comoros,869595,Africa,3786,146
COM,2021-15,30,0,Comoros,869595,Africa,3816,146
COM,2021-16,10,0,Comoros,869595,Africa,3826,146
COM,2021-17,11,0,Comoros,869595,Africa,3837,146
COM,2021-18,14,0,Comoros,869595,Africa,3851,146
COM,2021-19,9,0,Comoros,869595,Africa,3860,146
COM,2021-20,9,0,Comoros,869595,Africa,3869,146
COM,2021-21,9,0,Comoros,869595,Africa,3878,146
COM,2021-22,7,0,Comoros,869595,Africa,3885,146
COM,2021-23,11,0,Comoros,869595,Africa,3896,146
COM,2021-24,10,0,Comoros,869595,Africa,3906,146
COM,2021-25,16,0,Comoros,869595,Africa,3922,146
COM,2021-26,33,0,Comoros,869595,Africa,3955,146
COM,2021-27,38,0,Comoros,869595,Africa,3993,146
COM,2021-28,15,1,Comoros,869595,Africa,4008,147
COM,2021-29,10,0,Comoros,869595,Africa,4018,147
COM,2021-30,7,0,Comoros,869595,Africa,4025,147
COM,2021-31,3,0,Comoros,869595,Africa,4028,147
COM,2021-32,50,0,Comoros,869595,Africa,4078,147
CPV,2020-13,2,1,Cape Verde,555988,Africa,2,1
CPV,2020-14,2,0,Cape Verde,555988,Africa,4,1
CPV,2020-15,3,0,Cape Verde,555988,Africa,7,1
CPV,2020-16,51,0,Cape Verde,555988,Africa,58,1
CPV,2020-17,45,0,Cape Verde,555988,Africa,103,1
CPV,2020-18,59,1,Cape Verde,555988,Africa,162,2
CPV,2020-19,81,0,Cape Verde,555988,Africa,243,2
CPV,2020-20,82,1,Cape Verde,555988,Africa,325,3
CPV,2020-21,52,0,Cape Verde,555988,Africa,377,3
CPV,2020-22,55,1,Cape Verde,555988,Africa,432,4
CPV,2020-23,119,1,Cape Verde,555988,Africa,551,5
CPV,2020-24,196,1,Cape Verde,555988,Africa,747,6
CPV,2020-25,140,2,Cape Verde,555988,Africa,887,8
CPV,2020-26,265,4,Cape Verde,555988,Africa,1152,12
CPV,2020-27,296,5,Cape Verde,555988,Africa,1448,17
CPV,2020-28,247,2,Cape Verde,555988,Africa,1695,19
CPV,2020-29,345,2,Cape Verde,555988,Africa,2040,21
CPV,2020-30,264,1,Cape Verde,555988,Africa,2304,22
CPV,2020-31,240,2,Cape Verde,555988,Africa,2544,24
CPV,2020-32,311,8,Cape Verde,555988,Africa,2855,32
CPV,2020-33,321,3,Cape Verde,555988,Africa,3176,35
CPV,2020-34,330,2,Cape Verde,555988,Africa,3506,37
CPV,2020-35,343,3,Cape Verde,555988,Africa,3849,40
CPV,2020-36,478,2,Cape Verde,555988,Africa,4327,42
CPV,2020-37,483,2,Cape Verde,555988,Africa,4810,44
CPV,2020-38,444,7,Cape Verde,555988,Africa,5254,51
CPV,2020-39,514,6,Cape Verde,555988,Africa,5768,57
CPV,2020-40,589,8,Cape Verde,555988,Africa,6357,65
CPV,2020-41,712,10,Cape Verde,555988,Africa,7069,75
CPV,2020-42,680,11,Cape Verde,555988,Africa,7749,86
CPV,2020-43,644,8,Cape Verde,555988,Africa,8393,94
CPV,2020-44,452,1,Cape Verde,555988,Africa,8845,95
CPV,2020-45,521,5,Cape Verde,555988,Africa,9366,100
CPV,2020-46,453,3,Cape Verde,555988,Africa,9819,103
CPV,2020-47,454,1,Cape Verde,555988,Africa,10273,104
CPV,2020-48,250,0,Cape Verde,555988,Africa,10523,104
CPV,2020-49,537,5,Cape Verde,555988,Africa,11060,109
CPV,2020-50,294,1,Cape Verde,555988,Africa,11354,110
CPV,2020-51,222,1,Cape Verde,555988,Africa,11576,111
CPV,2020-52,144,1,Cape Verde,555988,Africa,11720,112
CPV,2020-53,197,1,Cape Verde,555988,Africa,11917,113
CPV,2021-01,513,2,Cape Verde,555988,Africa,12430,115
CPV,2021-02,560,4,Cape Verde,555988,Africa,12990,119
CPV,2021-03,496,11,Cape Verde,555988,Africa,13486,130
CPV,2021-04,609,4,Cape Verde,555988,Africa,14095,134
CPV,2021-05,353,2,Cape Verde,555988,Africa,14448,136
CPV,2021-06,290,3,Cape Verde,555988,Africa,14738,139
CPV,2021-07,307,5,Cape Verde,555988,Africa,15045,144
CPV,2021-08,352,3,Cape Verde,555988,Africa,15397,147
CPV,2021-09,382,7,Cape Verde,555988,Africa,15779,154
CPV,2021-10,319,2,Cape Verde,555988,Africa,16098,156
CPV,2021-11,390,3,Cape Verde,555988,Africa,16488,159
CPV,2021-12,634,6,Cape Verde,555988,Africa,17122,165
CPV,2021-13,746,8,Cape Verde,555988,Africa,17868,173
CPV,2021-14,1134,9,Cape Verde,555988,Africa,19002,182
CPV,2021-15,1461,9,Cape Verde,555988,Africa,20463,191
CPV,2021-16,1892,12,Cape Verde,555988,Africa,22355,203
CPV,2021-17,2190,17,Cape Verde,555988,Africa,24545,220
CPV,2021-18,1893,12,Cape Verde,555988,Africa,26438,232
CPV,2021-19,1727,17,Cape Verde,555988,Africa,28165,249
CPV,2021-20,1166,7,Cape Verde,555988,Africa,29331,256
CPV,2021-21,1025,8,Cape Verde,555988,Africa,30356,264
CPV,2021-22,738,3,Cape Verde,555988,Africa,31094,267
CPV,2021-23,474,6,Cape Verde,555988,Africa,31568,273
CPV,2021-24,468,10,Cape Verde,555988,Africa,32036,283
CPV,2021-25,333,3,Cape Verde,555988,Africa,32369,286
CPV,2021-26,363,2,Cape Verde,555988,Africa,32732,288
CPV,2021-27,271,1,Cape Verde,555988,Africa,33003,289
CPV,2021-28,296,6,Cape Verde,555988,Africa,33299,295
CPV,2021-29,275,3,Cape Verde,555988,Africa,33574,298
CPV,2021-30,245,0,Cape Verde,555988,Africa,33819,298
CPV,2021-31,256,0,Cape Verde,555988,Africa,34075,298
CPV,2021-32,319,2,Cape Verde,555988,Africa,34394,300
CRI,2020-11,30,0,Costa Rica,5094114,America,30,0
CRI,2020-12,99,2,Costa Rica,5094114,America,129,2
CRI,2020-13,180,0,Costa Rica,5094114,America,309,2
CRI,2020-14,140,0,Costa Rica,5094114,America,449,2
CRI,2020-15,141,1,Costa Rica,5094114,America,590,3
CRI,2020-16,65,1,Costa Rica,5094114,America,655,4
CRI,2020-17,35,2,Costa Rica,5094114,America,690,6
CRI,2020-18,44,0,Costa Rica,5094114,America,734,6
CRI,2020-19,53,0,Costa Rica,5094114,America,787,6
CRI,2020-20,71,4,Costa Rica,5094114,America,858,10
CRI,2020-21,67,0,Costa Rica,5094114,America,925,10
CRI,2020-22,126,0,Costa Rica,5094114,America,1051,10
CRI,2020-23,262,0,Costa Rica,5094114,America,1313,10
CRI,2020-24,397,2,Costa Rica,5094114,America,1710,12
CRI,2020-25,498,0,Costa Rica,5094114,America,2208,12
CRI,2020-26,917,3,Costa Rica,5094114,America,3125,15
CRI,2020-27,1866,4,Costa Rica,5094114,America,4991,19
CRI,2020-28,2600,11,Costa Rica,5094114,America,7591,30
CRI,2020-29,3518,32,Costa Rica,5094114,America,11109,62
CRI,2020-30,4115,42,Costa Rica,5094114,America,15224,104
CRI,2020-31,3746,58,Costa Rica,5094114,America,18970,162
CRI,2020-32,4311,73,Costa Rica,5094114,America,23281,235
CRI,2020-33,5179,59,Costa Rica,5094114,America,28460,294
CRI,2020-34,5355,61,Costa Rica,5094114,America,33815,355
CRI,2020-35,5879,63,Costa Rica,5094114,America,39694,418
CRI,2020-36,7221,60,Costa Rica,5094114,America,46915,478
CRI,2020-37,8534,112,Costa Rica,5094114,America,55449,590
CRI,2020-38,8258,116,Costa Rica,5094114,America,63707,706
CRI,2020-39,8337,122,Costa Rica,5094114,America,72044,828
CRI,2020-40,7133,122,Costa Rica,5094114,America,79177,950
CRI,2020-41,8257,126,Costa Rica,5094114,America,87434,1076
CRI,2020-42,8075,107,Costa Rica,5094114,America,95509,1183
CRI,2020-43,7574,99,Costa Rica,5094114,America,103083,1282
CRI,2020-44,6883,103,Costa Rica,5094114,America,109966,1385
CRI,2020-45,6392,79,Costa Rica,5094114,America,116358,1464
CRI,2020-46,6860,82,Costa Rica,5094114,America,123218,1546
CRI,2020-47,6195,62,Costa Rica,5094114,America,129413,1608
CRI,2020-48,7675,82,Costa Rica,5094114,America,137088,1690
CRI,2020-49,6592,83,Costa Rica,5094114,America,143680,1773
CRI,2020-50,9484,163,Costa Rica,5094114,America,153164,1936
CRI,2020-51,6724,101,Costa Rica,5094114,America,159888,2037
CRI,2020-52,5869,107,Costa Rica,5094114,America,165757,2144
CRI,2020-53,6674,85,Costa Rica,5094114,America,172431,2229
CRI,2021-01,7625,124,Costa Rica,5094114,America,180056,2353
CRI,2021-02,5955,105,Costa Rica,5094114,America,186011,2458
CRI,2021-03,4729,100,Costa Rica,5094114,America,190740,2558
CRI,2021-04,3824,76,Costa Rica,5094114,America,194564,2634
CRI,2021-05,2866,58,Costa Rica,5094114,America,197430,2692
CRI,2021-06,2589,38,Costa Rica,5094114,America,200019,2730
CRI,2021-07,2650,52,Costa Rica,5094114,America,202669,2782
CRI,2021-08,2412,30,Costa Rica,5094114,America,205081,2812
CRI,2021-09,2374,29,Costa Rica,5094114,America,207455,2841
CRI,2021-10,2987,45,Costa Rica,5094114,America,210442,2886
CRI,2021-11,1456,10,Costa Rica,5094114,America,211898,2896
CRI,2021-12,3275,35,Costa Rica,5094114,America,215173,2931
CRI,2021-13,1586,26,Costa Rica,5094114,America,216759,2957
CRI,2021-14,5780,61,Costa Rica,5094114,America,222539,3018
CRI,2021-15,8293,81,Costa Rica,5094114,America,230832,3099
CRI,2021-16,10403,69,Costa Rica,5094114,America,241235,3168
CRI,2021-17,15436,122,Costa Rica,5094114,America,256671,3290
CRI,2021-18,14802,140,Costa Rica,5094114,America,271473,3430
CRI,2021-19,17148,195,Costa Rica,5094114,America,288621,3625
CRI,2021-20,15903,224,Costa Rica,5094114,America,304524,3849
CRI,2021-21,14457,192,Costa Rica,5094114,America,318981,4041
CRI,2021-22,12934,187,Costa Rica,5094114,America,331915,4228
CRI,2021-23,11684,160,Costa Rica,5094114,America,343599,4388
CRI,2021-24,10491,142,Costa Rica,5094114,America,354090,4530
CRI,2021-25,10209,118,Costa Rica,5094114,America,364299,4648
CRI,2021-26,10020,78,Costa Rica,5094114,America,374319,4726
CRI,2021-27,9176,86,Costa Rica,5094114,America,383495,4812
CRI,2021-28,9281,94,Costa Rica,5094114,America,392776,4906
CRI,2021-29,5827,35,Costa Rica,5094114,America,398603,4941
CRI,2021-30,8206,89,Costa Rica,5094114,America,406809,5030
CRI,2021-31,13648,132,Costa Rica,5094114,America,420457,5162
CRI,2021-32,11687,93,Costa Rica,5094114,America,432144,5255
CUB,2020-13,104,2,Cuba,11326616,America,104,2
CUB,2020-14,181,5,Cuba,11326616,America,285,7
CUB,2020-15,349,10,Cuba,11326616,America,634,17
CUB,2020-16,366,16,Cuba,11326616,America,1000,33
CUB,2020-17,334,20,Cuba,11326616,America,1334,53
CUB,2020-18,280,13,Cuba,11326616,America,1614,66
CUB,2020-19,117,10,Cuba,11326616,America,1731,76
CUB,2020-20,106,2,Cuba,11326616,America,1837,78
CUB,2020-21,69,3,Cuba,11326616,America,1906,81
CUB,2020-22,104,1,Cuba,11326616,America,2010,82
CUB,2020-23,146,0,Cuba,11326616,America,2156,82
CUB,2020-24,57,1,Cuba,11326616,America,2213,83
CUB,2020-25,64,1,Cuba,11326616,America,2277,84
CUB,2020-26,20,1,Cuba,11326616,America,2297,85
CUB,2020-27,40,0,Cuba,11326616,America,2337,85
CUB,2020-28,54,1,Cuba,11326616,America,2391,86
CUB,2020-29,20,0,Cuba,11326616,America,2411,86
CUB,2020-30,49,0,Cuba,11326616,America,2460,86
CUB,2020-31,151,0,Cuba,11326616,America,2611,86
CUB,2020-32,307,1,Cuba,11326616,America,2918,87
CUB,2020-33,363,0,Cuba,11326616,America,3281,87
CUB,2020-34,366,3,Cuba,11326616,America,3647,90
CUB,2020-35,291,3,Cuba,11326616,America,3938,93
CUB,2020-36,336,7,Cuba,11326616,America,4274,100
CUB,2020-37,375,7,Cuba,11326616,America,4649,107
CUB,2020-38,407,7,Cuba,11326616,America,5056,114
CUB,2020-39,366,7,Cuba,11326616,America,5422,121
CUB,2020-40,352,0,Cuba,11326616,America,5774,121
CUB,2020-41,169,1,Cuba,11326616,America,5943,122
CUB,2020-42,242,2,Cuba,11326616,America,6185,124
CUB,2020-43,346,3,Cuba,11326616,America,6531,127
CUB,2020-44,369,0,Cuba,11326616,America,6900,127
CUB,2020-45,362,2,Cuba,11326616,America,7262,129
CUB,2020-46,293,1,Cuba,11326616,America,7555,130
CUB,2020-47,256,1,Cuba,11326616,America,7811,131
CUB,2020-48,387,2,Cuba,11326616,America,8198,133
CUB,2020-49,549,2,Cuba,11326616,America,8747,135
CUB,2020-50,641,1,Cuba,11326616,America,9388,136
CUB,2020-51,819,0,Cuba,11326616,America,10207,136
CUB,2020-52,1192,6,Cuba,11326616,America,11399,142
CUB,2020-53,1306,4,Cuba,11326616,America,12705,146
CUB,2021-01,2267,6,Cuba,11326616,America,14972,152
CUB,2021-02,3436,20,Cuba,11326616,America,18408,172
CUB,2021-03,3385,24,Cuba,11326616,America,21793,196
CUB,2021-04,5764,19,Cuba,11326616,America,27557,215
CUB,2021-05,5892,24,Cuba,11326616,America,33449,239
CUB,2021-06,5520,29,Cuba,11326616,America,38969,268
CUB,2021-07,6357,31,Cuba,11326616,America,45326,299
CUB,2021-08,5229,24,Cuba,11326616,America,50555,323
CUB,2021-09,5976,26,Cuba,11326616,America,56531,349
CUB,2021-10,5640,23,Cuba,11326616,America,62171,372
CUB,2021-11,5270,24,Cuba,11326616,America,67441,396
CUB,2021-12,5728,20,Cuba,11326616,America,73169,416
CUB,2021-13,7406,19,Cuba,11326616,America,80575,435
CUB,2021-14,6775,31,Cuba,11326616,America,87350,466
CUB,2021-15,7186,64,Cuba,11326616,America,94536,530
CUB,2021-16,7870,66,Cuba,11326616,America,102406,596
CUB,2021-17,7184,78,Cuba,11326616,America,109590,674
CUB,2021-18,7472,66,Cuba,11326616,America,117062,740
CUB,2021-19,7357,73,Cuba,11326616,America,124419,813
CUB,2021-20,9754,76,Cuba,11326616,America,134173,889
CUB,2021-21,8058,68,Cuba,11326616,America,142231,957
CUB,2021-22,6652,54,Cuba,11326616,America,148883,1011
CUB,2021-23,10139,86,Cuba,11326616,America,159022,1097
CUB,2021-24,10299,72,Cuba,11326616,America,169321,1169
CUB,2021-25,15587,83,Cuba,11326616,America,184908,1252
CUB,2021-26,22379,119,Cuba,11326616,America,207287,1371
CUB,2021-27,37592,207,Cuba,11326616,America,244879,1578
CUB,2021-28,43478,387,Cuba,11326616,America,288357,1965
CUB,2021-29,52760,451,Cuba,11326616,America,341117,2416
CUB,2021-30,62470,496,Cuba,11326616,America,403587,2912
CUB,2021-31,62547,602,Cuba,11326616,America,466134,3514
CUB,2021-32,60668,573,Cuba,11326616,America,526802,4087
CUW,2020-14,2,0,Curaçao,164100,America,2,0
CUW,2020-15,3,0,Curaçao,164100,America,5,0
CUW,2020-16,0,0,Curaçao,164100,America,5,0
CUW,2020-17,2,0,Curaçao,164100,America,7,0
CUW,2020-18,0,0,Curaçao,164100,America,7,0
CUW,2020-19,0,0,Curaçao,164100,America,7,0
CUW,2020-20,0,0,Curaçao,164100,America,7,0
CUW,2020-21,1,0,Curaçao,164100,America,8,0
CUW,2020-22,2,0,Curaçao,164100,America,10,0
CUW,2020-23,2,0,Curaçao,164100,America,12,0
CUW,2020-24,1,0,Curaçao,164100,America,13,0
CUW,2020-25,1,0,Curaçao,164100,America,14,0
CUW,2020-26,1,0,Curaçao,164100,America,15,0
CUW,2020-27,1,0,Curaçao,164100,America,16,0
CUW,2020-28,0,0,Curaçao,164100,America,16,0
CUW,2020-29,3,0,Curaçao,164100,America,19,0
CUW,2020-30,1,0,Curaçao,164100,America,20,0
CUW,2020-31,0,0,Curaçao,164100,America,20,0
CUW,2020-32,2,0,Curaçao,164100,America,22,0
CUW,2020-33,3,0,Curaçao,164100,America,25,0
CUW,2020-34,9,0,Curaçao,164100,America,34,0
CUW,2020-35,14,0,Curaçao,164100,America,48,0
CUW,2020-36,35,0,Curaçao,164100,America,83,0
CUW,2020-37,65,0,Curaçao,164100,America,148,0
CUW,2020-38,111,0,Curaçao,164100,America,259,0
CUW,2020-39,92,0,Curaçao,164100,America,351,0
CUW,2020-40,92,0,Curaçao,164100,America,443,0
CUW,2020-41,131,0,Curaçao,164100,America,574,0
CUW,2020-42,161,0,Curaçao,164100,America,735,0
CUW,2020-43,114,0,Curaçao,164100,America,849,0
CUW,2020-44,129,0,Curaçao,164100,America,978,0
CUW,2020-45,110,1,Curaçao,164100,America,1088,1
CUW,2020-46,243,0,Curaçao,164100,America,1331,1
CUW,2020-47,409,1,Curaçao,164100,America,1740,2
CUW,2020-48,615,1,Curaçao,164100,America,2355,3
CUW,2020-49,772,3,Curaçao,164100,America,3127,6
CUW,2020-50,488,4,Curaçao,164100,America,3615,10
CUW,2020-51,350,0,Curaçao,164100,America,3965,10
CUW,2020-52,177,3,Curaçao,164100,America,4142,13
CUW,2020-53,166,2,Curaçao,164100,America,4308,15
CUW,2021-01,147,3,Curaçao,164100,America,4455,18
CUW,2021-02,56,0,Curaçao,164100,America,4511,18
CUW,2021-03,28,1,Curaçao,164100,America,4539,19
CUW,2021-04,37,1,Curaçao,164100,America,4576,20
CUW,2021-05,28,0,Curaçao,164100,America,4604,20
CUW,2021-06,39,1,Curaçao,164100,America,4643,21
CUW,2021-07,42,0,Curaçao,164100,America,4685,21
CUW,2021-08,37,0,Curaçao,164100,America,4722,21
CUW,2021-09,82,0,Curaçao,164100,America,4804,21
CUW,2021-10,325,0,Curaçao,164100,America,5129,21
CUW,2021-11,903,2,Curaçao,164100,America,6032,23
CUW,2021-12,1699,9,Curaçao,164100,America,7731,32
CUW,2021-13,2326,19,Curaçao,164100,America,10057,51
CUW,2021-14,1289,14,Curaçao,164100,America,11346,65
CUW,2021-15,548,24,Curaçao,164100,America,11894,89
CUW,2021-16,226,15,Curaçao,164100,America,12120,104
CUW,2021-17,81,6,Curaçao,164100,America,12201,110
CUW,2021-18,25,3,Curaçao,164100,America,12226,113
CUW,2021-19,21,6,Curaçao,164100,America,12247,119
CUW,2021-20,15,2,Curaçao,164100,America,12262,121
CUW,2021-21,1,0,Curaçao,164100,America,12263,121
CUW,2021-22,8,1,Curaçao,164100,America,12271,122
CUW,2021-23,15,0,Curaçao,164100,America,12286,122
CUW,2021-24,23,2,Curaçao,164100,America,12309,124
CUW,2021-25,14,1,Curaçao,164100,America,12323,125
CUW,2021-26,17,0,Curaçao,164100,America,12340,125
CUW,2021-27,46,0,Curaçao,164100,America,12386,125
CUW,2021-28,409,0,Curaçao,164100,America,12795,125
CUW,2021-29,496,0,Curaçao,164100,America,13291,125
CUW,2021-30,392,1,Curaçao,164100,America,13683,126
CUW,2021-31,445,5,Curaçao,164100,America,14128,131
CUW,2021-32,465,2,Curaçao,164100,America,14593,133
CYM,2020-13,5,0,Cayman Islands,65720,America,5,0
CYM,2020-14,31,0,Cayman Islands,65720,America,36,0
CYM,2020-15,14,0,Cayman Islands,65720,America,50,0
CYM,2020-16,8,0,Cayman Islands,65720,America,58,0
CYM,2020-17,9,0,Cayman Islands,65720,America,67,0
CYM,2020-18,4,0,Cayman Islands,65720,America,71,0
CYM,2020-19,7,0,Cayman Islands,65720,America,78,0
CYM,2020-20,13,0,Cayman Islands,65720,America,91,0
CYM,2020-21,35,0,Cayman Islands,65720,America,126,0
CYM,2020-22,12,0,Cayman Islands,65720,America,138,0
CYM,2020-23,23,0,Cayman Islands,65720,America,161,0
CYM,2020-24,23,0,Cayman Islands,65720,America,184,0
CYM,2020-25,8,0,Cayman Islands,65720,America,192,0
CYM,2020-26,1,0,Cayman Islands,65720,America,193,0
CYM,2020-27,5,0,Cayman Islands,65720,America,198,0
CYM,2020-28,0,0,Cayman Islands,65720,America,198,0
CYM,2020-29,2,0,Cayman Islands,65720,America,200,0
CYM,2020-30,0,0,Cayman Islands,65720,America,200,0
CYM,2020-31,0,0,Cayman Islands,65720,America,200,0
CYM,2020-32,0,0,Cayman Islands,65720,America,200,0
CYM,2020-33,0,0,Cayman Islands,65720,America,200,0
CYM,2020-34,2,0,Cayman Islands,65720,America,202,0
CYM,2020-35,0,0,Cayman Islands,65720,America,202,0
CYM,2020-36,0,0,Cayman Islands,65720,America,202,0
CYM,2020-37,3,0,Cayman Islands,65720,America,205,0
CYM,2020-38,1,0,Cayman Islands,65720,America,206,0
CYM,2020-39,1,0,Cayman Islands,65720,America,207,0
CYM,2020-40,3,0,Cayman Islands,65720,America,210,0
CYM,2020-41,8,0,Cayman Islands,65720,America,218,0
CYM,2020-42,12,0,Cayman Islands,65720,America,230,0
CYM,2020-43,6,0,Cayman Islands,65720,America,236,0
CYM,2020-44,1,0,Cayman Islands,65720,America,237,0
CYM,2020-45,10,0,Cayman Islands,65720,America,247,0
CYM,2020-46,4,0,Cayman Islands,65720,America,251,0
CYM,2020-47,7,1,Cayman Islands,65720,America,258,1
CYM,2020-48,13,0,Cayman Islands,65720,America,271,1
CYM,2020-49,14,0,Cayman Islands,65720,America,285,1
CYM,2020-50,10,0,Cayman Islands,65720,America,295,1
CYM,2020-51,18,0,Cayman Islands,65720,America,313,1
CYM,2020-52,2,0,Cayman Islands,65720,America,315,1
CYM,2020-53,29,0,Cayman Islands,65720,America,344,1
CYM,2021-01,15,0,Cayman Islands,65720,America,359,1
CYM,2021-02,18,0,Cayman Islands,65720,America,377,1
CYM,2021-03,3,0,Cayman Islands,65720,America,380,1
CYM,2021-04,15,0,Cayman Islands,65720,America,395,1
CYM,2021-05,10,0,Cayman Islands,65720,America,405,1
CYM,2021-06,8,0,Cayman Islands,65720,America,413,1
CYM,2021-07,15,0,Cayman Islands,65720,America,428,1
CYM,2021-08,16,0,Cayman Islands,65720,America,444,1
CYM,2021-09,13,0,Cayman Islands,65720,America,457,1
CYM,2021-10,14,0,Cayman Islands,65720,America,471,1
CYM,2021-11,8,0,Cayman Islands,65720,America,479,1
CYM,2021-12,17,0,Cayman Islands,65720,America,496,1
CYM,2021-13,2,0,Cayman Islands,65720,America,498,1
CYM,2021-14,22,0,Cayman Islands,65720,America,520,1
CYM,2021-15,8,0,Cayman Islands,65720,America,528,1
CYM,2021-16,10,0,Cayman Islands,65720,America,538,1
CYM,2021-17,4,0,Cayman Islands,65720,America,542,1
CYM,2021-18,3,0,Cayman Islands,65720,America,545,1
CYM,2021-19,17,0,Cayman Islands,65720,America,562,1
CYM,2021-20,13,0,Cayman Islands,65720,America,575,1
CYM,2021-21,6,0,Cayman Islands,65720,America,581,1
CYM,2021-22,7,0,Cayman Islands,65720,America,588,1
CYM,2021-23,2,0,Cayman Islands,65720,America,590,1
CYM,2021-24,16,0,Cayman Islands,65720,America,606,1
CYM,2021-25,5,0,Cayman Islands,65720,America,611,1
CYM,2021-26,1,0,Cayman Islands,65720,America,612,1
CYM,2021-27,4,0,Cayman Islands,65720,America,616,1
CYM,2021-28,6,0,Cayman Islands,65720,America,622,1
CYM,2021-29,11,0,Cayman Islands,65720,America,633,1
CYM,2021-30,8,0,Cayman Islands,65720,America,641,1
CYM,2021-31,2,0,Cayman Islands,65720,America,643,1
CYM,2021-32,10,0,Cayman Islands,65720,America,653,1
CYP,2020-12,65,0,Cyprus,888005,Europe,65,0
CYP,2020-13,119,6,Cyprus,888005,Europe,184,6
CYP,2020-14,232,3,Cyprus,888005,Europe,416,9
CYP,2020-15,187,2,Cyprus,888005,Europe,603,11
CYP,2020-16,134,1,Cyprus,888005,Europe,737,12
CYP,2020-17,50,2,Cyprus,888005,Europe,787,14
CYP,2020-18,55,1,Cyprus,888005,Europe,842,15
CYP,2020-19,26,1,Cyprus,888005,Europe,868,16
CYP,2020-20,18,1,Cyprus,888005,Europe,886,17
CYP,2020-21,19,0,Cyprus,888005,Europe,905,17
CYP,2020-22,9,0,Cyprus,888005,Europe,914,17
CYP,2020-23,20,1,Cyprus,888005,Europe,934,18
CYP,2020-24,19,0,Cyprus,888005,Europe,953,18
CYP,2020-25,3,1,Cyprus,888005,Europe,956,19
CYP,2020-26,8,0,Cyprus,888005,Europe,964,19
CYP,2020-27,9,0,Cyprus,888005,Europe,973,19
CYP,2020-28,18,0,Cyprus,888005,Europe,991,19
CYP,2020-29,17,0,Cyprus,888005,Europe,1008,19
CYP,2020-30,19,0,Cyprus,888005,Europe,1027,19
CYP,2020-31,93,0,Cyprus,888005,Europe,1120,19
CYP,2020-32,92,0,Cyprus,888005,Europe,1212,19
CYP,2020-33,90,1,Cyprus,888005,Europe,1302,20
CYP,2020-34,89,1,Cyprus,888005,Europe,1391,21
CYP,2020-35,66,0,Cyprus,888005,Europe,1457,21
CYP,2020-36,22,0,Cyprus,888005,Europe,1479,21
CYP,2020-37,17,0,Cyprus,888005,Europe,1496,21
CYP,2020-38,74,1,Cyprus,888005,Europe,1570,22
CYP,2020-39,96,0,Cyprus,888005,Europe,1666,22
CYP,2020-40,128,0,Cyprus,888005,Europe,1794,22
CYP,2020-41,162,3,Cyprus,888005,Europe,1956,25
CYP,2020-42,658,0,Cyprus,888005,Europe,2614,25
CYP,2020-43,901,0,Cyprus,888005,Europe,3515,25
CYP,2020-44,1018,1,Cyprus,888005,Europe,4533,26
CYP,2020-45,1424,1,Cyprus,888005,Europe,5957,27
CYP,2020-46,1191,13,Cyprus,888005,Europe,7148,40
CYP,2020-47,1465,4,Cyprus,888005,Europe,8613,44
CYP,2020-48,1740,4,Cyprus,888005,Europe,10353,48
CYP,2020-49,2068,13,Cyprus,888005,Europe,12421,61
CYP,2020-50,2650,17,Cyprus,888005,Europe,15071,78
CYP,2020-51,2587,13,Cyprus,888005,Europe,17658,91
CYP,2020-52,1969,21,Cyprus,888005,Europe,19627,112
CYP,2020-53,4317,19,Cyprus,888005,Europe,23944,131
CYP,2021-01,3376,17,Cyprus,888005,Europe,27320,148
CYP,2021-02,1618,22,Cyprus,888005,Europe,28938,170
CYP,2021-03,1049,16,Cyprus,888005,Europe,29987,186
CYP,2021-04,859,13,Cyprus,888005,Europe,30846,199
CYP,2021-05,883,13,Cyprus,888005,Europe,31729,212
CYP,2021-06,754,9,Cyprus,888005,Europe,32483,221
CYP,2021-07,747,8,Cyprus,888005,Europe,33230,229
CYP,2021-08,1447,2,Cyprus,888005,Europe,34677,231
CYP,2021-09,2171,2,Cyprus,888005,Europe,36848,233
CYP,2021-10,2773,7,Cyprus,888005,Europe,39621,240
CYP,2021-11,2567,3,Cyprus,888005,Europe,42188,243
CYP,2021-12,2413,9,Cyprus,888005,Europe,44601,252
CYP,2021-13,3082,9,Cyprus,888005,Europe,47683,261
CYP,2021-14,3792,11,Cyprus,888005,Europe,51475,272
CYP,2021-15,4754,19,Cyprus,888005,Europe,56229,291
CYP,2021-16,6090,7,Cyprus,888005,Europe,62319,298
CYP,2021-17,4081,16,Cyprus,888005,Europe,66400,314
CYP,2021-18,3002,22,Cyprus,888005,Europe,69402,336
CYP,2021-19,1632,10,Cyprus,888005,Europe,71034,346
CYP,2021-20,847,8,Cyprus,888005,Europe,71881,354
CYP,2021-21,496,6,Cyprus,888005,Europe,72377,360
CYP,2021-22,372,3,Cyprus,888005,Europe,72749,363
CYP,2021-23,411,10,Cyprus,888005,Europe,73160,373
CYP,2021-24,453,1,Cyprus,888005,Europe,73613,374
CYP,2021-25,1142,0,Cyprus,888005,Europe,74755,374
CYP,2021-26,3237,5,Cyprus,888005,Europe,77992,379
CYP,2021-27,6250,1,Cyprus,888005,Europe,84242,380
CYP,2021-28,6924,5,Cyprus,888005,Europe,91166,385
CYP,2021-29,6522,18,Cyprus,888005,Europe,97688,403
CYP,2021-30,4505,19,Cyprus,888005,Europe,102193,422
CYP,2021-31,3759,19,Cyprus,888005,Europe,105952,441
CYP,2021-32,2890,15,Cyprus,888005,Europe,108842,456
CZE,2020-02,0,0,Czechia,10693939,Europe,0,0
CZE,2020-03,0,0,Czechia,10693939,Europe,0,0
CZE,2020-04,0,0,Czechia,10693939,Europe,0,0
CZE,2020-05,0,0,Czechia,10693939,Europe,0,0
CZE,2020-06,0,0,Czechia,10693939,Europe,0,0
CZE,2020-07,0,0,Czechia,10693939,Europe,0,0
CZE,2020-08,0,0,Czechia,10693939,Europe,0,0
CZE,2020-09,3,0,Czechia,10693939,Europe,3,0
CZE,2020-10,30,0,Czechia,10693939,Europe,33,0
CZE,2020-11,266,0,Czechia,10693939,Europe,299,0
CZE,2020-12,866,1,Czechia,10693939,Europe,1165,1
CZE,2020-13,1661,22,Czechia,10693939,Europe,2826,23
CZE,2020-14,1772,51,Czechia,10693939,Europe,4598,74
CZE,2020-15,1405,72,Czechia,10693939,Europe,6003,146
CZE,2020-16,755,43,Czechia,10693939,Europe,6758,189
CZE,2020-17,658,35,Czechia,10693939,Europe,7416,224
CZE,2020-18,379,30,Czechia,10693939,Europe,7795,254
CZE,2020-19,344,26,Czechia,10693939,Europe,8139,280
CZE,2020-20,359,17,Czechia,10693939,Europe,8498,297
CZE,2020-21,485,17,Czechia,10693939,Europe,8983,314
CZE,2020-22,318,4,Czechia,10693939,Europe,9301,318
CZE,2020-23,366,8,Czechia,10693939,Europe,9667,326
CZE,2020-24,399,5,Czechia,10693939,Europe,10066,331
CZE,2020-25,475,8,Czechia,10693939,Europe,10541,339
CZE,2020-26,1106,7,Czechia,10693939,Europe,11647,346
CZE,2020-27,909,6,Czechia,10693939,Europe,12556,352
CZE,2020-28,656,3,Czechia,10693939,Europe,13212,355
CZE,2020-29,770,6,Czechia,10693939,Europe,13982,361
CZE,2020-30,1375,11,Czechia,10693939,Europe,15357,372
CZE,2020-31,1454,14,Czechia,10693939,Europe,16811,386
CZE,2020-32,1567,7,Czechia,10693939,Europe,18378,393
CZE,2020-33,1657,9,Czechia,10693939,Europe,20035,402
CZE,2020-34,1905,16,Czechia,10693939,Europe,21940,418
CZE,2020-35,2448,8,Czechia,10693939,Europe,24388,426
CZE,2020-36,3785,17,Czechia,10693939,Europe,28173,443
CZE,2020-37,8033,29,Czechia,10693939,Europe,36206,472
CZE,2020-38,13099,56,Czechia,10693939,Europe,49305,528
CZE,2020-39,15305,99,Czechia,10693939,Europe,64610,627
CZE,2020-40,17865,146,Czechia,10693939,Europe,82475,773
CZE,2020-41,34664,301,Czechia,10693939,Europe,117139,1074
CZE,2020-42,56776,493,Czechia,10693939,Europe,173915,1567
CZE,2020-43,84209,898,Czechia,10693939,Europe,258124,2465
CZE,2020-44,83548,1357,Czechia,10693939,Europe,341672,3822
CZE,2020-45,73167,1531,Czechia,10693939,Europe,414839,5353
CZE,2020-46,45344,1271,Czechia,10693939,Europe,460183,6624
CZE,2020-47,32154,976,Czechia,10693939,Europe,492337,7600
CZE,2020-48,27421,867,Czechia,10693939,Europe,519758,8467
CZE,2020-49,27108,749,Czechia,10693939,Europe,546866,9216
CZE,2020-50,34255,692,Czechia,10693939,Europe,581121,9908
CZE,2020-51,46522,766,Czechia,10693939,Europe,627643,10674
CZE,2020-52,46868,770,Czechia,10693939,Europe,674511,11444
CZE,2020-53,72492,987,Czechia,10693939,Europe,747003,12431
CZE,2021-01,88893,1224,Czechia,10693939,Europe,835896,13655
CZE,2021-02,56424,1159,Czechia,10693939,Europe,892320,14814
CZE,2021-03,48170,1036,Czechia,10693939,Europe,940490,15850
CZE,2021-04,47384,974,Czechia,10693939,Europe,987874,16824
CZE,2021-05,50073,919,Czechia,10693939,Europe,1037947,17743
CZE,2021-06,53496,944,Czechia,10693939,Europe,1091443,18687
CZE,2021-07,66316,1090,Czechia,10693939,Europe,1157759,19777
CZE,2021-08,82937,1207,Czechia,10693939,Europe,1240696,20984
CZE,2021-09,85332,1407,Czechia,10693939,Europe,1326028,22391
CZE,2021-10,77162,1540,Czechia,10693939,Europe,1403190,23931
CZE,2021-11,64963,1414,Czechia,10693939,Europe,1468153,25345
CZE,2021-12,49434,1199,Czechia,10693939,Europe,1517587,26544
CZE,2021-13,37021,1030,Czechia,10693939,Europe,1554608,27574
CZE,2021-14,27361,788,Czechia,10693939,Europe,1581969,28362
CZE,2021-15,21511,567,Czechia,10693939,Europe,1603480,28929
CZE,2021-16,17474,417,Czechia,10693939,Europe,1620954,29346
CZE,2021-17,14387,333,Czechia,10693939,Europe,1635341,29679
CZE,2021-18,10830,254,Czechia,10693939,Europe,1646171,29933
CZE,2021-19,7628,166,Czechia,10693939,Europe,1653799,30099
CZE,2021-20,4989,104,Czechia,10693939,Europe,1658788,30203
CZE,2021-21,3190,57,Czechia,10693939,Europe,1661978,30260
CZE,2021-22,2339,37,Czechia,10693939,Europe,1664317,30297
CZE,2021-23,1411,25,Czechia,10693939,Europe,1665728,30322
CZE,2021-24,931,13,Czechia,10693939,Europe,1666659,30335
CZE,2021-25,690,8,Czechia,10693939,Europe,1667349,30343
CZE,2021-26,1005,5,Czechia,10693939,Europe,1668354,30348
CZE,2021-27,1352,2,Czechia,10693939,Europe,1669706,30350
CZE,2021-28,1599,3,Czechia,10693939,Europe,1671305,30353
CZE,2021-29,1334,3,Czechia,10693939,Europe,1672639,30356
CZE,2021-30,1181,4,Czechia,10693939,Europe,1673820,30360
CZE,2021-31,1190,3,Czechia,10693939,Europe,1675010,30363
CZE,2021-32,1287,12,Czechia,10693939,Europe,1676297,30375
DEU,2020-02,0,0,Germany,83166711,Europe,0,0
DEU,2020-03,0,0,Germany,83166711,Europe,0,0
DEU,2020-04,0,0,Germany,83166711,Europe,0,0
DEU,2020-05,9,0,Germany,83166711,Europe,9,0
DEU,2020-06,4,0,Germany,83166711,Europe,13,0
DEU,2020-07,2,0,Germany,83166711,Europe,15,0
DEU,2020-08,0,0,Germany,83166711,Europe,15,0
DEU,2020-09,114,0,Germany,83166711,Europe,129,0
DEU,2020-10,773,0,Germany,83166711,Europe,902,0
DEU,2020-11,3936,12,Germany,83166711,Europe,4838,12
DEU,2020-12,19936,82,Germany,83166711,Europe,24774,94
DEU,2020-13,32524,361,Germany,83166711,Europe,57298,455
DEU,2020-14,38093,979,Germany,83166711,Europe,95391,1434
DEU,2020-15,27625,1365,Germany,83166711,Europe,123016,2799
DEU,2020-16,18656,1605,Germany,83166711,Europe,141672,4404
DEU,2020-17,13521,1346,Germany,83166711,Europe,155193,5750
DEU,2020-18,7982,942,Germany,83166711,Europe,163175,6692
DEU,2020-19,6400,725,Germany,83166711,Europe,169575,7417
DEU,2020-20,5122,518,Germany,83166711,Europe,174697,7935
DEU,2020-21,3873,322,Germany,83166711,Europe,178570,8257
DEU,2020-22,3245,254,Germany,83166711,Europe,181815,8511
DEU,2020-23,2378,163,Germany,83166711,Europe,184193,8674
DEU,2020-24,2268,117,Germany,83166711,Europe,186461,8791
DEU,2020-25,3898,94,Germany,83166711,Europe,190359,8885
DEU,2020-26,3402,76,Germany,83166711,Europe,193761,8961
DEU,2020-27,2793,55,Germany,83166711,Europe,196554,9016
DEU,2020-28,2409,48,Germany,83166711,Europe,198963,9064
DEU,2020-29,2860,22,Germany,83166711,Europe,201823,9086
DEU,2020-30,3786,32,Germany,83166711,Europe,205609,9118
DEU,2020-31,4793,30,Germany,83166711,Europe,210402,9148
DEU,2020-32,5925,49,Germany,83166711,Europe,216327,9197
DEU,2020-33,7687,35,Germany,83166711,Europe,224014,9232
DEU,2020-34,9561,40,Germany,83166711,Europe,233575,9272
DEU,2020-35,8806,26,Germany,83166711,Europe,242381,9298
DEU,2020-36,8418,27,Germany,83166711,Europe,250799,9325
DEU,2020-37,9556,25,Germany,83166711,Europe,260355,9350
DEU,2020-38,11982,36,Germany,83166711,Europe,272337,9386
DEU,2020-39,12995,74,Germany,83166711,Europe,285332,9460
DEU,2020-40,15287,74,Germany,83166711,Europe,300619,9534
DEU,2020-41,24712,87,Germany,83166711,Europe,325331,9621
DEU,2020-42,40968,168,Germany,83166711,Europe,366299,9789
DEU,2020-43,71567,267,Germany,83166711,Europe,437866,10056
DEU,2020-44,107161,474,Germany,83166711,Europe,545027,10530
DEU,2020-45,126841,822,Germany,83166711,Europe,671868,11352
DEU,2020-46,129459,1195,Germany,83166711,Europe,801327,12547
DEU,2020-47,127806,1565,Germany,83166711,Europe,929133,14112
DEU,2020-48,124736,2136,Germany,83166711,Europe,1053869,16248
DEU,2020-49,129785,2671,Germany,83166711,Europe,1183654,18919
DEU,2020-50,153424,3056,Germany,83166711,Europe,1337078,21975
DEU,2020-51,173574,4300,Germany,83166711,Europe,1510652,26275
DEU,2020-52,141182,3851,Germany,83166711,Europe,1651834,30126
DEU,2020-53,123679,4448,Germany,83166711,Europe,1775513,34574
DEU,2021-01,145511,6112,Germany,83166711,Europe,1921024,40686
DEU,2021-02,119635,5947,Germany,83166711,Europe,2040659,46633
DEU,2021-03,101006,5454,Germany,83166711,Europe,2141665,52087
DEU,2021-04,80306,5033,Germany,83166711,Europe,2221971,57120
DEU,2021-05,66574,4555,Germany,83166711,Europe,2288545,61675
DEU,2021-06,50442,3401,Germany,83166711,Europe,2338987,65076
DEU,2021-07,51941,2827,Germany,83166711,Europe,2390928,67903
DEU,2021-08,56140,2202,Germany,83166711,Europe,2447068,70105
DEU,2021-09,58125,1829,Germany,83166711,Europe,2505193,71934
DEU,2021-10,70656,1484,Germany,83166711,Europe,2575849,73418
DEU,2021-11,91376,1296,Germany,83166711,Europe,2667225,74714
DEU,2021-12,115048,1199,Germany,83166711,Europe,2782273,75913
DEU,2021-13,111610,1100,Germany,83166711,Europe,2893883,77013
DEU,2021-14,117630,1439,Germany,83166711,Europe,3011513,78452
DEU,2021-15,142186,1554,Germany,83166711,Europe,3153699,80006
DEU,2021-16,145626,1618,Germany,83166711,Europe,3299325,81624
DEU,2021-17,126657,1652,Germany,83166711,Europe,3425982,83276
DEU,2021-18,101269,1553,Germany,83166711,Europe,3527251,84829
DEU,2021-19,71595,1331,Germany,83166711,Europe,3598846,86160
DEU,2021-20,52794,1263,Germany,83166711,Europe,3651640,87423
DEU,2021-21,29486,1019,Germany,83166711,Europe,3681126,88442
DEU,2021-22,20358,802,Germany,83166711,Europe,3701484,89244
DEU,2021-23,14034,600,Germany,83166711,Europe,3715518,89844
DEU,2021-24,6809,551,Germany,83166711,Europe,3722327,90395
DEU,2021-25,4602,367,Germany,83166711,Europe,3726929,90762
DEU,2021-26,4195,269,Germany,83166711,Europe,3731124,91031
DEU,2021-27,5365,202,Germany,83166711,Europe,3736489,91233
DEU,2021-28,8738,130,Germany,83166711,Europe,3745227,91363
DEU,2021-29,11629,164,Germany,83166711,Europe,3756856,91527
DEU,2021-30,15253,133,Germany,83166711,Europe,3772109,91660
DEU,2021-31,19840,124,Germany,83166711,Europe,3791949,91784
DEU,2021-32,31190,87,Germany,83166711,Europe,3823139,91871
DJI,2020-13,18,0,Djibouti,988002,Africa,18,0
DJI,2020-14,40,0,Djibouti,988002,Africa,58,0
DJI,2020-15,155,2,Djibouti,988002,Africa,213,2
DJI,2020-16,632,0,Djibouti,988002,Africa,845,2
DJI,2020-17,177,0,Djibouti,988002,Africa,1022,2
DJI,2020-18,89,0,Djibouti,988002,Africa,1111,2
DJI,2020-19,98,1,Djibouti,988002,Africa,1209,3
DJI,2020-20,191,1,Djibouti,988002,Africa,1400,4
DJI,2020-21,869,6,Djibouti,988002,Africa,2269,10
DJI,2020-22,1084,14,Djibouti,988002,Africa,3353,24
DJI,2020-23,853,4,Djibouti,988002,Africa,4206,28
DJI,2020-24,258,15,Djibouti,988002,Africa,4464,43
DJI,2020-25,117,2,Djibouti,988002,Africa,4581,45
DJI,2020-26,61,7,Djibouti,988002,Africa,4642,52
DJI,2020-27,149,3,Djibouti,988002,Africa,4791,55
DJI,2020-28,180,1,Djibouti,988002,Africa,4971,56
DJI,2020-29,39,0,Djibouti,988002,Africa,5010,56
DJI,2020-30,39,2,Djibouti,988002,Africa,5049,58
DJI,2020-31,111,1,Djibouti,988002,Africa,5160,59
DJI,2020-32,183,0,Djibouti,988002,Africa,5343,59
DJI,2020-33,25,0,Djibouti,988002,Africa,5368,59
DJI,2020-34,13,1,Djibouti,988002,Africa,5381,60
DJI,2020-35,3,0,Djibouti,988002,Africa,5384,60
DJI,2020-36,3,1,Djibouti,988002,Africa,5387,61
DJI,2020-37,7,0,Djibouti,988002,Africa,5394,61
DJI,2020-38,8,0,Djibouti,988002,Africa,5402,61
DJI,2020-39,6,0,Djibouti,988002,Africa,5408,61
DJI,2020-40,10,0,Djibouti,988002,Africa,5418,61
DJI,2020-41,4,0,Djibouti,988002,Africa,5422,61
DJI,2020-42,36,0,Djibouti,988002,Africa,5458,61
DJI,2020-43,77,0,Djibouti,988002,Africa,5535,61
DJI,2020-44,27,0,Djibouti,988002,Africa,5562,61
DJI,2020-45,45,0,Djibouti,988002,Africa,5607,61
DJI,2020-46,41,0,Djibouti,988002,Africa,5648,61
DJI,2020-47,19,0,Djibouti,988002,Africa,5667,61
DJI,2020-48,9,0,Djibouti,988002,Africa,5676,61
DJI,2020-49,24,0,Djibouti,988002,Africa,5700,61
DJI,2020-50,27,0,Djibouti,988002,Africa,5727,61
DJI,2020-51,53,0,Djibouti,988002,Africa,5780,61
DJI,2020-52,32,0,Djibouti,988002,Africa,5812,61
DJI,2020-53,29,0,Djibouti,988002,Africa,5841,61
DJI,2021-01,29,0,Djibouti,988002,Africa,5870,61
DJI,2021-02,34,0,Djibouti,988002,Africa,5904,61
DJI,2021-03,14,0,Djibouti,988002,Africa,5918,61
DJI,2021-04,13,2,Djibouti,988002,Africa,5931,63
DJI,2021-05,15,0,Djibouti,988002,Africa,5946,63
DJI,2021-06,24,0,Djibouti,988002,Africa,5970,63
DJI,2021-07,53,0,Djibouti,988002,Africa,6023,63
DJI,2021-08,42,0,Djibouti,988002,Africa,6065,63
DJI,2021-09,80,0,Djibouti,988002,Africa,6145,63
DJI,2021-10,122,0,Djibouti,988002,Africa,6267,63
DJI,2021-11,320,1,Djibouti,988002,Africa,6587,64
DJI,2021-12,773,3,Djibouti,988002,Africa,7360,67
DJI,2021-13,1335,9,Djibouti,988002,Africa,8695,76
DJI,2021-14,1180,20,Djibouti,988002,Africa,9875,96
DJI,2021-15,584,20,Djibouti,988002,Africa,10459,116
DJI,2021-16,342,20,Djibouti,988002,Africa,10801,136
DJI,2021-17,14,10,Djibouti,988002,Africa,10815,146
DJI,2021-18,539,3,Djibouti,988002,Africa,11354,149
DJI,2021-19,79,2,Djibouti,988002,Africa,11433,151
DJI,2021-20,59,2,Djibouti,988002,Africa,11492,153
DJI,2021-21,35,1,Djibouti,988002,Africa,11527,154
DJI,2021-22,34,0,Djibouti,988002,Africa,11561,154
DJI,2021-23,10,0,Djibouti,988002,Africa,11571,154
DJI,2021-24,15,1,Djibouti,988002,Africa,11586,155
DJI,2021-25,14,0,Djibouti,988002,Africa,11600,155
DJI,2021-26,4,0,Djibouti,988002,Africa,11604,155
DJI,2021-27,10,0,Djibouti,988002,Africa,11614,155
DJI,2021-28,12,0,Djibouti,988002,Africa,11626,155
DJI,2021-29,8,0,Djibouti,988002,Africa,11634,155
DJI,2021-30,17,1,Djibouti,988002,Africa,11651,156
DJI,2021-31,10,0,Djibouti,988002,Africa,11661,156
DJI,2021-32,20,0,Djibouti,988002,Africa,11681,156
DMA,2020-13,10,0,Dominica,71991,America,10,0
DMA,2020-14,3,0,Dominica,71991,America,13,0
DMA,2020-15,2,0,Dominica,71991,America,15,0
DMA,2020-16,0,0,Dominica,71991,America,15,0
DMA,2020-17,0,0,Dominica,71991,America,15,0
DMA,2020-18,0,0,Dominica,71991,America,15,0
DMA,2020-19,0,0,Dominica,71991,America,15,0
DMA,2020-20,0,0,Dominica,71991,America,15,0
DMA,2020-21,0,0,Dominica,71991,America,15,0
DMA,2020-22,0,0,Dominica,71991,America,15,0
DMA,2020-23,2,0,Dominica,71991,America,17,0
DMA,2020-24,0,0,Dominica,71991,America,17,0
DMA,2020-25,0,0,Dominica,71991,America,17,0
DMA,2020-26,0,0,Dominica,71991,America,17,0
DMA,2020-27,0,0,Dominica,71991,America,17,0
DMA,2020-28,0,0,Dominica,71991,America,17,0
DMA,2020-29,0,0,Dominica,71991,America,17,0
DMA,2020-30,0,0,Dominica,71991,America,17,0
DMA,2020-31,0,0,Dominica,71991,America,17,0
DMA,2020-32,0,0,Dominica,71991,America,17,0
DMA,2020-33,0,0,Dominica,71991,America,17,0
DMA,2020-34,1,0,Dominica,71991,America,18,0
DMA,2020-35,1,0,Dominica,71991,America,19,0
DMA,2020-36,0,0,Dominica,71991,America,19,0
DMA,2020-37,4,0,Dominica,71991,America,23,0
DMA,2020-38,0,0,Dominica,71991,America,23,0
DMA,2020-39,0,0,Dominica,71991,America,23,0
DMA,2020-40,7,0,Dominica,71991,America,30,0
DMA,2020-41,1,0,Dominica,71991,America,31,0
DMA,2020-42,1,0,Dominica,71991,America,32,0
DMA,2020-43,5,0,Dominica,71991,America,37,0
DMA,2020-44,4,0,Dominica,71991,America,41,0
DMA,2020-45,0,0,Dominica,71991,America,41,0
DMA,2020-46,26,0,Dominica,71991,America,67,0
DMA,2020-47,9,0,Dominica,71991,America,76,0
DMA,2020-48,8,0,Dominica,71991,America,84,0
DMA,2020-49,0,0,Dominica,71991,America,84,0
DMA,2020-50,3,0,Dominica,71991,America,87,0
DMA,2020-51,4,0,Dominica,71991,America,91,0
DMA,2020-52,0,0,Dominica,71991,America,91,0
DMA,2020-53,4,0,Dominica,71991,America,95,0
DMA,2021-01,13,0,Dominica,71991,America,108,0
DMA,2021-02,4,0,Dominica,71991,America,112,0
DMA,2021-03,0,0,Dominica,71991,America,112,0
DMA,2021-04,4,0,Dominica,71991,America,116,0
DMA,2021-05,4,0,Dominica,71991,America,120,0
DMA,2021-06,13,0,Dominica,71991,America,133,0
DMA,2021-07,0,0,Dominica,71991,America,133,0
DMA,2021-08,8,0,Dominica,71991,America,141,0
DMA,2021-09,9,0,Dominica,71991,America,150,0
DMA,2021-10,6,0,Dominica,71991,America,156,0
DMA,2021-11,0,0,Dominica,71991,America,156,0
DMA,2021-12,4,0,Dominica,71991,America,160,0
DMA,2021-13,4,0,Dominica,71991,America,164,0
DMA,2021-14,0,0,Dominica,71991,America,164,0
DMA,2021-15,7,0,Dominica,71991,America,171,0
DMA,2021-16,1,0,Dominica,71991,America,172,0
DMA,2021-17,1,0,Dominica,71991,America,173,0
DMA,2021-18,1,0,Dominica,71991,America,174,0
DMA,2021-19,3,0,Dominica,71991,America,177,0
DMA,2021-20,6,0,Dominica,71991,America,183,0
DMA,2021-21,4,0,Dominica,71991,America,187,0
DMA,2021-22,0,0,Dominica,71991,America,187,0
DMA,2021-23,1,0,Dominica,71991,America,188,0
DMA,2021-24,2,0,Dominica,71991,America,190,0
DMA,2021-25,2,0,Dominica,71991,America,192,0
DMA,2021-26,1,0,Dominica,71991,America,193,0
DMA,2021-27,5,0,Dominica,71991,America,198,0
DMA,2021-28,7,0,Dominica,71991,America,205,0
DMA,2021-29,3,0,Dominica,71991,America,208,0
DMA,2021-30,9,0,Dominica,71991,America,217,0
DMA,2021-31,170,0,Dominica,71991,America,387,0
DMA,2021-32,555,0,Dominica,71991,America,942,0
DNK,2020-02,0,0,Denmark,5822763,Europe,0,0
DNK,2020-03,0,0,Denmark,5822763,Europe,0,0
DNK,2020-04,0,0,Denmark,5822763,Europe,0,0
DNK,2020-05,0,0,Denmark,5822763,Europe,0,0
DNK,2020-06,0,0,Denmark,5822763,Europe,0,0
DNK,2020-07,0,0,Denmark,5822763,Europe,0,0
DNK,2020-08,0,0,Denmark,5822763,Europe,0,0
DNK,2020-09,4,0,Denmark,5822763,Europe,4,0
DNK,2020-10,34,0,Denmark,5822763,Europe,38,0
DNK,2020-11,837,1,Denmark,5822763,Europe,875,1
DNK,2020-12,520,12,Denmark,5822763,Europe,1395,13
DNK,2020-13,1000,59,Denmark,5822763,Europe,2395,72
DNK,2020-14,1974,107,Denmark,5822763,Europe,4369,179
DNK,2020-15,1805,94,Denmark,5822763,Europe,6174,273
DNK,2020-16,1210,82,Denmark,5822763,Europe,7384,355
DNK,2020-17,1191,67,Denmark,5822763,Europe,8575,422
DNK,2020-18,948,59,Denmark,5822763,Europe,9523,481
DNK,2020-19,906,38,Denmark,5822763,Europe,10429,519
DNK,2020-20,498,28,Denmark,5822763,Europe,10927,547
DNK,2020-21,433,15,Denmark,5822763,Europe,11360,562
DNK,2020-22,309,12,Denmark,5822763,Europe,11669,574
DNK,2020-23,279,15,Denmark,5822763,Europe,11948,589
DNK,2020-24,245,8,Denmark,5822763,Europe,12193,597
DNK,2020-25,198,3,Denmark,5822763,Europe,12391,600
DNK,2020-26,284,4,Denmark,5822763,Europe,12675,604
DNK,2020-27,157,2,Denmark,5822763,Europe,12832,606
DNK,2020-28,114,3,Denmark,5822763,Europe,12946,609
DNK,2020-29,227,2,Denmark,5822763,Europe,13173,611
DNK,2020-30,265,2,Denmark,5822763,Europe,13438,613
DNK,2020-31,351,2,Denmark,5822763,Europe,13789,615
DNK,2020-32,653,2,Denmark,5822763,Europe,14442,617
DNK,2020-33,1175,4,Denmark,5822763,Europe,15617,621
DNK,2020-34,510,0,Denmark,5822763,Europe,16127,621
DNK,2020-35,573,3,Denmark,5822763,Europe,16700,624
DNK,2020-36,847,3,Denmark,5822763,Europe,17547,627
DNK,2020-37,1669,2,Denmark,5822763,Europe,19216,629
DNK,2020-38,2631,6,Denmark,5822763,Europe,21847,635
DNK,2020-39,4790,14,Denmark,5822763,Europe,26637,649
DNK,2020-40,3043,9,Denmark,5822763,Europe,29680,658
DNK,2020-41,2742,11,Denmark,5822763,Europe,32422,669
DNK,2020-42,2970,11,Denmark,5822763,Europe,35392,680
DNK,2020-43,4964,22,Denmark,5822763,Europe,40356,702
DNK,2020-44,6943,21,Denmark,5822763,Europe,47299,723
DNK,2020-45,7822,20,Denmark,5822763,Europe,55121,743
DNK,2020-46,7015,17,Denmark,5822763,Europe,62136,760
DNK,2020-47,8349,24,Denmark,5822763,Europe,70485,784
DNK,2020-48,8867,45,Denmark,5822763,Europe,79352,829
DNK,2020-49,11251,56,Denmark,5822763,Europe,90603,885
DNK,2020-50,19155,56,Denmark,5822763,Europe,109758,941
DNK,2020-51,24676,94,Denmark,5822763,Europe,134434,1035
DNK,2020-52,18915,169,Denmark,5822763,Europe,153349,1204
DNK,2020-53,15362,170,Denmark,5822763,Europe,168711,1374
DNK,2021-01,14014,223,Denmark,5822763,Europe,182725,1597
DNK,2021-02,7170,208,Denmark,5822763,Europe,189895,1805
DNK,2021-03,5401,205,Denmark,5822763,Europe,195296,2010
DNK,2021-04,3664,135,Denmark,5822763,Europe,198960,2145
DNK,2021-05,2661,71,Denmark,5822763,Europe,201621,2216
DNK,2021-06,3178,85,Denmark,5822763,Europe,204799,2301
DNK,2021-07,3228,42,Denmark,5822763,Europe,208027,2343
DNK,2021-08,3665,22,Denmark,5822763,Europe,211692,2365
DNK,2021-09,3572,16,Denmark,5822763,Europe,215264,2381
DNK,2021-10,5807,12,Denmark,5822763,Europe,221071,2393
DNK,2021-11,5206,9,Denmark,5822763,Europe,226277,2402
DNK,2021-12,2415,13,Denmark,5822763,Europe,228692,2415
DNK,2021-13,5105,15,Denmark,5822763,Europe,233797,2430
DNK,2021-14,4509,13,Denmark,5822763,Europe,238306,2443
DNK,2021-15,5068,16,Denmark,5822763,Europe,243374,2459
DNK,2021-16,4952,18,Denmark,5822763,Europe,248326,2477
DNK,2021-17,5347,13,Denmark,5822763,Europe,253673,2490
DNK,2021-18,6315,7,Denmark,5822763,Europe,259988,2497
DNK,2021-19,7351,6,Denmark,5822763,Europe,267339,2503
DNK,2021-20,7074,6,Denmark,5822763,Europe,274413,2509
DNK,2021-21,6814,7,Denmark,5822763,Europe,281227,2516
DNK,2021-22,5721,4,Denmark,5822763,Europe,286948,2520
DNK,2021-23,3163,6,Denmark,5822763,Europe,290111,2526
DNK,2021-24,1690,5,Denmark,5822763,Europe,291801,2531
DNK,2021-25,1293,2,Denmark,5822763,Europe,293094,2533
DNK,2021-26,2560,4,Denmark,5822763,Europe,295654,2537
DNK,2021-27,4417,2,Denmark,5822763,Europe,300071,2539
DNK,2021-28,6873,3,Denmark,5822763,Europe,306944,2542
DNK,2021-29,5348,1,Denmark,5822763,Europe,312292,2543
DNK,2021-30,6193,7,Denmark,5822763,Europe,318485,2550
DNK,2021-31,6236,2,Denmark,5822763,Europe,324721,2552
DNK,2021-32,7015,8,Denmark,5822763,Europe,331736,2560
DOM,2020-02,0,0,Dominican Republic,10847904,America,0,0
DOM,2020-03,0,0,Dominican Republic,10847904,America,0,0
DOM,2020-04,0,0,Dominican Republic,10847904,America,0,0
DOM,2020-05,0,0,Dominican Republic,10847904,America,0,0
DOM,2020-06,0,0,Dominican Republic,10847904,America,0,0
DOM,2020-07,0,0,Dominican Republic,10847904,America,0,0
DOM,2020-08,0,0,Dominican Republic,10847904,America,0,0
DOM,2020-09,1,0,Dominican Republic,10847904,America,1,0
DOM,2020-10,1,0,Dominican Republic,10847904,America,2,0
DOM,2020-11,9,0,Dominican Republic,10847904,America,11,0
DOM,2020-12,191,3,Dominican Republic,10847904,America,202,3
DOM,2020-13,657,36,Dominican Republic,10847904,America,859,39
DOM,2020-14,886,43,Dominican Republic,10847904,America,1745,82
DOM,2020-15,1222,91,Dominican Republic,10847904,America,2967,173
DOM,2020-16,1713,53,Dominican Republic,10847904,America,4680,226
DOM,2020-17,1455,52,Dominican Republic,10847904,America,6135,278
DOM,2020-18,1819,55,Dominican Republic,10847904,America,7954,333
DOM,2020-19,2393,55,Dominican Republic,10847904,America,10347,388
DOM,2020-20,1967,40,Dominican Republic,10847904,America,12314,428
DOM,2020-21,2108,30,Dominican Republic,10847904,America,14422,458
DOM,2020-22,2863,44,Dominican Republic,10847904,America,17285,502
DOM,2020-23,2315,36,Dominican Republic,10847904,America,19600,538
DOM,2020-24,3362,54,Dominican Republic,10847904,America,22962,592
DOM,2020-25,3715,70,Dominican Republic,10847904,America,26677,662
DOM,2020-26,4696,64,Dominican Republic,10847904,America,31373,726
DOM,2020-27,6052,68,Dominican Republic,10847904,America,37425,794
DOM,2020-28,7107,103,Dominican Republic,10847904,America,44532,897
DOM,2020-29,8323,84,Dominican Republic,10847904,America,52855,981
DOM,2020-30,10053,82,Dominican Republic,10847904,America,62908,1063
DOM,2020-31,9335,115,Dominican Republic,10847904,America,72243,1178
DOM,2020-32,7489,131,Dominican Republic,10847904,America,79732,1309
DOM,2020-33,6577,144,Dominican Republic,10847904,America,86309,1453
DOM,2020-34,4852,114,Dominican Republic,10847904,America,91161,1567
DOM,2020-35,3080,114,Dominican Republic,10847904,America,94241,1681
DOM,2020-36,5092,164,Dominican Republic,10847904,America,99333,1845
DOM,2020-37,4327,123,Dominican Republic,10847904,America,103660,1968
DOM,2020-38,4629,79,Dominican Republic,10847904,America,108289,2047
DOM,2020-39,3097,48,Dominican Republic,10847904,America,111386,2095
DOM,2020-40,3094,39,Dominican Republic,10847904,America,114480,2134
DOM,2020-41,3997,39,Dominican Republic,10847904,America,118477,2173
DOM,2020-42,2870,26,Dominican Republic,10847904,America,121347,2199
DOM,2020-43,3180,24,Dominican Republic,10847904,America,124527,2223
DOM,2020-44,2805,26,Dominican Republic,10847904,America,127332,2249
DOM,2020-45,2850,16,Dominican Republic,10847904,America,130182,2265
DOM,2020-46,3542,20,Dominican Republic,10847904,America,133724,2285
DOM,2020-47,4686,25,Dominican Republic,10847904,America,138410,2310
DOM,2020-48,5063,20,Dominican Republic,10847904,America,143473,2330
DOM,2020-49,4980,15,Dominican Republic,10847904,America,148453,2345
DOM,2020-50,6239,16,Dominican Republic,10847904,America,154692,2361
DOM,2020-51,6360,24,Dominican Republic,10847904,America,161052,2385
DOM,2020-52,6353,19,Dominican Republic,10847904,America,167405,2404
DOM,2020-53,5926,14,Dominican Republic,10847904,America,173331,2418
DOM,2021-01,9951,9,Dominican Republic,10847904,America,183282,2427
DOM,2021-02,11684,21,Dominican Republic,10847904,America,194966,2448
DOM,2021-03,10196,97,Dominican Republic,10847904,America,205162,2545
DOM,2021-04,9924,143,Dominican Republic,10847904,America,215086,2688
DOM,2021-05,9033,155,Dominican Republic,10847904,America,224119,2843
DOM,2021-06,6444,116,Dominican Republic,10847904,America,230563,2959
DOM,2021-07,5319,89,Dominican Republic,10847904,America,235882,3048
DOM,2021-08,4116,58,Dominican Republic,10847904,America,239998,3106
DOM,2021-09,3528,73,Dominican Republic,10847904,America,243526,3179
DOM,2021-10,2773,47,Dominican Republic,10847904,America,246299,3226
DOM,2021-11,3477,49,Dominican Republic,10847904,America,249776,3275
DOM,2021-12,2406,32,Dominican Republic,10847904,America,252182,3307
DOM,2021-13,2253,44,Dominican Republic,10847904,America,254435,3351
DOM,2021-14,3604,41,Dominican Republic,10847904,America,258039,3392
DOM,2021-15,3492,30,Dominican Republic,10847904,America,261531,3422
DOM,2021-16,3872,37,Dominican Republic,10847904,America,265403,3459
DOM,2021-17,2278,40,Dominican Republic,10847904,America,267681,3499
DOM,2021-18,4427,41,Dominican Republic,10847904,America,272108,3540
DOM,2021-19,5811,49,Dominican Republic,10847904,America,277919,3589
DOM,2021-20,6648,21,Dominican Republic,10847904,America,284567,3610
DOM,2021-21,8219,18,Dominican Republic,10847904,America,292786,3628
DOM,2021-22,9198,27,Dominican Republic,10847904,America,301984,3655
DOM,2021-23,7493,53,Dominican Republic,10847904,America,309477,3708
DOM,2021-24,8168,50,Dominican Republic,10847904,America,317645,3758
DOM,2021-25,6005,43,Dominican Republic,10847904,America,323650,3801
DOM,2021-26,5882,56,Dominican Republic,10847904,America,329532,3857
DOM,2021-27,5012,36,Dominican Republic,10847904,America,334544,3893
DOM,2021-28,3194,23,Dominican Republic,10847904,America,337738,3916
DOM,2021-29,2492,21,Dominican Republic,10847904,America,340230,3937
DOM,2021-30,2430,26,Dominican Republic,10847904,America,342660,3963
DOM,2021-31,1965,11,Dominican Republic,10847904,America,344625,3974
DOM,2021-32,1834,11,Dominican Republic,10847904,America,346459,3985
DZA,2020-02,0,0,Algeria,43851043,Africa,0,0
DZA,2020-03,0,0,Algeria,43851043,Africa,0,0
DZA,2020-04,0,0,Algeria,43851043,Africa,0,0
DZA,2020-05,0,0,Algeria,43851043,Africa,0,0
DZA,2020-06,0,0,Algeria,43851043,Africa,0,0
DZA,2020-07,0,0,Algeria,43851043,Africa,0,0
DZA,2020-08,0,0,Algeria,43851043,Africa,0,0
DZA,2020-09,3,0,Algeria,43851043,Africa,3,0
DZA,2020-10,17,0,Algeria,43851043,Africa,20,0
DZA,2020-11,28,4,Algeria,43851043,Africa,48,4
DZA,2020-12,153,13,Algeria,43851043,Africa,201,17
DZA,2020-13,310,14,Algeria,43851043,Africa,511,31
DZA,2020-14,809,121,Algeria,43851043,Africa,1320,152
DZA,2020-15,594,141,Algeria,43851043,Africa,1914,293
DZA,2020-16,715,82,Algeria,43851043,Africa,2629,375
DZA,2020-17,753,50,Algeria,43851043,Africa,3382,425
DZA,2020-18,1092,38,Algeria,43851043,Africa,4474,463
DZA,2020-19,1249,39,Algeria,43851043,Africa,5723,502
DZA,2020-20,1296,46,Algeria,43851043,Africa,7019,548
DZA,2020-21,1287,52,Algeria,43851043,Africa,8306,600
DZA,2020-22,1088,53,Algeria,43851043,Africa,9394,653
DZA,2020-23,760,54,Algeria,43851043,Africa,10154,707
DZA,2020-24,765,60,Algeria,43851043,Africa,10919,767
DZA,2020-25,852,78,Algeria,43851043,Africa,11771,845
DZA,2020-26,1502,52,Algeria,43851043,Africa,13273,897
DZA,2020-27,2668,55,Algeria,43851043,Africa,15941,952
DZA,2020-28,3254,59,Algeria,43851043,Africa,19195,1011
DZA,2020-29,3889,67,Algeria,43851043,Africa,23084,1078
DZA,2020-30,4273,77,Algeria,43851043,Africa,27357,1155
DZA,2020-31,4108,76,Algeria,43851043,Africa,31465,1231
DZA,2020-32,3749,71,Algeria,43851043,Africa,35214,1302
DZA,2020-33,3369,68,Algeria,43851043,Africa,38583,1370
DZA,2020-34,2877,65,Algeria,43851043,Africa,41460,1435
DZA,2020-35,2686,66,Algeria,43851043,Africa,44146,1501
DZA,2020-36,2218,55,Algeria,43851043,Africa,46364,1556
DZA,2020-37,1890,56,Algeria,43851043,Africa,48254,1612
DZA,2020-38,1572,60,Algeria,43851043,Africa,49826,1672
DZA,2020-39,1241,42,Algeria,43851043,Africa,51067,1714
DZA,2020-40,1069,46,Algeria,43851043,Africa,52136,1760
DZA,2020-41,936,41,Algeria,43851043,Africa,53072,1801
DZA,2020-42,1330,55,Algeria,43851043,Africa,54402,1856
DZA,2020-43,1741,58,Algeria,43851043,Africa,56143,1914
DZA,2020-44,2129,59,Algeria,43851043,Africa,58272,1973
DZA,2020-45,3779,75,Algeria,43851043,Africa,62051,2048
DZA,2020-46,5628,106,Algeria,43851043,Africa,67679,2154
DZA,2020-47,7183,121,Algeria,43851043,Africa,74862,2275
DZA,2020-48,7359,135,Algeria,43851043,Africa,82221,2410
DZA,2020-49,6031,106,Algeria,43851043,Africa,88252,2516
DZA,2020-50,3850,80,Algeria,43851043,Africa,92102,2596
DZA,2020-51,3101,70,Algeria,43851043,Africa,95203,2666
DZA,2020-52,3428,71,Algeria,43851043,Africa,98631,2737
DZA,2020-53,1777,35,Algeria,43851043,Africa,100408,2772
DZA,2021-01,1736,35,Algeria,43851043,Africa,102144,2807
DZA,2021-02,1689,29,Algeria,43851043,Africa,103833,2836
DZA,2021-03,1763,27,Algeria,43851043,Africa,105596,2863
DZA,2021-04,1743,28,Algeria,43851043,Africa,107339,2891
DZA,2021-05,1749,23,Algeria,43851043,Africa,109088,2914
DZA,2021-06,1623,25,Algeria,43851043,Africa,110711,2939
DZA,2021-07,1206,22,Algeria,43851043,Africa,111917,2961
DZA,2021-08,1175,22,Algeria,43851043,Africa,113092,2983
DZA,2021-09,1290,35,Algeria,43851043,Africa,114382,3018
DZA,2021-10,883,18,Algeria,43851043,Africa,115265,3036
DZA,2021-11,990,25,Algeria,43851043,Africa,116255,3061
DZA,2021-12,691,23,Algeria,43851043,Africa,116946,3084
DZA,2021-13,793,24,Algeria,43851043,Africa,117739,3108
DZA,2021-14,777,22,Algeria,43851043,Africa,118516,3130
DZA,2021-15,1126,25,Algeria,43851043,Africa,119642,3155
DZA,2021-16,1470,62,Algeria,43851043,Africa,121112,3217
DZA,2021-17,1605,63,Algeria,43851043,Africa,122717,3280
DZA,2021-18,1387,48,Algeria,43851043,Africa,124104,3328
DZA,2021-19,1207,46,Algeria,43851043,Africa,125311,3374
DZA,2021-20,1549,44,Algeria,43851043,Africa,126860,3418
DZA,2021-21,1865,47,Algeria,43851043,Africa,128725,3465
DZA,2021-22,2233,53,Algeria,43851043,Africa,130958,3518
DZA,2021-23,2430,53,Algeria,43851043,Africa,133388,3571
DZA,2021-24,2594,60,Algeria,43851043,Africa,135982,3631
DZA,2021-25,2483,62,Algeria,43851043,Africa,138465,3693
DZA,2021-26,3006,62,Algeria,43851043,Africa,141471,3755
DZA,2021-27,4611,81,Algeria,43851043,Africa,146082,3836
DZA,2021-28,7227,102,Algeria,43851043,Africa,153309,3938
DZA,2021-29,8846,125,Algeria,43851043,Africa,162155,4063
DZA,2021-30,10409,228,Algeria,43851043,Africa,172564,4291
DZA,2021-31,8812,259,Algeria,43851043,Africa,181376,4550
DZA,2021-32,5882,244,Algeria,43851043,Africa,187258,4794
ECU,2020-02,0,0,Ecuador,17643060,America,0,0
ECU,2020-03,0,0,Ecuador,17643060,America,0,0
ECU,2020-04,0,0,Ecuador,17643060,America,0,0
ECU,2020-05,0,0,Ecuador,17643060,America,0,0
ECU,2020-06,0,0,Ecuador,17643060,America,0,0
ECU,2020-07,0,0,Ecuador,17643060,America,0,0
ECU,2020-08,0,0,Ecuador,17643060,America,0,0
ECU,2020-09,6,0,Ecuador,17643060,America,6,0
ECU,2020-10,8,0,Ecuador,17643060,America,14,0
ECU,2020-11,23,2,Ecuador,17643060,America,37,2
ECU,2020-12,752,12,Ecuador,17643060,America,789,14
ECU,2020-13,1101,44,Ecuador,17643060,America,1890,58
ECU,2020-14,1756,122,Ecuador,17643060,America,3646,180
ECU,2020-15,3820,153,Ecuador,17643060,America,7466,333
ECU,2020-16,2002,141,Ecuador,17643060,America,9468,474
ECU,2020-17,13251,102,Ecuador,17643060,America,22719,576
ECU,2020-18,6819,988,Ecuador,17643060,America,29538,1564
ECU,2020-19,21,563,Ecuador,17643060,America,29559,2127
ECU,2020-20,3623,609,Ecuador,17643060,America,33182,2736
ECU,2020-21,3574,372,Ecuador,17643060,America,36756,3108
ECU,2020-22,2342,250,Ecuador,17643060,America,39098,3358
ECU,2020-23,4022,263,Ecuador,17643060,America,43120,3621
ECU,2020-24,3631,275,Ecuador,17643060,America,46751,3896
ECU,2020-25,3889,327,Ecuador,17643060,America,50640,4223
ECU,2020-26,4615,206,Ecuador,17643060,America,55255,4429
ECU,2020-27,6703,352,Ecuador,17643060,America,61958,4781
ECU,2020-28,5912,266,Ecuador,17643060,America,67870,5047
ECU,2020-29,6143,266,Ecuador,17643060,America,74013,5313
ECU,2020-30,6681,202,Ecuador,17643060,America,80694,5515
ECU,2020-31,5830,235,Ecuador,17643060,America,86524,5750
ECU,2020-32,7935,172,Ecuador,17643060,America,94459,5922
ECU,2020-33,7083,148,Ecuador,17643060,America,101542,6070
ECU,2020-34,6227,240,Ecuador,17643060,America,107769,6310
ECU,2020-35,5879,245,Ecuador,17643060,America,113648,6555
ECU,2020-36,-3864,3969,Ecuador,17643060,America,109784,10524
ECU,2020-37,8810,379,Ecuador,17643060,America,118594,10903
ECU,2020-38,7825,187,Ecuador,17643060,America,126419,11090
ECU,2020-39,8328,189,Ecuador,17643060,America,134747,11279
ECU,2020-40,6287,368,Ecuador,17643060,America,141034,11647
ECU,2020-41,5999,544,Ecuador,17643060,America,147033,12191
ECU,2020-42,6256,196,Ecuador,17643060,America,153289,12387
ECU,2020-43,8346,166,Ecuador,17643060,America,161635,12553
ECU,2020-44,7559,131,Ecuador,17643060,America,169194,12684
ECU,2020-45,5713,146,Ecuador,17643060,America,174907,12830
ECU,2020-46,5388,178,Ecuador,17643060,America,180295,13008
ECU,2020-47,5348,193,Ecuador,17643060,America,185643,13201
ECU,2020-48,6474,222,Ecuador,17643060,America,192117,13423
ECU,2020-49,5881,355,Ecuador,17643060,America,197998,13778
ECU,2020-50,4112,97,Ecuador,17643060,America,202110,13875
ECU,2020-51,4219,74,Ecuador,17643060,America,206329,13949
ECU,2020-52,3429,45,Ecuador,17643060,America,209758,13994
ECU,2020-53,4856,65,Ecuador,17643060,America,214614,14059
ECU,2021-01,6892,125,Ecuador,17643060,America,221506,14184
ECU,2021-02,10138,138,Ecuador,17643060,America,231644,14322
ECU,2021-03,9923,317,Ecuador,17643060,America,241567,14639
ECU,2021-04,9419,251,Ecuador,17643060,America,250986,14890
ECU,2021-05,7621,123,Ecuador,17643060,America,258607,15013
ECU,2021-06,9094,342,Ecuador,17643060,America,267701,15355
ECU,2021-07,7267,192,Ecuador,17643060,America,274968,15547
ECU,2021-08,11399,285,Ecuador,17643060,America,286367,15832
ECU,2021-09,8251,211,Ecuador,17643060,America,294618,16043
ECU,2021-10,7880,197,Ecuador,17643060,America,302498,16240
ECU,2021-11,10353,238,Ecuador,17643060,America,312851,16478
ECU,2021-12,12273,268,Ecuador,17643060,America,325124,16746
ECU,2021-13,11653,241,Ecuador,17643060,America,336777,16987
ECU,2021-14,10293,311,Ecuador,17643060,America,347070,17298
ECU,2021-15,13493,405,Ecuador,17643060,America,360563,17703
ECU,2021-16,14212,597,Ecuador,17643060,America,374775,18300
ECU,2021-17,13271,465,Ecuador,17643060,America,388046,18765
ECU,2021-18,14014,477,Ecuador,17643060,America,402060,19242
ECU,2021-19,8810,544,Ecuador,17643060,America,410870,19786
ECU,2021-20,13765,424,Ecuador,17643060,America,424635,20210
ECU,2021-21,1402,362,Ecuador,17643060,America,426037,20572
ECU,2021-22,6702,242,Ecuador,17643060,America,432739,20814
ECU,2021-23,6400,237,Ecuador,17643060,America,439139,21051
ECU,2021-24,7494,253,Ecuador,17643060,America,446633,21304
ECU,2021-25,9110,219,Ecuador,17643060,America,455743,21523
ECU,2021-26,6906,172,Ecuador,17643060,America,462649,21695
ECU,2021-27,5765,135,Ecuador,17643060,America,468414,21830
ECU,2021-28,7898,128,Ecuador,17643060,America,476312,21958
ECU,2021-29,4408,8839,Ecuador,17643060,America,480720,30797
ECU,2021-30,6982,847,Ecuador,17643060,America,487702,31644
ECU,2021-31,4129,144,Ecuador,17643060,America,491831,31788
ECU,2021-32,1936,82,Ecuador,17643060,America,493767,31870
EGY,2020-02,0,0,Egypt,102334403,Africa,0,0
EGY,2020-03,0,0,Egypt,102334403,Africa,0,0
EGY,2020-04,0,0,Egypt,102334403,Africa,0,0
EGY,2020-05,0,0,Egypt,102334403,Africa,0,0
EGY,2020-06,0,0,Egypt,102334403,Africa,0,0
EGY,2020-07,1,0,Egypt,102334403,Africa,1,0
EGY,2020-08,0,0,Egypt,102334403,Africa,1,0
EGY,2020-09,1,0,Egypt,102334403,Africa,2,0
EGY,2020-10,47,1,Egypt,102334403,Africa,49,1
EGY,2020-11,61,1,Egypt,102334403,Africa,110,2
EGY,2020-12,184,8,Egypt,102334403,Africa,294,10
EGY,2020-13,282,26,Egypt,102334403,Africa,576,36
EGY,2020-14,494,35,Egypt,102334403,Africa,1070,71
EGY,2020-15,995,88,Egypt,102334403,Africa,2065,159
EGY,2020-16,1079,80,Egypt,102334403,Africa,3144,239
EGY,2020-17,1175,68,Egypt,102334403,Africa,4319,307
EGY,2020-18,2146,122,Egypt,102334403,Africa,6465,429
EGY,2020-19,2935,96,Egypt,102334403,Africa,9400,525
EGY,2020-20,2829,105,Egypt,102334403,Africa,12229,630
EGY,2020-21,5036,134,Egypt,102334403,Africa,17265,764
EGY,2020-22,7720,195,Egypt,102334403,Africa,24985,959
EGY,2020-23,9094,278,Egypt,102334403,Africa,34079,1237
EGY,2020-24,10519,338,Egypt,102334403,Africa,44598,1575
EGY,2020-25,10635,618,Egypt,102334403,Africa,55233,2193
EGY,2020-26,9955,596,Egypt,102334403,Africa,65188,2789
EGY,2020-27,10065,554,Egypt,102334403,Africa,75253,3343
EGY,2020-28,6817,515,Egypt,102334403,Africa,82070,3858
EGY,2020-29,5705,444,Egypt,102334403,Africa,87775,4302
EGY,2020-30,4287,304,Egypt,102334403,Africa,92062,4606
EGY,2020-31,2421,259,Egypt,102334403,Africa,94483,4865
EGY,2020-32,1009,144,Egypt,102334403,Africa,95492,5009
EGY,2020-33,983,151,Egypt,102334403,Africa,96475,5160
EGY,2020-34,762,83,Egypt,102334403,Africa,97237,5243
EGY,2020-35,1490,156,Egypt,102334403,Africa,98727,5399
EGY,2020-36,1136,131,Egypt,102334403,Africa,99863,5530
EGY,2020-37,1146,118,Egypt,102334403,Africa,101009,5648
EGY,2020-38,1006,122,Egypt,102334403,Africa,102015,5770
EGY,2020-39,825,113,Egypt,102334403,Africa,102840,5883
EGY,2020-40,843,98,Egypt,102334403,Africa,103683,5981
EGY,2020-41,704,59,Egypt,102334403,Africa,104387,6040
EGY,2020-42,1037,80,Egypt,102334403,Africa,105424,6120
EGY,2020-43,1116,79,Egypt,102334403,Africa,106540,6199
EGY,2020-44,1196,79,Egypt,102334403,Africa,107736,6278
EGY,2020-45,1465,90,Egypt,102334403,Africa,109201,6368
EGY,2020-46,1566,85,Egypt,102334403,Africa,110767,6453
EGY,2020-47,2260,95,Egypt,102334403,Africa,113027,6548
EGY,2020-48,2514,88,Egypt,102334403,Africa,115541,6636
EGY,2020-49,2891,135,Egypt,102334403,Africa,118432,6771
EGY,2020-50,3143,149,Egypt,102334403,Africa,121575,6920
EGY,2020-51,3980,178,Egypt,102334403,Africa,125555,7098
EGY,2020-52,6986,307,Egypt,102334403,Africa,132541,7405
EGY,2020-53,9646,400,Egypt,102334403,Africa,142187,7805
EGY,2021-01,7605,392,Egypt,102334403,Africa,149792,8197
EGY,2021-02,6605,386,Egypt,102334403,Africa,156397,8583
EGY,2021-03,5420,376,Egypt,102334403,Africa,161817,8959
EGY,2021-04,4134,357,Egypt,102334403,Africa,165951,9316
EGY,2021-05,3689,335,Egypt,102334403,Africa,169640,9651
EGY,2021-06,4173,343,Egypt,102334403,Africa,173813,9994
EGY,2021-07,4338,359,Egypt,102334403,Africa,178151,10353
EGY,2021-08,4273,335,Egypt,102334403,Africa,182424,10688
EGY,2021-09,4079,307,Egypt,102334403,Africa,186503,10995
EGY,2021-10,4421,305,Egypt,102334403,Africa,190924,11300
EGY,2021-11,4494,298,Egypt,102334403,Africa,195418,11598
EGY,2021-12,4632,284,Egypt,102334403,Africa,200050,11882
EGY,2021-13,4915,281,Egypt,102334403,Africa,204965,12163
EGY,2021-14,5524,282,Egypt,102334403,Africa,210489,12445
EGY,2021-15,5845,293,Egypt,102334403,Africa,216334,12738
EGY,2021-16,6189,311,Egypt,102334403,Africa,222523,13049
EGY,2021-17,7112,420,Egypt,102334403,Africa,229635,13469
EGY,2021-18,7775,435,Egypt,102334403,Africa,237410,13904
EGY,2021-19,8311,423,Egypt,102334403,Africa,245721,14327
EGY,2021-20,8114,394,Egypt,102334403,Africa,253835,14721
EGY,2021-21,7831,326,Egypt,102334403,Africa,261666,15047
EGY,2021-22,6306,305,Egypt,102334403,Africa,267972,15352
EGY,2021-23,5210,271,Egypt,102334403,Africa,273182,15623
EGY,2021-24,4615,275,Egypt,102334403,Africa,277797,15898
EGY,2021-25,2208,164,Egypt,102334403,Africa,280005,16062
EGY,2021-26,2077,202,Egypt,102334403,Africa,282082,16264
EGY,2021-27,1020,132,Egypt,102334403,Africa,283102,16396
EGY,2021-28,601,50,Egypt,102334403,Africa,283703,16446
EGY,2021-29,321,41,Egypt,102334403,Africa,284024,16487
EGY,2021-30,287,41,Egypt,102334403,Africa,284311,16528
EGY,2021-31,395,47,Egypt,102334403,Africa,284706,16575
EGY,2021-32,652,44,Egypt,102334403,Africa,285358,16619
ERI,2020-13,11,0,Eritrea,3546427,Africa,11,0
ERI,2020-14,17,0,Eritrea,3546427,Africa,28,0
ERI,2020-15,5,0,Eritrea,3546427,Africa,33,0
ERI,2020-16,5,0,Eritrea,3546427,Africa,38,0
ERI,2020-17,0,0,Eritrea,3546427,Africa,38,0
ERI,2020-18,0,0,Eritrea,3546427,Africa,38,0
ERI,2020-19,0,0,Eritrea,3546427,Africa,38,0
ERI,2020-20,0,0,Eritrea,3546427,Africa,38,0
ERI,2020-21,0,0,Eritrea,3546427,Africa,38,0
ERI,2020-22,0,0,Eritrea,3546427,Africa,38,0
ERI,2020-23,2,0,Eritrea,3546427,Africa,40,0
ERI,2020-24,55,0,Eritrea,3546427,Africa,95,0
ERI,2020-25,47,0,Eritrea,3546427,Africa,142,0
ERI,2020-26,48,0,Eritrea,3546427,Africa,190,0
ERI,2020-27,24,0,Eritrea,3546427,Africa,214,0
ERI,2020-28,17,0,Eritrea,3546427,Africa,231,0
ERI,2020-29,19,0,Eritrea,3546427,Africa,250,0
ERI,2020-30,12,0,Eritrea,3546427,Africa,262,0
ERI,2020-31,16,0,Eritrea,3546427,Africa,278,0
ERI,2020-32,6,0,Eritrea,3546427,Africa,284,0
ERI,2020-33,0,0,Eritrea,3546427,Africa,284,0
ERI,2020-34,21,0,Eritrea,3546427,Africa,305,0
ERI,2020-35,12,0,Eritrea,3546427,Africa,317,0
ERI,2020-36,12,0,Eritrea,3546427,Africa,329,0
ERI,2020-37,31,0,Eritrea,3546427,Africa,360,0
ERI,2020-38,3,0,Eritrea,3546427,Africa,363,0
ERI,2020-39,11,0,Eritrea,3546427,Africa,374,0
ERI,2020-40,23,0,Eritrea,3546427,Africa,397,0
ERI,2020-41,16,0,Eritrea,3546427,Africa,413,0
ERI,2020-42,11,0,Eritrea,3546427,Africa,424,0
ERI,2020-43,36,0,Eritrea,3546427,Africa,460,0
ERI,2020-44,2,0,Eritrea,3546427,Africa,462,0
ERI,2020-45,28,0,Eritrea,3546427,Africa,490,0
ERI,2020-46,2,0,Eritrea,3546427,Africa,492,0
ERI,2020-47,58,0,Eritrea,3546427,Africa,550,0
ERI,2020-48,26,0,Eritrea,3546427,Africa,576,0
ERI,2020-49,55,0,Eritrea,3546427,Africa,631,0
ERI,2020-50,79,0,Eritrea,3546427,Africa,710,0
ERI,2020-51,96,0,Eritrea,3546427,Africa,806,0
ERI,2020-52,232,1,Eritrea,3546427,Africa,1038,1
ERI,2020-53,324,2,Eritrea,3546427,Africa,1362,3
ERI,2021-01,193,3,Eritrea,3546427,Africa,1555,6
ERI,2021-02,321,0,Eritrea,3546427,Africa,1876,6
ERI,2021-03,73,1,Eritrea,3546427,Africa,1949,7
ERI,2021-04,185,0,Eritrea,3546427,Africa,2134,7
ERI,2021-05,191,0,Eritrea,3546427,Africa,2325,7
ERI,2021-06,103,0,Eritrea,3546427,Africa,2428,7
ERI,2021-07,274,0,Eritrea,3546427,Africa,2702,7
ERI,2021-08,144,0,Eritrea,3546427,Africa,2846,7
ERI,2021-09,97,0,Eritrea,3546427,Africa,2943,7
ERI,2021-10,94,0,Eritrea,3546427,Africa,3037,7
ERI,2021-11,57,0,Eritrea,3546427,Africa,3094,7
ERI,2021-12,113,2,Eritrea,3546427,Africa,3207,9
ERI,2021-13,126,1,Eritrea,3546427,Africa,3333,10
ERI,2021-14,132,0,Eritrea,3546427,Africa,3465,10
ERI,2021-15,25,0,Eritrea,3546427,Africa,3490,10
ERI,2021-16,149,0,Eritrea,3546427,Africa,3639,10
ERI,2021-17,33,2,Eritrea,3546427,Africa,3672,12
ERI,2021-18,81,0,Eritrea,3546427,Africa,3753,12
ERI,2021-19,114,2,Eritrea,3546427,Africa,3867,14
ERI,2021-20,64,0,Eritrea,3546427,Africa,3931,14
ERI,2021-21,129,0,Eritrea,3546427,Africa,4060,14
ERI,2021-22,438,0,Eritrea,3546427,Africa,4498,14
ERI,2021-23,349,2,Eritrea,3546427,Africa,4847,16
ERI,2021-24,514,3,Eritrea,3546427,Africa,5361,19
ERI,2021-25,574,4,Eritrea,3546427,Africa,5935,23
ERI,2021-26,252,2,Eritrea,3546427,Africa,6187,25
ERI,2021-27,96,4,Eritrea,3546427,Africa,6283,29
ERI,2021-28,118,1,Eritrea,3546427,Africa,6401,30
ERI,2021-29,93,3,Eritrea,3546427,Africa,6494,33
ERI,2021-30,64,2,Eritrea,3546427,Africa,6558,35
ERI,2021-31,30,0,Eritrea,3546427,Africa,6588,35
ERI,2021-32,14,2,Eritrea,3546427,Africa,6602,37
ESH,2020-18,0,0,Western Sahara,597330,Africa,0,0
ESH,2020-19,0,0,Western Sahara,597330,Africa,0,0
ESH,2020-20,0,0,Western Sahara,597330,Africa,0,0
ESH,2020-21,0,0,Western Sahara,597330,Africa,0,0
ESH,2020-22,17,1,Western Sahara,597330,Africa,17,1
ESH,2020-23,0,0,Western Sahara,597330,Africa,17,1
ESH,2020-24,0,0,Western Sahara,597330,Africa,17,1
ESH,2020-25,2,0,Western Sahara,597330,Africa,19,1
ESH,2020-26,183,0,Western Sahara,597330,Africa,202,1
ESH,2020-27,311,0,Western Sahara,597330,Africa,513,1
ESH,2020-28,0,0,Western Sahara,597330,Africa,513,1
ESH,2020-29,247,0,Western Sahara,597330,Africa,760,1
ESH,2020-30,0,0,Western Sahara,597330,Africa,760,1
ESH,2020-31,0,0,Western Sahara,597330,Africa,760,1
ESH,2020-32,0,0,Western Sahara,597330,Africa,760,1
ESH,2020-33,0,0,Western Sahara,597330,Africa,760,1
ESH,2020-34,0,0,Western Sahara,597330,Africa,760,1
ESH,2020-35,0,0,Western Sahara,597330,Africa,760,1
ESH,2020-36,0,0,Western Sahara,597330,Africa,760,1
ESH,2020-37,0,0,Western Sahara,597330,Africa,760,1
ESH,2020-38,0,0,Western Sahara,597330,Africa,760,1
ESH,2020-39,0,0,Western Sahara,597330,Africa,760,1
ESH,2020-40,0,0,Western Sahara,597330,Africa,760,1
ESH,2020-41,0,0,Western Sahara,597330,Africa,760,1
ESH,2020-42,0,0,Western Sahara,597330,Africa,760,1
ESH,2020-43,0,0,Western Sahara,597330,Africa,760,1
ESH,2020-44,0,0,Western Sahara,597330,Africa,760,1
ESH,2020-45,0,0,Western Sahara,597330,Africa,760,1
ESH,2020-46,0,0,Western Sahara,597330,Africa,760,1
ESH,2020-47,0,0,Western Sahara,597330,Africa,760,1
ESH,2020-48,0,0,Western Sahara,597330,Africa,760,1
ESH,2020-49,0,0,Western Sahara,597330,Africa,760,1
ESH,2020-50,0,0,Western Sahara,597330,Africa,760,1
ESH,2020-51,0,0,Western Sahara,597330,Africa,760,1
ESH,2020-52,0,0,Western Sahara,597330,Africa,760,1
ESH,2020-53,0,0,Western Sahara,597330,Africa,760,1
ESH,2021-01,0,0,Western Sahara,597330,Africa,760,1
ESH,2021-02,0,0,Western Sahara,597330,Africa,760,1
ESH,2021-03,0,0,Western Sahara,597330,Africa,760,1
ESH,2021-04,0,0,Western Sahara,597330,Africa,760,1
ESH,2021-05,0,0,Western Sahara,597330,Africa,760,1
ESH,2021-06,0,0,Western Sahara,597330,Africa,760,1
ESH,2021-07,0,0,Western Sahara,597330,Africa,760,1
ESH,2021-08,0,0,Western Sahara,597330,Africa,760,1
ESH,2021-09,0,0,Western Sahara,597330,Africa,760,1
ESH,2021-10,0,0,Western Sahara,597330,Africa,760,1
ESH,2021-11,0,0,Western Sahara,597330,Africa,760,1
ESH,2021-12,0,0,Western Sahara,597330,Africa,760,1
ESH,2021-13,0,0,Western Sahara,597330,Africa,760,1
ESH,2021-14,0,0,Western Sahara,597330,Africa,760,1
ESH,2021-15,0,0,Western Sahara,597330,Africa,760,1
ESH,2021-16,0,0,Western Sahara,597330,Africa,760,1
ESH,2021-17,0,0,Western Sahara,597330,Africa,760,1
ESH,2021-18,0,0,Western Sahara,597330,Africa,760,1
ESH,2021-19,0,0,Western Sahara,597330,Africa,760,1
ESH,2021-20,0,0,Western Sahara,597330,Africa,760,1
ESH,2021-21,0,0,Western Sahara,597330,Africa,760,1
ESH,2021-22,0,0,Western Sahara,597330,Africa,760,1
ESH,2021-23,0,0,Western Sahara,597330,Africa,760,1
ESH,2021-24,0,0,Western Sahara,597330,Africa,760,1
ESH,2021-25,0,0,Western Sahara,597330,Africa,760,1
ESH,2021-26,0,0,Western Sahara,597330,Africa,760,1
ESH,2021-27,0,0,Western Sahara,597330,Africa,760,1
ESH,2021-28,0,0,Western Sahara,597330,Africa,760,1
ESH,2021-29,0,0,Western Sahara,597330,Africa,760,1
ESH,2021-30,0,0,Western Sahara,597330,Africa,760,1
ESH,2021-31,0,0,Western Sahara,597330,Africa,760,1
ESH,2021-32,0,0,Western Sahara,597330,Africa,760,1
ESP,2020-02,0,0,Spain,47332614,Europe,0,0
ESP,2020-03,0,0,Spain,47332614,Europe,0,0
ESP,2020-04,0,0,Spain,47332614,Europe,0,0
ESP,2020-05,1,0,Spain,47332614,Europe,1,0
ESP,2020-06,1,0,Spain,47332614,Europe,2,0
ESP,2020-07,0,0,Spain,47332614,Europe,2,0
ESP,2020-08,0,0,Spain,47332614,Europe,2,0
ESP,2020-09,134,0,Spain,47332614,Europe,136,0
ESP,2020-10,1391,5,Spain,47332614,Europe,1527,5
ESP,2020-11,9964,283,Spain,47332614,Europe,11491,288
ESP,2020-12,29771,1432,Spain,47332614,Europe,41262,1720
ESP,2020-13,54860,4808,Spain,47332614,Europe,96122,6528
ESP,2020-14,46276,5890,Spain,47332614,Europe,142398,12418
ESP,2020-15,32553,4554,Spain,47332614,Europe,174951,16972
ESP,2020-16,20519,3880,Spain,47332614,Europe,195470,20852
ESP,2020-17,16100,2338,Spain,47332614,Europe,211570,23190
ESP,2020-18,7635,2238,Spain,47332614,Europe,219205,25428
ESP,2020-19,8565,1316,Spain,47332614,Europe,227770,26744
ESP,2020-20,3836,965,Spain,47332614,Europe,231606,27709
ESP,2020-21,3794,-875,Spain,47332614,Europe,235400,26834
ESP,2020-22,4238,293,Spain,47332614,Europe,239638,27127
ESP,2020-23,2079,9,Spain,47332614,Europe,241717,27136
ESP,2020-24,2392,0,Spain,47332614,Europe,244109,27136
ESP,2020-25,2395,1188,Spain,47332614,Europe,246504,28324
ESP,2020-26,2466,22,Spain,47332614,Europe,248970,28346
ESP,2020-27,2819,42,Spain,47332614,Europe,251789,28388
ESP,2020-28,4164,18,Spain,47332614,Europe,255953,28406
ESP,2020-29,8883,16,Spain,47332614,Europe,264836,28422
ESP,2020-30,13946,12,Spain,47332614,Europe,278782,28434
ESP,2020-31,18272,38,Spain,47332614,Europe,297054,28472
ESP,2020-32,25926,104,Spain,47332614,Europe,322980,28576
ESP,2020-33,36102,70,Spain,47332614,Europe,359082,28646
ESP,2020-34,46354,226,Spain,47332614,Europe,405436,28872
ESP,2020-35,57422,222,Spain,47332614,Europe,462858,29094
ESP,2020-36,62691,422,Spain,47332614,Europe,525549,29516
ESP,2020-37,68181,332,Spain,47332614,Europe,593730,29848
ESP,2020-38,77738,815,Spain,47332614,Europe,671468,30663
ESP,2020-39,76798,748,Spain,47332614,Europe,748266,31411
ESP,2020-40,65146,814,Spain,47332614,Europe,813412,32225
ESP,2020-41,75556,899,Spain,47332614,Europe,888968,33124
ESP,2020-42,85481,868,Spain,47332614,Europe,974449,33992
ESP,2020-43,123871,1039,Spain,47332614,Europe,1098320,35031
ESP,2020-44,142377,1226,Spain,47332614,Europe,1240697,36257
ESP,2020-45,140521,3088,Spain,47332614,Europe,1381218,39345
ESP,2020-46,115646,1908,Spain,47332614,Europe,1496864,41253
ESP,2020-47,85752,1878,Spain,47332614,Europe,1582616,43131
ESP,2020-48,65571,1938,Spain,47332614,Europe,1648187,45069
ESP,2020-49,54141,1577,Spain,47332614,Europe,1702328,46646
ESP,2020-50,49556,1367,Spain,47332614,Europe,1751884,48013
ESP,2020-51,67365,1247,Spain,47332614,Europe,1819249,49260
ESP,2020-52,60164,862,Spain,47332614,Europe,1879413,50122
ESP,2020-53,79431,956,Spain,47332614,Europe,1958844,51078
ESP,2021-01,152938,1197,Spain,47332614,Europe,2111782,52275
ESP,2021-02,224669,1494,Spain,47332614,Europe,2336451,53769
ESP,2021-03,256931,2439,Spain,47332614,Europe,2593382,56208
ESP,2021-04,229423,2873,Spain,47332614,Europe,2822805,59081
ESP,2021-05,166280,3214,Spain,47332614,Europe,2989085,62295
ESP,2021-06,97201,3154,Spain,47332614,Europe,3086286,65449
ESP,2021-07,67685,2187,Spain,47332614,Europe,3153971,67636
ESP,2021-08,-28304,1973,Spain,47332614,Europe,3125667,69609
ESP,2021-09,35303,1827,Spain,47332614,Europe,3160970,71436
ESP,2021-10,34092,988,Spain,47332614,Europe,3195062,72424
ESP,2021-11,33741,1119,Spain,47332614,Europe,3228803,73543
ESP,2021-12,42022,1656,Spain,47332614,Europe,3270825,75199
ESP,2021-13,40500,584,Spain,47332614,Europe,3311325,75783
ESP,2021-14,58931,742,Spain,47332614,Europe,3370256,76525
ESP,2021-15,58098,577,Spain,47332614,Europe,3428354,77102
ESP,2021-16,60115,636,Spain,47332614,Europe,3488469,77738
ESP,2021-17,51961,555,Spain,47332614,Europe,3540430,78293
ESP,2021-18,40962,602,Spain,47332614,Europe,3581392,78895
ESP,2021-19,34468,537,Spain,47332614,Europe,3615860,79432
ESP,2021-20,31660,279,Spain,47332614,Europe,3647520,79711
ESP,2021-21,30870,242,Spain,47332614,Europe,3678390,79953
ESP,2021-22,29133,283,Spain,47332614,Europe,3707523,80236
ESP,2021-23,34244,281,Spain,47332614,Europe,3741767,80517
ESP,2021-24,22884,172,Spain,47332614,Europe,3764651,80689
ESP,2021-25,27991,100,Spain,47332614,Europe,3792642,80789
ESP,2021-26,73833,145,Spain,47332614,Europe,3866475,80934
ESP,2021-27,104649,86,Spain,47332614,Europe,3971124,81020
ESP,2021-28,190726,99,Spain,47332614,Europe,4161850,81119
ESP,2021-29,180204,149,Spain,47332614,Europe,4342054,81268
ESP,2021-30,160929,375,Spain,47332614,Europe,4502983,81643
ESP,2021-31,124787,482,Spain,47332614,Europe,4627770,82125
ESP,2021-32,91496,470,Spain,47332614,Europe,4719266,82595
EST,2020-02,0,0,Estonia,1328976,Europe,0,0
EST,2020-03,0,0,Estonia,1328976,Europe,0,0
EST,2020-04,0,0,Estonia,1328976,Europe,0,0
EST,2020-05,0,0,Estonia,1328976,Europe,0,0
EST,2020-06,0,0,Estonia,1328976,Europe,0,0
EST,2020-07,0,0,Estonia,1328976,Europe,0,0
EST,2020-08,0,0,Estonia,1328976,Europe,0,0
EST,2020-09,1,0,Estonia,1328976,Europe,1,0
EST,2020-10,9,0,Estonia,1328976,Europe,10,0
EST,2020-11,161,0,Estonia,1328976,Europe,171,0
EST,2020-12,155,0,Estonia,1328976,Europe,326,0
EST,2020-13,353,3,Estonia,1328976,Europe,679,3
EST,2020-14,418,12,Estonia,1328976,Europe,1097,15
EST,2020-15,212,10,Estonia,1328976,Europe,1309,25
EST,2020-16,219,15,Estonia,1328976,Europe,1528,40
EST,2020-17,115,9,Estonia,1328976,Europe,1643,49
EST,2020-18,57,6,Estonia,1328976,Europe,1700,55
EST,2020-19,39,5,Estonia,1328976,Europe,1739,60
EST,2020-20,35,3,Estonia,1328976,Europe,1774,63
EST,2020-21,49,0,Estonia,1328976,Europe,1823,63
EST,2020-22,46,0,Estonia,1328976,Europe,1869,63
EST,2020-23,70,0,Estonia,1328976,Europe,1939,63
EST,2020-24,34,0,Estonia,1328976,Europe,1973,63
EST,2020-25,8,0,Estonia,1328976,Europe,1981,63
EST,2020-26,6,0,Estonia,1328976,Europe,1987,63
EST,2020-27,6,0,Estonia,1328976,Europe,1993,63
EST,2020-28,21,0,Estonia,1328976,Europe,2014,63
EST,2020-29,7,0,Estonia,1328976,Europe,2021,63
EST,2020-30,13,0,Estonia,1328976,Europe,2034,63
EST,2020-31,45,0,Estonia,1328976,Europe,2079,63
EST,2020-32,73,0,Estonia,1328976,Europe,2152,63
EST,2020-33,38,0,Estonia,1328976,Europe,2190,63
EST,2020-34,82,0,Estonia,1328976,Europe,2272,63
EST,2020-35,101,1,Estonia,1328976,Europe,2373,64
EST,2020-36,142,0,Estonia,1328976,Europe,2515,64
EST,2020-37,161,0,Estonia,1328976,Europe,2676,64
EST,2020-38,248,0,Estonia,1328976,Europe,2924,64
EST,2020-39,276,0,Estonia,1328976,Europe,3200,64
EST,2020-40,407,3,Estonia,1328976,Europe,3607,67
EST,2020-41,258,1,Estonia,1328976,Europe,3865,68
EST,2020-42,213,0,Estonia,1328976,Europe,4078,68
EST,2020-43,333,5,Estonia,1328976,Europe,4411,73
EST,2020-44,574,0,Estonia,1328976,Europe,4985,73
EST,2020-45,1140,2,Estonia,1328976,Europe,6125,75
EST,2020-46,1512,6,Estonia,1328976,Europe,7637,81
EST,2020-47,2087,7,Estonia,1328976,Europe,9724,88
EST,2020-48,2328,24,Estonia,1328976,Europe,12052,112
EST,2020-49,2926,19,Estonia,1328976,Europe,14978,131
EST,2020-50,3077,18,Estonia,1328976,Europe,18055,149
EST,2020-51,3739,25,Estonia,1328976,Europe,21794,174
EST,2020-52,4014,39,Estonia,1328976,Europe,25808,213
EST,2020-53,3713,38,Estonia,1328976,Europe,29521,251
EST,2021-01,4284,36,Estonia,1328976,Europe,33805,287
EST,2021-02,3539,46,Estonia,1328976,Europe,37344,333
EST,2021-03,3372,43,Estonia,1328976,Europe,40716,376
EST,2021-04,3492,43,Estonia,1328976,Europe,44208,419
EST,2021-05,4059,47,Estonia,1328976,Europe,48267,466
EST,2021-06,4560,35,Estonia,1328976,Europe,52827,501
EST,2021-07,4789,34,Estonia,1328976,Europe,57616,535
EST,2021-08,9012,63,Estonia,1328976,Europe,66628,598
EST,2021-09,9555,69,Estonia,1328976,Europe,76183,667
EST,2021-10,9903,61,Estonia,1328976,Europe,86086,728
EST,2021-11,10308,69,Estonia,1328976,Europe,96394,797
EST,2021-12,7820,82,Estonia,1328976,Europe,104214,879
EST,2021-13,5567,71,Estonia,1328976,Europe,109781,950
EST,2021-14,4662,87,Estonia,1328976,Europe,114443,1037
EST,2021-15,3339,63,Estonia,1328976,Europe,117782,1100
EST,2021-16,2596,43,Estonia,1328976,Europe,120378,1143
EST,2021-17,2565,29,Estonia,1328976,Europe,122943,1172
EST,2021-18,2394,32,Estonia,1328976,Europe,125337,1204
EST,2021-19,1869,18,Estonia,1328976,Europe,127206,1222
EST,2021-20,1463,19,Estonia,1328976,Europe,128669,1241
EST,2021-21,875,11,Estonia,1328976,Europe,129544,1252
EST,2021-22,612,12,Estonia,1328976,Europe,130156,1264
EST,2021-23,382,2,Estonia,1328976,Europe,130538,1266
EST,2021-24,280,2,Estonia,1328976,Europe,130818,1268
EST,2021-25,165,1,Estonia,1328976,Europe,130983,1269
EST,2021-26,224,1,Estonia,1328976,Europe,131207,1270
EST,2021-27,301,0,Estonia,1328976,Europe,131508,1270
EST,2021-28,374,1,Estonia,1328976,Europe,131882,1271
EST,2021-29,642,0,Estonia,1328976,Europe,132524,1271
EST,2021-30,1247,1,Estonia,1328976,Europe,133771,1272
EST,2021-31,1452,5,Estonia,1328976,Europe,135223,1277
EST,2021-32,1932,2,Estonia,1328976,Europe,137155,1279
ETH,2020-12,7,0,Ethiopia,114963583,Africa,7,0
ETH,2020-13,5,0,Ethiopia,114963583,Africa,12,0
ETH,2020-14,27,2,Ethiopia,114963583,Africa,39,2
ETH,2020-15,28,1,Ethiopia,114963583,Africa,67,3
ETH,2020-16,37,0,Ethiopia,114963583,Africa,104,3
ETH,2020-17,15,0,Ethiopia,114963583,Africa,119,3
ETH,2020-18,12,0,Ethiopia,114963583,Africa,131,3
ETH,2020-19,104,2,Ethiopia,114963583,Africa,235,5
ETH,2020-20,78,0,Ethiopia,114963583,Africa,313,5
ETH,2020-21,265,0,Ethiopia,114963583,Africa,578,5
ETH,2020-22,590,6,Ethiopia,114963583,Africa,1168,11
ETH,2020-23,848,16,Ethiopia,114963583,Africa,2016,27
ETH,2020-24,1325,30,Ethiopia,114963583,Africa,3341,57
ETH,2020-25,1187,17,Ethiopia,114963583,Africa,4528,74
ETH,2020-26,1157,24,Ethiopia,114963583,Africa,5685,98
ETH,2020-27,157,5,Ethiopia,114963583,Africa,5842,103
ETH,2020-28,1714,24,Ethiopia,114963583,Africa,7556,127
ETH,2020-29,1943,40,Ethiopia,114963583,Africa,9499,167
ETH,2020-30,4465,56,Ethiopia,114963583,Africa,13964,223
ETH,2020-31,4031,61,Ethiopia,114963583,Africa,17995,284
ETH,2020-32,4819,123,Ethiopia,114963583,Africa,22814,407
ETH,2020-33,7058,121,Ethiopia,114963583,Africa,29872,528
ETH,2020-34,10795,150,Ethiopia,114963583,Africa,40667,678
ETH,2020-35,10451,115,Ethiopia,114963583,Africa,51118,793
ETH,2020-36,7550,125,Ethiopia,114963583,Africa,58668,918
ETH,2020-37,5629,95,Ethiopia,114963583,Africa,64297,1013
ETH,2020-38,4519,83,Ethiopia,114963583,Africa,68816,1096
ETH,2020-39,4512,74,Ethiopia,114963583,Africa,73328,1170
ETH,2020-40,5487,52,Ethiopia,114963583,Africa,78815,1222
ETH,2020-41,5476,65,Ethiopia,114963583,Africa,84291,1287
ETH,2020-42,4842,65,Ethiopia,114963583,Africa,89133,1352
ETH,2020-43,4206,74,Ethiopia,114963583,Africa,93339,1426
ETH,2020-44,3240,52,Ethiopia,114963583,Africa,96579,1478
ETH,2020-45,3092,45,Ethiopia,114963583,Africa,99671,1523
ETH,2020-46,3045,46,Ethiopia,114963583,Africa,102716,1569
ETH,2020-47,3065,78,Ethiopia,114963583,Africa,105781,1647
ETH,2020-48,3749,53,Ethiopia,114963583,Africa,109530,1700
ETH,2020-49,3761,47,Ethiopia,114963583,Africa,113291,1747
ETH,2020-50,3474,59,Ethiopia,114963583,Africa,116765,1806
ETH,2020-51,3182,47,Ethiopia,114963583,Africa,119947,1853
ETH,2020-52,3194,59,Ethiopia,114963583,Africa,123141,1912
ETH,2020-53,2477,36,Ethiopia,114963583,Africa,125618,1948
ETH,2021-01,2994,55,Ethiopia,114963583,Africa,128612,2003
ETH,2021-02,2579,27,Ethiopia,114963583,Africa,131191,2030
ETH,2021-03,2572,36,Ethiopia,114963583,Africa,133763,2066
ETH,2021-04,4617,37,Ethiopia,114963583,Africa,138380,2103
ETH,2021-05,3954,45,Ethiopia,114963583,Africa,142334,2148
ETH,2021-06,4754,46,Ethiopia,114963583,Africa,147088,2194
ETH,2021-07,6449,99,Ethiopia,114963583,Africa,153537,2293
ETH,2021-08,5531,72,Ethiopia,114963583,Africa,159068,2365
ETH,2021-09,7066,64,Ethiopia,114963583,Africa,166134,2429
ETH,2021-10,9329,121,Ethiopia,114963583,Africa,175463,2550
ETH,2021-11,11898,109,Ethiopia,114963583,Africa,187361,2659
ETH,2021-12,13198,125,Ethiopia,114963583,Africa,200559,2784
ETH,2021-13,14626,179,Ethiopia,114963583,Africa,215185,2963
ETH,2021-14,13807,211,Ethiopia,114963583,Africa,228992,3174
ETH,2021-15,13032,196,Ethiopia,114963583,Africa,242024,3370
ETH,2021-16,10251,181,Ethiopia,114963583,Africa,252275,3551
ETH,2021-17,6105,175,Ethiopia,114963583,Africa,258380,3726
ETH,2021-18,4318,162,Ethiopia,114963583,Africa,262698,3888
ETH,2021-19,3562,108,Ethiopia,114963583,Africa,266260,3996
ETH,2021-20,2930,80,Ethiopia,114963583,Africa,269190,4076
ETH,2021-21,2151,79,Ethiopia,114963583,Africa,271341,4155
ETH,2021-22,1569,54,Ethiopia,114963583,Africa,272910,4209
ETH,2021-23,1273,33,Ethiopia,114963583,Africa,274183,4242
ETH,2021-24,1007,41,Ethiopia,114963583,Africa,275190,4283
ETH,2021-25,741,31,Ethiopia,114963583,Africa,275931,4314
ETH,2021-26,500,17,Ethiopia,114963583,Africa,276431,4331
ETH,2021-27,636,12,Ethiopia,114963583,Africa,277067,4343
ETH,2021-28,625,14,Ethiopia,114963583,Africa,277692,4357
ETH,2021-29,847,12,Ethiopia,114963583,Africa,278539,4369
ETH,2021-30,2022,21,Ethiopia,114963583,Africa,280561,4390
ETH,2021-31,3526,36,Ethiopia,114963583,Africa,284087,4426
ETH,2021-32,5183,52,Ethiopia,114963583,Africa,289270,4478
FIN,2020-02,0,0,Finland,5525292,Europe,0,0
FIN,2020-03,0,0,Finland,5525292,Europe,0,0
FIN,2020-04,0,0,Finland,5525292,Europe,0,0
FIN,2020-05,1,0,Finland,5525292,Europe,1,0
FIN,2020-06,0,0,Finland,5525292,Europe,1,0
FIN,2020-07,0,0,Finland,5525292,Europe,1,0
FIN,2020-08,0,0,Finland,5525292,Europe,1,0
FIN,2020-09,5,0,Finland,5525292,Europe,6,0
FIN,2020-10,24,1,Finland,5525292,Europe,30,1
FIN,2020-11,237,2,Finland,5525292,Europe,267,3
FIN,2020-12,359,8,Finland,5525292,Europe,626,11
FIN,2020-13,592,30,Finland,5525292,Europe,1218,41
FIN,2020-14,709,43,Finland,5525292,Europe,1927,84
FIN,2020-15,1047,63,Finland,5525292,Europe,2974,147
FIN,2020-16,809,64,Finland,5525292,Europe,3783,211
FIN,2020-17,793,41,Finland,5525292,Europe,4576,252
FIN,2020-18,678,16,Finland,5525292,Europe,5254,268
FIN,2020-19,708,23,Finland,5525292,Europe,5962,291
FIN,2020-20,385,8,Finland,5525292,Europe,6347,299
FIN,2020-21,232,4,Finland,5525292,Europe,6579,303
FIN,2020-22,280,2,Finland,5525292,Europe,6859,305
FIN,2020-23,122,0,Finland,5525292,Europe,6981,305
FIN,2020-24,123,0,Finland,5525292,Europe,7104,305
FIN,2020-25,39,2,Finland,5525292,Europe,7143,307
FIN,2020-26,48,1,Finland,5525292,Europe,7191,308
FIN,2020-27,81,1,Finland,5525292,Europe,7272,309
FIN,2020-28,20,0,Finland,5525292,Europe,7292,309
FIN,2020-29,46,0,Finland,5525292,Europe,7338,309
FIN,2020-30,55,1,Finland,5525292,Europe,7393,310
FIN,2020-31,60,2,Finland,5525292,Europe,7453,312
FIN,2020-32,131,1,Finland,5525292,Europe,7584,313
FIN,2020-33,147,1,Finland,5525292,Europe,7731,314
FIN,2020-34,189,0,Finland,5525292,Europe,7920,314
FIN,2020-35,157,0,Finland,5525292,Europe,8077,314
FIN,2020-36,214,4,Finland,5525292,Europe,8291,318
FIN,2020-37,289,5,Finland,5525292,Europe,8580,323
FIN,2020-38,400,2,Finland,5525292,Europe,8980,325
FIN,2020-39,702,4,Finland,5525292,Europe,9682,329
FIN,2020-40,856,2,Finland,5525292,Europe,10538,331
FIN,2020-41,1460,8,Finland,5525292,Europe,11998,339
FIN,2020-42,1426,3,Finland,5525292,Europe,13424,342
FIN,2020-43,1424,5,Finland,5525292,Europe,14848,347
FIN,2020-44,1443,2,Finland,5525292,Europe,16291,349
FIN,2020-45,1506,12,Finland,5525292,Europe,17797,361
FIN,2020-46,1518,18,Finland,5525292,Europe,19315,379
FIN,2020-47,2324,29,Finland,5525292,Europe,21639,408
FIN,2020-48,2990,34,Finland,5525292,Europe,24629,442
FIN,2020-49,3002,45,Finland,5525292,Europe,27631,487
FIN,2020-50,3179,38,Finland,5525292,Europe,30810,525
FIN,2020-51,2352,35,Finland,5525292,Europe,33162,560
FIN,2020-52,1975,21,Finland,5525292,Europe,35137,581
FIN,2020-53,1782,26,Finland,5525292,Europe,36919,607
FIN,2021-01,1671,26,Finland,5525292,Europe,38590,633
FIN,2021-02,1747,29,Finland,5525292,Europe,40337,662
FIN,2021-03,2243,27,Finland,5525292,Europe,42580,689
FIN,2021-04,2902,13,Finland,5525292,Europe,45482,702
FIN,2021-05,2487,15,Finland,5525292,Europe,47969,717
FIN,2021-06,2350,22,Finland,5525292,Europe,50319,739
FIN,2021-07,3813,17,Finland,5525292,Europe,54132,756
FIN,2021-08,3540,35,Finland,5525292,Europe,57672,791
FIN,2021-09,4391,20,Finland,5525292,Europe,62063,811
FIN,2021-10,4806,20,Finland,5525292,Europe,66869,831
FIN,2021-11,4774,25,Finland,5525292,Europe,71643,856
FIN,2021-12,4360,22,Finland,5525292,Europe,76003,878
FIN,2021-13,3393,11,Finland,5525292,Europe,79396,889
FIN,2021-14,2657,9,Finland,5525292,Europe,82053,898
FIN,2021-15,2078,18,Finland,5525292,Europe,84131,916
FIN,2021-16,1673,8,Finland,5525292,Europe,85804,924
FIN,2021-17,1424,9,Finland,5525292,Europe,87228,933
FIN,2021-18,1495,5,Finland,5525292,Europe,88723,938
FIN,2021-19,1382,14,Finland,5525292,Europe,90105,952
FIN,2021-20,1421,12,Finland,5525292,Europe,91526,964
FIN,2021-21,906,4,Finland,5525292,Europe,92432,968
FIN,2021-22,794,2,Finland,5525292,Europe,93226,970
FIN,2021-23,595,0,Finland,5525292,Europe,93821,970
FIN,2021-24,513,2,Finland,5525292,Europe,94334,972
FIN,2021-25,750,1,Finland,5525292,Europe,95084,973
FIN,2021-26,1379,1,Finland,5525292,Europe,96463,974
FIN,2021-27,1619,2,Finland,5525292,Europe,98082,976
FIN,2021-28,2074,3,Finland,5525292,Europe,100156,979
FIN,2021-29,2816,1,Finland,5525292,Europe,102972,980
FIN,2021-30,4349,4,Finland,5525292,Europe,107321,984
FIN,2021-31,4886,7,Finland,5525292,Europe,112207,991
FIN,2021-32,5324,12,Finland,5525292,Europe,117531,1003
FJI,2020-13,2,0,Fiji,896444,Oceania,2,0
FJI,2020-14,9,0,Fiji,896444,Oceania,11,0
FJI,2020-15,2,0,Fiji,896444,Oceania,13,0
FJI,2020-16,1,0,Fiji,896444,Oceania,14,0
FJI,2020-17,1,0,Fiji,896444,Oceania,15,0
FJI,2020-18,0,0,Fiji,896444,Oceania,15,0
FJI,2020-19,0,0,Fiji,896444,Oceania,15,0
FJI,2020-20,0,0,Fiji,896444,Oceania,15,0
FJI,2020-21,0,0,Fiji,896444,Oceania,15,0
FJI,2020-22,0,0,Fiji,896444,Oceania,15,0
FJI,2020-23,0,0,Fiji,896444,Oceania,15,0
FJI,2020-24,0,0,Fiji,896444,Oceania,15,0
FJI,2020-25,0,0,Fiji,896444,Oceania,15,0
FJI,2020-26,0,0,Fiji,896444,Oceania,15,0
FJI,2020-27,0,0,Fiji,896444,Oceania,15,0
FJI,2020-28,8,0,Fiji,896444,Oceania,23,0
FJI,2020-29,0,0,Fiji,896444,Oceania,23,0
FJI,2020-30,1,0,Fiji,896444,Oceania,24,0
FJI,2020-31,0,1,Fiji,896444,Oceania,24,1
FJI,2020-32,0,0,Fiji,896444,Oceania,24,1
FJI,2020-33,1,0,Fiji,896444,Oceania,25,1
FJI,2020-34,0,0,Fiji,896444,Oceania,25,1
FJI,2020-35,0,1,Fiji,896444,Oceania,25,2
FJI,2020-36,3,0,Fiji,896444,Oceania,28,2
FJI,2020-37,1,0,Fiji,896444,Oceania,29,2
FJI,2020-38,0,0,Fiji,896444,Oceania,29,2
FJI,2020-39,0,0,Fiji,896444,Oceania,29,2
FJI,2020-40,0,0,Fiji,896444,Oceania,29,2
FJI,2020-41,0,0,Fiji,896444,Oceania,29,2
FJI,2020-42,0,0,Fiji,896444,Oceania,29,2
FJI,2020-43,1,0,Fiji,896444,Oceania,30,2
FJI,2020-44,1,0,Fiji,896444,Oceania,31,2
FJI,2020-45,0,0,Fiji,896444,Oceania,31,2
FJI,2020-46,1,0,Fiji,896444,Oceania,32,2
FJI,2020-47,0,0,Fiji,896444,Oceania,32,2
FJI,2020-48,7,0,Fiji,896444,Oceania,39,2
FJI,2020-49,2,0,Fiji,896444,Oceania,41,2
FJI,2020-50,2,0,Fiji,896444,Oceania,43,2
FJI,2020-51,0,0,Fiji,896444,Oceania,43,2
FJI,2020-52,0,0,Fiji,896444,Oceania,43,2
FJI,2020-53,3,0,Fiji,896444,Oceania,46,2
FJI,2021-01,4,0,Fiji,896444,Oceania,50,2
FJI,2021-02,2,0,Fiji,896444,Oceania,52,2
FJI,2021-03,0,0,Fiji,896444,Oceania,52,2
FJI,2021-04,0,0,Fiji,896444,Oceania,52,2
FJI,2021-05,1,0,Fiji,896444,Oceania,53,2
FJI,2021-06,0,0,Fiji,896444,Oceania,53,2
FJI,2021-07,0,0,Fiji,896444,Oceania,53,2
FJI,2021-08,3,0,Fiji,896444,Oceania,56,2
FJI,2021-09,7,0,Fiji,896444,Oceania,63,2
FJI,2021-10,0,0,Fiji,896444,Oceania,63,2
FJI,2021-11,1,0,Fiji,896444,Oceania,64,2
FJI,2021-12,0,0,Fiji,896444,Oceania,64,2
FJI,2021-13,0,0,Fiji,896444,Oceania,64,2
FJI,2021-14,1,0,Fiji,896444,Oceania,65,2
FJI,2021-15,4,0,Fiji,896444,Oceania,69,2
FJI,2021-16,19,0,Fiji,896444,Oceania,88,2
FJI,2021-17,30,0,Fiji,896444,Oceania,118,2
FJI,2021-18,18,1,Fiji,896444,Oceania,136,3
FJI,2021-19,35,1,Fiji,896444,Oceania,171,4
FJI,2021-20,56,0,Fiji,896444,Oceania,227,4
FJI,2021-21,171,0,Fiji,896444,Oceania,398,4
FJI,2021-22,350,0,Fiji,896444,Oceania,748,4
FJI,2021-23,455,0,Fiji,896444,Oceania,1203,4
FJI,2021-24,884,3,Fiji,896444,Oceania,2087,7
FJI,2021-25,1742,10,Fiji,896444,Oceania,3829,17
FJI,2021-26,3317,22,Fiji,896444,Oceania,7146,39
FJI,2021-27,4236,19,Fiji,896444,Oceania,11382,58
FJI,2021-28,6843,55,Fiji,896444,Oceania,18225,113
FJI,2021-29,3133,48,Fiji,896444,Oceania,21358,161
FJI,2021-30,9052,80,Fiji,896444,Oceania,30410,241
FJI,2021-31,6566,58,Fiji,896444,Oceania,36976,299
FJI,2021-32,3608,95,Fiji,896444,Oceania,40584,394
FLK,2020-15,3,0,Falkland Islands (Malvinas),3483,America,3,0
FLK,2020-16,6,0,Falkland Islands (Malvinas),3483,America,9,0
FLK,2020-17,2,0,Falkland Islands (Malvinas),3483,America,11,0
FLK,2020-18,0,0,Falkland Islands (Malvinas),3483,America,11,0
FLK,2020-19,0,0,Falkland Islands (Malvinas),3483,America,11,0
FLK,2020-20,0,0,Falkland Islands (Malvinas),3483,America,11,0
FLK,2020-21,0,0,Falkland Islands (Malvinas),3483,America,11,0
FLK,2020-22,0,0,Falkland Islands (Malvinas),3483,America,11,0
FLK,2020-23,0,0,Falkland Islands (Malvinas),3483,America,11,0
FLK,2020-24,0,0,Falkland Islands (Malvinas),3483,America,11,0
FLK,2020-25,0,0,Falkland Islands (Malvinas),3483,America,11,0
FLK,2020-26,0,0,Falkland Islands (Malvinas),3483,America,11,0
FLK,2020-27,0,0,Falkland Islands (Malvinas),3483,America,11,0
FLK,2020-28,0,0,Falkland Islands (Malvinas),3483,America,11,0
FLK,2020-29,0,0,Falkland Islands (Malvinas),3483,America,11,0
FLK,2020-30,0,0,Falkland Islands (Malvinas),3483,America,11,0
FLK,2020-31,0,0,Falkland Islands (Malvinas),3483,America,11,0
FLK,2020-32,0,0,Falkland Islands (Malvinas),3483,America,11,0
FLK,2020-33,0,0,Falkland Islands (Malvinas),3483,America,11,0
FLK,2020-34,0,0,Falkland Islands (Malvinas),3483,America,11,0
FLK,2020-35,0,0,Falkland Islands (Malvinas),3483,America,11,0
FLK,2020-36,0,0,Falkland Islands (Malvinas),3483,America,11,0
FLK,2020-37,0,0,Falkland Islands (Malvinas),3483,America,11,0
FLK,2020-38,0,0,Falkland Islands (Malvinas),3483,America,11,0
FLK,2020-39,0,0,Falkland Islands (Malvinas),3483,America,11,0
FLK,2020-40,0,0,Falkland Islands (Malvinas),3483,America,11,0
FLK,2020-41,0,0,Falkland Islands (Malvinas),3483,America,11,0
FLK,2020-42,0,0,Falkland Islands (Malvinas),3483,America,11,0
FLK,2020-43,0,0,Falkland Islands (Malvinas),3483,America,11,0
FLK,2020-44,0,0,Falkland Islands (Malvinas),3483,America,11,0
FLK,2020-45,0,0,Falkland Islands (Malvinas),3483,America,11,0
FLK,2020-46,2,0,Falkland Islands (Malvinas),3483,America,13,0
FLK,2020-47,1,0,Falkland Islands (Malvinas),3483,America,14,0
FLK,2020-48,1,0,Falkland Islands (Malvinas),3483,America,15,0
FLK,2020-49,0,0,Falkland Islands (Malvinas),3483,America,15,0
FLK,2020-50,2,0,Falkland Islands (Malvinas),3483,America,17,0
FLK,2020-51,4,0,Falkland Islands (Malvinas),3483,America,21,0
FLK,2020-52,5,0,Falkland Islands (Malvinas),3483,America,26,0
FLK,2020-53,1,0,Falkland Islands (Malvinas),3483,America,27,0
FLK,2021-01,0,0,Falkland Islands (Malvinas),3483,America,27,0
FLK,2021-02,3,0,Falkland Islands (Malvinas),3483,America,30,0
FLK,2021-03,5,0,Falkland Islands (Malvinas),3483,America,35,0
FLK,2021-04,3,0,Falkland Islands (Malvinas),3483,America,38,0
FLK,2021-05,8,0,Falkland Islands (Malvinas),3483,America,46,0
FLK,2021-06,1,0,Falkland Islands (Malvinas),3483,America,47,0
FLK,2021-07,0,0,Falkland Islands (Malvinas),3483,America,47,0
FLK,2021-08,2,0,Falkland Islands (Malvinas),3483,America,49,0
FLK,2021-09,3,0,Falkland Islands (Malvinas),3483,America,52,0
FLK,2021-10,0,0,Falkland Islands (Malvinas),3483,America,52,0
FLK,2021-11,0,0,Falkland Islands (Malvinas),3483,America,52,0
FLK,2021-12,0,0,Falkland Islands (Malvinas),3483,America,52,0
FLK,2021-13,0,0,Falkland Islands (Malvinas),3483,America,52,0
FLK,2021-14,6,0,Falkland Islands (Malvinas),3483,America,58,0
FLK,2021-15,2,0,Falkland Islands (Malvinas),3483,America,60,0
FLK,2021-16,1,0,Falkland Islands (Malvinas),3483,America,61,0
FLK,2021-17,0,0,Falkland Islands (Malvinas),3483,America,61,0
FLK,2021-18,0,0,Falkland Islands (Malvinas),3483,America,61,0
FLK,2021-19,0,0,Falkland Islands (Malvinas),3483,America,61,0
FLK,2021-20,0,0,Falkland Islands (Malvinas),3483,America,61,0
FLK,2021-21,0,0,Falkland Islands (Malvinas),3483,America,61,0
FLK,2021-22,0,0,Falkland Islands (Malvinas),3483,America,61,0
FLK,2021-23,0,0,Falkland Islands (Malvinas),3483,America,61,0
FLK,2021-24,0,0,Falkland Islands (Malvinas),3483,America,61,0
FLK,2021-25,0,0,Falkland Islands (Malvinas),3483,America,61,0
FLK,2021-26,0,0,Falkland Islands (Malvinas),3483,America,61,0
FLK,2021-27,0,0,Falkland Islands (Malvinas),3483,America,61,0
FLK,2021-28,0,0,Falkland Islands (Malvinas),3483,America,61,0
FLK,2021-29,0,0,Falkland Islands (Malvinas),3483,America,61,0
FLK,2021-30,0,0,Falkland Islands (Malvinas),3483,America,61,0
FLK,2021-31,3,0,Falkland Islands (Malvinas),3483,America,64,0
FLK,2021-32,0,0,Falkland Islands (Malvinas),3483,America,64,0
FRA,2020-02,0,0,France,67320216,Europe,0,0
FRA,2020-03,0,0,France,67320216,Europe,0,0
FRA,2020-04,3,0,France,67320216,Europe,3,0
FRA,2020-05,3,0,France,67320216,Europe,6,0
FRA,2020-06,5,0,France,67320216,Europe,11,0
FRA,2020-07,1,1,France,67320216,Europe,12,1
FRA,2020-08,0,0,France,67320216,Europe,12,1
FRA,2020-09,121,1,France,67320216,Europe,133,2
FRA,2020-10,981,17,France,67320216,Europe,1114,19
FRA,2020-11,4297,108,France,67320216,Europe,5411,127
FRA,2020-12,11266,547,France,67320216,Europe,16677,674
FRA,2020-13,23485,1932,France,67320216,Europe,40162,2606
FRA,2020-14,31002,5472,France,67320216,Europe,71164,8078
FRA,2020-15,25898,6315,France,67320216,Europe,97062,14393
FRA,2020-16,16220,5325,France,67320216,Europe,113282,19718
FRA,2020-17,11120,3138,France,67320216,Europe,124402,22856
FRA,2020-18,6144,2039,France,67320216,Europe,130546,24895
FRA,2020-19,4046,1485,France,67320216,Europe,134592,26380
FRA,2020-20,3392,1331,France,67320216,Europe,137984,27711
FRA,2020-21,4663,656,France,67320216,Europe,142647,28367
FRA,2020-22,4005,435,France,67320216,Europe,146652,28802
FRA,2020-23,3169,353,France,67320216,Europe,149821,29155
FRA,2020-24,3282,252,France,67320216,Europe,153103,29407
FRA,2020-25,3558,233,France,67320216,Europe,156661,29640
FRA,2020-26,3575,138,France,67320216,Europe,160236,29778
FRA,2020-27,3832,115,France,67320216,Europe,164068,29893
FRA,2020-28,3994,111,France,67320216,Europe,168062,30004
FRA,2020-29,4503,148,France,67320216,Europe,172565,30152
FRA,2020-30,6628,40,France,67320216,Europe,179193,30192
FRA,2020-31,8503,73,France,67320216,Europe,187696,30265
FRA,2020-32,11908,59,France,67320216,Europe,199604,30324
FRA,2020-33,17306,86,France,67320216,Europe,216910,30410
FRA,2020-34,28123,103,France,67320216,Europe,245033,30513
FRA,2020-35,39812,93,France,67320216,Europe,284845,30606
FRA,2020-36,52783,95,France,67320216,Europe,337628,30701
FRA,2020-37,64661,215,France,67320216,Europe,402289,30916
FRA,2020-38,75740,369,France,67320216,Europe,478029,31285
FRA,2020-39,74047,442,France,67320216,Europe,552076,31727
FRA,2020-40,79885,503,France,67320216,Europe,631961,32230
FRA,2020-41,123001,500,France,67320216,Europe,754962,32730
FRA,2020-42,174734,747,France,67320216,Europe,929696,33477
FRA,2020-43,275387,1284,France,67320216,Europe,1205083,34761
FRA,2020-44,334435,2258,France,67320216,Europe,1539518,37019
FRA,2020-45,304537,3420,France,67320216,Europe,1844055,40439
FRA,2020-46,178236,4109,France,67320216,Europe,2022291,44548
FRA,2020-47,116361,4184,France,67320216,Europe,2138652,48732
FRA,2020-48,78220,3593,France,67320216,Europe,2216872,52325
FRA,2020-49,72108,2830,France,67320216,Europe,2288980,55155
FRA,2020-50,78718,2756,France,67320216,Europe,2367698,57911
FRA,2020-51,94277,2638,France,67320216,Europe,2461975,60549
FRA,2020-52,85079,2560,France,67320216,Europe,2547054,63109
FRA,2020-53,89718,1928,France,67320216,Europe,2636772,65037
FRA,2021-01,123772,2713,France,67320216,Europe,2760544,67750
FRA,2021-02,120584,2533,France,67320216,Europe,2881128,70283
FRA,2021-03,132681,2766,France,67320216,Europe,3013809,73049
FRA,2021-04,134201,3008,France,67320216,Europe,3148010,76057
FRA,2021-05,131725,2908,France,67320216,Europe,3279735,78965
FRA,2021-06,114493,2849,France,67320216,Europe,3394228,81814
FRA,2021-07,120503,2492,France,67320216,Europe,3514731,84306
FRA,2021-08,130574,2148,France,67320216,Europe,3645305,86454
FRA,2021-09,128276,2146,France,67320216,Europe,3773581,88600
FRA,2021-10,149109,1855,France,67320216,Europe,3922690,90455
FRA,2021-11,190121,1850,France,67320216,Europe,4112811,92305
FRA,2021-12,230574,2318,France,67320216,Europe,4343385,94623
FRA,2021-13,243764,2055,France,67320216,Europe,4587149,96678
FRA,2021-14,205598,2100,France,67320216,Europe,4792747,98778
FRA,2021-15,201074,1984,France,67320216,Europe,4993821,100762
FRA,2021-16,178829,2125,France,67320216,Europe,5172650,102887
FRA,2021-17,132684,1961,France,67320216,Europe,5305334,104848
FRA,2021-18,109016,1573,France,67320216,Europe,5414350,106421
FRA,2021-19,88274,1224,France,67320216,Europe,5502624,107645
FRA,2021-20,101042,980,France,67320216,Europe,5603666,108625
FRA,2021-21,62447,806,France,67320216,Europe,5666113,109431
FRA,2021-22,46640,596,France,67320216,Europe,5712753,110027
FRA,2021-23,27912,393,France,67320216,Europe,5740665,110420
FRA,2021-24,16646,347,France,67320216,Europe,5757311,110767
FRA,2021-25,12710,230,France,67320216,Europe,5770021,110997
FRA,2021-26,16182,193,France,67320216,Europe,5786203,111190
FRA,2021-27,26436,164,France,67320216,Europe,5812639,111354
FRA,2021-28,55091,147,France,67320216,Europe,5867730,111501
FRA,2021-29,126207,143,France,67320216,Europe,5993937,111644
FRA,2021-30,152682,272,France,67320216,Europe,6146619,111916
FRA,2021-31,158539,334,France,67320216,Europe,6305158,112250
FRA,2021-32,165877,452,France,67320216,Europe,6471035,112702
FRO,2020-11,6,0,Faroe Islands,48865,Europe,6,0
FRO,2020-12,106,0,Faroe Islands,48865,Europe,112,0
FRO,2020-13,44,0,Faroe Islands,48865,Europe,156,0
FRO,2020-14,22,0,Faroe Islands,48865,Europe,178,0
FRO,2020-15,3,0,Faroe Islands,48865,Europe,181,0
FRO,2020-16,1,0,Faroe Islands,48865,Europe,182,0
FRO,2020-17,2,0,Faroe Islands,48865,Europe,184,0
FRO,2020-18,0,0,Faroe Islands,48865,Europe,184,0
FRO,2020-19,0,0,Faroe Islands,48865,Europe,184,0
FRO,2020-20,0,0,Faroe Islands,48865,Europe,184,0
FRO,2020-21,0,0,Faroe Islands,48865,Europe,184,0
FRO,2020-22,0,0,Faroe Islands,48865,Europe,184,0
FRO,2020-23,0,0,Faroe Islands,48865,Europe,184,0
FRO,2020-24,0,0,Faroe Islands,48865,Europe,184,0
FRO,2020-25,0,0,Faroe Islands,48865,Europe,184,0
FRO,2020-26,0,0,Faroe Islands,48865,Europe,184,0
FRO,2020-27,0,0,Faroe Islands,48865,Europe,184,0
FRO,2020-28,1,0,Faroe Islands,48865,Europe,185,0
FRO,2020-29,3,0,Faroe Islands,48865,Europe,188,0
FRO,2020-30,0,0,Faroe Islands,48865,Europe,188,0
FRO,2020-31,34,0,Faroe Islands,48865,Europe,222,0
FRO,2020-32,66,0,Faroe Islands,48865,Europe,288,0
FRO,2020-33,81,0,Faroe Islands,48865,Europe,369,0
FRO,2020-34,12,0,Faroe Islands,48865,Europe,381,0
FRO,2020-35,27,0,Faroe Islands,48865,Europe,408,0
FRO,2020-36,2,0,Faroe Islands,48865,Europe,410,0
FRO,2020-37,10,0,Faroe Islands,48865,Europe,420,0
FRO,2020-38,11,0,Faroe Islands,48865,Europe,431,0
FRO,2020-39,26,0,Faroe Islands,48865,Europe,457,0
FRO,2020-40,14,0,Faroe Islands,48865,Europe,471,0
FRO,2020-41,3,0,Faroe Islands,48865,Europe,474,0
FRO,2020-42,8,0,Faroe Islands,48865,Europe,482,0
FRO,2020-43,5,0,Faroe Islands,48865,Europe,487,0
FRO,2020-44,5,0,Faroe Islands,48865,Europe,492,0
FRO,2020-45,2,0,Faroe Islands,48865,Europe,494,0
FRO,2020-46,1,0,Faroe Islands,48865,Europe,495,0
FRO,2020-47,2,0,Faroe Islands,48865,Europe,497,0
FRO,2020-48,2,0,Faroe Islands,48865,Europe,499,0
FRO,2020-49,8,0,Faroe Islands,48865,Europe,507,0
FRO,2020-50,18,0,Faroe Islands,48865,Europe,525,0
FRO,2020-51,18,0,Faroe Islands,48865,Europe,543,0
FRO,2020-52,36,0,Faroe Islands,48865,Europe,579,0
FRO,2020-53,38,0,Faroe Islands,48865,Europe,617,0
FRO,2021-01,26,1,Faroe Islands,48865,Europe,643,1
FRO,2021-02,3,0,Faroe Islands,48865,Europe,646,1
FRO,2021-03,3,0,Faroe Islands,48865,Europe,649,1
FRO,2021-04,2,0,Faroe Islands,48865,Europe,651,1
FRO,2021-05,2,0,Faroe Islands,48865,Europe,653,1
FRO,2021-06,1,0,Faroe Islands,48865,Europe,654,1
FRO,2021-07,1,0,Faroe Islands,48865,Europe,655,1
FRO,2021-08,0,0,Faroe Islands,48865,Europe,655,1
FRO,2021-09,2,0,Faroe Islands,48865,Europe,657,1
FRO,2021-10,1,0,Faroe Islands,48865,Europe,658,1
FRO,2021-11,0,0,Faroe Islands,48865,Europe,658,1
FRO,2021-12,0,0,Faroe Islands,48865,Europe,658,1
FRO,2021-13,0,0,Faroe Islands,48865,Europe,658,1
FRO,2021-14,0,0,Faroe Islands,48865,Europe,658,1
FRO,2021-15,1,0,Faroe Islands,48865,Europe,659,1
FRO,2021-16,1,0,Faroe Islands,48865,Europe,660,1
FRO,2021-17,1,0,Faroe Islands,48865,Europe,661,1
FRO,2021-18,4,0,Faroe Islands,48865,Europe,665,1
FRO,2021-19,2,0,Faroe Islands,48865,Europe,667,1
FRO,2021-20,22,0,Faroe Islands,48865,Europe,689,1
FRO,2021-21,26,0,Faroe Islands,48865,Europe,715,1
FRO,2021-22,26,0,Faroe Islands,48865,Europe,741,1
FRO,2021-23,12,0,Faroe Islands,48865,Europe,753,1
FRO,2021-24,12,0,Faroe Islands,48865,Europe,765,1
FRO,2021-25,4,0,Faroe Islands,48865,Europe,769,1
FRO,2021-26,12,0,Faroe Islands,48865,Europe,781,1
FRO,2021-27,84,0,Faroe Islands,48865,Europe,865,1
FRO,2021-28,65,0,Faroe Islands,48865,Europe,930,1
FRO,2021-29,40,0,Faroe Islands,48865,Europe,970,1
FRO,2021-30,12,1,Faroe Islands,48865,Europe,982,2
FRO,2021-31,4,0,Faroe Islands,48865,Europe,986,2
FRO,2021-32,3,0,Faroe Islands,48865,Europe,989,2
FSM,2021-02,0,0,Micronesia (Federated States Of),115021,Oceania,0,0
FSM,2021-03,0,0,Micronesia (Federated States Of),115021,Oceania,0,0
FSM,2021-04,0,0,Micronesia (Federated States Of),115021,Oceania,0,0
FSM,2021-05,0,0,Micronesia (Federated States Of),115021,Oceania,0,0
FSM,2021-06,0,0,Micronesia (Federated States Of),115021,Oceania,0,0
FSM,2021-07,0,0,Micronesia (Federated States Of),115021,Oceania,0,0
FSM,2021-08,0,0,Micronesia (Federated States Of),115021,Oceania,0,0
FSM,2021-09,0,0,Micronesia (Federated States Of),115021,Oceania,0,0
FSM,2021-10,0,0,Micronesia (Federated States Of),115021,Oceania,0,0
FSM,2021-11,0,0,Micronesia (Federated States Of),115021,Oceania,0,0
FSM,2021-12,0,0,Micronesia (Federated States Of),115021,Oceania,0,0
FSM,2021-13,0,0,Micronesia (Federated States Of),115021,Oceania,0,0
FSM,2021-14,0,0,Micronesia (Federated States Of),115021,Oceania,0,0
FSM,2021-15,0,0,Micronesia (Federated States Of),115021,Oceania,0,0
FSM,2021-16,0,0,Micronesia (Federated States Of),115021,Oceania,0,0
FSM,2021-17,0,0,Micronesia (Federated States Of),115021,Oceania,0,0
FSM,2021-18,0,0,Micronesia (Federated States Of),115021,Oceania,0,0
FSM,2021-19,0,0,Micronesia (Federated States Of),115021,Oceania,0,0
FSM,2021-20,0,0,Micronesia (Federated States Of),115021,Oceania,0,0
FSM,2021-21,0,0,Micronesia (Federated States Of),115021,Oceania,0,0
FSM,2021-22,0,0,Micronesia (Federated States Of),115021,Oceania,0,0
FSM,2021-23,0,0,Micronesia (Federated States Of),115021,Oceania,0,0
FSM,2021-24,0,0,Micronesia (Federated States Of),115021,Oceania,0,0
FSM,2021-25,0,0,Micronesia (Federated States Of),115021,Oceania,0,0
FSM,2021-26,0,0,Micronesia (Federated States Of),115021,Oceania,0,0
FSM,2021-27,0,0,Micronesia (Federated States Of),115021,Oceania,0,0
FSM,2021-28,0,0,Micronesia (Federated States Of),115021,Oceania,0,0
FSM,2021-29,0,0,Micronesia (Federated States Of),115021,Oceania,0,0
FSM,2021-30,0,0,Micronesia (Federated States Of),115021,Oceania,0,0
FSM,2021-31,0,0,Micronesia (Federated States Of),115021,Oceania,0,0
FSM,2021-32,0,0,Micronesia (Federated States Of),115021,Oceania,0,0
GAB,2020-12,5,1,Gabon,2225728,Africa,5,1
GAB,2020-13,1,0,Gabon,2225728,Africa,6,1
GAB,2020-14,14,0,Gabon,2225728,Africa,20,1
GAB,2020-15,36,0,Gabon,2225728,Africa,56,1
GAB,2020-16,52,0,Gabon,2225728,Africa,108,1
GAB,2020-17,67,2,Gabon,2225728,Africa,175,3
GAB,2020-18,159,2,Gabon,2225728,Africa,334,5
GAB,2020-19,326,3,Gabon,2225728,Africa,660,8
GAB,2020-20,659,3,Gabon,2225728,Africa,1319,11
GAB,2020-21,614,1,Gabon,2225728,Africa,1933,12
GAB,2020-22,721,5,Gabon,2225728,Africa,2654,17
GAB,2020-23,446,4,Gabon,2225728,Africa,3100,21
GAB,2020-24,362,2,Gabon,2225728,Africa,3462,23
GAB,2020-25,965,11,Gabon,2225728,Africa,4427,34
GAB,2020-26,781,6,Gabon,2225728,Africa,5208,40
GAB,2020-27,411,4,Gabon,2225728,Africa,5619,44
GAB,2020-28,322,2,Gabon,2225728,Africa,5941,46
GAB,2020-29,373,0,Gabon,2225728,Africa,6314,46
GAB,2020-30,669,3,Gabon,2225728,Africa,6983,49
GAB,2020-31,547,1,Gabon,2225728,Africa,7530,50
GAB,2020-32,392,1,Gabon,2225728,Africa,7922,51
GAB,2020-33,302,0,Gabon,2225728,Africa,8224,51
GAB,2020-34,163,2,Gabon,2225728,Africa,8387,53
GAB,2020-35,117,0,Gabon,2225728,Africa,8504,53
GAB,2020-36,96,0,Gabon,2225728,Africa,8600,53
GAB,2020-37,42,0,Gabon,2225728,Africa,8642,53
GAB,2020-38,53,0,Gabon,2225728,Africa,8695,53
GAB,2020-39,32,1,Gabon,2225728,Africa,8727,54
GAB,2020-40,69,0,Gabon,2225728,Africa,8796,54
GAB,2020-41,38,0,Gabon,2225728,Africa,8834,54
GAB,2020-42,46,0,Gabon,2225728,Africa,8880,54
GAB,2020-43,38,0,Gabon,2225728,Africa,8918,54
GAB,2020-44,49,1,Gabon,2225728,Africa,8967,55
GAB,2020-45,54,0,Gabon,2225728,Africa,9021,55
GAB,2020-46,40,3,Gabon,2225728,Africa,9061,58
GAB,2020-47,69,1,Gabon,2225728,Africa,9130,59
GAB,2020-48,60,0,Gabon,2225728,Africa,9190,59
GAB,2020-49,63,1,Gabon,2225728,Africa,9253,60
GAB,2020-50,97,3,Gabon,2225728,Africa,9350,63
GAB,2020-51,69,1,Gabon,2225728,Africa,9419,64
GAB,2020-52,90,0,Gabon,2225728,Africa,9509,64
GAB,2020-53,95,2,Gabon,2225728,Africa,9604,66
GAB,2021-01,135,0,Gabon,2225728,Africa,9739,66
GAB,2021-02,159,0,Gabon,2225728,Africa,9898,66
GAB,2021-03,512,1,Gabon,2225728,Africa,10410,67
GAB,2021-04,542,1,Gabon,2225728,Africa,10952,68
GAB,2021-05,504,3,Gabon,2225728,Africa,11456,71
GAB,2021-06,1408,4,Gabon,2225728,Africa,12864,75
GAB,2021-07,1019,1,Gabon,2225728,Africa,13883,76
GAB,2021-08,680,7,Gabon,2225728,Africa,14563,83
GAB,2021-09,1451,7,Gabon,2225728,Africa,16014,90
GAB,2021-10,645,6,Gabon,2225728,Africa,16659,96
GAB,2021-11,1051,10,Gabon,2225728,Africa,17710,106
GAB,2021-12,1066,5,Gabon,2225728,Africa,18776,111
GAB,2021-13,773,7,Gabon,2225728,Africa,19549,118
GAB,2021-14,1086,9,Gabon,2225728,Africa,20635,127
GAB,2021-15,1396,9,Gabon,2225728,Africa,22031,136
GAB,2021-16,401,2,Gabon,2225728,Africa,22432,138
GAB,2021-17,642,1,Gabon,2225728,Africa,23074,139
GAB,2021-18,490,4,Gabon,2225728,Africa,23564,143
GAB,2021-19,234,0,Gabon,2225728,Africa,23798,143
GAB,2021-20,308,4,Gabon,2225728,Africa,24106,147
GAB,2021-21,322,5,Gabon,2225728,Africa,24428,152
GAB,2021-22,222,2,Gabon,2225728,Africa,24650,154
GAB,2021-23,85,2,Gabon,2225728,Africa,24735,156
GAB,2021-24,128,2,Gabon,2225728,Africa,24863,158
GAB,2021-25,120,1,Gabon,2225728,Africa,24983,159
GAB,2021-26,122,2,Gabon,2225728,Africa,25105,161
GAB,2021-27,58,1,Gabon,2225728,Africa,25163,162
GAB,2021-28,119,1,Gabon,2225728,Africa,25282,163
GAB,2021-29,42,0,Gabon,2225728,Africa,25324,163
GAB,2021-30,59,1,Gabon,2225728,Africa,25383,164
GAB,2021-31,103,1,Gabon,2225728,Africa,25486,165
GAB,2021-32,77,0,Gabon,2225728,Africa,25563,165
GBR,2020-02,0,0,United Kingdom,68059863,Europe,0,0
GBR,2020-03,0,0,United Kingdom,68059863,Europe,0,0
GBR,2020-04,0,0,United Kingdom,68059863,Europe,0,0
GBR,2020-05,2,0,United Kingdom,68059863,Europe,2,0
GBR,2020-06,6,0,United Kingdom,68059863,Europe,8,0
GBR,2020-07,2,0,United Kingdom,68059863,Europe,10,0
GBR,2020-08,1,0,United Kingdom,68059863,Europe,11,0
GBR,2020-09,36,0,United Kingdom,68059863,Europe,47,0
GBR,2020-10,365,2,United Kingdom,68059863,Europe,412,2
GBR,2020-11,2193,41,United Kingdom,68059863,Europe,2605,43
GBR,2020-12,6329,245,United Kingdom,68059863,Europe,8934,288
GBR,2020-13,17889,1388,United Kingdom,68059863,Europe,26823,1676
GBR,2020-14,30357,4197,United Kingdom,68059863,Europe,57180,5873
GBR,2020-15,32205,6440,United Kingdom,68059863,Europe,89385,12313
GBR,2020-16,32027,6166,United Kingdom,68059863,Europe,121412,18479
GBR,2020-17,32830,5512,United Kingdom,68059863,Europe,154242,23991
GBR,2020-18,31282,4227,United Kingdom,68059863,Europe,185524,28218
GBR,2020-19,22867,3174,United Kingdom,68059863,Europe,208391,31392
GBR,2020-20,19857,2428,United Kingdom,68059863,Europe,228248,33820
GBR,2020-21,16360,2137,United Kingdom,68059863,Europe,244608,35957
GBR,2020-22,10907,1488,United Kingdom,68059863,Europe,255515,37445
GBR,2020-23,8524,1174,United Kingdom,68059863,Europe,264039,38619
GBR,2020-24,7136,747,United Kingdom,68059863,Europe,271175,39366
GBR,2020-25,6680,512,United Kingdom,68059863,Europe,277855,39878
GBR,2020-26,5240,442,United Kingdom,68059863,Europe,283095,40320
GBR,2020-27,4026,312,United Kingdom,68059863,Europe,287121,40632
GBR,2020-28,4271,213,United Kingdom,68059863,Europe,291392,40845
GBR,2020-29,4310,150,United Kingdom,68059863,Europe,295702,40995
GBR,2020-30,4549,116,United Kingdom,68059863,Europe,300251,41111
GBR,2020-31,4444,96,United Kingdom,68059863,Europe,304695,41207
GBR,2020-32,6130,71,United Kingdom,68059863,Europe,310825,41278
GBR,2020-33,7659,88,United Kingdom,68059863,Europe,318484,41366
GBR,2020-34,7158,63,United Kingdom,68059863,Europe,325642,41429
GBR,2020-35,8825,70,United Kingdom,68059863,Europe,334467,41499
GBR,2020-36,12685,52,United Kingdom,68059863,Europe,347152,41551
GBR,2020-37,21352,77,United Kingdom,68059863,Europe,368504,41628
GBR,2020-38,25753,149,United Kingdom,68059863,Europe,394257,41777
GBR,2020-39,40712,211,United Kingdom,68059863,Europe,434969,41988
GBR,2020-40,68009,362,United Kingdom,68059863,Europe,502978,42350
GBR,2020-41,100738,475,United Kingdom,68059863,Europe,603716,42825
GBR,2020-42,118693,821,United Kingdom,68059863,Europe,722409,43646
GBR,2020-43,151391,1250,United Kingdom,68059863,Europe,873800,44896
GBR,2020-44,161114,1821,United Kingdom,68059863,Europe,1034914,46717
GBR,2020-45,157099,2327,United Kingdom,68059863,Europe,1192013,49044
GBR,2020-46,177305,2890,United Kingdom,68059863,Europe,1369318,51934
GBR,2020-47,142727,2817,United Kingdom,68059863,Europe,1512045,54751
GBR,2020-48,105282,3494,United Kingdom,68059863,Europe,1617327,58245
GBR,2020-49,105915,3000,United Kingdom,68059863,Europe,1723242,61245
GBR,2020-50,126161,2925,United Kingdom,68059863,Europe,1849403,64170
GBR,2020-51,190744,3231,United Kingdom,68059863,Europe,2040147,67401
GBR,2020-52,289583,3708,United Kingdom,68059863,Europe,2329730,71109
GBR,2020-53,325049,3915,United Kingdom,68059863,Europe,2654779,75024
GBR,2021-01,417570,6407,United Kingdom,68059863,Europe,3072349,81431
GBR,2021-02,323610,7830,United Kingdom,68059863,Europe,3395959,89261
GBR,2021-03,251504,8678,United Kingdom,68059863,Europe,3647463,97939
GBR,2021-04,169713,8219,United Kingdom,68059863,Europe,3817176,106158
GBR,2021-05,142608,6640,United Kingdom,68059863,Europe,3959784,112798
GBR,2021-06,78294,4368,United Kingdom,68059863,Europe,4038078,117166
GBR,2021-07,77431,3414,United Kingdom,68059863,Europe,4115509,120580
GBR,2021-08,61045,2269,United Kingdom,68059863,Europe,4176554,122849
GBR,2021-09,41966,1652,United Kingdom,68059863,Europe,4218520,124501
GBR,2021-10,39918,1015,United Kingdom,68059863,Europe,4258438,125516
GBR,2021-11,38145,639,United Kingdom,68059863,Europe,4296583,126155
GBR,2021-12,36459,437,United Kingdom,68059863,Europe,4333042,126592
GBR,2021-13,26346,244,United Kingdom,68059863,Europe,4359388,126836
GBR,2021-14,13955,264,United Kingdom,68059863,Europe,4373343,127100
GBR,2021-15,14477,170,United Kingdom,68059863,Europe,4387820,127270
GBR,2021-16,17062,158,United Kingdom,68059863,Europe,4404882,127428
GBR,2021-17,15319,110,United Kingdom,68059863,Europe,4420201,127538
GBR,2021-18,14659,67,United Kingdom,68059863,Europe,4434860,127605
GBR,2021-19,15917,74,United Kingdom,68059863,Europe,4450777,127679
GBR,2021-20,11761,42,United Kingdom,68059863,Europe,4462538,127721
GBR,2021-21,21518,60,United Kingdom,68059863,Europe,4484056,127781
GBR,2021-22,32836,59,United Kingdom,68059863,Europe,4516892,127840
GBR,2021-23,56527,64,United Kingdom,68059863,Europe,4573419,127904
GBR,2021-24,56621,72,United Kingdom,68059863,Europe,4630040,127976
GBR,2021-25,102394,124,United Kingdom,68059863,Europe,4732434,128100
GBR,2021-26,198099,131,United Kingdom,68059863,Europe,4930533,128231
GBR,2021-27,190712,194,United Kingdom,68059863,Europe,5121245,128425
GBR,2021-28,312694,283,United Kingdom,68059863,Europe,5433939,128708
GBR,2021-29,263973,450,United Kingdom,68059863,Europe,5697912,129158
GBR,2021-30,182755,561,United Kingdom,68059863,Europe,5880667,129719
GBR,2021-31,213576,637,United Kingdom,68059863,Europe,6094243,130356
GBR,2021-32,173194,597,United Kingdom,68059863,Europe,6267437,130953
GEO,2020-02,0,0,Georgia,3989175,Europe,0,0
GEO,2020-03,0,0,Georgia,3989175,Europe,0,0
GEO,2020-04,0,0,Georgia,3989175,Europe,0,0
GEO,2020-05,0,0,Georgia,3989175,Europe,0,0
GEO,2020-06,0,0,Georgia,3989175,Europe,0,0
GEO,2020-07,0,0,Georgia,3989175,Europe,0,0
GEO,2020-08,0,0,Georgia,3989175,Europe,0,0
GEO,2020-09,3,0,Georgia,3989175,Europe,3,0
GEO,2020-10,10,0,Georgia,3989175,Europe,13,0
GEO,2020-11,17,0,Georgia,3989175,Europe,30,0
GEO,2020-12,24,0,Georgia,3989175,Europe,54,0
GEO,2020-13,36,0,Georgia,3989175,Europe,90,0
GEO,2020-14,84,2,Georgia,3989175,Europe,174,2
GEO,2020-15,83,1,Georgia,3989175,Europe,257,3
GEO,2020-16,137,1,Georgia,3989175,Europe,394,4
GEO,2020-17,92,2,Georgia,3989175,Europe,486,6
GEO,2020-18,103,3,Georgia,3989175,Europe,589,9
GEO,2020-19,46,1,Georgia,3989175,Europe,635,10
GEO,2020-20,66,2,Georgia,3989175,Europe,701,12
GEO,2020-21,29,0,Georgia,3989175,Europe,730,12
GEO,2020-22,53,0,Georgia,3989175,Europe,783,12
GEO,2020-23,25,1,Georgia,3989175,Europe,808,13
GEO,2020-24,71,1,Georgia,3989175,Europe,879,14
GEO,2020-25,29,0,Georgia,3989175,Europe,908,14
GEO,2020-26,18,1,Georgia,3989175,Europe,926,15
GEO,2020-27,27,0,Georgia,3989175,Europe,953,15
GEO,2020-28,42,0,Georgia,3989175,Europe,995,15
GEO,2020-29,33,0,Georgia,3989175,Europe,1028,15
GEO,2020-30,109,1,Georgia,3989175,Europe,1137,16
GEO,2020-31,40,1,Georgia,3989175,Europe,1177,17
GEO,2020-32,73,0,Georgia,3989175,Europe,1250,17
GEO,2020-33,91,0,Georgia,3989175,Europe,1341,17
GEO,2020-34,70,0,Georgia,3989175,Europe,1411,17
GEO,2020-35,76,2,Georgia,3989175,Europe,1487,19
GEO,2020-36,153,0,Georgia,3989175,Europe,1640,19
GEO,2020-37,752,0,Georgia,3989175,Europe,2392,19
GEO,2020-38,1303,1,Georgia,3989175,Europe,3695,20
GEO,2020-39,1857,8,Georgia,3989175,Europe,5552,28
GEO,2020-40,2566,22,Georgia,3989175,Europe,8118,50
GEO,2020-41,3676,35,Georgia,3989175,Europe,11794,85
GEO,2020-42,5683,51,Georgia,3989175,Europe,17477,136
GEO,2020-43,12826,79,Georgia,3989175,Europe,30303,215
GEO,2020-44,12276,127,Georgia,3989175,Europe,42579,342
GEO,2020-45,18101,157,Georgia,3989175,Europe,60680,499
GEO,2020-46,22155,234,Georgia,3989175,Europe,82835,733
GEO,2020-47,25855,279,Georgia,3989175,Europe,108690,1012
GEO,2020-48,26894,255,Georgia,3989175,Europe,135584,1267
GEO,2020-49,29392,273,Georgia,3989175,Europe,164976,1540
GEO,2020-50,26087,299,Georgia,3989175,Europe,191063,1839
GEO,2020-51,18399,301,Georgia,3989175,Europe,209462,2140
GEO,2020-52,12681,278,Georgia,3989175,Europe,222143,2418
GEO,2020-53,7620,210,Georgia,3989175,Europe,229763,2628
GEO,2021-01,10017,168,Georgia,3989175,Europe,239780,2796
GEO,2021-02,8135,162,Georgia,3989175,Europe,247915,2958
GEO,2021-03,5901,113,Georgia,3989175,Europe,253816,3071
GEO,2021-04,4535,123,Georgia,3989175,Europe,258351,3194
GEO,2021-05,3877,104,Georgia,3989175,Europe,262228,3298
GEO,2021-06,3494,65,Georgia,3989175,Europe,265722,3363
GEO,2021-07,2780,84,Georgia,3989175,Europe,268502,3447
GEO,2021-08,2416,73,Georgia,3989175,Europe,270918,3520
GEO,2021-09,2080,71,Georgia,3989175,Europe,272998,3591
GEO,2021-10,2150,59,Georgia,3989175,Europe,275148,3650
GEO,2021-11,2502,60,Georgia,3989175,Europe,277650,3710
GEO,2021-12,2651,41,Georgia,3989175,Europe,280301,3751
GEO,2021-13,3760,71,Georgia,3989175,Europe,284061,3822
GEO,2021-14,4335,55,Georgia,3989175,Europe,288396,3877
GEO,2021-15,7540,72,Georgia,3989175,Europe,295936,3949
GEO,2021-16,8336,94,Georgia,3989175,Europe,304272,4043
GEO,2021-17,8682,120,Georgia,3989175,Europe,312954,4163
GEO,2021-18,8965,118,Georgia,3989175,Europe,321919,4281
GEO,2021-19,8456,161,Georgia,3989175,Europe,330375,4442
GEO,2021-20,7586,197,Georgia,3989175,Europe,337961,4639
GEO,2021-21,6002,134,Georgia,3989175,Europe,343963,4773
GEO,2021-22,5442,161,Georgia,3989175,Europe,349405,4934
GEO,2021-23,4871,126,Georgia,3989175,Europe,354276,5060
GEO,2021-24,4605,100,Georgia,3989175,Europe,358881,5160
GEO,2021-25,4993,115,Georgia,3989175,Europe,363874,5275
GEO,2021-26,5174,72,Georgia,3989175,Europe,369048,5347
GEO,2021-27,8763,121,Georgia,3989175,Europe,377811,5468
GEO,2021-28,10518,98,Georgia,3989175,Europe,388329,5566
GEO,2021-29,15694,148,Georgia,3989175,Europe,404023,5714
GEO,2021-30,19820,162,Georgia,3989175,Europe,423843,5876
GEO,2021-31,24070,208,Georgia,3989175,Europe,447913,6084
GEO,2021-32,33665,322,Georgia,3989175,Europe,481578,6406
GGY,2020-13,28,0,Guernsey,64468,Europe,28,0
GGY,2020-14,109,3,Guernsey,64468,Europe,137,3
GGY,2020-15,64,3,Guernsey,64468,Europe,201,6
GGY,2020-16,21,3,Guernsey,64468,Europe,222,9
GGY,2020-17,8,4,Guernsey,64468,Europe,230,13
GGY,2020-18,5,0,Guernsey,64468,Europe,235,13
GGY,2020-19,0,0,Guernsey,64468,Europe,235,13
GGY,2020-20,0,0,Guernsey,64468,Europe,235,13
GGY,2020-21,0,0,Guernsey,64468,Europe,235,13
GGY,2020-22,0,0,Guernsey,64468,Europe,235,13
GGY,2020-23,0,0,Guernsey,64468,Europe,235,13
GGY,2020-24,0,0,Guernsey,64468,Europe,235,13
GGY,2020-25,0,0,Guernsey,64468,Europe,235,13
GGY,2020-26,0,0,Guernsey,64468,Europe,235,13
GGY,2020-27,0,0,Guernsey,64468,Europe,235,13
GGY,2020-28,0,0,Guernsey,64468,Europe,235,13
GGY,2020-29,0,0,Guernsey,64468,Europe,235,13
GGY,2020-30,0,0,Guernsey,64468,Europe,235,13
GGY,2020-31,0,0,Guernsey,64468,Europe,235,13
GGY,2020-32,0,0,Guernsey,64468,Europe,235,13
GGY,2020-33,0,0,Guernsey,64468,Europe,235,13
GGY,2020-34,0,0,Guernsey,64468,Europe,235,13
GGY,2020-35,0,0,Guernsey,64468,Europe,235,13
GGY,2020-36,0,0,Guernsey,64468,Europe,235,13
GGY,2020-37,1,0,Guernsey,64468,Europe,236,13
GGY,2020-38,2,0,Guernsey,64468,Europe,238,13
GGY,2020-39,1,0,Guernsey,64468,Europe,239,13
GGY,2020-40,1,0,Guernsey,64468,Europe,240,13
GGY,2020-41,1,0,Guernsey,64468,Europe,241,13
GGY,2020-42,0,0,Guernsey,64468,Europe,241,13
GGY,2020-43,7,0,Guernsey,64468,Europe,248,13
GGY,2020-44,5,0,Guernsey,64468,Europe,253,13
GGY,2020-45,9,0,Guernsey,64468,Europe,262,13
GGY,2020-46,3,0,Guernsey,64468,Europe,265,13
GGY,2020-47,1,0,Guernsey,64468,Europe,266,13
GGY,2020-48,3,0,Guernsey,64468,Europe,269,13
GGY,2020-49,2,0,Guernsey,64468,Europe,271,13
GGY,2020-50,1,0,Guernsey,64468,Europe,272,13
GGY,2020-51,4,0,Guernsey,64468,Europe,276,13
GGY,2020-52,4,0,Guernsey,64468,Europe,280,13
GGY,2020-53,3,0,Guernsey,64468,Europe,283,13
GGY,2021-01,5,0,Guernsey,64468,Europe,288,13
GGY,2021-02,4,0,Guernsey,64468,Europe,292,13
GGY,2021-03,12,0,Guernsey,64468,Europe,304,13
GGY,2021-04,218,0,Guernsey,64468,Europe,522,13
GGY,2021-05,202,0,Guernsey,64468,Europe,724,13
GGY,2021-06,56,0,Guernsey,64468,Europe,780,13
GGY,2021-07,16,1,Guernsey,64468,Europe,796,14
GGY,2021-08,8,0,Guernsey,64468,Europe,804,14
GGY,2021-09,0,0,Guernsey,64468,Europe,804,14
GGY,2021-10,0,0,Guernsey,64468,Europe,804,14
GGY,2021-11,0,0,Guernsey,64468,Europe,804,14
GGY,2021-12,0,0,Guernsey,64468,Europe,804,14
GGY,2021-13,0,0,Guernsey,64468,Europe,804,14
GGY,2021-14,0,0,Guernsey,64468,Europe,804,14
GGY,2021-15,1,0,Guernsey,64468,Europe,805,14
GGY,2021-16,0,0,Guernsey,64468,Europe,805,14
GGY,2021-17,0,0,Guernsey,64468,Europe,805,14
GGY,2021-18,0,0,Guernsey,64468,Europe,805,14
GGY,2021-19,0,0,Guernsey,64468,Europe,805,14
GGY,2021-20,0,0,Guernsey,64468,Europe,805,14
GGY,2021-21,1,0,Guernsey,64468,Europe,806,14
GGY,2021-22,0,0,Guernsey,64468,Europe,806,14
GGY,2021-23,2,0,Guernsey,64468,Europe,808,14
GGY,2021-24,2,0,Guernsey,64468,Europe,810,14
GGY,2021-25,8,0,Guernsey,64468,Europe,818,14
GGY,2021-26,12,0,Guernsey,64468,Europe,830,14
GGY,2021-27,10,0,Guernsey,64468,Europe,840,14
GGY,2021-28,37,0,Guernsey,64468,Europe,877,14
GGY,2021-29,35,1,Guernsey,64468,Europe,912,15
GGY,2021-30,27,1,Guernsey,64468,Europe,939,16
GGY,2021-31,51,0,Guernsey,64468,Europe,990,16
GGY,2021-32,78,0,Guernsey,64468,Europe,1068,16
GHA,2020-12,22,1,Ghana,31072945,Africa,22,1
GHA,2020-13,128,4,Ghana,31072945,Africa,150,5
GHA,2020-14,62,0,Ghana,31072945,Africa,212,5
GHA,2020-15,352,3,Ghana,31072945,Africa,564,8
GHA,2020-16,476,1,Ghana,31072945,Africa,1040,9
GHA,2020-17,508,2,Ghana,31072945,Africa,1548,11
GHA,2020-18,619,7,Ghana,31072945,Africa,2167,18
GHA,2020-19,2094,4,Ghana,31072945,Africa,4261,22
GHA,2020-20,1472,7,Ghana,31072945,Africa,5733,29
GHA,2020-21,948,3,Ghana,31072945,Africa,6681,32
GHA,2020-22,1387,4,Ghana,31072945,Africa,8068,36
GHA,2020-23,1568,8,Ghana,31072945,Africa,9636,44
GHA,2020-24,2326,10,Ghana,31072945,Africa,11962,54
GHA,2020-25,2190,31,Ghana,31072945,Africa,14152,85
GHA,2020-26,3197,27,Ghana,31072945,Africa,17349,112
GHA,2020-27,2734,10,Ghana,31072945,Africa,20083,122
GHA,2020-28,4433,17,Ghana,31072945,Africa,24516,139
GHA,2020-29,3149,9,Ghana,31072945,Africa,27665,148
GHA,2020-30,5302,20,Ghana,31072945,Africa,32967,168
GHA,2020-31,4045,14,Ghana,31072945,Africa,37012,182
GHA,2020-32,3989,33,Ghana,31072945,Africa,41001,215
GHA,2020-33,1529,16,Ghana,31072945,Africa,42530,231
GHA,2020-34,973,30,Ghana,31072945,Africa,43503,261
GHA,2020-35,700,15,Ghana,31072945,Africa,44203,276
GHA,2020-36,572,7,Ghana,31072945,Africa,44775,283
GHA,2020-37,657,3,Ghana,31072945,Africa,45432,286
GHA,2020-38,570,11,Ghana,31072945,Africa,46002,297
GHA,2020-39,383,2,Ghana,31072945,Africa,46385,299
GHA,2020-40,442,4,Ghana,31072945,Africa,46827,303
GHA,2020-41,176,3,Ghana,31072945,Africa,47003,306
GHA,2020-42,305,4,Ghana,31072945,Africa,47308,310
GHA,2020-43,380,6,Ghana,31072945,Africa,47688,316
GHA,2020-44,434,4,Ghana,31072945,Africa,48122,320
GHA,2020-45,1078,0,Ghana,31072945,Africa,49200,320
GHA,2020-46,921,2,Ghana,31072945,Africa,50121,322
GHA,2020-47,751,1,Ghana,31072945,Africa,50872,323
GHA,2020-48,695,0,Ghana,31072945,Africa,51567,323
GHA,2020-49,705,2,Ghana,31072945,Africa,52272,325
GHA,2020-50,740,2,Ghana,31072945,Africa,53012,327
GHA,2020-51,639,4,Ghana,31072945,Africa,53651,331
GHA,2020-52,850,2,Ghana,31072945,Africa,54501,333
GHA,2020-53,665,2,Ghana,31072945,Africa,55166,335
GHA,2021-01,1062,3,Ghana,31072945,Africa,56228,338
GHA,2021-02,1484,8,Ghana,31072945,Africa,57712,346
GHA,2021-03,4421,26,Ghana,31072945,Africa,62133,372
GHA,2021-04,4875,44,Ghana,31072945,Africa,67008,416
GHA,2021-05,5318,56,Ghana,31072945,Africa,72326,472
GHA,2021-06,3508,61,Ghana,31072945,Africa,75834,533
GHA,2021-07,4417,44,Ghana,31072945,Africa,80251,577
GHA,2021-08,3770,30,Ghana,31072945,Africa,84021,607
GHA,2021-09,2442,40,Ghana,31072945,Africa,86463,647
GHA,2021-10,1297,38,Ghana,31072945,Africa,87760,685
GHA,2021-11,1920,40,Ghana,31072945,Africa,89680,725
GHA,2021-12,605,15,Ghana,31072945,Africa,90285,740
GHA,2021-13,613,12,Ghana,31072945,Africa,90898,752
GHA,2021-14,360,0,Ghana,31072945,Africa,91258,752
GHA,2021-15,449,19,Ghana,31072945,Africa,91707,771
GHA,2021-16,457,6,Ghana,31072945,Africa,92164,777
GHA,2021-17,517,2,Ghana,31072945,Africa,92681,779
GHA,2021-18,328,4,Ghana,31072945,Africa,93009,783
GHA,2021-19,379,0,Ghana,31072945,Africa,93388,783
GHA,2021-20,254,0,Ghana,31072945,Africa,93642,783
GHA,2021-21,254,2,Ghana,31072945,Africa,93896,785
GHA,2021-22,330,2,Ghana,31072945,Africa,94226,787
GHA,2021-23,265,2,Ghana,31072945,Africa,94491,789
GHA,2021-24,420,4,Ghana,31072945,Africa,94911,793
GHA,2021-25,456,2,Ghana,31072945,Africa,95367,795
GHA,2021-26,1033,1,Ghana,31072945,Africa,96400,796
GHA,2021-27,1326,6,Ghana,31072945,Africa,97726,802
GHA,2021-28,1432,13,Ghana,31072945,Africa,99158,815
GHA,2021-29,2943,8,Ghana,31072945,Africa,102101,823
GHA,2021-30,2227,13,Ghana,31072945,Africa,104328,836
GHA,2021-31,3896,38,Ghana,31072945,Africa,108224,874
GHA,2021-32,3006,56,Ghana,31072945,Africa,111230,930
GIB,2020-13,50,0,Gibraltar,33691,Europe,50,0
GIB,2020-14,38,0,Gibraltar,33691,Europe,88,0
GIB,2020-15,26,0,Gibraltar,33691,Europe,114,0
GIB,2020-16,4,0,Gibraltar,33691,Europe,118,0
GIB,2020-17,8,0,Gibraltar,33691,Europe,126,0
GIB,2020-18,3,0,Gibraltar,33691,Europe,129,0
GIB,2020-19,2,0,Gibraltar,33691,Europe,131,0
GIB,2020-20,1,0,Gibraltar,33691,Europe,132,0
GIB,2020-21,4,0,Gibraltar,33691,Europe,136,0
GIB,2020-22,18,0,Gibraltar,33691,Europe,154,0
GIB,2020-23,6,0,Gibraltar,33691,Europe,160,0
GIB,2020-24,1,0,Gibraltar,33691,Europe,161,0
GIB,2020-25,0,0,Gibraltar,33691,Europe,161,0
GIB,2020-26,1,0,Gibraltar,33691,Europe,162,0
GIB,2020-27,1,0,Gibraltar,33691,Europe,163,0
GIB,2020-28,2,0,Gibraltar,33691,Europe,165,0
GIB,2020-29,0,0,Gibraltar,33691,Europe,165,0
GIB,2020-30,5,0,Gibraltar,33691,Europe,170,0
GIB,2020-31,3,0,Gibraltar,33691,Europe,173,0
GIB,2020-32,9,0,Gibraltar,33691,Europe,182,0
GIB,2020-33,18,0,Gibraltar,33691,Europe,200,0
GIB,2020-34,14,0,Gibraltar,33691,Europe,214,0
GIB,2020-35,56,0,Gibraltar,33691,Europe,270,0
GIB,2020-36,30,0,Gibraltar,33691,Europe,300,0
GIB,2020-37,15,0,Gibraltar,33691,Europe,315,0
GIB,2020-38,20,0,Gibraltar,33691,Europe,335,0
GIB,2020-39,29,0,Gibraltar,33691,Europe,364,0
GIB,2020-40,53,0,Gibraltar,33691,Europe,417,0
GIB,2020-41,53,0,Gibraltar,33691,Europe,470,0
GIB,2020-42,86,0,Gibraltar,33691,Europe,556,0
GIB,2020-43,96,0,Gibraltar,33691,Europe,652,0
GIB,2020-44,36,0,Gibraltar,33691,Europe,688,0
GIB,2020-45,90,0,Gibraltar,33691,Europe,778,0
GIB,2020-46,109,1,Gibraltar,33691,Europe,887,1
GIB,2020-47,56,3,Gibraltar,33691,Europe,943,4
GIB,2020-48,56,1,Gibraltar,33691,Europe,999,5
GIB,2020-49,39,0,Gibraltar,33691,Europe,1038,5
GIB,2020-50,22,0,Gibraltar,33691,Europe,1060,5
GIB,2020-51,169,1,Gibraltar,33691,Europe,1229,6
GIB,2020-52,462,0,Gibraltar,33691,Europe,1691,6
GIB,2020-53,700,2,Gibraltar,33691,Europe,2391,8
GIB,2021-01,764,8,Gibraltar,33691,Europe,3155,16
GIB,2021-02,500,27,Gibraltar,33691,Europe,3655,43
GIB,2021-03,296,20,Gibraltar,33691,Europe,3951,63
GIB,2021-04,148,14,Gibraltar,33691,Europe,4099,77
GIB,2021-05,73,6,Gibraltar,33691,Europe,4172,83
GIB,2021-06,32,4,Gibraltar,33691,Europe,4204,87
GIB,2021-07,9,3,Gibraltar,33691,Europe,4213,90
GIB,2021-08,11,3,Gibraltar,33691,Europe,4224,93
GIB,2021-09,10,0,Gibraltar,33691,Europe,4234,93
GIB,2021-10,14,1,Gibraltar,33691,Europe,4248,94
GIB,2021-11,7,0,Gibraltar,33691,Europe,4255,94
GIB,2021-12,3,0,Gibraltar,33691,Europe,4258,94
GIB,2021-13,2,0,Gibraltar,33691,Europe,4260,94
GIB,2021-14,2,0,Gibraltar,33691,Europe,4262,94
GIB,2021-15,6,0,Gibraltar,33691,Europe,4268,94
GIB,2021-16,0,0,Gibraltar,33691,Europe,4268,94
GIB,2021-17,0,0,Gibraltar,33691,Europe,4268,94
GIB,2021-18,3,0,Gibraltar,33691,Europe,4271,94
GIB,2021-19,0,0,Gibraltar,33691,Europe,4271,94
GIB,2021-20,2,0,Gibraltar,33691,Europe,4273,94
GIB,2021-21,5,0,Gibraltar,33691,Europe,4278,94
GIB,2021-22,7,0,Gibraltar,33691,Europe,4285,94
GIB,2021-23,12,0,Gibraltar,33691,Europe,4297,94
GIB,2021-24,9,0,Gibraltar,33691,Europe,4306,94
GIB,2021-25,24,0,Gibraltar,33691,Europe,4330,94
GIB,2021-26,21,0,Gibraltar,33691,Europe,4351,94
GIB,2021-27,64,0,Gibraltar,33691,Europe,4415,94
GIB,2021-28,165,0,Gibraltar,33691,Europe,4580,94
GIB,2021-29,204,0,Gibraltar,33691,Europe,4784,94
GIB,2021-30,181,0,Gibraltar,33691,Europe,4965,94
GIB,2021-31,147,1,Gibraltar,33691,Europe,5112,95
GIB,2021-32,85,0,Gibraltar,33691,Europe,5197,95
GIN,2020-13,6,0,Guinea,13132792,Africa,6,0
GIN,2020-14,113,0,Guinea,13132792,Africa,119,0
GIN,2020-15,129,0,Guinea,13132792,Africa,248,0
GIN,2020-16,329,5,Guinea,13132792,Africa,577,5
GIN,2020-17,515,2,Guinea,13132792,Africa,1092,7
GIN,2020-18,492,0,Guinea,13132792,Africa,1584,7
GIN,2020-19,560,4,Guinea,13132792,Africa,2144,11
GIN,2020-20,512,5,Guinea,13132792,Africa,2656,16
GIN,2020-21,617,4,Guinea,13132792,Africa,3273,20
GIN,2020-22,496,3,Guinea,13132792,Africa,3769,23
GIN,2020-23,394,0,Guinea,13132792,Africa,4163,23
GIN,2020-24,367,2,Guinea,13132792,Africa,4530,25
GIN,2020-25,456,2,Guinea,13132792,Africa,4986,27
GIN,2020-26,354,4,Guinea,13132792,Africa,5340,31
GIN,2020-27,268,3,Guinea,13132792,Africa,5608,34
GIN,2020-28,531,3,Guinea,13132792,Africa,6139,37
GIN,2020-29,403,2,Guinea,13132792,Africa,6542,39
GIN,2020-30,464,4,Guinea,13132792,Africa,7006,43
GIN,2020-31,356,3,Guinea,13132792,Africa,7362,46
GIN,2020-32,566,4,Guinea,13132792,Africa,7928,50
GIN,2020-33,552,1,Guinea,13132792,Africa,8480,51
GIN,2020-34,485,2,Guinea,13132792,Africa,8965,53
GIN,2020-35,404,6,Guinea,13132792,Africa,9369,59
GIN,2020-36,351,2,Guinea,13132792,Africa,9720,61
GIN,2020-37,298,2,Guinea,13132792,Africa,10018,63
GIN,2020-38,305,1,Guinea,13132792,Africa,10323,64
GIN,2020-39,255,2,Guinea,13132792,Africa,10578,66
GIN,2020-40,174,0,Guinea,13132792,Africa,10752,66
GIN,2020-41,268,3,Guinea,13132792,Africa,11020,69
GIN,2020-42,496,1,Guinea,13132792,Africa,11516,70
GIN,2020-43,151,1,Guinea,13132792,Africa,11667,71
GIN,2020-44,526,2,Guinea,13132792,Africa,12193,73
GIN,2020-45,231,1,Guinea,13132792,Africa,12424,74
GIN,2020-46,185,1,Guinea,13132792,Africa,12609,75
GIN,2020-47,215,0,Guinea,13132792,Africa,12824,75
GIN,2020-48,213,1,Guinea,13132792,Africa,13037,76
GIN,2020-49,194,0,Guinea,13132792,Africa,13231,76
GIN,2020-50,224,4,Guinea,13132792,Africa,13455,80
GIN,2020-51,93,0,Guinea,13132792,Africa,13548,80
GIN,2020-52,138,0,Guinea,13132792,Africa,13686,80
GIN,2020-53,111,1,Guinea,13132792,Africa,13797,81
GIN,2021-01,190,0,Guinea,13132792,Africa,13987,81
GIN,2021-02,183,0,Guinea,13132792,Africa,14170,81
GIN,2021-03,207,1,Guinea,13132792,Africa,14377,82
GIN,2021-04,176,1,Guinea,13132792,Africa,14553,83
GIN,2021-05,209,1,Guinea,13132792,Africa,14762,84
GIN,2021-06,203,1,Guinea,13132792,Africa,14965,85
GIN,2021-07,460,1,Guinea,13132792,Africa,15425,86
GIN,2021-08,565,3,Guinea,13132792,Africa,15990,89
GIN,2021-09,833,6,Guinea,13132792,Africa,16823,95
GIN,2021-10,1026,8,Guinea,13132792,Africa,17849,103
GIN,2021-11,1026,8,Guinea,13132792,Africa,18875,111
GIN,2021-12,793,9,Guinea,13132792,Africa,19668,120
GIN,2021-13,836,10,Guinea,13132792,Africa,20504,130
GIN,2021-14,526,6,Guinea,13132792,Africa,21030,136
GIN,2021-15,580,2,Guinea,13132792,Africa,21610,138
GIN,2021-16,373,3,Guinea,13132792,Africa,21983,141
GIN,2021-17,319,4,Guinea,13132792,Africa,22302,145
GIN,2021-18,329,5,Guinea,13132792,Africa,22631,150
GIN,2021-19,220,3,Guinea,13132792,Africa,22851,153
GIN,2021-20,199,6,Guinea,13132792,Africa,23050,159
GIN,2021-21,125,2,Guinea,13132792,Africa,23175,161
GIN,2021-22,135,3,Guinea,13132792,Africa,23310,164
GIN,2021-23,86,3,Guinea,13132792,Africa,23396,167
GIN,2021-24,145,1,Guinea,13132792,Africa,23541,168
GIN,2021-25,149,0,Guinea,13132792,Africa,23690,168
GIN,2021-26,115,4,Guinea,13132792,Africa,23805,172
GIN,2021-27,310,5,Guinea,13132792,Africa,24115,177
GIN,2021-28,551,11,Guinea,13132792,Africa,24666,188
GIN,2021-29,386,14,Guinea,13132792,Africa,25052,202
GIN,2021-30,860,30,Guinea,13132792,Africa,25912,232
GIN,2021-31,1055,28,Guinea,13132792,Africa,26967,260
GIN,2021-32,1149,32,Guinea,13132792,Africa,28116,292
GMB,2020-13,2,1,Gambia,2416664,Africa,2,1
GMB,2020-14,1,0,Gambia,2416664,Africa,3,1
GMB,2020-15,5,0,Gambia,2416664,Africa,8,1
GMB,2020-16,1,0,Gambia,2416664,Africa,9,1
GMB,2020-17,0,0,Gambia,2416664,Africa,9,1
GMB,2020-18,7,0,Gambia,2416664,Africa,16,1
GMB,2020-19,3,0,Gambia,2416664,Africa,19,1
GMB,2020-20,3,0,Gambia,2416664,Africa,22,1
GMB,2020-21,2,0,Gambia,2416664,Africa,24,1
GMB,2020-22,0,0,Gambia,2416664,Africa,24,1
GMB,2020-23,1,0,Gambia,2416664,Africa,25,1
GMB,2020-24,2,0,Gambia,2416664,Africa,27,1
GMB,2020-25,9,1,Gambia,2416664,Africa,36,2
GMB,2020-26,8,0,Gambia,2416664,Africa,44,2
GMB,2020-27,12,0,Gambia,2416664,Africa,56,2
GMB,2020-28,7,1,Gambia,2416664,Africa,63,3
GMB,2020-29,29,1,Gambia,2416664,Africa,92,4
GMB,2020-30,184,2,Gambia,2416664,Africa,276,6
GMB,2020-31,221,3,Gambia,2416664,Africa,497,9
GMB,2020-32,737,14,Gambia,2416664,Africa,1234,23
GMB,2020-33,637,40,Gambia,2416664,Africa,1871,63
GMB,2020-34,565,21,Gambia,2416664,Africa,2436,84
GMB,2020-35,526,12,Gambia,2416664,Africa,2962,96
GMB,2020-36,234,3,Gambia,2416664,Africa,3196,99
GMB,2020-37,208,4,Gambia,2416664,Africa,3404,103
GMB,2020-38,121,5,Gambia,2416664,Africa,3525,108
GMB,2020-39,43,3,Gambia,2416664,Africa,3568,111
GMB,2020-40,25,4,Gambia,2416664,Africa,3593,115
GMB,2020-41,38,2,Gambia,2416664,Africa,3631,117
GMB,2020-42,17,1,Gambia,2416664,Africa,3648,118
GMB,2020-43,11,1,Gambia,2416664,Africa,3659,119
GMB,2020-44,12,0,Gambia,2416664,Africa,3671,119
GMB,2020-45,12,2,Gambia,2416664,Africa,3683,121
GMB,2020-46,18,1,Gambia,2416664,Africa,3701,122
GMB,2020-47,24,1,Gambia,2416664,Africa,3725,123
GMB,2020-48,8,0,Gambia,2416664,Africa,3733,123
GMB,2020-49,36,0,Gambia,2416664,Africa,3769,123
GMB,2020-50,12,0,Gambia,2416664,Africa,3781,123
GMB,2020-51,7,0,Gambia,2416664,Africa,3788,123
GMB,2020-52,8,0,Gambia,2416664,Africa,3796,123
GMB,2020-53,9,2,Gambia,2416664,Africa,3805,125
GMB,2021-01,70,0,Gambia,2416664,Africa,3875,125
GMB,2021-02,34,2,Gambia,2416664,Africa,3909,127
GMB,2021-03,98,1,Gambia,2416664,Africa,4007,128
GMB,2021-04,131,3,Gambia,2416664,Africa,4138,131
GMB,2021-05,98,3,Gambia,2416664,Africa,4236,134
GMB,2021-06,177,4,Gambia,2416664,Africa,4413,138
GMB,2021-07,198,8,Gambia,2416664,Africa,4611,146
GMB,2021-08,100,4,Gambia,2416664,Africa,4711,150
GMB,2021-09,80,3,Gambia,2416664,Africa,4791,153
GMB,2021-10,227,0,Gambia,2416664,Africa,5018,153
GMB,2021-11,236,8,Gambia,2416664,Africa,5254,161
GMB,2021-12,165,3,Gambia,2416664,Africa,5419,164
GMB,2021-13,85,2,Gambia,2416664,Africa,5504,166
GMB,2021-14,97,2,Gambia,2416664,Africa,5601,168
GMB,2021-15,182,2,Gambia,2416664,Africa,5783,170
GMB,2021-16,73,3,Gambia,2416664,Africa,5856,173
GMB,2021-17,44,2,Gambia,2416664,Africa,5900,175
GMB,2021-18,28,0,Gambia,2416664,Africa,5928,175
GMB,2021-19,28,0,Gambia,2416664,Africa,5956,175
GMB,2021-20,21,3,Gambia,2416664,Africa,5977,178
GMB,2021-21,15,1,Gambia,2416664,Africa,5992,179
GMB,2021-22,6,0,Gambia,2416664,Africa,5998,179
GMB,2021-23,9,1,Gambia,2416664,Africa,6007,180
GMB,2021-24,31,1,Gambia,2416664,Africa,6038,181
GMB,2021-25,30,0,Gambia,2416664,Africa,6068,181
GMB,2021-26,47,1,Gambia,2416664,Africa,6115,182
GMB,2021-27,212,3,Gambia,2416664,Africa,6327,185
GMB,2021-28,592,5,Gambia,2416664,Africa,6919,190
GMB,2021-29,413,18,Gambia,2416664,Africa,7332,208
GMB,2021-30,629,5,Gambia,2416664,Africa,7961,213
GMB,2021-31,801,32,Gambia,2416664,Africa,8762,245
GMB,2021-32,432,26,Gambia,2416664,Africa,9194,271
GNB,2020-14,16,0,Guinea Bissau,1967998,Africa,16,0
GNB,2020-15,21,0,Guinea Bissau,1967998,Africa,37,0
GNB,2020-16,11,0,Guinea Bissau,1967998,Africa,48,0
GNB,2020-17,3,1,Guinea Bissau,1967998,Africa,51,1
GNB,2020-18,239,1,Guinea Bissau,1967998,Africa,290,2
GNB,2020-19,434,1,Guinea Bissau,1967998,Africa,724,3
GNB,2020-20,264,1,Guinea Bissau,1967998,Africa,988,4
GNB,2020-21,183,2,Guinea Bissau,1967998,Africa,1171,6
GNB,2020-22,149,2,Guinea Bissau,1967998,Africa,1320,8
GNB,2020-23,46,4,Guinea Bissau,1967998,Africa,1366,12
GNB,2020-24,92,3,Guinea Bissau,1967998,Africa,1458,15
GNB,2020-25,81,2,Guinea Bissau,1967998,Africa,1539,17
GNB,2020-26,73,4,Guinea Bissau,1967998,Africa,1612,21
GNB,2020-27,151,4,Guinea Bissau,1967998,Africa,1763,25
GNB,2020-28,77,0,Guinea Bissau,1967998,Africa,1840,25
GNB,2020-29,85,1,Guinea Bissau,1967998,Africa,1925,26
GNB,2020-30,27,0,Guinea Bissau,1967998,Africa,1952,26
GNB,2020-31,27,0,Guinea Bissau,1967998,Africa,1979,26
GNB,2020-32,71,3,Guinea Bissau,1967998,Africa,2050,29
GNB,2020-33,65,4,Guinea Bissau,1967998,Africa,2115,33
GNB,2020-34,32,0,Guinea Bissau,1967998,Africa,2147,33
GNB,2020-35,56,1,Guinea Bissau,1967998,Africa,2203,34
GNB,2020-36,40,4,Guinea Bissau,1967998,Africa,2243,38
GNB,2020-37,30,1,Guinea Bissau,1967998,Africa,2273,39
GNB,2020-38,28,0,Guinea Bissau,1967998,Africa,2301,39
GNB,2020-39,21,0,Guinea Bissau,1967998,Africa,2322,39
GNB,2020-40,38,0,Guinea Bissau,1967998,Africa,2360,39
GNB,2020-41,23,1,Guinea Bissau,1967998,Africa,2383,40
GNB,2020-42,4,1,Guinea Bissau,1967998,Africa,2387,41
GNB,2020-43,14,0,Guinea Bissau,1967998,Africa,2401,41
GNB,2020-44,10,0,Guinea Bissau,1967998,Africa,2411,41
GNB,2020-45,0,0,Guinea Bissau,1967998,Africa,2411,41
GNB,2020-46,6,2,Guinea Bissau,1967998,Africa,2417,43
GNB,2020-47,2,0,Guinea Bissau,1967998,Africa,2419,43
GNB,2020-48,1,0,Guinea Bissau,1967998,Africa,2420,43
GNB,2020-49,20,1,Guinea Bissau,1967998,Africa,2440,44
GNB,2020-50,5,0,Guinea Bissau,1967998,Africa,2445,44
GNB,2020-51,0,0,Guinea Bissau,1967998,Africa,2445,44
GNB,2020-52,0,0,Guinea Bissau,1967998,Africa,2445,44
GNB,2020-53,0,0,Guinea Bissau,1967998,Africa,2445,44
GNB,2021-01,31,1,Guinea Bissau,1967998,Africa,2476,45
GNB,2021-02,31,0,Guinea Bissau,1967998,Africa,2507,45
GNB,2021-03,23,0,Guinea Bissau,1967998,Africa,2530,45
GNB,2021-04,103,0,Guinea Bissau,1967998,Africa,2633,45
GNB,2021-05,137,1,Guinea Bissau,1967998,Africa,2770,46
GNB,2021-06,152,0,Guinea Bissau,1967998,Africa,2922,46
GNB,2021-07,191,1,Guinea Bissau,1967998,Africa,3113,47
GNB,2021-08,132,1,Guinea Bissau,1967998,Africa,3245,48
GNB,2021-09,65,1,Guinea Bissau,1967998,Africa,3310,49
GNB,2021-10,68,2,Guinea Bissau,1967998,Africa,3378,51
GNB,2021-11,156,4,Guinea Bissau,1967998,Africa,3534,55
GNB,2021-12,98,6,Guinea Bissau,1967998,Africa,3632,61
GNB,2021-13,28,5,Guinea Bissau,1967998,Africa,3660,66
GNB,2021-14,18,0,Guinea Bissau,1967998,Africa,3678,66
GNB,2021-15,32,0,Guinea Bissau,1967998,Africa,3710,66
GNB,2021-16,14,1,Guinea Bissau,1967998,Africa,3724,67
GNB,2021-17,10,0,Guinea Bissau,1967998,Africa,3734,67
GNB,2021-18,5,0,Guinea Bissau,1967998,Africa,3739,67
GNB,2021-19,5,0,Guinea Bissau,1967998,Africa,3744,67
GNB,2021-20,3,1,Guinea Bissau,1967998,Africa,3747,68
GNB,2021-21,12,0,Guinea Bissau,1967998,Africa,3759,68
GNB,2021-22,26,0,Guinea Bissau,1967998,Africa,3785,68
GNB,2021-23,16,1,Guinea Bissau,1967998,Africa,3801,69
GNB,2021-24,22,0,Guinea Bissau,1967998,Africa,3823,69
GNB,2021-25,21,0,Guinea Bissau,1967998,Africa,3844,69
GNB,2021-26,35,0,Guinea Bissau,1967998,Africa,3879,69
GNB,2021-27,66,1,Guinea Bissau,1967998,Africa,3945,70
GNB,2021-28,105,3,Guinea Bissau,1967998,Africa,4050,73
GNB,2021-29,156,1,Guinea Bissau,1967998,Africa,4206,74
GNB,2021-30,271,2,Guinea Bissau,1967998,Africa,4477,76
GNB,2021-31,309,3,Guinea Bissau,1967998,Africa,4786,79
GNB,2021-32,264,10,Guinea Bissau,1967998,Africa,5050,89
GNQ,2020-12,5,0,Equatorial Guinea,1402985,Africa,5,0
GNQ,2020-13,8,0,Equatorial Guinea,1402985,Africa,13,0
GNQ,2020-14,2,0,Equatorial Guinea,1402985,Africa,15,0
GNQ,2020-15,5,0,Equatorial Guinea,1402985,Africa,20,0
GNQ,2020-16,58,0,Equatorial Guinea,1402985,Africa,78,0
GNQ,2020-17,179,1,Equatorial Guinea,1402985,Africa,257,1
GNQ,2020-18,57,0,Equatorial Guinea,1402985,Africa,314,1
GNQ,2020-19,124,3,Equatorial Guinea,1402985,Africa,438,4
GNQ,2020-20,155,3,Equatorial Guinea,1402985,Africa,593,7
GNQ,2020-21,449,5,Equatorial Guinea,1402985,Africa,1042,12
GNQ,2020-22,263,0,Equatorial Guinea,1402985,Africa,1305,12
GNQ,2020-23,0,0,Equatorial Guinea,1402985,Africa,1305,12
GNQ,2020-24,0,0,Equatorial Guinea,1402985,Africa,1305,12
GNQ,2020-25,358,20,Equatorial Guinea,1402985,Africa,1663,32
GNQ,2020-26,337,0,Equatorial Guinea,1402985,Africa,2000,32
GNQ,2020-27,1070,19,Equatorial Guinea,1402985,Africa,3070,51
GNQ,2020-28,0,0,Equatorial Guinea,1402985,Africa,3070,51
GNQ,2020-29,0,0,Equatorial Guinea,1402985,Africa,3070,51
GNQ,2020-30,0,0,Equatorial Guinea,1402985,Africa,3070,51
GNQ,2020-31,1750,32,Equatorial Guinea,1402985,Africa,4820,83
GNQ,2020-32,0,0,Equatorial Guinea,1402985,Africa,4820,83
GNQ,2020-33,0,0,Equatorial Guinea,1402985,Africa,4820,83
GNQ,2020-34,105,0,Equatorial Guinea,1402985,Africa,4925,83
GNQ,2020-35,15,0,Equatorial Guinea,1402985,Africa,4940,83
GNQ,2020-36,31,0,Equatorial Guinea,1402985,Africa,4971,83
GNQ,2020-37,24,0,Equatorial Guinea,1402985,Africa,4995,83
GNQ,2020-38,6,0,Equatorial Guinea,1402985,Africa,5001,83
GNQ,2020-39,26,0,Equatorial Guinea,1402985,Africa,5027,83
GNQ,2020-40,17,0,Equatorial Guinea,1402985,Africa,5044,83
GNQ,2020-41,18,0,Equatorial Guinea,1402985,Africa,5062,83
GNQ,2020-42,7,0,Equatorial Guinea,1402985,Africa,5069,83
GNQ,2020-43,9,0,Equatorial Guinea,1402985,Africa,5078,83
GNQ,2020-44,10,0,Equatorial Guinea,1402985,Africa,5088,83
GNQ,2020-45,3,2,Equatorial Guinea,1402985,Africa,5091,85
GNQ,2020-46,12,0,Equatorial Guinea,1402985,Africa,5103,85
GNQ,2020-47,26,0,Equatorial Guinea,1402985,Africa,5129,85
GNQ,2020-48,23,0,Equatorial Guinea,1402985,Africa,5152,85
GNQ,2020-49,13,0,Equatorial Guinea,1402985,Africa,5165,85
GNQ,2020-50,29,0,Equatorial Guinea,1402985,Africa,5194,85
GNQ,2020-51,36,0,Equatorial Guinea,1402985,Africa,5230,85
GNQ,2020-52,17,1,Equatorial Guinea,1402985,Africa,5247,86
GNQ,2020-53,31,0,Equatorial Guinea,1402985,Africa,5278,86
GNQ,2021-01,17,0,Equatorial Guinea,1402985,Africa,5295,86
GNQ,2021-02,69,0,Equatorial Guinea,1402985,Africa,5364,86
GNQ,2021-03,89,0,Equatorial Guinea,1402985,Africa,5453,86
GNQ,2021-04,80,0,Equatorial Guinea,1402985,Africa,5533,86
GNQ,2021-05,80,1,Equatorial Guinea,1402985,Africa,5613,87
GNQ,2021-06,80,0,Equatorial Guinea,1402985,Africa,5693,87
GNQ,2021-07,158,4,Equatorial Guinea,1402985,Africa,5851,91
GNQ,2021-08,243,1,Equatorial Guinea,1402985,Africa,6094,92
GNQ,2021-09,276,4,Equatorial Guinea,1402985,Africa,6370,96
GNQ,2021-10,191,2,Equatorial Guinea,1402985,Africa,6561,98
GNQ,2021-11,218,3,Equatorial Guinea,1402985,Africa,6779,101
GNQ,2021-12,134,1,Equatorial Guinea,1402985,Africa,6913,102
GNQ,2021-13,145,2,Equatorial Guinea,1402985,Africa,7058,104
GNQ,2021-14,160,2,Equatorial Guinea,1402985,Africa,7218,106
GNQ,2021-15,286,0,Equatorial Guinea,1402985,Africa,7504,106
GNQ,2021-16,54,1,Equatorial Guinea,1402985,Africa,7558,107
GNQ,2021-17,135,5,Equatorial Guinea,1402985,Africa,7693,112
GNQ,2021-18,0,0,Equatorial Guinea,1402985,Africa,7693,112
GNQ,2021-19,0,0,Equatorial Guinea,1402985,Africa,7693,112
GNQ,2021-20,782,1,Equatorial Guinea,1402985,Africa,8475,113
GNQ,2021-21,53,5,Equatorial Guinea,1402985,Africa,8528,118
GNQ,2021-22,111,0,Equatorial Guinea,1402985,Africa,8639,118
GNQ,2021-23,10,2,Equatorial Guinea,1402985,Africa,8649,120
GNQ,2021-24,58,0,Equatorial Guinea,1402985,Africa,8707,120
GNQ,2021-25,15,1,Equatorial Guinea,1402985,Africa,8722,121
GNQ,2021-26,36,1,Equatorial Guinea,1402985,Africa,8758,122
GNQ,2021-27,56,0,Equatorial Guinea,1402985,Africa,8814,122
GNQ,2021-28,33,1,Equatorial Guinea,1402985,Africa,8847,123
GNQ,2021-29,15,0,Equatorial Guinea,1402985,Africa,8862,123
GNQ,2021-30,48,0,Equatorial Guinea,1402985,Africa,8910,123
GNQ,2021-31,40,0,Equatorial Guinea,1402985,Africa,8950,123
GNQ,2021-32,21,0,Equatorial Guinea,1402985,Africa,8971,123
GRC,2020-02,0,0,Greece,10718565,Europe,0,0
GRC,2020-03,0,0,Greece,10718565,Europe,0,0
GRC,2020-04,0,0,Greece,10718565,Europe,0,0
GRC,2020-05,0,0,Greece,10718565,Europe,0,0
GRC,2020-06,0,0,Greece,10718565,Europe,0,0
GRC,2020-07,0,0,Greece,10718565,Europe,0,0
GRC,2020-08,0,0,Greece,10718565,Europe,0,0
GRC,2020-09,7,0,Greece,10718565,Europe,7,0
GRC,2020-10,66,0,Greece,10718565,Europe,73,0
GRC,2020-11,258,4,Greece,10718565,Europe,331,4
GRC,2020-12,293,11,Greece,10718565,Europe,624,15
GRC,2020-13,532,23,Greece,10718565,Europe,1156,38
GRC,2020-14,579,35,Greece,10718565,Europe,1735,73
GRC,2020-15,379,25,Greece,10718565,Europe,2114,98
GRC,2020-16,121,12,Greece,10718565,Europe,2235,110
GRC,2020-17,271,20,Greece,10718565,Europe,2506,130
GRC,2020-18,120,14,Greece,10718565,Europe,2626,144
GRC,2020-19,90,7,Greece,10718565,Europe,2716,151
GRC,2020-20,118,12,Greece,10718565,Europe,2834,163
GRC,2020-21,44,8,Greece,10718565,Europe,2878,171
GRC,2020-22,39,4,Greece,10718565,Europe,2917,175
GRC,2020-23,80,5,Greece,10718565,Europe,2997,180
GRC,2020-24,124,3,Greece,10718565,Europe,3121,183
GRC,2020-25,145,7,Greece,10718565,Europe,3266,190
GRC,2020-26,110,1,Greece,10718565,Europe,3376,191
GRC,2020-27,143,1,Greece,10718565,Europe,3519,192
GRC,2020-28,284,1,Greece,10718565,Europe,3803,193
GRC,2020-29,204,1,Greece,10718565,Europe,4007,194
GRC,2020-30,186,8,Greece,10718565,Europe,4193,202
GRC,2020-31,469,6,Greece,10718565,Europe,4662,208
GRC,2020-32,961,4,Greece,10718565,Europe,5623,212
GRC,2020-33,1452,16,Greece,10718565,Europe,7075,228
GRC,2020-34,1589,14,Greece,10718565,Europe,8664,242
GRC,2020-35,1470,20,Greece,10718565,Europe,10134,262
GRC,2020-36,1390,22,Greece,10718565,Europe,11524,284
GRC,2020-37,1716,21,Greece,10718565,Europe,13240,305
GRC,2020-38,1902,33,Greece,10718565,Europe,15142,338
GRC,2020-39,2302,41,Greece,10718565,Europe,17444,379
GRC,2020-40,2398,30,Greece,10718565,Europe,19842,409
GRC,2020-41,2516,40,Greece,10718565,Europe,22358,449
GRC,2020-42,3012,60,Greece,10718565,Europe,25370,509
GRC,2020-43,5412,65,Greece,10718565,Europe,30782,574
GRC,2020-44,10147,61,Greece,10718565,Europe,40929,635
GRC,2020-45,15769,149,Greece,10718565,Europe,56698,784
GRC,2020-46,17507,322,Greece,10718565,Europe,74205,1106
GRC,2020-47,17414,524,Greece,10718565,Europe,91619,1630
GRC,2020-48,12608,691,Greece,10718565,Europe,104227,2321
GRC,2020-49,11244,682,Greece,10718565,Europe,115471,3003
GRC,2020-50,9063,622,Greece,10718565,Europe,124534,3625
GRC,2020-51,6538,547,Greece,10718565,Europe,131072,4172
GRC,2020-52,4859,500,Greece,10718565,Europe,135931,4672
GRC,2020-53,4168,285,Greece,10718565,Europe,140099,4957
GRC,2021-01,4639,306,Greece,10718565,Europe,144738,5263
GRC,2021-02,3869,206,Greece,10718565,Europe,148607,5469
GRC,2021-03,3373,177,Greece,10718565,Europe,151980,5646
GRC,2021-04,4977,150,Greece,10718565,Europe,156957,5796
GRC,2021-05,6989,176,Greece,10718565,Europe,163946,5972
GRC,2021-06,8182,154,Greece,10718565,Europe,172128,6126
GRC,2021-07,7674,171,Greece,10718565,Europe,179802,6297
GRC,2021-08,11298,207,Greece,10718565,Europe,191100,6504
GRC,2021-09,14020,254,Greece,10718565,Europe,205120,6758
GRC,2021-10,16027,333,Greece,10718565,Europe,221147,7091
GRC,2021-11,15978,371,Greece,10718565,Europe,237125,7462
GRC,2021-12,16906,418,Greece,10718565,Europe,254031,7880
GRC,2021-13,21383,500,Greece,10718565,Europe,275414,8380
GRC,2021-14,20066,505,Greece,10718565,Europe,295480,8885
GRC,2021-15,19793,577,Greece,10718565,Europe,315273,9462
GRC,2021-16,17856,545,Greece,10718565,Europe,333129,10007
GRC,2021-17,13293,446,Greece,10718565,Europe,346422,10453
GRC,2021-18,15582,576,Greece,10718565,Europe,362004,11029
GRC,2021-19,15086,386,Greece,10718565,Europe,377090,11415
GRC,2021-20,12714,357,Greece,10718565,Europe,389804,11772
GRC,2021-21,11497,282,Greece,10718565,Europe,401301,12054
GRC,2021-22,8067,223,Greece,10718565,Europe,409368,12277
GRC,2021-23,5565,145,Greece,10718565,Europe,414933,12422
GRC,2021-24,3409,126,Greece,10718565,Europe,418342,12548
GRC,2021-25,2563,116,Greece,10718565,Europe,420905,12664
GRC,2021-26,5059,73,Greece,10718565,Europe,425964,12737
GRC,2021-27,12845,55,Greece,10718565,Europe,438809,12792
GRC,2021-28,18503,58,Greece,10718565,Europe,457312,12850
GRC,2021-29,18607,48,Greece,10718565,Europe,475919,12898
GRC,2021-30,18988,77,Greece,10718565,Europe,494907,12975
GRC,2021-31,19285,100,Greece,10718565,Europe,514192,13075
GRC,2021-32,22933,148,Greece,10718565,Europe,537125,13223
GRD,2020-13,8,0,Grenada,112519,America,8,0
GRD,2020-14,3,0,Grenada,112519,America,11,0
GRD,2020-15,2,0,Grenada,112519,America,13,0
GRD,2020-16,0,0,Grenada,112519,America,13,0
GRD,2020-17,4,0,Grenada,112519,America,17,0
GRD,2020-18,3,0,Grenada,112519,America,20,0
GRD,2020-19,0,0,Grenada,112519,America,20,0
GRD,2020-20,1,0,Grenada,112519,America,21,0
GRD,2020-21,0,0,Grenada,112519,America,21,0
GRD,2020-22,1,0,Grenada,112519,America,22,0
GRD,2020-23,0,0,Grenada,112519,America,22,0
GRD,2020-24,0,0,Grenada,112519,America,22,0
GRD,2020-25,0,0,Grenada,112519,America,22,0
GRD,2020-26,0,0,Grenada,112519,America,22,0
GRD,2020-27,0,0,Grenada,112519,America,22,0
GRD,2020-28,0,0,Grenada,112519,America,22,0
GRD,2020-29,0,0,Grenada,112519,America,22,0
GRD,2020-30,0,0,Grenada,112519,America,22,0
GRD,2020-31,1,0,Grenada,112519,America,23,0
GRD,2020-32,0,0,Grenada,112519,America,23,0
GRD,2020-33,0,0,Grenada,112519,America,23,0
GRD,2020-34,0,0,Grenada,112519,America,23,0
GRD,2020-35,0,0,Grenada,112519,America,23,0
GRD,2020-36,0,0,Grenada,112519,America,23,0
GRD,2020-37,0,0,Grenada,112519,America,23,0
GRD,2020-38,0,0,Grenada,112519,America,23,0
GRD,2020-39,0,0,Grenada,112519,America,23,0
GRD,2020-40,0,0,Grenada,112519,America,23,0
GRD,2020-41,0,0,Grenada,112519,America,23,0
GRD,2020-42,3,0,Grenada,112519,America,26,0
GRD,2020-43,1,0,Grenada,112519,America,27,0
GRD,2020-44,0,0,Grenada,112519,America,27,0
GRD,2020-45,4,0,Grenada,112519,America,31,0
GRD,2020-46,0,0,Grenada,112519,America,31,0
GRD,2020-47,9,0,Grenada,112519,America,40,0
GRD,2020-48,0,0,Grenada,112519,America,40,0
GRD,2020-49,0,0,Grenada,112519,America,40,0
GRD,2020-50,28,0,Grenada,112519,America,68,0
GRD,2020-51,38,0,Grenada,112519,America,106,0
GRD,2020-52,9,0,Grenada,112519,America,115,0
GRD,2020-53,18,0,Grenada,112519,America,133,0
GRD,2021-01,1,1,Grenada,112519,America,134,1
GRD,2021-02,4,0,Grenada,112519,America,138,1
GRD,2021-03,9,0,Grenada,112519,America,147,1
GRD,2021-04,0,0,Grenada,112519,America,147,1
GRD,2021-05,0,0,Grenada,112519,America,147,1
GRD,2021-06,0,0,Grenada,112519,America,147,1
GRD,2021-07,0,0,Grenada,112519,America,147,1
GRD,2021-08,0,0,Grenada,112519,America,147,1
GRD,2021-09,0,0,Grenada,112519,America,147,1
GRD,2021-10,6,0,Grenada,112519,America,153,1
GRD,2021-11,0,0,Grenada,112519,America,153,1
GRD,2021-12,1,0,Grenada,112519,America,154,1
GRD,2021-13,1,0,Grenada,112519,America,155,1
GRD,2021-14,2,0,Grenada,112519,America,157,1
GRD,2021-15,1,0,Grenada,112519,America,158,1
GRD,2021-16,0,0,Grenada,112519,America,158,1
GRD,2021-17,2,0,Grenada,112519,America,160,1
GRD,2021-18,0,0,Grenada,112519,America,160,1
GRD,2021-19,0,0,Grenada,112519,America,160,1
GRD,2021-20,0,0,Grenada,112519,America,160,1
GRD,2021-21,0,0,Grenada,112519,America,160,1
GRD,2021-22,0,0,Grenada,112519,America,160,1
GRD,2021-23,0,0,Grenada,112519,America,160,1
GRD,2021-24,0,0,Grenada,112519,America,160,1
GRD,2021-25,1,0,Grenada,112519,America,161,1
GRD,2021-26,0,0,Grenada,112519,America,161,1
GRD,2021-27,0,0,Grenada,112519,America,161,1
GRD,2021-28,1,0,Grenada,112519,America,162,1
GRD,2021-29,2,0,Grenada,112519,America,164,1
GRD,2021-30,4,0,Grenada,112519,America,168,1
GRD,2021-31,9,0,Grenada,112519,America,177,1
GRD,2021-32,10,0,Grenada,112519,America,187,1
GRL,2020-13,8,0,Greenland,56772,America,8,0
GRL,2020-14,1,0,Greenland,56772,America,9,0
GRL,2020-15,0,0,Greenland,56772,America,9,0
GRL,2020-16,0,0,Greenland,56772,America,9,0
GRL,2020-17,0,0,Greenland,56772,America,9,0
GRL,2020-18,0,0,Greenland,56772,America,9,0
GRL,2020-19,0,0,Greenland,56772,America,9,0
GRL,2020-20,0,0,Greenland,56772,America,9,0
GRL,2020-21,0,0,Greenland,56772,America,9,0
GRL,2020-22,2,0,Greenland,56772,America,11,0
GRL,2020-23,0,0,Greenland,56772,America,11,0
GRL,2020-24,0,0,Greenland,56772,America,11,0
GRL,2020-25,0,0,Greenland,56772,America,11,0
GRL,2020-26,0,0,Greenland,56772,America,11,0
GRL,2020-27,0,0,Greenland,56772,America,11,0
GRL,2020-28,0,0,Greenland,56772,America,11,0
GRL,2020-29,0,0,Greenland,56772,America,11,0
GRL,2020-30,0,0,Greenland,56772,America,11,0
GRL,2020-31,1,0,Greenland,56772,America,12,0
GRL,2020-32,0,0,Greenland,56772,America,12,0
GRL,2020-33,0,0,Greenland,56772,America,12,0
GRL,2020-34,0,0,Greenland,56772,America,12,0
GRL,2020-35,0,0,Greenland,56772,America,12,0
GRL,2020-36,0,0,Greenland,56772,America,12,0
GRL,2020-37,0,0,Greenland,56772,America,12,0
GRL,2020-38,0,0,Greenland,56772,America,12,0
GRL,2020-39,0,0,Greenland,56772,America,12,0
GRL,2020-40,0,0,Greenland,56772,America,12,0
GRL,2020-41,2,0,Greenland,56772,America,14,0
GRL,2020-42,0,0,Greenland,56772,America,14,0
GRL,2020-43,1,0,Greenland,56772,America,15,0
GRL,2020-44,0,0,Greenland,56772,America,15,0
GRL,2020-45,0,0,Greenland,56772,America,15,0
GRL,2020-46,0,0,Greenland,56772,America,15,0
GRL,2020-47,1,0,Greenland,56772,America,16,0
GRL,2020-48,0,0,Greenland,56772,America,16,0
GRL,2020-49,0,0,Greenland,56772,America,16,0
GRL,2020-50,1,0,Greenland,56772,America,17,0
GRL,2020-51,0,0,Greenland,56772,America,17,0
GRL,2020-52,7,0,Greenland,56772,America,24,0
GRL,2020-53,1,0,Greenland,56772,America,25,0
GRL,2021-01,0,0,Greenland,56772,America,25,0
GRL,2021-02,3,0,Greenland,56772,America,28,0
GRL,2021-03,0,0,Greenland,56772,America,28,0
GRL,2021-04,0,0,Greenland,56772,America,28,0
GRL,2021-05,0,0,Greenland,56772,America,28,0
GRL,2021-06,0,0,Greenland,56772,America,28,0
GRL,2021-07,0,0,Greenland,56772,America,28,0
GRL,2021-08,0,0,Greenland,56772,America,28,0
GRL,2021-09,1,0,Greenland,56772,America,29,0
GRL,2021-10,0,0,Greenland,56772,America,29,0
GRL,2021-11,0,0,Greenland,56772,America,29,0
GRL,2021-12,0,0,Greenland,56772,America,29,0
GRL,2021-13,0,0,Greenland,56772,America,29,0
GRL,2021-14,0,0,Greenland,56772,America,29,0
GRL,2021-15,0,0,Greenland,56772,America,29,0
GRL,2021-16,0,0,Greenland,56772,America,29,0
GRL,2021-17,0,0,Greenland,56772,America,29,0
GRL,2021-18,0,0,Greenland,56772,America,29,0
GRL,2021-19,0,0,Greenland,56772,America,29,0
GRL,2021-20,3,0,Greenland,56772,America,32,0
GRL,2021-21,6,0,Greenland,56772,America,38,0
GRL,2021-22,3,0,Greenland,56772,America,41,0
GRL,2021-23,1,0,Greenland,56772,America,42,0
GRL,2021-24,6,0,Greenland,56772,America,48,0
GRL,2021-25,0,0,Greenland,56772,America,48,0
GRL,2021-26,1,0,Greenland,56772,America,49,0
GRL,2021-27,4,0,Greenland,56772,America,53,0
GRL,2021-28,26,0,Greenland,56772,America,79,0
GRL,2021-29,11,0,Greenland,56772,America,90,0
GRL,2021-30,30,0,Greenland,56772,America,120,0
GRL,2021-31,60,0,Greenland,56772,America,180,0
GRL,2021-32,67,0,Greenland,56772,America,247,0
GTM,2020-12,18,0,Guatemala,17915567,America,18,0
GTM,2020-13,17,0,Guatemala,17915567,America,35,0
GTM,2020-14,34,2,Guatemala,17915567,America,69,2
GTM,2020-15,86,2,Guatemala,17915567,America,155,4
GTM,2020-16,133,2,Guatemala,17915567,America,288,6
GTM,2020-17,211,8,Guatemala,17915567,America,499,14
GTM,2020-18,203,2,Guatemala,17915567,America,702,16
GTM,2020-19,349,9,Guatemala,17915567,America,1051,25
GTM,2020-20,860,9,Guatemala,17915567,America,1911,34
GTM,2020-21,1512,23,Guatemala,17915567,America,3423,57
GTM,2020-22,1663,50,Guatemala,17915567,America,5086,107
GTM,2020-23,1968,144,Guatemala,17915567,America,7054,251
GTM,2020-24,2790,132,Guatemala,17915567,America,9844,383
GTM,2020-25,3300,147,Guatemala,17915567,America,13144,530
GTM,2020-26,3785,196,Guatemala,17915567,America,16929,726
GTM,2020-27,6318,220,Guatemala,17915567,America,23247,946
GTM,2020-28,6107,272,Guatemala,17915567,America,29354,1218
GTM,2020-29,9322,266,Guatemala,17915567,America,38676,1484
GTM,2020-30,6376,249,Guatemala,17915567,America,45052,1733
GTM,2020-31,6253,261,Guatemala,17915567,America,51305,1994
GTM,2020-32,5299,216,Guatemala,17915567,America,56604,2210
GTM,2020-33,5957,168,Guatemala,17915567,America,62561,2378
GTM,2020-34,5626,215,Guatemala,17915567,America,68187,2593
GTM,2020-35,5724,146,Guatemala,17915567,America,73911,2739
GTM,2020-36,3771,112,Guatemala,17915567,America,77682,2851
GTM,2020-37,4226,105,Guatemala,17915567,America,81908,2956
GTM,2020-38,3535,162,Guatemala,17915567,America,85443,3118
GTM,2020-39,4648,110,Guatemala,17915567,America,90091,3228
GTM,2020-40,3871,64,Guatemala,17915567,America,93962,3292
GTM,2020-41,3752,91,Guatemala,17915567,America,97714,3383
GTM,2020-42,3645,146,Guatemala,17915567,America,101359,3529
GTM,2020-43,3427,114,Guatemala,17915567,America,104786,3643
GTM,2020-44,3317,94,Guatemala,17915567,America,108103,3737
GTM,2020-45,3158,83,Guatemala,17915567,America,111261,3820
GTM,2020-46,3623,111,Guatemala,17915567,America,114884,3931
GTM,2020-47,3744,144,Guatemala,17915567,America,118628,4075
GTM,2020-48,3342,90,Guatemala,17915567,America,121970,4165
GTM,2020-49,3579,84,Guatemala,17915567,America,125549,4249
GTM,2020-50,3732,173,Guatemala,17915567,America,129281,4422
GTM,2020-51,4319,295,Guatemala,17915567,America,133600,4717
GTM,2020-52,1840,55,Guatemala,17915567,America,135440,4772
GTM,2020-53,3215,62,Guatemala,17915567,America,138655,4834
GTM,2021-01,4517,215,Guatemala,17915567,America,143172,5049
GTM,2021-02,5973,228,Guatemala,17915567,America,149145,5277
GTM,2021-03,5284,191,Guatemala,17915567,America,154429,5468
GTM,2021-04,5202,204,Guatemala,17915567,America,159631,5672
GTM,2021-05,3615,249,Guatemala,17915567,America,163246,5921
GTM,2021-06,4136,228,Guatemala,17915567,America,167382,6149
GTM,2021-07,3906,156,Guatemala,17915567,America,171288,6305
GTM,2021-08,3364,96,Guatemala,17915567,America,174652,6401
GTM,2021-09,4117,77,Guatemala,17915567,America,178769,6478
GTM,2021-10,4244,99,Guatemala,17915567,America,183013,6577
GTM,2021-11,5105,132,Guatemala,17915567,America,188118,6709
GTM,2021-12,5437,99,Guatemala,17915567,America,193555,6808
GTM,2021-13,2124,85,Guatemala,17915567,America,195679,6893
GTM,2021-14,7629,126,Guatemala,17915567,America,203308,7019
GTM,2021-15,9740,221,Guatemala,17915567,America,213048,7240
GTM,2021-16,8890,187,Guatemala,17915567,America,221938,7427
GTM,2021-17,6932,150,Guatemala,17915567,America,228870,7577
GTM,2021-18,6218,155,Guatemala,17915567,America,235088,7732
GTM,2021-19,6280,154,Guatemala,17915567,America,241368,7886
GTM,2021-20,6275,122,Guatemala,17915567,America,247643,8008
GTM,2021-21,6773,156,Guatemala,17915567,America,254416,8164
GTM,2021-22,7838,140,Guatemala,17915567,America,262254,8304
GTM,2021-23,9735,160,Guatemala,17915567,America,271989,8464
GTM,2021-24,8864,270,Guatemala,17915567,America,280853,8734
GTM,2021-25,11123,354,Guatemala,17915567,America,291976,9088
GTM,2021-26,10557,409,Guatemala,17915567,America,302533,9497
GTM,2021-27,16623,223,Guatemala,17915567,America,319156,9720
GTM,2021-28,15218,206,Guatemala,17915567,America,334374,9926
GTM,2021-29,18209,185,Guatemala,17915567,America,352583,10111
GTM,2021-30,17674,336,Guatemala,17915567,America,370257,10447
GTM,2021-31,20860,360,Guatemala,17915567,America,391117,10807
GTM,2021-32,22679,381,Guatemala,17915567,America,413796,11188
GUM,2020-13,29,0,Guam,168783,Oceania,29,0
GUM,2020-14,54,3,Guam,168783,Oceania,83,3
GUM,2020-15,23,1,Guam,168783,Oceania,106,4
GUM,2020-16,3,0,Guam,168783,Oceania,109,4
GUM,2020-17,6,0,Guam,168783,Oceania,115,4
GUM,2020-18,7,0,Guam,168783,Oceania,122,4
GUM,2020-19,2,0,Guam,168783,Oceania,124,4
GUM,2020-20,3,0,Guam,168783,Oceania,127,4
GUM,2020-21,12,0,Guam,168783,Oceania,139,4
GUM,2020-22,9,0,Guam,168783,Oceania,148,4
GUM,2020-23,4,0,Guam,168783,Oceania,152,4
GUM,2020-24,6,0,Guam,168783,Oceania,158,4
GUM,2020-25,37,0,Guam,168783,Oceania,195,4
GUM,2020-26,31,0,Guam,168783,Oceania,226,4
GUM,2020-27,48,0,Guam,168783,Oceania,274,4
GUM,2020-28,11,0,Guam,168783,Oceania,285,4
GUM,2020-29,7,0,Guam,168783,Oceania,292,4
GUM,2020-30,27,0,Guam,168783,Oceania,319,4
GUM,2020-31,22,0,Guam,168783,Oceania,341,4
GUM,2020-32,50,0,Guam,168783,Oceania,391,4
GUM,2020-33,140,0,Guam,168783,Oceania,531,4
GUM,2020-34,262,2,Guam,168783,Oceania,793,6
GUM,2020-35,527,3,Guam,168783,Oceania,1320,9
GUM,2020-36,272,4,Guam,168783,Oceania,1592,13
GUM,2020-37,272,11,Guam,168783,Oceania,1864,24
GUM,2020-38,226,9,Guam,168783,Oceania,2090,33
GUM,2020-39,237,8,Guam,168783,Oceania,2327,41
GUM,2020-40,345,10,Guam,168783,Oceania,2672,51
GUM,2020-41,379,8,Guam,168783,Oceania,3051,59
GUM,2020-42,597,6,Guam,168783,Oceania,3648,65
GUM,2020-43,541,6,Guam,168783,Oceania,4189,71
GUM,2020-44,477,7,Guam,168783,Oceania,4666,78
GUM,2020-45,540,10,Guam,168783,Oceania,5206,88
GUM,2020-46,888,9,Guam,168783,Oceania,6094,97
GUM,2020-47,428,8,Guam,168783,Oceania,6522,105
GUM,2020-48,269,6,Guam,168783,Oceania,6791,111
GUM,2020-49,186,1,Guam,168783,Oceania,6977,112
GUM,2020-50,102,5,Guam,168783,Oceania,7079,117
GUM,2020-51,105,2,Guam,168783,Oceania,7184,119
GUM,2020-52,59,1,Guam,168783,Oceania,7243,120
GUM,2020-53,57,2,Guam,168783,Oceania,7300,122
GUM,2021-01,96,1,Guam,168783,Oceania,7396,123
GUM,2021-02,62,4,Guam,168783,Oceania,7458,127
GUM,2021-03,69,1,Guam,168783,Oceania,7527,128
GUM,2021-04,54,0,Guam,168783,Oceania,7581,128
GUM,2021-05,41,1,Guam,168783,Oceania,7622,129
GUM,2021-06,50,0,Guam,168783,Oceania,7672,129
GUM,2021-07,28,0,Guam,168783,Oceania,7700,129
GUM,2021-08,10,1,Guam,168783,Oceania,7710,130
GUM,2021-09,14,2,Guam,168783,Oceania,7724,132
GUM,2021-10,17,0,Guam,168783,Oceania,7741,132
GUM,2021-11,16,1,Guam,168783,Oceania,7757,133
GUM,2021-12,16,0,Guam,168783,Oceania,7773,133
GUM,2021-13,16,2,Guam,168783,Oceania,7789,135
GUM,2021-14,26,0,Guam,168783,Oceania,7815,135
GUM,2021-15,37,0,Guam,168783,Oceania,7852,135
GUM,2021-16,36,0,Guam,168783,Oceania,7888,135
GUM,2021-17,89,1,Guam,168783,Oceania,7977,136
GUM,2021-18,39,2,Guam,168783,Oceania,8016,138
GUM,2021-19,60,0,Guam,168783,Oceania,8076,138
GUM,2021-20,33,0,Guam,168783,Oceania,8109,138
GUM,2021-21,20,0,Guam,168783,Oceania,8129,138
GUM,2021-22,48,0,Guam,168783,Oceania,8177,138
GUM,2021-23,40,0,Guam,168783,Oceania,8217,138
GUM,2021-24,40,0,Guam,168783,Oceania,8257,138
GUM,2021-25,60,1,Guam,168783,Oceania,8317,139
GUM,2021-26,50,0,Guam,168783,Oceania,8367,139
GUM,2021-27,60,1,Guam,168783,Oceania,8427,140
GUM,2021-28,24,2,Guam,168783,Oceania,8451,142
GUM,2021-29,23,0,Guam,168783,Oceania,8474,142
GUM,2021-30,63,0,Guam,168783,Oceania,8537,142
GUM,2021-31,161,0,Guam,168783,Oceania,8698,142
GUM,2021-32,293,0,Guam,168783,Oceania,8991,142
GUY,2020-12,1,0,Guyana,786559,America,1,0
GUY,2020-13,3,0,Guyana,786559,America,4,0
GUY,2020-14,21,3,Guyana,786559,America,25,3
GUY,2020-15,16,2,Guyana,786559,America,41,5
GUY,2020-16,20,1,Guyana,786559,America,61,6
GUY,2020-17,9,1,Guyana,786559,America,70,7
GUY,2020-18,8,1,Guyana,786559,America,78,8
GUY,2020-19,22,1,Guyana,786559,America,100,9
GUY,2020-20,13,0,Guyana,786559,America,113,9
GUY,2020-21,18,0,Guyana,786559,America,131,9
GUY,2020-22,18,2,Guyana,786559,America,149,11
GUY,2020-23,1,0,Guyana,786559,America,150,11
GUY,2020-24,5,0,Guyana,786559,America,155,11
GUY,2020-25,25,0,Guyana,786559,America,180,11
GUY,2020-26,46,0,Guyana,786559,America,226,11
GUY,2020-27,43,3,Guyana,786559,America,269,14
GUY,2020-28,24,2,Guyana,786559,America,293,16
GUY,2020-29,39,2,Guyana,786559,America,332,18
GUY,2020-30,34,1,Guyana,786559,America,366,19
GUY,2020-31,104,1,Guyana,786559,America,470,20
GUY,2020-32,94,1,Guyana,786559,America,564,21
GUY,2020-33,141,1,Guyana,786559,America,705,22
GUY,2020-34,246,8,Guyana,786559,America,951,30
GUY,2020-35,279,6,Guyana,786559,America,1230,36
GUY,2020-36,234,9,Guyana,786559,America,1464,45
GUY,2020-37,385,10,Guyana,786559,America,1849,55
GUY,2020-38,416,8,Guyana,786559,America,2265,63
GUY,2020-39,503,12,Guyana,786559,America,2768,75
GUY,2020-40,321,11,Guyana,786559,America,3089,86
GUY,2020-41,376,16,Guyana,786559,America,3465,102
GUY,2020-42,265,6,Guyana,786559,America,3730,108
GUY,2020-43,289,10,Guyana,786559,America,4019,118
GUY,2020-44,185,7,Guyana,786559,America,4204,125
GUY,2020-45,306,8,Guyana,786559,America,4510,133
GUY,2020-46,309,5,Guyana,786559,America,4819,138
GUY,2020-47,310,4,Guyana,786559,America,5129,142
GUY,2020-48,243,7,Guyana,786559,America,5372,149
GUY,2020-49,289,3,Guyana,786559,America,5661,152
GUY,2020-50,255,2,Guyana,786559,America,5916,154
GUY,2020-51,251,4,Guyana,786559,America,6167,158
GUY,2020-52,122,5,Guyana,786559,America,6289,163
GUY,2020-53,65,0,Guyana,786559,America,6354,163
GUY,2021-01,396,5,Guyana,786559,America,6750,168
GUY,2021-02,154,1,Guyana,786559,America,6904,169
GUY,2021-03,409,2,Guyana,786559,America,7313,171
GUY,2021-04,324,4,Guyana,786559,America,7637,175
GUY,2021-05,341,4,Guyana,786559,America,7978,179
GUY,2021-06,250,6,Guyana,786559,America,8228,185
GUY,2021-07,188,3,Guyana,786559,America,8416,188
GUY,2021-08,165,6,Guyana,786559,America,8581,194
GUY,2021-09,229,8,Guyana,786559,America,8810,202
GUY,2021-10,373,4,Guyana,786559,America,9183,206
GUY,2021-11,462,8,Guyana,786559,America,9645,214
GUY,2021-12,519,12,Guyana,786559,America,10164,226
GUY,2021-13,412,16,Guyana,786559,America,10576,242
GUY,2021-14,609,14,Guyana,786559,America,11185,256
GUY,2021-15,674,14,Guyana,786559,America,11859,270
GUY,2021-16,891,16,Guyana,786559,America,12750,286
GUY,2021-17,764,12,Guyana,786559,America,13514,298
GUY,2021-18,844,26,Guyana,786559,America,14358,324
GUY,2021-19,909,16,Guyana,786559,America,15267,340
GUY,2021-20,859,18,Guyana,786559,America,16126,358
GUY,2021-21,780,26,Guyana,786559,America,16906,384
GUY,2021-22,755,24,Guyana,786559,America,17661,408
GUY,2021-23,721,17,Guyana,786559,America,18382,425
GUY,2021-24,700,21,Guyana,786559,America,19082,446
GUY,2021-25,791,15,Guyana,786559,America,19873,461
GUY,2021-26,501,16,Guyana,786559,America,20374,477
GUY,2021-27,624,19,Guyana,786559,America,20998,496
GUY,2021-28,560,15,Guyana,786559,America,21558,511
GUY,2021-29,619,18,Guyana,786559,America,22177,529
GUY,2021-30,416,16,Guyana,786559,America,22593,545
GUY,2021-31,385,13,Guyana,786559,America,22978,558
GUY,2021-32,579,15,Guyana,786559,America,23557,573
HND,2020-12,21,0,Honduras,9904608,America,21,0
HND,2020-13,112,3,Honduras,9904608,America,133,3
HND,2020-14,159,19,Honduras,9904608,America,292,22
HND,2020-15,99,3,Honduras,9904608,America,391,25
HND,2020-16,80,21,Honduras,9904608,America,471,46
HND,2020-17,184,15,Honduras,9904608,America,655,61
HND,2020-18,394,21,Honduras,9904608,America,1049,82
HND,2020-19,917,26,Honduras,9904608,America,1966,108
HND,2020-20,674,34,Honduras,9904608,America,2640,142
HND,2020-21,1304,38,Honduras,9904608,America,3944,180
HND,2020-22,1252,32,Honduras,9904608,America,5196,212
HND,2020-23,1125,46,Honduras,9904608,America,6321,258
HND,2020-24,2531,54,Honduras,9904608,America,8852,312
HND,2020-25,3911,51,Honduras,9904608,America,12763,363
HND,2020-26,5313,116,Honduras,9904608,America,18076,479
HND,2020-27,5861,160,Honduras,9904608,America,23937,639
HND,2020-28,4147,135,Honduras,9904608,America,28084,774
HND,2020-29,5745,126,Honduras,9904608,America,33829,900
HND,2020-30,5441,216,Honduras,9904608,America,39270,1116
HND,2020-31,3921,261,Honduras,9904608,America,43191,1377
HND,2020-32,4257,118,Honduras,9904608,America,47448,1495
HND,2020-33,3048,80,Honduras,9904608,America,50496,1575
HND,2020-34,4009,79,Honduras,9904608,America,54505,1654
HND,2020-35,5663,204,Honduras,9904608,America,60168,1858
HND,2020-36,4590,149,Honduras,9904608,America,64758,2007
HND,2020-37,3025,72,Honduras,9904608,America,67783,2079
HND,2020-38,3827,105,Honduras,9904608,America,71610,2184
HND,2020-39,3493,105,Honduras,9904608,America,75103,2289
HND,2020-40,4520,133,Honduras,9904608,America,79623,2422
HND,2020-41,4452,90,Honduras,9904608,America,84075,2512
HND,2020-42,4344,56,Honduras,9904608,America,88419,2568
HND,2020-43,4789,55,Honduras,9904608,America,93208,2623
HND,2020-44,4998,52,Honduras,9904608,America,98206,2675
HND,2020-45,2296,76,Honduras,9904608,America,100502,2751
HND,2020-46,2594,72,Honduras,9904608,America,103096,2823
HND,2020-47,1333,34,Honduras,9904608,America,104429,2857
HND,2020-48,3453,52,Honduras,9904608,America,107882,2909
HND,2020-49,3135,37,Honduras,9904608,America,111017,2946
HND,2020-50,3336,29,Honduras,9904608,America,114353,2975
HND,2020-51,2663,52,Honduras,9904608,America,117016,3027
HND,2020-52,3081,61,Honduras,9904608,America,120097,3088
HND,2020-53,3266,92,Honduras,9904608,America,123363,3180
HND,2021-01,4576,93,Honduras,9904608,America,127939,3273
HND,2021-02,6166,81,Honduras,9904608,America,134105,3354
HND,2021-03,7873,108,Honduras,9904608,America,141978,3462
HND,2021-04,5859,148,Honduras,9904608,America,147837,3610
HND,2021-05,6725,111,Honduras,9904608,America,154562,3721
HND,2021-06,6415,172,Honduras,9904608,America,160977,3893
HND,2021-07,4112,103,Honduras,9904608,America,165089,3996
HND,2021-08,5209,155,Honduras,9904608,America,170298,4151
HND,2021-09,3425,109,Honduras,9904608,America,173723,4260
HND,2021-10,5196,100,Honduras,9904608,America,178919,4360
HND,2021-11,3484,83,Honduras,9904608,America,182403,4443
HND,2021-12,4606,114,Honduras,9904608,America,187009,4557
HND,2021-13,4121,124,Honduras,9904608,America,191130,4681
HND,2021-14,4389,89,Honduras,9904608,America,195519,4770
HND,2021-15,5410,187,Honduras,9904608,America,200929,4957
HND,2021-16,5446,143,Honduras,9904608,America,206375,5100
HND,2021-17,6786,218,Honduras,9904608,America,213161,5318
HND,2021-18,7018,347,Honduras,9904608,America,220179,5665
HND,2021-19,6534,295,Honduras,9904608,America,226713,5960
HND,2021-20,5953,186,Honduras,9904608,America,232666,6146
HND,2021-21,4909,170,Honduras,9904608,America,237575,6316
HND,2021-22,4245,163,Honduras,9904608,America,241820,6479
HND,2021-23,5902,152,Honduras,9904608,America,247722,6631
HND,2021-24,6147,135,Honduras,9904608,America,253869,6766
HND,2021-25,6456,226,Honduras,9904608,America,260325,6992
HND,2021-26,7527,97,Honduras,9904608,America,267852,7089
HND,2021-27,6620,170,Honduras,9904608,America,274472,7259
HND,2021-28,4779,168,Honduras,9904608,America,279251,7427
HND,2021-29,11190,223,Honduras,9904608,America,290441,7650
HND,2021-30,6664,184,Honduras,9904608,America,297105,7834
HND,2021-31,8825,286,Honduras,9904608,America,305930,8120
HND,2021-32,10299,253,Honduras,9904608,America,316229,8373
HRV,2020-02,0,0,Croatia,4058165,Europe,0,0
HRV,2020-03,0,0,Croatia,4058165,Europe,0,0
HRV,2020-04,0,0,Croatia,4058165,Europe,0,0
HRV,2020-05,0,0,Croatia,4058165,Europe,0,0
HRV,2020-06,0,0,Croatia,4058165,Europe,0,0
HRV,2020-07,0,0,Croatia,4058165,Europe,0,0
HRV,2020-08,0,0,Croatia,4058165,Europe,0,0
HRV,2020-09,7,0,Croatia,4058165,Europe,7,0
HRV,2020-10,5,0,Croatia,4058165,Europe,12,0
HRV,2020-11,36,0,Croatia,4058165,Europe,48,0
HRV,2020-12,187,0,Croatia,4058165,Europe,235,0
HRV,2020-13,478,6,Croatia,4058165,Europe,713,6
HRV,2020-14,469,9,Croatia,4058165,Europe,1182,15
HRV,2020-15,418,8,Croatia,4058165,Europe,1600,23
HRV,2020-16,271,24,Croatia,4058165,Europe,1871,47
HRV,2020-17,159,8,Croatia,4058165,Europe,2030,55
HRV,2020-18,66,24,Croatia,4058165,Europe,2096,79
HRV,2020-19,91,11,Croatia,4058165,Europe,2187,90
HRV,2020-20,39,5,Croatia,4058165,Europe,2226,95
HRV,2020-21,18,4,Croatia,4058165,Europe,2244,99
HRV,2020-22,2,4,Croatia,4058165,Europe,2246,103
HRV,2020-23,1,1,Croatia,4058165,Europe,2247,104
HRV,2020-24,5,3,Croatia,4058165,Europe,2252,107
HRV,2020-25,65,0,Croatia,4058165,Europe,2317,107
HRV,2020-26,374,0,Croatia,4058165,Europe,2691,107
HRV,2020-27,460,6,Croatia,4058165,Europe,3151,113
HRV,2020-28,571,6,Croatia,4058165,Europe,3722,119
HRV,2020-29,632,1,Croatia,4058165,Europe,4354,120
HRV,2020-30,503,16,Croatia,4058165,Europe,4857,136
HRV,2020-31,403,13,Croatia,4058165,Europe,5260,149
HRV,2020-32,344,8,Croatia,4058165,Europe,5604,157
HRV,2020-33,967,9,Croatia,4058165,Europe,6571,166
HRV,2020-34,1604,5,Croatia,4058165,Europe,8175,171
HRV,2020-35,1948,13,Croatia,4058165,Europe,10123,184
HRV,2020-36,1841,14,Croatia,4058165,Europe,11964,198
HRV,2020-37,1569,26,Croatia,4058165,Europe,13533,224
HRV,2020-38,1389,24,Croatia,4058165,Europe,14922,248
HRV,2020-39,1275,24,Croatia,4058165,Europe,16197,272
HRV,2020-40,1462,26,Croatia,4058165,Europe,17659,298
HRV,2020-41,2781,26,Croatia,4058165,Europe,20440,324
HRV,2020-42,5140,39,Croatia,4058165,Europe,25580,363
HRV,2020-43,10800,74,Croatia,4058165,Europe,36380,437
HRV,2020-44,15115,125,Croatia,4058165,Europe,51495,562
HRV,2020-45,15752,232,Croatia,4058165,Europe,67247,794
HRV,2020-46,16959,255,Croatia,4058165,Europe,84206,1049
HRV,2020-47,19512,304,Croatia,4058165,Europe,103718,1353
HRV,2020-48,22894,359,Croatia,4058165,Europe,126612,1712
HRV,2020-49,23741,462,Croatia,4058165,Europe,150353,2174
HRV,2020-50,25533,466,Croatia,4058165,Europe,175886,2640
HRV,2020-51,19842,617,Croatia,4058165,Europe,195728,3257
HRV,2020-52,9518,482,Croatia,4058165,Europe,205246,3739
HRV,2020-53,7712,333,Croatia,4058165,Europe,212958,4072
HRV,2021-01,7265,331,Croatia,4058165,Europe,220223,4403
HRV,2021-02,4905,252,Croatia,4058165,Europe,225128,4655
HRV,2021-03,3926,204,Croatia,4058165,Europe,229054,4859
HRV,2021-04,3466,195,Croatia,4058165,Europe,232520,5054
HRV,2021-05,2953,144,Croatia,4058165,Europe,235473,5198
HRV,2021-06,2252,141,Croatia,4058165,Europe,237725,5339
HRV,2021-07,2292,110,Croatia,4058165,Europe,240017,5449
HRV,2021-08,3047,88,Croatia,4058165,Europe,243064,5537
HRV,2021-09,3544,72,Croatia,4058165,Europe,246608,5609
HRV,2021-10,4566,76,Croatia,4058165,Europe,251174,5685
HRV,2021-11,6615,101,Croatia,4058165,Europe,257789,5786
HRV,2021-12,9733,125,Croatia,4058165,Europe,267522,5911
HRV,2021-13,12642,172,Croatia,4058165,Europe,280164,6083
HRV,2021-14,12774,250,Croatia,4058165,Europe,292938,6333
HRV,2021-15,15262,268,Croatia,4058165,Europe,308200,6601
HRV,2021-16,14836,304,Croatia,4058165,Europe,323036,6905
HRV,2021-17,12486,313,Croatia,4058165,Europe,335522,7218
HRV,2021-18,9225,285,Croatia,4058165,Europe,344747,7503
HRV,2021-19,5759,235,Croatia,4058165,Europe,350506,7738
HRV,2021-20,3554,191,Croatia,4058165,Europe,354060,7929
HRV,2021-21,2121,97,Croatia,4058165,Europe,356181,8026
HRV,2021-22,1427,65,Croatia,4058165,Europe,357608,8091
HRV,2021-23,973,61,Croatia,4058165,Europe,358581,8152
HRV,2021-24,603,30,Croatia,4058165,Europe,359184,8182
HRV,2021-25,482,20,Croatia,4058165,Europe,359666,8202
HRV,2021-26,580,17,Croatia,4058165,Europe,360246,8219
HRV,2021-27,595,10,Croatia,4058165,Europe,360841,8229
HRV,2021-28,772,11,Croatia,4058165,Europe,361613,8240
HRV,2021-29,1035,7,Croatia,4058165,Europe,362648,8247
HRV,2021-30,1139,19,Croatia,4058165,Europe,363787,8266
HRV,2021-31,1302,7,Croatia,4058165,Europe,365089,8273
HRV,2021-32,1979,12,Croatia,4058165,Europe,367068,8285
HTI,2020-13,13,0,Haiti,11402533,America,13,0
HTI,2020-14,6,0,Haiti,11402533,America,19,0
HTI,2020-15,12,3,Haiti,11402533,America,31,3
HTI,2020-16,14,0,Haiti,11402533,America,45,3
HTI,2020-17,25,3,Haiti,11402533,America,70,6
HTI,2020-18,13,2,Haiti,11402533,America,83,8
HTI,2020-19,97,7,Haiti,11402533,America,180,15
HTI,2020-20,274,5,Haiti,11402533,America,454,20
HTI,2020-21,502,7,Haiti,11402533,America,956,27
HTI,2020-22,1166,17,Haiti,11402533,America,2122,44
HTI,2020-23,1210,7,Haiti,11402533,America,3332,51
HTI,2020-24,975,22,Haiti,11402533,America,4307,73
HTI,2020-25,902,15,Haiti,11402533,America,5209,88
HTI,2020-26,636,16,Haiti,11402533,America,5845,104
HTI,2020-27,486,9,Haiti,11402533,America,6331,113
HTI,2020-28,394,26,Haiti,11402533,America,6725,139
HTI,2020-29,326,7,Haiti,11402533,America,7051,146
HTI,2020-30,262,11,Haiti,11402533,America,7313,157
HTI,2020-31,161,8,Haiti,11402533,America,7474,165
HTI,2020-32,158,18,Haiti,11402533,America,7632,183
HTI,2020-33,245,13,Haiti,11402533,America,7877,196
HTI,2020-34,203,0,Haiti,11402533,America,8080,196
HTI,2020-35,127,5,Haiti,11402533,America,8207,201
HTI,2020-36,151,13,Haiti,11402533,America,8358,214
HTI,2020-37,133,5,Haiti,11402533,America,8491,219
HTI,2020-38,126,2,Haiti,11402533,America,8617,221
HTI,2020-39,104,6,Haiti,11402533,America,8721,227
HTI,2020-40,96,2,Haiti,11402533,America,8817,229
HTI,2020-41,63,1,Haiti,11402533,America,8880,230
HTI,2020-42,43,1,Haiti,11402533,America,8923,231
HTI,2020-43,101,1,Haiti,11402533,America,9024,232
HTI,2020-44,28,0,Haiti,11402533,America,9052,232
HTI,2020-45,73,0,Haiti,11402533,America,9125,232
HTI,2020-46,52,0,Haiti,11402533,America,9177,232
HTI,2020-47,35,0,Haiti,11402533,America,9212,232
HTI,2020-48,50,0,Haiti,11402533,America,9262,232
HTI,2020-49,106,1,Haiti,11402533,America,9368,233
HTI,2020-50,195,1,Haiti,11402533,America,9563,234
HTI,2020-51,206,1,Haiti,11402533,America,9769,235
HTI,2020-52,228,1,Haiti,11402533,America,9997,236
HTI,2020-53,128,0,Haiti,11402533,America,10125,236
HTI,2021-01,145,2,Haiti,11402533,America,10270,238
HTI,2021-02,635,2,Haiti,11402533,America,10905,240
HTI,2021-03,379,3,Haiti,11402533,America,11284,243
HTI,2021-04,304,2,Haiti,11402533,America,11588,245
HTI,2021-05,379,1,Haiti,11402533,America,11967,246
HTI,2021-06,237,1,Haiti,11402533,America,12204,247
HTI,2021-07,103,0,Haiti,11402533,America,12307,247
HTI,2021-08,184,3,Haiti,11402533,America,12491,250
HTI,2021-09,101,0,Haiti,11402533,America,12592,250
HTI,2021-10,75,0,Haiti,11402533,America,12667,250
HTI,2021-11,63,1,Haiti,11402533,America,12730,251
HTI,2021-12,28,0,Haiti,11402533,America,12758,251
HTI,2021-13,43,0,Haiti,11402533,America,12801,251
HTI,2021-14,52,0,Haiti,11402533,America,12853,251
HTI,2021-15,63,0,Haiti,11402533,America,12916,251
HTI,2021-16,40,1,Haiti,11402533,America,12956,252
HTI,2021-17,191,8,Haiti,11402533,America,13147,260
HTI,2021-18,78,6,Haiti,11402533,America,13225,266
HTI,2021-19,233,5,Haiti,11402533,America,13458,271
HTI,2021-20,577,21,Haiti,11402533,America,14035,292
HTI,2021-21,528,25,Haiti,11402533,America,14563,317
HTI,2021-22,1189,13,Haiti,11402533,America,15752,330
HTI,2021-23,602,22,Haiti,11402533,America,16354,352
HTI,2021-24,1354,41,Haiti,11402533,America,17708,393
HTI,2021-25,852,32,Haiti,11402533,America,18560,425
HTI,2021-26,390,26,Haiti,11402533,America,18950,451
HTI,2021-27,268,20,Haiti,11402533,America,19218,471
HTI,2021-28,343,39,Haiti,11402533,America,19561,510
HTI,2021-29,355,25,Haiti,11402533,America,19916,535
HTI,2021-30,389,25,Haiti,11402533,America,20305,560
HTI,2021-31,82,9,Haiti,11402533,America,20387,569
HTI,2021-32,167,7,Haiti,11402533,America,20554,576
HUN,2020-11,31,1,Hungary,9769526,Europe,31,1
HUN,2020-12,128,6,Hungary,9769526,Europe,159,7
HUN,2020-13,280,8,Hungary,9769526,Europe,439,15
HUN,2020-14,297,23,Hungary,9769526,Europe,736,38
HUN,2020-15,714,71,Hungary,9769526,Europe,1450,109
HUN,2020-16,526,90,Hungary,9769526,Europe,1976,199
HUN,2020-17,599,81,Hungary,9769526,Europe,2575,280
HUN,2020-18,452,71,Hungary,9769526,Europe,3027,351
HUN,2020-19,249,70,Hungary,9769526,Europe,3276,421
HUN,2020-20,251,41,Hungary,9769526,Europe,3527,462
HUN,2020-21,221,29,Hungary,9769526,Europe,3748,491
HUN,2020-22,120,35,Hungary,9769526,Europe,3868,526
HUN,2020-23,94,16,Hungary,9769526,Europe,3962,542
HUN,2020-24,106,21,Hungary,9769526,Europe,4068,563
HUN,2020-25,26,9,Hungary,9769526,Europe,4094,572
HUN,2020-26,40,9,Hungary,9769526,Europe,4134,581
HUN,2020-27,41,8,Hungary,9769526,Europe,4175,589
HUN,2020-28,51,6,Hungary,9769526,Europe,4226,595
HUN,2020-29,99,1,Hungary,9769526,Europe,4325,596
HUN,2020-30,115,0,Hungary,9769526,Europe,4440,596
HUN,2020-31,87,1,Hungary,9769526,Europe,4527,597
HUN,2020-32,161,5,Hungary,9769526,Europe,4688,602
HUN,2020-33,220,6,Hungary,9769526,Europe,4908,608
HUN,2020-34,239,5,Hungary,9769526,Europe,5147,613
HUN,2020-35,806,1,Hungary,9769526,Europe,5953,614
HUN,2020-36,2426,10,Hungary,9769526,Europe,8379,624
HUN,2020-37,3922,13,Hungary,9769526,Europe,12301,637
HUN,2020-38,6557,49,Hungary,9769526,Europe,18858,686
HUN,2020-39,5850,63,Hungary,9769526,Europe,24708,749
HUN,2020-40,6764,84,Hungary,9769526,Europe,31472,833
HUN,2020-41,7097,135,Hungary,9769526,Europe,38569,968
HUN,2020-42,9191,205,Hungary,9769526,Europe,47760,1173
HUN,2020-43,13795,299,Hungary,9769526,Europe,61555,1472
HUN,2020-44,21217,417,Hungary,9769526,Europe,82772,1889
HUN,2020-45,31998,604,Hungary,9769526,Europe,114770,2493
HUN,2020-46,32678,697,Hungary,9769526,Europe,147448,3190
HUN,2020-47,30496,701,Hungary,9769526,Europe,177944,3891
HUN,2020-48,39170,932,Hungary,9769526,Europe,217114,4823
HUN,2020-49,37026,1161,Hungary,9769526,Europe,254140,5984
HUN,2020-50,29722,1146,Hungary,9769526,Europe,283862,7130
HUN,2020-51,21260,1152,Hungary,9769526,Europe,305122,8282
HUN,2020-52,11539,879,Hungary,9769526,Europe,316661,9161
HUN,2020-53,12182,816,Hungary,9769526,Europe,328843,9977
HUN,2021-01,14805,748,Hungary,9769526,Europe,343648,10725
HUN,2021-02,9047,684,Hungary,9769526,Europe,352695,11409
HUN,2021-03,7715,615,Hungary,9769526,Europe,360410,12024
HUN,2021-04,8292,554,Hungary,9769526,Europe,368702,12578
HUN,2021-05,8945,577,Hungary,9769526,Europe,377647,13155
HUN,2021-06,11144,597,Hungary,9769526,Europe,388791,13752
HUN,2021-07,16847,595,Hungary,9769526,Europe,405638,14347
HUN,2021-08,27279,711,Hungary,9769526,Europe,432917,15058
HUN,2021-09,35788,930,Hungary,9769526,Europe,468705,15988
HUN,2021-10,55483,1095,Hungary,9769526,Europe,524188,17083
HUN,2021-11,56446,1368,Hungary,9769526,Europe,580634,18451
HUN,2021-12,60482,1710,Hungary,9769526,Europe,641116,20161
HUN,2021-13,48729,1767,Hungary,9769526,Europe,689845,21928
HUN,2021-14,35388,1780,Hungary,9769526,Europe,725233,23708
HUN,2021-15,27947,1673,Hungary,9769526,Europe,753180,25381
HUN,2021-16,18266,1420,Hungary,9769526,Europe,771446,26801
HUN,2021-17,12657,1107,Hungary,9769526,Europe,784103,27908
HUN,2021-18,8275,785,Hungary,9769526,Europe,792378,28693
HUN,2021-19,6187,520,Hungary,9769526,Europe,798565,29213
HUN,2021-20,3773,347,Hungary,9769526,Europe,802338,29560
HUN,2021-21,2192,173,Hungary,9769526,Europe,804530,29733
HUN,2021-22,1551,133,Hungary,9769526,Europe,806081,29866
HUN,2021-23,956,59,Hungary,9769526,Europe,807037,29925
HUN,2021-24,585,34,Hungary,9769526,Europe,807622,29959
HUN,2021-25,412,30,Hungary,9769526,Europe,808034,29989
HUN,2021-26,220,7,Hungary,9769526,Europe,808254,29996
HUN,2021-27,277,11,Hungary,9769526,Europe,808531,30007
HUN,2021-28,325,10,Hungary,9769526,Europe,808856,30017
HUN,2021-29,398,3,Hungary,9769526,Europe,809254,30020
HUN,2021-30,384,7,Hungary,9769526,Europe,809638,30027
HUN,2021-31,365,10,Hungary,9769526,Europe,810003,30037
HUN,2021-32,493,4,Hungary,9769526,Europe,810496,30041
IDN,2020-02,0,0,Indonesia,273523621,Asia,0,0
IDN,2020-03,0,0,Indonesia,273523621,Asia,0,0
IDN,2020-04,0,0,Indonesia,273523621,Asia,0,0
IDN,2020-05,0,0,Indonesia,273523621,Asia,0,0
IDN,2020-06,0,0,Indonesia,273523621,Asia,0,0
IDN,2020-07,0,0,Indonesia,273523621,Asia,0,0
IDN,2020-08,0,0,Indonesia,273523621,Asia,0,0
IDN,2020-09,2,0,Indonesia,273523621,Asia,2,0
IDN,2020-10,4,0,Indonesia,273523621,Asia,6,0
IDN,2020-11,111,5,Indonesia,273523621,Asia,117,5
IDN,2020-12,397,43,Indonesia,273523621,Asia,514,48
IDN,2020-13,771,66,Indonesia,273523621,Asia,1285,114
IDN,2020-14,988,84,Indonesia,273523621,Asia,2273,198
IDN,2020-15,1968,175,Indonesia,273523621,Asia,4241,373
IDN,2020-16,2334,209,Indonesia,273523621,Asia,6575,582
IDN,2020-17,2307,161,Indonesia,273523621,Asia,8882,743
IDN,2020-18,2310,102,Indonesia,273523621,Asia,11192,845
IDN,2020-19,2840,128,Indonesia,273523621,Asia,14032,973
IDN,2020-20,3482,175,Indonesia,273523621,Asia,17514,1148
IDN,2020-21,4757,224,Indonesia,273523621,Asia,22271,1372
IDN,2020-22,4202,241,Indonesia,273523621,Asia,26473,1613
IDN,2020-23,4713,238,Indonesia,273523621,Asia,31186,1851
IDN,2020-24,7091,283,Indonesia,273523621,Asia,38277,2134
IDN,2020-25,7614,331,Indonesia,273523621,Asia,45891,2465
IDN,2020-26,8119,289,Indonesia,273523621,Asia,54010,2754
IDN,2020-27,9739,417,Indonesia,273523621,Asia,63749,3171
IDN,2020-28,11950,435,Indonesia,273523621,Asia,75699,3606
IDN,2020-29,10822,537,Indonesia,273523621,Asia,86521,4143
IDN,2020-30,12257,638,Indonesia,273523621,Asia,98778,4781
IDN,2020-31,12677,455,Indonesia,273523621,Asia,111455,5236
IDN,2020-32,13941,487,Indonesia,273523621,Asia,125396,5723
IDN,2020-33,14153,427,Indonesia,273523621,Asia,139549,6150
IDN,2020-34,13986,530,Indonesia,273523621,Asia,153535,6680
IDN,2020-35,18518,663,Indonesia,273523621,Asia,172053,7343
IDN,2020-36,22056,682,Indonesia,273523621,Asia,194109,8025
IDN,2020-37,24273,698,Indonesia,273523621,Asia,218382,8723
IDN,2020-38,26294,830,Indonesia,273523621,Asia,244676,9553
IDN,2020-39,30537,833,Indonesia,273523621,Asia,275213,10386
IDN,2020-40,28285,765,Indonesia,273523621,Asia,303498,11151
IDN,2020-41,29951,693,Indonesia,273523621,Asia,333449,11844
IDN,2020-42,28418,667,Indonesia,273523621,Asia,361867,12511
IDN,2020-43,27845,788,Indonesia,273523621,Asia,389712,13299
IDN,2020-44,23072,644,Indonesia,273523621,Asia,412784,13943
IDN,2020-45,24932,671,Indonesia,273523621,Asia,437716,14614
IDN,2020-46,29397,597,Indonesia,273523621,Asia,467113,15211
IDN,2020-47,30555,673,Indonesia,273523621,Asia,497668,15884
IDN,2020-48,36598,931,Indonesia,273523621,Asia,534266,16815
IDN,2020-49,41530,925,Indonesia,273523621,Asia,575796,17740
IDN,2020-50,42024,1079,Indonesia,273523621,Asia,617820,18819
IDN,2020-51,47110,1061,Indonesia,273523621,Asia,664930,19880
IDN,2020-52,48435,1357,Indonesia,273523621,Asia,713365,21237
IDN,2020-53,45108,1318,Indonesia,273523621,Asia,758473,22555
IDN,2021-01,69553,1574,Indonesia,273523621,Asia,828026,24129
IDN,2021-02,79903,1858,Indonesia,273523621,Asia,907929,25987
IDN,2021-03,81333,1848,Indonesia,273523621,Asia,989262,27835
IDN,2021-04,89052,2163,Indonesia,273523621,Asia,1078314,29998
IDN,2021-05,79523,1558,Indonesia,273523621,Asia,1157837,31556
IDN,2021-06,59631,1627,Indonesia,273523621,Asia,1217468,33183
IDN,2021-07,53885,1133,Indonesia,273523621,Asia,1271353,34316
IDN,2021-08,63281,1850,Indonesia,273523621,Asia,1334634,36166
IDN,2021-09,45028,1100,Indonesia,273523621,Asia,1379662,37266
IDN,2021-10,39793,1160,Indonesia,273523621,Asia,1419455,38426
IDN,2021-11,40729,1124,Indonesia,273523621,Asia,1460184,39550
IDN,2021-12,35901,899,Indonesia,273523621,Asia,1496085,40449
IDN,2021-13,0,0,Indonesia,273523621,Asia,1496085,40449
IDN,2021-14,70910,2081,Indonesia,273523621,Asia,1566995,42530
IDN,2021-15,37353,894,Indonesia,273523621,Asia,1604348,43424
IDN,2021-16,36846,1170,Indonesia,273523621,Asia,1641194,44594
IDN,2021-17,36070,1202,Indonesia,273523621,Asia,1677264,45796
IDN,2021-18,36420,1216,Indonesia,273523621,Asia,1713684,47012
IDN,2021-19,26066,1081,Indonesia,273523621,Asia,1739750,48093
IDN,2021-20,35470,0,Indonesia,273523621,Asia,1775220,48093
IDN,2021-21,40821,2311,Indonesia,273523621,Asia,1816041,50404
IDN,2021-22,39997,1208,Indonesia,273523621,Asia,1856038,51612
IDN,2021-23,55320,1267,Indonesia,273523621,Asia,1911358,52879
IDN,2021-24,78551,1783,Indonesia,273523621,Asia,1989909,54662
IDN,2021-25,125395,2476,Indonesia,273523621,Asia,2115304,57138
IDN,2021-26,168780,3444,Indonesia,273523621,Asia,2284084,60582
IDN,2021-27,243119,5882,Indonesia,273523621,Asia,2527203,66464
IDN,2021-28,350273,7118,Indonesia,273523621,Asia,2877476,73582
IDN,2021-29,289029,9697,Indonesia,273523621,Asia,3166505,83279
IDN,2021-30,273891,12444,Indonesia,273523621,Asia,3440396,95723
IDN,2021-31,225635,11373,Indonesia,273523621,Asia,3666031,107096
IDN,2021-32,188323,10492,Indonesia,273523621,Asia,3854354,117588
IMN,2020-13,40,0,Isle Of Man,85032,Europe,40,0
IMN,2020-14,85,1,Isle Of Man,85032,Europe,125,1
IMN,2020-15,23,1,Isle Of Man,85032,Europe,148,2
IMN,2020-16,133,4,Isle Of Man,85032,Europe,281,6
IMN,2020-17,24,12,Isle Of Man,85032,Europe,305,18
IMN,2020-18,2,4,Isle Of Man,85032,Europe,307,22
IMN,2020-19,17,1,Isle Of Man,85032,Europe,324,23
IMN,2020-20,4,1,Isle Of Man,85032,Europe,328,24
IMN,2020-21,5,0,Isle Of Man,85032,Europe,333,24
IMN,2020-22,1,0,Isle Of Man,85032,Europe,334,24
IMN,2020-23,0,0,Isle Of Man,85032,Europe,334,24
IMN,2020-24,0,0,Isle Of Man,85032,Europe,334,24
IMN,2020-25,0,0,Isle Of Man,85032,Europe,334,24
IMN,2020-26,0,0,Isle Of Man,85032,Europe,334,24
IMN,2020-27,0,0,Isle Of Man,85032,Europe,334,24
IMN,2020-28,0,0,Isle Of Man,85032,Europe,334,24
IMN,2020-29,0,0,Isle Of Man,85032,Europe,334,24
IMN,2020-30,0,0,Isle Of Man,85032,Europe,334,24
IMN,2020-31,0,0,Isle Of Man,85032,Europe,334,24
IMN,2020-32,0,0,Isle Of Man,85032,Europe,334,24
IMN,2020-33,0,0,Isle Of Man,85032,Europe,334,24
IMN,2020-34,0,0,Isle Of Man,85032,Europe,334,24
IMN,2020-35,0,0,Isle Of Man,85032,Europe,334,24
IMN,2020-36,0,0,Isle Of Man,85032,Europe,334,24
IMN,2020-37,1,0,Isle Of Man,85032,Europe,335,24
IMN,2020-38,2,0,Isle Of Man,85032,Europe,337,24
IMN,2020-39,1,0,Isle Of Man,85032,Europe,338,24
IMN,2020-40,0,0,Isle Of Man,85032,Europe,338,24
IMN,2020-41,5,0,Isle Of Man,85032,Europe,343,24
IMN,2020-42,1,0,Isle Of Man,85032,Europe,344,24
IMN,2020-43,2,0,Isle Of Man,85032,Europe,346,24
IMN,2020-44,4,0,Isle Of Man,85032,Europe,350,24
IMN,2020-45,3,1,Isle Of Man,85032,Europe,353,25
IMN,2020-46,2,0,Isle Of Man,85032,Europe,355,25
IMN,2020-47,6,0,Isle Of Man,85032,Europe,361,25
IMN,2020-48,6,0,Isle Of Man,85032,Europe,367,25
IMN,2020-49,0,0,Isle Of Man,85032,Europe,367,25
IMN,2020-50,1,0,Isle Of Man,85032,Europe,368,25
IMN,2020-51,3,0,Isle Of Man,85032,Europe,371,25
IMN,2020-52,1,0,Isle Of Man,85032,Europe,372,25
IMN,2020-53,0,0,Isle Of Man,85032,Europe,372,25
IMN,2021-01,6,0,Isle Of Man,85032,Europe,378,25
IMN,2021-02,23,0,Isle Of Man,85032,Europe,401,25
IMN,2021-03,29,0,Isle Of Man,85032,Europe,430,25
IMN,2021-04,0,0,Isle Of Man,85032,Europe,430,25
IMN,2021-05,3,0,Isle Of Man,85032,Europe,433,25
IMN,2021-06,1,0,Isle Of Man,85032,Europe,434,25
IMN,2021-07,20,0,Isle Of Man,85032,Europe,454,25
IMN,2021-08,30,0,Isle Of Man,85032,Europe,484,25
IMN,2021-09,379,0,Isle Of Man,85032,Europe,863,25
IMN,2021-10,441,0,Isle Of Man,85032,Europe,1304,25
IMN,2021-11,197,1,Isle Of Man,85032,Europe,1501,26
IMN,2021-12,63,0,Isle Of Man,85032,Europe,1564,26
IMN,2021-13,5,3,Isle Of Man,85032,Europe,1569,29
IMN,2021-14,4,0,Isle Of Man,85032,Europe,1573,29
IMN,2021-15,2,0,Isle Of Man,85032,Europe,1575,29
IMN,2021-16,10,0,Isle Of Man,85032,Europe,1585,29
IMN,2021-17,3,0,Isle Of Man,85032,Europe,1588,29
IMN,2021-18,0,0,Isle Of Man,85032,Europe,1588,29
IMN,2021-19,1,0,Isle Of Man,85032,Europe,1589,29
IMN,2021-20,0,0,Isle Of Man,85032,Europe,1589,29
IMN,2021-21,2,0,Isle Of Man,85032,Europe,1591,29
IMN,2021-22,6,0,Isle Of Man,85032,Europe,1597,29
IMN,2021-23,1,0,Isle Of Man,85032,Europe,1598,29
IMN,2021-24,0,0,Isle Of Man,85032,Europe,1598,29
IMN,2021-25,11,0,Isle Of Man,85032,Europe,1609,29
IMN,2021-26,35,0,Isle Of Man,85032,Europe,1644,29
IMN,2021-27,67,0,Isle Of Man,85032,Europe,1711,29
IMN,2021-28,837,0,Isle Of Man,85032,Europe,2548,29
IMN,2021-29,1644,0,Isle Of Man,85032,Europe,4192,29
IMN,2021-30,719,0,Isle Of Man,85032,Europe,4911,29
IMN,2021-31,674,0,Isle Of Man,85032,Europe,5585,29
IMN,2021-32,426,0,Isle Of Man,85032,Europe,6011,29
IND,2020-02,0,0,India,1380004385,Asia,0,0
IND,2020-03,0,0,India,1380004385,Asia,0,0
IND,2020-04,0,0,India,1380004385,Asia,0,0
IND,2020-05,2,0,India,1380004385,Asia,2,0
IND,2020-06,1,0,India,1380004385,Asia,3,0
IND,2020-07,0,0,India,1380004385,Asia,3,0
IND,2020-08,0,0,India,1380004385,Asia,3,0
IND,2020-09,0,0,India,1380004385,Asia,3,0
IND,2020-10,31,0,India,1380004385,Asia,34,0
IND,2020-11,59,2,India,1380004385,Asia,93,2
IND,2020-12,346,5,India,1380004385,Asia,439,7
IND,2020-13,632,22,India,1380004385,Asia,1071,29
IND,2020-14,2996,80,India,1380004385,Asia,4067,109
IND,2020-15,5085,199,India,1380004385,Asia,9152,308
IND,2020-16,8113,235,India,1380004385,Asia,17265,543
IND,2020-17,10627,329,India,1380004385,Asia,27892,872
IND,2020-18,14641,501,India,1380004385,Asia,42533,1373
IND,2020-19,24619,833,India,1380004385,Asia,67152,2206
IND,2020-20,29017,823,India,1380004385,Asia,96169,3029
IND,2020-21,42676,992,India,1380004385,Asia,138845,4021
IND,2020-22,51690,1373,India,1380004385,Asia,190535,5394
IND,2020-23,66076,1741,India,1380004385,Asia,256611,7135
IND,2020-24,75813,2385,India,1380004385,Asia,332424,9520
IND,2020-25,92858,4179,India,1380004385,Asia,425282,13699
IND,2020-26,123036,2776,India,1380004385,Asia,548318,16475
IND,2020-27,149095,3218,India,1380004385,Asia,697413,19693
IND,2020-28,180841,3481,India,1380004385,Asia,878254,23174
IND,2020-29,239789,4323,India,1380004385,Asia,1118043,27497
IND,2020-30,317410,5274,India,1380004385,Asia,1435453,32771
IND,2020-31,368242,5364,India,1380004385,Asia,1803695,38135
IND,2020-32,411379,6251,India,1380004385,Asia,2215074,44386
IND,2020-33,432589,6535,India,1380004385,Asia,2647663,50921
IND,2020-34,458685,6621,India,1380004385,Asia,3106348,57542
IND,2020-35,514897,6927,India,1380004385,Asia,3621245,64469
IND,2020-36,583368,7173,India,1380004385,Asia,4204613,71642
IND,2020-37,641814,8080,India,1380004385,Asia,4846427,79722
IND,2020-38,641153,8160,India,1380004385,Asia,5487580,87882
IND,2020-39,587122,7660,India,1380004385,Asia,6074702,95542
IND,2020-40,549113,7143,India,1380004385,Asia,6623815,102685
IND,2020-41,496723,6465,India,1380004385,Asia,7120538,109150
IND,2020-42,429735,5460,India,1380004385,Asia,7550273,114610
IND,2020-43,359686,4404,India,1380004385,Asia,7909959,119014
IND,2020-44,319354,3593,India,1380004385,Asia,8229313,122607
IND,2020-45,324344,4004,India,1380004385,Asia,8553657,126611
IND,2020-46,291470,3459,India,1380004385,Asia,8845127,130070
IND,2020-47,294738,3668,India,1380004385,Asia,9139865,133738
IND,2020-48,291826,3401,India,1380004385,Asia,9431691,137139
IND,2020-49,245512,3434,India,1380004385,Asia,9677203,140573
IND,2020-50,206897,2782,India,1380004385,Asia,9884100,143355
IND,2020-51,171460,2455,India,1380004385,Asia,10055560,145810
IND,2020-52,152311,2091,India,1380004385,Asia,10207871,147901
IND,2020-53,132598,1748,India,1380004385,Asia,10340469,149649
IND,2021-01,126126,1511,India,1380004385,Asia,10466595,151160
IND,2021-02,105178,1259,India,1380004385,Asia,10571773,152419
IND,2021-03,95963,1051,India,1380004385,Asia,10667736,153470
IND,2021-04,89874,922,India,1380004385,Asia,10757610,154392
IND,2021-05,80584,688,India,1380004385,Asia,10838194,155080
IND,2021-06,78395,652,India,1380004385,Asia,10916589,155732
IND,2021-07,89261,653,India,1380004385,Asia,11005850,156385
IND,2021-08,106391,772,India,1380004385,Asia,11112241,157157
IND,2021-09,117157,696,India,1380004385,Asia,11229398,157853
IND,2021-10,155941,872,India,1380004385,Asia,11385339,158725
IND,2021-11,260742,1242,India,1380004385,Asia,11646081,159967
IND,2021-12,393563,1876,India,1380004385,Asia,12039644,161843
IND,2021-13,549423,3258,India,1380004385,Asia,12589067,165101
IND,2021-14,938650,5078,India,1380004385,Asia,13527717,170179
IND,2021-15,1534202,8590,India,1380004385,Asia,15061919,178769
IND,2021-16,2056121,16354,India,1380004385,Asia,17118040,195123
IND,2021-17,2807564,23836,India,1380004385,Asia,19925604,218959
IND,2021-18,2736971,27157,India,1380004385,Asia,22662575,246116
IND,2021-19,2302888,28274,India,1380004385,Asia,24965463,274390
IND,2021-20,1786984,29330,India,1380004385,Asia,26752447,303720
IND,2021-21,1295087,25380,India,1380004385,Asia,28047534,329100
IND,2021-22,862441,20086,India,1380004385,Asia,28909975,349186
IND,2021-23,600435,25119,India,1380004385,Asia,29510410,374305
IND,2021-24,424811,13830,India,1380004385,Asia,29935221,388135
IND,2021-25,344110,8595,India,1380004385,Asia,30279331,396730
IND,2021-26,305898,5998,India,1380004385,Asia,30585229,402728
IND,2021-27,289147,6036,India,1380004385,Asia,30874376,408764
IND,2021-28,269853,5344,India,1380004385,Asia,31144229,414108
IND,2021-29,267033,6859,India,1380004385,Asia,31411262,420967
IND,2021-30,284696,3806,India,1380004385,Asia,31695958,424773
IND,2021-31,273996,3536,India,1380004385,Asia,31969954,428309
IND,2021-32,255559,3333,India,1380004385,Asia,32225513,431642
IRL,2020-02,0,0,Ireland,4964440,Europe,0,0
IRL,2020-03,0,0,Ireland,4964440,Europe,0,0
IRL,2020-04,0,0,Ireland,4964440,Europe,0,0
IRL,2020-05,0,0,Ireland,4964440,Europe,0,0
IRL,2020-06,0,0,Ireland,4964440,Europe,0,0
IRL,2020-07,0,0,Ireland,4964440,Europe,0,0
IRL,2020-08,0,0,Ireland,4964440,Europe,0,0
IRL,2020-09,1,0,Ireland,4964440,Europe,1,0
IRL,2020-10,20,0,Ireland,4964440,Europe,21,0
IRL,2020-11,148,2,Ireland,4964440,Europe,169,2
IRL,2020-12,737,2,Ireland,4964440,Europe,906,4
IRL,2020-13,1709,42,Ireland,4964440,Europe,2615,46
IRL,2020-14,2496,112,Ireland,4964440,Europe,5111,158
IRL,2020-15,4544,176,Ireland,4964440,Europe,9655,334
IRL,2020-16,5596,276,Ireland,4964440,Europe,15251,610
IRL,2020-17,4011,477,Ireland,4964440,Europe,19262,1087
IRL,2020-18,2244,216,Ireland,4964440,Europe,21506,1303
IRL,2020-19,1490,155,Ireland,4964440,Europe,22996,1458
IRL,2020-20,1116,85,Ireland,4964440,Europe,24112,1543
IRL,2020-21,527,63,Ireland,4964440,Europe,24639,1606
IRL,2020-22,351,44,Ireland,4964440,Europe,24990,1650
IRL,2020-23,211,29,Ireland,4964440,Europe,25201,1679
IRL,2020-24,102,27,Ireland,4964440,Europe,25303,1706
IRL,2020-25,76,9,Ireland,4964440,Europe,25379,1715
IRL,2020-26,60,20,Ireland,4964440,Europe,25439,1735
IRL,2020-27,88,6,Ireland,4964440,Europe,25527,1741
IRL,2020-28,101,5,Ireland,4964440,Europe,25628,1746
IRL,2020-29,132,7,Ireland,4964440,Europe,25760,1753
IRL,2020-30,121,10,Ireland,4964440,Europe,25881,1763
IRL,2020-31,281,0,Ireland,4964440,Europe,26162,1763
IRL,2020-32,550,9,Ireland,4964440,Europe,26712,1772
IRL,2020-33,545,2,Ireland,4964440,Europe,27257,1774
IRL,2020-34,712,3,Ireland,4964440,Europe,27969,1777
IRL,2020-35,791,0,Ireland,4964440,Europe,28760,1777
IRL,2020-36,912,0,Ireland,4964440,Europe,29672,1777
IRL,2020-37,1313,7,Ireland,4964440,Europe,30985,1784
IRL,2020-38,1948,8,Ireland,4964440,Europe,32933,1792
IRL,2020-39,2057,10,Ireland,4964440,Europe,34990,1802
IRL,2020-40,3042,8,Ireland,4964440,Europe,38032,1810
IRL,2020-41,4496,16,Ireland,4964440,Europe,42528,1826
IRL,2020-42,7434,26,Ireland,4964440,Europe,49962,1852
IRL,2020-43,7166,30,Ireland,4964440,Europe,57128,1882
IRL,2020-44,4874,33,Ireland,4964440,Europe,62002,1915
IRL,2020-45,3392,32,Ireland,4964440,Europe,65394,1947
IRL,2020-46,2509,32,Ireland,4964440,Europe,67903,1979
IRL,2020-47,2558,43,Ireland,4964440,Europe,70461,2022
IRL,2020-48,1780,30,Ireland,4964440,Europe,72241,2052
IRL,2020-49,2005,45,Ireland,4964440,Europe,74246,2097
IRL,2020-50,1939,27,Ireland,4964440,Europe,76185,2124
IRL,2020-51,3357,34,Ireland,4964440,Europe,79542,2158
IRL,2020-52,6587,46,Ireland,4964440,Europe,86129,2204
IRL,2020-53,15758,55,Ireland,4964440,Europe,101887,2259
IRL,2021-01,45726,85,Ireland,4964440,Europe,147613,2344
IRL,2021-02,25113,264,Ireland,4964440,Europe,172726,2608
IRL,2021-03,14828,362,Ireland,4964440,Europe,187554,2970
IRL,2021-04,8993,337,Ireland,4964440,Europe,196547,3307
IRL,2021-05,7021,379,Ireland,4964440,Europe,203568,3686
IRL,2021-06,6014,262,Ireland,4964440,Europe,209582,3948
IRL,2021-07,5475,188,Ireland,4964440,Europe,215057,4136
IRL,2021-08,4535,183,Ireland,4964440,Europe,219592,4319
IRL,2021-09,3627,103,Ireland,4964440,Europe,223219,4422
IRL,2021-10,3522,112,Ireland,4964440,Europe,226741,4534
IRL,2021-11,3858,53,Ireland,4964440,Europe,230599,4587
IRL,2021-12,3942,79,Ireland,4964440,Europe,234541,4666
IRL,2021-13,3607,52,Ireland,4964440,Europe,238148,4718
IRL,2021-14,2797,67,Ireland,4964440,Europe,240945,4785
IRL,2021-15,2563,51,Ireland,4964440,Europe,243508,4836
IRL,2021-16,3125,37,Ireland,4964440,Europe,246633,4873
IRL,2021-17,3205,33,Ireland,4964440,Europe,249838,4906
IRL,2021-18,2971,15,Ireland,4964440,Europe,252809,4921
IRL,2021-19,2905,20,Ireland,4964440,Europe,255714,4941
IRL,2021-20,3074,0,Ireland,4964440,Europe,258788,4941
IRL,2021-21,2855,0,Ireland,4964440,Europe,261643,4941
IRL,2021-22,2786,0,Ireland,4964440,Europe,264429,4941
IRL,2021-23,2296,0,Ireland,4964440,Europe,266725,4941
IRL,2021-24,2162,0,Ireland,4964440,Europe,268887,4941
IRL,2021-25,2352,48,Ireland,4964440,Europe,271239,4989
IRL,2021-26,3067,11,Ireland,4964440,Europe,274306,5000
IRL,2021-27,3586,6,Ireland,4964440,Europe,277892,5006
IRL,2021-28,6588,12,Ireland,4964440,Europe,284480,5018
IRL,2021-29,8516,8,Ireland,4964440,Europe,292996,5026
IRL,2021-30,9078,9,Ireland,4964440,Europe,302074,5035
IRL,2021-31,10391,9,Ireland,4964440,Europe,312465,5044
IRL,2021-32,12282,15,Ireland,4964440,Europe,324747,5059
IRN,2020-02,0,0,Iran,83992953,Asia,0,0
IRN,2020-03,0,0,Iran,83992953,Asia,0,0
IRN,2020-04,0,0,Iran,83992953,Asia,0,0
IRN,2020-05,0,0,Iran,83992953,Asia,0,0
IRN,2020-06,0,0,Iran,83992953,Asia,0,0
IRN,2020-07,0,0,Iran,83992953,Asia,0,0
IRN,2020-08,43,8,Iran,83992953,Asia,43,8
IRN,2020-09,935,46,Iran,83992953,Asia,978,54
IRN,2020-10,5588,140,Iran,83992953,Asia,6566,194
IRN,2020-11,7372,530,Iran,83992953,Asia,13938,724
IRN,2020-12,7700,961,Iran,83992953,Asia,21638,1685
IRN,2020-13,16671,955,Iran,83992953,Asia,38309,2640
IRN,2020-14,19917,963,Iran,83992953,Asia,58226,3603
IRN,2020-15,13460,871,Iran,83992953,Asia,71686,4474
IRN,2020-16,10525,644,Iran,83992953,Asia,82211,5118
IRN,2020-17,8270,592,Iran,83992953,Asia,90481,5710
IRN,2020-18,6943,493,Iran,83992953,Asia,97424,6203
IRN,2020-19,10179,437,Iran,83992953,Asia,107603,6640
IRN,2020-20,12595,348,Iran,83992953,Asia,120198,6988
IRN,2020-21,15503,429,Iran,83992953,Asia,135701,7417
IRN,2020-22,15765,380,Iran,83992953,Asia,151466,7797
IRN,2020-23,20323,484,Iran,83992953,Asia,171789,8281
IRN,2020-24,15638,556,Iran,83992953,Asia,187427,8837
IRN,2020-25,17525,786,Iran,83992953,Asia,204952,9623
IRN,2020-26,17717,885,Iran,83992953,Asia,222669,10508
IRN,2020-27,17769,1063,Iran,83992953,Asia,240438,11571
IRN,2020-28,16865,1258,Iran,83992953,Asia,257303,12829
IRN,2020-29,16485,1359,Iran,83992953,Asia,273788,14188
IRN,2020-30,17384,1512,Iran,83992953,Asia,291172,15700
IRN,2020-31,18265,1490,Iran,83992953,Asia,309437,17190
IRN,2020-32,17275,1237,Iran,83992953,Asia,326712,18427
IRN,2020-33,16491,1212,Iran,83992953,Asia,343203,19639
IRN,2020-34,15702,1004,Iran,83992953,Asia,358905,20643
IRN,2020-35,14665,819,Iran,83992953,Asia,373570,21462
IRN,2020-36,13088,831,Iran,83992953,Asia,386658,22293
IRN,2020-37,15371,864,Iran,83992953,Asia,402029,23157
IRN,2020-38,20111,1144,Iran,83992953,Asia,422140,24301
IRN,2020-39,24308,1288,Iran,83992953,Asia,446448,25589
IRN,2020-40,25324,1368,Iran,83992953,Asia,471772,26957
IRN,2020-41,28303,1587,Iran,83992953,Asia,500075,28544
IRN,2020-42,30305,1831,Iran,83992953,Asia,530380,30375
IRN,2020-43,38516,2241,Iran,83992953,Asia,568896,32616
IRN,2020-44,51595,2682,Iran,83992953,Asia,620491,35298
IRN,2020-45,61995,2993,Iran,83992953,Asia,682486,38291
IRN,2020-46,79582,3202,Iran,83992953,Asia,762068,41493
IRN,2020-47,92293,3309,Iran,83992953,Asia,854361,44802
IRN,2020-48,94388,3073,Iran,83992953,Asia,948749,47875
IRN,2020-49,91798,2435,Iran,83992953,Asia,1040547,50310
IRN,2020-50,67722,1886,Iran,83992953,Asia,1108269,52196
IRN,2020-51,43803,1252,Iran,83992953,Asia,1152072,53448
IRN,2020-52,48393,1245,Iran,83992953,Asia,1200465,54693
IRN,2020-53,42969,847,Iran,83992953,Asia,1243434,55540
IRN,2021-01,42972,631,Iran,83992953,Asia,1286406,56171
IRN,2021-02,44005,632,Iran,83992953,Asia,1330411,56803
IRN,2021-03,42566,580,Iran,83992953,Asia,1372977,57383
IRN,2021-04,45022,576,Iran,83992953,Asia,1417999,57959
IRN,2021-05,48436,510,Iran,83992953,Asia,1466435,58469
IRN,2021-06,51828,476,Iran,83992953,Asia,1518263,58945
IRN,2021-07,55749,538,Iran,83992953,Asia,1574012,59483
IRN,2021-08,57157,590,Iran,83992953,Asia,1631169,60073
IRN,2021-09,50513,521,Iran,83992953,Asia,1681682,60594
IRN,2021-10,65271,636,Iran,83992953,Asia,1746953,61230
IRN,2021-11,54112,567,Iran,83992953,Asia,1801065,61797
IRN,2021-12,45858,511,Iran,83992953,Asia,1846923,62308
IRN,2021-13,85151,852,Iran,83992953,Asia,1932074,63160
IRN,2021-14,117004,1072,Iran,83992953,Asia,2049078,64232
IRN,2021-15,188011,2500,Iran,83992953,Asia,2237089,66732
IRN,2021-16,159115,2842,Iran,83992953,Asia,2396204,69574
IRN,2021-17,119953,2516,Iran,83992953,Asia,2516157,72090
IRN,2021-18,124513,2434,Iran,83992953,Asia,2640670,74524
IRN,2021-19,99205,2109,Iran,83992953,Asia,2739875,76633
IRN,2021-20,84012,1748,Iran,83992953,Asia,2823887,78381
IRN,2021-21,69331,1360,Iran,83992953,Asia,2893218,79741
IRN,2021-22,73145,1322,Iran,83992953,Asia,2966363,81063
IRN,2021-23,54159,848,Iran,83992953,Asia,3020522,81911
IRN,2021-24,74613,1054,Iran,83992953,Asia,3095135,82965
IRN,2021-25,62848,746,Iran,83992953,Asia,3157983,83711
IRN,2021-26,83054,916,Iran,83992953,Asia,3241037,84627
IRN,2021-27,114749,1067,Iran,83992953,Asia,3355786,85694
IRN,2021-28,167477,1467,Iran,83992953,Asia,3523263,87161
IRN,2021-29,168169,1639,Iran,83992953,Asia,3691432,88800
IRN,2021-30,179576,1830,Iran,83992953,Asia,3871008,90630
IRN,2021-31,287721,3385,Iran,83992953,Asia,4158729,94015
IRN,2021-32,230356,3193,Iran,83992953,Asia,4389085,97208
IRQ,2020-02,0,0,Iraq,40222503,Asia,0,0
IRQ,2020-03,0,0,Iraq,40222503,Asia,0,0
IRQ,2020-04,0,0,Iraq,40222503,Asia,0,0
IRQ,2020-05,0,0,Iraq,40222503,Asia,0,0
IRQ,2020-06,0,0,Iraq,40222503,Asia,0,0
IRQ,2020-07,0,0,Iraq,40222503,Asia,0,0
IRQ,2020-08,0,0,Iraq,40222503,Asia,0,0
IRQ,2020-09,19,0,Iraq,40222503,Asia,19,0
IRQ,2020-10,42,6,Iraq,40222503,Asia,61,6
IRQ,2020-11,63,3,Iraq,40222503,Asia,124,9
IRQ,2020-12,109,11,Iraq,40222503,Asia,233,20
IRQ,2020-13,314,22,Iraq,40222503,Asia,547,42
IRQ,2020-14,414,19,Iraq,40222503,Asia,961,61
IRQ,2020-15,391,15,Iraq,40222503,Asia,1352,76
IRQ,2020-16,187,6,Iraq,40222503,Asia,1539,82
IRQ,2020-17,281,5,Iraq,40222503,Asia,1820,87
IRQ,2020-18,476,10,Iraq,40222503,Asia,2296,97
IRQ,2020-19,471,12,Iraq,40222503,Asia,2767,109
IRQ,2020-20,637,14,Iraq,40222503,Asia,3404,123
IRQ,2020-21,1065,37,Iraq,40222503,Asia,4469,160
IRQ,2020-22,1970,45,Iraq,40222503,Asia,6439,205
IRQ,2020-23,5927,141,Iraq,40222503,Asia,12366,346
IRQ,2020-24,7843,261,Iraq,40222503,Asia,20209,607
IRQ,2020-25,10659,493,Iraq,40222503,Asia,30868,1100
IRQ,2020-26,14534,656,Iraq,40222503,Asia,45402,1756
IRQ,2020-27,15077,717,Iraq,40222503,Asia,60479,2473
IRQ,2020-28,17027,677,Iraq,40222503,Asia,77506,3150
IRQ,2020-29,15024,631,Iraq,40222503,Asia,92530,3781
IRQ,2020-30,17502,581,Iraq,40222503,Asia,110032,4362
IRQ,2020-31,19119,506,Iraq,40222503,Asia,129151,4868
IRQ,2020-32,20964,524,Iraq,40222503,Asia,150115,5392
IRQ,2020-33,26816,468,Iraq,40222503,Asia,176931,5860
IRQ,2020-34,27410,568,Iraq,40222503,Asia,204341,6428
IRQ,2020-35,26836,531,Iraq,40222503,Asia,231177,6959
IRQ,2020-36,29193,553,Iraq,40222503,Asia,260370,7512
IRQ,2020-37,29939,502,Iraq,40222503,Asia,290309,8014
IRQ,2020-38,28726,541,Iraq,40222503,Asia,319035,8555
IRQ,2020-39,30415,435,Iraq,40222503,Asia,349450,8990
IRQ,2020-40,29691,409,Iraq,40222503,Asia,379141,9399
IRQ,2020-41,23189,453,Iraq,40222503,Asia,402330,9852
IRQ,2020-42,24304,402,Iraq,40222503,Asia,426634,10254
IRQ,2020-43,25073,369,Iraq,40222503,Asia,451707,10623
IRQ,2020-44,23581,343,Iraq,40222503,Asia,475288,10966
IRQ,2020-45,23261,361,Iraq,40222503,Asia,498549,11327
IRQ,2020-46,20603,343,Iraq,40222503,Asia,519152,11670
IRQ,2020-47,16169,288,Iraq,40222503,Asia,535321,11958
IRQ,2020-48,15114,266,Iraq,40222503,Asia,550435,12224
IRQ,2020-49,13765,208,Iraq,40222503,Asia,564200,12432
IRQ,2020-50,10434,147,Iraq,40222503,Asia,574634,12579
IRQ,2020-51,9511,118,Iraq,40222503,Asia,584145,12697
IRQ,2020-52,7452,83,Iraq,40222503,Asia,591597,12780
IRQ,2020-53,6772,64,Iraq,40222503,Asia,598369,12844
IRQ,2021-01,0,0,Iraq,40222503,Asia,598369,12844
IRQ,2021-02,9863,100,Iraq,40222503,Asia,608232,12944
IRQ,2021-03,5531,49,Iraq,40222503,Asia,613763,12993
IRQ,2021-04,5873,54,Iraq,40222503,Asia,619636,13047
IRQ,2021-05,8914,73,Iraq,40222503,Asia,628550,13120
IRQ,2021-06,15302,59,Iraq,40222503,Asia,643852,13179
IRQ,2021-07,24085,93,Iraq,40222503,Asia,667937,13272
IRQ,2021-08,27552,134,Iraq,40222503,Asia,695489,13406
IRQ,2021-09,31059,166,Iraq,40222503,Asia,726548,13572
IRQ,2021-10,31636,179,Iraq,40222503,Asia,758184,13751
IRQ,2021-11,35708,256,Iraq,40222503,Asia,793892,14007
IRQ,2021-12,38536,205,Iraq,40222503,Asia,832428,14212
IRQ,2021-13,41140,251,Iraq,40222503,Asia,873568,14463
IRQ,2021-14,51378,250,Iraq,40222503,Asia,924946,14713
IRQ,2021-15,52229,268,Iraq,40222503,Asia,977175,14981
IRQ,2021-16,60683,322,Iraq,40222503,Asia,1037858,15303
IRQ,2021-17,37072,233,Iraq,40222503,Asia,1074930,15536
IRQ,2021-18,37795,235,Iraq,40222503,Asia,1112725,15771
IRQ,2021-19,26648,185,Iraq,40222503,Asia,1139373,15956
IRQ,2021-20,28567,234,Iraq,40222503,Asia,1167940,16190
IRQ,2021-21,29142,161,Iraq,40222503,Asia,1197082,16351
IRQ,2021-22,27910,187,Iraq,40222503,Asia,1224992,16538
IRQ,2021-23,29651,167,Iraq,40222503,Asia,1254643,16705
IRQ,2021-24,38057,205,Iraq,40222503,Asia,1292700,16910
IRQ,2021-25,33000,181,Iraq,40222503,Asia,1325700,17091
IRQ,2021-26,45775,270,Iraq,40222503,Asia,1371475,17361
IRQ,2021-27,57887,187,Iraq,40222503,Asia,1429362,17548
IRQ,2021-28,62350,282,Iraq,40222503,Asia,1491712,17830
IRQ,2021-29,60936,457,Iraq,40222503,Asia,1552648,18287
IRQ,2021-30,83345,447,Iraq,40222503,Asia,1635993,18734
IRQ,2021-31,76716,469,Iraq,40222503,Asia,1712709,19203
IRQ,2021-32,63055,469,Iraq,40222503,Asia,1775764,19672
ISL,2020-02,0,0,Iceland,364134,Europe,0,0
ISL,2020-03,0,0,Iceland,364134,Europe,0,0
ISL,2020-04,0,0,Iceland,364134,Europe,0,0
ISL,2020-05,0,0,Iceland,364134,Europe,0,0
ISL,2020-06,0,0,Iceland,364134,Europe,0,0
ISL,2020-07,0,0,Iceland,364134,Europe,0,0
ISL,2020-08,0,0,Iceland,364134,Europe,0,0
ISL,2020-09,3,0,Iceland,364134,Europe,3,0
ISL,2020-10,52,0,Iceland,364134,Europe,55,0
ISL,2020-11,123,0,Iceland,364134,Europe,178,0
ISL,2020-12,390,1,Iceland,364134,Europe,568,1
ISL,2020-13,452,1,Iceland,364134,Europe,1020,2
ISL,2020-14,466,2,Iceland,364134,Europe,1486,4
ISL,2020-15,215,4,Iceland,364134,Europe,1701,8
ISL,2020-16,70,1,Iceland,364134,Europe,1771,9
ISL,2020-17,21,1,Iceland,364134,Europe,1792,10
ISL,2020-18,7,0,Iceland,364134,Europe,1799,10
ISL,2020-19,2,0,Iceland,364134,Europe,1801,10
ISL,2020-20,1,0,Iceland,364134,Europe,1802,10
ISL,2020-21,2,0,Iceland,364134,Europe,1804,10
ISL,2020-22,2,0,Iceland,364134,Europe,1806,10
ISL,2020-23,1,0,Iceland,364134,Europe,1807,10
ISL,2020-24,3,0,Iceland,364134,Europe,1810,10
ISL,2020-25,5,0,Iceland,364134,Europe,1815,10
ISL,2020-26,6,0,Iceland,364134,Europe,1821,10
ISL,2020-27,9,0,Iceland,364134,Europe,1830,10
ISL,2020-28,3,0,Iceland,364134,Europe,1833,10
ISL,2020-29,6,0,Iceland,364134,Europe,1839,10
ISL,2020-30,8,0,Iceland,364134,Europe,1847,10
ISL,2020-31,60,0,Iceland,364134,Europe,1907,10
ISL,2020-32,51,0,Iceland,364134,Europe,1958,10
ISL,2020-33,53,0,Iceland,364134,Europe,2011,10
ISL,2020-34,53,0,Iceland,364134,Europe,2064,10
ISL,2020-35,41,0,Iceland,364134,Europe,2105,10
ISL,2020-36,36,0,Iceland,364134,Europe,2141,10
ISL,2020-37,24,0,Iceland,364134,Europe,2165,10
ISL,2020-38,181,0,Iceland,364134,Europe,2346,10
ISL,2020-39,277,0,Iceland,364134,Europe,2623,10
ISL,2020-40,298,0,Iceland,364134,Europe,2921,10
ISL,2020-41,605,0,Iceland,364134,Europe,3526,10
ISL,2020-42,529,1,Iceland,364134,Europe,4055,11
ISL,2020-43,393,0,Iceland,364134,Europe,4448,11
ISL,2020-44,442,1,Iceland,364134,Europe,4890,12
ISL,2020-45,188,8,Iceland,364134,Europe,5078,20
ISL,2020-46,111,5,Iceland,364134,Europe,5189,25
ISL,2020-47,88,1,Iceland,364134,Europe,5277,26
ISL,2020-48,104,0,Iceland,364134,Europe,5381,26
ISL,2020-49,101,1,Iceland,364134,Europe,5482,27
ISL,2020-50,75,1,Iceland,364134,Europe,5557,28
ISL,2020-51,85,0,Iceland,364134,Europe,5642,28
ISL,2020-52,84,0,Iceland,364134,Europe,5726,28
ISL,2020-53,28,1,Iceland,364134,Europe,5754,29
ISL,2021-01,144,0,Iceland,364134,Europe,5898,29
ISL,2021-02,72,0,Iceland,364134,Europe,5970,29
ISL,2021-03,20,0,Iceland,364134,Europe,5990,29
ISL,2021-04,19,0,Iceland,364134,Europe,6009,29
ISL,2021-05,11,0,Iceland,364134,Europe,6020,29
ISL,2021-06,19,0,Iceland,364134,Europe,6039,29
ISL,2021-07,10,0,Iceland,364134,Europe,6049,29
ISL,2021-08,5,0,Iceland,364134,Europe,6054,29
ISL,2021-09,10,0,Iceland,364134,Europe,6064,29
ISL,2021-10,19,0,Iceland,364134,Europe,6083,29
ISL,2021-11,36,0,Iceland,364134,Europe,6119,29
ISL,2021-12,64,0,Iceland,364134,Europe,6183,29
ISL,2021-13,42,0,Iceland,364134,Europe,6225,29
ISL,2021-14,42,0,Iceland,364134,Europe,6267,29
ISL,2021-15,62,0,Iceland,364134,Europe,6329,29
ISL,2021-16,100,0,Iceland,364134,Europe,6429,29
ISL,2021-17,54,0,Iceland,364134,Europe,6483,29
ISL,2021-18,36,0,Iceland,364134,Europe,6519,29
ISL,2021-19,29,0,Iceland,364134,Europe,6548,29
ISL,2021-20,8,0,Iceland,364134,Europe,6556,29
ISL,2021-21,30,1,Iceland,364134,Europe,6586,30
ISL,2021-22,26,0,Iceland,364134,Europe,6612,30
ISL,2021-23,9,0,Iceland,364134,Europe,6621,30
ISL,2021-24,9,0,Iceland,364134,Europe,6630,30
ISL,2021-25,19,0,Iceland,364134,Europe,6649,30
ISL,2021-26,15,0,Iceland,364134,Europe,6664,30
ISL,2021-27,11,0,Iceland,364134,Europe,6675,30
ISL,2021-28,43,0,Iceland,364134,Europe,6718,30
ISL,2021-29,586,0,Iceland,364134,Europe,7304,30
ISL,2021-30,818,0,Iceland,364134,Europe,8122,30
ISL,2021-31,778,0,Iceland,364134,Europe,8900,30
ISL,2021-32,678,0,Iceland,364134,Europe,9578,30
ISR,2020-02,0,0,Israel,8655541,Asia,0,0
ISR,2020-03,0,0,Israel,8655541,Asia,0,0
ISR,2020-04,0,0,Israel,8655541,Asia,0,0
ISR,2020-05,0,0,Israel,8655541,Asia,0,0
ISR,2020-06,0,0,Israel,8655541,Asia,0,0
ISR,2020-07,0,0,Israel,8655541,Asia,0,0
ISR,2020-08,2,0,Israel,8655541,Asia,2,0
ISR,2020-09,8,0,Israel,8655541,Asia,10,0
ISR,2020-10,29,0,Israel,8655541,Asia,39,0
ISR,2020-11,211,0,Israel,8655541,Asia,250,0
ISR,2020-12,821,1,Israel,8655541,Asia,1071,1
ISR,2020-13,3176,14,Israel,8655541,Asia,4247,15
ISR,2020-14,4183,34,Israel,8655541,Asia,8430,49
ISR,2020-15,2715,54,Israel,8655541,Asia,11145,103
ISR,2020-16,2346,69,Israel,8655541,Asia,13491,172
ISR,2020-17,1907,27,Israel,8655541,Asia,15398,199
ISR,2020-18,810,33,Israel,8655541,Asia,16208,232
ISR,2020-19,269,20,Israel,8655541,Asia,16477,252
ISR,2020-20,140,20,Israel,8655541,Asia,16617,272
ISR,2020-21,103,8,Israel,8655541,Asia,16720,280
ISR,2020-22,351,5,Israel,8655541,Asia,17071,285
ISR,2020-23,844,13,Israel,8655541,Asia,17915,298
ISR,2020-24,1206,4,Israel,8655541,Asia,19121,302
ISR,2020-25,1657,4,Israel,8655541,Asia,20778,306
ISR,2020-26,2977,12,Israel,8655541,Asia,23755,318
ISR,2020-27,6203,13,Israel,8655541,Asia,29958,331
ISR,2020-28,8712,31,Israel,8655541,Asia,38670,362
ISR,2020-29,11619,47,Israel,8655541,Asia,50289,409
ISR,2020-30,11667,61,Israel,8655541,Asia,61956,470
ISR,2020-31,11069,66,Israel,8655541,Asia,73025,536
ISR,2020-32,9977,64,Israel,8655541,Asia,83002,600
ISR,2020-33,9678,85,Israel,8655541,Asia,92680,685
ISR,2020-34,10471,149,Israel,8655541,Asia,103151,834
ISR,2020-35,10869,85,Israel,8655541,Asia,114020,919
ISR,2020-36,16624,100,Israel,8655541,Asia,130644,1019
ISR,2020-37,25952,100,Israel,8655541,Asia,156596,1119
ISR,2020-38,31831,137,Israel,8655541,Asia,188427,1256
ISR,2020-39,42599,210,Israel,8655541,Asia,231026,1466
ISR,2020-40,37149,253,Israel,8655541,Asia,268175,1719
ISR,2020-41,23653,264,Israel,8655541,Asia,291828,1983
ISR,2020-42,12018,226,Israel,8655541,Asia,303846,2209
ISR,2020-43,6302,188,Israel,8655541,Asia,310148,2397
ISR,2020-44,4983,157,Israel,8655541,Asia,315131,2554
ISR,2020-45,4431,120,Israel,8655541,Asia,319562,2674
ISR,2020-46,4573,58,Israel,8655541,Asia,324135,2732
ISR,2020-47,5268,74,Israel,8655541,Asia,329403,2806
ISR,2020-48,6577,58,Israel,8655541,Asia,335980,2864
ISR,2020-49,9221,53,Israel,8655541,Asia,345201,2917
ISR,2020-50,12658,82,Israel,8655541,Asia,357859,2999
ISR,2020-51,18500,102,Israel,8655541,Asia,376359,3101
ISR,2020-52,27627,139,Israel,8655541,Asia,403986,3240
ISR,2020-53,38201,193,Israel,8655541,Asia,442187,3433
ISR,2021-01,52876,256,Israel,8655541,Asia,495063,3689
ISR,2021-02,56626,316,Israel,8655541,Asia,551689,4005
ISR,2021-03,49380,432,Israel,8655541,Asia,601069,4437
ISR,2021-04,45208,359,Israel,8655541,Asia,646277,4796
ISR,2021-05,54202,333,Israel,8655541,Asia,700479,5129
ISR,2021-06,27006,274,Israel,8655541,Asia,727485,5403
ISR,2021-07,24913,182,Israel,8655541,Asia,752398,5585
ISR,2021-08,25774,173,Israel,8655541,Asia,778172,5758
ISR,2021-09,25088,141,Israel,8655541,Asia,803260,5899
ISR,2021-10,16727,126,Israel,8655541,Asia,819987,6025
ISR,2021-11,8252,73,Israel,8655541,Asia,828239,6098
ISR,2021-12,3773,96,Israel,8655541,Asia,832012,6194
ISR,2021-13,2434,49,Israel,8655541,Asia,834446,6243
ISR,2021-14,1712,61,Israel,8655541,Asia,836158,6304
ISR,2021-15,1002,34,Israel,8655541,Asia,837160,6338
ISR,2021-16,924,14,Israel,8655541,Asia,838084,6352
ISR,2021-17,492,14,Israel,8655541,Asia,838576,6366
ISR,2021-18,0,11,Israel,8655541,Asia,838576,6377
ISR,2021-19,543,5,Israel,8655541,Asia,839119,6382
ISR,2021-20,200,22,Israel,8655541,Asia,839319,6404
ISR,2021-21,153,7,Israel,8655541,Asia,839472,6411
ISR,2021-22,105,7,Israel,8655541,Asia,839577,6418
ISR,2021-23,97,9,Israel,8655541,Asia,839674,6427
ISR,2021-24,266,0,Israel,8655541,Asia,839940,6427
ISR,2021-25,1055,1,Israel,8655541,Asia,840995,6428
ISR,2021-26,2128,0,Israel,8655541,Asia,843123,6428
ISR,2021-27,3204,10,Israel,8655541,Asia,846327,6438
ISR,2021-28,5849,12,Israel,8655541,Asia,852176,6450
ISR,2021-29,9340,11,Israel,8655541,Asia,861516,6461
ISR,2021-30,15800,16,Israel,8655541,Asia,877316,6477
ISR,2021-31,29089,82,Israel,8655541,Asia,906405,6559
ISR,2021-32,35834,109,Israel,8655541,Asia,942239,6668
ITA,2020-02,0,0,Italy,59641488,Europe,0,0
ITA,2020-03,0,0,Italy,59641488,Europe,0,0
ITA,2020-04,0,0,Italy,59641488,Europe,0,0
ITA,2020-05,3,0,Italy,59641488,Europe,3,0
ITA,2020-06,0,0,Italy,59641488,Europe,3,0
ITA,2020-07,0,0,Italy,59641488,Europe,3,0
ITA,2020-08,129,2,Italy,59641488,Europe,132,2
ITA,2020-09,1557,33,Italy,59641488,Europe,1689,35
ITA,2020-10,5686,331,Italy,59641488,Europe,7375,366
ITA,2020-11,16605,1445,Italy,59641488,Europe,23980,1811
ITA,2020-12,35158,3665,Italy,59641488,Europe,59138,5476
ITA,2020-13,38551,5305,Italy,59641488,Europe,97689,10781
ITA,2020-14,31259,5108,Italy,59641488,Europe,128948,15889
ITA,2020-15,27415,4012,Italy,59641488,Europe,156363,19901
ITA,2020-16,22609,3759,Italy,59641488,Europe,178972,23660
ITA,2020-17,18703,2984,Italy,59641488,Europe,197675,26644
ITA,2020-18,13042,2240,Italy,59641488,Europe,210717,28884
ITA,2020-19,8353,1676,Italy,59641488,Europe,219070,30560
ITA,2020-20,6365,1348,Italy,59641488,Europe,225435,31908
ITA,2020-21,4423,877,Italy,59641488,Europe,229858,32785
ITA,2020-22,3161,630,Italy,59641488,Europe,233019,33415
ITA,2020-23,1979,484,Italy,59641488,Europe,234998,33899
ITA,2020-24,1991,446,Italy,59641488,Europe,236989,34345
ITA,2020-25,1510,289,Italy,59641488,Europe,238499,34634
ITA,2020-26,1811,104,Italy,59641488,Europe,240310,34738
ITA,2020-27,1301,123,Italy,59641488,Europe,241611,34861
ITA,2020-28,1450,93,Italy,59641488,Europe,243061,34954
ITA,2020-29,1373,91,Italy,59641488,Europe,244434,35045
ITA,2020-30,1684,62,Italy,59641488,Europe,246118,35107
ITA,2020-31,1952,47,Italy,59641488,Europe,248070,35154
ITA,2020-32,2496,51,Italy,59641488,Europe,250566,35205
ITA,2020-33,3349,191,Italy,59641488,Europe,253915,35396
ITA,2020-34,5430,41,Italy,59641488,Europe,259345,35437
ITA,2020-35,8873,40,Italy,59641488,Europe,268218,35477
ITA,2020-36,9416,64,Italy,59641488,Europe,277634,35541
ITA,2020-37,10119,69,Italy,59641488,Europe,287753,35610
ITA,2020-38,10403,97,Italy,59641488,Europe,298156,35707
ITA,2020-39,11714,128,Italy,59641488,Europe,309870,35835
ITA,2020-40,15459,151,Italy,59641488,Europe,325329,35986
ITA,2020-41,29621,180,Italy,59641488,Europe,354950,36166
ITA,2020-42,59291,377,Italy,59641488,Europe,414241,36543
ITA,2020-43,111541,795,Italy,59641488,Europe,525782,37338
ITA,2020-44,183553,1488,Italy,59641488,Europe,709335,38826
ITA,2020-45,225769,2568,Italy,59641488,Europe,935104,41394
ITA,2020-46,243425,3835,Italy,59641488,Europe,1178529,45229
ITA,2020-47,230339,4594,Italy,59641488,Europe,1408868,49823
ITA,2020-48,176310,5081,Italy,59641488,Europe,1585178,54904
ITA,2020-49,143700,5174,Italy,59641488,Europe,1728878,60078
ITA,2020-50,114834,4442,Italy,59641488,Europe,1843712,64520
ITA,2020-51,109473,4279,Italy,59641488,Europe,1953185,68799
ITA,2020-52,94511,3126,Italy,59641488,Europe,2047696,71925
ITA,2020-53,107750,3407,Italy,59641488,Europe,2155446,75332
ITA,2021-01,121045,3423,Italy,59641488,Europe,2276491,78755
ITA,2021-02,104786,3422,Italy,59641488,Europe,2381277,82177
ITA,2021-03,85536,3284,Italy,59641488,Europe,2466813,85461
ITA,2021-04,86219,3055,Italy,59641488,Europe,2553032,88516
ITA,2021-05,83706,2757,Italy,59641488,Europe,2636738,91273
ITA,2021-06,85141,2304,Italy,59641488,Europe,2721879,93577
ITA,2021-07,87367,2141,Italy,59641488,Europe,2809246,95718
ITA,2021-08,116019,1981,Italy,59641488,Europe,2925265,97699
ITA,2021-09,142221,2086,Italy,59641488,Europe,3067486,99785
ITA,2021-10,155656,2360,Italy,59641488,Europe,3223142,102145
ITA,2021-11,153234,2797,Italy,59641488,Europe,3376376,104942
ITA,2021-12,155681,2991,Italy,59641488,Europe,3532057,107933
ITA,2021-13,136207,3097,Italy,59641488,Europe,3668264,111030
ITA,2021-14,101550,3224,Italy,59641488,Europe,3769814,114254
ITA,2021-15,100317,2673,Italy,59641488,Europe,3870131,116927
ITA,2021-16,92543,2311,Italy,59641488,Europe,3962674,119238
ITA,2021-17,82088,1939,Italy,59641488,Europe,4044762,121177
ITA,2021-18,66448,1656,Italy,59641488,Europe,4111210,122833
ITA,2021-19,47912,1323,Italy,59641488,Europe,4159122,124156
ITA,2021-20,33061,1069,Italy,59641488,Europe,4192183,125225
ITA,2021-21,23820,821,Italy,59641488,Europe,4216003,126046
ITA,2021-22,16425,477,Italy,59641488,Europe,4232428,126523
ITA,2021-23,12444,479,Italy,59641488,Europe,4244872,127002
ITA,2021-24,8104,268,Italy,59641488,Europe,4252976,127270
ITA,2021-25,5093,202,Italy,59641488,Europe,4258069,127472
ITA,2021-26,5248,177,Italy,59641488,Europe,4263317,127649
ITA,2021-27,7959,126,Italy,59641488,Europe,4271276,127775
ITA,2021-28,16182,92,Italy,59641488,Europe,4287458,127867
ITA,2021-29,29957,82,Italy,59641488,Europe,4317415,127949
ITA,2021-30,37933,119,Italy,59641488,Europe,4355348,128068
ITA,2021-31,41069,152,Italy,59641488,Europe,4396417,128220
ITA,2021-32,44252,212,Italy,59641488,Europe,4440669,128432
JAM,2020-12,9,0,Jamaica,2961161,America,9,0
JAM,2020-13,15,1,Jamaica,2961161,America,24,1
JAM,2020-14,24,2,Jamaica,2961161,America,48,3
JAM,2020-15,14,1,Jamaica,2961161,America,62,4
JAM,2020-16,124,1,Jamaica,2961161,America,186,5
JAM,2020-17,154,2,Jamaica,2961161,America,340,7
JAM,2020-18,119,2,Jamaica,2961161,America,459,9
JAM,2020-19,33,0,Jamaica,2961161,America,492,9
JAM,2020-20,18,0,Jamaica,2961161,America,510,9
JAM,2020-21,32,0,Jamaica,2961161,America,542,9
JAM,2020-22,34,0,Jamaica,2961161,America,576,9
JAM,2020-23,12,1,Jamaica,2961161,America,588,10
JAM,2020-24,19,0,Jamaica,2961161,America,607,10
JAM,2020-25,42,0,Jamaica,2961161,America,649,10
JAM,2020-26,37,0,Jamaica,2961161,America,686,10
JAM,2020-27,36,0,Jamaica,2961161,America,722,10
JAM,2020-28,26,0,Jamaica,2961161,America,748,10
JAM,2020-29,32,0,Jamaica,2961161,America,780,10
JAM,2020-30,52,0,Jamaica,2961161,America,832,10
JAM,2020-31,52,2,Jamaica,2961161,America,884,12
JAM,2020-32,129,2,Jamaica,2961161,America,1013,14
JAM,2020-33,90,0,Jamaica,2961161,America,1103,14
JAM,2020-34,416,2,Jamaica,2961161,America,1519,16
JAM,2020-35,828,5,Jamaica,2961161,America,2347,21
JAM,2020-36,746,12,Jamaica,2961161,America,3093,33
JAM,2020-37,668,9,Jamaica,2961161,America,3761,42
JAM,2020-38,1217,25,Jamaica,2961161,America,4978,67
JAM,2020-39,1005,22,Jamaica,2961161,America,5983,89
JAM,2020-40,902,31,Jamaica,2961161,America,6885,120
JAM,2020-41,823,19,Jamaica,2961161,America,7708,139
JAM,2020-42,556,32,Jamaica,2961161,America,8264,171
JAM,2020-43,440,17,Jamaica,2961161,America,8704,188
JAM,2020-44,417,21,Jamaica,2961161,America,9121,209
JAM,2020-45,375,12,Jamaica,2961161,America,9496,221
JAM,2020-46,378,10,Jamaica,2961161,America,9874,231
JAM,2020-47,400,7,Jamaica,2961161,America,10274,238
JAM,2020-48,425,18,Jamaica,2961161,America,10699,256
JAM,2020-49,411,9,Jamaica,2961161,America,11110,265
JAM,2020-50,590,8,Jamaica,2961161,America,11700,273
JAM,2020-51,579,13,Jamaica,2961161,America,12279,286
JAM,2020-52,443,12,Jamaica,2961161,America,12722,298
JAM,2020-53,317,6,Jamaica,2961161,America,13039,304
JAM,2021-01,588,9,Jamaica,2961161,America,13627,313
JAM,2021-02,637,13,Jamaica,2961161,America,14264,326
JAM,2021-03,738,12,Jamaica,2961161,America,15002,338
JAM,2021-04,766,14,Jamaica,2961161,America,15768,352
JAM,2021-05,1520,6,Jamaica,2961161,America,17288,358
JAM,2021-06,2007,20,Jamaica,2961161,America,19295,378
JAM,2021-07,2374,21,Jamaica,2961161,America,21669,399
JAM,2021-08,1920,26,Jamaica,2961161,America,23589,425
JAM,2021-09,3305,29,Jamaica,2961161,America,26894,454
JAM,2021-10,4401,38,Jamaica,2961161,America,31295,492
JAM,2021-11,4591,44,Jamaica,2961161,America,35886,536
JAM,2021-12,2618,50,Jamaica,2961161,America,38504,586
JAM,2021-13,2499,32,Jamaica,2961161,America,41003,618
JAM,2021-14,1750,58,Jamaica,2961161,America,42753,676
JAM,2021-15,1373,51,Jamaica,2961161,America,44126,727
JAM,2021-16,1009,34,Jamaica,2961161,America,45135,761
JAM,2021-17,894,29,Jamaica,2961161,America,46029,790
JAM,2021-18,743,19,Jamaica,2961161,America,46772,809
JAM,2021-19,614,54,Jamaica,2961161,America,47386,863
JAM,2021-20,658,62,Jamaica,2961161,America,48044,925
JAM,2021-21,503,23,Jamaica,2961161,America,48547,948
JAM,2021-22,426,23,Jamaica,2961161,America,48973,971
JAM,2021-23,373,40,Jamaica,2961161,America,49346,1011
JAM,2021-24,356,23,Jamaica,2961161,America,49702,1034
JAM,2021-25,342,27,Jamaica,2961161,America,50044,1061
JAM,2021-26,335,33,Jamaica,2961161,America,50379,1094
JAM,2021-27,368,37,Jamaica,2961161,America,50747,1131
JAM,2021-28,463,26,Jamaica,2961161,America,51210,1157
JAM,2021-29,869,21,Jamaica,2961161,America,52079,1178
JAM,2021-30,1339,22,Jamaica,2961161,America,53418,1200
JAM,2021-31,1712,31,Jamaica,2961161,America,55130,1231
JAM,2021-32,3318,80,Jamaica,2961161,America,58448,1311
JEY,2020-13,48,2,Jersey,107796,Europe,48,2
JEY,2020-14,92,1,Jersey,107796,Europe,140,3
JEY,2020-15,58,1,Jersey,107796,Europe,198,4
JEY,2020-16,36,8,Jersey,107796,Europe,234,12
JEY,2020-17,32,7,Jersey,107796,Europe,266,19
JEY,2020-18,11,5,Jersey,107796,Europe,277,24
JEY,2020-19,2,1,Jersey,107796,Europe,279,25
JEY,2020-20,8,2,Jersey,107796,Europe,287,27
JEY,2020-21,4,2,Jersey,107796,Europe,291,29
JEY,2020-22,2,0,Jersey,107796,Europe,293,29
JEY,2020-23,3,1,Jersey,107796,Europe,296,30
JEY,2020-24,2,0,Jersey,107796,Europe,298,30
JEY,2020-25,5,1,Jersey,107796,Europe,303,31
JEY,2020-26,1,0,Jersey,107796,Europe,304,31
JEY,2020-27,1,0,Jersey,107796,Europe,305,31
JEY,2020-28,5,0,Jersey,107796,Europe,310,31
JEY,2020-29,6,0,Jersey,107796,Europe,316,31
JEY,2020-30,1,0,Jersey,107796,Europe,317,31
JEY,2020-31,3,0,Jersey,107796,Europe,320,31
JEY,2020-32,10,0,Jersey,107796,Europe,330,31
JEY,2020-33,10,0,Jersey,107796,Europe,340,31
JEY,2020-34,8,1,Jersey,107796,Europe,348,32
JEY,2020-35,11,0,Jersey,107796,Europe,359,32
JEY,2020-36,10,0,Jersey,107796,Europe,369,32
JEY,2020-37,-4,0,Jersey,107796,Europe,365,32
JEY,2020-38,13,0,Jersey,107796,Europe,378,32
JEY,2020-39,7,0,Jersey,107796,Europe,385,32
JEY,2020-40,21,0,Jersey,107796,Europe,406,32
JEY,2020-41,28,0,Jersey,107796,Europe,434,32
JEY,2020-42,41,0,Jersey,107796,Europe,475,32
JEY,2020-43,40,0,Jersey,107796,Europe,515,32
JEY,2020-44,44,0,Jersey,107796,Europe,559,32
JEY,2020-45,69,0,Jersey,107796,Europe,628,32
JEY,2020-46,89,0,Jersey,107796,Europe,717,32
JEY,2020-47,79,0,Jersey,107796,Europe,796,32
JEY,2020-48,117,0,Jersey,107796,Europe,913,32
JEY,2020-49,429,0,Jersey,107796,Europe,1342,32
JEY,2020-50,422,0,Jersey,107796,Europe,1764,32
JEY,2020-51,557,4,Jersey,107796,Europe,2321,36
JEY,2020-52,327,5,Jersey,107796,Europe,2648,41
JEY,2020-53,158,3,Jersey,107796,Europe,2806,44
JEY,2021-01,151,13,Jersey,107796,Europe,2957,57
JEY,2021-02,82,5,Jersey,107796,Europe,3039,62
JEY,2021-03,68,1,Jersey,107796,Europe,3107,63
JEY,2021-04,30,3,Jersey,107796,Europe,3137,66
JEY,2021-05,24,1,Jersey,107796,Europe,3161,67
JEY,2021-06,26,0,Jersey,107796,Europe,3187,67
JEY,2021-07,11,1,Jersey,107796,Europe,3198,68
JEY,2021-08,4,1,Jersey,107796,Europe,3202,69
JEY,2021-09,4,0,Jersey,107796,Europe,3206,69
JEY,2021-10,1,0,Jersey,107796,Europe,3207,69
JEY,2021-11,2,0,Jersey,107796,Europe,3209,69
JEY,2021-12,1,0,Jersey,107796,Europe,3210,69
JEY,2021-13,4,0,Jersey,107796,Europe,3214,69
JEY,2021-14,2,0,Jersey,107796,Europe,3216,69
JEY,2021-15,2,0,Jersey,107796,Europe,3218,69
JEY,2021-16,0,0,Jersey,107796,Europe,3218,69
JEY,2021-17,1,0,Jersey,107796,Europe,3219,69
JEY,2021-18,1,0,Jersey,107796,Europe,3220,69
JEY,2021-19,1,0,Jersey,107796,Europe,3221,69
JEY,2021-20,2,0,Jersey,107796,Europe,3223,69
JEY,2021-21,5,0,Jersey,107796,Europe,3228,69
JEY,2021-22,10,0,Jersey,107796,Europe,3238,69
JEY,2021-23,34,0,Jersey,107796,Europe,3272,69
JEY,2021-24,26,0,Jersey,107796,Europe,3298,69
JEY,2021-25,143,0,Jersey,107796,Europe,3441,69
JEY,2021-26,428,0,Jersey,107796,Europe,3869,69
JEY,2021-27,921,0,Jersey,107796,Europe,4790,69
JEY,2021-28,1758,0,Jersey,107796,Europe,6548,69
JEY,2021-29,1296,0,Jersey,107796,Europe,7844,69
JEY,2021-30,401,0,Jersey,107796,Europe,8245,69
JEY,2021-31,415,4,Jersey,107796,Europe,8660,73
JEY,2021-32,242,1,Jersey,107796,Europe,8902,74
JOR,2020-12,84,0,Jordan,10203140,Asia,84,0
JOR,2020-13,160,1,Jordan,10203140,Asia,244,1
JOR,2020-14,86,4,Jordan,10203140,Asia,330,5
JOR,2020-15,44,2,Jordan,10203140,Asia,374,7
JOR,2020-16,28,0,Jordan,10203140,Asia,402,7
JOR,2020-17,30,0,Jordan,10203140,Asia,432,7
JOR,2020-18,14,2,Jordan,10203140,Asia,446,9
JOR,2020-19,79,0,Jordan,10203140,Asia,525,9
JOR,2020-20,73,0,Jordan,10203140,Asia,598,9
JOR,2020-21,95,0,Jordan,10203140,Asia,693,9
JOR,2020-22,31,0,Jordan,10203140,Asia,724,9
JOR,2020-23,69,0,Jordan,10203140,Asia,793,9
JOR,2020-24,153,0,Jordan,10203140,Asia,946,9
JOR,2020-25,72,0,Jordan,10203140,Asia,1018,9
JOR,2020-26,88,0,Jordan,10203140,Asia,1106,9
JOR,2020-27,43,1,Jordan,10203140,Asia,1149,10
JOR,2020-28,15,0,Jordan,10203140,Asia,1164,10
JOR,2020-29,39,1,Jordan,10203140,Asia,1203,11
JOR,2020-30,-50,0,Jordan,10203140,Asia,1153,11
JOR,2020-31,45,0,Jordan,10203140,Asia,1198,11
JOR,2020-32,39,0,Jordan,10203140,Asia,1237,11
JOR,2020-33,126,0,Jordan,10203140,Asia,1363,11
JOR,2020-34,231,1,Jordan,10203140,Asia,1594,12
JOR,2020-35,357,3,Jordan,10203140,Asia,1951,15
JOR,2020-36,445,1,Jordan,10203140,Asia,2396,16
JOR,2020-37,903,8,Jordan,10203140,Asia,3299,24
JOR,2020-38,1465,6,Jordan,10203140,Asia,4764,30
JOR,2020-39,3713,15,Jordan,10203140,Asia,8477,45
JOR,2020-40,7148,56,Jordan,10203140,Asia,15625,101
JOR,2020-41,9286,90,Jordan,10203140,Asia,24911,191
JOR,2020-42,12647,154,Jordan,10203140,Asia,37558,345
JOR,2020-43,15514,234,Jordan,10203140,Asia,53072,579
JOR,2020-44,22779,287,Jordan,10203140,Asia,75851,866
JOR,2020-45,33455,367,Jordan,10203140,Asia,109306,1233
JOR,2020-46,34357,539,Jordan,10203140,Asia,143663,1772
JOR,2020-47,39751,464,Jordan,10203140,Asia,183414,2236
JOR,2020-48,30878,458,Jordan,10203140,Asia,214292,2694
JOR,2020-49,25782,362,Jordan,10203140,Asia,240074,3056
JOR,2020-50,19525,309,Jordan,10203140,Asia,259599,3365
JOR,2020-51,17834,239,Jordan,10203140,Asia,277433,3604
JOR,2020-52,10498,154,Jordan,10203140,Asia,287931,3758
JOR,2020-53,10262,145,Jordan,10203140,Asia,298193,3903
JOR,2021-01,10462,140,Jordan,10203140,Asia,308655,4043
JOR,2021-02,6874,110,Jordan,10203140,Asia,315529,4153
JOR,2021-03,4909,71,Jordan,10203140,Asia,320438,4224
JOR,2021-04,7609,102,Jordan,10203140,Asia,328047,4326
JOR,2021-05,7092,53,Jordan,10203140,Asia,335139,4379
JOR,2021-06,12096,76,Jordan,10203140,Asia,347235,4455
JOR,2021-07,21028,115,Jordan,10203140,Asia,368263,4570
JOR,2021-08,28880,157,Jordan,10203140,Asia,397143,4727
JOR,2021-09,37972,260,Jordan,10203140,Asia,435115,4987
JOR,2021-10,41923,359,Jordan,10203140,Asia,477038,5346
JOR,2021-11,67671,639,Jordan,10203140,Asia,544709,5985
JOR,2021-12,37409,487,Jordan,10203140,Asia,582118,6472
JOR,2021-13,57311,811,Jordan,10203140,Asia,639429,7283
JOR,2021-14,26291,490,Jordan,10203140,Asia,665720,7773
JOR,2021-15,23747,535,Jordan,10203140,Asia,689467,8308
JOR,2021-16,15058,352,Jordan,10203140,Asia,704525,8660
JOR,2021-17,9633,265,Jordan,10203140,Asia,714158,8925
JOR,2021-18,5060,151,Jordan,10203140,Asia,719218,9076
JOR,2021-19,6025,200,Jordan,10203140,Asia,725243,9276
JOR,2021-20,6178,108,Jordan,10203140,Asia,731421,9384
JOR,2021-21,5098,78,Jordan,10203140,Asia,736519,9462
JOR,2021-22,3313,68,Jordan,10203140,Asia,739832,9530
JOR,2021-23,3484,62,Jordan,10203140,Asia,743316,9592
JOR,2021-24,3149,71,Jordan,10203140,Asia,746465,9663
JOR,2021-25,3909,74,Jordan,10203140,Asia,750374,9737
JOR,2021-26,3387,48,Jordan,10203140,Asia,753761,9785
JOR,2021-27,3914,58,Jordan,10203140,Asia,757675,9843
JOR,2021-28,4338,67,Jordan,10203140,Asia,762013,9910
JOR,2021-29,4086,61,Jordan,10203140,Asia,766099,9971
JOR,2021-30,6629,88,Jordan,10203140,Asia,772728,10059
JOR,2021-31,5350,76,Jordan,10203140,Asia,778078,10135
JOR,2021-32,7604,104,Jordan,10203140,Asia,785682,10239
JPN,2020-02,0,0,Japan,126476458,Asia,0,0
JPN,2020-03,1,0,Japan,126476458,Asia,1,0
JPN,2020-04,2,0,Japan,126476458,Asia,3,0
JPN,2020-05,17,0,Japan,126476458,Asia,20,0
JPN,2020-06,5,0,Japan,126476458,Asia,25,0
JPN,2020-07,34,1,Japan,126476458,Asia,59,1
JPN,2020-08,85,0,Japan,126476458,Asia,144,1
JPN,2020-09,110,5,Japan,126476458,Asia,254,6
JPN,2020-10,234,1,Japan,126476458,Asia,488,7
JPN,2020-11,326,17,Japan,126476458,Asia,814,24
JPN,2020-12,275,17,Japan,126476458,Asia,1089,41
JPN,2020-13,777,13,Japan,126476458,Asia,1866,54
JPN,2020-14,1788,19,Japan,126476458,Asia,3654,73
JPN,2020-15,3601,29,Japan,126476458,Asia,7255,102
JPN,2020-16,3496,69,Japan,126476458,Asia,10751,171
JPN,2020-17,2634,180,Japan,126476458,Asia,13385,351
JPN,2020-18,1672,159,Japan,126476458,Asia,15057,510
JPN,2020-19,741,111,Japan,126476458,Asia,15798,621
JPN,2020-20,507,128,Japan,126476458,Asia,16305,749
JPN,2020-21,276,81,Japan,126476458,Asia,16581,830
JPN,2020-22,303,62,Japan,126476458,Asia,16884,892
JPN,2020-23,290,24,Japan,126476458,Asia,17174,916
JPN,2020-24,328,9,Japan,126476458,Asia,17502,925
JPN,2020-25,414,28,Japan,126476458,Asia,17916,953
JPN,2020-26,560,19,Japan,126476458,Asia,18476,972
JPN,2020-27,1299,5,Japan,126476458,Asia,19775,977
JPN,2020-28,2093,5,Japan,126476458,Asia,21868,982
JPN,2020-29,3228,3,Japan,126476458,Asia,25096,985
JPN,2020-30,4893,11,Japan,126476458,Asia,29989,996
JPN,2020-31,8083,15,Japan,126476458,Asia,38072,1011
JPN,2020-32,9918,36,Japan,126476458,Asia,47990,1047
JPN,2020-33,6962,51,Japan,126476458,Asia,54952,1098
JPN,2020-34,6802,82,Japan,126476458,Asia,61754,1180
JPN,2020-35,6111,99,Japan,126476458,Asia,67865,1279
JPN,2020-36,3991,84,Japan,126476458,Asia,71856,1363
JPN,2020-37,3801,79,Japan,126476458,Asia,75657,1442
JPN,2020-38,3000,58,Japan,126476458,Asia,78657,1500
JPN,2020-39,3474,48,Japan,126476458,Asia,82131,1548
JPN,2020-40,3608,51,Japan,126476458,Asia,85739,1599
JPN,2020-41,3608,30,Japan,126476458,Asia,89347,1629
JPN,2020-42,3780,45,Japan,126476458,Asia,93127,1674
JPN,2020-43,3947,44,Japan,126476458,Asia,97074,1718
JPN,2020-44,4739,56,Japan,126476458,Asia,101813,1774
JPN,2020-45,6271,44,Japan,126476458,Asia,108084,1818
JPN,2020-46,8593,65,Japan,126476458,Asia,116677,1883
JPN,2020-47,14240,97,Japan,126476458,Asia,130917,1980
JPN,2020-48,15843,139,Japan,126476458,Asia,146760,2119
JPN,2020-49,15307,216,Japan,126476458,Asia,162067,2335
JPN,2020-50,17586,250,Japan,126476458,Asia,179653,2585
JPN,2020-51,18870,315,Japan,126476458,Asia,198523,2900
JPN,2020-52,21713,352,Japan,126476458,Asia,220236,3252
JPN,2020-53,23611,347,Japan,126476458,Asia,243847,3599
JPN,2021-01,42905,445,Japan,126476458,Asia,286752,4044
JPN,2021-02,41542,457,Japan,126476458,Asia,328294,4501
JPN,2021-03,32367,518,Japan,126476458,Asia,360661,5019
JPN,2021-04,28857,703,Japan,126476458,Asia,389518,5722
JPN,2021-05,15472,673,Japan,126476458,Asia,404990,6395
JPN,2021-06,10792,557,Japan,126476458,Asia,415782,6952
JPN,2021-07,8457,575,Japan,126476458,Asia,424239,7527
JPN,2021-08,8534,360,Japan,126476458,Asia,432773,7887
JPN,2021-09,7219,366,Japan,126476458,Asia,439992,8253
JPN,2021-10,7914,337,Japan,126476458,Asia,447906,8590
JPN,2021-11,8875,245,Japan,126476458,Asia,456781,8835
JPN,2021-12,11833,226,Japan,126476458,Asia,468614,9061
JPN,2021-13,14253,160,Japan,126476458,Asia,482867,9221
JPN,2021-14,20536,158,Japan,126476458,Asia,503403,9379
JPN,2021-15,30649,262,Japan,126476458,Asia,534052,9641
JPN,2021-16,28089,272,Japan,126476458,Asia,562141,9913
JPN,2021-17,39978,448,Japan,126476458,Asia,602119,10361
JPN,2021-18,30908,462,Japan,126476458,Asia,633027,10823
JPN,2021-19,44961,640,Japan,126476458,Asia,677988,11463
JPN,2021-20,36286,773,Japan,126476458,Asia,714274,12236
JPN,2021-21,27400,684,Japan,126476458,Asia,741674,12920
JPN,2021-22,18649,603,Japan,126476458,Asia,760323,13523
JPN,2021-23,13499,510,Japan,126476458,Asia,773822,14033
JPN,2021-24,10178,367,Japan,126476458,Asia,784000,14400
JPN,2021-25,10457,257,Japan,126476458,Asia,794457,14657
JPN,2021-26,10919,185,Japan,126476458,Asia,805376,14842
JPN,2021-27,13314,106,Japan,126476458,Asia,818690,14948
JPN,2021-28,19742,92,Japan,126476458,Asia,838432,15040
JPN,2021-29,32013,89,Japan,126476458,Asia,870445,15129
JPN,2021-30,65441,68,Japan,126476458,Asia,935886,15197
JPN,2021-31,95410,83,Japan,126476458,Asia,1031296,15280
JPN,2021-32,97086,120,Japan,126476458,Asia,1128382,15400
KAZ,2020-12,51,0,Kazakhstan,18776707,Asia,51,0
KAZ,2020-13,224,1,Kazakhstan,18776707,Asia,275,1
KAZ,2020-14,247,4,Kazakhstan,18776707,Asia,522,5
KAZ,2020-15,430,5,Kazakhstan,18776707,Asia,952,10
KAZ,2020-16,774,9,Kazakhstan,18776707,Asia,1726,19
KAZ,2020-17,982,6,Kazakhstan,18776707,Asia,2708,25
KAZ,2020-18,1247,2,Kazakhstan,18776707,Asia,3955,27
KAZ,2020-19,1162,4,Kazakhstan,18776707,Asia,5117,31
KAZ,2020-20,1314,3,Kazakhstan,18776707,Asia,6431,34
KAZ,2020-21,2091,1,Kazakhstan,18776707,Asia,8522,35
KAZ,2020-22,2777,6,Kazakhstan,18776707,Asia,11299,41
KAZ,2020-23,1551,15,Kazakhstan,18776707,Asia,12850,56
KAZ,2020-24,1950,21,Kazakhstan,18776707,Asia,14800,77
KAZ,2020-25,2923,43,Kazakhstan,18776707,Asia,17723,120
KAZ,2020-26,3595,63,Kazakhstan,18776707,Asia,21318,183
KAZ,2020-27,27247,5,Kazakhstan,18776707,Asia,48565,188
KAZ,2020-28,11315,187,Kazakhstan,18776707,Asia,59880,375
KAZ,2020-29,11949,0,Kazakhstan,18776707,Asia,71829,375
KAZ,2020-30,11284,210,Kazakhstan,18776707,Asia,83113,585
KAZ,2020-31,15519,524,Kazakhstan,18776707,Asia,98632,1109
KAZ,2020-32,14081,324,Kazakhstan,18776707,Asia,112713,1433
KAZ,2020-33,8917,54,Kazakhstan,18776707,Asia,121630,1487
KAZ,2020-34,5823,186,Kazakhstan,18776707,Asia,127453,1673
KAZ,2020-35,3211,108,Kazakhstan,18776707,Asia,130664,1781
KAZ,2020-36,3450,121,Kazakhstan,18776707,Asia,134114,1902
KAZ,2020-37,2390,60,Kazakhstan,18776707,Asia,136504,1962
KAZ,2020-38,1942,53,Kazakhstan,18776707,Asia,138446,2015
KAZ,2020-39,1810,34,Kazakhstan,18776707,Asia,140256,2049
KAZ,2020-40,1579,36,Kazakhstan,18776707,Asia,141835,2085
KAZ,2020-41,1896,29,Kazakhstan,18776707,Asia,143731,2114
KAZ,2020-42,1733,36,Kazakhstan,18776707,Asia,145464,2150
KAZ,2020-43,1990,40,Kazakhstan,18776707,Asia,147454,2190
KAZ,2020-44,3400,37,Kazakhstan,18776707,Asia,150854,2227
KAZ,2020-45,5013,39,Kazakhstan,18776707,Asia,155867,2266
KAZ,2020-46,5372,53,Kazakhstan,18776707,Asia,161239,2319
KAZ,2020-47,6137,53,Kazakhstan,18776707,Asia,167376,2372
KAZ,2020-48,6421,61,Kazakhstan,18776707,Asia,173797,2433
KAZ,2020-49,6283,55,Kazakhstan,18776707,Asia,180080,2488
KAZ,2020-50,6188,64,Kazakhstan,18776707,Asia,186268,2552
KAZ,2020-51,5373,70,Kazakhstan,18776707,Asia,191641,2622
KAZ,2020-52,7009,67,Kazakhstan,18776707,Asia,198650,2689
KAZ,2020-53,8409,86,Kazakhstan,18776707,Asia,207059,2775
KAZ,2021-01,3018,100,Kazakhstan,18776707,Asia,210077,2875
KAZ,2021-02,6878,16,Kazakhstan,18776707,Asia,216955,2891
KAZ,2021-03,8927,67,Kazakhstan,18776707,Asia,225882,2958
KAZ,2021-04,9953,88,Kazakhstan,18776707,Asia,235835,3046
KAZ,2021-05,8584,78,Kazakhstan,18776707,Asia,244419,3124
KAZ,2021-06,6839,16,Kazakhstan,18776707,Asia,251258,3140
KAZ,2021-07,5833,12,Kazakhstan,18776707,Asia,257091,3152
KAZ,2021-08,5615,10,Kazakhstan,18776707,Asia,262706,3162
KAZ,2021-09,6187,303,Kazakhstan,18776707,Asia,268893,3465
KAZ,2021-10,9150,46,Kazakhstan,18776707,Asia,278043,3511
KAZ,2021-11,4975,75,Kazakhstan,18776707,Asia,283018,3586
KAZ,2021-12,9279,110,Kazakhstan,18776707,Asia,292297,3696
KAZ,2021-13,13554,116,Kazakhstan,18776707,Asia,305851,3812
KAZ,2021-14,19374,179,Kazakhstan,18776707,Asia,325225,3991
KAZ,2021-15,18906,199,Kazakhstan,18776707,Asia,344131,4190
KAZ,2021-16,19731,191,Kazakhstan,18776707,Asia,363862,4381
KAZ,2021-17,17207,161,Kazakhstan,18776707,Asia,381069,4542
KAZ,2021-18,21977,218,Kazakhstan,18776707,Asia,403046,4760
KAZ,2021-19,13128,198,Kazakhstan,18776707,Asia,416174,4958
KAZ,2021-20,7010,-25,Kazakhstan,18776707,Asia,423184,4933
KAZ,2021-21,15522,2216,Kazakhstan,18776707,Asia,438706,7149
KAZ,2021-22,9863,172,Kazakhstan,18776707,Asia,448569,7321
KAZ,2021-23,9874,265,Kazakhstan,18776707,Asia,458443,7586
KAZ,2021-24,8617,80,Kazakhstan,18776707,Asia,467060,7666
KAZ,2021-25,9671,0,Kazakhstan,18776707,Asia,476731,7666
KAZ,2021-26,17650,93,Kazakhstan,18776707,Asia,494381,7759
KAZ,2021-27,25946,175,Kazakhstan,18776707,Asia,520327,7934
KAZ,2021-28,32517,239,Kazakhstan,18776707,Asia,552844,8173
KAZ,2021-29,49544,365,Kazakhstan,18776707,Asia,602388,8538
KAZ,2021-30,46810,539,Kazakhstan,18776707,Asia,649198,9077
KAZ,2021-31,56120,832,Kazakhstan,18776707,Asia,705318,9909
KAZ,2021-32,61836,1816,Kazakhstan,18776707,Asia,767154,11725
KEN,2020-12,12,0,Kenya,53771300,Africa,12,0
KEN,2020-13,27,1,Kenya,53771300,Africa,39,1
KEN,2020-14,100,3,Kenya,53771300,Africa,139,4
KEN,2020-15,55,4,Kenya,53771300,Africa,194,8
KEN,2020-16,73,6,Kenya,53771300,Africa,267,14
KEN,2020-17,85,0,Kenya,53771300,Africa,352,14
KEN,2020-18,110,10,Kenya,53771300,Africa,462,24
KEN,2020-19,207,8,Kenya,53771300,Africa,669,32
KEN,2020-20,215,18,Kenya,53771300,Africa,884,50
KEN,2020-21,327,1,Kenya,53771300,Africa,1211,51
KEN,2020-22,748,13,Kenya,53771300,Africa,1959,64
KEN,2020-23,805,20,Kenya,53771300,Africa,2764,84
KEN,2020-24,827,19,Kenya,53771300,Africa,3591,103
KEN,2020-25,1144,20,Kenya,53771300,Africa,4735,123
KEN,2020-26,1332,20,Kenya,53771300,Africa,6067,143
KEN,2020-27,1816,17,Kenya,53771300,Africa,7883,160
KEN,2020-28,2219,25,Kenya,53771300,Africa,10102,185
KEN,2020-29,3248,49,Kenya,53771300,Africa,13350,234
KEN,2020-30,4250,46,Kenya,53771300,Africa,17600,280
KEN,2020-31,4450,89,Kenya,53771300,Africa,22050,369
KEN,2020-32,4383,51,Kenya,53771300,Africa,26433,420
KEN,2020-33,3684,54,Kenya,53771300,Africa,30117,474
KEN,2020-34,2244,74,Kenya,53771300,Africa,32361,548
KEN,2020-35,1693,26,Kenya,53771300,Africa,34054,574
KEN,2020-36,1046,23,Kenya,53771300,Africa,35100,597
KEN,2020-37,1054,25,Kenya,53771300,Africa,36154,622
KEN,2020-38,824,26,Kenya,53771300,Africa,36978,648
KEN,2020-39,1134,43,Kenya,53771300,Africa,38112,691
KEN,2020-40,1312,40,Kenya,53771300,Africa,39424,731
KEN,2020-41,2119,35,Kenya,53771300,Africa,41543,766
KEN,2020-42,3335,66,Kenya,53771300,Africa,44878,832
KEN,2020-43,4840,70,Kenya,53771300,Africa,49718,902
KEN,2020-44,6156,111,Kenya,53771300,Africa,55874,1013
KEN,2020-45,6611,98,Kenya,53771300,Africa,62485,1111
KEN,2020-46,7757,158,Kenya,53771300,Africa,70242,1269
KEN,2020-47,7127,111,Kenya,53771300,Africa,77369,1380
KEN,2020-48,5944,72,Kenya,53771300,Africa,83313,1452
KEN,2020-49,5064,74,Kenya,53771300,Africa,88377,1526
KEN,2020-50,3512,61,Kenya,53771300,Africa,91889,1587
KEN,2020-51,2608,52,Kenya,53771300,Africa,94497,1639
KEN,2020-52,1492,25,Kenya,53771300,Africa,95989,1664
KEN,2020-53,810,21,Kenya,53771300,Africa,96799,1685
KEN,2021-01,1469,28,Kenya,53771300,Africa,98268,1713
KEN,2021-02,891,18,Kenya,53771300,Africa,99159,1731
KEN,2021-03,890,13,Kenya,53771300,Africa,100049,1744
KEN,2021-04,804,22,Kenya,53771300,Africa,100853,1766
KEN,2021-05,1088,20,Kenya,53771300,Africa,101941,1786
KEN,2021-06,923,9,Kenya,53771300,Africa,102864,1795
KEN,2021-07,1439,32,Kenya,53771300,Africa,104303,1827
KEN,2021-08,1667,29,Kenya,53771300,Africa,105970,1856
KEN,2021-09,2854,20,Kenya,53771300,Africa,108824,1876
KEN,2021-10,4409,37,Kenya,53771300,Africa,113233,1913
KEN,2021-11,7674,98,Kenya,53771300,Africa,120907,2011
KEN,2021-12,9304,106,Kenya,53771300,Africa,130211,2117
KEN,2021-13,8774,107,Kenya,53771300,Africa,138985,2224
KEN,2021-14,6682,124,Kenya,53771300,Africa,145667,2348
KEN,2021-15,5983,133,Kenya,53771300,Africa,151650,2481
KEN,2021-16,5134,141,Kenya,53771300,Africa,156784,2622
KEN,2021-17,3635,141,Kenya,53771300,Africa,160419,2763
KEN,2021-18,3132,132,Kenya,53771300,Africa,163551,2895
KEN,2021-19,1911,108,Kenya,53771300,Africa,165462,3003
KEN,2021-20,2967,56,Kenya,53771300,Africa,168429,3059
KEN,2021-21,2215,98,Kenya,53771300,Africa,170644,3157
KEN,2021-22,1844,130,Kenya,53771300,Africa,172488,3287
KEN,2021-23,2846,123,Kenya,53771300,Africa,175334,3410
KEN,2021-24,3738,46,Kenya,53771300,Africa,179072,3456
KEN,2021-25,3522,139,Kenya,53771300,Africa,182594,3595
KEN,2021-26,3271,80,Kenya,53771300,Africa,185865,3675
KEN,2021-27,2886,47,Kenya,53771300,Africa,188751,3722
KEN,2021-28,4004,53,Kenya,53771300,Africa,192755,3775
KEN,2021-29,4651,90,Kenya,53771300,Africa,197406,3865
KEN,2021-30,6271,81,Kenya,53771300,Africa,203677,3946
KEN,2021-31,8148,203,Kenya,53771300,Africa,211825,4149
KEN,2021-32,8899,191,Kenya,53771300,Africa,220724,4340
KGZ,2020-13,70,0,Kyrgyzstan,6524191,Asia,70,0
KGZ,2020-14,132,4,Kyrgyzstan,6524191,Asia,202,4
KGZ,2020-15,203,1,Kyrgyzstan,6524191,Asia,405,5
KGZ,2020-16,149,2,Kyrgyzstan,6524191,Asia,554,7
KGZ,2020-17,127,1,Kyrgyzstan,6524191,Asia,681,8
KGZ,2020-18,135,2,Kyrgyzstan,6524191,Asia,816,10
KGZ,2020-19,186,2,Kyrgyzstan,6524191,Asia,1002,12
KGZ,2020-20,200,2,Kyrgyzstan,6524191,Asia,1202,14
KGZ,2020-21,217,2,Kyrgyzstan,6524191,Asia,1419,16
KGZ,2020-22,384,0,Kyrgyzstan,6524191,Asia,1803,16
KGZ,2020-23,215,7,Kyrgyzstan,6524191,Asia,2018,23
KGZ,2020-24,340,4,Kyrgyzstan,6524191,Asia,2358,27
KGZ,2020-25,984,13,Kyrgyzstan,6524191,Asia,3342,40
KGZ,2020-26,1661,10,Kyrgyzstan,6524191,Asia,5003,50
KGZ,2020-27,2674,42,Kyrgyzstan,6524191,Asia,7677,92
KGZ,2020-28,3426,55,Kyrgyzstan,6524191,Asia,11103,147
KGZ,2020-29,16026,890,Kyrgyzstan,6524191,Asia,27129,1037
KGZ,2020-30,6153,264,Kyrgyzstan,6524191,Asia,33282,1301
KGZ,2020-31,3833,119,Kyrgyzstan,6524191,Asia,37115,1420
KGZ,2020-32,3048,54,Kyrgyzstan,6524191,Asia,40163,1474
KGZ,2020-33,1814,22,Kyrgyzstan,6524191,Asia,41977,1496
KGZ,2020-34,1135,-439,Kyrgyzstan,6524191,Asia,43112,1057
KGZ,2020-35,772,1,Kyrgyzstan,6524191,Asia,43884,1058
KGZ,2020-36,553,2,Kyrgyzstan,6524191,Asia,44437,1060
KGZ,2020-37,477,3,Kyrgyzstan,6524191,Asia,44914,1063
KGZ,2020-38,543,0,Kyrgyzstan,6524191,Asia,45457,1063
KGZ,2020-39,884,1,Kyrgyzstan,6524191,Asia,46341,1064
KGZ,2020-40,1280,2,Kyrgyzstan,6524191,Asia,47621,1066
KGZ,2020-41,1595,19,Kyrgyzstan,6524191,Asia,49216,1085
KGZ,2020-42,3296,26,Kyrgyzstan,6524191,Asia,52512,1111
KGZ,2020-43,3644,23,Kyrgyzstan,6524191,Asia,56156,1134
KGZ,2020-44,3709,21,Kyrgyzstan,6524191,Asia,59865,1155
KGZ,2020-45,3511,27,Kyrgyzstan,6524191,Asia,63376,1182
KGZ,2020-46,3593,21,Kyrgyzstan,6524191,Asia,66969,1203
KGZ,2020-47,2902,34,Kyrgyzstan,6524191,Asia,69871,1237
KGZ,2020-48,2922,34,Kyrgyzstan,6524191,Asia,72793,1271
KGZ,2020-49,2588,26,Kyrgyzstan,6524191,Asia,75381,1297
KGZ,2020-50,2279,15,Kyrgyzstan,6524191,Asia,77660,1312
KGZ,2020-51,1580,19,Kyrgyzstan,6524191,Asia,79240,1331
KGZ,2020-52,1281,18,Kyrgyzstan,6524191,Asia,80521,1349
KGZ,2020-53,853,11,Kyrgyzstan,6524191,Asia,81374,1360
KGZ,2021-01,992,11,Kyrgyzstan,6524191,Asia,82366,1371
KGZ,2021-02,798,16,Kyrgyzstan,6524191,Asia,83164,1387
KGZ,2021-03,793,14,Kyrgyzstan,6524191,Asia,83957,1401
KGZ,2021-04,617,11,Kyrgyzstan,6524191,Asia,84574,1412
KGZ,2021-05,525,19,Kyrgyzstan,6524191,Asia,85099,1431
KGZ,2021-06,403,11,Kyrgyzstan,6524191,Asia,85502,1442
KGZ,2021-07,413,16,Kyrgyzstan,6524191,Asia,85915,1458
KGZ,2021-08,322,8,Kyrgyzstan,6524191,Asia,86237,1466
KGZ,2021-09,332,7,Kyrgyzstan,6524191,Asia,86569,1473
KGZ,2021-10,267,8,Kyrgyzstan,6524191,Asia,86836,1481
KGZ,2021-11,612,9,Kyrgyzstan,6524191,Asia,87448,1490
KGZ,2021-12,701,7,Kyrgyzstan,6524191,Asia,88149,1497
KGZ,2021-13,990,10,Kyrgyzstan,6524191,Asia,89139,1507
KGZ,2021-14,1219,21,Kyrgyzstan,6524191,Asia,90358,1528
KGZ,2021-15,1723,27,Kyrgyzstan,6524191,Asia,92081,1555
KGZ,2021-16,1935,29,Kyrgyzstan,6524191,Asia,94016,1584
KGZ,2021-17,2307,38,Kyrgyzstan,6524191,Asia,96323,1622
KGZ,2021-18,2317,33,Kyrgyzstan,6524191,Asia,98640,1655
KGZ,2021-19,2078,56,Kyrgyzstan,6524191,Asia,100718,1711
KGZ,2021-20,1970,40,Kyrgyzstan,6524191,Asia,102688,1751
KGZ,2021-21,2027,57,Kyrgyzstan,6524191,Asia,104715,1808
KGZ,2021-22,2606,44,Kyrgyzstan,6524191,Asia,107321,1852
KGZ,2021-23,3494,47,Kyrgyzstan,6524191,Asia,110815,1899
KGZ,2021-24,4786,38,Kyrgyzstan,6524191,Asia,115601,1937
KGZ,2021-25,6331,45,Kyrgyzstan,6524191,Asia,121932,1982
KGZ,2021-26,10124,64,Kyrgyzstan,6524191,Asia,132056,2046
KGZ,2021-27,8908,67,Kyrgyzstan,6524191,Asia,140964,2113
KGZ,2021-28,9338,73,Kyrgyzstan,6524191,Asia,150302,2186
KGZ,2021-29,7804,75,Kyrgyzstan,6524191,Asia,158106,2261
KGZ,2021-30,6623,83,Kyrgyzstan,6524191,Asia,164729,2344
KGZ,2021-31,4757,63,Kyrgyzstan,6524191,Asia,169486,2407
KGZ,2021-32,2827,44,Kyrgyzstan,6524191,Asia,172313,2451
KHM,2020-02,0,0,Cambodia,16718971,Asia,0,0
KHM,2020-03,0,0,Cambodia,16718971,Asia,0,0
KHM,2020-04,0,0,Cambodia,16718971,Asia,0,0
KHM,2020-05,1,0,Cambodia,16718971,Asia,1,0
KHM,2020-06,0,0,Cambodia,16718971,Asia,1,0
KHM,2020-07,0,0,Cambodia,16718971,Asia,1,0
KHM,2020-08,0,0,Cambodia,16718971,Asia,1,0
KHM,2020-09,0,0,Cambodia,16718971,Asia,1,0
KHM,2020-10,1,0,Cambodia,16718971,Asia,2,0
KHM,2020-11,10,0,Cambodia,16718971,Asia,12,0
KHM,2020-12,74,0,Cambodia,16718971,Asia,86,0
KHM,2020-13,21,0,Cambodia,16718971,Asia,107,0
KHM,2020-14,7,0,Cambodia,16718971,Asia,114,0
KHM,2020-15,8,0,Cambodia,16718971,Asia,122,0
KHM,2020-16,0,0,Cambodia,16718971,Asia,122,0
KHM,2020-17,0,0,Cambodia,16718971,Asia,122,0
KHM,2020-18,0,0,Cambodia,16718971,Asia,122,0
KHM,2020-19,0,0,Cambodia,16718971,Asia,122,0
KHM,2020-20,0,0,Cambodia,16718971,Asia,122,0
KHM,2020-21,2,0,Cambodia,16718971,Asia,124,0
KHM,2020-22,1,0,Cambodia,16718971,Asia,125,0
KHM,2020-23,1,0,Cambodia,16718971,Asia,126,0
KHM,2020-24,2,0,Cambodia,16718971,Asia,128,0
KHM,2020-25,1,0,Cambodia,16718971,Asia,129,0
KHM,2020-26,12,0,Cambodia,16718971,Asia,141,0
KHM,2020-27,0,0,Cambodia,16718971,Asia,141,0
KHM,2020-28,15,0,Cambodia,16718971,Asia,156,0
KHM,2020-29,15,0,Cambodia,16718971,Asia,171,0
KHM,2020-30,54,0,Cambodia,16718971,Asia,225,0
KHM,2020-31,15,0,Cambodia,16718971,Asia,240,0
KHM,2020-32,11,0,Cambodia,16718971,Asia,251,0
KHM,2020-33,22,0,Cambodia,16718971,Asia,273,0
KHM,2020-34,0,0,Cambodia,16718971,Asia,273,0
KHM,2020-35,1,0,Cambodia,16718971,Asia,274,0
KHM,2020-36,0,0,Cambodia,16718971,Asia,274,0
KHM,2020-37,1,0,Cambodia,16718971,Asia,275,0
KHM,2020-38,0,0,Cambodia,16718971,Asia,275,0
KHM,2020-39,1,0,Cambodia,16718971,Asia,276,0
KHM,2020-40,4,0,Cambodia,16718971,Asia,280,0
KHM,2020-41,3,0,Cambodia,16718971,Asia,283,0
KHM,2020-42,0,0,Cambodia,16718971,Asia,283,0
KHM,2020-43,4,0,Cambodia,16718971,Asia,287,0
KHM,2020-44,4,0,Cambodia,16718971,Asia,291,0
KHM,2020-45,6,0,Cambodia,16718971,Asia,297,0
KHM,2020-46,5,0,Cambodia,16718971,Asia,302,0
KHM,2020-47,4,0,Cambodia,16718971,Asia,306,0
KHM,2020-48,17,0,Cambodia,16718971,Asia,323,0
KHM,2020-49,25,0,Cambodia,16718971,Asia,348,0
KHM,2020-50,11,0,Cambodia,16718971,Asia,359,0
KHM,2020-51,4,0,Cambodia,16718971,Asia,363,0
KHM,2020-52,1,0,Cambodia,16718971,Asia,364,0
KHM,2020-53,18,0,Cambodia,16718971,Asia,382,0
KHM,2021-01,9,0,Cambodia,16718971,Asia,391,0
KHM,2021-02,50,0,Cambodia,16718971,Asia,441,0
KHM,2021-03,17,0,Cambodia,16718971,Asia,458,0
KHM,2021-04,8,0,Cambodia,16718971,Asia,466,0
KHM,2021-05,8,0,Cambodia,16718971,Asia,474,0
KHM,2021-06,5,0,Cambodia,16718971,Asia,479,0
KHM,2021-07,89,0,Cambodia,16718971,Asia,568,0
KHM,2021-08,252,0,Cambodia,16718971,Asia,820,0
KHM,2021-09,191,0,Cambodia,16718971,Asia,1011,0
KHM,2021-10,314,1,Cambodia,16718971,Asia,1325,1
KHM,2021-11,428,2,Cambodia,16718971,Asia,1753,3
KHM,2021-12,520,8,Cambodia,16718971,Asia,2273,11
KHM,2021-13,479,10,Cambodia,16718971,Asia,2752,21
KHM,2021-14,1763,9,Cambodia,16718971,Asia,4515,30
KHM,2021-15,2498,15,Cambodia,16718971,Asia,7013,45
KHM,2021-16,3542,34,Cambodia,16718971,Asia,10555,79
KHM,2021-17,4806,27,Cambodia,16718971,Asia,15361,106
KHM,2021-18,4382,20,Cambodia,16718971,Asia,19743,126
KHM,2021-19,2801,28,Cambodia,16718971,Asia,22544,154
KHM,2021-20,3217,25,Cambodia,16718971,Asia,25761,179
KHM,2021-21,4333,35,Cambodia,16718971,Asia,30094,214
KHM,2021-22,4739,52,Cambodia,16718971,Asia,34833,266
KHM,2021-23,4136,82,Cambodia,16718971,Asia,38969,348
KHM,2021-24,4477,93,Cambodia,16718971,Asia,43446,441
KHM,2021-25,5086,115,Cambodia,16718971,Asia,48532,556
KHM,2021-26,6655,192,Cambodia,16718971,Asia,55187,748
KHM,2021-27,6683,177,Cambodia,16718971,Asia,61870,925
KHM,2021-28,6101,203,Cambodia,16718971,Asia,67971,1128
KHM,2021-29,5730,177,Cambodia,16718971,Asia,73701,1305
KHM,2021-30,4773,137,Cambodia,16718971,Asia,78474,1442
KHM,2021-31,3925,143,Cambodia,16718971,Asia,82399,1585
KHM,2021-32,3642,119,Cambodia,16718971,Asia,86041,1704
KNA,2020-14,3,0,Saint Kitts And Nevis,53192,America,3,0
KNA,2020-15,2,0,Saint Kitts And Nevis,53192,America,5,0
KNA,2020-16,3,0,Saint Kitts And Nevis,53192,America,8,0
KNA,2020-17,0,0,Saint Kitts And Nevis,53192,America,8,0
KNA,2020-18,0,0,Saint Kitts And Nevis,53192,America,8,0
KNA,2020-19,0,0,Saint Kitts And Nevis,53192,America,8,0
KNA,2020-20,0,0,Saint Kitts And Nevis,53192,America,8,0
KNA,2020-21,0,0,Saint Kitts And Nevis,53192,America,8,0
KNA,2020-22,0,0,Saint Kitts And Nevis,53192,America,8,0
KNA,2020-23,0,0,Saint Kitts And Nevis,53192,America,8,0
KNA,2020-24,0,0,Saint Kitts And Nevis,53192,America,8,0
KNA,2020-25,0,0,Saint Kitts And Nevis,53192,America,8,0
KNA,2020-26,0,0,Saint Kitts And Nevis,53192,America,8,0
KNA,2020-27,1,0,Saint Kitts And Nevis,53192,America,9,0
KNA,2020-28,1,0,Saint Kitts And Nevis,53192,America,10,0
KNA,2020-29,0,0,Saint Kitts And Nevis,53192,America,10,0
KNA,2020-30,0,0,Saint Kitts And Nevis,53192,America,10,0
KNA,2020-31,0,0,Saint Kitts And Nevis,53192,America,10,0
KNA,2020-32,0,0,Saint Kitts And Nevis,53192,America,10,0
KNA,2020-33,0,0,Saint Kitts And Nevis,53192,America,10,0
KNA,2020-34,0,0,Saint Kitts And Nevis,53192,America,10,0
KNA,2020-35,0,0,Saint Kitts And Nevis,53192,America,10,0
KNA,2020-36,0,0,Saint Kitts And Nevis,53192,America,10,0
KNA,2020-37,0,0,Saint Kitts And Nevis,53192,America,10,0
KNA,2020-38,0,0,Saint Kitts And Nevis,53192,America,10,0
KNA,2020-39,2,0,Saint Kitts And Nevis,53192,America,12,0
KNA,2020-40,0,0,Saint Kitts And Nevis,53192,America,12,0
KNA,2020-41,0,0,Saint Kitts And Nevis,53192,America,12,0
KNA,2020-42,0,0,Saint Kitts And Nevis,53192,America,12,0
KNA,2020-43,0,0,Saint Kitts And Nevis,53192,America,12,0
KNA,2020-44,0,0,Saint Kitts And Nevis,53192,America,12,0
KNA,2020-45,0,0,Saint Kitts And Nevis,53192,America,12,0
KNA,2020-46,0,0,Saint Kitts And Nevis,53192,America,12,0
KNA,2020-47,1,0,Saint Kitts And Nevis,53192,America,13,0
KNA,2020-48,2,0,Saint Kitts And Nevis,53192,America,15,0
KNA,2020-49,3,0,Saint Kitts And Nevis,53192,America,18,0
KNA,2020-50,3,0,Saint Kitts And Nevis,53192,America,21,0
KNA,2020-51,2,0,Saint Kitts And Nevis,53192,America,23,0
KNA,2020-52,2,0,Saint Kitts And Nevis,53192,America,25,0
KNA,2020-53,1,0,Saint Kitts And Nevis,53192,America,26,0
KNA,2021-01,1,0,Saint Kitts And Nevis,53192,America,27,0
KNA,2021-02,1,0,Saint Kitts And Nevis,53192,America,28,0
KNA,2021-03,0,0,Saint Kitts And Nevis,53192,America,28,0
KNA,2021-04,3,0,Saint Kitts And Nevis,53192,America,31,0
KNA,2021-05,2,0,Saint Kitts And Nevis,53192,America,33,0
KNA,2021-06,1,0,Saint Kitts And Nevis,53192,America,34,0
KNA,2021-07,0,0,Saint Kitts And Nevis,53192,America,34,0
KNA,2021-08,0,0,Saint Kitts And Nevis,53192,America,34,0
KNA,2021-09,0,0,Saint Kitts And Nevis,53192,America,34,0
KNA,2021-10,2,0,Saint Kitts And Nevis,53192,America,36,0
KNA,2021-11,1,0,Saint Kitts And Nevis,53192,America,37,0
KNA,2021-12,0,0,Saint Kitts And Nevis,53192,America,37,0
KNA,2021-13,0,0,Saint Kitts And Nevis,53192,America,37,0
KNA,2021-14,0,0,Saint Kitts And Nevis,53192,America,37,0
KNA,2021-15,0,0,Saint Kitts And Nevis,53192,America,37,0
KNA,2021-16,0,0,Saint Kitts And Nevis,53192,America,37,0
KNA,2021-17,1,0,Saint Kitts And Nevis,53192,America,38,0
KNA,2021-18,0,0,Saint Kitts And Nevis,53192,America,38,0
KNA,2021-19,0,0,Saint Kitts And Nevis,53192,America,38,0
KNA,2021-20,15,0,Saint Kitts And Nevis,53192,America,53,0
KNA,2021-21,8,0,Saint Kitts And Nevis,53192,America,61,0
KNA,2021-22,10,0,Saint Kitts And Nevis,53192,America,71,0
KNA,2021-23,109,0,Saint Kitts And Nevis,53192,America,180,0
KNA,2021-24,154,1,Saint Kitts And Nevis,53192,America,334,1
KNA,2021-25,87,2,Saint Kitts And Nevis,53192,America,421,3
KNA,2021-26,62,0,Saint Kitts And Nevis,53192,America,483,3
KNA,2021-27,48,0,Saint Kitts And Nevis,53192,America,531,3
KNA,2021-28,12,0,Saint Kitts And Nevis,53192,America,543,3
KNA,2021-29,15,0,Saint Kitts And Nevis,53192,America,558,3
KNA,2021-30,29,0,Saint Kitts And Nevis,53192,America,587,3
KNA,2021-31,20,0,Saint Kitts And Nevis,53192,America,607,3
KNA,2021-32,41,0,Saint Kitts And Nevis,53192,America,648,3
KOR,2020-02,0,0,South Korea,51269183,Asia,0,0
KOR,2020-03,1,0,South Korea,51269183,Asia,1,0
KOR,2020-04,3,0,South Korea,51269183,Asia,4,0
KOR,2020-05,11,0,South Korea,51269183,Asia,15,0
KOR,2020-06,12,0,South Korea,51269183,Asia,27,0
KOR,2020-07,3,0,South Korea,51269183,Asia,30,0
KOR,2020-08,732,7,South Korea,51269183,Asia,762,7
KOR,2020-09,3450,15,South Korea,51269183,Asia,4212,22
KOR,2020-10,3170,29,South Korea,51269183,Asia,7382,51
KOR,2020-11,854,24,South Korea,51269183,Asia,8236,75
KOR,2020-12,725,38,South Korea,51269183,Asia,8961,113
KOR,2020-13,700,45,South Korea,51269183,Asia,9661,158
KOR,2020-14,623,28,South Korea,51269183,Asia,10284,186
KOR,2020-15,253,31,South Korea,51269183,Asia,10537,217
KOR,2020-16,137,19,South Korea,51269183,Asia,10674,236
KOR,2020-17,64,7,South Korea,51269183,Asia,10738,243
KOR,2020-18,63,9,South Korea,51269183,Asia,10801,252
KOR,2020-19,108,4,South Korea,51269183,Asia,10909,256
KOR,2020-20,156,7,South Korea,51269183,Asia,11065,263
KOR,2020-21,141,4,South Korea,51269183,Asia,11206,267
KOR,2020-22,297,4,South Korea,51269183,Asia,11503,271
KOR,2020-23,311,2,South Korea,51269183,Asia,11814,273
KOR,2020-24,307,4,South Korea,51269183,Asia,12121,277
KOR,2020-25,317,3,South Korea,51269183,Asia,12438,280
KOR,2020-26,319,2,South Korea,51269183,Asia,12757,282
KOR,2020-27,334,1,South Korea,51269183,Asia,13091,283
KOR,2020-28,388,6,South Korea,51269183,Asia,13479,289
KOR,2020-29,292,7,South Korea,51269183,Asia,13771,296
KOR,2020-30,404,3,South Korea,51269183,Asia,14175,299
KOR,2020-31,214,2,South Korea,51269183,Asia,14389,301
KOR,2020-32,237,4,South Korea,51269183,Asia,14626,305
KOR,2020-33,889,0,South Korea,51269183,Asia,15515,305
KOR,2020-34,2150,4,South Korea,51269183,Asia,17665,309
KOR,2020-35,2282,15,South Korea,51269183,Asia,19947,324
KOR,2020-36,1349,12,South Korea,51269183,Asia,21296,336
KOR,2020-37,989,27,South Korea,51269183,Asia,22285,363
KOR,2020-38,760,22,South Korea,51269183,Asia,23045,385
KOR,2020-39,616,21,South Korea,51269183,Asia,23661,406
KOR,2020-40,503,16,South Korea,51269183,Asia,24164,422
KOR,2020-41,539,11,South Korea,51269183,Asia,24703,433
KOR,2020-42,572,11,South Korea,51269183,Asia,25275,444
KOR,2020-43,680,13,South Korea,51269183,Asia,25955,457
KOR,2020-44,777,11,South Korea,51269183,Asia,26732,468
KOR,2020-45,821,12,South Korea,51269183,Asia,27553,480
KOR,2020-46,1216,14,South Korea,51269183,Asia,28769,494
KOR,2020-47,2235,15,South Korea,51269183,Asia,31004,509
KOR,2020-48,3197,17,South Korea,51269183,Asia,34201,526
KOR,2020-49,3960,23,South Korea,51269183,Asia,38161,549
KOR,2020-50,5323,38,South Korea,51269183,Asia,43484,587
KOR,2020-51,7107,111,South Korea,51269183,Asia,50591,698
KOR,2020-52,7089,121,South Korea,51269183,Asia,57680,819
KOR,2020-53,6584,162,South Korea,51269183,Asia,64264,981
KOR,2021-01,4850,159,South Korea,51269183,Asia,69114,1140
KOR,2021-02,3615,124,South Korea,51269183,Asia,72729,1264
KOR,2021-03,2792,96,South Korea,51269183,Asia,75521,1360
KOR,2021-04,2987,65,South Korea,51269183,Asia,78508,1425
KOR,2021-05,2677,49,South Korea,51269183,Asia,81185,1474
KOR,2021-06,2684,53,South Korea,51269183,Asia,83869,1527
KOR,2021-07,3455,35,South Korea,51269183,Asia,87324,1562
KOR,2021-08,2705,43,South Korea,51269183,Asia,90029,1605
KOR,2021-09,2788,37,South Korea,51269183,Asia,92817,1642
KOR,2021-10,3200,33,South Korea,51269183,Asia,96017,1675
KOR,2021-11,3058,22,South Korea,51269183,Asia,99075,1697
KOR,2021-12,3066,29,South Korea,51269183,Asia,102141,1726
KOR,2021-13,3611,22,South Korea,51269183,Asia,105752,1748
KOR,2021-14,4394,22,South Korea,51269183,Asia,110146,1770
KOR,2021-15,4500,31,South Korea,51269183,Asia,114646,1801
KOR,2021-16,4741,16,South Korea,51269183,Asia,119387,1817
KOR,2021-17,4341,17,South Korea,51269183,Asia,123728,1834
KOR,2021-18,4044,41,South Korea,51269183,Asia,127772,1875
KOR,2021-19,4518,28,South Korea,51269183,Asia,132290,1903
KOR,2021-20,4177,31,South Korea,51269183,Asia,136467,1934
KOR,2021-21,3873,25,South Korea,51269183,Asia,140340,1959
KOR,2021-22,4297,15,South Korea,51269183,Asia,144637,1974
KOR,2021-23,3636,14,South Korea,51269183,Asia,148273,1988
KOR,2021-24,3233,16,South Korea,51269183,Asia,151506,2004
KOR,2021-25,4066,11,South Korea,51269183,Asia,155572,2015
KOR,2021-26,5223,13,South Korea,51269183,Asia,160795,2028
KOR,2021-27,8351,16,South Korea,51269183,Asia,169146,2044
KOR,2021-28,10057,14,South Korea,51269183,Asia,179203,2058
KOR,2021-29,10963,19,South Korea,51269183,Asia,190166,2077
KOR,2021-30,10836,22,South Korea,51269183,Asia,201002,2099
KOR,2021-31,11446,26,South Korea,51269183,Asia,212448,2125
KOR,2021-32,13033,42,South Korea,51269183,Asia,225481,2167
KWT,2020-02,0,0,Kuwait,4270563,Asia,0,0
KWT,2020-03,0,0,Kuwait,4270563,Asia,0,0
KWT,2020-04,0,0,Kuwait,4270563,Asia,0,0
KWT,2020-05,0,0,Kuwait,4270563,Asia,0,0
KWT,2020-06,0,0,Kuwait,4270563,Asia,0,0
KWT,2020-07,0,0,Kuwait,4270563,Asia,0,0
KWT,2020-08,3,0,Kuwait,4270563,Asia,3,0
KWT,2020-09,43,0,Kuwait,4270563,Asia,46,0
KWT,2020-10,18,0,Kuwait,4270563,Asia,64,0
KWT,2020-11,48,0,Kuwait,4270563,Asia,112,0
KWT,2020-12,76,0,Kuwait,4270563,Asia,188,0
KWT,2020-13,67,0,Kuwait,4270563,Asia,255,0
KWT,2020-14,301,1,Kuwait,4270563,Asia,556,1
KWT,2020-15,678,0,Kuwait,4270563,Asia,1234,1
KWT,2020-16,681,6,Kuwait,4270563,Asia,1915,7
KWT,2020-17,1160,13,Kuwait,4270563,Asia,3075,20
KWT,2020-18,1908,18,Kuwait,4270563,Asia,4983,38
KWT,2020-19,3705,20,Kuwait,4270563,Asia,8688,58
KWT,2020-20,6162,54,Kuwait,4270563,Asia,14850,112
KWT,2020-21,6452,44,Kuwait,4270563,Asia,21302,156
KWT,2020-22,5741,56,Kuwait,4270563,Asia,27043,212
KWT,2020-23,4805,52,Kuwait,4270563,Asia,31848,264
KWT,2020-24,4072,32,Kuwait,4270563,Asia,35920,296
KWT,2020-25,3730,30,Kuwait,4270563,Asia,39650,326
KWT,2020-26,5292,22,Kuwait,4270563,Asia,44942,348
KWT,2020-27,4999,20,Kuwait,4270563,Asia,49941,368
KWT,2020-28,4953,22,Kuwait,4270563,Asia,54894,390
KWT,2020-29,4310,18,Kuwait,4270563,Asia,59204,408
KWT,2020-30,4569,25,Kuwait,4270563,Asia,63773,433
KWT,2020-31,4138,24,Kuwait,4270563,Asia,67911,457
KWT,2020-32,3802,21,Kuwait,4270563,Asia,71713,478
KWT,2020-33,4492,23,Kuwait,4270563,Asia,76205,501
KWT,2020-34,4323,14,Kuwait,4270563,Asia,80528,515
KWT,2020-35,4108,15,Kuwait,4270563,Asia,84636,530
KWT,2020-36,4946,14,Kuwait,4270563,Asia,89582,544
KWT,2020-37,5182,16,Kuwait,4270563,Asia,94764,560
KWT,2020-38,4670,24,Kuwait,4270563,Asia,99434,584
KWT,2020-39,4110,17,Kuwait,4270563,Asia,103544,601
KWT,2020-40,3481,23,Kuwait,4270563,Asia,107025,624
KWT,2020-41,4091,34,Kuwait,4270563,Asia,111116,658
KWT,2020-42,5030,43,Kuwait,4270563,Asia,116146,701
KWT,2020-43,5489,45,Kuwait,4270563,Asia,121635,746
KWT,2020-44,4899,36,Kuwait,4270563,Asia,126534,782
KWT,2020-45,5209,29,Kuwait,4270563,Asia,131743,811
KWT,2020-46,5097,27,Kuwait,4270563,Asia,136840,838
KWT,2020-47,3216,28,Kuwait,4270563,Asia,140056,866
KWT,2020-48,2370,12,Kuwait,4270563,Asia,142426,878
KWT,2020-49,1943,13,Kuwait,4270563,Asia,144369,891
KWT,2020-50,1849,20,Kuwait,4270563,Asia,146218,911
KWT,2020-51,1761,10,Kuwait,4270563,Asia,147979,921
KWT,2020-52,1674,10,Kuwait,4270563,Asia,149653,931
KWT,2020-53,1690,6,Kuwait,4270563,Asia,151343,937
KWT,2021-01,2971,6,Kuwait,4270563,Asia,154314,943
KWT,2021-02,3463,4,Kuwait,4270563,Asia,157777,947
KWT,2021-03,3508,5,Kuwait,4270563,Asia,161285,952
KWT,2021-04,3972,7,Kuwait,4270563,Asia,165257,959
KWT,2021-05,5741,7,Kuwait,4270563,Asia,170998,966
KWT,2021-06,6703,37,Kuwait,4270563,Asia,177701,1003
KWT,2021-07,6389,41,Kuwait,4270563,Asia,184090,1044
KWT,2021-08,6762,39,Kuwait,4270563,Asia,190852,1083
KWT,2021-09,9720,44,Kuwait,4270563,Asia,200572,1127
KWT,2021-10,8951,45,Kuwait,4270563,Asia,209523,1172
KWT,2021-11,9602,54,Kuwait,4270563,Asia,219125,1226
KWT,2021-12,9174,60,Kuwait,4270563,Asia,228299,1286
KWT,2021-13,8893,67,Kuwait,4270563,Asia,237192,1353
KWT,2021-14,9902,54,Kuwait,4270563,Asia,247094,1407
KWT,2021-15,9893,41,Kuwait,4270563,Asia,256987,1448
KWT,2021-16,9962,68,Kuwait,4270563,Asia,266949,1516
KWT,2021-17,9637,62,Kuwait,4270563,Asia,276586,1578
KWT,2021-18,8482,67,Kuwait,4270563,Asia,285068,1645
KWT,2021-19,5733,42,Kuwait,4270563,Asia,290801,1687
KWT,2021-20,8414,47,Kuwait,4270563,Asia,299215,1734
KWT,2021-21,8597,37,Kuwait,4270563,Asia,307812,1771
KWT,2021-22,9385,24,Kuwait,4270563,Asia,317197,1795
KWT,2021-23,10766,25,Kuwait,4270563,Asia,327963,1820
KWT,2021-24,11069,50,Kuwait,4270563,Asia,339032,1870
KWT,2021-25,12449,63,Kuwait,4270563,Asia,351481,1933
KWT,2021-26,12191,84,Kuwait,4270563,Asia,363672,2017
KWT,2021-27,11922,100,Kuwait,4270563,Asia,375594,2117
KWT,2021-28,10168,104,Kuwait,4270563,Asia,385762,2221
KWT,2021-29,6855,63,Kuwait,4270563,Asia,392617,2284
KWT,2021-30,5921,44,Kuwait,4270563,Asia,398538,2328
KWT,2021-31,4811,41,Kuwait,4270563,Asia,403349,2369
KWT,2021-32,3191,20,Kuwait,4270563,Asia,406540,2389
LAO,2020-14,5,0,Laos,7275556,Asia,5,0
LAO,2020-15,8,0,Laos,7275556,Asia,13,0
LAO,2020-16,0,0,Laos,7275556,Asia,13,0
LAO,2020-17,0,0,Laos,7275556,Asia,13,0
LAO,2020-18,0,0,Laos,7275556,Asia,13,0
LAO,2020-19,0,0,Laos,7275556,Asia,13,0
LAO,2020-20,0,0,Laos,7275556,Asia,13,0
LAO,2020-21,0,0,Laos,7275556,Asia,13,0
LAO,2020-22,0,0,Laos,7275556,Asia,13,0
LAO,2020-23,0,0,Laos,7275556,Asia,13,0
LAO,2020-24,0,0,Laos,7275556,Asia,13,0
LAO,2020-25,0,0,Laos,7275556,Asia,13,0
LAO,2020-26,0,0,Laos,7275556,Asia,13,0
LAO,2020-27,0,0,Laos,7275556,Asia,13,0
LAO,2020-28,0,0,Laos,7275556,Asia,13,0
LAO,2020-29,0,0,Laos,7275556,Asia,13,0
LAO,2020-30,1,0,Laos,7275556,Asia,14,0
LAO,2020-31,0,0,Laos,7275556,Asia,14,0
LAO,2020-32,0,0,Laos,7275556,Asia,14,0
LAO,2020-33,0,0,Laos,7275556,Asia,14,0
LAO,2020-34,2,0,Laos,7275556,Asia,16,0
LAO,2020-35,0,0,Laos,7275556,Asia,16,0
LAO,2020-36,0,0,Laos,7275556,Asia,16,0
LAO,2020-37,1,0,Laos,7275556,Asia,17,0
LAO,2020-38,0,0,Laos,7275556,Asia,17,0
LAO,2020-39,0,0,Laos,7275556,Asia,17,0
LAO,2020-40,0,0,Laos,7275556,Asia,17,0
LAO,2020-41,0,0,Laos,7275556,Asia,17,0
LAO,2020-42,0,0,Laos,7275556,Asia,17,0
LAO,2020-43,1,0,Laos,7275556,Asia,18,0
LAO,2020-44,0,0,Laos,7275556,Asia,18,0
LAO,2020-45,0,0,Laos,7275556,Asia,18,0
LAO,2020-46,0,0,Laos,7275556,Asia,18,0
LAO,2020-47,0,0,Laos,7275556,Asia,18,0
LAO,2020-48,15,0,Laos,7275556,Asia,33,0
LAO,2020-49,2,0,Laos,7275556,Asia,35,0
LAO,2020-50,0,0,Laos,7275556,Asia,35,0
LAO,2020-51,0,0,Laos,7275556,Asia,35,0
LAO,2020-52,0,0,Laos,7275556,Asia,35,0
LAO,2020-53,0,0,Laos,7275556,Asia,35,0
LAO,2021-01,0,0,Laos,7275556,Asia,35,0
LAO,2021-02,0,0,Laos,7275556,Asia,35,0
LAO,2021-03,3,0,Laos,7275556,Asia,38,0
LAO,2021-04,0,0,Laos,7275556,Asia,38,0
LAO,2021-05,1,0,Laos,7275556,Asia,39,0
LAO,2021-06,0,0,Laos,7275556,Asia,39,0
LAO,2021-07,0,0,Laos,7275556,Asia,39,0
LAO,2021-08,0,0,Laos,7275556,Asia,39,0
LAO,2021-09,2,0,Laos,7275556,Asia,41,0
LAO,2021-10,2,0,Laos,7275556,Asia,43,0
LAO,2021-11,0,0,Laos,7275556,Asia,43,0
LAO,2021-12,0,0,Laos,7275556,Asia,43,0
LAO,2021-13,0,0,Laos,7275556,Asia,43,0
LAO,2021-14,3,0,Laos,7275556,Asia,46,0
LAO,2021-15,6,0,Laos,7275556,Asia,52,0
LAO,2021-16,265,0,Laos,7275556,Asia,317,0
LAO,2021-17,643,0,Laos,7275556,Asia,960,0
LAO,2021-18,336,1,Laos,7275556,Asia,1296,1
LAO,2021-19,289,1,Laos,7275556,Asia,1585,2
LAO,2021-20,210,0,Laos,7275556,Asia,1795,2
LAO,2021-21,111,1,Laos,7275556,Asia,1906,3
LAO,2021-22,56,0,Laos,7275556,Asia,1962,3
LAO,2021-23,42,0,Laos,7275556,Asia,2004,3
LAO,2021-24,43,0,Laos,7275556,Asia,2047,3
LAO,2021-25,57,0,Laos,7275556,Asia,2104,3
LAO,2021-26,134,0,Laos,7275556,Asia,2238,3
LAO,2021-27,581,0,Laos,7275556,Asia,2819,3
LAO,2021-28,362,1,Laos,7275556,Asia,3181,4
LAO,2021-29,1798,1,Laos,7275556,Asia,4979,5
LAO,2021-30,1581,2,Laos,7275556,Asia,6560,7
LAO,2021-31,1566,1,Laos,7275556,Asia,8126,8
LAO,2021-32,1960,1,Laos,7275556,Asia,10086,9
LBN,2020-02,0,0,Lebanon,6825442,Asia,0,0
LBN,2020-03,0,0,Lebanon,6825442,Asia,0,0
LBN,2020-04,0,0,Lebanon,6825442,Asia,0,0
LBN,2020-05,0,0,Lebanon,6825442,Asia,0,0
LBN,2020-06,0,0,Lebanon,6825442,Asia,0,0
LBN,2020-07,0,0,Lebanon,6825442,Asia,0,0
LBN,2020-08,1,0,Lebanon,6825442,Asia,1,0
LBN,2020-09,9,0,Lebanon,6825442,Asia,10,0
LBN,2020-10,22,0,Lebanon,6825442,Asia,32,0
LBN,2020-11,67,3,Lebanon,6825442,Asia,99,3
LBN,2020-12,149,1,Lebanon,6825442,Asia,248,4
LBN,2020-13,190,6,Lebanon,6825442,Asia,438,10
LBN,2020-14,89,8,Lebanon,6825442,Asia,527,18
LBN,2020-15,103,2,Lebanon,6825442,Asia,630,20
LBN,2020-16,43,1,Lebanon,6825442,Asia,673,21
LBN,2020-17,34,3,Lebanon,6825442,Asia,707,24
LBN,2020-18,30,1,Lebanon,6825442,Asia,737,25
LBN,2020-19,108,1,Lebanon,6825442,Asia,845,26
LBN,2020-20,66,0,Lebanon,6825442,Asia,911,26
LBN,2020-21,203,0,Lebanon,6825442,Asia,1114,26
LBN,2020-22,106,1,Lebanon,6825442,Asia,1220,27
LBN,2020-23,111,3,Lebanon,6825442,Asia,1331,30
LBN,2020-24,115,2,Lebanon,6825442,Asia,1446,32
LBN,2020-25,141,0,Lebanon,6825442,Asia,1587,32
LBN,2020-26,153,2,Lebanon,6825442,Asia,1740,34
LBN,2020-27,133,2,Lebanon,6825442,Asia,1873,36
LBN,2020-28,461,0,Lebanon,6825442,Asia,2334,36
LBN,2020-29,525,4,Lebanon,6825442,Asia,2859,40
LBN,2020-30,891,11,Lebanon,6825442,Asia,3750,51
LBN,2020-31,1135,11,Lebanon,6825442,Asia,4885,62
LBN,2020-32,1632,14,Lebanon,6825442,Asia,6517,76
LBN,2020-33,2364,27,Lebanon,6825442,Asia,8881,103
LBN,2020-34,3310,18,Lebanon,6825442,Asia,12191,121
LBN,2020-35,4679,39,Lebanon,6825442,Asia,16870,160
LBN,2020-36,3556,31,Lebanon,6825442,Asia,20426,191
LBN,2020-37,3884,50,Lebanon,6825442,Asia,24310,241
LBN,2020-38,4993,56,Lebanon,6825442,Asia,29303,297
LBN,2020-39,6951,50,Lebanon,6825442,Asia,36254,347
LBN,2020-40,8228,59,Lebanon,6825442,Asia,44482,406
LBN,2020-41,8076,49,Lebanon,6825442,Asia,52558,455
LBN,2020-42,9728,65,Lebanon,6825442,Asia,62286,520
LBN,2020-43,9104,45,Lebanon,6825442,Asia,71390,565
LBN,2020-44,11227,78,Lebanon,6825442,Asia,82617,643
LBN,2020-45,11619,80,Lebanon,6825442,Asia,94236,723
LBN,2020-46,11194,94,Lebanon,6825442,Asia,105430,817
LBN,2020-47,11046,83,Lebanon,6825442,Asia,116476,900
LBN,2020-48,10468,104,Lebanon,6825442,Asia,126944,1004
LBN,2020-49,10209,95,Lebanon,6825442,Asia,137153,1099
LBN,2020-50,9367,101,Lebanon,6825442,Asia,146520,1200
LBN,2020-51,11584,81,Lebanon,6825442,Asia,158104,1281
LBN,2020-52,13122,113,Lebanon,6825442,Asia,171226,1394
LBN,2020-53,18052,105,Lebanon,6825442,Asia,189278,1499
LBN,2021-01,30018,107,Lebanon,6825442,Asia,219296,1606
LBN,2021-02,33516,259,Lebanon,6825442,Asia,252812,1865
LBN,2021-03,26785,455,Lebanon,6825442,Asia,279597,2320
LBN,2021-04,21455,762,Lebanon,6825442,Asia,301052,3082
LBN,2021-05,18865,534,Lebanon,6825442,Asia,319917,3616
LBN,2021-06,19205,377,Lebanon,6825442,Asia,339122,3993
LBN,2021-07,15951,347,Lebanon,6825442,Asia,355073,4340
LBN,2021-08,19977,352,Lebanon,6825442,Asia,375050,4692
LBN,2021-09,20554,354,Lebanon,6825442,Asia,395604,5046
LBN,2021-10,22844,334,Lebanon,6825442,Asia,418448,5380
LBN,2021-11,21120,377,Lebanon,6825442,Asia,439568,5757
LBN,2021-12,21494,339,Lebanon,6825442,Asia,461062,6096
LBN,2021-13,18439,313,Lebanon,6825442,Asia,479501,6409
LBN,2021-14,17345,252,Lebanon,6825442,Asia,496846,6661
LBN,2021-15,13557,264,Lebanon,6825442,Asia,510403,6925
LBN,2021-16,10536,217,Lebanon,6825442,Asia,520939,7142
LBN,2021-17,7269,182,Lebanon,6825442,Asia,528208,7324
LBN,2021-18,4631,162,Lebanon,6825442,Asia,532839,7486
LBN,2021-19,2914,134,Lebanon,6825442,Asia,535753,7620
LBN,2021-20,2765,57,Lebanon,6825442,Asia,538518,7677
LBN,2021-21,1759,46,Lebanon,6825442,Asia,540277,7723
LBN,2021-22,1280,40,Lebanon,6825442,Asia,541557,7763
LBN,2021-23,818,27,Lebanon,6825442,Asia,542375,7790
LBN,2021-24,274,11,Lebanon,6825442,Asia,542649,7801
LBN,2021-25,1642,40,Lebanon,6825442,Asia,544291,7841
LBN,2021-26,1072,18,Lebanon,6825442,Asia,545363,7859
LBN,2021-27,3092,20,Lebanon,6825442,Asia,548455,7879
LBN,2021-28,2487,6,Lebanon,6825442,Asia,550942,7885
LBN,2021-29,4360,7,Lebanon,6825442,Asia,555302,7892
LBN,2021-30,3067,5,Lebanon,6825442,Asia,558369,7897
LBN,2021-31,13281,46,Lebanon,6825442,Asia,571650,7943
LBN,2021-32,4900,15,Lebanon,6825442,Asia,576550,7958
LBR,2020-13,0,0,Liberia,5057677,Africa,0,0
LBR,2020-14,10,3,Liberia,5057677,Africa,10,3
LBR,2020-15,37,2,Liberia,5057677,Africa,47,5
LBR,2020-16,41,3,Liberia,5057677,Africa,88,8
LBR,2020-17,33,4,Liberia,5057677,Africa,121,12
LBR,2020-18,34,6,Liberia,5057677,Africa,155,18
LBR,2020-19,41,2,Liberia,5057677,Africa,196,20
LBR,2020-20,27,1,Liberia,5057677,Africa,223,21
LBR,2020-21,39,5,Liberia,5057677,Africa,262,26
LBR,2020-22,23,1,Liberia,5057677,Africa,285,27
LBR,2020-23,71,3,Liberia,5057677,Africa,356,30
LBR,2020-24,99,2,Liberia,5057677,Africa,455,32
LBR,2020-25,168,2,Liberia,5057677,Africa,623,34
LBR,2020-26,142,0,Liberia,5057677,Africa,765,34
LBR,2020-27,106,3,Liberia,5057677,Africa,871,37
LBR,2020-28,136,14,Liberia,5057677,Africa,1007,51
LBR,2020-29,81,19,Liberia,5057677,Africa,1088,70
LBR,2020-30,71,2,Liberia,5057677,Africa,1159,72
LBR,2020-31,45,5,Liberia,5057677,Africa,1204,77
LBR,2020-32,30,2,Liberia,5057677,Africa,1234,79
LBR,2020-33,20,3,Liberia,5057677,Africa,1254,82
LBR,2020-34,29,0,Liberia,5057677,Africa,1283,82
LBR,2020-35,18,0,Liberia,5057677,Africa,1301,82
LBR,2020-36,3,0,Liberia,5057677,Africa,1304,82
LBR,2020-37,12,0,Liberia,5057677,Africa,1316,82
LBR,2020-38,16,0,Liberia,5057677,Africa,1332,82
LBR,2020-39,4,0,Liberia,5057677,Africa,1336,82
LBR,2020-40,9,0,Liberia,5057677,Africa,1345,82
LBR,2020-41,15,0,Liberia,5057677,Africa,1360,82
LBR,2020-42,14,0,Liberia,5057677,Africa,1374,82
LBR,2020-43,16,0,Liberia,5057677,Africa,1390,82
LBR,2020-44,33,0,Liberia,5057677,Africa,1423,82
LBR,2020-45,16,0,Liberia,5057677,Africa,1439,82
LBR,2020-46,65,0,Liberia,5057677,Africa,1504,82
LBR,2020-47,44,0,Liberia,5057677,Africa,1548,82
LBR,2020-48,44,1,Liberia,5057677,Africa,1592,83
LBR,2020-49,81,0,Liberia,5057677,Africa,1673,83
LBR,2020-50,95,0,Liberia,5057677,Africa,1768,83
LBR,2020-51,17,0,Liberia,5057677,Africa,1785,83
LBR,2020-52,12,0,Liberia,5057677,Africa,1797,83
LBR,2020-53,0,0,Liberia,5057677,Africa,1797,83
LBR,2021-01,0,0,Liberia,5057677,Africa,1797,83
LBR,2021-02,87,1,Liberia,5057677,Africa,1884,84
LBR,2021-03,27,0,Liberia,5057677,Africa,1911,84
LBR,2021-04,25,0,Liberia,5057677,Africa,1936,84
LBR,2021-05,17,0,Liberia,5057677,Africa,1953,84
LBR,2021-06,13,0,Liberia,5057677,Africa,1966,84
LBR,2021-07,19,1,Liberia,5057677,Africa,1985,85
LBR,2021-08,22,0,Liberia,5057677,Africa,2007,85
LBR,2021-09,16,0,Liberia,5057677,Africa,2023,85
LBR,2021-10,4,0,Liberia,5057677,Africa,2027,85
LBR,2021-11,12,0,Liberia,5057677,Africa,2039,85
LBR,2021-12,11,0,Liberia,5057677,Africa,2050,85
LBR,2021-13,8,0,Liberia,5057677,Africa,2058,85
LBR,2021-14,5,0,Liberia,5057677,Africa,2063,85
LBR,2021-15,5,0,Liberia,5057677,Africa,2068,85
LBR,2021-16,15,0,Liberia,5057677,Africa,2083,85
LBR,2021-17,13,0,Liberia,5057677,Africa,2096,85
LBR,2021-18,18,0,Liberia,5057677,Africa,2114,85
LBR,2021-19,11,0,Liberia,5057677,Africa,2125,85
LBR,2021-20,14,0,Liberia,5057677,Africa,2139,85
LBR,2021-21,37,1,Liberia,5057677,Africa,2176,86
LBR,2021-22,111,2,Liberia,5057677,Africa,2287,88
LBR,2021-23,245,5,Liberia,5057677,Africa,2532,93
LBR,2021-24,460,2,Liberia,5057677,Africa,2992,95
LBR,2021-25,741,25,Liberia,5057677,Africa,3733,120
LBR,2021-26,784,13,Liberia,5057677,Africa,4517,133
LBR,2021-27,695,11,Liberia,5057677,Africa,5212,144
LBR,2021-28,181,4,Liberia,5057677,Africa,5393,148
LBR,2021-29,8,0,Liberia,5057677,Africa,5401,148
LBR,2021-30,55,0,Liberia,5057677,Africa,5456,148
LBR,2021-31,2,72,Liberia,5057677,Africa,5458,220
LBR,2021-32,21,1,Liberia,5057677,Africa,5479,221
LBY,2020-14,10,1,Libya,6871287,Africa,10,1
LBY,2020-15,7,0,Libya,6871287,Africa,17,1
LBY,2020-16,24,0,Libya,6871287,Africa,41,1
LBY,2020-17,12,1,Libya,6871287,Africa,53,2
LBY,2020-18,2,1,Libya,6871287,Africa,55,3
LBY,2020-19,1,0,Libya,6871287,Africa,56,3
LBY,2020-20,1,0,Libya,6871287,Africa,57,3
LBY,2020-21,10,0,Libya,6871287,Africa,67,3
LBY,2020-22,81,2,Libya,6871287,Africa,148,5
LBY,2020-23,100,0,Libya,6871287,Africa,248,5
LBY,2020-24,162,3,Libya,6871287,Africa,410,8
LBY,2020-25,126,2,Libya,6871287,Africa,536,10
LBY,2020-26,218,11,Libya,6871287,Africa,754,21
LBY,2020-27,227,6,Libya,6871287,Africa,981,27
LBY,2020-28,444,12,Libya,6871287,Africa,1425,39
LBY,2020-29,433,9,Libya,6871287,Africa,1858,48
LBY,2020-30,681,10,Libya,6871287,Africa,2539,58
LBY,2020-31,1144,22,Libya,6871287,Africa,3683,80
LBY,2020-32,1541,33,Libya,6871287,Africa,5224,113
LBY,2020-33,2506,32,Libya,6871287,Africa,7730,145
LBY,2020-34,2699,43,Libya,6871287,Africa,10429,188
LBY,2020-35,2986,44,Libya,6871287,Africa,13415,232
LBY,2020-36,4326,53,Libya,6871287,Africa,17741,285
LBY,2020-37,5032,77,Libya,6871287,Africa,22773,362
LBY,2020-38,5168,76,Libya,6871287,Africa,27941,438
LBY,2020-39,4415,82,Libya,6871287,Africa,32356,520
LBY,2020-40,4445,72,Libya,6871287,Africa,36801,592
LBY,2020-41,5903,39,Libya,6871287,Africa,42704,631
LBY,2020-42,6078,94,Libya,6871287,Africa,48782,725
LBY,2020-43,7223,70,Libya,6871287,Africa,56005,795
LBY,2020-44,6032,76,Libya,6871287,Africa,62037,871
LBY,2020-45,6072,58,Libya,6871287,Africa,68109,929
LBY,2020-46,5485,88,Libya,6871287,Africa,73594,1017
LBY,2020-47,4221,72,Libya,6871287,Africa,77815,1089
LBY,2020-48,4607,77,Libya,6871287,Africa,82422,1166
LBY,2020-49,4150,65,Libya,6871287,Africa,86572,1231
LBY,2020-50,4199,68,Libya,6871287,Africa,90771,1299
LBY,2020-51,4421,70,Libya,6871287,Africa,95192,1369
LBY,2020-52,3181,67,Libya,6871287,Africa,98373,1436
LBY,2020-53,3594,90,Libya,6871287,Africa,101967,1526
LBY,2021-01,3403,63,Libya,6871287,Africa,105370,1589
LBY,2021-02,4491,109,Libya,6871287,Africa,109861,1698
LBY,2021-03,5430,91,Libya,6871287,Africa,115291,1789
LBY,2021-04,4103,94,Libya,6871287,Africa,119394,1883
LBY,2021-05,4624,70,Libya,6871287,Africa,124018,1953
LBY,2021-06,3328,65,Libya,6871287,Africa,127346,2018
LBY,2021-07,2858,98,Libya,6871287,Africa,130204,2116
LBY,2021-08,3915,94,Libya,6871287,Africa,134119,2210
LBY,2021-09,5531,78,Libya,6871287,Africa,139650,2288
LBY,2021-10,5335,98,Libya,6871287,Africa,144985,2386
LBY,2021-11,7517,127,Libya,6871287,Africa,152502,2513
LBY,2021-12,5035,140,Libya,6871287,Africa,157537,2653
LBY,2021-13,5897,104,Libya,6871287,Africa,163434,2757
LBY,2021-14,4383,66,Libya,6871287,Africa,167817,2823
LBY,2021-15,4639,85,Libya,6871287,Africa,172456,2908
LBY,2021-16,3289,97,Libya,6871287,Africa,175745,3005
LBY,2021-17,2582,42,Libya,6871287,Africa,178327,3047
LBY,2021-18,1891,25,Libya,6871287,Africa,180218,3072
LBY,2021-19,1488,20,Libya,6871287,Africa,181706,3092
LBY,2021-20,1878,20,Libya,6871287,Africa,183584,3112
LBY,2021-21,2184,14,Libya,6871287,Africa,185768,3126
LBY,2021-22,1909,20,Libya,6871287,Africa,187677,3146
LBY,2021-23,1599,19,Libya,6871287,Africa,189276,3165
LBY,2021-24,1754,13,Libya,6871287,Africa,191030,3178
LBY,2021-25,1748,13,Libya,6871287,Africa,192778,3191
LBY,2021-26,3038,22,Libya,6871287,Africa,195816,3213
LBY,2021-27,8266,27,Libya,6871287,Africa,204082,3240
LBY,2021-28,20830,59,Libya,6871287,Africa,224912,3299
LBY,2021-29,12041,99,Libya,6871287,Africa,236953,3398
LBY,2021-30,19367,181,Libya,6871287,Africa,256320,3579
LBY,2021-31,13519,171,Libya,6871287,Africa,269839,3750
LBY,2021-32,17047,206,Libya,6871287,Africa,286886,3956
LCA,2020-12,0,0,Saint Lucia,183629,America,0,0
LCA,2020-13,7,0,Saint Lucia,183629,America,7,0
LCA,2020-14,5,0,Saint Lucia,183629,America,12,0
LCA,2020-15,1,0,Saint Lucia,183629,America,13,0
LCA,2020-16,0,0,Saint Lucia,183629,America,13,0
LCA,2020-17,0,0,Saint Lucia,183629,America,13,0
LCA,2020-18,3,0,Saint Lucia,183629,America,16,0
LCA,2020-19,0,0,Saint Lucia,183629,America,16,0
LCA,2020-20,0,0,Saint Lucia,183629,America,16,0
LCA,2020-21,0,0,Saint Lucia,183629,America,16,0
LCA,2020-22,0,0,Saint Lucia,183629,America,16,0
LCA,2020-23,1,0,Saint Lucia,183629,America,17,0
LCA,2020-24,0,0,Saint Lucia,183629,America,17,0
LCA,2020-25,0,0,Saint Lucia,183629,America,17,0
LCA,2020-26,0,0,Saint Lucia,183629,America,17,0
LCA,2020-27,3,0,Saint Lucia,183629,America,20,0
LCA,2020-28,0,0,Saint Lucia,183629,America,20,0
LCA,2020-29,1,0,Saint Lucia,183629,America,21,0
LCA,2020-30,1,0,Saint Lucia,183629,America,22,0
LCA,2020-31,1,0,Saint Lucia,183629,America,23,0
LCA,2020-32,0,0,Saint Lucia,183629,America,23,0
LCA,2020-33,0,0,Saint Lucia,183629,America,23,0
LCA,2020-34,1,0,Saint Lucia,183629,America,24,0
LCA,2020-35,0,0,Saint Lucia,183629,America,24,0
LCA,2020-36,0,0,Saint Lucia,183629,America,24,0
LCA,2020-37,1,0,Saint Lucia,183629,America,25,0
LCA,2020-38,0,0,Saint Lucia,183629,America,25,0
LCA,2020-39,0,0,Saint Lucia,183629,America,25,0
LCA,2020-40,0,0,Saint Lucia,183629,America,25,0
LCA,2020-41,2,0,Saint Lucia,183629,America,27,0
LCA,2020-42,4,0,Saint Lucia,183629,America,31,0
LCA,2020-43,21,0,Saint Lucia,183629,America,52,0
LCA,2020-44,30,0,Saint Lucia,183629,America,82,0
LCA,2020-45,47,0,Saint Lucia,183629,America,129,0
LCA,2020-46,40,2,Saint Lucia,183629,America,169,2
LCA,2020-47,49,0,Saint Lucia,183629,America,218,2
LCA,2020-48,37,0,Saint Lucia,183629,America,255,2
LCA,2020-49,8,0,Saint Lucia,183629,America,263,2
LCA,2020-50,10,2,Saint Lucia,183629,America,273,4
LCA,2020-51,12,1,Saint Lucia,183629,America,285,5
LCA,2020-52,18,0,Saint Lucia,183629,America,303,5
LCA,2020-53,48,0,Saint Lucia,183629,America,351,5
LCA,2021-01,85,0,Saint Lucia,183629,America,436,5
LCA,2021-02,173,3,Saint Lucia,183629,America,609,8
LCA,2021-03,310,5,Saint Lucia,183629,America,919,13
LCA,2021-04,490,2,Saint Lucia,183629,America,1409,15
LCA,2021-05,616,4,Saint Lucia,183629,America,2025,19
LCA,2021-06,492,4,Saint Lucia,183629,America,2517,23
LCA,2021-07,623,9,Saint Lucia,183629,America,3140,32
LCA,2021-08,248,4,Saint Lucia,183629,America,3388,36
LCA,2021-09,481,10,Saint Lucia,183629,America,3869,46
LCA,2021-10,182,9,Saint Lucia,183629,America,4051,55
LCA,2021-11,68,0,Saint Lucia,183629,America,4119,55
LCA,2021-12,70,3,Saint Lucia,183629,America,4189,58
LCA,2021-13,82,3,Saint Lucia,183629,America,4271,61
LCA,2021-14,82,3,Saint Lucia,183629,America,4353,64
LCA,2021-15,46,3,Saint Lucia,183629,America,4399,67
LCA,2021-16,101,6,Saint Lucia,183629,America,4500,73
LCA,2021-17,58,1,Saint Lucia,183629,America,4558,74
LCA,2021-18,130,1,Saint Lucia,183629,America,4688,75
LCA,2021-19,128,1,Saint Lucia,183629,America,4816,76
LCA,2021-20,127,1,Saint Lucia,183629,America,4943,77
LCA,2021-21,108,0,Saint Lucia,183629,America,5051,77
LCA,2021-22,80,3,Saint Lucia,183629,America,5131,80
LCA,2021-23,46,0,Saint Lucia,183629,America,5177,80
LCA,2021-24,37,0,Saint Lucia,183629,America,5214,80
LCA,2021-25,62,4,Saint Lucia,183629,America,5276,84
LCA,2021-26,48,1,Saint Lucia,183629,America,5324,85
LCA,2021-27,90,1,Saint Lucia,183629,America,5414,86
LCA,2021-28,65,1,Saint Lucia,183629,America,5479,87
LCA,2021-29,48,1,Saint Lucia,183629,America,5527,88
LCA,2021-30,103,1,Saint Lucia,183629,America,5630,89
LCA,2021-31,205,1,Saint Lucia,183629,America,5835,90
LCA,2021-32,529,5,Saint Lucia,183629,America,6364,95
LIE,2020-12,39,0,Liechtenstein,38747,Europe,39,0
LIE,2020-13,16,0,Liechtenstein,38747,Europe,55,0
LIE,2020-14,16,1,Liechtenstein,38747,Europe,71,1
LIE,2020-15,2,0,Liechtenstein,38747,Europe,73,1
LIE,2020-16,2,0,Liechtenstein,38747,Europe,75,1
LIE,2020-17,1,0,Liechtenstein,38747,Europe,76,1
LIE,2020-18,0,0,Liechtenstein,38747,Europe,76,1
LIE,2020-19,0,0,Liechtenstein,38747,Europe,76,1
LIE,2020-20,0,0,Liechtenstein,38747,Europe,76,1
LIE,2020-21,0,0,Liechtenstein,38747,Europe,76,1
LIE,2020-22,0,0,Liechtenstein,38747,Europe,76,1
LIE,2020-23,0,0,Liechtenstein,38747,Europe,76,1
LIE,2020-24,0,0,Liechtenstein,38747,Europe,76,1
LIE,2020-25,0,0,Liechtenstein,38747,Europe,76,1
LIE,2020-26,0,0,Liechtenstein,38747,Europe,76,1
LIE,2020-27,1,0,Liechtenstein,38747,Europe,77,1
LIE,2020-28,1,0,Liechtenstein,38747,Europe,78,1
LIE,2020-29,2,0,Liechtenstein,38747,Europe,80,1
LIE,2020-30,0,0,Liechtenstein,38747,Europe,80,1
LIE,2020-31,2,0,Liechtenstein,38747,Europe,82,1
LIE,2020-32,0,0,Liechtenstein,38747,Europe,82,1
LIE,2020-33,4,0,Liechtenstein,38747,Europe,86,1
LIE,2020-34,8,0,Liechtenstein,38747,Europe,94,1
LIE,2020-35,7,0,Liechtenstein,38747,Europe,101,1
LIE,2020-36,0,0,Liechtenstein,38747,Europe,101,1
LIE,2020-37,3,0,Liechtenstein,38747,Europe,104,1
LIE,2020-38,1,0,Liechtenstein,38747,Europe,105,1
LIE,2020-39,5,0,Liechtenstein,38747,Europe,110,1
LIE,2020-40,9,0,Liechtenstein,38747,Europe,119,1
LIE,2020-41,12,0,Liechtenstein,38747,Europe,131,1
LIE,2020-42,86,0,Liechtenstein,38747,Europe,217,1
LIE,2020-43,141,0,Liechtenstein,38747,Europe,358,1
LIE,2020-44,186,2,Liechtenstein,38747,Europe,544,3
LIE,2020-45,237,0,Liechtenstein,38747,Europe,781,3
LIE,2020-46,197,1,Liechtenstein,38747,Europe,978,4
LIE,2020-47,127,4,Liechtenstein,38747,Europe,1105,8
LIE,2020-48,161,7,Liechtenstein,38747,Europe,1266,15
LIE,2020-49,123,1,Liechtenstein,38747,Europe,1389,16
LIE,2020-50,118,2,Liechtenstein,38747,Europe,1507,18
LIE,2020-51,315,6,Liechtenstein,38747,Europe,1822,24
LIE,2020-52,263,3,Liechtenstein,38747,Europe,2085,27
LIE,2020-53,130,8,Liechtenstein,38747,Europe,2215,35
LIE,2021-01,124,14,Liechtenstein,38747,Europe,2339,49
LIE,2021-02,49,1,Liechtenstein,38747,Europe,2388,50
LIE,2021-03,59,2,Liechtenstein,38747,Europe,2447,52
LIE,2021-04,43,0,Liechtenstein,38747,Europe,2490,52
LIE,2021-05,29,0,Liechtenstein,38747,Europe,2519,52
LIE,2021-06,14,1,Liechtenstein,38747,Europe,2533,53
LIE,2021-07,10,1,Liechtenstein,38747,Europe,2543,54
LIE,2021-08,26,0,Liechtenstein,38747,Europe,2569,54
LIE,2021-09,18,1,Liechtenstein,38747,Europe,2587,55
LIE,2021-10,21,1,Liechtenstein,38747,Europe,2608,56
LIE,2021-11,19,0,Liechtenstein,38747,Europe,2627,56
LIE,2021-12,30,0,Liechtenstein,38747,Europe,2657,56
LIE,2021-13,33,0,Liechtenstein,38747,Europe,2690,56
LIE,2021-14,71,0,Liechtenstein,38747,Europe,2761,56
LIE,2021-15,68,0,Liechtenstein,38747,Europe,2829,56
LIE,2021-16,67,1,Liechtenstein,38747,Europe,2896,57
LIE,2021-17,45,0,Liechtenstein,38747,Europe,2941,57
LIE,2021-18,27,1,Liechtenstein,38747,Europe,2968,58
LIE,2021-19,17,0,Liechtenstein,38747,Europe,2985,58
LIE,2021-20,10,0,Liechtenstein,38747,Europe,2995,58
LIE,2021-21,10,0,Liechtenstein,38747,Europe,3005,58
LIE,2021-22,10,0,Liechtenstein,38747,Europe,3015,58
LIE,2021-23,4,1,Liechtenstein,38747,Europe,3019,59
LIE,2021-24,2,0,Liechtenstein,38747,Europe,3021,59
LIE,2021-25,6,0,Liechtenstein,38747,Europe,3027,59
LIE,2021-26,13,0,Liechtenstein,38747,Europe,3040,59
LIE,2021-27,11,0,Liechtenstein,38747,Europe,3051,59
LIE,2021-28,11,0,Liechtenstein,38747,Europe,3062,59
LIE,2021-29,11,0,Liechtenstein,38747,Europe,3073,59
LIE,2021-30,9,0,Liechtenstein,38747,Europe,3082,59
LIE,2021-31,18,0,Liechtenstein,38747,Europe,3100,59
LIE,2021-32,68,0,Liechtenstein,38747,Europe,3168,59
LKA,2020-02,0,0,Sri Lanka,21413250,Asia,0,0
LKA,2020-03,0,0,Sri Lanka,21413250,Asia,0,0
LKA,2020-04,0,0,Sri Lanka,21413250,Asia,0,0
LKA,2020-05,1,0,Sri Lanka,21413250,Asia,1,0
LKA,2020-06,0,0,Sri Lanka,21413250,Asia,1,0
LKA,2020-07,0,0,Sri Lanka,21413250,Asia,1,0
LKA,2020-08,0,0,Sri Lanka,21413250,Asia,1,0
LKA,2020-09,0,0,Sri Lanka,21413250,Asia,1,0
LKA,2020-10,0,0,Sri Lanka,21413250,Asia,1,0
LKA,2020-11,18,0,Sri Lanka,21413250,Asia,19,0
LKA,2020-12,68,0,Sri Lanka,21413250,Asia,87,0
LKA,2020-13,33,1,Sri Lanka,21413250,Asia,120,1
LKA,2020-14,46,4,Sri Lanka,21413250,Asia,166,5
LKA,2020-15,44,2,Sri Lanka,21413250,Asia,210,7
LKA,2020-16,85,0,Sri Lanka,21413250,Asia,295,7
LKA,2020-17,228,0,Sri Lanka,21413250,Asia,523,7
LKA,2020-18,195,0,Sri Lanka,21413250,Asia,718,7
LKA,2020-19,145,2,Sri Lanka,21413250,Asia,863,9
LKA,2020-20,118,0,Sri Lanka,21413250,Asia,981,9
LKA,2020-21,160,0,Sri Lanka,21413250,Asia,1141,9
LKA,2020-22,492,1,Sri Lanka,21413250,Asia,1633,10
LKA,2020-23,202,1,Sri Lanka,21413250,Asia,1835,11
LKA,2020-24,54,0,Sri Lanka,21413250,Asia,1889,11
LKA,2020-25,61,0,Sri Lanka,21413250,Asia,1950,11
LKA,2020-26,87,0,Sri Lanka,21413250,Asia,2037,11
LKA,2020-27,39,0,Sri Lanka,21413250,Asia,2076,11
LKA,2020-28,541,0,Sri Lanka,21413250,Asia,2617,11
LKA,2020-29,107,0,Sri Lanka,21413250,Asia,2724,11
LKA,2020-30,58,0,Sri Lanka,21413250,Asia,2782,11
LKA,2020-31,41,0,Sri Lanka,21413250,Asia,2823,11
LKA,2020-32,21,0,Sri Lanka,21413250,Asia,2844,11
LKA,2020-33,49,0,Sri Lanka,21413250,Asia,2893,11
LKA,2020-34,60,1,Sri Lanka,21413250,Asia,2953,12
LKA,2020-35,59,0,Sri Lanka,21413250,Asia,3012,12
LKA,2020-36,111,0,Sri Lanka,21413250,Asia,3123,12
LKA,2020-37,111,0,Sri Lanka,21413250,Asia,3234,12
LKA,2020-38,53,1,Sri Lanka,21413250,Asia,3287,13
LKA,2020-39,73,0,Sri Lanka,21413250,Asia,3360,13
LKA,2020-40,42,0,Sri Lanka,21413250,Asia,3402,13
LKA,2020-41,1350,0,Sri Lanka,21413250,Asia,4752,13
LKA,2020-42,786,0,Sri Lanka,21413250,Asia,5538,13
LKA,2020-43,2334,2,Sri Lanka,21413250,Asia,7872,15
LKA,2020-44,3188,6,Sri Lanka,21413250,Asia,11060,21
LKA,2020-45,2869,14,Sri Lanka,21413250,Asia,13929,35
LKA,2020-46,3358,23,Sri Lanka,21413250,Asia,17287,58
LKA,2020-47,2884,29,Sri Lanka,21413250,Asia,20171,87
LKA,2020-48,3313,29,Sri Lanka,21413250,Asia,23484,116
LKA,2020-49,4393,24,Sri Lanka,21413250,Asia,27877,140
LKA,2020-50,4913,12,Sri Lanka,21413250,Asia,32790,152
LKA,2020-51,4471,24,Sri Lanka,21413250,Asia,37261,176
LKA,2020-52,3793,15,Sri Lanka,21413250,Asia,41054,191
LKA,2020-53,3720,22,Sri Lanka,21413250,Asia,44774,213
LKA,2021-01,3606,19,Sri Lanka,21413250,Asia,48380,232
LKA,2021-02,4682,32,Sri Lanka,21413250,Asia,53062,264
LKA,2021-03,5368,19,Sri Lanka,21413250,Asia,58430,283
LKA,2021-04,5727,33,Sri Lanka,21413250,Asia,64157,316
LKA,2021-05,5191,40,Sri Lanka,21413250,Asia,69348,356
LKA,2021-06,6306,41,Sri Lanka,21413250,Asia,75654,397
LKA,2021-07,4345,48,Sri Lanka,21413250,Asia,79999,445
LKA,2021-08,3243,26,Sri Lanka,21413250,Asia,83242,471
LKA,2021-09,2453,31,Sri Lanka,21413250,Asia,85695,502
LKA,2021-10,2212,25,Sri Lanka,21413250,Asia,87907,527
LKA,2021-11,2293,19,Sri Lanka,21413250,Asia,90200,546
LKA,2021-12,1888,15,Sri Lanka,21413250,Asia,92088,561
LKA,2021-13,1348,20,Sri Lanka,21413250,Asia,93436,581
LKA,2021-14,1695,17,Sri Lanka,21413250,Asia,95131,598
LKA,2021-15,1665,20,Sri Lanka,21413250,Asia,96796,618
LKA,2021-16,4583,24,Sri Lanka,21413250,Asia,101379,642
LKA,2021-17,10374,45,Sri Lanka,21413250,Asia,111753,687
LKA,2021-18,14153,114,Sri Lanka,21413250,Asia,125906,801
LKA,2021-19,16840,161,Sri Lanka,21413250,Asia,142746,962
LKA,2021-20,21455,248,Sri Lanka,21413250,Asia,164201,1210
LKA,2021-21,19251,231,Sri Lanka,21413250,Asia,183452,1441
LKA,2021-22,21881,301,Sri Lanka,21413250,Asia,205333,1742
LKA,2021-23,18305,394,Sri Lanka,21413250,Asia,223638,2136
LKA,2021-24,16051,398,Sri Lanka,21413250,Asia,239689,2534
LKA,2021-25,13929,353,Sri Lanka,21413250,Asia,253618,2887
LKA,2021-26,12012,292,Sri Lanka,21413250,Asia,265630,3179
LKA,2021-27,8908,288,Sri Lanka,21413250,Asia,274538,3467
LKA,2021-28,10394,255,Sri Lanka,21413250,Asia,284932,3722
LKA,2021-29,11584,320,Sri Lanka,21413250,Asia,296516,4042
LKA,2021-30,14833,409,Sri Lanka,21413250,Asia,311349,4451
LKA,2021-31,18645,603,Sri Lanka,21413250,Asia,329994,5054
LKA,2021-32,28614,509,Sri Lanka,21413250,Asia,358608,5563
LSO,2020-21,1,0,Lesotho,2142252,Africa,1,0
LSO,2020-22,0,0,Lesotho,2142252,Africa,1,0
LSO,2020-23,2,0,Lesotho,2142252,Africa,3,0
LSO,2020-24,0,0,Lesotho,2142252,Africa,3,0
LSO,2020-25,0,0,Lesotho,2142252,Africa,3,0
LSO,2020-26,23,0,Lesotho,2142252,Africa,26,0
LSO,2020-27,52,0,Lesotho,2142252,Africa,78,0
LSO,2020-28,154,2,Lesotho,2142252,Africa,232,2
LSO,2020-29,126,4,Lesotho,2142252,Africa,358,6
LSO,2020-30,87,5,Lesotho,2142252,Africa,445,11
LSO,2020-31,272,8,Lesotho,2142252,Africa,717,19
LSO,2020-32,24,4,Lesotho,2142252,Africa,741,23
LSO,2020-33,204,7,Lesotho,2142252,Africa,945,30
LSO,2020-34,69,0,Lesotho,2142252,Africa,1014,30
LSO,2020-35,51,1,Lesotho,2142252,Africa,1065,31
LSO,2020-36,82,0,Lesotho,2142252,Africa,1147,31
LSO,2020-37,97,2,Lesotho,2142252,Africa,1244,33
LSO,2020-38,179,0,Lesotho,2142252,Africa,1423,33
LSO,2020-39,134,2,Lesotho,2142252,Africa,1557,35
LSO,2020-40,122,4,Lesotho,2142252,Africa,1679,39
LSO,2020-41,125,3,Lesotho,2142252,Africa,1804,42
LSO,2020-42,28,0,Lesotho,2142252,Africa,1832,42
LSO,2020-43,107,1,Lesotho,2142252,Africa,1939,43
LSO,2020-44,7,0,Lesotho,2142252,Africa,1946,43
LSO,2020-45,20,1,Lesotho,2142252,Africa,1966,44
LSO,2020-46,74,0,Lesotho,2142252,Africa,2040,44
LSO,2020-47,44,0,Lesotho,2142252,Africa,2084,44
LSO,2020-48,24,0,Lesotho,2142252,Africa,2108,44
LSO,2020-49,41,0,Lesotho,2142252,Africa,2149,44
LSO,2020-50,135,0,Lesotho,2142252,Africa,2284,44
LSO,2020-51,261,4,Lesotho,2142252,Africa,2545,48
LSO,2020-52,410,3,Lesotho,2142252,Africa,2955,51
LSO,2020-53,250,14,Lesotho,2142252,Africa,3205,65
LSO,2021-01,2731,20,Lesotho,2142252,Africa,5936,85
LSO,2021-02,434,8,Lesotho,2142252,Africa,6370,93
LSO,2021-03,1285,30,Lesotho,2142252,Africa,7655,123
LSO,2021-04,622,37,Lesotho,2142252,Africa,8277,160
LSO,2021-05,1102,23,Lesotho,2142252,Africa,9379,183
LSO,2021-06,874,60,Lesotho,2142252,Africa,10253,243
LSO,2021-07,207,42,Lesotho,2142252,Africa,10460,285
LSO,2021-08,30,7,Lesotho,2142252,Africa,10490,292
LSO,2021-09,32,16,Lesotho,2142252,Africa,10522,308
LSO,2021-10,7,1,Lesotho,2142252,Africa,10529,309
LSO,2021-11,8,0,Lesotho,2142252,Africa,10537,309
LSO,2021-12,148,6,Lesotho,2142252,Africa,10685,315
LSO,2021-13,21,0,Lesotho,2142252,Africa,10706,315
LSO,2021-14,2,0,Lesotho,2142252,Africa,10708,315
LSO,2021-15,11,1,Lesotho,2142252,Africa,10719,316
LSO,2021-16,8,0,Lesotho,2142252,Africa,10727,316
LSO,2021-17,5,2,Lesotho,2142252,Africa,10732,318
LSO,2021-18,40,1,Lesotho,2142252,Africa,10772,319
LSO,2021-19,17,1,Lesotho,2142252,Africa,10789,320
LSO,2021-20,32,6,Lesotho,2142252,Africa,10821,326
LSO,2021-21,9,0,Lesotho,2142252,Africa,10830,326
LSO,2021-22,8,0,Lesotho,2142252,Africa,10838,326
LSO,2021-23,82,0,Lesotho,2142252,Africa,10920,326
LSO,2021-24,186,3,Lesotho,2142252,Africa,11106,329
LSO,2021-25,132,0,Lesotho,2142252,Africa,11238,329
LSO,2021-26,329,0,Lesotho,2142252,Africa,11567,329
LSO,2021-27,335,6,Lesotho,2142252,Africa,11902,335
LSO,2021-28,495,4,Lesotho,2142252,Africa,12397,339
LSO,2021-29,482,24,Lesotho,2142252,Africa,12879,363
LSO,2021-30,723,14,Lesotho,2142252,Africa,13602,377
LSO,2021-31,240,13,Lesotho,2142252,Africa,13842,390
LSO,2021-32,400,7,Lesotho,2142252,Africa,14242,397
LTU,2020-02,0,0,Lithuania,2794090,Europe,0,0
LTU,2020-03,0,0,Lithuania,2794090,Europe,0,0
LTU,2020-04,0,0,Lithuania,2794090,Europe,0,0
LTU,2020-05,0,0,Lithuania,2794090,Europe,0,0
LTU,2020-06,0,0,Lithuania,2794090,Europe,0,0
LTU,2020-07,0,0,Lithuania,2794090,Europe,0,0
LTU,2020-08,0,0,Lithuania,2794090,Europe,0,0
LTU,2020-09,1,0,Lithuania,2794090,Europe,1,0
LTU,2020-10,0,0,Lithuania,2794090,Europe,1,0
LTU,2020-11,13,0,Lithuania,2794090,Europe,14,0
LTU,2020-12,129,1,Lithuania,2794090,Europe,143,1
LTU,2020-13,341,6,Lithuania,2794090,Europe,484,7
LTU,2020-14,327,6,Lithuania,2794090,Europe,811,13
LTU,2020-15,251,11,Lithuania,2794090,Europe,1062,24
LTU,2020-16,264,12,Lithuania,2794090,Europe,1326,36
LTU,2020-17,112,5,Lithuania,2794090,Europe,1438,41
LTU,2020-18,-28,5,Lithuania,2794090,Europe,1410,46
LTU,2020-19,69,4,Lithuania,2794090,Europe,1479,50
LTU,2020-20,62,6,Lithuania,2794090,Europe,1541,56
LTU,2020-21,82,7,Lithuania,2794090,Europe,1623,63
LTU,2020-22,52,7,Lithuania,2794090,Europe,1675,70
LTU,2020-23,39,1,Lithuania,2794090,Europe,1714,71
LTU,2020-24,54,4,Lithuania,2794090,Europe,1768,75
LTU,2020-25,30,1,Lithuania,2794090,Europe,1798,76
LTU,2020-26,18,2,Lithuania,2794090,Europe,1816,78
LTU,2020-27,20,1,Lithuania,2794090,Europe,1836,79
LTU,2020-28,33,0,Lithuania,2794090,Europe,1869,79
LTU,2020-29,63,1,Lithuania,2794090,Europe,1932,80
LTU,2020-30,76,0,Lithuania,2794090,Europe,2008,80
LTU,2020-31,102,0,Lithuania,2794090,Europe,2110,80
LTU,2020-32,142,1,Lithuania,2794090,Europe,2252,81
LTU,2020-33,164,0,Lithuania,2794090,Europe,2416,81
LTU,2020-34,219,3,Lithuania,2794090,Europe,2635,84
LTU,2020-35,239,2,Lithuania,2794090,Europe,2874,86
LTU,2020-36,209,0,Lithuania,2794090,Europe,3083,86
LTU,2020-37,252,1,Lithuania,2794090,Europe,3335,87
LTU,2020-38,409,0,Lithuania,2794090,Europe,3744,87
LTU,2020-39,641,4,Lithuania,2794090,Europe,4385,91
LTU,2020-40,800,3,Lithuania,2794090,Europe,5185,94
LTU,2020-41,937,9,Lithuania,2794090,Europe,6122,103
LTU,2020-42,1399,10,Lithuania,2794090,Europe,7521,113
LTU,2020-43,2663,21,Lithuania,2794090,Europe,10184,134
LTU,2020-44,5535,32,Lithuania,2794090,Europe,15719,166
LTU,2020-45,8980,41,Lithuania,2794090,Europe,24699,207
LTU,2020-46,10059,70,Lithuania,2794090,Europe,34758,277
LTU,2020-47,12289,109,Lithuania,2794090,Europe,47047,386
LTU,2020-48,14278,120,Lithuania,2794090,Europe,61325,506
LTU,2020-49,14711,131,Lithuania,2794090,Europe,76036,637
LTU,2020-50,18985,188,Lithuania,2794090,Europe,95021,825
LTU,2020-51,19466,214,Lithuania,2794090,Europe,114487,1039
LTU,2020-52,17882,230,Lithuania,2794090,Europe,132369,1269
LTU,2020-53,15618,681,Lithuania,2794090,Europe,147987,1950
LTU,2021-01,12459,282,Lithuania,2794090,Europe,160446,2232
LTU,2021-02,7546,237,Lithuania,2794090,Europe,167992,2469
LTU,2021-03,9174,195,Lithuania,2794090,Europe,177166,2664
LTU,2021-04,5727,161,Lithuania,2794090,Europe,182893,2825
LTU,2021-05,4146,130,Lithuania,2794090,Europe,187039,2955
LTU,2021-06,3898,125,Lithuania,2794090,Europe,190937,3080
LTU,2021-07,3396,98,Lithuania,2794090,Europe,194333,3178
LTU,2021-08,5065,75,Lithuania,2794090,Europe,199398,3253
LTU,2021-09,3032,83,Lithuania,2794090,Europe,202430,3336
LTU,2021-10,3214,74,Lithuania,2794090,Europe,205644,3410
LTU,2021-11,3696,76,Lithuania,2794090,Europe,209340,3486
LTU,2021-12,5025,74,Lithuania,2794090,Europe,214365,3560
LTU,2021-13,5847,55,Lithuania,2794090,Europe,220212,3615
LTU,2021-14,6571,82,Lithuania,2794090,Europe,226783,3697
LTU,2021-15,7449,73,Lithuania,2794090,Europe,234232,3770
LTU,2021-16,7640,87,Lithuania,2794090,Europe,241872,3857
LTU,2021-17,8465,99,Lithuania,2794090,Europe,250337,3956
LTU,2021-18,8286,89,Lithuania,2794090,Europe,258623,4045
LTU,2021-19,7440,67,Lithuania,2794090,Europe,266063,4112
LTU,2021-20,5619,97,Lithuania,2794090,Europe,271682,4209
LTU,2021-21,3094,67,Lithuania,2794090,Europe,274776,4276
LTU,2021-22,1983,41,Lithuania,2794090,Europe,276759,4317
LTU,2021-23,1183,31,Lithuania,2794090,Europe,277942,4348
LTU,2021-24,524,23,Lithuania,2794090,Europe,278466,4371
LTU,2021-25,260,10,Lithuania,2794090,Europe,278726,4381
LTU,2021-26,224,14,Lithuania,2794090,Europe,278950,4395
LTU,2021-27,352,6,Lithuania,2794090,Europe,279302,4401
LTU,2021-28,612,3,Lithuania,2794090,Europe,279914,4404
LTU,2021-29,1370,7,Lithuania,2794090,Europe,281284,4411
LTU,2021-30,2372,9,Lithuania,2794090,Europe,283656,4420
LTU,2021-31,3287,13,Lithuania,2794090,Europe,286943,4433
LTU,2021-32,3823,25,Lithuania,2794090,Europe,290766,4458
LUX,2020-02,0,0,Luxembourg,626108,Europe,0,0
LUX,2020-03,0,0,Luxembourg,626108,Europe,0,0
LUX,2020-04,0,0,Luxembourg,626108,Europe,0,0
LUX,2020-05,0,0,Luxembourg,626108,Europe,0,0
LUX,2020-06,0,0,Luxembourg,626108,Europe,0,0
LUX,2020-07,0,0,Luxembourg,626108,Europe,0,0
LUX,2020-08,0,0,Luxembourg,626108,Europe,0,0
LUX,2020-09,1,0,Luxembourg,626108,Europe,1,0
LUX,2020-10,4,0,Luxembourg,626108,Europe,5,0
LUX,2020-11,72,1,Luxembourg,626108,Europe,77,1
LUX,2020-12,721,7,Luxembourg,626108,Europe,798,8
LUX,2020-13,1152,13,Luxembourg,626108,Europe,1950,21
LUX,2020-14,854,15,Luxembourg,626108,Europe,2804,36
LUX,2020-15,477,30,Luxembourg,626108,Europe,3281,66
LUX,2020-16,269,7,Luxembourg,626108,Europe,3550,73
LUX,2020-17,173,15,Luxembourg,626108,Europe,3723,88
LUX,2020-18,101,8,Luxembourg,626108,Europe,3824,96
LUX,2020-19,62,5,Luxembourg,626108,Europe,3886,101
LUX,2020-20,59,6,Luxembourg,626108,Europe,3945,107
LUX,2020-21,47,3,Luxembourg,626108,Europe,3992,110
LUX,2020-22,26,0,Luxembourg,626108,Europe,4018,110
LUX,2020-23,21,0,Luxembourg,626108,Europe,4039,110
LUX,2020-24,31,0,Luxembourg,626108,Europe,4070,110
LUX,2020-25,50,0,Luxembourg,626108,Europe,4120,110
LUX,2020-26,122,0,Luxembourg,626108,Europe,4242,110
LUX,2020-27,280,0,Luxembourg,626108,Europe,4522,110
LUX,2020-28,403,1,Luxembourg,626108,Europe,4925,111
LUX,2020-29,558,0,Luxembourg,626108,Europe,5483,111
LUX,2020-30,789,1,Luxembourg,626108,Europe,6272,112
LUX,2020-31,423,5,Luxembourg,626108,Europe,6695,117
LUX,2020-32,418,2,Luxembourg,626108,Europe,7113,119
LUX,2020-33,326,4,Luxembourg,626108,Europe,7439,123
LUX,2020-34,265,1,Luxembourg,626108,Europe,7704,124
LUX,2020-35,-1079,0,Luxembourg,626108,Europe,6625,124
LUX,2020-36,271,0,Luxembourg,626108,Europe,6896,124
LUX,2020-37,298,0,Luxembourg,626108,Europe,7194,124
LUX,2020-38,610,0,Luxembourg,626108,Europe,7804,124
LUX,2020-39,553,0,Luxembourg,626108,Europe,8357,124
LUX,2020-40,352,1,Luxembourg,626108,Europe,8709,125
LUX,2020-41,651,5,Luxembourg,626108,Europe,9360,130
LUX,2020-42,1286,3,Luxembourg,626108,Europe,10646,133
LUX,2020-43,3558,12,Luxembourg,626108,Europe,14204,145
LUX,2020-44,4578,15,Luxembourg,626108,Europe,18782,160
LUX,2020-45,3699,25,Luxembourg,626108,Europe,22481,185
LUX,2020-46,4063,37,Luxembourg,626108,Europe,26544,222
LUX,2020-47,3789,40,Luxembourg,626108,Europe,30333,262
LUX,2020-48,3640,44,Luxembourg,626108,Europe,33973,306
LUX,2020-49,3711,44,Luxembourg,626108,Europe,37684,350
LUX,2020-50,3588,46,Luxembourg,626108,Europe,41272,396
LUX,2020-51,2795,44,Luxembourg,626108,Europe,44067,440
LUX,2020-52,1782,47,Luxembourg,626108,Europe,45849,487
LUX,2020-53,1070,19,Luxembourg,626108,Europe,46919,506
LUX,2021-01,1065,27,Luxembourg,626108,Europe,47984,533
LUX,2021-02,868,19,Luxembourg,626108,Europe,48852,552
LUX,2021-03,852,12,Luxembourg,626108,Europe,49704,564
LUX,2021-04,965,16,Luxembourg,626108,Europe,50669,580
LUX,2021-05,1179,13,Luxembourg,626108,Europe,51848,593
LUX,2021-06,1036,14,Luxembourg,626108,Europe,52884,607
LUX,2021-07,1254,18,Luxembourg,626108,Europe,54138,625
LUX,2021-08,1287,13,Luxembourg,626108,Europe,55425,638
LUX,2021-09,1221,24,Luxembourg,626108,Europe,56646,662
LUX,2021-10,1231,27,Luxembourg,626108,Europe,57877,689
LUX,2021-11,1539,29,Luxembourg,626108,Europe,59416,718
LUX,2021-12,1339,20,Luxembourg,626108,Europe,60755,738
LUX,2021-13,1605,12,Luxembourg,626108,Europe,62360,750
LUX,2021-14,1290,18,Luxembourg,626108,Europe,63650,768
LUX,2021-15,1303,17,Luxembourg,626108,Europe,64953,785
LUX,2021-16,1249,5,Luxembourg,626108,Europe,66202,790
LUX,2021-17,1195,7,Luxembourg,626108,Europe,67397,797
LUX,2021-18,894,5,Luxembourg,626108,Europe,68291,802
LUX,2021-19,737,4,Luxembourg,626108,Europe,69028,806
LUX,2021-20,579,5,Luxembourg,626108,Europe,69607,811
LUX,2021-21,282,3,Luxembourg,626108,Europe,69889,814
LUX,2021-22,293,4,Luxembourg,626108,Europe,70182,818
LUX,2021-23,224,0,Luxembourg,626108,Europe,70406,818
LUX,2021-24,110,0,Luxembourg,626108,Europe,70516,818
LUX,2021-25,84,0,Luxembourg,626108,Europe,70600,818
LUX,2021-26,431,0,Luxembourg,626108,Europe,71031,818
LUX,2021-27,979,1,Luxembourg,626108,Europe,72010,819
LUX,2021-28,749,1,Luxembourg,626108,Europe,72759,820
LUX,2021-29,653,1,Luxembourg,626108,Europe,73412,821
LUX,2021-30,458,1,Luxembourg,626108,Europe,73870,822
LUX,2021-31,392,2,Luxembourg,626108,Europe,74262,824
LUX,2021-32,333,4,Luxembourg,626108,Europe,74595,828
LVA,2020-11,28,0,Latvia,1907675,Europe,28,0
LVA,2020-12,108,0,Latvia,1907675,Europe,136,0
LVA,2020-13,237,0,Latvia,1907675,Europe,373,0
LVA,2020-14,157,1,Latvia,1907675,Europe,530,1
LVA,2020-15,118,4,Latvia,1907675,Europe,648,5
LVA,2020-16,76,0,Latvia,1907675,Europe,724,5
LVA,2020-17,85,7,Latvia,1907675,Europe,809,12
LVA,2020-18,67,4,Latvia,1907675,Europe,876,16
LVA,2020-19,60,2,Latvia,1907675,Europe,936,18
LVA,2020-20,69,1,Latvia,1907675,Europe,1005,19
LVA,2020-21,39,3,Latvia,1907675,Europe,1044,22
LVA,2020-22,19,2,Latvia,1907675,Europe,1063,24
LVA,2020-23,22,1,Latvia,1907675,Europe,1085,25
LVA,2020-24,9,3,Latvia,1907675,Europe,1094,28
LVA,2020-25,14,2,Latvia,1907675,Europe,1108,30
LVA,2020-26,5,0,Latvia,1907675,Europe,1113,30
LVA,2020-27,8,0,Latvia,1907675,Europe,1121,30
LVA,2020-28,49,0,Latvia,1907675,Europe,1170,30
LVA,2020-29,19,1,Latvia,1907675,Europe,1189,31
LVA,2020-30,27,0,Latvia,1907675,Europe,1216,31
LVA,2020-31,24,1,Latvia,1907675,Europe,1240,32
LVA,2020-32,47,0,Latvia,1907675,Europe,1287,32
LVA,2020-33,32,0,Latvia,1907675,Europe,1319,32
LVA,2020-34,15,1,Latvia,1907675,Europe,1334,33
LVA,2020-35,56,1,Latvia,1907675,Europe,1390,34
LVA,2020-36,35,1,Latvia,1907675,Europe,1425,35
LVA,2020-37,46,0,Latvia,1907675,Europe,1471,35
LVA,2020-38,51,1,Latvia,1907675,Europe,1522,36
LVA,2020-39,151,0,Latvia,1907675,Europe,1673,36
LVA,2020-40,410,2,Latvia,1907675,Europe,2083,38
LVA,2020-41,584,2,Latvia,1907675,Europe,2667,40
LVA,2020-42,780,2,Latvia,1907675,Europe,3447,42
LVA,2020-43,1228,14,Latvia,1907675,Europe,4675,56
LVA,2020-44,1458,18,Latvia,1907675,Europe,6133,74
LVA,2020-45,1959,25,Latvia,1907675,Europe,8092,99
LVA,2020-46,2452,24,Latvia,1907675,Europe,10544,123
LVA,2020-47,2573,30,Latvia,1907675,Europe,13117,153
LVA,2020-48,3855,44,Latvia,1907675,Europe,16972,197
LVA,2020-49,4338,65,Latvia,1907675,Europe,21310,262
LVA,2020-50,4362,87,Latvia,1907675,Europe,25672,349
LVA,2020-51,5265,90,Latvia,1907675,Europe,30937,439
LVA,2020-52,5390,120,Latvia,1907675,Europe,36327,559
LVA,2020-53,6167,121,Latvia,1907675,Europe,42494,680
LVA,2021-01,7071,169,Latvia,1907675,Europe,49565,849
LVA,2021-02,6096,129,Latvia,1907675,Europe,55661,978
LVA,2021-03,5344,133,Latvia,1907675,Europe,61005,1111
LVA,2021-04,5233,84,Latvia,1907675,Europe,66238,1195
LVA,2021-05,5559,144,Latvia,1907675,Europe,71797,1339
LVA,2021-06,4906,112,Latvia,1907675,Europe,76703,1451
LVA,2021-07,4813,91,Latvia,1907675,Europe,81516,1542
LVA,2021-08,4667,76,Latvia,1907675,Europe,86183,1618
LVA,2021-09,4145,77,Latvia,1907675,Europe,90328,1695
LVA,2021-10,3450,72,Latvia,1907675,Europe,93778,1767
LVA,2021-11,3628,59,Latvia,1907675,Europe,97406,1826
LVA,2021-12,3631,52,Latvia,1907675,Europe,101037,1878
LVA,2021-13,3065,53,Latvia,1907675,Europe,104102,1931
LVA,2021-14,3503,55,Latvia,1907675,Europe,107605,1986
LVA,2021-15,3726,67,Latvia,1907675,Europe,111331,2053
LVA,2021-16,3982,49,Latvia,1907675,Europe,115313,2102
LVA,2021-17,4434,42,Latvia,1907675,Europe,119747,2144
LVA,2021-18,4213,68,Latvia,1907675,Europe,123960,2212
LVA,2021-19,4015,54,Latvia,1907675,Europe,127975,2266
LVA,2021-20,2967,60,Latvia,1907675,Europe,130942,2326
LVA,2021-21,2153,44,Latvia,1907675,Europe,133095,2370
LVA,2021-22,1714,43,Latvia,1907675,Europe,134809,2413
LVA,2021-23,1218,43,Latvia,1907675,Europe,136027,2456
LVA,2021-24,780,40,Latvia,1907675,Europe,136807,2496
LVA,2021-25,400,7,Latvia,1907675,Europe,137207,2503
LVA,2021-26,421,25,Latvia,1907675,Europe,137628,2528
LVA,2021-27,268,9,Latvia,1907675,Europe,137896,2537
LVA,2021-28,260,6,Latvia,1907675,Europe,138156,2543
LVA,2021-29,322,7,Latvia,1907675,Europe,138478,2550
LVA,2021-30,418,6,Latvia,1907675,Europe,138896,2556
LVA,2021-31,522,3,Latvia,1907675,Europe,139418,2559
LVA,2021-32,701,2,Latvia,1907675,Europe,140119,2561
MAR,2020-12,87,3,Morocco,36910558,Africa,87,3
MAR,2020-13,364,22,Morocco,36910558,Africa,451,25
MAR,2020-14,542,44,Morocco,36910558,Africa,993,69
MAR,2020-15,640,48,Morocco,36910558,Africa,1633,117
MAR,2020-16,1194,23,Morocco,36910558,Africa,2827,140
MAR,2020-17,1210,20,Morocco,36910558,Africa,4037,160
MAR,2020-18,838,13,Morocco,36910558,Africa,4875,173
MAR,2020-19,1160,14,Morocco,36910558,Africa,6035,187
MAR,2020-20,807,4,Morocco,36910558,Africa,6842,191
MAR,2020-21,563,7,Morocco,36910558,Africa,7405,198
MAR,2020-22,374,6,Morocco,36910558,Africa,7779,204
MAR,2020-23,417,3,Morocco,36910558,Africa,8196,207
MAR,2020-24,510,4,Morocco,36910558,Africa,8706,211
MAR,2020-25,1243,2,Morocco,36910558,Africa,9949,213
MAR,2020-26,2075,7,Morocco,36910558,Africa,12024,220
MAR,2020-27,2163,14,Morocco,36910558,Africa,14187,234
MAR,2020-28,1530,15,Morocco,36910558,Africa,15717,249
MAR,2020-29,1491,23,Morocco,36910558,Africa,17208,272
MAR,2020-30,3042,40,Morocco,36910558,Africa,20250,312
MAR,2020-31,5259,69,Morocco,36910558,Africa,25509,381
MAR,2020-32,7700,116,Morocco,36910558,Africa,33209,497
MAR,2020-33,9252,160,Morocco,36910558,Africa,42461,657
MAR,2020-34,9860,230,Morocco,36910558,Africa,52321,887
MAR,2020-35,9050,223,Morocco,36910558,Africa,61371,1110
MAR,2020-36,10995,250,Morocco,36910558,Africa,72366,1360
MAR,2020-37,14292,217,Morocco,36910558,Africa,86658,1577
MAR,2020-38,15057,252,Morocco,36910558,Africa,101715,1829
MAR,2020-39,15942,239,Morocco,36910558,Africa,117657,2068
MAR,2020-40,15587,261,Morocco,36910558,Africa,133244,2329
MAR,2020-41,19132,275,Morocco,36910558,Africa,152376,2604
MAR,2020-42,21228,323,Morocco,36910558,Africa,173604,2927
MAR,2020-43,23849,373,Morocco,36910558,Africa,197453,3300
MAR,2020-44,25063,461,Morocco,36910558,Africa,222516,3761
MAR,2020-45,34237,510,Morocco,36910558,Africa,256753,4271
MAR,2020-46,36396,507,Morocco,36910558,Africa,293149,4778
MAR,2020-47,27785,477,Morocco,36910558,Africa,320934,5255
MAR,2020-48,32841,533,Morocco,36910558,Africa,353775,5788
MAR,2020-49,25854,456,Morocco,36910558,Africa,379629,6244
MAR,2020-50,19952,379,Morocco,36910558,Africa,399581,6623
MAR,2020-51,17516,333,Morocco,36910558,Africa,417097,6956
MAR,2020-52,14954,283,Morocco,36910558,Africa,432051,7239
MAR,2020-53,11067,245,Morocco,36910558,Africa,443118,7484
MAR,2021-01,9386,258,Morocco,36910558,Africa,452504,7742
MAR,2021-02,7139,199,Morocco,36910558,Africa,459643,7941
MAR,2021-03,6618,208,Morocco,36910558,Africa,466261,8149
MAR,2021-04,4868,125,Morocco,36910558,Africa,471129,8274
MAR,2021-05,4198,119,Morocco,36910558,Africa,475327,8393
MAR,2021-06,3119,83,Morocco,36910558,Africa,478446,8476
MAR,2021-07,2681,77,Morocco,36910558,Africa,481127,8553
MAR,2021-08,2611,83,Morocco,36910558,Africa,483738,8636
MAR,2021-09,2457,45,Morocco,36910558,Africa,486195,8681
MAR,2021-10,2714,41,Morocco,36910558,Africa,488909,8722
MAR,2021-11,2772,44,Morocco,36910558,Africa,491681,8766
MAR,2021-12,2950,31,Morocco,36910558,Africa,494631,8797
MAR,2021-13,3538,52,Morocco,36910558,Africa,498169,8849
MAR,2021-14,3905,50,Morocco,36910558,Africa,502074,8899
MAR,2021-15,3709,45,Morocco,36910558,Africa,505783,8944
MAR,2021-16,3552,47,Morocco,36910558,Africa,509335,8991
MAR,2021-17,2493,36,Morocco,36910558,Africa,511828,9027
MAR,2021-18,2008,44,Morocco,36910558,Africa,513836,9071
MAR,2021-19,1080,26,Morocco,36910558,Africa,514916,9097
MAR,2021-20,2079,24,Morocco,36910558,Africa,516995,9121
MAR,2021-21,2085,21,Morocco,36910558,Africa,519080,9142
MAR,2021-22,2318,35,Morocco,36910558,Africa,521398,9177
MAR,2021-23,2464,33,Morocco,36910558,Africa,523862,9210
MAR,2021-24,2761,27,Morocco,36910558,Africa,526623,9237
MAR,2021-25,3025,39,Morocco,36910558,Africa,529648,9276
MAR,2021-26,4874,42,Morocco,36910558,Africa,534522,9318
MAR,2021-27,7912,50,Morocco,36910558,Africa,542434,9368
MAR,2021-28,15170,81,Morocco,36910558,Africa,557604,9449
MAR,2021-29,21640,139,Morocco,36910558,Africa,579244,9588
MAR,2021-30,50445,244,Morocco,36910558,Africa,629689,9832
MAR,2021-31,66565,502,Morocco,36910558,Africa,696254,10334
MAR,2021-32,63174,682,Morocco,36910558,Africa,759428,11016
MCO,2020-02,0,0,Monaco,39244,Europe,0,0
MCO,2020-03,0,0,Monaco,39244,Europe,0,0
MCO,2020-04,0,0,Monaco,39244,Europe,0,0
MCO,2020-05,0,0,Monaco,39244,Europe,0,0
MCO,2020-06,0,0,Monaco,39244,Europe,0,0
MCO,2020-07,0,0,Monaco,39244,Europe,0,0
MCO,2020-08,0,0,Monaco,39244,Europe,0,0
MCO,2020-09,1,0,Monaco,39244,Europe,1,0
MCO,2020-10,0,0,Monaco,39244,Europe,1,0
MCO,2020-11,8,0,Monaco,39244,Europe,9,0
MCO,2020-12,11,0,Monaco,39244,Europe,20,0
MCO,2020-13,15,0,Monaco,39244,Europe,35,0
MCO,2020-14,16,0,Monaco,39244,Europe,51,0
MCO,2020-15,13,1,Monaco,39244,Europe,64,1
MCO,2020-16,1,0,Monaco,39244,Europe,65,1
MCO,2020-17,0,0,Monaco,39244,Europe,65,1
MCO,2020-18,1,0,Monaco,39244,Europe,66,1
MCO,2020-19,0,0,Monaco,39244,Europe,66,1
MCO,2020-20,0,0,Monaco,39244,Europe,66,1
MCO,2020-21,1,0,Monaco,39244,Europe,67,1
MCO,2020-22,0,0,Monaco,39244,Europe,67,1
MCO,2020-23,0,0,Monaco,39244,Europe,67,1
MCO,2020-24,0,0,Monaco,39244,Europe,67,1
MCO,2020-25,1,0,Monaco,39244,Europe,68,1
MCO,2020-26,2,0,Monaco,39244,Europe,70,1
MCO,2020-27,5,0,Monaco,39244,Europe,75,1
MCO,2020-28,1,0,Monaco,39244,Europe,76,1
MCO,2020-29,0,0,Monaco,39244,Europe,76,1
MCO,2020-30,5,0,Monaco,39244,Europe,81,1
MCO,2020-31,3,0,Monaco,39244,Europe,84,1
MCO,2020-32,10,0,Monaco,39244,Europe,94,1
MCO,2020-33,5,0,Monaco,39244,Europe,99,1
MCO,2020-34,12,0,Monaco,39244,Europe,111,1
MCO,2020-35,20,0,Monaco,39244,Europe,131,1
MCO,2020-36,17,0,Monaco,39244,Europe,148,1
MCO,2020-37,23,0,Monaco,39244,Europe,171,1
MCO,2020-38,22,0,Monaco,39244,Europe,193,1
MCO,2020-39,17,0,Monaco,39244,Europe,210,1
MCO,2020-40,12,0,Monaco,39244,Europe,222,1
MCO,2020-41,12,0,Monaco,39244,Europe,234,1
MCO,2020-42,31,0,Monaco,39244,Europe,265,1
MCO,2020-43,41,0,Monaco,39244,Europe,306,1
MCO,2020-44,60,0,Monaco,39244,Europe,366,1
MCO,2020-45,120,0,Monaco,39244,Europe,486,1
MCO,2020-46,62,0,Monaco,39244,Europe,548,1
MCO,2020-47,34,1,Monaco,39244,Europe,582,2
MCO,2020-48,26,0,Monaco,39244,Europe,608,2
MCO,2020-49,30,0,Monaco,39244,Europe,638,2
MCO,2020-50,30,0,Monaco,39244,Europe,668,2
MCO,2020-51,60,0,Monaco,39244,Europe,728,2
MCO,2020-52,75,0,Monaco,39244,Europe,803,2
MCO,2020-53,104,1,Monaco,39244,Europe,907,3
MCO,2021-01,150,0,Monaco,39244,Europe,1057,3
MCO,2021-02,148,5,Monaco,39244,Europe,1205,8
MCO,2021-03,152,0,Monaco,39244,Europe,1357,8
MCO,2021-04,132,5,Monaco,39244,Europe,1489,13
MCO,2021-05,166,0,Monaco,39244,Europe,1655,13
MCO,2021-06,105,8,Monaco,39244,Europe,1760,21
MCO,2021-07,110,0,Monaco,39244,Europe,1870,21
MCO,2021-08,86,3,Monaco,39244,Europe,1956,24
MCO,2021-09,67,1,Monaco,39244,Europe,2023,25
MCO,2021-10,84,0,Monaco,39244,Europe,2107,25
MCO,2021-11,66,2,Monaco,39244,Europe,2173,27
MCO,2021-12,86,0,Monaco,39244,Europe,2259,27
MCO,2021-13,70,2,Monaco,39244,Europe,2329,29
MCO,2021-14,46,2,Monaco,39244,Europe,2375,31
MCO,2021-15,24,0,Monaco,39244,Europe,2399,31
MCO,2021-16,40,1,Monaco,39244,Europe,2439,32
MCO,2021-17,18,0,Monaco,39244,Europe,2457,32
MCO,2021-18,22,0,Monaco,39244,Europe,2479,32
MCO,2021-19,14,0,Monaco,39244,Europe,2493,32
MCO,2021-20,8,0,Monaco,39244,Europe,2501,32
MCO,2021-21,3,0,Monaco,39244,Europe,2504,32
MCO,2021-22,4,1,Monaco,39244,Europe,2508,33
MCO,2021-23,17,0,Monaco,39244,Europe,2525,33
MCO,2021-24,23,0,Monaco,39244,Europe,2548,33
MCO,2021-25,23,0,Monaco,39244,Europe,2571,33
MCO,2021-26,16,0,Monaco,39244,Europe,2587,33
MCO,2021-27,35,0,Monaco,39244,Europe,2622,33
MCO,2021-28,71,0,Monaco,39244,Europe,2693,33
MCO,2021-29,92,0,Monaco,39244,Europe,2785,33
MCO,2021-30,112,0,Monaco,39244,Europe,2897,33
MCO,2021-31,89,0,Monaco,39244,Europe,2986,33
MCO,2021-32,88,0,Monaco,39244,Europe,3074,33
MDA,2020-12,71,1,Moldova,4033963,Europe,71,1
MDA,2020-13,169,1,Moldova,4033963,Europe,240,2
MDA,2020-14,601,13,Moldova,4033963,Europe,841,15
MDA,2020-15,798,17,Moldova,4033963,Europe,1639,32
MDA,2020-16,810,35,Moldova,4033963,Europe,2449,67
MDA,2020-17,936,29,Moldova,4033963,Europe,3385,96
MDA,2020-18,713,29,Moldova,4033963,Europe,4098,125
MDA,2020-19,806,44,Moldova,4033963,Europe,4904,169
MDA,2020-20,1133,42,Moldova,4033963,Europe,6037,211
MDA,2020-21,1033,39,Moldova,4033963,Europe,7070,250
MDA,2020-22,1158,45,Moldova,4033963,Europe,8228,295
MDA,2020-23,1449,46,Moldova,4033963,Europe,9677,341
MDA,2020-24,2040,65,Moldova,4033963,Europe,11717,406
MDA,2020-25,2460,67,Moldova,4033963,Europe,14177,473
MDA,2020-26,2050,57,Moldova,4033963,Europe,16227,530
MDA,2020-27,1564,55,Moldova,4033963,Europe,17791,585
MDA,2020-28,1568,57,Moldova,4033963,Europe,19359,642
MDA,2020-29,1598,42,Moldova,4033963,Europe,20957,684
MDA,2020-30,2054,51,Moldova,4033963,Europe,23011,735
MDA,2020-31,2328,56,Moldova,4033963,Europe,25339,791
MDA,2020-32,2298,54,Moldova,4033963,Europe,27637,845
MDA,2020-33,2523,51,Moldova,4033963,Europe,30160,896
MDA,2020-34,3295,44,Moldova,4033963,Europe,33455,940
MDA,2020-35,3222,52,Moldova,4033963,Europe,36677,992
MDA,2020-36,3097,71,Moldova,4033963,Europe,39774,1063
MDA,2020-37,3181,60,Moldova,4033963,Europe,42955,1123
MDA,2020-38,3618,80,Moldova,4033963,Europe,46573,1203
MDA,2020-39,4279,84,Moldova,4033963,Europe,50852,1287
MDA,2020-40,5704,79,Moldova,4033963,Europe,56556,1366
MDA,2020-41,5572,95,Moldova,4033963,Europe,62128,1461
MDA,2020-42,4899,123,Moldova,4033963,Europe,67027,1584
MDA,2020-43,4453,101,Moldova,4033963,Europe,71480,1685
MDA,2020-44,5079,115,Moldova,4033963,Europe,76559,1800
MDA,2020-45,5764,93,Moldova,4033963,Europe,82323,1893
MDA,2020-46,6933,126,Moldova,4033963,Europe,89256,2019
MDA,2020-47,8662,130,Moldova,4033963,Europe,97918,2149
MDA,2020-48,9076,141,Moldova,4033963,Europe,106994,2290
MDA,2020-49,9618,129,Moldova,4033963,Europe,116612,2419
MDA,2020-50,9883,153,Moldova,4033963,Europe,126495,2572
MDA,2020-51,8689,180,Moldova,4033963,Europe,135184,2752
MDA,2020-52,6148,139,Moldova,4033963,Europe,141332,2891
MDA,2020-53,4518,146,Moldova,4033963,Europe,145850,3037
MDA,2021-01,3518,102,Moldova,4033963,Europe,149368,3139
MDA,2021-02,3463,111,Moldova,4033963,Europe,152831,3250
MDA,2021-03,3348,111,Moldova,4033963,Europe,156179,3361
MDA,2021-04,3602,77,Moldova,4033963,Europe,159781,3438
MDA,2021-05,4765,105,Moldova,4033963,Europe,164546,3543
MDA,2021-06,5617,108,Moldova,4033963,Europe,170163,3651
MDA,2021-07,6566,129,Moldova,4033963,Europe,176729,3780
MDA,2021-08,8701,169,Moldova,4033963,Europe,185430,3949
MDA,2021-09,9799,162,Moldova,4033963,Europe,195229,4111
MDA,2021-10,9211,219,Moldova,4033963,Europe,204440,4330
MDA,2021-11,10571,229,Moldova,4033963,Europe,215011,4559
MDA,2021-12,11487,268,Moldova,4033963,Europe,226498,4827
MDA,2021-13,8566,309,Moldova,4033963,Europe,235064,5136
MDA,2021-14,6130,252,Moldova,4033963,Europe,241194,5388
MDA,2021-15,4680,183,Moldova,4033963,Europe,245874,5571
MDA,2021-16,3242,159,Moldova,4033963,Europe,249116,5730
MDA,2021-17,2196,108,Moldova,4033963,Europe,251312,5838
MDA,2021-18,1414,114,Moldova,4033963,Europe,252726,5952
MDA,2021-19,1096,75,Moldova,4033963,Europe,253822,6027
MDA,2021-20,831,48,Moldova,4033963,Europe,254653,6075
MDA,2021-21,469,29,Moldova,4033963,Europe,255122,6104
MDA,2021-22,308,30,Moldova,4033963,Europe,255430,6134
MDA,2021-23,344,20,Moldova,4033963,Europe,255774,6154
MDA,2021-24,343,16,Moldova,4033963,Europe,256117,6170
MDA,2021-25,419,14,Moldova,4033963,Europe,256536,6184
MDA,2021-26,411,12,Moldova,4033963,Europe,256947,6196
MDA,2021-27,497,13,Moldova,4033963,Europe,257444,6209
MDA,2021-28,540,18,Moldova,4033963,Europe,257984,6227
MDA,2021-29,617,16,Moldova,4033963,Europe,258601,6243
MDA,2021-30,925,12,Moldova,4033963,Europe,259526,6255
MDA,2021-31,1081,27,Moldova,4033963,Europe,260607,6282
MDA,2021-32,1414,26,Moldova,4033963,Europe,262021,6308
MDG,2020-13,34,0,Madagascar,27691019,Africa,34,0
MDG,2020-14,35,0,Madagascar,27691019,Africa,69,0
MDG,2020-15,34,0,Madagascar,27691019,Africa,103,0
MDG,2020-16,15,0,Madagascar,27691019,Africa,118,0
MDG,2020-17,3,0,Madagascar,27691019,Africa,121,0
MDG,2020-18,25,0,Madagascar,27691019,Africa,146,0
MDG,2020-19,22,0,Madagascar,27691019,Africa,168,0
MDG,2020-20,133,1,Madagascar,27691019,Africa,301,1
MDG,2020-21,223,1,Madagascar,27691019,Africa,524,2
MDG,2020-22,244,4,Madagascar,27691019,Africa,768,6
MDG,2020-23,281,3,Madagascar,27691019,Africa,1049,9
MDG,2020-24,220,1,Madagascar,27691019,Africa,1269,10
MDG,2020-25,324,4,Madagascar,27691019,Africa,1593,14
MDG,2020-26,482,4,Madagascar,27691019,Africa,2075,18
MDG,2020-27,650,11,Madagascar,27691019,Africa,2725,29
MDG,2020-28,2139,6,Madagascar,27691019,Africa,4864,35
MDG,2020-29,2182,24,Madagascar,27691019,Africa,7046,59
MDG,2020-30,2246,26,Madagascar,27691019,Africa,9292,85
MDG,2020-31,2233,29,Madagascar,27691019,Africa,11525,114
MDG,2020-32,1558,34,Madagascar,27691019,Africa,13083,148
MDG,2020-33,741,22,Madagascar,27691019,Africa,13824,170
MDG,2020-34,500,8,Madagascar,27691019,Africa,14324,178
MDG,2020-35,516,13,Madagascar,27691019,Africa,14840,191
MDG,2020-36,476,9,Madagascar,27691019,Africa,15316,200
MDG,2020-37,438,11,Madagascar,27691019,Africa,15754,211
MDG,2020-38,296,12,Madagascar,27691019,Africa,16050,223
MDG,2020-39,232,6,Madagascar,27691019,Africa,16282,229
MDG,2020-40,273,3,Madagascar,27691019,Africa,16555,232
MDG,2020-41,160,5,Madagascar,27691019,Africa,16715,237
MDG,2020-42,92,1,Madagascar,27691019,Africa,16807,238
MDG,2020-43,158,6,Madagascar,27691019,Africa,16965,244
MDG,2020-44,143,0,Madagascar,27691019,Africa,17108,244
MDG,2020-45,112,5,Madagascar,27691019,Africa,17220,249
MDG,2020-46,10,0,Madagascar,27691019,Africa,17230,249
MDG,2020-47,108,2,Madagascar,27691019,Africa,17338,251
MDG,2020-48,0,0,Madagascar,27691019,Africa,17338,251
MDG,2020-49,172,4,Madagascar,27691019,Africa,17510,255
MDG,2020-50,120,3,Madagascar,27691019,Africa,17630,258
MDG,2020-51,0,2,Madagascar,27691019,Africa,17630,260
MDG,2020-52,81,1,Madagascar,27691019,Africa,17711,261
MDG,2020-53,53,1,Madagascar,27691019,Africa,17764,262
MDG,2021-01,234,5,Madagascar,27691019,Africa,17998,267
MDG,2021-02,300,6,Madagascar,27691019,Africa,18298,273
MDG,2021-03,442,6,Madagascar,27691019,Africa,18740,279
MDG,2021-04,322,2,Madagascar,27691019,Africa,19062,281
MDG,2021-05,295,4,Madagascar,27691019,Africa,19357,285
MDG,2021-06,238,7,Madagascar,27691019,Africa,19595,292
MDG,2021-07,233,5,Madagascar,27691019,Africa,19828,297
MDG,2021-08,0,0,Madagascar,27691019,Africa,19828,297
MDG,2021-09,324,3,Madagascar,27691019,Africa,20152,300
MDG,2021-10,1201,26,Madagascar,27691019,Africa,21353,326
MDG,2021-11,757,14,Madagascar,27691019,Africa,22110,340
MDG,2021-12,1472,47,Madagascar,27691019,Africa,23582,387
MDG,2021-13,1677,67,Madagascar,27691019,Africa,25259,454
MDG,2021-14,2801,61,Madagascar,27691019,Africa,28060,515
MDG,2021-15,3554,23,Madagascar,27691019,Africa,31614,538
MDG,2021-16,3645,55,Madagascar,27691019,Africa,35259,593
MDG,2021-17,2034,61,Madagascar,27691019,Africa,37293,654
MDG,2021-18,1716,68,Madagascar,27691019,Africa,39009,722
MDG,2021-19,993,32,Madagascar,27691019,Africa,40002,754
MDG,2021-20,871,46,Madagascar,27691019,Africa,40873,800
MDG,2021-21,358,29,Madagascar,27691019,Africa,41231,829
MDG,2021-22,397,30,Madagascar,27691019,Africa,41628,859
MDG,2021-23,263,23,Madagascar,27691019,Africa,41891,882
MDG,2021-24,229,19,Madagascar,27691019,Africa,42120,901
MDG,2021-25,71,5,Madagascar,27691019,Africa,42191,906
MDG,2021-26,172,19,Madagascar,27691019,Africa,42363,925
MDG,2021-27,116,6,Madagascar,27691019,Africa,42479,931
MDG,2021-28,35,5,Madagascar,27691019,Africa,42514,936
MDG,2021-29,143,7,Madagascar,27691019,Africa,42657,943
MDG,2021-30,75,4,Madagascar,27691019,Africa,42732,947
MDG,2021-31,41,1,Madagascar,27691019,Africa,42773,948
MDG,2021-32,26,3,Madagascar,27691019,Africa,42799,951
MDV,2020-11,9,0,Maldives,540542,Asia,9,0
MDV,2020-12,0,0,Maldives,540542,Asia,9,0
MDV,2020-13,4,0,Maldives,540542,Asia,13,0
MDV,2020-14,2,0,Maldives,540542,Asia,15,0
MDV,2020-15,1,0,Maldives,540542,Asia,16,0
MDV,2020-16,32,0,Maldives,540542,Asia,48,0
MDV,2020-17,162,0,Maldives,540542,Asia,210,0
MDV,2020-18,313,1,Maldives,540542,Asia,523,1
MDV,2020-19,308,2,Maldives,540542,Asia,831,3
MDV,2020-20,259,1,Maldives,540542,Asia,1090,4
MDV,2020-21,277,0,Maldives,540542,Asia,1367,4
MDV,2020-22,402,1,Maldives,540542,Asia,1769,5
MDV,2020-23,130,3,Maldives,540542,Asia,1899,8
MDV,2020-24,132,0,Maldives,540542,Asia,2031,8
MDV,2020-25,168,0,Maldives,540542,Asia,2199,8
MDV,2020-26,120,0,Maldives,540542,Asia,2319,8
MDV,2020-27,145,3,Maldives,540542,Asia,2464,11
MDV,2020-28,263,2,Maldives,540542,Asia,2727,13
MDV,2020-29,235,2,Maldives,540542,Asia,2962,15
MDV,2020-30,336,0,Maldives,540542,Asia,3298,15
MDV,2020-31,862,2,Maldives,540542,Asia,4160,17
MDV,2020-32,877,2,Maldives,540542,Asia,5037,19
MDV,2020-33,744,3,Maldives,540542,Asia,5781,22
MDV,2020-34,994,4,Maldives,540542,Asia,6775,26
MDV,2020-35,888,2,Maldives,540542,Asia,7663,28
MDV,2020-36,917,1,Maldives,540542,Asia,8580,29
MDV,2020-37,589,3,Maldives,540542,Asia,9169,32
MDV,2020-38,551,1,Maldives,540542,Asia,9720,33
MDV,2020-39,374,1,Maldives,540542,Asia,10094,34
MDV,2020-40,432,0,Maldives,540542,Asia,10526,34
MDV,2020-41,364,1,Maldives,540542,Asia,10890,35
MDV,2020-42,316,2,Maldives,540542,Asia,11206,37
MDV,2020-43,295,0,Maldives,540542,Asia,11501,37
MDV,2020-44,196,1,Maldives,540542,Asia,11697,38
MDV,2020-45,285,2,Maldives,540542,Asia,11982,40
MDV,2020-46,218,3,Maldives,540542,Asia,12200,43
MDV,2020-47,404,3,Maldives,540542,Asia,12604,46
MDV,2020-48,386,0,Maldives,540542,Asia,12990,46
MDV,2020-49,204,1,Maldives,540542,Asia,13194,47
MDV,2020-50,170,1,Maldives,540542,Asia,13364,48
MDV,2020-51,125,0,Maldives,540542,Asia,13489,48
MDV,2020-52,151,0,Maldives,540542,Asia,13640,48
MDV,2020-53,223,0,Maldives,540542,Asia,13863,48
MDV,2021-01,242,1,Maldives,540542,Asia,14105,49
MDV,2021-02,404,0,Maldives,540542,Asia,14509,49
MDV,2021-03,480,2,Maldives,540542,Asia,14989,51
MDV,2021-04,848,1,Maldives,540542,Asia,15837,52
MDV,2021-05,942,3,Maldives,540542,Asia,16779,55
MDV,2021-06,1045,3,Maldives,540542,Asia,17824,58
MDV,2021-07,941,2,Maldives,540542,Asia,18765,60
MDV,2021-08,1024,2,Maldives,540542,Asia,19789,62
MDV,2021-09,1001,2,Maldives,540542,Asia,20790,64
MDV,2021-10,778,0,Maldives,540542,Asia,21568,64
MDV,2021-11,941,2,Maldives,540542,Asia,22509,66
MDV,2021-12,724,0,Maldives,540542,Asia,23233,66
MDV,2021-13,1414,0,Maldives,540542,Asia,24647,66
MDV,2021-14,966,1,Maldives,540542,Asia,25613,67
MDV,2021-15,731,3,Maldives,540542,Asia,26344,70
MDV,2021-16,1526,1,Maldives,540542,Asia,27870,71
MDV,2021-17,2871,3,Maldives,540542,Asia,30741,74
MDV,2021-18,5070,10,Maldives,540542,Asia,35811,84
MDV,2021-19,8708,13,Maldives,540542,Asia,44519,97
MDV,2021-20,11401,32,Maldives,540542,Asia,55920,129
MDV,2021-21,7762,29,Maldives,540542,Asia,63682,158
MDV,2021-22,4264,27,Maldives,540542,Asia,67946,185
MDV,2021-23,2351,12,Maldives,540542,Asia,70297,197
MDV,2021-24,1595,9,Maldives,540542,Asia,71892,206
MDV,2021-25,1431,3,Maldives,540542,Asia,73323,209
MDV,2021-26,1024,4,Maldives,540542,Asia,74347,213
MDV,2021-27,720,1,Maldives,540542,Asia,75067,214
MDV,2021-28,808,2,Maldives,540542,Asia,75875,216
MDV,2021-29,871,3,Maldives,540542,Asia,76746,219
MDV,2021-30,797,2,Maldives,540542,Asia,77543,221
MDV,2021-31,809,1,Maldives,540542,Asia,78352,222
MDV,2021-32,781,0,Maldives,540542,Asia,79133,222
MEX,2020-02,0,0,Mexico,128932753,America,0,0
MEX,2020-03,1,0,Mexico,128932753,America,1,0
MEX,2020-04,0,0,Mexico,128932753,America,1,0
MEX,2020-05,1,0,Mexico,128932753,America,2,0
MEX,2020-06,0,0,Mexico,128932753,America,2,0
MEX,2020-07,1,0,Mexico,128932753,America,3,0
MEX,2020-08,1,0,Mexico,128932753,America,4,0
MEX,2020-09,11,0,Mexico,128932753,America,15,0
MEX,2020-10,14,0,Mexico,128932753,America,29,0
MEX,2020-11,216,0,Mexico,128932753,America,245,0
MEX,2020-12,654,2,Mexico,128932753,America,899,2
MEX,2020-13,1221,18,Mexico,128932753,America,2120,20
MEX,2020-14,2083,74,Mexico,128932753,America,4203,94
MEX,2020-15,3386,202,Mexico,128932753,America,7589,296
MEX,2020-16,6141,390,Mexico,128932753,America,13730,686
MEX,2020-17,9135,665,Mexico,128932753,America,22865,1351
MEX,2020-18,11094,803,Mexico,128932753,America,33959,2154
MEX,2020-19,14536,1311,Mexico,128932753,America,48495,3465
MEX,2020-20,19213,1712,Mexico,128932753,America,67708,5177
MEX,2020-21,23497,2217,Mexico,128932753,America,91205,7394
MEX,2020-22,26685,2536,Mexico,128932753,America,117890,9930
MEX,2020-23,30070,3769,Mexico,128932753,America,147960,13699
MEX,2020-24,34118,3442,Mexico,128932753,America,182078,17141
MEX,2020-25,37054,4684,Mexico,128932753,America,219132,21825
MEX,2020-26,38916,4823,Mexico,128932753,America,258048,26648
MEX,2020-27,42740,3991,Mexico,128932753,America,300788,30639
MEX,2020-28,44253,4367,Mexico,128932753,America,345041,35006
MEX,2020-29,49745,4178,Mexico,128932753,America,394786,39184
MEX,2020-30,48945,4496,Mexico,128932753,America,443731,43680
MEX,2020-31,44519,4066,Mexico,128932753,America,488250,47746
MEX,2020-32,40936,4552,Mexico,128932753,America,529186,52298
MEX,2020-33,37880,4459,Mexico,128932753,America,567066,56757
MEX,2020-34,36673,3723,Mexico,128932753,America,603739,60480
MEX,2020-35,37703,3678,Mexico,128932753,America,641442,64158
MEX,2020-36,37193,3400,Mexico,128932753,America,678635,67558
MEX,2020-37,33735,3263,Mexico,128932753,America,712370,70821
MEX,2020-38,28075,2672,Mexico,128932753,America,740445,73493
MEX,2020-39,31936,2937,Mexico,128932753,America,772381,76430
MEX,2020-40,30405,2658,Mexico,128932753,America,802786,79088
MEX,2020-41,29957,4554,Mexico,128932753,America,832743,83642
MEX,2020-42,18484,2525,Mexico,128932753,America,851227,86167
MEX,2020-43,39933,2757,Mexico,128932753,America,891160,88924
MEX,2020-44,38232,2971,Mexico,128932753,America,929392,91895
MEX,2020-45,38433,3132,Mexico,128932753,America,967825,95027
MEX,2020-46,38697,3515,Mexico,128932753,America,1006522,98542
MEX,2020-47,35353,3134,Mexico,128932753,America,1041875,101676
MEX,2020-48,65196,3979,Mexico,128932753,America,1107071,105655
MEX,2020-49,68779,4062,Mexico,128932753,America,1175850,109717
MEX,2020-50,74194,4236,Mexico,128932753,America,1250044,113953
MEX,2020-51,75871,4645,Mexico,128932753,America,1325915,118598
MEX,2020-52,63515,4257,Mexico,128932753,America,1389430,122855
MEX,2020-53,59325,4358,Mexico,128932753,America,1448755,127213
MEX,2021-01,92878,7155,Mexico,128932753,America,1541633,134368
MEX,2021-02,107869,6880,Mexico,128932753,America,1649502,141248
MEX,2021-03,122238,9025,Mexico,128932753,America,1771740,150273
MEX,2021-04,97968,8827,Mexico,128932753,America,1869708,159100
MEX,2021-05,66305,7631,Mexico,128932753,America,1936013,166731
MEX,2021-06,59879,7926,Mexico,128932753,America,1995892,174657
MEX,2021-07,47740,5879,Mexico,128932753,America,2043632,180536
MEX,2021-08,45649,5616,Mexico,128932753,America,2089281,186152
MEX,2021-09,41196,4771,Mexico,128932753,America,2130477,190923
MEX,2021-10,37252,4021,Mexico,128932753,America,2167729,194944
MEX,2021-11,29431,3295,Mexico,128932753,America,2197160,198239
MEX,2021-12,30682,3587,Mexico,128932753,America,2227842,201826
MEX,2021-13,23863,2513,Mexico,128932753,America,2251705,204339
MEX,2021-14,37599,6416,Mexico,128932753,America,2289304,210755
MEX,2021-15,17606,1711,Mexico,128932753,America,2306910,212466
MEX,2021-16,22624,2647,Mexico,128932753,America,2329534,215113
MEX,2021-17,20366,2232,Mexico,128932753,America,2349900,217345
MEX,2021-18,16596,1744,Mexico,128932753,America,2366496,219089
MEX,2021-19,15427,1348,Mexico,128932753,America,2381923,220437
MEX,2021-20,15384,1258,Mexico,128932753,America,2397307,221695
MEX,2021-21,16435,1873,Mexico,128932753,America,2413742,223568
MEX,2021-22,20820,5270,Mexico,128932753,America,2434562,228838
MEX,2021-23,20789,1347,Mexico,128932753,America,2455351,230185
MEX,2021-24,23200,1059,Mexico,128932753,America,2478551,231244
MEX,2021-25,28902,1364,Mexico,128932753,America,2507453,232608
MEX,2021-26,34420,1081,Mexico,128932753,America,2541873,233689
MEX,2021-27,51701,1369,Mexico,128932753,America,2593574,235058
MEX,2021-28,70870,1411,Mexico,128932753,America,2664444,236469
MEX,2021-29,89994,2126,Mexico,128932753,America,2754438,238595
MEX,2021-30,107060,2684,Mexico,128932753,America,2861498,241279
MEX,2021-31,116832,3411,Mexico,128932753,America,2978330,244690
MEX,2021-32,130108,3962,Mexico,128932753,America,3108438,248652
MHL,2020-45,0,0,Marshall Islands,59194,Oceania,0,0
MHL,2020-46,0,0,Marshall Islands,59194,Oceania,0,0
MHL,2020-47,3,0,Marshall Islands,59194,Oceania,3,0
MHL,2020-48,0,0,Marshall Islands,59194,Oceania,3,0
MHL,2020-49,0,0,Marshall Islands,59194,Oceania,3,0
MHL,2020-50,0,0,Marshall Islands,59194,Oceania,3,0
MHL,2020-51,0,0,Marshall Islands,59194,Oceania,3,0
MHL,2020-52,0,0,Marshall Islands,59194,Oceania,3,0
MHL,2020-53,0,0,Marshall Islands,59194,Oceania,3,0
MHL,2021-01,0,0,Marshall Islands,59194,Oceania,3,0
MHL,2021-02,0,0,Marshall Islands,59194,Oceania,3,0
MHL,2021-03,0,0,Marshall Islands,59194,Oceania,3,0
MHL,2021-04,0,0,Marshall Islands,59194,Oceania,3,0
MHL,2021-05,0,0,Marshall Islands,59194,Oceania,3,0
MHL,2021-06,0,0,Marshall Islands,59194,Oceania,3,0
MHL,2021-07,0,0,Marshall Islands,59194,Oceania,3,0
MHL,2021-08,0,0,Marshall Islands,59194,Oceania,3,0
MHL,2021-09,0,0,Marshall Islands,59194,Oceania,3,0
MHL,2021-10,0,0,Marshall Islands,59194,Oceania,3,0
MHL,2021-11,0,0,Marshall Islands,59194,Oceania,3,0
MHL,2021-12,0,0,Marshall Islands,59194,Oceania,3,0
MHL,2021-13,0,0,Marshall Islands,59194,Oceania,3,0
MHL,2021-14,0,0,Marshall Islands,59194,Oceania,3,0
MHL,2021-15,0,0,Marshall Islands,59194,Oceania,3,0
MHL,2021-16,0,0,Marshall Islands,59194,Oceania,3,0
MHL,2021-17,0,0,Marshall Islands,59194,Oceania,3,0
MHL,2021-18,0,0,Marshall Islands,59194,Oceania,3,0
MHL,2021-19,0,0,Marshall Islands,59194,Oceania,3,0
MHL,2021-20,0,0,Marshall Islands,59194,Oceania,3,0
MHL,2021-21,0,0,Marshall Islands,59194,Oceania,3,0
MHL,2021-22,0,0,Marshall Islands,59194,Oceania,3,0
MHL,2021-23,0,0,Marshall Islands,59194,Oceania,3,0
MHL,2021-24,0,0,Marshall Islands,59194,Oceania,3,0
MHL,2021-25,0,0,Marshall Islands,59194,Oceania,3,0
MHL,2021-26,0,0,Marshall Islands,59194,Oceania,3,0
MHL,2021-27,0,0,Marshall Islands,59194,Oceania,3,0
MHL,2021-28,0,0,Marshall Islands,59194,Oceania,3,0
MHL,2021-29,0,0,Marshall Islands,59194,Oceania,3,0
MHL,2021-30,0,0,Marshall Islands,59194,Oceania,3,0
MHL,2021-31,0,0,Marshall Islands,59194,Oceania,3,0
MHL,2021-32,0,0,Marshall Islands,59194,Oceania,3,0
MKD,2020-02,0,0,North Macedonia,2076255,Europe,0,0
MKD,2020-03,0,0,North Macedonia,2076255,Europe,0,0
MKD,2020-04,0,0,North Macedonia,2076255,Europe,0,0
MKD,2020-05,0,0,North Macedonia,2076255,Europe,0,0
MKD,2020-06,0,0,North Macedonia,2076255,Europe,0,0
MKD,2020-07,0,0,North Macedonia,2076255,Europe,0,0
MKD,2020-08,0,0,North Macedonia,2076255,Europe,0,0
MKD,2020-09,1,0,North Macedonia,2076255,Europe,1,0
MKD,2020-10,2,0,North Macedonia,2076255,Europe,3,0
MKD,2020-11,10,0,North Macedonia,2076255,Europe,13,0
MKD,2020-12,101,1,North Macedonia,2076255,Europe,114,1
MKD,2020-13,145,5,North Macedonia,2076255,Europe,259,6
MKD,2020-14,224,11,North Macedonia,2076255,Europe,483,17
MKD,2020-15,345,17,North Macedonia,2076255,Europe,828,34
MKD,2020-16,379,17,North Macedonia,2076255,Europe,1207,51
MKD,2020-17,179,10,North Macedonia,2076255,Europe,1386,61
MKD,2020-18,125,23,North Macedonia,2076255,Europe,1511,84
MKD,2020-19,131,7,North Macedonia,2076255,Europe,1642,91
MKD,2020-20,150,10,North Macedonia,2076255,Europe,1792,101
MKD,2020-21,186,12,North Macedonia,2076255,Europe,1978,113
MKD,2020-22,248,20,North Macedonia,2076255,Europe,2226,133
MKD,2020-23,802,20,North Macedonia,2076255,Europe,3028,153
MKD,2020-24,1029,35,North Macedonia,2076255,Europe,4057,188
MKD,2020-25,1049,50,North Macedonia,2076255,Europe,5106,238
MKD,2020-26,986,48,North Macedonia,2076255,Europe,6092,286
MKD,2020-27,954,55,North Macedonia,2076255,Europe,7046,341
MKD,2020-28,1065,41,North Macedonia,2076255,Europe,8111,382
MKD,2020-29,1021,40,North Macedonia,2076255,Europe,9132,422
MKD,2020-30,954,38,North Macedonia,2076255,Europe,10086,460
MKD,2020-31,968,37,North Macedonia,2076255,Europe,11054,497
MKD,2020-32,802,30,North Macedonia,2076255,Europe,11856,527
MKD,2020-33,883,17,North Macedonia,2076255,Europe,12739,544
MKD,2020-34,775,19,North Macedonia,2076255,Europe,13514,563
MKD,2020-35,413,21,North Macedonia,2076255,Europe,13927,584
MKD,2020-36,835,22,North Macedonia,2076255,Europe,14762,606
MKD,2020-37,932,40,North Macedonia,2076255,Europe,15694,646
MKD,2020-38,1041,47,North Macedonia,2076255,Europe,16735,693
MKD,2020-39,894,32,North Macedonia,2076255,Europe,17629,725
MKD,2020-40,973,28,North Macedonia,2076255,Europe,18602,753
MKD,2020-41,2335,39,North Macedonia,2076255,Europe,20937,792
MKD,2020-42,2691,42,North Macedonia,2076255,Europe,23628,834
MKD,2020-43,3326,85,North Macedonia,2076255,Europe,26954,919
MKD,2020-44,5482,85,North Macedonia,2076255,Europe,32436,1004
MKD,2020-45,7324,132,North Macedonia,2076255,Europe,39760,1136
MKD,2020-46,7290,169,North Macedonia,2076255,Europe,47050,1305
MKD,2020-47,7693,206,North Macedonia,2076255,Europe,54743,1511
MKD,2020-48,6800,220,North Macedonia,2076255,Europe,61543,1731
MKD,2020-49,6425,193,North Macedonia,2076255,Europe,67968,1924
MKD,2020-50,5670,197,North Macedonia,2076255,Europe,73638,2121
MKD,2020-51,4667,171,North Macedonia,2076255,Europe,78305,2292
MKD,2020-52,3499,164,North Macedonia,2076255,Europe,81804,2456
MKD,2020-53,2220,74,North Macedonia,2076255,Europe,84024,2530
MKD,2021-01,2470,92,North Macedonia,2076255,Europe,86494,2622
MKD,2021-02,2444,80,North Macedonia,2076255,Europe,88938,2702
MKD,2021-03,1716,83,North Macedonia,2076255,Europe,90654,2785
MKD,2021-04,2039,70,North Macedonia,2076255,Europe,92693,2855
MKD,2021-05,2105,69,North Macedonia,2076255,Europe,94798,2924
MKD,2021-06,2254,65,North Macedonia,2076255,Europe,97052,2989
MKD,2021-07,2233,74,North Macedonia,2076255,Europe,99285,3063
MKD,2021-08,3502,74,North Macedonia,2076255,Europe,102787,3137
MKD,2021-09,4376,58,North Macedonia,2076255,Europe,107163,3195
MKD,2021-10,5483,124,North Macedonia,2076255,Europe,112646,3319
MKD,2021-11,6732,154,North Macedonia,2076255,Europe,119378,3473
MKD,2021-12,7560,202,North Macedonia,2076255,Europe,126938,3675
MKD,2021-13,7196,230,North Macedonia,2076255,Europe,134134,3905
MKD,2021-14,7710,323,North Macedonia,2076255,Europe,141844,4228
MKD,2021-15,5250,215,North Macedonia,2076255,Europe,147094,4443
MKD,2021-16,3494,234,North Macedonia,2076255,Europe,150588,4677
MKD,2021-17,2097,259,North Macedonia,2076255,Europe,152685,4936
MKD,2021-18,1341,157,North Macedonia,2076255,Europe,154026,5093
MKD,2021-19,672,118,North Macedonia,2076255,Europe,154698,5211
MKD,2021-20,365,100,North Macedonia,2076255,Europe,155063,5311
MKD,2021-21,209,102,North Macedonia,2076255,Europe,155272,5413
MKD,2021-22,146,45,North Macedonia,2076255,Europe,155418,5458
MKD,2021-23,118,13,North Macedonia,2076255,Europe,155536,5471
MKD,2021-24,88,4,North Macedonia,2076255,Europe,155624,5475
MKD,2021-25,49,9,North Macedonia,2076255,Europe,155673,5484
MKD,2021-26,43,2,North Macedonia,2076255,Europe,155716,5486
MKD,2021-27,86,1,North Macedonia,2076255,Europe,155802,5487
MKD,2021-28,129,0,North Macedonia,2076255,Europe,155931,5487
MKD,2021-29,155,4,North Macedonia,2076255,Europe,156086,5491
MKD,2021-30,366,2,North Macedonia,2076255,Europe,156452,5493
MKD,2021-31,1573,14,North Macedonia,2076255,Europe,158025,5507
MKD,2021-32,4139,45,North Macedonia,2076255,Europe,162164,5552
MLI,2020-14,27,5,Mali,20250834,Africa,27,5
MLI,2020-15,71,4,Mali,20250834,Africa,98,9
MLI,2020-16,108,5,Mali,20250834,Africa,206,14
MLI,2020-17,165,9,Mali,20250834,Africa,371,23
MLI,2020-18,174,4,Mali,20250834,Africa,545,27
MLI,2020-19,141,11,Mali,20250834,Africa,686,38
MLI,2020-20,156,14,Mali,20250834,Africa,842,52
MLI,2020-21,170,13,Mali,20250834,Africa,1012,65
MLI,2020-22,235,12,Mali,20250834,Africa,1247,77
MLI,2020-23,268,15,Mali,20250834,Africa,1515,92
MLI,2020-24,276,12,Mali,20250834,Africa,1791,104
MLI,2020-25,152,7,Mali,20250834,Africa,1943,111
MLI,2020-26,186,3,Mali,20250834,Africa,2129,114
MLI,2020-27,183,5,Mali,20250834,Africa,2312,119
MLI,2020-28,81,2,Mali,20250834,Africa,2393,121
MLI,2020-29,64,0,Mali,20250834,Africa,2457,121
MLI,2020-30,35,2,Mali,20250834,Africa,2492,123
MLI,2020-31,31,1,Mali,20250834,Africa,2523,124
MLI,2020-32,26,1,Mali,20250834,Africa,2549,125
MLI,2020-33,47,0,Mali,20250834,Africa,2596,125
MLI,2020-34,91,0,Mali,20250834,Africa,2687,125
MLI,2020-35,68,1,Mali,20250834,Africa,2755,126
MLI,2020-36,69,1,Mali,20250834,Africa,2824,127
MLI,2020-37,82,1,Mali,20250834,Africa,2906,128
MLI,2020-38,89,0,Mali,20250834,Africa,2995,128
MLI,2020-39,73,2,Mali,20250834,Africa,3068,130
MLI,2020-40,98,1,Mali,20250834,Africa,3166,131
MLI,2020-41,102,1,Mali,20250834,Africa,3268,132
MLI,2020-42,93,0,Mali,20250834,Africa,3361,132
MLI,2020-43,111,1,Mali,20250834,Africa,3472,133
MLI,2020-44,55,3,Mali,20250834,Africa,3527,136
MLI,2020-45,131,1,Mali,20250834,Africa,3658,137
MLI,2020-46,192,2,Mali,20250834,Africa,3850,139
MLI,2020-47,338,4,Mali,20250834,Africa,4188,143
MLI,2020-48,453,6,Mali,20250834,Africa,4641,149
MLI,2020-49,476,15,Mali,20250834,Africa,5117,164
MLI,2020-50,679,30,Mali,20250834,Africa,5796,194
MLI,2020-51,377,28,Mali,20250834,Africa,6173,222
MLI,2020-52,512,34,Mali,20250834,Africa,6685,256
MLI,2020-53,550,22,Mali,20250834,Africa,7235,278
MLI,2021-01,347,20,Mali,20250834,Africa,7582,298
MLI,2021-02,239,13,Mali,20250834,Africa,7821,311
MLI,2021-03,144,11,Mali,20250834,Africa,7965,322
MLI,2021-04,117,8,Mali,20250834,Africa,8082,330
MLI,2021-05,76,8,Mali,20250834,Africa,8158,338
MLI,2021-06,53,4,Mali,20250834,Africa,8211,342
MLI,2021-07,70,6,Mali,20250834,Africa,8281,348
MLI,2021-08,77,5,Mali,20250834,Africa,8358,353
MLI,2021-09,204,5,Mali,20250834,Africa,8562,358
MLI,2021-10,333,2,Mali,20250834,Africa,8895,360
MLI,2021-11,417,8,Mali,20250834,Africa,9312,368
MLI,2021-12,541,11,Mali,20250834,Africa,9853,379
MLI,2021-13,630,13,Mali,20250834,Africa,10483,392
MLI,2021-14,1343,16,Mali,20250834,Africa,11826,408
MLI,2021-15,1226,25,Mali,20250834,Africa,13052,433
MLI,2021-16,557,34,Mali,20250834,Africa,13609,467
MLI,2021-17,288,22,Mali,20250834,Africa,13897,489
MLI,2021-18,193,11,Mali,20250834,Africa,14090,500
MLI,2021-19,82,11,Mali,20250834,Africa,14172,511
MLI,2021-20,51,3,Mali,20250834,Africa,14223,514
MLI,2021-21,24,3,Mali,20250834,Africa,14247,517
MLI,2021-22,33,2,Mali,20250834,Africa,14280,519
MLI,2021-23,52,4,Mali,20250834,Africa,14332,523
MLI,2021-24,31,1,Mali,20250834,Africa,14363,524
MLI,2021-25,36,1,Mali,20250834,Africa,14399,525
MLI,2021-26,32,2,Mali,20250834,Africa,14431,527
MLI,2021-27,14,1,Mali,20250834,Africa,14445,528
MLI,2021-28,50,2,Mali,20250834,Africa,14495,530
MLI,2021-29,29,0,Mali,20250834,Africa,14524,530
MLI,2021-30,45,3,Mali,20250834,Africa,14569,533
MLI,2021-31,55,1,Mali,20250834,Africa,14624,534
MLI,2021-32,53,1,Mali,20250834,Africa,14677,535
MLT,2020-11,27,0,Malta,514564,Europe,27,0
MLT,2020-12,77,0,Malta,514564,Europe,104,0
MLT,2020-13,49,0,Malta,514564,Europe,153,0
MLT,2020-14,85,0,Malta,514564,Europe,238,0
MLT,2020-15,143,3,Malta,514564,Europe,381,3
MLT,2020-16,47,0,Malta,514564,Europe,428,3
MLT,2020-17,18,1,Malta,514564,Europe,446,4
MLT,2020-18,30,0,Malta,514564,Europe,476,4
MLT,2020-19,23,1,Malta,514564,Europe,499,5
MLT,2020-20,55,1,Malta,514564,Europe,554,6
MLT,2020-21,53,0,Malta,514564,Europe,607,6
MLT,2020-22,8,3,Malta,514564,Europe,615,9
MLT,2020-23,11,0,Malta,514564,Europe,626,9
MLT,2020-24,20,0,Malta,514564,Europe,646,9
MLT,2020-25,15,0,Malta,514564,Europe,661,9
MLT,2020-26,5,0,Malta,514564,Europe,666,9
MLT,2020-27,2,0,Malta,514564,Europe,668,9
MLT,2020-28,2,0,Malta,514564,Europe,670,9
MLT,2020-29,2,0,Malta,514564,Europe,672,9
MLT,2020-30,24,0,Malta,514564,Europe,696,9
MLT,2020-31,84,0,Malta,514564,Europe,780,9
MLT,2020-32,223,0,Malta,514564,Europe,1003,9
MLT,2020-33,367,0,Malta,514564,Europe,1370,9
MLT,2020-34,295,1,Malta,514564,Europe,1665,10
MLT,2020-35,217,2,Malta,514564,Europe,1882,12
MLT,2020-36,192,2,Malta,514564,Europe,2074,14
MLT,2020-37,329,1,Malta,514564,Europe,2403,15
MLT,2020-38,371,6,Malta,514564,Europe,2774,21
MLT,2020-39,230,11,Malta,514564,Europe,3004,32
MLT,2020-40,311,7,Malta,514564,Europe,3315,39
MLT,2020-41,517,4,Malta,514564,Europe,3832,43
MLT,2020-42,894,2,Malta,514564,Europe,4726,45
MLT,2020-43,838,8,Malta,514564,Europe,5564,53
MLT,2020-44,823,8,Malta,514564,Europe,6387,61
MLT,2020-45,842,14,Malta,514564,Europe,7229,75
MLT,2020-46,894,20,Malta,514564,Europe,8123,95
MLT,2020-47,867,15,Malta,514564,Europe,8990,110
MLT,2020-48,869,25,Malta,514564,Europe,9859,135
MLT,2020-49,786,15,Malta,514564,Europe,10645,150
MLT,2020-50,595,21,Malta,514564,Europe,11240,171
MLT,2020-51,548,20,Malta,514564,Europe,11788,191
MLT,2020-52,624,20,Malta,514564,Europe,12412,211
MLT,2020-53,804,6,Malta,514564,Europe,13216,217
MLT,2021-01,1299,11,Malta,514564,Europe,14515,228
MLT,2021-02,1213,7,Malta,514564,Europe,15728,235
MLT,2021-03,1119,12,Malta,514564,Europe,16847,247
MLT,2021-04,1021,22,Malta,514564,Europe,17868,269
MLT,2021-05,896,13,Malta,514564,Europe,18764,282
MLT,2021-06,1132,13,Malta,514564,Europe,19896,295
MLT,2021-07,1140,9,Malta,514564,Europe,21036,304
MLT,2021-08,1908,12,Malta,514564,Europe,22944,316
MLT,2021-09,1854,18,Malta,514564,Europe,24798,334
MLT,2021-10,2205,20,Malta,514564,Europe,27003,354
MLT,2021-11,1348,19,Malta,514564,Europe,28351,373
MLT,2021-12,584,15,Malta,514564,Europe,28935,388
MLT,2021-13,350,11,Malta,514564,Europe,29285,399
MLT,2021-14,377,3,Malta,514564,Europe,29662,402
MLT,2021-15,319,7,Malta,514564,Europe,29981,409
MLT,2021-16,195,4,Malta,514564,Europe,30176,413
MLT,2021-17,147,3,Malta,514564,Europe,30323,416
MLT,2021-18,83,1,Malta,514564,Europe,30406,417
MLT,2021-19,22,0,Malta,514564,Europe,30428,417
MLT,2021-20,23,0,Malta,514564,Europe,30451,417
MLT,2021-21,34,2,Malta,514564,Europe,30485,419
MLT,2021-22,29,0,Malta,514564,Europe,30514,419
MLT,2021-23,10,0,Malta,514564,Europe,30524,419
MLT,2021-24,13,1,Malta,514564,Europe,30537,420
MLT,2021-25,23,0,Malta,514564,Europe,30560,420
MLT,2021-26,57,0,Malta,514564,Europe,30617,420
MLT,2021-27,705,0,Malta,514564,Europe,31322,420
MLT,2021-28,1439,0,Malta,514564,Europe,32761,420
MLT,2021-29,1071,1,Malta,514564,Europe,33832,421
MLT,2021-30,604,2,Malta,514564,Europe,34436,423
MLT,2021-31,463,5,Malta,514564,Europe,34899,428
MLT,2021-32,478,3,Malta,514564,Europe,35377,431
MMR,2020-14,13,1,Myanmar,54409794,Asia,13,1
MMR,2020-15,20,3,Myanmar,54409794,Asia,33,4
MMR,2020-16,70,1,Myanmar,54409794,Asia,103,5
MMR,2020-17,35,0,Myanmar,54409794,Asia,138,5
MMR,2020-18,9,1,Myanmar,54409794,Asia,147,6
MMR,2020-19,25,0,Myanmar,54409794,Asia,172,6
MMR,2020-20,7,0,Myanmar,54409794,Asia,179,6
MMR,2020-21,14,0,Myanmar,54409794,Asia,193,6
MMR,2020-22,27,0,Myanmar,54409794,Asia,220,6
MMR,2020-23,15,0,Myanmar,54409794,Asia,235,6
MMR,2020-24,19,0,Myanmar,54409794,Asia,254,6
MMR,2020-25,28,0,Myanmar,54409794,Asia,282,6
MMR,2020-26,9,0,Myanmar,54409794,Asia,291,6
MMR,2020-27,14,0,Myanmar,54409794,Asia,305,6
MMR,2020-28,18,0,Myanmar,54409794,Asia,323,6
MMR,2020-29,10,0,Myanmar,54409794,Asia,333,6
MMR,2020-30,9,0,Myanmar,54409794,Asia,342,6
MMR,2020-31,3,0,Myanmar,54409794,Asia,345,6
MMR,2020-32,7,0,Myanmar,54409794,Asia,352,6
MMR,2020-33,15,0,Myanmar,54409794,Asia,367,6
MMR,2020-34,88,0,Myanmar,54409794,Asia,455,6
MMR,2020-35,324,0,Myanmar,54409794,Asia,779,6
MMR,2020-36,677,2,Myanmar,54409794,Asia,1456,8
MMR,2020-37,1551,16,Myanmar,54409794,Asia,3007,24
MMR,2020-38,2790,70,Myanmar,54409794,Asia,5797,94
MMR,2020-39,4929,132,Myanmar,54409794,Asia,10726,226
MMR,2020-40,7060,186,Myanmar,54409794,Asia,17786,412
MMR,2020-41,10180,234,Myanmar,54409794,Asia,27966,646
MMR,2020-42,8051,234,Myanmar,54409794,Asia,36017,880
MMR,2020-43,8749,215,Myanmar,54409794,Asia,44766,1095
MMR,2020-44,8631,163,Myanmar,54409794,Asia,53397,1258
MMR,2020-45,7972,162,Myanmar,54409794,Asia,61369,1420
MMR,2020-46,7617,157,Myanmar,54409794,Asia,68986,1577
MMR,2020-47,10252,162,Myanmar,54409794,Asia,79238,1739
MMR,2020-48,10240,179,Myanmar,54409794,Asia,89478,1918
MMR,2020-49,9669,192,Myanmar,54409794,Asia,99147,2110
MMR,2020-50,9187,158,Myanmar,54409794,Asia,108334,2268
MMR,2020-51,7792,175,Myanmar,54409794,Asia,116126,2443
MMR,2020-52,5752,158,Myanmar,54409794,Asia,121878,2601
MMR,2020-53,4459,127,Myanmar,54409794,Asia,126337,2728
MMR,2021-01,4259,118,Myanmar,54409794,Asia,130596,2846
MMR,2021-02,3714,109,Myanmar,54409794,Asia,134310,2955
MMR,2021-03,3256,107,Myanmar,54409794,Asia,137566,3062
MMR,2021-04,2571,69,Myanmar,54409794,Asia,140137,3131
MMR,2021-05,1278,44,Myanmar,54409794,Asia,141415,3175
MMR,2021-06,178,14,Myanmar,54409794,Asia,141593,3189
MMR,2021-07,149,7,Myanmar,54409794,Asia,141742,3196
MMR,2021-08,146,3,Myanmar,54409794,Asia,141888,3199
MMR,2021-09,138,1,Myanmar,54409794,Asia,142026,3200
MMR,2021-10,113,0,Myanmar,54409794,Asia,142139,3200
MMR,2021-11,99,4,Myanmar,54409794,Asia,142238,3204
MMR,2021-12,139,2,Myanmar,54409794,Asia,142377,3206
MMR,2021-13,156,0,Myanmar,54409794,Asia,142533,3206
MMR,2021-14,46,0,Myanmar,54409794,Asia,142579,3206
MMR,2021-15,43,0,Myanmar,54409794,Asia,142622,3206
MMR,2021-16,92,1,Myanmar,54409794,Asia,142714,3207
MMR,2021-17,116,2,Myanmar,54409794,Asia,142830,3209
MMR,2021-18,116,1,Myanmar,54409794,Asia,142946,3210
MMR,2021-19,111,2,Myanmar,54409794,Asia,143057,3212
MMR,2021-20,231,4,Myanmar,54409794,Asia,143288,3216
MMR,2021-21,275,0,Myanmar,54409794,Asia,143563,3216
MMR,2021-22,746,9,Myanmar,54409794,Asia,144309,3225
MMR,2021-23,1286,19,Myanmar,54409794,Asia,145595,3244
MMR,2021-24,2419,18,Myanmar,54409794,Asia,148014,3262
MMR,2021-25,5138,35,Myanmar,54409794,Asia,153152,3297
MMR,2021-26,12245,122,Myanmar,54409794,Asia,165397,3419
MMR,2021-27,26808,419,Myanmar,54409794,Asia,192205,3838
MMR,2021-28,37308,1162,Myanmar,54409794,Asia,229513,5000
MMR,2021-29,40004,2111,Myanmar,54409794,Asia,269517,7111
MMR,2021-30,33140,2620,Myanmar,54409794,Asia,302657,9731
MMR,2021-31,26851,2045,Myanmar,54409794,Asia,329508,11776
MMR,2021-32,24763,1487,Myanmar,54409794,Asia,354271,13263
MNE,2020-13,64,1,Montenegro,621873,Europe,64,1
MNE,2020-14,129,1,Montenegro,621873,Europe,193,2
MNE,2020-15,58,1,Montenegro,621873,Europe,251,3
MNE,2020-16,36,2,Montenegro,621873,Europe,287,5
MNE,2020-17,13,2,Montenegro,621873,Europe,300,7
MNE,2020-18,1,1,Montenegro,621873,Europe,301,8
MNE,2020-19,2,1,Montenegro,621873,Europe,303,9
MNE,2020-20,0,0,Montenegro,621873,Europe,303,9
MNE,2020-21,0,0,Montenegro,621873,Europe,303,9
MNE,2020-22,0,0,Montenegro,621873,Europe,303,9
MNE,2020-23,0,0,Montenegro,621873,Europe,303,9
MNE,2020-24,1,0,Montenegro,621873,Europe,304,9
MNE,2020-25,37,0,Montenegro,621873,Europe,341,9
MNE,2020-26,119,2,Montenegro,621873,Europe,460,11
MNE,2020-27,300,3,Montenegro,621873,Europe,760,14
MNE,2020-28,440,9,Montenegro,621873,Europe,1200,23
MNE,2020-29,550,7,Montenegro,621873,Europe,1750,30
MNE,2020-30,798,10,Montenegro,621873,Europe,2548,40
MNE,2020-31,689,11,Montenegro,621873,Europe,3237,51
MNE,2020-32,360,13,Montenegro,621873,Europe,3597,64
MNE,2020-33,417,13,Montenegro,621873,Europe,4014,77
MNE,2020-34,308,7,Montenegro,621873,Europe,4322,84
MNE,2020-35,447,14,Montenegro,621873,Europe,4769,98
MNE,2020-36,763,10,Montenegro,621873,Europe,5532,108
MNE,2020-37,1159,12,Montenegro,621873,Europe,6691,120
MNE,2020-38,1900,16,Montenegro,621873,Europe,8591,136
MNE,2020-39,1701,22,Montenegro,621873,Europe,10292,158
MNE,2020-40,1814,21,Montenegro,621873,Europe,12106,179
MNE,2020-41,1742,23,Montenegro,621873,Europe,13848,202
MNE,2020-42,1746,34,Montenegro,621873,Europe,15594,236
MNE,2020-43,1182,30,Montenegro,621873,Europe,16776,266
MNE,2020-44,1917,47,Montenegro,621873,Europe,18693,313
MNE,2020-45,4091,24,Montenegro,621873,Europe,22784,337
MNE,2020-46,4372,54,Montenegro,621873,Europe,27156,391
MNE,2020-47,3885,48,Montenegro,621873,Europe,31041,439
MNE,2020-48,3819,48,Montenegro,621873,Europe,34860,487
MNE,2020-49,3365,46,Montenegro,621873,Europe,38225,533
MNE,2020-50,3180,49,Montenegro,621873,Europe,41405,582
MNE,2020-51,2529,44,Montenegro,621873,Europe,43934,626
MNE,2020-52,2739,40,Montenegro,621873,Europe,46673,666
MNE,2020-53,2501,23,Montenegro,621873,Europe,49174,689
MNE,2021-01,3236,36,Montenegro,621873,Europe,52410,725
MNE,2021-02,3062,20,Montenegro,621873,Europe,55472,745
MNE,2021-03,2823,23,Montenegro,621873,Europe,58295,768
MNE,2021-04,3343,37,Montenegro,621873,Europe,61638,805
MNE,2021-05,3568,33,Montenegro,621873,Europe,65206,838
MNE,2021-06,3694,52,Montenegro,621873,Europe,68900,890
MNE,2021-07,3074,60,Montenegro,621873,Europe,71974,950
MNE,2021-08,3838,53,Montenegro,621873,Europe,75812,1003
MNE,2021-09,4358,82,Montenegro,621873,Europe,80170,1085
MNE,2021-10,3502,44,Montenegro,621873,Europe,83672,1129
MNE,2021-11,3519,70,Montenegro,621873,Europe,87191,1199
MNE,2021-12,2871,46,Montenegro,621873,Europe,90062,1245
MNE,2021-13,2436,60,Montenegro,621873,Europe,92498,1305
MNE,2021-14,1900,76,Montenegro,621873,Europe,94398,1381
MNE,2021-15,1132,48,Montenegro,621873,Europe,95530,1429
MNE,2021-16,1109,36,Montenegro,621873,Europe,96639,1465
MNE,2021-17,1058,45,Montenegro,621873,Europe,97697,1510
MNE,2021-18,585,30,Montenegro,621873,Europe,98282,1540
MNE,2021-19,595,21,Montenegro,621873,Europe,98877,1561
MNE,2021-20,350,13,Montenegro,621873,Europe,99227,1574
MNE,2021-21,357,9,Montenegro,621873,Europe,99584,1583
MNE,2021-22,207,9,Montenegro,621873,Europe,99791,1592
MNE,2021-23,144,9,Montenegro,621873,Europe,99935,1601
MNE,2021-24,119,4,Montenegro,621873,Europe,100054,1605
MNE,2021-25,115,4,Montenegro,621873,Europe,100169,1609
MNE,2021-26,137,6,Montenegro,621873,Europe,100306,1615
MNE,2021-27,161,6,Montenegro,621873,Europe,100467,1621
MNE,2021-28,202,2,Montenegro,621873,Europe,100669,1623
MNE,2021-29,440,1,Montenegro,621873,Europe,101109,1624
MNE,2021-30,962,6,Montenegro,621873,Europe,102071,1630
MNE,2021-31,1630,5,Montenegro,621873,Europe,103701,1635
MNE,2021-32,2771,11,Montenegro,621873,Europe,106472,1646
MNG,2020-13,2,0,Mongolia,3278292,Asia,2,0
MNG,2020-14,2,0,Mongolia,3278292,Asia,4,0
MNG,2020-15,2,0,Mongolia,3278292,Asia,6,0
MNG,2020-16,16,0,Mongolia,3278292,Asia,22,0
MNG,2020-17,6,0,Mongolia,3278292,Asia,28,0
MNG,2020-18,2,0,Mongolia,3278292,Asia,30,0
MNG,2020-19,2,0,Mongolia,3278292,Asia,32,0
MNG,2020-20,98,0,Mongolia,3278292,Asia,130,0
MNG,2020-21,1,0,Mongolia,3278292,Asia,131,0
MNG,2020-22,44,0,Mongolia,3278292,Asia,175,0
MNG,2020-23,9,0,Mongolia,3278292,Asia,184,0
MNG,2020-24,3,0,Mongolia,3278292,Asia,187,0
MNG,2020-25,16,0,Mongolia,3278292,Asia,203,0
MNG,2020-26,7,0,Mongolia,3278292,Asia,210,0
MNG,2020-27,0,0,Mongolia,3278292,Asia,210,0
MNG,2020-28,10,0,Mongolia,3278292,Asia,220,0
MNG,2020-29,57,0,Mongolia,3278292,Asia,277,0
MNG,2020-30,1,0,Mongolia,3278292,Asia,278,0
MNG,2020-31,5,0,Mongolia,3278292,Asia,283,0
MNG,2020-32,0,0,Mongolia,3278292,Asia,283,0
MNG,2020-33,5,0,Mongolia,3278292,Asia,288,0
MNG,2020-34,0,0,Mongolia,3278292,Asia,288,0
MNG,2020-35,3,0,Mongolia,3278292,Asia,291,0
MNG,2020-36,9,0,Mongolia,3278292,Asia,300,0
MNG,2020-37,1,0,Mongolia,3278292,Asia,301,0
MNG,2020-38,1,0,Mongolia,3278292,Asia,302,0
MNG,2020-39,1,0,Mongolia,3278292,Asia,303,0
MNG,2020-40,1,0,Mongolia,3278292,Asia,304,0
MNG,2020-41,4,0,Mongolia,3278292,Asia,308,0
MNG,2020-42,6,0,Mongolia,3278292,Asia,314,0
MNG,2020-43,15,0,Mongolia,3278292,Asia,329,0
MNG,2020-44,10,0,Mongolia,3278292,Asia,339,0
MNG,2020-45,19,0,Mongolia,3278292,Asia,358,0
MNG,2020-46,63,0,Mongolia,3278292,Asia,421,0
MNG,2020-47,209,0,Mongolia,3278292,Asia,630,0
MNG,2020-48,151,0,Mongolia,3278292,Asia,781,0
MNG,2020-49,96,0,Mongolia,3278292,Asia,877,0
MNG,2020-50,25,0,Mongolia,3278292,Asia,902,0
MNG,2020-51,81,0,Mongolia,3278292,Asia,983,0
MNG,2020-52,144,0,Mongolia,3278292,Asia,1127,0
MNG,2020-53,149,0,Mongolia,3278292,Asia,1276,0
MNG,2021-01,156,0,Mongolia,3278292,Asia,1432,0
MNG,2021-02,84,0,Mongolia,3278292,Asia,1516,0
MNG,2021-03,117,0,Mongolia,3278292,Asia,1633,0
MNG,2021-04,171,2,Mongolia,3278292,Asia,1804,2
MNG,2021-05,259,0,Mongolia,3278292,Asia,2063,2
MNG,2021-06,310,0,Mongolia,3278292,Asia,2373,2
MNG,2021-07,310,0,Mongolia,3278292,Asia,2683,2
MNG,2021-08,259,0,Mongolia,3278292,Asia,2942,2
MNG,2021-09,384,1,Mongolia,3278292,Asia,3326,3
MNG,2021-10,497,1,Mongolia,3278292,Asia,3823,4
MNG,2021-11,1353,1,Mongolia,3278292,Asia,5176,5
MNG,2021-12,2403,1,Mongolia,3278292,Asia,7579,6
MNG,2021-13,3231,5,Mongolia,3278292,Asia,10810,11
MNG,2021-14,4898,14,Mongolia,3278292,Asia,15708,25
MNG,2021-15,7166,24,Mongolia,3278292,Asia,22874,49
MNG,2021-16,8455,31,Mongolia,3278292,Asia,31329,80
MNG,2021-17,8042,35,Mongolia,3278292,Asia,39371,115
MNG,2021-18,6078,55,Mongolia,3278292,Asia,45449,170
MNG,2021-19,3716,44,Mongolia,3278292,Asia,49165,214
MNG,2021-20,3925,39,Mongolia,3278292,Asia,53090,253
MNG,2021-21,4412,19,Mongolia,3278292,Asia,57502,272
MNG,2021-22,8931,35,Mongolia,3278292,Asia,66433,307
MNG,2021-23,11904,62,Mongolia,3278292,Asia,78337,369
MNG,2021-24,15204,67,Mongolia,3278292,Asia,93541,436
MNG,2021-25,16143,82,Mongolia,3278292,Asia,109684,518
MNG,2021-26,8269,60,Mongolia,3278292,Asia,117953,578
MNG,2021-27,21321,111,Mongolia,3278292,Asia,139274,689
MNG,2021-28,9140,51,Mongolia,3278292,Asia,148414,740
MNG,2021-29,9550,42,Mongolia,3278292,Asia,157964,782
MNG,2021-30,8236,41,Mongolia,3278292,Asia,166200,823
MNG,2021-31,7322,34,Mongolia,3278292,Asia,173522,857
MNG,2021-32,10120,204,Mongolia,3278292,Asia,183642,1061
MNP,2020-15,3,1,Northern Mariana Islands,57557,Oceania,3,1
MNP,2020-16,3,0,Northern Mariana Islands,57557,Oceania,6,1
MNP,2020-17,0,0,Northern Mariana Islands,57557,Oceania,6,1
MNP,2020-18,0,0,Northern Mariana Islands,57557,Oceania,6,1
MNP,2020-19,2,0,Northern Mariana Islands,57557,Oceania,8,1
MNP,2020-20,5,0,Northern Mariana Islands,57557,Oceania,13,1
MNP,2020-21,1,0,Northern Mariana Islands,57557,Oceania,14,1
MNP,2020-22,0,0,Northern Mariana Islands,57557,Oceania,14,1
MNP,2020-23,5,0,Northern Mariana Islands,57557,Oceania,19,1
MNP,2020-24,3,0,Northern Mariana Islands,57557,Oceania,22,1
MNP,2020-25,0,0,Northern Mariana Islands,57557,Oceania,22,1
MNP,2020-26,0,0,Northern Mariana Islands,57557,Oceania,22,1
MNP,2020-27,1,0,Northern Mariana Islands,57557,Oceania,23,1
MNP,2020-28,2,0,Northern Mariana Islands,57557,Oceania,25,1
MNP,2020-29,4,0,Northern Mariana Islands,57557,Oceania,29,1
MNP,2020-30,3,0,Northern Mariana Islands,57557,Oceania,32,1
MNP,2020-31,6,0,Northern Mariana Islands,57557,Oceania,38,1
MNP,2020-32,2,0,Northern Mariana Islands,57557,Oceania,40,1
MNP,2020-33,2,0,Northern Mariana Islands,57557,Oceania,42,1
MNP,2020-34,4,0,Northern Mariana Islands,57557,Oceania,46,1
MNP,2020-35,2,0,Northern Mariana Islands,57557,Oceania,48,1
MNP,2020-36,2,0,Northern Mariana Islands,57557,Oceania,50,1
MNP,2020-37,2,0,Northern Mariana Islands,57557,Oceania,52,1
MNP,2020-38,9,0,Northern Mariana Islands,57557,Oceania,61,1
MNP,2020-39,1,0,Northern Mariana Islands,57557,Oceania,62,1
MNP,2020-40,3,0,Northern Mariana Islands,57557,Oceania,65,1
MNP,2020-41,4,0,Northern Mariana Islands,57557,Oceania,69,1
MNP,2020-42,9,0,Northern Mariana Islands,57557,Oceania,78,1
MNP,2020-43,6,0,Northern Mariana Islands,57557,Oceania,84,1
MNP,2020-44,4,0,Northern Mariana Islands,57557,Oceania,88,1
MNP,2020-45,4,0,Northern Mariana Islands,57557,Oceania,92,1
MNP,2020-46,2,0,Northern Mariana Islands,57557,Oceania,94,1
MNP,2020-47,2,0,Northern Mariana Islands,57557,Oceania,96,1
MNP,2020-48,2,0,Northern Mariana Islands,57557,Oceania,98,1
MNP,2020-49,3,0,Northern Mariana Islands,57557,Oceania,101,1
MNP,2020-50,4,0,Northern Mariana Islands,57557,Oceania,105,1
MNP,2020-51,3,0,Northern Mariana Islands,57557,Oceania,108,1
MNP,2020-52,6,0,Northern Mariana Islands,57557,Oceania,114,1
MNP,2020-53,0,0,Northern Mariana Islands,57557,Oceania,114,1
MNP,2021-01,3,0,Northern Mariana Islands,57557,Oceania,117,1
MNP,2021-02,3,0,Northern Mariana Islands,57557,Oceania,120,1
MNP,2021-03,1,0,Northern Mariana Islands,57557,Oceania,121,1
MNP,2021-04,3,0,Northern Mariana Islands,57557,Oceania,124,1
MNP,2021-05,1,0,Northern Mariana Islands,57557,Oceania,125,1
MNP,2021-06,1,0,Northern Mariana Islands,57557,Oceania,126,1
MNP,2021-07,9,0,Northern Mariana Islands,57557,Oceania,135,1
MNP,2021-08,0,0,Northern Mariana Islands,57557,Oceania,135,1
MNP,2021-09,3,0,Northern Mariana Islands,57557,Oceania,138,1
MNP,2021-10,8,0,Northern Mariana Islands,57557,Oceania,146,1
MNP,2021-11,3,0,Northern Mariana Islands,57557,Oceania,149,1
MNP,2021-12,2,0,Northern Mariana Islands,57557,Oceania,151,1
MNP,2021-13,0,0,Northern Mariana Islands,57557,Oceania,151,1
MNP,2021-14,1,0,Northern Mariana Islands,57557,Oceania,152,1
MNP,2021-15,2,0,Northern Mariana Islands,57557,Oceania,154,1
MNP,2021-16,2,0,Northern Mariana Islands,57557,Oceania,156,1
MNP,2021-17,4,0,Northern Mariana Islands,57557,Oceania,160,1
MNP,2021-18,2,0,Northern Mariana Islands,57557,Oceania,162,1
MNP,2021-19,2,0,Northern Mariana Islands,57557,Oceania,164,1
MNP,2021-20,9,0,Northern Mariana Islands,57557,Oceania,173,1
MNP,2021-21,2,0,Northern Mariana Islands,57557,Oceania,175,1
MNP,2021-22,0,0,Northern Mariana Islands,57557,Oceania,175,1
MNP,2021-23,0,0,Northern Mariana Islands,57557,Oceania,175,1
MNP,2021-24,0,0,Northern Mariana Islands,57557,Oceania,175,1
MNP,2021-25,0,0,Northern Mariana Islands,57557,Oceania,175,1
MNP,2021-26,0,0,Northern Mariana Islands,57557,Oceania,175,1
MNP,2021-27,0,0,Northern Mariana Islands,57557,Oceania,175,1
MNP,2021-28,0,0,Northern Mariana Islands,57557,Oceania,175,1
MNP,2021-29,0,0,Northern Mariana Islands,57557,Oceania,175,1
MNP,2021-30,0,0,Northern Mariana Islands,57557,Oceania,175,1
MNP,2021-31,0,0,Northern Mariana Islands,57557,Oceania,175,1
MNP,2021-32,0,0,Northern Mariana Islands,57557,Oceania,175,1
MOZ,2020-13,7,0,Mozambique,31255435,Africa,7,0
MOZ,2020-14,2,0,Mozambique,31255435,Africa,9,0
MOZ,2020-15,11,0,Mozambique,31255435,Africa,20,0
MOZ,2020-16,18,0,Mozambique,31255435,Africa,38,0
MOZ,2020-17,37,0,Mozambique,31255435,Africa,75,0
MOZ,2020-18,4,0,Mozambique,31255435,Africa,79,0
MOZ,2020-19,11,0,Mozambique,31255435,Africa,90,0
MOZ,2020-20,46,0,Mozambique,31255435,Africa,136,0
MOZ,2020-21,57,0,Mozambique,31255435,Africa,193,0
MOZ,2020-22,60,2,Mozambique,31255435,Africa,253,2
MOZ,2020-23,172,0,Mozambique,31255435,Africa,425,2
MOZ,2020-24,157,1,Mozambique,31255435,Africa,582,3
MOZ,2020-25,150,2,Mozambique,31255435,Africa,732,5
MOZ,2020-26,126,0,Mozambique,31255435,Africa,858,5
MOZ,2020-27,128,3,Mozambique,31255435,Africa,986,8
MOZ,2020-28,170,1,Mozambique,31255435,Africa,1156,9
MOZ,2020-29,334,1,Mozambique,31255435,Africa,1490,10
MOZ,2020-30,178,1,Mozambique,31255435,Africa,1668,11
MOZ,2020-31,277,2,Mozambique,31255435,Africa,1945,13
MOZ,2020-32,323,3,Mozambique,31255435,Africa,2268,16
MOZ,2020-33,586,3,Mozambique,31255435,Africa,2854,19
MOZ,2020-34,540,1,Mozambique,31255435,Africa,3394,20
MOZ,2020-35,426,3,Mozambique,31255435,Africa,3820,23
MOZ,2020-36,623,4,Mozambique,31255435,Africa,4443,27
MOZ,2020-37,825,8,Mozambique,31255435,Africa,5268,35
MOZ,2020-38,1502,8,Mozambique,31255435,Africa,6770,43
MOZ,2020-39,1212,15,Mozambique,31255435,Africa,7982,58
MOZ,2020-40,1213,8,Mozambique,31255435,Africa,9195,66
MOZ,2020-41,805,5,Mozambique,31255435,Africa,10000,71
MOZ,2020-42,865,4,Mozambique,31255435,Africa,10865,75
MOZ,2020-43,1120,11,Mozambique,31255435,Africa,11985,86
MOZ,2020-44,1002,7,Mozambique,31255435,Africa,12987,93
MOZ,2020-45,780,6,Mozambique,31255435,Africa,13767,99
MOZ,2020-46,680,14,Mozambique,31255435,Africa,14447,113
MOZ,2020-47,589,11,Mozambique,31255435,Africa,15036,124
MOZ,2020-48,576,6,Mozambique,31255435,Africa,15612,130
MOZ,2020-49,631,3,Mozambique,31255435,Africa,16243,133
MOZ,2020-50,710,9,Mozambique,31255435,Africa,16953,142
MOZ,2020-51,614,6,Mozambique,31255435,Africa,17567,148
MOZ,2020-52,742,14,Mozambique,31255435,Africa,18309,162
MOZ,2020-53,999,7,Mozambique,31255435,Africa,19308,169
MOZ,2021-01,3025,28,Mozambique,31255435,Africa,22333,197
MOZ,2021-02,4217,44,Mozambique,31255435,Africa,26550,241
MOZ,2021-03,6230,122,Mozambique,31255435,Africa,32780,363
MOZ,2021-04,6679,23,Mozambique,31255435,Africa,39459,386
MOZ,2021-05,5140,74,Mozambique,31255435,Africa,44599,460
MOZ,2021-06,5665,75,Mozambique,31255435,Africa,50264,535
MOZ,2021-07,5378,60,Mozambique,31255435,Africa,55642,595
MOZ,2021-08,3707,46,Mozambique,31255435,Africa,59349,641
MOZ,2021-09,3170,52,Mozambique,31255435,Africa,62519,693
MOZ,2021-10,1996,32,Mozambique,31255435,Africa,64515,725
MOZ,2021-11,1696,21,Mozambique,31255435,Africa,66211,746
MOZ,2021-12,985,18,Mozambique,31255435,Africa,67196,764
MOZ,2021-13,922,18,Mozambique,31255435,Africa,68118,782
MOZ,2021-14,639,9,Mozambique,31255435,Africa,68757,791
MOZ,2021-15,445,7,Mozambique,31255435,Africa,69202,798
MOZ,2021-16,462,9,Mozambique,31255435,Africa,69664,807
MOZ,2021-17,319,8,Mozambique,31255435,Africa,69983,815
MOZ,2021-18,254,10,Mozambique,31255435,Africa,70237,825
MOZ,2021-19,204,1,Mozambique,31255435,Africa,70441,826
MOZ,2021-20,148,5,Mozambique,31255435,Africa,70589,831
MOZ,2021-21,190,5,Mozambique,31255435,Africa,70779,836
MOZ,2021-22,334,1,Mozambique,31255435,Africa,71113,837
MOZ,2021-23,424,4,Mozambique,31255435,Africa,71537,841
MOZ,2021-24,969,7,Mozambique,31255435,Africa,72506,848
MOZ,2021-25,2631,20,Mozambique,31255435,Africa,75137,868
MOZ,2021-26,5013,36,Mozambique,31255435,Africa,80150,904
MOZ,2021-27,8717,78,Mozambique,31255435,Africa,88867,982
MOZ,2021-28,10544,136,Mozambique,31255435,Africa,99411,1118
MOZ,2021-29,10876,164,Mozambique,31255435,Africa,110287,1282
MOZ,2021-30,13253,180,Mozambique,31255435,Africa,123540,1462
MOZ,2021-31,8911,151,Mozambique,31255435,Africa,132451,1613
MOZ,2021-32,6297,103,Mozambique,31255435,Africa,138748,1716
MRT,2020-12,1,0,Mauritania,4649660,Africa,1,0
MRT,2020-13,3,0,Mauritania,4649660,Africa,4,0
MRT,2020-14,1,1,Mauritania,4649660,Africa,5,1
MRT,2020-15,1,0,Mauritania,4649660,Africa,6,1
MRT,2020-16,0,0,Mauritania,4649660,Africa,6,1
MRT,2020-17,0,0,Mauritania,4649660,Africa,6,1
MRT,2020-18,1,0,Mauritania,4649660,Africa,7,1
MRT,2020-19,0,0,Mauritania,4649660,Africa,7,1
MRT,2020-20,54,3,Mauritania,4649660,Africa,61,4
MRT,2020-21,175,2,Mauritania,4649660,Africa,236,6
MRT,2020-22,293,17,Mauritania,4649660,Africa,529,23
MRT,2020-23,417,20,Mauritania,4649660,Africa,946,43
MRT,2020-24,836,44,Mauritania,4649660,Africa,1782,87
MRT,2020-25,1030,21,Mauritania,4649660,Africa,2812,108
MRT,2020-26,1094,12,Mauritania,4649660,Africa,3906,120
MRT,2020-27,972,10,Mauritania,4649660,Africa,4878,130
MRT,2020-28,247,14,Mauritania,4649660,Africa,5125,144
MRT,2020-29,747,11,Mauritania,4649660,Africa,5872,155
MRT,2020-30,298,1,Mauritania,4649660,Africa,6170,156
MRT,2020-31,139,1,Mauritania,4649660,Africa,6309,157
MRT,2020-32,188,0,Mauritania,4649660,Africa,6497,157
MRT,2020-33,203,0,Mauritania,4649660,Africa,6700,157
MRT,2020-34,184,1,Mauritania,4649660,Africa,6884,158
MRT,2020-35,137,1,Mauritania,4649660,Africa,7021,159
MRT,2020-36,112,1,Mauritania,4649660,Africa,7133,160
MRT,2020-37,142,1,Mauritania,4649660,Africa,7275,161
MRT,2020-38,92,0,Mauritania,4649660,Africa,7367,161
MRT,2020-39,94,0,Mauritania,4649660,Africa,7461,161
MRT,2020-40,58,0,Mauritania,4649660,Africa,7519,161
MRT,2020-41,30,2,Mauritania,4649660,Africa,7549,163
MRT,2020-42,53,0,Mauritania,4649660,Africa,7602,163
MRT,2020-43,59,0,Mauritania,4649660,Africa,7661,163
MRT,2020-44,55,0,Mauritania,4649660,Africa,7716,163
MRT,2020-45,89,2,Mauritania,4649660,Africa,7805,165
MRT,2020-46,79,0,Mauritania,4649660,Africa,7884,165
MRT,2020-47,211,4,Mauritania,4649660,Africa,8095,169
MRT,2020-48,453,6,Mauritania,4649660,Africa,8548,175
MRT,2020-49,161,2,Mauritania,4649660,Africa,8709,177
MRT,2020-50,2261,48,Mauritania,4649660,Africa,10970,225
MRT,2020-51,1447,56,Mauritania,4649660,Africa,12417,281
MRT,2020-52,1360,49,Mauritania,4649660,Africa,13777,330
MRT,2020-53,1016,28,Mauritania,4649660,Africa,14793,358
MRT,2021-01,718,26,Mauritania,4649660,Africa,15511,384
MRT,2021-02,527,21,Mauritania,4649660,Africa,16038,405
MRT,2021-03,358,11,Mauritania,4649660,Africa,16396,416
MRT,2021-04,146,5,Mauritania,4649660,Africa,16542,421
MRT,2021-05,234,4,Mauritania,4649660,Africa,16776,425
MRT,2021-06,197,5,Mauritania,4649660,Africa,16973,430
MRT,2021-07,42,1,Mauritania,4649660,Africa,17015,431
MRT,2021-08,114,6,Mauritania,4649660,Africa,17129,437
MRT,2021-09,179,5,Mauritania,4649660,Africa,17308,442
MRT,2021-10,115,1,Mauritania,4649660,Africa,17423,443
MRT,2021-11,146,3,Mauritania,4649660,Africa,17569,446
MRT,2021-12,175,2,Mauritania,4649660,Africa,17744,448
MRT,2021-13,172,1,Mauritania,4649660,Africa,17916,449
MRT,2021-14,105,1,Mauritania,4649660,Africa,18021,450
MRT,2021-15,99,2,Mauritania,4649660,Africa,18120,452
MRT,2021-16,71,2,Mauritania,4649660,Africa,18191,454
MRT,2021-17,210,1,Mauritania,4649660,Africa,18401,455
MRT,2021-18,265,1,Mauritania,4649660,Africa,18666,456
MRT,2021-19,139,1,Mauritania,4649660,Africa,18805,457
MRT,2021-20,343,1,Mauritania,4649660,Africa,19148,458
MRT,2021-21,345,5,Mauritania,4649660,Africa,19493,463
MRT,2021-22,323,5,Mauritania,4649660,Africa,19816,468
MRT,2021-23,256,7,Mauritania,4649660,Africa,20072,475
MRT,2021-24,215,5,Mauritania,4649660,Africa,20287,480
MRT,2021-25,347,6,Mauritania,4649660,Africa,20634,486
MRT,2021-26,441,3,Mauritania,4649660,Africa,21075,489
MRT,2021-27,596,6,Mauritania,4649660,Africa,21671,495
MRT,2021-28,836,13,Mauritania,4649660,Africa,22507,508
MRT,2021-29,1047,20,Mauritania,4649660,Africa,23554,528
MRT,2021-30,2418,39,Mauritania,4649660,Africa,25972,567
MRT,2021-31,2224,38,Mauritania,4649660,Africa,28196,605
MRT,2021-32,1406,29,Mauritania,4649660,Africa,29602,634
MSR,2020-13,4,0,Montserrat,4999,America,4,0
MSR,2020-14,1,0,Montserrat,4999,America,5,0
MSR,2020-15,5,0,Montserrat,4999,America,10,0
MSR,2020-16,0,0,Montserrat,4999,America,10,0
MSR,2020-17,0,1,Montserrat,4999,America,10,1
MSR,2020-18,0,0,Montserrat,4999,America,10,1
MSR,2020-19,0,0,Montserrat,4999,America,10,1
MSR,2020-20,0,0,Montserrat,4999,America,10,1
MSR,2020-21,0,0,Montserrat,4999,America,10,1
MSR,2020-22,0,0,Montserrat,4999,America,10,1
MSR,2020-23,0,0,Montserrat,4999,America,10,1
MSR,2020-24,0,0,Montserrat,4999,America,10,1
MSR,2020-25,0,0,Montserrat,4999,America,10,1
MSR,2020-26,0,0,Montserrat,4999,America,10,1
MSR,2020-27,0,0,Montserrat,4999,America,10,1
MSR,2020-28,1,0,Montserrat,4999,America,11,1
MSR,2020-29,0,0,Montserrat,4999,America,11,1
MSR,2020-30,1,0,Montserrat,4999,America,12,1
MSR,2020-31,0,0,Montserrat,4999,America,12,1
MSR,2020-32,0,0,Montserrat,4999,America,12,1
MSR,2020-33,0,0,Montserrat,4999,America,12,1
MSR,2020-34,0,0,Montserrat,4999,America,12,1
MSR,2020-35,0,0,Montserrat,4999,America,12,1
MSR,2020-36,0,0,Montserrat,4999,America,12,1
MSR,2020-37,0,0,Montserrat,4999,America,12,1
MSR,2020-38,0,0,Montserrat,4999,America,12,1
MSR,2020-39,0,0,Montserrat,4999,America,12,1
MSR,2020-40,0,0,Montserrat,4999,America,12,1
MSR,2020-41,0,0,Montserrat,4999,America,12,1
MSR,2020-42,0,0,Montserrat,4999,America,12,1
MSR,2020-43,0,0,Montserrat,4999,America,12,1
MSR,2020-44,0,0,Montserrat,4999,America,12,1
MSR,2020-45,0,0,Montserrat,4999,America,12,1
MSR,2020-46,0,0,Montserrat,4999,America,12,1
MSR,2020-47,0,0,Montserrat,4999,America,12,1
MSR,2020-48,0,0,Montserrat,4999,America,12,1
MSR,2020-49,0,0,Montserrat,4999,America,12,1
MSR,2020-50,0,0,Montserrat,4999,America,12,1
MSR,2020-51,0,0,Montserrat,4999,America,12,1
MSR,2020-52,0,0,Montserrat,4999,America,12,1
MSR,2020-53,0,0,Montserrat,4999,America,12,1
MSR,2021-01,0,0,Montserrat,4999,America,12,1
MSR,2021-02,0,0,Montserrat,4999,America,12,1
MSR,2021-03,0,0,Montserrat,4999,America,12,1
MSR,2021-04,0,0,Montserrat,4999,America,12,1
MSR,2021-05,4,0,Montserrat,4999,America,16,1
MSR,2021-06,3,0,Montserrat,4999,America,19,1
MSR,2021-07,0,0,Montserrat,4999,America,19,1
MSR,2021-08,0,0,Montserrat,4999,America,19,1
MSR,2021-09,0,0,Montserrat,4999,America,19,1
MSR,2021-10,0,0,Montserrat,4999,America,19,1
MSR,2021-11,0,0,Montserrat,4999,America,19,1
MSR,2021-12,0,0,Montserrat,4999,America,19,1
MSR,2021-13,0,0,Montserrat,4999,America,19,1
MSR,2021-14,0,0,Montserrat,4999,America,19,1
MSR,2021-15,0,0,Montserrat,4999,America,19,1
MSR,2021-16,0,0,Montserrat,4999,America,19,1
MSR,2021-17,0,0,Montserrat,4999,America,19,1
MSR,2021-18,0,0,Montserrat,4999,America,19,1
MSR,2021-19,0,0,Montserrat,4999,America,19,1
MSR,2021-20,0,0,Montserrat,4999,America,19,1
MSR,2021-21,0,0,Montserrat,4999,America,19,1
MSR,2021-22,0,0,Montserrat,4999,America,19,1
MSR,2021-23,0,0,Montserrat,4999,America,19,1
MSR,2021-24,0,0,Montserrat,4999,America,19,1
MSR,2021-25,0,0,Montserrat,4999,America,19,1
MSR,2021-26,0,0,Montserrat,4999,America,19,1
MSR,2021-27,1,0,Montserrat,4999,America,20,1
MSR,2021-28,0,0,Montserrat,4999,America,20,1
MSR,2021-29,0,0,Montserrat,4999,America,20,1
MSR,2021-30,0,0,Montserrat,4999,America,20,1
MSR,2021-31,0,0,Montserrat,4999,America,20,1
MSR,2021-32,2,0,Montserrat,4999,America,22,1
MUS,2020-13,82,1,Mauritius,1271767,Africa,82,1
MUS,2020-14,117,4,Mauritius,1271767,Africa,199,5
MUS,2020-15,97,2,Mauritius,1271767,Africa,296,7
MUS,2020-16,4,0,Mauritius,1271767,Africa,300,7
MUS,2020-17,4,0,Mauritius,1271767,Africa,304,7
MUS,2020-18,0,1,Mauritius,1271767,Africa,304,8
MUS,2020-19,0,0,Mauritius,1271767,Africa,304,8
MUS,2020-20,0,0,Mauritius,1271767,Africa,304,8
MUS,2020-21,2,0,Mauritius,1271767,Africa,306,8
MUS,2020-22,1,0,Mauritius,1271767,Africa,307,8
MUS,2020-23,2,0,Mauritius,1271767,Africa,309,8
MUS,2020-24,0,0,Mauritius,1271767,Africa,309,8
MUS,2020-25,0,0,Mauritius,1271767,Africa,309,8
MUS,2020-26,4,0,Mauritius,1271767,Africa,313,8
MUS,2020-27,0,0,Mauritius,1271767,Africa,313,8
MUS,2020-28,1,0,Mauritius,1271767,Africa,314,8
MUS,2020-29,1,0,Mauritius,1271767,Africa,315,8
MUS,2020-30,1,0,Mauritius,1271767,Africa,316,8
MUS,2020-31,0,0,Mauritius,1271767,Africa,316,8
MUS,2020-32,0,0,Mauritius,1271767,Africa,316,8
MUS,2020-33,2,0,Mauritius,1271767,Africa,318,8
MUS,2020-34,0,0,Mauritius,1271767,Africa,318,8
MUS,2020-35,0,0,Mauritius,1271767,Africa,318,8
MUS,2020-36,10,0,Mauritius,1271767,Africa,328,8
MUS,2020-37,5,0,Mauritius,1271767,Africa,333,8
MUS,2020-38,6,0,Mauritius,1271767,Africa,339,8
MUS,2020-39,0,0,Mauritius,1271767,Africa,339,8
MUS,2020-40,14,0,Mauritius,1271767,Africa,353,8
MUS,2020-41,14,0,Mauritius,1271767,Africa,367,8
MUS,2020-42,12,0,Mauritius,1271767,Africa,379,8
MUS,2020-43,28,0,Mauritius,1271767,Africa,407,8
MUS,2020-44,11,0,Mauritius,1271767,Africa,418,8
MUS,2020-45,6,0,Mauritius,1271767,Africa,424,8
MUS,2020-46,26,0,Mauritius,1271767,Africa,450,8
MUS,2020-47,16,0,Mauritius,1271767,Africa,466,8
MUS,2020-48,7,0,Mauritius,1271767,Africa,473,8
MUS,2020-49,4,0,Mauritius,1271767,Africa,477,8
MUS,2020-50,18,0,Mauritius,1271767,Africa,495,8
MUS,2020-51,3,0,Mauritius,1271767,Africa,498,8
MUS,2020-52,1,0,Mauritius,1271767,Africa,499,8
MUS,2020-53,4,0,Mauritius,1271767,Africa,503,8
MUS,2021-01,14,0,Mauritius,1271767,Africa,517,8
MUS,2021-02,2,0,Mauritius,1271767,Africa,519,8
MUS,2021-03,21,0,Mauritius,1271767,Africa,540,8
MUS,2021-04,1,0,Mauritius,1271767,Africa,541,8
MUS,2021-05,24,0,Mauritius,1271767,Africa,565,8
MUS,2021-06,2,0,Mauritius,1271767,Africa,567,8
MUS,2021-07,8,0,Mauritius,1271767,Africa,575,8
MUS,2021-08,7,0,Mauritius,1271767,Africa,582,8
MUS,2021-09,31,0,Mauritius,1271767,Africa,613,8
MUS,2021-10,50,0,Mauritius,1271767,Africa,663,8
MUS,2021-11,101,0,Mauritius,1271767,Africa,764,8
MUS,2021-12,78,0,Mauritius,1271767,Africa,842,8
MUS,2021-13,164,2,Mauritius,1271767,Africa,1006,10
MUS,2021-14,142,0,Mauritius,1271767,Africa,1148,10
MUS,2021-15,27,3,Mauritius,1271767,Africa,1175,13
MUS,2021-16,3,1,Mauritius,1271767,Africa,1178,14
MUS,2021-17,0,0,Mauritius,1271767,Africa,1178,14
MUS,2021-18,40,1,Mauritius,1271767,Africa,1218,15
MUS,2021-19,42,0,Mauritius,1271767,Africa,1260,15
MUS,2021-20,34,0,Mauritius,1271767,Africa,1294,15
MUS,2021-21,71,0,Mauritius,1271767,Africa,1365,15
MUS,2021-22,65,1,Mauritius,1271767,Africa,1430,16
MUS,2021-23,222,0,Mauritius,1271767,Africa,1652,16
MUS,2021-24,0,0,Mauritius,1271767,Africa,1652,16
MUS,2021-25,200,0,Mauritius,1271767,Africa,1852,16
MUS,2021-26,104,0,Mauritius,1271767,Africa,1956,16
MUS,2021-27,147,0,Mauritius,1271767,Africa,2103,16
MUS,2021-28,404,1,Mauritius,1271767,Africa,2507,17
MUS,2021-29,1194,0,Mauritius,1271767,Africa,3701,17
MUS,2021-30,485,1,Mauritius,1271767,Africa,4186,18
MUS,2021-31,906,1,Mauritius,1271767,Africa,5092,19
MUS,2021-32,1046,0,Mauritius,1271767,Africa,6138,19
MWI,2020-15,9,2,Malawi,19129955,Africa,9,2
MWI,2020-16,4,0,Malawi,19129955,Africa,13,2
MWI,2020-17,17,1,Malawi,19129955,Africa,30,3
MWI,2020-18,5,0,Malawi,19129955,Africa,35,3
MWI,2020-19,17,0,Malawi,19129955,Africa,52,3
MWI,2020-20,14,0,Malawi,19129955,Africa,66,3
MWI,2020-21,13,1,Malawi,19129955,Africa,79,4
MWI,2020-22,201,0,Malawi,19129955,Africa,280,4
MWI,2020-23,154,0,Malawi,19129955,Africa,434,4
MWI,2020-24,109,2,Malawi,19129955,Africa,543,6
MWI,2020-25,183,5,Malawi,19129955,Africa,726,11
MWI,2020-26,416,2,Malawi,19129955,Africa,1142,13
MWI,2020-27,596,6,Malawi,19129955,Africa,1738,19
MWI,2020-28,622,19,Malawi,19129955,Africa,2360,38
MWI,2020-29,628,24,Malawi,19129955,Africa,2988,62
MWI,2020-30,648,37,Malawi,19129955,Africa,3636,99
MWI,2020-31,591,24,Malawi,19129955,Africa,4227,123
MWI,2020-32,427,23,Malawi,19129955,Africa,4654,146
MWI,2020-33,414,15,Malawi,19129955,Africa,5068,161
MWI,2020-34,250,5,Malawi,19129955,Africa,5318,166
MWI,2020-35,214,8,Malawi,19129955,Africa,5532,174
MWI,2020-36,78,1,Malawi,19129955,Africa,5610,175
MWI,2020-37,76,2,Malawi,19129955,Africa,5686,177
MWI,2020-38,41,2,Malawi,19129955,Africa,5727,179
MWI,2020-39,37,0,Malawi,19129955,Africa,5764,179
MWI,2020-40,18,0,Malawi,19129955,Africa,5782,179
MWI,2020-41,35,1,Malawi,19129955,Africa,5817,180
MWI,2020-42,36,1,Malawi,19129955,Africa,5853,181
MWI,2020-43,33,2,Malawi,19129955,Africa,5886,183
MWI,2020-44,42,1,Malawi,19129955,Africa,5928,184
MWI,2020-45,19,0,Malawi,19129955,Africa,5947,184
MWI,2020-46,14,1,Malawi,19129955,Africa,5961,185
MWI,2020-47,38,0,Malawi,19129955,Africa,5999,185
MWI,2020-48,22,0,Malawi,19129955,Africa,6021,185
MWI,2020-49,26,0,Malawi,19129955,Africa,6047,185
MWI,2020-50,15,2,Malawi,19129955,Africa,6062,187
MWI,2020-51,95,0,Malawi,19129955,Africa,6157,187
MWI,2020-52,216,1,Malawi,19129955,Africa,6373,188
MWI,2020-53,467,7,Malawi,19129955,Africa,6840,195
MWI,2021-01,1731,30,Malawi,19129955,Africa,8571,225
MWI,2021-02,3895,89,Malawi,19129955,Africa,12466,314
MWI,2021-03,7517,204,Malawi,19129955,Africa,19983,518
MWI,2021-04,4378,194,Malawi,19129955,Africa,24361,712
MWI,2021-05,3057,162,Malawi,19129955,Africa,27418,874
MWI,2021-06,1613,78,Malawi,19129955,Africa,29031,952
MWI,2021-07,1707,61,Malawi,19129955,Africa,30738,1013
MWI,2021-08,1203,31,Malawi,19129955,Africa,31941,1044
MWI,2021-09,497,25,Malawi,19129955,Africa,32438,1069
MWI,2021-10,389,14,Malawi,19129955,Africa,32827,1083
MWI,2021-11,406,13,Malawi,19129955,Africa,33233,1096
MWI,2021-12,244,18,Malawi,19129955,Africa,33477,1114
MWI,2021-13,180,9,Malawi,19129955,Africa,33657,1123
MWI,2021-14,166,5,Malawi,19129955,Africa,33823,1128
MWI,2021-15,114,10,Malawi,19129955,Africa,33937,1138
MWI,2021-16,75,9,Malawi,19129955,Africa,34012,1147
MWI,2021-17,62,1,Malawi,19129955,Africa,34074,1148
MWI,2021-18,93,5,Malawi,19129955,Africa,34167,1153
MWI,2021-19,45,0,Malawi,19129955,Africa,34212,1153
MWI,2021-20,68,0,Malawi,19129955,Africa,34280,1153
MWI,2021-21,51,2,Malawi,19129955,Africa,34331,1155
MWI,2021-22,55,2,Malawi,19129955,Africa,34386,1157
MWI,2021-23,95,2,Malawi,19129955,Africa,34481,1159
MWI,2021-24,429,12,Malawi,19129955,Africa,34910,1171
MWI,2021-25,715,11,Malawi,19129955,Africa,35625,1182
MWI,2021-26,1297,26,Malawi,19129955,Africa,36922,1208
MWI,2021-27,2260,42,Malawi,19129955,Africa,39182,1250
MWI,2021-28,4284,88,Malawi,19129955,Africa,43466,1338
MWI,2021-29,5167,142,Malawi,19129955,Africa,48633,1480
MWI,2021-30,3994,181,Malawi,19129955,Africa,52627,1661
MWI,2021-31,3289,167,Malawi,19129955,Africa,55916,1828
MWI,2021-32,2163,140,Malawi,19129955,Africa,58079,1968
MYS,2020-02,0,0,Malaysia,32365998,Asia,0,0
MYS,2020-03,0,0,Malaysia,32365998,Asia,0,0
MYS,2020-04,4,0,Malaysia,32365998,Asia,4,0
MYS,2020-05,4,0,Malaysia,32365998,Asia,8,0
MYS,2020-06,10,0,Malaysia,32365998,Asia,18,0
MYS,2020-07,4,0,Malaysia,32365998,Asia,22,0
MYS,2020-08,0,0,Malaysia,32365998,Asia,22,0
MYS,2020-09,7,0,Malaysia,32365998,Asia,29,0
MYS,2020-10,70,0,Malaysia,32365998,Asia,99,0
MYS,2020-11,329,0,Malaysia,32365998,Asia,428,0
MYS,2020-12,878,10,Malaysia,32365998,Asia,1306,10
MYS,2020-13,1164,24,Malaysia,32365998,Asia,2470,34
MYS,2020-14,1192,27,Malaysia,32365998,Asia,3662,61
MYS,2020-15,1021,15,Malaysia,32365998,Asia,4683,76
MYS,2020-16,706,13,Malaysia,32365998,Asia,5389,89
MYS,2020-17,391,9,Malaysia,32365998,Asia,5780,98
MYS,2020-18,518,7,Malaysia,32365998,Asia,6298,105
MYS,2020-19,358,3,Malaysia,32365998,Asia,6656,108
MYS,2020-20,238,5,Malaysia,32365998,Asia,6894,113
MYS,2020-21,351,2,Malaysia,32365998,Asia,7245,115
MYS,2020-22,574,0,Malaysia,32365998,Asia,7819,115
MYS,2020-23,503,2,Malaysia,32365998,Asia,8322,117
MYS,2020-24,131,4,Malaysia,32365998,Asia,8453,121
MYS,2020-25,119,0,Malaysia,32365998,Asia,8572,121
MYS,2020-26,62,0,Malaysia,32365998,Asia,8634,121
MYS,2020-27,24,0,Malaysia,32365998,Asia,8658,121
MYS,2020-28,60,1,Malaysia,32365998,Asia,8718,122
MYS,2020-29,61,1,Malaysia,32365998,Asia,8779,123
MYS,2020-30,118,1,Malaysia,32365998,Asia,8897,124
MYS,2020-31,102,1,Malaysia,32365998,Asia,8999,125
MYS,2020-32,84,0,Malaysia,32365998,Asia,9083,125
MYS,2020-33,117,0,Malaysia,32365998,Asia,9200,125
MYS,2020-34,67,0,Malaysia,32365998,Asia,9267,125
MYS,2020-35,67,1,Malaysia,32365998,Asia,9334,126
MYS,2020-36,63,2,Malaysia,32365998,Asia,9397,128
MYS,2020-37,518,0,Malaysia,32365998,Asia,9915,128
MYS,2020-38,304,2,Malaysia,32365998,Asia,10219,130
MYS,2020-39,700,4,Malaysia,32365998,Asia,10919,134
MYS,2020-40,1462,3,Malaysia,32365998,Asia,12381,137
MYS,2020-41,3276,20,Malaysia,32365998,Asia,15657,157
MYS,2020-42,4841,30,Malaysia,32365998,Asia,20498,187
MYS,2020-43,6067,42,Malaysia,32365998,Asia,26565,229
MYS,2020-44,5940,20,Malaysia,32365998,Asia,32505,249
MYS,2020-45,7704,37,Malaysia,32365998,Asia,40209,286
MYS,2020-46,7208,23,Malaysia,32365998,Asia,47417,309
MYS,2020-47,7358,26,Malaysia,32365998,Asia,54775,335
MYS,2020-48,9710,22,Malaysia,32365998,Asia,64485,357
MYS,2020-49,8209,25,Malaysia,32365998,Asia,72694,382
MYS,2020-50,10781,33,Malaysia,32365998,Asia,83475,415
MYS,2020-51,9834,22,Malaysia,32365998,Asia,93309,437
MYS,2020-52,11787,15,Malaysia,32365998,Asia,105096,452
MYS,2020-53,15722,49,Malaysia,32365998,Asia,120818,501
MYS,2021-01,15174,50,Malaysia,32365998,Asia,135992,551
MYS,2021-02,22442,50,Malaysia,32365998,Asia,158434,601
MYS,2021-03,25367,77,Malaysia,32365998,Asia,183801,678
MYS,2021-04,31158,82,Malaysia,32365998,Asia,214959,760
MYS,2021-05,27493,112,Malaysia,32365998,Asia,242452,872
MYS,2021-06,21817,93,Malaysia,32365998,Asia,264269,965
MYS,2021-07,21492,97,Malaysia,32365998,Asia,285761,1062
MYS,2021-08,14991,68,Malaysia,32365998,Asia,300752,1130
MYS,2021-09,12708,39,Malaysia,32365998,Asia,313460,1169
MYS,2021-10,10303,41,Malaysia,32365998,Asia,323763,1210
MYS,2021-11,9277,23,Malaysia,32365998,Asia,333040,1233
MYS,2021-12,8904,22,Malaysia,32365998,Asia,341944,1255
MYS,2021-13,9015,33,Malaysia,32365998,Asia,350959,1288
MYS,2021-14,11214,45,Malaysia,32365998,Asia,362173,1333
MYS,2021-15,12881,45,Malaysia,32365998,Asia,375054,1378
MYS,2021-16,17888,58,Malaysia,32365998,Asia,392942,1436
MYS,2021-17,22070,97,Malaysia,32365998,Asia,415012,1533
MYS,2021-18,25665,150,Malaysia,32365998,Asia,440677,1683
MYS,2021-19,29433,219,Malaysia,32365998,Asia,470110,1902
MYS,2021-20,48490,346,Malaysia,32365998,Asia,518600,2248
MYS,2021-21,46933,481,Malaysia,32365998,Asia,565533,2729
MYS,2021-22,51282,649,Malaysia,32365998,Asia,616815,3378
MYS,2021-23,40693,530,Malaysia,32365998,Asia,657508,3908
MYS,2021-24,43511,569,Malaysia,32365998,Asia,701019,4477
MYS,2021-25,33029,467,Malaysia,32365998,Asia,734048,4944
MYS,2021-26,44604,553,Malaysia,32365998,Asia,778652,5497
MYS,2021-27,57644,661,Malaysia,32365998,Asia,836296,6158
MYS,2021-28,91237,990,Malaysia,32365998,Asia,927533,7148
MYS,2021-29,100421,846,Malaysia,32365998,Asia,1027954,7994
MYS,2021-30,102468,1190,Malaysia,32365998,Asia,1130422,9184
MYS,2021-31,132118,1565,Malaysia,32365998,Asia,1262540,10749
MYS,2021-32,142359,1761,Malaysia,32365998,Asia,1404899,12510
NAM,2020-12,1,0,Namibia,2540916,Africa,1,0
NAM,2020-13,8,0,Namibia,2540916,Africa,9,0
NAM,2020-14,5,0,Namibia,2540916,Africa,14,0
NAM,2020-15,0,0,Namibia,2540916,Africa,14,0
NAM,2020-16,0,0,Namibia,2540916,Africa,14,0
NAM,2020-17,0,0,Namibia,2540916,Africa,14,0
NAM,2020-18,0,0,Namibia,2540916,Africa,14,0
NAM,2020-19,0,0,Namibia,2540916,Africa,14,0
NAM,2020-20,0,0,Namibia,2540916,Africa,14,0
NAM,2020-21,5,0,Namibia,2540916,Africa,19,0
NAM,2020-22,3,0,Namibia,2540916,Africa,22,0
NAM,2020-23,5,0,Namibia,2540916,Africa,27,0
NAM,2020-24,3,0,Namibia,2540916,Africa,30,0
NAM,2020-25,23,0,Namibia,2540916,Africa,53,0
NAM,2020-26,128,0,Namibia,2540916,Africa,181,0
NAM,2020-27,229,0,Namibia,2540916,Africa,410,0
NAM,2020-28,373,1,Namibia,2540916,Africa,783,1
NAM,2020-29,462,2,Namibia,2540916,Africa,1245,3
NAM,2020-30,528,5,Namibia,2540916,Africa,1773,8
NAM,2020-31,519,3,Namibia,2540916,Africa,2292,11
NAM,2020-32,655,8,Namibia,2540916,Africa,2947,19
NAM,2020-33,1205,16,Namibia,2540916,Africa,4152,35
NAM,2020-34,1700,17,Namibia,2540916,Africa,5852,52
NAM,2020-35,1511,20,Namibia,2540916,Africa,7363,72
NAM,2020-36,1320,17,Namibia,2540916,Africa,8683,89
NAM,2020-37,1034,12,Namibia,2540916,Africa,9717,101
NAM,2020-38,658,11,Namibia,2540916,Africa,10375,112
NAM,2020-39,656,7,Namibia,2540916,Africa,11031,119
NAM,2020-40,593,4,Namibia,2540916,Africa,11624,123
NAM,2020-41,310,5,Namibia,2540916,Africa,11934,128
NAM,2020-42,357,3,Namibia,2540916,Africa,12291,131
NAM,2020-43,367,2,Namibia,2540916,Africa,12658,133
NAM,2020-44,328,0,Namibia,2540916,Africa,12986,133
NAM,2020-45,223,1,Namibia,2540916,Africa,13209,134
NAM,2020-46,297,4,Namibia,2540916,Africa,13506,138
NAM,2020-47,357,7,Namibia,2540916,Africa,13863,145
NAM,2020-48,480,6,Namibia,2540916,Africa,14343,151
NAM,2020-49,733,1,Namibia,2540916,Africa,15076,152
NAM,2020-50,1458,8,Namibia,2540916,Africa,16534,160
NAM,2020-51,2178,17,Namibia,2540916,Africa,18712,177
NAM,2020-52,3573,16,Namibia,2540916,Africa,22285,193
NAM,2020-53,3099,25,Namibia,2540916,Africa,25384,218
NAM,2021-01,3216,43,Namibia,2540916,Africa,28600,261
NAM,2021-02,1761,24,Namibia,2540916,Africa,30361,285
NAM,2021-03,2062,34,Namibia,2540916,Africa,32423,319
NAM,2021-04,1743,34,Namibia,2540916,Africa,34166,353
NAM,2021-05,0,0,Namibia,2540916,Africa,34166,353
NAM,2021-06,1784,35,Namibia,2540916,Africa,35950,388
NAM,2021-07,1944,23,Namibia,2540916,Africa,37894,411
NAM,2021-08,949,13,Namibia,2540916,Africa,38843,424
NAM,2021-09,1342,15,Namibia,2540916,Africa,40185,439
NAM,2021-10,1013,19,Namibia,2540916,Africa,41198,458
NAM,2021-11,1277,34,Namibia,2540916,Africa,42475,492
NAM,2021-12,1155,17,Namibia,2540916,Africa,43630,509
NAM,2021-13,1158,28,Namibia,2540916,Africa,44788,537
NAM,2021-14,533,27,Namibia,2540916,Africa,45321,564
NAM,2021-15,1332,40,Namibia,2540916,Africa,46653,604
NAM,2021-16,1121,21,Namibia,2540916,Africa,47774,625
NAM,2021-17,878,18,Namibia,2540916,Africa,48652,643
NAM,2021-18,1416,46,Namibia,2540916,Africa,50068,689
NAM,2021-19,1148,29,Namibia,2540916,Africa,51216,718
NAM,2021-20,1728,47,Namibia,2540916,Africa,52944,765
NAM,2021-21,2195,59,Namibia,2540916,Africa,55139,824
NAM,2021-22,3566,88,Namibia,2540916,Africa,58705,912
NAM,2021-23,6382,83,Namibia,2540916,Africa,65087,995
NAM,2021-24,10677,184,Namibia,2540916,Africa,75764,1179
NAM,2021-25,10883,266,Namibia,2540916,Africa,86647,1445
NAM,2021-26,9054,12,Namibia,2540916,Africa,95701,1457
NAM,2021-27,9892,534,Namibia,2540916,Africa,105593,1991
NAM,2021-28,6565,283,Namibia,2540916,Africa,112158,2274
NAM,2021-29,4804,560,Namibia,2540916,Africa,116962,2834
NAM,2021-30,2478,230,Namibia,2540916,Africa,119440,3064
NAM,2021-31,1761,132,Namibia,2540916,Africa,121201,3196
NAM,2021-32,1266,81,Namibia,2540916,Africa,122467,3277
NCL,2020-13,10,0,New Caledonia,285491,Oceania,10,0
NCL,2020-14,3,0,New Caledonia,285491,Oceania,13,0
NCL,2020-15,0,0,New Caledonia,285491,Oceania,13,0
NCL,2020-16,0,0,New Caledonia,285491,Oceania,13,0
NCL,2020-17,0,0,New Caledonia,285491,Oceania,13,0
NCL,2020-18,0,0,New Caledonia,285491,Oceania,13,0
NCL,2020-19,0,0,New Caledonia,285491,Oceania,13,0
NCL,2020-20,0,0,New Caledonia,285491,Oceania,13,0
NCL,2020-21,0,0,New Caledonia,285491,Oceania,13,0
NCL,2020-22,1,0,New Caledonia,285491,Oceania,14,0
NCL,2020-23,1,0,New Caledonia,285491,Oceania,15,0
NCL,2020-24,1,0,New Caledonia,285491,Oceania,16,0
NCL,2020-25,0,0,New Caledonia,285491,Oceania,16,0
NCL,2020-26,0,0,New Caledonia,285491,Oceania,16,0
NCL,2020-27,0,0,New Caledonia,285491,Oceania,16,0
NCL,2020-28,0,0,New Caledonia,285491,Oceania,16,0
NCL,2020-29,1,0,New Caledonia,285491,Oceania,17,0
NCL,2020-30,0,0,New Caledonia,285491,Oceania,17,0
NCL,2020-31,0,0,New Caledonia,285491,Oceania,17,0
NCL,2020-32,1,0,New Caledonia,285491,Oceania,18,0
NCL,2020-33,0,0,New Caledonia,285491,Oceania,18,0
NCL,2020-34,0,0,New Caledonia,285491,Oceania,18,0
NCL,2020-35,0,0,New Caledonia,285491,Oceania,18,0
NCL,2020-36,3,0,New Caledonia,285491,Oceania,21,0
NCL,2020-37,0,0,New Caledonia,285491,Oceania,21,0
NCL,2020-38,0,0,New Caledonia,285491,Oceania,21,0
NCL,2020-39,1,0,New Caledonia,285491,Oceania,22,0
NCL,2020-40,0,0,New Caledonia,285491,Oceania,22,0
NCL,2020-41,0,0,New Caledonia,285491,Oceania,22,0
NCL,2020-42,0,0,New Caledonia,285491,Oceania,22,0
NCL,2020-43,0,0,New Caledonia,285491,Oceania,22,0
NCL,2020-44,1,0,New Caledonia,285491,Oceania,23,0
NCL,2020-45,1,0,New Caledonia,285491,Oceania,24,0
NCL,2020-46,1,0,New Caledonia,285491,Oceania,25,0
NCL,2020-47,2,0,New Caledonia,285491,Oceania,27,0
NCL,2020-48,0,0,New Caledonia,285491,Oceania,27,0
NCL,2020-49,3,0,New Caledonia,285491,Oceania,30,0
NCL,2020-50,1,0,New Caledonia,285491,Oceania,31,0
NCL,2020-51,1,0,New Caledonia,285491,Oceania,32,0
NCL,2020-52,1,0,New Caledonia,285491,Oceania,33,0
NCL,2020-53,2,0,New Caledonia,285491,Oceania,35,0
NCL,2021-01,0,0,New Caledonia,285491,Oceania,35,0
NCL,2021-02,4,0,New Caledonia,285491,Oceania,39,0
NCL,2021-03,0,0,New Caledonia,285491,Oceania,39,0
NCL,2021-04,3,0,New Caledonia,285491,Oceania,42,0
NCL,2021-05,0,0,New Caledonia,285491,Oceania,42,0
NCL,2021-06,5,0,New Caledonia,285491,Oceania,47,0
NCL,2021-07,3,0,New Caledonia,285491,Oceania,50,0
NCL,2021-08,3,0,New Caledonia,285491,Oceania,53,0
NCL,2021-09,9,0,New Caledonia,285491,Oceania,62,0
NCL,2021-10,26,0,New Caledonia,285491,Oceania,88,0
NCL,2021-11,23,0,New Caledonia,285491,Oceania,111,0
NCL,2021-12,5,0,New Caledonia,285491,Oceania,116,0
NCL,2021-13,0,0,New Caledonia,285491,Oceania,116,0
NCL,2021-14,0,0,New Caledonia,285491,Oceania,116,0
NCL,2021-15,3,0,New Caledonia,285491,Oceania,119,0
NCL,2021-16,0,0,New Caledonia,285491,Oceania,119,0
NCL,2021-17,0,0,New Caledonia,285491,Oceania,119,0
NCL,2021-18,0,0,New Caledonia,285491,Oceania,119,0
NCL,2021-19,0,0,New Caledonia,285491,Oceania,119,0
NCL,2021-20,1,0,New Caledonia,285491,Oceania,120,0
NCL,2021-21,3,0,New Caledonia,285491,Oceania,123,0
NCL,2021-22,0,0,New Caledonia,285491,Oceania,123,0
NCL,2021-23,0,0,New Caledonia,285491,Oceania,123,0
NCL,2021-24,1,0,New Caledonia,285491,Oceania,124,0
NCL,2021-25,0,0,New Caledonia,285491,Oceania,124,0
NCL,2021-26,0,0,New Caledonia,285491,Oceania,124,0
NCL,2021-27,0,0,New Caledonia,285491,Oceania,124,0
NCL,2021-28,0,0,New Caledonia,285491,Oceania,124,0
NCL,2021-29,2,0,New Caledonia,285491,Oceania,126,0
NCL,2021-30,3,0,New Caledonia,285491,Oceania,129,0
NCL,2021-31,0,0,New Caledonia,285491,Oceania,129,0
NCL,2021-32,0,0,New Caledonia,285491,Oceania,129,0
NER,2020-13,9,1,Niger,24206636,Africa,9,1
NER,2020-14,174,9,Niger,24206636,Africa,183,10
NER,2020-15,345,2,Niger,24206636,Africa,528,12
NER,2020-16,119,8,Niger,24206636,Africa,647,20
NER,2020-17,48,9,Niger,24206636,Africa,695,29
NER,2020-18,54,7,Niger,24206636,Africa,749,36
NER,2020-19,71,10,Niger,24206636,Africa,820,46
NER,2020-20,83,8,Niger,24206636,Africa,903,54
NER,2020-21,41,7,Niger,24206636,Africa,944,61
NER,2020-22,13,3,Niger,24206636,Africa,957,64
NER,2020-23,15,1,Niger,24206636,Africa,972,65
NER,2020-24,7,1,Niger,24206636,Africa,979,66
NER,2020-25,56,1,Niger,24206636,Africa,1035,67
NER,2020-26,38,0,Niger,24206636,Africa,1073,67
NER,2020-27,19,1,Niger,24206636,Africa,1092,68
NER,2020-28,6,0,Niger,24206636,Africa,1098,68
NER,2020-29,5,1,Niger,24206636,Africa,1103,69
NER,2020-30,28,0,Niger,24206636,Africa,1131,69
NER,2020-31,15,0,Niger,24206636,Africa,1146,69
NER,2020-32,11,0,Niger,24206636,Africa,1157,69
NER,2020-33,9,0,Niger,24206636,Africa,1166,69
NER,2020-34,5,0,Niger,24206636,Africa,1171,69
NER,2020-35,4,0,Niger,24206636,Africa,1175,69
NER,2020-36,1,0,Niger,24206636,Africa,1176,69
NER,2020-37,3,0,Niger,24206636,Africa,1179,69
NER,2020-38,8,0,Niger,24206636,Africa,1187,69
NER,2020-39,8,0,Niger,24206636,Africa,1195,69
NER,2020-40,4,0,Niger,24206636,Africa,1199,69
NER,2020-41,1,0,Niger,24206636,Africa,1200,69
NER,2020-42,9,0,Niger,24206636,Africa,1209,69
NER,2020-43,5,0,Niger,24206636,Africa,1214,69
NER,2020-44,6,0,Niger,24206636,Africa,1220,69
NER,2020-45,22,0,Niger,24206636,Africa,1242,69
NER,2020-46,64,1,Niger,24206636,Africa,1306,70
NER,2020-47,61,0,Niger,24206636,Africa,1367,70
NER,2020-48,148,0,Niger,24206636,Africa,1515,70
NER,2020-49,340,7,Niger,24206636,Africa,1855,77
NER,2020-50,402,3,Niger,24206636,Africa,2257,80
NER,2020-51,401,7,Niger,24206636,Africa,2658,87
NER,2020-52,500,12,Niger,24206636,Africa,3158,99
NER,2020-53,306,11,Niger,24206636,Africa,3464,110
NER,2021-01,412,16,Niger,24206636,Africa,3876,126
NER,2021-02,279,14,Niger,24206636,Africa,4155,140
NER,2021-03,197,11,Niger,24206636,Africa,4352,151
NER,2021-04,184,10,Niger,24206636,Africa,4536,161
NER,2021-05,75,4,Niger,24206636,Africa,4611,165
NER,2021-06,83,4,Niger,24206636,Africa,4694,169
NER,2021-07,45,3,Niger,24206636,Africa,4739,172
NER,2021-08,0,0,Niger,24206636,Africa,4739,172
NER,2021-09,88,5,Niger,24206636,Africa,4827,177
NER,2021-10,32,5,Niger,24206636,Africa,4859,182
NER,2021-11,68,3,Niger,24206636,Africa,4927,185
NER,2021-12,59,0,Niger,24206636,Africa,4986,185
NER,2021-13,54,3,Niger,24206636,Africa,5040,188
NER,2021-14,33,1,Niger,24206636,Africa,5073,189
NER,2021-15,57,1,Niger,24206636,Africa,5130,190
NER,2021-16,60,1,Niger,24206636,Africa,5190,191
NER,2021-17,60,0,Niger,24206636,Africa,5250,191
NER,2021-18,70,1,Niger,24206636,Africa,5320,192
NER,2021-19,12,0,Niger,24206636,Africa,5332,192
NER,2021-20,50,0,Niger,24206636,Africa,5382,192
NER,2021-21,27,0,Niger,24206636,Africa,5409,192
NER,2021-22,29,0,Niger,24206636,Africa,5438,192
NER,2021-23,7,0,Niger,24206636,Africa,5445,192
NER,2021-24,23,1,Niger,24206636,Africa,5468,193
NER,2021-25,10,0,Niger,24206636,Africa,5478,193
NER,2021-26,40,1,Niger,24206636,Africa,5518,194
NER,2021-27,19,0,Niger,24206636,Africa,5537,194
NER,2021-28,49,0,Niger,24206636,Africa,5586,194
NER,2021-29,12,1,Niger,24206636,Africa,5598,195
NER,2021-30,38,0,Niger,24206636,Africa,5636,195
NER,2021-31,50,1,Niger,24206636,Africa,5686,196
NER,2021-32,37,0,Niger,24206636,Africa,5723,196
NGA,2020-02,0,0,Nigeria,206139587,Africa,0,0
NGA,2020-03,0,0,Nigeria,206139587,Africa,0,0
NGA,2020-04,0,0,Nigeria,206139587,Africa,0,0
NGA,2020-05,0,0,Nigeria,206139587,Africa,0,0
NGA,2020-06,0,0,Nigeria,206139587,Africa,0,0
NGA,2020-07,0,0,Nigeria,206139587,Africa,0,0
NGA,2020-08,0,0,Nigeria,206139587,Africa,0,0
NGA,2020-09,1,0,Nigeria,206139587,Africa,1,0
NGA,2020-10,0,0,Nigeria,206139587,Africa,1,0
NGA,2020-11,1,0,Nigeria,206139587,Africa,2,0
NGA,2020-12,28,0,Nigeria,206139587,Africa,30,0
NGA,2020-13,67,1,Nigeria,206139587,Africa,97,1
NGA,2020-14,135,4,Nigeria,206139587,Africa,232,5
NGA,2020-15,91,5,Nigeria,206139587,Africa,323,10
NGA,2020-16,304,11,Nigeria,206139587,Africa,627,21
NGA,2020-17,646,19,Nigeria,206139587,Africa,1273,40
NGA,2020-18,1285,47,Nigeria,206139587,Africa,2558,87
NGA,2020-19,1841,56,Nigeria,206139587,Africa,4399,143
NGA,2020-20,1560,39,Nigeria,206139587,Africa,5959,182
NGA,2020-21,1880,44,Nigeria,206139587,Africa,7839,226
NGA,2020-22,2323,61,Nigeria,206139587,Africa,10162,287
NGA,2020-23,2324,67,Nigeria,206139587,Africa,12486,354
NGA,2020-24,3599,66,Nigeria,206139587,Africa,16085,420
NGA,2020-25,4159,98,Nigeria,206139587,Africa,20244,518
NGA,2020-26,4323,47,Nigeria,206139587,Africa,24567,565
NGA,2020-27,4144,80,Nigeria,206139587,Africa,28711,645
NGA,2020-28,3847,95,Nigeria,206139587,Africa,32558,740
NGA,2020-29,4105,49,Nigeria,206139587,Africa,36663,789
NGA,2020-30,3869,69,Nigeria,206139587,Africa,40532,858
NGA,2020-31,3309,30,Nigeria,206139587,Africa,43841,888
NGA,2020-32,2736,57,Nigeria,206139587,Africa,46577,945
NGA,2020-33,2491,30,Nigeria,206139587,Africa,49068,975
NGA,2020-34,3159,27,Nigeria,206139587,Africa,52227,1002
NGA,2020-35,1638,11,Nigeria,206139587,Africa,53865,1013
NGA,2020-36,1140,44,Nigeria,206139587,Africa,55005,1057
NGA,2020-37,1251,25,Nigeria,206139587,Africa,56256,1082
NGA,2020-38,986,16,Nigeria,206139587,Africa,57242,1098
NGA,2020-39,1082,10,Nigeria,206139587,Africa,58324,1108
NGA,2020-40,1021,5,Nigeria,206139587,Africa,59345,1113
NGA,2020-41,921,2,Nigeria,206139587,Africa,60266,1115
NGA,2020-42,1174,10,Nigeria,206139587,Africa,61440,1125
NGA,2020-43,552,5,Nigeria,206139587,Africa,61992,1130
NGA,2020-44,972,16,Nigeria,206139587,Africa,62964,1146
NGA,2020-45,1126,8,Nigeria,206139587,Africa,64090,1154
NGA,2020-46,1058,9,Nigeria,206139587,Africa,65148,1163
NGA,2020-47,1235,4,Nigeria,206139587,Africa,66383,1167
NGA,2020-48,1029,6,Nigeria,206139587,Africa,67412,1173
NGA,2020-49,1843,7,Nigeria,206139587,Africa,69255,1180
NGA,2020-50,3920,17,Nigeria,206139587,Africa,73175,1197
NGA,2020-51,5259,24,Nigeria,206139587,Africa,78434,1221
NGA,2020-52,6377,43,Nigeria,206139587,Africa,84811,1264
NGA,2020-53,5269,47,Nigeria,206139587,Africa,90080,1311
NGA,2021-01,10007,47,Nigeria,206139587,Africa,100087,1358
NGA,2021-02,10300,77,Nigeria,206139587,Africa,110387,1435
NGA,2021-03,12609,72,Nigeria,206139587,Africa,122996,1507
NGA,2021-04,8922,100,Nigeria,206139587,Africa,131918,1607
NGA,2021-05,7830,60,Nigeria,206139587,Africa,139748,1667
NGA,2021-06,6436,85,Nigeria,206139587,Africa,146184,1752
NGA,2021-07,5890,87,Nigeria,206139587,Africa,152074,1839
NGA,2021-08,3583,68,Nigeria,206139587,Africa,155657,1907
NGA,2021-09,2849,62,Nigeria,206139587,Africa,158506,1969
NGA,2021-10,2151,44,Nigeria,206139587,Africa,160657,2013
NGA,2021-11,1080,17,Nigeria,206139587,Africa,161737,2030
NGA,2021-12,856,18,Nigeria,206139587,Africa,162593,2048
NGA,2021-13,520,10,Nigeria,206139587,Africa,163113,2058
NGA,2021-14,680,2,Nigeria,206139587,Africa,163793,2060
NGA,2021-15,440,1,Nigeria,206139587,Africa,164233,2061
NGA,2021-16,486,1,Nigeria,206139587,Africa,164719,2062
NGA,2021-17,462,1,Nigeria,206139587,Africa,165181,2063
NGA,2021-18,238,2,Nigeria,206139587,Africa,165419,2065
NGA,2021-19,290,1,Nigeria,206139587,Africa,165709,2066
NGA,2021-20,310,1,Nigeria,206139587,Africa,166019,2067
NGA,2021-21,296,4,Nigeria,206139587,Africa,166315,2071
NGA,2021-22,415,46,Nigeria,206139587,Africa,166730,2117
NGA,2021-23,329,0,Nigeria,206139587,Africa,167059,2117
NGA,2021-24,233,1,Nigeria,206139587,Africa,167292,2118
NGA,2021-25,175,1,Nigeria,206139587,Africa,167467,2119
NGA,2021-26,392,2,Nigeria,206139587,Africa,167859,2121
NGA,2021-27,693,3,Nigeria,206139587,Africa,168552,2124
NGA,2021-28,980,3,Nigeria,206139587,Africa,169532,2127
NGA,2021-29,1579,5,Nigeria,206139587,Africa,171111,2132
NGA,2021-30,3204,17,Nigeria,206139587,Africa,174315,2149
NGA,2021-31,3771,38,Nigeria,206139587,Africa,178086,2187
NGA,2021-32,4417,32,Nigeria,206139587,Africa,182503,2219
NIC,2020-13,2,1,Nicaragua,6624554,America,2,1
NIC,2020-14,1,0,Nicaragua,6624554,America,3,1
NIC,2020-15,4,0,Nicaragua,6624554,America,7,1
NIC,2020-16,0,0,Nicaragua,6624554,America,7,1
NIC,2020-17,4,2,Nicaragua,6624554,America,11,3
NIC,2020-18,1,2,Nicaragua,6624554,America,12,5
NIC,2020-19,2,0,Nicaragua,6624554,America,14,5
NIC,2020-20,9,3,Nicaragua,6624554,America,23,8
NIC,2020-21,254,9,Nicaragua,6624554,America,277,17
NIC,2020-22,480,18,Nicaragua,6624554,America,757,35
NIC,2020-23,550,11,Nicaragua,6624554,America,1307,46
NIC,2020-24,346,9,Nicaragua,6624554,America,1653,55
NIC,2020-25,359,9,Nicaragua,6624554,America,2012,64
NIC,2020-26,156,10,Nicaragua,6624554,America,2168,74
NIC,2020-27,349,9,Nicaragua,6624554,America,2517,83
NIC,2020-28,327,8,Nicaragua,6624554,America,2844,91
NIC,2020-29,301,8,Nicaragua,6624554,America,3145,99
NIC,2020-30,292,9,Nicaragua,6624554,America,3437,108
NIC,2020-31,233,8,Nicaragua,6624554,America,3670,116
NIC,2020-32,230,7,Nicaragua,6624554,America,3900,123
NIC,2020-33,213,5,Nicaragua,6624554,America,4113,128
NIC,2020-34,196,5,Nicaragua,6624554,America,4309,133
NIC,2020-35,183,4,Nicaragua,6624554,America,4492,137
NIC,2020-36,174,4,Nicaragua,6624554,America,4666,141
NIC,2020-37,150,3,Nicaragua,6624554,America,4816,144
NIC,2020-38,143,3,Nicaragua,6624554,America,4959,147
NIC,2020-39,112,2,Nicaragua,6624554,America,5071,149
NIC,2020-40,97,2,Nicaragua,6624554,America,5168,151
NIC,2020-41,94,2,Nicaragua,6624554,America,5262,153
NIC,2020-42,89,1,Nicaragua,6624554,America,5351,154
NIC,2020-43,81,1,Nicaragua,6624554,America,5432,155
NIC,2020-44,80,1,Nicaragua,6624554,America,5512,156
NIC,2020-45,77,1,Nicaragua,6624554,America,5589,157
NIC,2020-46,70,1,Nicaragua,6624554,America,5659,158
NIC,2020-47,64,1,Nicaragua,6624554,America,5723,159
NIC,2020-48,59,1,Nicaragua,6624554,America,5782,160
NIC,2020-49,54,1,Nicaragua,6624554,America,5836,161
NIC,2020-50,49,1,Nicaragua,6624554,America,5885,162
NIC,2020-51,51,1,Nicaragua,6624554,America,5936,163
NIC,2020-52,53,1,Nicaragua,6624554,America,5989,164
NIC,2020-53,55,1,Nicaragua,6624554,America,6044,165
NIC,2021-01,51,1,Nicaragua,6624554,America,6095,166
NIC,2021-02,55,1,Nicaragua,6624554,America,6150,167
NIC,2021-03,52,1,Nicaragua,6624554,America,6202,168
NIC,2021-04,49,1,Nicaragua,6624554,America,6251,169
NIC,2021-05,46,1,Nicaragua,6624554,America,6297,170
NIC,2021-06,48,1,Nicaragua,6624554,America,6345,171
NIC,2021-07,98,2,Nicaragua,6624554,America,6443,173
NIC,2021-08,44,1,Nicaragua,6624554,America,6487,174
NIC,2021-09,0,0,Nicaragua,6624554,America,6487,174
NIC,2021-10,48,1,Nicaragua,6624554,America,6535,175
NIC,2021-11,45,1,Nicaragua,6624554,America,6580,176
NIC,2021-12,47,1,Nicaragua,6624554,America,6627,177
NIC,2021-13,48,1,Nicaragua,6624554,America,6675,178
NIC,2021-14,50,1,Nicaragua,6624554,America,6725,179
NIC,2021-15,51,1,Nicaragua,6624554,America,6776,180
NIC,2021-16,57,1,Nicaragua,6624554,America,6833,181
NIC,2021-17,63,1,Nicaragua,6624554,America,6896,182
NIC,2021-18,91,1,Nicaragua,6624554,America,6987,183
NIC,2021-19,97,1,Nicaragua,6624554,America,7084,184
NIC,2021-20,107,1,Nicaragua,6624554,America,7191,185
NIC,2021-21,131,1,Nicaragua,6624554,America,7322,186
NIC,2021-22,157,1,Nicaragua,6624554,America,7479,187
NIC,2021-23,181,1,Nicaragua,6624554,America,7660,188
NIC,2021-24,34,0,Nicaragua,6624554,America,7694,188
NIC,2021-25,224,2,Nicaragua,6624554,America,7918,190
NIC,2021-26,258,1,Nicaragua,6624554,America,8176,191
NIC,2021-27,283,1,Nicaragua,6624554,America,8459,192
NIC,2021-28,306,1,Nicaragua,6624554,America,8765,193
NIC,2021-29,341,1,Nicaragua,6624554,America,9106,194
NIC,2021-30,362,1,Nicaragua,6624554,America,9468,195
NIC,2021-31,383,1,Nicaragua,6624554,America,9851,196
NIC,2021-32,398,1,Nicaragua,6624554,America,10249,197
NLD,2020-02,0,0,Netherlands,17407585,Europe,0,0
NLD,2020-03,0,0,Netherlands,17407585,Europe,0,0
NLD,2020-04,0,0,Netherlands,17407585,Europe,0,0
NLD,2020-05,0,0,Netherlands,17407585,Europe,0,0
NLD,2020-06,0,0,Netherlands,17407585,Europe,0,0
NLD,2020-07,0,0,Netherlands,17407585,Europe,0,0
NLD,2020-08,0,0,Netherlands,17407585,Europe,0,0
NLD,2020-09,13,0,Netherlands,17407585,Europe,13,0
NLD,2020-10,252,3,Netherlands,17407585,Europe,265,3
NLD,2020-11,870,17,Netherlands,17407585,Europe,1135,20
NLD,2020-12,3069,159,Netherlands,17407585,Europe,4204,179
NLD,2020-13,6662,592,Netherlands,17407585,Europe,10866,771
NLD,2020-14,6985,995,Netherlands,17407585,Europe,17851,1766
NLD,2020-15,7736,971,Netherlands,17407585,Europe,25587,2737
NLD,2020-16,7068,947,Netherlands,17407585,Europe,32655,3684
NLD,2020-17,5190,791,Netherlands,17407585,Europe,37845,4475
NLD,2020-18,2726,581,Netherlands,17407585,Europe,40571,5056
NLD,2020-19,2056,384,Netherlands,17407585,Europe,42627,5440
NLD,2020-20,1368,240,Netherlands,17407585,Europe,43995,5680
NLD,2020-21,1241,142,Netherlands,17407585,Europe,45236,5822
NLD,2020-22,1206,134,Netherlands,17407585,Europe,46442,5956
NLD,2020-23,1132,57,Netherlands,17407585,Europe,47574,6013
NLD,2020-24,1209,46,Netherlands,17407585,Europe,48783,6059
NLD,2020-25,810,31,Netherlands,17407585,Europe,49593,6090
NLD,2020-26,554,15,Netherlands,17407585,Europe,50147,6105
NLD,2020-27,474,22,Netherlands,17407585,Europe,50621,6127
NLD,2020-28,401,8,Netherlands,17407585,Europe,51022,6135
NLD,2020-29,703,1,Netherlands,17407585,Europe,51725,6136
NLD,2020-30,1221,4,Netherlands,17407585,Europe,52946,6140
NLD,2020-31,2097,0,Netherlands,17407585,Europe,55043,6140
NLD,2020-32,3521,8,Netherlands,17407585,Europe,58564,6148
NLD,2020-33,4379,15,Netherlands,17407585,Europe,62943,6163
NLD,2020-34,3547,28,Netherlands,17407585,Europe,66490,6191
NLD,2020-35,3581,24,Netherlands,17407585,Europe,70071,6215
NLD,2020-36,4644,19,Netherlands,17407585,Europe,74715,6234
NLD,2020-37,7308,11,Netherlands,17407585,Europe,82023,6245
NLD,2020-38,11661,25,Netherlands,17407585,Europe,93684,6270
NLD,2020-39,17826,95,Netherlands,17407585,Europe,111510,6365
NLD,2020-40,24239,80,Netherlands,17407585,Europe,135749,6445
NLD,2020-41,38701,130,Netherlands,17407585,Europe,174450,6575
NLD,2020-42,53784,176,Netherlands,17407585,Europe,228234,6751
NLD,2020-43,62691,285,Netherlands,17407585,Europe,290925,7036
NLD,2020-44,68512,388,Netherlands,17407585,Europe,359437,7424
NLD,2020-45,50136,570,Netherlands,17407585,Europe,409573,7994
NLD,2020-46,37762,481,Netherlands,17407585,Europe,447335,8475
NLD,2020-47,36725,404,Netherlands,17407585,Europe,484060,8879
NLD,2020-48,34213,457,Netherlands,17407585,Europe,518273,9336
NLD,2020-49,38280,338,Netherlands,17407585,Europe,556553,9674
NLD,2020-50,56193,360,Netherlands,17407585,Europe,612746,10034
NLD,2020-51,76154,443,Netherlands,17407585,Europe,688900,10477
NLD,2020-52,80594,551,Netherlands,17407585,Europe,769494,11028
NLD,2020-53,50699,570,Netherlands,17407585,Europe,820193,11598
NLD,2021-01,57026,799,Netherlands,17407585,Europe,877219,12397
NLD,2021-02,38967,645,Netherlands,17407585,Europe,916186,13042
NLD,2021-03,35590,522,Netherlands,17407585,Europe,951776,13564
NLD,2021-04,28671,445,Netherlands,17407585,Europe,980447,14009
NLD,2021-05,26270,403,Netherlands,17407585,Europe,1006717,14412
NLD,2021-06,24069,414,Netherlands,17407585,Europe,1030786,14826
NLD,2021-07,28657,405,Netherlands,17407585,Europe,1059443,15231
NLD,2021-08,28395,326,Netherlands,17407585,Europe,1087838,15557
NLD,2021-09,31311,268,Netherlands,17407585,Europe,1119149,15825
NLD,2021-10,37029,236,Netherlands,17407585,Europe,1156178,16061
NLD,2021-11,44404,208,Netherlands,17407585,Europe,1200582,16269
NLD,2021-12,50962,186,Netherlands,17407585,Europe,1251544,16455
NLD,2021-13,49757,159,Netherlands,17407585,Europe,1301301,16614
NLD,2021-14,48484,151,Netherlands,17407585,Europe,1349785,16765
NLD,2021-15,53179,148,Netherlands,17407585,Europe,1402964,16913
NLD,2021-16,57349,134,Netherlands,17407585,Europe,1460313,17047
NLD,2021-17,46473,120,Netherlands,17407585,Europe,1506786,17167
NLD,2021-18,52463,152,Netherlands,17407585,Europe,1559249,17319
NLD,2021-19,38178,130,Netherlands,17407585,Europe,1597427,17449
NLD,2021-20,28081,92,Netherlands,17407585,Europe,1625508,17541
NLD,2021-21,21131,81,Netherlands,17407585,Europe,1646639,17622
NLD,2021-22,15901,53,Netherlands,17407585,Europe,1662540,17675
NLD,2021-23,9905,34,Netherlands,17407585,Europe,1672445,17709
NLD,2021-24,6297,17,Netherlands,17407585,Europe,1678742,17726
NLD,2021-25,4330,15,Netherlands,17407585,Europe,1683072,17741
NLD,2021-26,5823,15,Netherlands,17407585,Europe,1688895,17756
NLD,2021-27,39140,10,Netherlands,17407585,Europe,1728035,17766
NLD,2021-28,70151,10,Netherlands,17407585,Europe,1798186,17776
NLD,2021-29,45006,24,Netherlands,17407585,Europe,1843192,17800
NLD,2021-30,24409,29,Netherlands,17407585,Europe,1867601,17829
NLD,2021-31,18065,40,Netherlands,17407585,Europe,1885666,17869
NLD,2021-32,16161,40,Netherlands,17407585,Europe,1901827,17909
NOR,2020-02,0,0,Norway,5367580,Europe,0,0
NOR,2020-03,0,0,Norway,5367580,Europe,0,0
NOR,2020-04,0,0,Norway,5367580,Europe,0,0
NOR,2020-05,0,0,Norway,5367580,Europe,0,0
NOR,2020-06,0,0,Norway,5367580,Europe,0,0
NOR,2020-07,0,0,Norway,5367580,Europe,0,0
NOR,2020-08,0,0,Norway,5367580,Europe,0,0
NOR,2020-09,19,0,Norway,5367580,Europe,19,0
NOR,2020-10,150,0,Norway,5367580,Europe,169,0
NOR,2020-11,908,1,Norway,5367580,Europe,1077,1
NOR,2020-12,1055,6,Norway,5367580,Europe,2132,7
NOR,2020-13,1970,15,Norway,5367580,Europe,4102,22
NOR,2020-14,1538,36,Norway,5367580,Europe,5640,58
NOR,2020-15,775,45,Norway,5367580,Europe,6415,103
NOR,2020-16,653,51,Norway,5367580,Europe,7068,154
NOR,2020-17,437,39,Norway,5367580,Europe,7505,193
NOR,2020-18,304,15,Norway,5367580,Europe,7809,208
NOR,2020-19,290,9,Norway,5367580,Europe,8099,217
NOR,2020-20,98,15,Norway,5367580,Europe,8197,232
NOR,2020-21,112,3,Norway,5367580,Europe,8309,235
NOR,2020-22,102,1,Norway,5367580,Europe,8411,236
NOR,2020-23,93,2,Norway,5367580,Europe,8504,238
NOR,2020-24,102,4,Norway,5367580,Europe,8606,242
NOR,2020-25,102,2,Norway,5367580,Europe,8708,244
NOR,2020-26,107,5,Norway,5367580,Europe,8815,249
NOR,2020-27,80,2,Norway,5367580,Europe,8895,251
NOR,2020-28,70,1,Norway,5367580,Europe,8965,252
NOR,2020-29,50,3,Norway,5367580,Europe,9015,255
NOR,2020-30,70,0,Norway,5367580,Europe,9085,255
NOR,2020-31,123,0,Norway,5367580,Europe,9208,255
NOR,2020-32,260,1,Norway,5367580,Europe,9468,256
NOR,2020-33,382,5,Norway,5367580,Europe,9850,261
NOR,2020-34,347,3,Norway,5367580,Europe,10197,264
NOR,2020-35,346,0,Norway,5367580,Europe,10543,264
NOR,2020-36,577,0,Norway,5367580,Europe,11120,264
NOR,2020-37,746,1,Norway,5367580,Europe,11866,265
NOR,2020-38,779,2,Norway,5367580,Europe,12645,267
NOR,2020-39,761,3,Norway,5367580,Europe,13406,270
NOR,2020-40,743,5,Norway,5367580,Europe,14149,275
NOR,2020-41,1072,0,Norway,5367580,Europe,15221,275
NOR,2020-42,915,3,Norway,5367580,Europe,16136,278
NOR,2020-43,1096,1,Norway,5367580,Europe,17232,279
NOR,2020-44,2331,3,Norway,5367580,Europe,19563,282
NOR,2020-45,3662,3,Norway,5367580,Europe,23225,285
NOR,2020-46,4001,9,Norway,5367580,Europe,27226,294
NOR,2020-47,4212,12,Norway,5367580,Europe,31438,306
NOR,2020-48,3309,22,Norway,5367580,Europe,34747,328
NOR,2020-49,2624,26,Norway,5367580,Europe,37371,354
NOR,2020-50,3632,39,Norway,5367580,Europe,41003,393
NOR,2020-51,1772,11,Norway,5367580,Europe,42775,404
NOR,2020-52,4282,25,Norway,5367580,Europe,47057,429
NOR,2020-53,3658,20,Norway,5367580,Europe,50715,449
NOR,2021-01,4758,29,Norway,5367580,Europe,55473,478
NOR,2021-02,3178,43,Norway,5367580,Europe,58651,521
NOR,2021-03,2431,27,Norway,5367580,Europe,61082,548
NOR,2021-04,1884,19,Norway,5367580,Europe,62966,567
NOR,2021-05,1806,15,Norway,5367580,Europe,64772,582
NOR,2021-06,1729,11,Norway,5367580,Europe,66501,593
NOR,2021-07,2030,15,Norway,5367580,Europe,68531,608
NOR,2021-08,2471,15,Norway,5367580,Europe,71002,623
NOR,2021-09,3938,9,Norway,5367580,Europe,74940,632
NOR,2021-10,5500,8,Norway,5367580,Europe,80440,640
NOR,2021-11,6499,9,Norway,5367580,Europe,86939,649
NOR,2021-12,6206,11,Norway,5367580,Europe,93145,660
NOR,2021-13,5529,16,Norway,5367580,Europe,98674,676
NOR,2021-14,4946,11,Norway,5367580,Europe,103620,687
NOR,2021-15,3890,22,Norway,5367580,Europe,107510,709
NOR,2021-16,3101,28,Norway,5367580,Europe,110611,737
NOR,2021-17,2857,20,Norway,5367580,Europe,113468,757
NOR,2021-18,2973,10,Norway,5367580,Europe,116441,767
NOR,2021-19,2816,7,Norway,5367580,Europe,119257,774
NOR,2021-20,3115,8,Norway,5367580,Europe,122372,782
NOR,2021-21,2408,1,Norway,5367580,Europe,124780,783
NOR,2021-22,2037,1,Norway,5367580,Europe,126817,784
NOR,2021-23,1262,5,Norway,5367580,Europe,128079,789
NOR,2021-24,1253,1,Norway,5367580,Europe,129332,790
NOR,2021-25,1287,2,Norway,5367580,Europe,130619,792
NOR,2021-26,1326,2,Norway,5367580,Europe,131945,794
NOR,2021-27,1250,2,Norway,5367580,Europe,133195,796
NOR,2021-28,1142,0,Norway,5367580,Europe,134337,796
NOR,2021-29,1430,3,Norway,5367580,Europe,135767,799
NOR,2021-30,2183,0,Norway,5367580,Europe,137950,799
NOR,2021-31,2880,5,Norway,5367580,Europe,140830,804
NOR,2021-32,3648,5,Norway,5367580,Europe,144478,809
NPL,2020-02,0,0,Nepal,29136808,Asia,0,0
NPL,2020-03,0,0,Nepal,29136808,Asia,0,0
NPL,2020-04,1,0,Nepal,29136808,Asia,1,0
NPL,2020-05,0,0,Nepal,29136808,Asia,1,0
NPL,2020-06,0,0,Nepal,29136808,Asia,1,0
NPL,2020-07,0,0,Nepal,29136808,Asia,1,0
NPL,2020-08,0,0,Nepal,29136808,Asia,1,0
NPL,2020-09,0,0,Nepal,29136808,Asia,1,0
NPL,2020-10,0,0,Nepal,29136808,Asia,1,0
NPL,2020-11,0,0,Nepal,29136808,Asia,1,0
NPL,2020-12,0,0,Nepal,29136808,Asia,1,0
NPL,2020-13,4,0,Nepal,29136808,Asia,5,0
NPL,2020-14,4,0,Nepal,29136808,Asia,9,0
NPL,2020-15,3,0,Nepal,29136808,Asia,12,0
NPL,2020-16,19,0,Nepal,29136808,Asia,31,0
NPL,2020-17,21,0,Nepal,29136808,Asia,52,0
NPL,2020-18,23,0,Nepal,29136808,Asia,75,0
NPL,2020-19,45,0,Nepal,29136808,Asia,120,0
NPL,2020-20,184,2,Nepal,29136808,Asia,304,2
NPL,2020-21,299,1,Nepal,29136808,Asia,603,3
NPL,2020-22,969,5,Nepal,29136808,Asia,1572,8
NPL,2020-23,1876,5,Nepal,29136808,Asia,3448,13
NPL,2020-24,2312,6,Nepal,29136808,Asia,5760,19
NPL,2020-25,3266,4,Nepal,29136808,Asia,9026,23
NPL,2020-26,3746,5,Nepal,29136808,Asia,12772,28
NPL,2020-27,3012,6,Nepal,29136808,Asia,15784,34
NPL,2020-28,1017,4,Nepal,29136808,Asia,16801,38
NPL,2020-29,857,2,Nepal,29136808,Asia,17658,40
NPL,2020-30,955,5,Nepal,29136808,Asia,18613,45
NPL,2020-31,1719,12,Nepal,29136808,Asia,20332,57
NPL,2020-32,2640,18,Nepal,29136808,Asia,22972,75
NPL,2020-33,3688,29,Nepal,29136808,Asia,26660,104
NPL,2020-34,5275,45,Nepal,29136808,Asia,31935,149
NPL,2020-35,6626,72,Nepal,29136808,Asia,38561,221
NPL,2020-36,7696,68,Nepal,29136808,Asia,46257,289
NPL,2020-37,7902,56,Nepal,29136808,Asia,54159,345
NPL,2020-38,9963,66,Nepal,29136808,Asia,64122,411
NPL,2020-39,9272,66,Nepal,29136808,Asia,73394,477
NPL,2020-40,13429,58,Nepal,29136808,Asia,86823,535
NPL,2020-41,20932,101,Nepal,29136808,Asia,107755,636
NPL,2020-42,24491,103,Nepal,29136808,Asia,132246,739
NPL,2020-43,25843,108,Nepal,29136808,Asia,158089,847
NPL,2020-44,15478,113,Nepal,29136808,Asia,173567,960
NPL,2020-45,20886,148,Nepal,29136808,Asia,194453,1108
NPL,2020-46,15323,113,Nepal,29136808,Asia,209776,1221
NPL,2020-47,10532,100,Nepal,29136808,Asia,220308,1321
NPL,2020-48,11670,158,Nepal,29136808,Asia,231978,1479
NPL,2020-49,9003,115,Nepal,29136808,Asia,240981,1594
NPL,2020-50,7442,104,Nepal,29136808,Asia,248423,1698
NPL,2020-51,5349,90,Nepal,29136808,Asia,253772,1788
NPL,2020-52,4409,37,Nepal,29136808,Asia,258181,1825
NPL,2020-53,3678,53,Nepal,29136808,Asia,261859,1878
NPL,2021-01,2921,39,Nepal,29136808,Asia,264780,1917
NPL,2021-02,2542,42,Nepal,29136808,Asia,267322,1959
NPL,2021-03,2128,42,Nepal,29136808,Asia,269450,2001
NPL,2021-04,1509,28,Nepal,29136808,Asia,270959,2029
NPL,2021-05,966,9,Nepal,29136808,Asia,271925,2038
NPL,2021-06,793,16,Nepal,29136808,Asia,272718,2054
NPL,2021-07,713,7,Nepal,29136808,Asia,273431,2061
NPL,2021-08,712,713,Nepal,29136808,Asia,274143,2774
NPL,2021-09,578,236,Nepal,29136808,Asia,274721,3010
NPL,2021-10,510,4,Nepal,29136808,Asia,275231,3014
NPL,2021-11,675,2,Nepal,29136808,Asia,275906,3016
NPL,2021-12,933,11,Nepal,29136808,Asia,276839,3027
NPL,2021-13,1105,5,Nepal,29136808,Asia,277944,3032
NPL,2021-14,2084,8,Nepal,29136808,Asia,280028,3040
NPL,2021-15,4645,43,Nepal,29136808,Asia,284673,3083
NPL,2021-16,15446,81,Nepal,29136808,Asia,300119,3164
NPL,2021-17,35911,161,Nepal,29136808,Asia,336030,3325
NPL,2021-18,58637,395,Nepal,29136808,Asia,394667,3720
NPL,2021-19,60353,1281,Nepal,29136808,Asia,455020,5001
NPL,2021-20,58221,1345,Nepal,29136808,Asia,513241,6346
NPL,2021-21,43883,1226,Nepal,29136808,Asia,557124,7572
NPL,2021-22,31000,326,Nepal,29136808,Asia,588124,7898
NPL,2021-23,20348,514,Nepal,29136808,Asia,608472,8412
NPL,2021-24,12584,314,Nepal,29136808,Asia,621056,8726
NPL,2021-25,12623,283,Nepal,29136808,Asia,633679,9009
NPL,2021-26,10943,216,Nepal,29136808,Asia,644622,9225
NPL,2021-27,10827,157,Nepal,29136808,Asia,655449,9382
NPL,2021-28,11660,168,Nepal,29136808,Asia,667109,9550
NPL,2021-29,13447,163,Nepal,29136808,Asia,680556,9713
NPL,2021-30,16814,162,Nepal,29136808,Asia,697370,9875
NPL,2021-31,20116,240,Nepal,29136808,Asia,717486,10115
NPL,2021-32,14786,177,Nepal,29136808,Asia,732272,10292
NZL,2020-02,0,0,New Zealand,4822233,Oceania,0,0
NZL,2020-03,0,0,New Zealand,4822233,Oceania,0,0
NZL,2020-04,0,0,New Zealand,4822233,Oceania,0,0
NZL,2020-05,0,0,New Zealand,4822233,Oceania,0,0
NZL,2020-06,0,0,New Zealand,4822233,Oceania,0,0
NZL,2020-07,0,0,New Zealand,4822233,Oceania,0,0
NZL,2020-08,0,0,New Zealand,4822233,Oceania,0,0
NZL,2020-09,1,0,New Zealand,4822233,Oceania,1,0
NZL,2020-10,4,0,New Zealand,4822233,Oceania,5,0
NZL,2020-11,3,0,New Zealand,4822233,Oceania,8,0
NZL,2020-12,94,0,New Zealand,4822233,Oceania,102,0
NZL,2020-13,450,1,New Zealand,4822233,Oceania,552,1
NZL,2020-14,359,0,New Zealand,4822233,Oceania,911,1
NZL,2020-15,153,4,New Zealand,4822233,Oceania,1064,5
NZL,2020-16,41,7,New Zealand,4822233,Oceania,1105,12
NZL,2020-17,17,7,New Zealand,4822233,Oceania,1122,19
NZL,2020-18,15,1,New Zealand,4822233,Oceania,1137,20
NZL,2020-19,10,1,New Zealand,4822233,Oceania,1147,21
NZL,2020-20,2,0,New Zealand,4822233,Oceania,1149,21
NZL,2020-21,5,0,New Zealand,4822233,Oceania,1154,21
NZL,2020-22,0,1,New Zealand,4822233,Oceania,1154,22
NZL,2020-23,0,0,New Zealand,4822233,Oceania,1154,22
NZL,2020-24,0,0,New Zealand,4822233,Oceania,1154,22
NZL,2020-25,9,0,New Zealand,4822233,Oceania,1163,22
NZL,2020-26,15,0,New Zealand,4822233,Oceania,1178,22
NZL,2020-27,5,0,New Zealand,4822233,Oceania,1183,22
NZL,2020-28,11,0,New Zealand,4822233,Oceania,1194,22
NZL,2020-29,10,0,New Zealand,4822233,Oceania,1204,22
NZL,2020-30,2,0,New Zealand,4822233,Oceania,1206,22
NZL,2020-31,11,0,New Zealand,4822233,Oceania,1217,22
NZL,2020-32,2,0,New Zealand,4822233,Oceania,1219,22
NZL,2020-33,61,0,New Zealand,4822233,Oceania,1280,22
NZL,2020-34,52,0,New Zealand,4822233,Oceania,1332,22
NZL,2020-35,55,0,New Zealand,4822233,Oceania,1387,22
NZL,2020-36,38,2,New Zealand,4822233,Oceania,1425,24
NZL,2020-37,22,0,New Zealand,4822233,Oceania,1447,24
NZL,2020-38,17,1,New Zealand,4822233,Oceania,1464,25
NZL,2020-39,13,0,New Zealand,4822233,Oceania,1477,25
NZL,2020-40,22,0,New Zealand,4822233,Oceania,1499,25
NZL,2020-41,16,0,New Zealand,4822233,Oceania,1515,25
NZL,2020-42,15,0,New Zealand,4822233,Oceania,1530,25
NZL,2020-43,54,0,New Zealand,4822233,Oceania,1584,25
NZL,2020-44,23,0,New Zealand,4822233,Oceania,1607,25
NZL,2020-45,23,0,New Zealand,4822233,Oceania,1630,25
NZL,2020-46,15,0,New Zealand,4822233,Oceania,1645,25
NZL,2020-47,29,0,New Zealand,4822233,Oceania,1674,25
NZL,2020-48,26,0,New Zealand,4822233,Oceania,1700,25
NZL,2020-49,23,0,New Zealand,4822233,Oceania,1723,25
NZL,2020-50,17,0,New Zealand,4822233,Oceania,1740,25
NZL,2020-51,25,0,New Zealand,4822233,Oceania,1765,25
NZL,2020-52,23,0,New Zealand,4822233,Oceania,1788,25
NZL,2020-53,37,0,New Zealand,4822233,Oceania,1825,25
NZL,2021-01,41,0,New Zealand,4822233,Oceania,1866,25
NZL,2021-02,40,0,New Zealand,4822233,Oceania,1906,25
NZL,2021-03,26,0,New Zealand,4822233,Oceania,1932,25
NZL,2021-04,15,0,New Zealand,4822233,Oceania,1947,25
NZL,2021-05,17,0,New Zealand,4822233,Oceania,1964,25
NZL,2021-06,16,0,New Zealand,4822233,Oceania,1980,25
NZL,2021-07,21,1,New Zealand,4822233,Oceania,2001,26
NZL,2021-08,21,0,New Zealand,4822233,Oceania,2022,26
NZL,2021-09,27,0,New Zealand,4822233,Oceania,2049,26
NZL,2021-10,25,0,New Zealand,4822233,Oceania,2074,26
NZL,2021-11,32,0,New Zealand,4822233,Oceania,2106,26
NZL,2021-12,31,0,New Zealand,4822233,Oceania,2137,26
NZL,2021-13,14,0,New Zealand,4822233,Oceania,2151,26
NZL,2021-14,76,0,New Zealand,4822233,Oceania,2227,26
NZL,2021-15,13,0,New Zealand,4822233,Oceania,2240,26
NZL,2021-16,13,0,New Zealand,4822233,Oceania,2253,26
NZL,2021-17,13,0,New Zealand,4822233,Oceania,2266,26
NZL,2021-18,22,0,New Zealand,4822233,Oceania,2288,26
NZL,2021-19,7,0,New Zealand,4822233,Oceania,2295,26
NZL,2021-20,16,0,New Zealand,4822233,Oceania,2311,26
NZL,2021-21,6,0,New Zealand,4822233,Oceania,2317,26
NZL,2021-22,9,0,New Zealand,4822233,Oceania,2326,26
NZL,2021-23,26,0,New Zealand,4822233,Oceania,2352,26
NZL,2021-24,11,0,New Zealand,4822233,Oceania,2363,26
NZL,2021-25,19,0,New Zealand,4822233,Oceania,2382,26
NZL,2021-26,20,0,New Zealand,4822233,Oceania,2402,26
NZL,2021-27,10,0,New Zealand,4822233,Oceania,2412,26
NZL,2021-28,49,0,New Zealand,4822233,Oceania,2461,26
NZL,2021-29,46,0,New Zealand,4822233,Oceania,2507,26
NZL,2021-30,14,0,New Zealand,4822233,Oceania,2521,26
NZL,2021-31,13,0,New Zealand,4822233,Oceania,2534,26
NZL,2021-32,0,0,New Zealand,4822233,Oceania,2534,26
OMN,2020-02,0,0,Oman,5106622,Asia,0,0
OMN,2020-03,0,0,Oman,5106622,Asia,0,0
OMN,2020-04,0,0,Oman,5106622,Asia,0,0
OMN,2020-05,0,0,Oman,5106622,Asia,0,0
OMN,2020-06,0,0,Oman,5106622,Asia,0,0
OMN,2020-07,0,0,Oman,5106622,Asia,0,0
OMN,2020-08,0,0,Oman,5106622,Asia,0,0
OMN,2020-09,6,0,Oman,5106622,Asia,6,0
OMN,2020-10,10,0,Oman,5106622,Asia,16,0
OMN,2020-11,6,0,Oman,5106622,Asia,22,0
OMN,2020-12,33,0,Oman,5106622,Asia,55,0
OMN,2020-13,112,0,Oman,5106622,Asia,167,0
OMN,2020-14,131,2,Oman,5106622,Asia,298,2
OMN,2020-15,301,2,Oman,5106622,Asia,599,4
OMN,2020-16,667,3,Oman,5106622,Asia,1266,7
OMN,2020-17,732,3,Oman,5106622,Asia,1998,10
OMN,2020-18,570,2,Oman,5106622,Asia,2568,12
OMN,2020-19,831,5,Oman,5106622,Asia,3399,17
OMN,2020-20,1787,5,Oman,5106622,Asia,5186,22
OMN,2020-21,2584,15,Oman,5106622,Asia,7770,37
OMN,2020-22,3667,10,Oman,5106622,Asia,11437,47
OMN,2020-23,5445,28,Oman,5106622,Asia,16882,75
OMN,2020-24,6599,29,Oman,5106622,Asia,23481,104
OMN,2020-25,5990,27,Oman,5106622,Asia,29471,131
OMN,2020-26,8679,32,Oman,5106622,Asia,38150,163
OMN,2020-27,8028,50,Oman,5106622,Asia,46178,213
OMN,2020-28,9837,44,Oman,5106622,Asia,56015,257
OMN,2020-29,10646,61,Oman,5106622,Asia,66661,318
OMN,2020-30,9344,66,Oman,5106622,Asia,76005,384
OMN,2020-31,3154,37,Oman,5106622,Asia,79159,421
OMN,2020-32,2421,92,Oman,5106622,Asia,81580,513
OMN,2020-33,1506,59,Oman,5106622,Asia,83086,572
OMN,2020-34,683,37,Oman,5106622,Asia,83769,609
OMN,2020-35,1775,68,Oman,5106622,Asia,85544,677
OMN,2020-36,1528,51,Oman,5106622,Asia,87072,728
OMN,2020-37,2674,52,Oman,5106622,Asia,89746,780
OMN,2020-38,3729,66,Oman,5106622,Asia,93475,846
OMN,2020-39,3975,63,Oman,5106622,Asia,97450,909
OMN,2020-40,3820,68,Oman,5106622,Asia,101270,977
OMN,2020-41,4620,61,Oman,5106622,Asia,105890,1038
OMN,2020-42,4063,63,Oman,5106622,Asia,109953,1101
OMN,2020-43,2979,73,Oman,5106622,Asia,112932,1174
OMN,2020-44,2802,72,Oman,5106622,Asia,115734,1246
OMN,2020-45,2406,55,Oman,5106622,Asia,118140,1301
OMN,2020-46,2249,37,Oman,5106622,Asia,120389,1338
OMN,2020-47,1692,42,Oman,5106622,Asia,122081,1380
OMN,2020-48,1403,38,Oman,5106622,Asia,123484,1418
OMN,2020-49,1402,26,Oman,5106622,Asia,124886,1444
OMN,2020-50,1354,27,Oman,5106622,Asia,126240,1471
OMN,2020-51,1427,17,Oman,5106622,Asia,127667,1488
OMN,2020-52,805,7,Oman,5106622,Asia,128472,1495
OMN,2020-53,1112,7,Oman,5106622,Asia,129584,1502
OMN,2021-01,1196,6,Oman,5106622,Asia,130780,1508
OMN,2021-02,1010,4,Oman,5106622,Asia,131790,1512
OMN,2021-03,1254,9,Oman,5106622,Asia,133044,1521
OMN,2021-04,1480,11,Oman,5106622,Asia,134524,1532
OMN,2021-05,1150,2,Oman,5106622,Asia,135674,1534
OMN,2021-06,1918,9,Oman,5106622,Asia,137592,1543
OMN,2021-07,2100,12,Oman,5106622,Asia,139692,1555
OMN,2021-08,2116,22,Oman,5106622,Asia,141808,1577
OMN,2021-09,2596,17,Oman,5106622,Asia,144404,1594
OMN,2021-10,2463,14,Oman,5106622,Asia,146867,1608
OMN,2021-11,3933,14,Oman,5106622,Asia,150800,1622
OMN,2021-12,5287,39,Oman,5106622,Asia,156087,1661
OMN,2021-13,7070,51,Oman,5106622,Asia,163157,1712
OMN,2021-14,8392,64,Oman,5106622,Asia,171549,1776
OMN,2021-15,8482,102,Oman,5106622,Asia,180031,1878
OMN,2021-16,10239,105,Oman,5106622,Asia,190270,1983
OMN,2021-17,6630,70,Oman,5106622,Asia,196900,2053
OMN,2021-18,4450,67,Oman,5106622,Asia,201350,2120
OMN,2021-19,4151,73,Oman,5106622,Asia,205501,2193
OMN,2021-20,4863,72,Oman,5106622,Asia,210364,2265
OMN,2021-21,5819,69,Oman,5106622,Asia,216183,2334
OMN,2021-22,8912,90,Oman,5106622,Asia,225095,2424
OMN,2021-23,9539,89,Oman,5106622,Asia,234634,2513
OMN,2021-24,15938,228,Oman,5106622,Asia,250572,2741
OMN,2021-25,13730,272,Oman,5106622,Asia,264302,3013
OMN,2021-26,12434,303,Oman,5106622,Asia,276736,3316
OMN,2021-27,9336,119,Oman,5106622,Asia,286072,3435
OMN,2021-28,2970,63,Oman,5106622,Asia,289042,3498
OMN,2021-29,4912,255,Oman,5106622,Asia,293954,3753
OMN,2021-30,3168,115,Oman,5106622,Asia,297122,3868
OMN,2021-31,1820,80,Oman,5106622,Asia,298942,3948
OMN,2021-32,1252,45,Oman,5106622,Asia,300194,3993
PAK,2020-02,0,0,Pakistan,220892331,Asia,0,0
PAK,2020-03,0,0,Pakistan,220892331,Asia,0,0
PAK,2020-04,0,0,Pakistan,220892331,Asia,0,0
PAK,2020-05,0,0,Pakistan,220892331,Asia,0,0
PAK,2020-06,0,0,Pakistan,220892331,Asia,0,0
PAK,2020-07,0,0,Pakistan,220892331,Asia,0,0
PAK,2020-08,0,0,Pakistan,220892331,Asia,0,0
PAK,2020-09,4,0,Pakistan,220892331,Asia,4,0
PAK,2020-10,2,0,Pakistan,220892331,Asia,6,0
PAK,2020-11,25,0,Pakistan,220892331,Asia,31,0
PAK,2020-12,753,5,Pakistan,220892331,Asia,784,5
PAK,2020-13,742,8,Pakistan,220892331,Asia,1526,13
PAK,2020-14,1751,37,Pakistan,220892331,Asia,3277,50
PAK,2020-15,2097,43,Pakistan,220892331,Asia,5374,93
PAK,2020-16,3044,83,Pakistan,220892331,Asia,8418,176
PAK,2020-17,4910,105,Pakistan,220892331,Asia,13328,281
PAK,2020-18,6858,181,Pakistan,220892331,Asia,20186,462
PAK,2020-19,10755,205,Pakistan,220892331,Asia,30941,667
PAK,2020-20,11184,236,Pakistan,220892331,Asia,42125,903
PAK,2020-21,14224,264,Pakistan,220892331,Asia,56349,1167
PAK,2020-22,16111,376,Pakistan,220892331,Asia,72460,1543
PAK,2020-23,31211,524,Pakistan,220892331,Asia,103671,2067
PAK,2020-24,40807,662,Pakistan,220892331,Asia,144478,2729
PAK,2020-25,36610,861,Pakistan,220892331,Asia,181088,3590
PAK,2020-26,25424,577,Pakistan,220892331,Asia,206512,4167
PAK,2020-27,25306,595,Pakistan,220892331,Asia,231818,4762
PAK,2020-28,19807,504,Pakistan,220892331,Asia,251625,5266
PAK,2020-29,13458,333,Pakistan,220892331,Asia,265083,5599
PAK,2020-30,9206,243,Pakistan,220892331,Asia,274289,5842
PAK,2020-31,5740,142,Pakistan,220892331,Asia,280029,5984
PAK,2020-32,4631,113,Pakistan,220892331,Asia,284660,6097
PAK,2020-33,4555,78,Pakistan,220892331,Asia,289215,6175
PAK,2020-34,3550,60,Pakistan,220892331,Asia,292765,6235
PAK,2020-35,3084,59,Pakistan,220892331,Asia,295849,6294
PAK,2020-36,3054,51,Pakistan,220892331,Asia,298903,6345
PAK,2020-37,3117,38,Pakistan,220892331,Asia,302020,6383
PAK,2020-38,4284,37,Pakistan,220892331,Asia,306304,6420
PAK,2020-39,4537,46,Pakistan,220892331,Asia,310841,6466
PAK,2020-40,3775,47,Pakistan,220892331,Asia,314616,6513
PAK,2020-41,4316,57,Pakistan,220892331,Asia,318932,6570
PAK,2020-42,4520,89,Pakistan,220892331,Asia,323452,6659
PAK,2020-43,5150,80,Pakistan,220892331,Asia,328602,6739
PAK,2020-44,6491,96,Pakistan,220892331,Asia,335093,6835
PAK,2020-45,9746,142,Pakistan,220892331,Asia,344839,6977
PAK,2020-46,14193,183,Pakistan,220892331,Asia,359032,7160
PAK,2020-47,17897,536,Pakistan,220892331,Asia,376929,7696
PAK,2020-48,21095,329,Pakistan,220892331,Asia,398024,8025
PAK,2020-49,22270,373,Pakistan,220892331,Asia,420294,8398
PAK,2020-50,20493,434,Pakistan,220892331,Asia,440787,8832
PAK,2020-51,18181,560,Pakistan,220892331,Asia,458968,9392
PAK,2020-52,14341,537,Pakistan,220892331,Asia,473309,9929
PAK,2020-53,15220,421,Pakistan,220892331,Asia,488529,10350
PAK,2021-01,15764,326,Pakistan,220892331,Asia,504293,10676
PAK,2021-02,16918,321,Pakistan,220892331,Asia,521211,10997
PAK,2021-03,12830,321,Pakistan,220892331,Asia,534041,11318
PAK,2021-04,12387,365,Pakistan,220892331,Asia,546428,11683
PAK,2021-05,9083,343,Pakistan,220892331,Asia,555511,12026
PAK,2021-06,8566,307,Pakistan,220892331,Asia,564077,12333
PAK,2021-07,8257,284,Pakistan,220892331,Asia,572334,12617
PAK,2021-08,9031,279,Pakistan,220892331,Asia,581365,12896
PAK,2021-09,10735,331,Pakistan,220892331,Asia,592100,13227
PAK,2021-10,15353,310,Pakistan,220892331,Asia,607453,13537
PAK,2021-11,23018,326,Pakistan,220892331,Asia,630471,13863
PAK,2021-12,28645,393,Pakistan,220892331,Asia,659116,14256
PAK,2021-13,33115,565,Pakistan,220892331,Asia,692231,14821
PAK,2021-14,33371,680,Pakistan,220892331,Asia,725602,15501
PAK,2021-15,35835,815,Pakistan,220892331,Asia,761437,16316
PAK,2021-16,39015,871,Pakistan,220892331,Asia,800452,17187
PAK,2021-17,33694,962,Pakistan,220892331,Asia,834146,18149
PAK,2021-18,27327,844,Pakistan,220892331,Asia,861473,18993
PAK,2021-19,18889,624,Pakistan,220892331,Asia,880362,19617
PAK,2021-20,23237,691,Pakistan,220892331,Asia,903599,20308
PAK,2021-21,17454,471,Pakistan,220892331,Asia,921053,20779
PAK,2021-22,12577,544,Pakistan,220892331,Asia,933630,21323
PAK,2021-23,8559,400,Pakistan,220892331,Asia,942189,21723
PAK,2021-24,6986,284,Pakistan,220892331,Asia,949175,22007
PAK,2021-25,6482,224,Pakistan,220892331,Asia,955657,22231
PAK,2021-26,8003,196,Pakistan,220892331,Asia,963660,22427
PAK,2021-27,11432,170,Pakistan,220892331,Asia,975092,22597
PAK,2021-28,16635,214,Pakistan,220892331,Asia,991727,22811
PAK,2021-29,16719,237,Pakistan,220892331,Asia,1008446,23048
PAK,2021-30,31249,414,Pakistan,220892331,Asia,1039695,23462
PAK,2021-31,31925,456,Pakistan,220892331,Asia,1071620,23918
PAK,2021-32,30459,560,Pakistan,220892331,Asia,1102079,24478
PAN,2020-12,270,2,Panama,4314768,America,270,2
PAN,2020-13,676,21,Panama,4314768,America,946,23
PAN,2020-14,999,30,Panama,4314768,America,1945,53
PAN,2020-15,1412,33,Panama,4314768,America,3357,86
PAN,2020-16,1067,39,Panama,4314768,America,4424,125
PAN,2020-17,1312,39,Panama,4314768,America,5736,164
PAN,2020-18,1418,35,Panama,4314768,America,7154,199
PAN,2020-19,1251,44,Panama,4314768,America,8405,243
PAN,2020-20,1158,31,Panama,4314768,America,9563,274
PAN,2020-21,1320,31,Panama,4314768,America,10883,305
PAN,2020-22,2537,30,Panama,4314768,America,13420,335
PAN,2020-23,2962,57,Panama,4314768,America,16382,392
PAN,2020-24,4261,44,Panama,4314768,America,20643,436
PAN,2020-25,5344,64,Panama,4314768,America,25987,500
PAN,2020-26,5656,103,Panama,4314768,America,31643,603
PAN,2020-27,6463,143,Panama,4314768,America,38106,746
PAN,2020-28,7484,162,Panama,4314768,America,45590,908
PAN,2020-29,7835,187,Panama,4314768,America,53425,1095
PAN,2020-30,6828,198,Panama,4314768,America,60253,1293
PAN,2020-31,7157,177,Panama,4314768,America,67410,1470
PAN,2020-32,7039,168,Panama,4314768,America,74449,1638
PAN,2020-33,7448,128,Panama,4314768,America,81897,1766
PAN,2020-34,4960,125,Panama,4314768,America,86857,1891
PAN,2020-35,5165,103,Panama,4314768,America,92022,1994
PAN,2020-36,4978,91,Panama,4314768,America,97000,2085
PAN,2020-37,4702,80,Panama,4314768,America,101702,2165
PAN,2020-38,4458,91,Panama,4314768,America,106160,2256
PAN,2020-39,4352,83,Panama,4314768,America,110512,2339
PAN,2020-40,4731,83,Panama,4314768,America,115243,2422
PAN,2020-41,5027,68,Panama,4314768,America,120270,2490
PAN,2020-42,4432,73,Panama,4314768,America,124702,2563
PAN,2020-43,4455,69,Panama,4314768,America,129157,2632
PAN,2020-44,5136,73,Panama,4314768,America,134293,2705
PAN,2020-45,5191,92,Panama,4314768,America,139484,2797
PAN,2020-46,7126,75,Panama,4314768,America,146610,2872
PAN,2020-47,8130,84,Panama,4314768,America,154740,2956
PAN,2020-48,9946,103,Panama,4314768,America,164686,3059
PAN,2020-49,12990,133,Panama,4314768,America,177676,3192
PAN,2020-50,15288,163,Panama,4314768,America,192964,3355
PAN,2020-51,21031,241,Panama,4314768,America,213995,3596
PAN,2020-52,19667,295,Panama,4314768,America,233662,3891
PAN,2020-53,20031,248,Panama,4314768,America,253693,4139
PAN,2021-01,25460,315,Panama,4314768,America,279153,4454
PAN,2021-02,18823,332,Panama,4314768,America,297976,4786
PAN,2021-03,14139,311,Panama,4314768,America,312115,5097
PAN,2021-04,8221,172,Panama,4314768,America,320336,5269
PAN,2021-05,6712,210,Panama,4314768,America,327048,5479
PAN,2021-06,5588,162,Panama,4314768,America,332636,5641
PAN,2021-07,3842,100,Panama,4314768,America,336478,5741
PAN,2021-08,4394,103,Panama,4314768,America,340872,5844
PAN,2021-09,3919,78,Panama,4314768,America,344791,5922
PAN,2021-10,3321,82,Panama,4314768,America,348112,6004
PAN,2021-11,2836,39,Panama,4314768,America,350948,6043
PAN,2021-12,2848,56,Panama,4314768,America,353796,6099
PAN,2021-13,2538,35,Panama,4314768,America,356334,6134
PAN,2021-14,2415,32,Panama,4314768,America,358749,6166
PAN,2021-15,2049,21,Panama,4314768,America,360798,6187
PAN,2021-16,2126,21,Panama,4314768,America,362924,6208
PAN,2021-17,2137,29,Panama,4314768,America,365061,6237
PAN,2021-18,2552,33,Panama,4314768,America,367613,6270
PAN,2021-19,3221,25,Panama,4314768,America,370834,6295
PAN,2021-20,3244,35,Panama,4314768,America,374078,6330
PAN,2021-21,3655,39,Panama,4314768,America,377733,6369
PAN,2021-22,4699,32,Panama,4314768,America,382432,6401
PAN,2021-23,5367,42,Panama,4314768,America,387799,6443
PAN,2021-24,5885,31,Panama,4314768,America,393684,6474
PAN,2021-25,6939,49,Panama,4314768,America,400623,6523
PAN,2021-26,7457,50,Panama,4314768,America,408080,6573
PAN,2021-27,8109,72,Panama,4314768,America,416189,6645
PAN,2021-28,6446,57,Panama,4314768,America,422635,6702
PAN,2021-29,7271,56,Panama,4314768,America,429906,6758
PAN,2021-30,6526,74,Panama,4314768,America,436432,6832
PAN,2021-31,5820,73,Panama,4314768,America,442252,6905
PAN,2021-32,5529,45,Panama,4314768,America,447781,6950
PER,2020-11,64,0,Peru,32971846,America,64,0
PER,2020-12,292,39,Peru,32971846,America,356,39
PER,2020-13,489,74,Peru,32971846,America,845,113
PER,2020-14,1429,247,Peru,32971846,America,2274,360
PER,2020-15,5238,592,Peru,32971846,America,7512,952
PER,2020-16,8109,1038,Peru,32971846,America,15621,1990
PER,2020-17,11889,1803,Peru,32971846,America,27510,3793
PER,2020-18,18411,2649,Peru,32971846,America,45921,6442
PER,2020-19,21379,3335,Peru,32971846,America,67300,9777
PER,2020-20,24966,3591,Peru,32971846,America,92266,13368
PER,2020-21,27686,3847,Peru,32971846,America,119952,17215
PER,2020-22,44517,4068,Peru,32971846,America,164469,21283
PER,2020-23,32039,4138,Peru,32971846,America,196508,25421
PER,2020-24,33221,4224,Peru,32971846,America,229729,29645
PER,2020-25,25200,4126,Peru,32971846,America,254929,33771
PER,2020-26,24483,3743,Peru,32971846,America,279412,37514
PER,2020-27,23299,3798,Peru,32971846,America,302711,41312
PER,2020-28,23608,3950,Peru,32971846,America,326319,45262
PER,2020-29,27264,4176,Peru,32971846,America,353583,49438
PER,2020-30,31207,4289,Peru,32971846,America,384790,53727
PER,2020-31,44053,4351,Peru,32971846,America,428843,58078
PER,2020-32,49174,4461,Peru,32971846,America,478017,62539
PER,2020-33,57922,4289,Peru,32971846,America,535939,66828
PER,2020-34,58380,3773,Peru,32971846,America,594319,70601
PER,2020-35,52840,3276,Peru,32971846,America,647159,73877
PER,2020-36,42811,2647,Peru,32971846,America,689970,76524
PER,2020-37,39642,2145,Peru,32971846,America,729612,78669
PER,2020-38,39276,1856,Peru,32971846,America,768888,80525
PER,2020-39,36407,1520,Peru,32971846,America,805295,82045
PER,2020-40,22867,1235,Peru,32971846,America,828162,83280
PER,2020-41,21202,1122,Peru,32971846,America,849364,84402
PER,2020-42,19304,962,Peru,32971846,America,868668,85364
PER,2020-43,20040,833,Peru,32971846,America,888708,86197
PER,2020-44,16196,800,Peru,32971846,America,904904,86997
PER,2020-45,17422,729,Peru,32971846,America,922326,87726
PER,2020-46,14678,700,Peru,32971846,America,937004,88426
PER,2020-47,12659,666,Peru,32971846,America,949663,89092
PER,2020-48,12860,660,Peru,32971846,America,962523,89752
PER,2020-49,11382,705,Peru,32971846,America,973905,90457
PER,2020-50,11061,751,Peru,32971846,America,984966,91208
PER,2020-51,13502,836,Peru,32971846,America,998468,92044
PER,2020-52,10433,895,Peru,32971846,America,1008901,92939
PER,2020-53,12150,1121,Peru,32971846,America,1021051,94060
PER,2021-01,16292,1487,Peru,32971846,America,1037343,95547
PER,2021-02,31452,2097,Peru,32971846,America,1068795,97644
PER,2021-03,30211,3065,Peru,32971846,America,1099006,100709
PER,2021-04,43703,3900,Peru,32971846,America,1142709,104609
PER,2021-05,43982,4250,Peru,32971846,America,1186691,108859
PER,2021-06,51803,4800,Peru,32971846,America,1238494,113659
PER,2021-07,48256,4926,Peru,32971846,America,1286750,118585
PER,2021-08,46182,4748,Peru,32971846,America,1332932,123333
PER,2021-09,41528,4686,Peru,32971846,America,1374460,128019
PER,2021-10,44507,4551,Peru,32971846,America,1418967,132570
PER,2021-11,53816,4664,Peru,32971846,America,1472783,137234
PER,2021-12,60331,4989,Peru,32971846,America,1533114,142223
PER,2021-13,57088,5195,Peru,32971846,America,1590202,147418
PER,2021-14,63111,5550,Peru,32971846,America,1653313,152968
PER,2021-15,54467,5616,Peru,32971846,America,1707780,158584
PER,2021-16,60399,5648,Peru,32971846,America,1768179,164232
PER,2021-17,45941,5162,Peru,32971846,America,1814120,169394
PER,2021-18,39243,4646,Peru,32971846,America,1853363,174040
PER,2021-19,35682,4009,Peru,32971846,America,1889045,178049
PER,2021-20,37871,3390,Peru,32971846,America,1926916,181439
PER,2021-21,28546,3010,Peru,32971846,America,1955462,184449
PER,2021-22,29530,2308,Peru,32971846,America,1984992,186757
PER,2021-23,19253,2164,Peru,32971846,America,2004245,188921
PER,2021-24,25373,1504,Peru,32971846,America,2029618,190425
PER,2021-25,19942,1738,Peru,32971846,America,2049560,192163
PER,2021-26,17110,1226,Peru,32971846,America,2066670,193389
PER,2021-27,14880,1099,Peru,32971846,America,2081550,194488
PER,2021-28,12888,755,Peru,32971846,America,2094438,195243
PER,2021-29,10560,730,Peru,32971846,America,2104998,195973
PER,2021-30,9440,545,Peru,32971846,America,2114438,196518
PER,2021-31,11403,511,Peru,32971846,America,2125841,197029
PER,2021-32,8517,458,Peru,32971846,America,2134358,197487
PHL,2020-02,0,0,Philippines,109581085,Asia,0,0
PHL,2020-03,0,0,Philippines,109581085,Asia,0,0
PHL,2020-04,0,0,Philippines,109581085,Asia,0,0
PHL,2020-05,2,1,Philippines,109581085,Asia,2,1
PHL,2020-06,1,0,Philippines,109581085,Asia,3,1
PHL,2020-07,0,0,Philippines,109581085,Asia,3,1
PHL,2020-08,0,0,Philippines,109581085,Asia,3,1
PHL,2020-09,0,0,Philippines,109581085,Asia,3,1
PHL,2020-10,7,0,Philippines,109581085,Asia,10,1
PHL,2020-11,130,11,Philippines,109581085,Asia,140,12
PHL,2020-12,240,13,Philippines,109581085,Asia,380,25
PHL,2020-13,1038,46,Philippines,109581085,Asia,1418,71
PHL,2020-14,1828,81,Philippines,109581085,Asia,3246,152
PHL,2020-15,1402,145,Philippines,109581085,Asia,4648,297
PHL,2020-16,1611,112,Philippines,109581085,Asia,6259,409
PHL,2020-17,1320,92,Philippines,109581085,Asia,7579,501
PHL,2020-18,1644,106,Philippines,109581085,Asia,9223,607
PHL,2020-19,1571,112,Philippines,109581085,Asia,10794,719
PHL,2020-20,1719,105,Philippines,109581085,Asia,12513,824
PHL,2020-21,1522,44,Philippines,109581085,Asia,14035,868
PHL,2020-22,4051,89,Philippines,109581085,Asia,18086,957
PHL,2020-23,3809,46,Philippines,109581085,Asia,21895,1003
PHL,2020-24,4035,85,Philippines,109581085,Asia,25930,1088
PHL,2020-25,4122,81,Philippines,109581085,Asia,30052,1169
PHL,2020-26,5403,75,Philippines,109581085,Asia,35455,1244
PHL,2020-27,6375,46,Philippines,109581085,Asia,41830,1290
PHL,2020-28,14429,244,Philippines,109581085,Asia,56259,1534
PHL,2020-29,11197,297,Philippines,109581085,Asia,67456,1831
PHL,2020-30,12992,101,Philippines,109581085,Asia,80448,1932
PHL,2020-31,22737,127,Philippines,109581085,Asia,103185,2059
PHL,2020-32,26728,211,Philippines,109581085,Asia,129913,2270
PHL,2020-33,31340,395,Philippines,109581085,Asia,161253,2665
PHL,2020-34,28348,333,Philippines,109581085,Asia,189601,2998
PHL,2020-35,27795,522,Philippines,109581085,Asia,217396,3520
PHL,2020-36,19969,355,Philippines,109581085,Asia,237365,3875
PHL,2020-37,23851,496,Philippines,109581085,Asia,261216,4371
PHL,2020-38,25527,613,Philippines,109581085,Asia,286743,4984
PHL,2020-39,17483,360,Philippines,109581085,Asia,304226,5344
PHL,2020-40,18271,432,Philippines,109581085,Asia,322497,5776
PHL,2020-41,16844,545,Philippines,109581085,Asia,339341,6321
PHL,2020-42,17277,331,Philippines,109581085,Asia,356618,6652
PHL,2020-43,13410,325,Philippines,109581085,Asia,370028,6977
PHL,2020-44,13085,261,Philippines,109581085,Asia,383113,7238
PHL,2020-45,13282,301,Philippines,109581085,Asia,396395,7539
PHL,2020-46,11443,293,Philippines,109581085,Asia,407838,7832
PHL,2020-47,10980,291,Philippines,109581085,Asia,418818,8123
PHL,2020-48,11046,250,Philippines,109581085,Asia,429864,8373
PHL,2020-49,9970,181,Philippines,109581085,Asia,439834,8554
PHL,2020-50,9566,179,Philippines,109581085,Asia,449400,8733
PHL,2020-51,10389,214,Philippines,109581085,Asia,459789,8947
PHL,2020-52,10097,162,Philippines,109581085,Asia,469886,9109
PHL,2020-53,7921,148,Philippines,109581085,Asia,477807,9257
PHL,2021-01,9883,148,Philippines,109581085,Asia,487690,9405
PHL,2021-02,12887,490,Philippines,109581085,Asia,500577,9895
PHL,2021-03,13042,347,Philippines,109581085,Asia,513619,10242
PHL,2021-04,11999,507,Philippines,109581085,Asia,525618,10749
PHL,2021-05,11692,430,Philippines,109581085,Asia,537310,11179
PHL,2021-06,11866,336,Philippines,109581085,Asia,549176,11515
PHL,2021-07,11993,573,Philippines,109581085,Asia,561169,12088
PHL,2021-08,15183,230,Philippines,109581085,Asia,576352,12318
PHL,2021-09,18060,198,Philippines,109581085,Asia,594412,12516
PHL,2021-10,27086,313,Philippines,109581085,Asia,621498,12829
PHL,2021-11,42296,139,Philippines,109581085,Asia,663794,12968
PHL,2021-12,58098,202,Philippines,109581085,Asia,721892,13170
PHL,2021-13,73159,255,Philippines,109581085,Asia,795051,13425
PHL,2021-14,69817,1520,Philippines,109581085,Asia,864868,14945
PHL,2021-15,71265,1015,Philippines,109581085,Asia,936133,15960
PHL,2021-16,61390,823,Philippines,109581085,Asia,997523,16783
PHL,2021-17,57460,648,Philippines,109581085,Asia,1054983,17431
PHL,2021-18,47007,1041,Philippines,109581085,Asia,1101990,18472
PHL,2021-19,41973,719,Philippines,109581085,Asia,1143963,19191
PHL,2021-20,35849,760,Philippines,109581085,Asia,1179812,19951
PHL,2021-21,43815,909,Philippines,109581085,Asia,1223627,20860
PHL,2021-22,45851,1038,Philippines,109581085,Asia,1269478,21898
PHL,2021-23,46161,890,Philippines,109581085,Asia,1315639,22788
PHL,2021-24,43376,833,Philippines,109581085,Asia,1359015,23621
PHL,2021-25,38977,751,Philippines,109581085,Asia,1397992,24372
PHL,2021-26,38377,777,Philippines,109581085,Asia,1436369,25149
PHL,2021-27,36656,772,Philippines,109581085,Asia,1473025,25921
PHL,2021-28,34730,793,Philippines,109581085,Asia,1507755,26714
PHL,2021-29,41000,530,Philippines,109581085,Asia,1548755,27244
PHL,2021-30,48934,772,Philippines,109581085,Asia,1597689,28016
PHL,2021-31,61227,1106,Philippines,109581085,Asia,1658916,29122
PHL,2021-32,82700,1218,Philippines,109581085,Asia,1741616,30340
PNG,2020-13,0,0,Papua New Guinea,8947027,Oceania,0,0
PNG,2020-14,0,0,Papua New Guinea,8947027,Oceania,0,0
PNG,2020-15,1,0,Papua New Guinea,8947027,Oceania,1,0
PNG,2020-16,5,0,Papua New Guinea,8947027,Oceania,6,0
PNG,2020-17,1,0,Papua New Guinea,8947027,Oceania,7,0
PNG,2020-18,0,0,Papua New Guinea,8947027,Oceania,7,0
PNG,2020-19,0,0,Papua New Guinea,8947027,Oceania,7,0
PNG,2020-20,0,0,Papua New Guinea,8947027,Oceania,7,0
PNG,2020-21,0,0,Papua New Guinea,8947027,Oceania,7,0
PNG,2020-22,0,0,Papua New Guinea,8947027,Oceania,7,0
PNG,2020-23,0,0,Papua New Guinea,8947027,Oceania,7,0
PNG,2020-24,0,0,Papua New Guinea,8947027,Oceania,7,0
PNG,2020-25,1,0,Papua New Guinea,8947027,Oceania,8,0
PNG,2020-26,2,0,Papua New Guinea,8947027,Oceania,10,0
PNG,2020-27,0,0,Papua New Guinea,8947027,Oceania,10,0
PNG,2020-28,0,0,Papua New Guinea,8947027,Oceania,10,0
PNG,2020-29,6,0,Papua New Guinea,8947027,Oceania,16,0
PNG,2020-30,45,0,Papua New Guinea,8947027,Oceania,61,0
PNG,2020-31,48,2,Papua New Guinea,8947027,Oceania,109,2
PNG,2020-32,104,1,Papua New Guinea,8947027,Oceania,213,3
PNG,2020-33,109,0,Papua New Guinea,8947027,Oceania,322,3
PNG,2020-34,78,1,Papua New Guinea,8947027,Oceania,400,4
PNG,2020-35,58,1,Papua New Guinea,8947027,Oceania,458,5
PNG,2020-36,38,0,Papua New Guinea,8947027,Oceania,496,5
PNG,2020-37,14,1,Papua New Guinea,8947027,Oceania,510,6
PNG,2020-38,6,1,Papua New Guinea,8947027,Oceania,516,7
PNG,2020-39,15,0,Papua New Guinea,8947027,Oceania,531,7
PNG,2020-40,8,0,Papua New Guinea,8947027,Oceania,539,7
PNG,2020-41,14,0,Papua New Guinea,8947027,Oceania,553,7
PNG,2020-42,27,0,Papua New Guinea,8947027,Oceania,580,7
PNG,2020-43,7,0,Papua New Guinea,8947027,Oceania,587,7
PNG,2020-44,2,0,Papua New Guinea,8947027,Oceania,589,7
PNG,2020-45,7,0,Papua New Guinea,8947027,Oceania,596,7
PNG,2020-46,3,0,Papua New Guinea,8947027,Oceania,599,7
PNG,2020-47,4,0,Papua New Guinea,8947027,Oceania,603,7
PNG,2020-48,51,0,Papua New Guinea,8947027,Oceania,654,7
PNG,2020-49,16,0,Papua New Guinea,8947027,Oceania,670,7
PNG,2020-50,54,1,Papua New Guinea,8947027,Oceania,724,8
PNG,2020-51,36,1,Papua New Guinea,8947027,Oceania,760,9
PNG,2020-52,19,0,Papua New Guinea,8947027,Oceania,779,9
PNG,2020-53,19,0,Papua New Guinea,8947027,Oceania,798,9
PNG,2021-01,12,0,Papua New Guinea,8947027,Oceania,810,9
PNG,2021-02,23,0,Papua New Guinea,8947027,Oceania,833,9
PNG,2021-03,15,0,Papua New Guinea,8947027,Oceania,848,9
PNG,2021-04,18,0,Papua New Guinea,8947027,Oceania,866,9
PNG,2021-05,27,0,Papua New Guinea,8947027,Oceania,893,9
PNG,2021-06,61,1,Papua New Guinea,8947027,Oceania,954,10
PNG,2021-07,15,0,Papua New Guinea,8947027,Oceania,969,10
PNG,2021-08,305,2,Papua New Guinea,8947027,Oceania,1274,12
PNG,2021-09,395,4,Papua New Guinea,8947027,Oceania,1669,16
PNG,2021-10,149,5,Papua New Guinea,8947027,Oceania,1818,21
PNG,2021-11,1755,15,Papua New Guinea,8947027,Oceania,3573,36
PNG,2021-12,1610,9,Papua New Guinea,8947027,Oceania,5183,45
PNG,2021-13,1673,16,Papua New Guinea,8947027,Oceania,6856,61
PNG,2021-14,1745,8,Papua New Guinea,8947027,Oceania,8601,69
PNG,2021-15,1197,21,Papua New Guinea,8947027,Oceania,9798,90
PNG,2021-16,871,12,Papua New Guinea,8947027,Oceania,10669,102
PNG,2021-17,536,13,Papua New Guinea,8947027,Oceania,11205,115
PNG,2021-18,1020,6,Papua New Guinea,8947027,Oceania,12225,121
PNG,2021-19,1702,15,Papua New Guinea,8947027,Oceania,13927,136
PNG,2021-20,1205,18,Papua New Guinea,8947027,Oceania,15132,154
PNG,2021-21,715,8,Papua New Guinea,8947027,Oceania,15847,162
PNG,2021-22,479,2,Papua New Guinea,8947027,Oceania,16326,164
PNG,2021-23,355,1,Papua New Guinea,8947027,Oceania,16681,165
PNG,2021-24,331,8,Papua New Guinea,8947027,Oceania,17012,173
PNG,2021-25,85,0,Papua New Guinea,8947027,Oceania,17097,173
PNG,2021-26,0,0,Papua New Guinea,8947027,Oceania,17097,173
PNG,2021-27,269,6,Papua New Guinea,8947027,Oceania,17366,179
PNG,2021-28,97,8,Papua New Guinea,8947027,Oceania,17463,187
PNG,2021-29,60,5,Papua New Guinea,8947027,Oceania,17523,192
PNG,2021-30,250,0,Papua New Guinea,8947027,Oceania,17773,192
PNG,2021-31,30,0,Papua New Guinea,8947027,Oceania,17803,192
PNG,2021-32,8,0,Papua New Guinea,8947027,Oceania,17811,192
POL,2020-11,114,3,Poland,37958138,Europe,114,3
POL,2020-12,509,4,Poland,37958138,Europe,623,7
POL,2020-13,1228,15,Poland,37958138,Europe,1851,22
POL,2020-14,2240,72,Poland,37958138,Europe,4091,94
POL,2020-15,2572,138,Poland,37958138,Europe,6663,232
POL,2020-16,2613,128,Poland,37958138,Europe,9276,360
POL,2020-17,2330,175,Poland,37958138,Europe,11606,535
POL,2020-18,2076,143,Poland,37958138,Europe,13682,678
POL,2020-19,2303,122,Poland,37958138,Europe,15985,800
POL,2020-20,2533,125,Poland,37958138,Europe,18518,925
POL,2020-21,2797,71,Poland,37958138,Europe,21315,996
POL,2020-22,2460,68,Poland,37958138,Europe,23775,1064
POL,2020-23,2775,93,Poland,37958138,Europe,26550,1157
POL,2020-24,2831,90,Poland,37958138,Europe,29381,1247
POL,2020-25,2539,109,Poland,37958138,Europe,31920,1356
POL,2020-26,1976,82,Poland,37958138,Europe,33896,1438
POL,2020-27,2043,79,Poland,37958138,Europe,35939,1517
POL,2020-28,1941,54,Poland,37958138,Europe,37880,1571
POL,2020-29,2213,53,Poland,37958138,Europe,40093,1624
POL,2020-30,2961,47,Poland,37958138,Europe,43054,1671
POL,2020-31,3829,60,Poland,37958138,Europe,46883,1731
POL,2020-32,4897,76,Poland,37958138,Europe,51780,1807
POL,2020-33,4893,70,Poland,37958138,Europe,56673,1877
POL,2020-34,5078,78,Poland,37958138,Europe,61751,1955
POL,2020-35,5108,78,Poland,37958138,Europe,66859,2033
POL,2020-36,3954,87,Poland,37958138,Europe,70813,2120
POL,2020-37,3328,68,Poland,37958138,Europe,74141,2188
POL,2020-38,5088,105,Poland,37958138,Europe,79229,2293
POL,2020-39,8090,139,Poland,37958138,Europe,87319,2432
POL,2020-40,10810,172,Poland,37958138,Europe,98129,2604
POL,2020-41,27676,400,Poland,37958138,Europe,125805,3004
POL,2020-42,49950,569,Poland,37958138,Europe,175755,3573
POL,2020-43,77922,865,Poland,37958138,Europe,253677,4438
POL,2020-44,126214,1345,Poland,37958138,Europe,379891,5783
POL,2020-45,166523,2089,Poland,37958138,Europe,546414,7872
POL,2020-46,166547,2476,Poland,37958138,Europe,712961,10348
POL,2020-47,148359,3270,Poland,37958138,Europe,861320,13618
POL,2020-48,123744,3411,Poland,37958138,Europe,985064,17029
POL,2020-49,78374,3060,Poland,37958138,Europe,1063438,20089
POL,2020-50,72227,2775,Poland,37958138,Europe,1135665,22864
POL,2020-51,67024,2533,Poland,37958138,Europe,1202689,25397
POL,2020-52,58310,1750,Poland,37958138,Europe,1260999,27147
POL,2020-53,61937,2014,Poland,37958138,Europe,1322936,29161
POL,2021-01,67438,2103,Poland,37958138,Europe,1390374,31264
POL,2021-02,48529,2143,Poland,37958138,Europe,1438903,33407
POL,2021-03,39205,1994,Poland,37958138,Europe,1478108,35401
POL,2021-04,35266,1779,Poland,37958138,Europe,1513374,37180
POL,2021-05,39301,1952,Poland,37958138,Europe,1552675,39132
POL,2021-06,38811,1700,Poland,37958138,Europe,1591486,40832
POL,2021-07,47270,1339,Poland,37958138,Europe,1638756,42171
POL,2021-08,73005,1622,Poland,37958138,Europe,1711761,43793
POL,2021-09,89311,1524,Poland,37958138,Europe,1801072,45317
POL,2021-10,116444,1889,Poland,37958138,Europe,1917516,47206
POL,2021-11,155602,2159,Poland,37958138,Europe,2073118,49365
POL,2021-12,194835,2567,Poland,37958138,Europe,2267953,51932
POL,2021-13,180499,3073,Poland,37958138,Europe,2448452,55005
POL,2021-14,138184,3476,Poland,37958138,Europe,2586636,58481
POL,2021-15,108680,3652,Poland,37958138,Europe,2695316,62133
POL,2021-16,66996,3304,Poland,37958138,Europe,2762312,65437
POL,2021-17,43433,2668,Poland,37958138,Europe,2805745,68105
POL,2021-18,29327,1929,Poland,37958138,Europe,2835072,70034
POL,2021-19,20107,1641,Poland,37958138,Europe,2855179,71675
POL,2021-20,10991,1270,Poland,37958138,Europe,2866170,72945
POL,2021-21,6102,800,Poland,37958138,Europe,2872272,73745
POL,2021-22,3045,415,Poland,37958138,Europe,2875317,74160
POL,2021-23,2280,414,Poland,37958138,Europe,2877597,74574
POL,2021-24,1232,255,Poland,37958138,Europe,2878829,74829
POL,2021-25,849,150,Poland,37958138,Europe,2879678,74979
POL,2021-26,619,106,Poland,37958138,Europe,2880297,75085
POL,2021-27,557,75,Poland,37958138,Europe,2880854,75160
POL,2021-28,626,55,Poland,37958138,Europe,2881480,75215
POL,2021-29,729,27,Poland,37958138,Europe,2882209,75242
POL,2021-30,900,19,Poland,37958138,Europe,2883109,75261
POL,2021-31,1042,24,Poland,37958138,Europe,2884151,75285
POL,2021-32,1299,14,Poland,37958138,Europe,2885450,75299
PRI,2020-14,301,17,Puerto Rico,2860840,America,301,17
PRI,2020-15,141,25,Puerto Rico,2860840,America,442,42
PRI,2020-16,135,19,Puerto Rico,2860840,America,577,61
PRI,2020-17,103,20,Puerto Rico,2860840,America,680,81
PRI,2020-18,84,15,Puerto Rico,2860840,America,764,96
PRI,2020-19,106,7,Puerto Rico,2860840,America,870,103
PRI,2020-20,58,5,Puerto Rico,2860840,America,928,108
PRI,2020-21,48,7,Puerto Rico,2860840,America,976,115
PRI,2020-22,92,9,Puerto Rico,2860840,America,1068,124
PRI,2020-23,66,6,Puerto Rico,2860840,America,1134,130
PRI,2020-24,91,2,Puerto Rico,2860840,America,1225,132
PRI,2020-25,103,2,Puerto Rico,2860840,America,1328,134
PRI,2020-26,272,3,Puerto Rico,2860840,America,1600,137
PRI,2020-27,657,7,Puerto Rico,2860840,America,2257,144
PRI,2020-28,1659,18,Puerto Rico,2860840,America,3916,162
PRI,2020-29,1896,15,Puerto Rico,2860840,America,5812,177
PRI,2020-30,1624,32,Puerto Rico,2860840,America,7436,209
PRI,2020-31,1584,52,Puerto Rico,2860840,America,9020,261
PRI,2020-32,2314,50,Puerto Rico,2860840,America,11334,311
PRI,2020-33,2269,67,Puerto Rico,2860840,America,13603,378
PRI,2020-34,1709,42,Puerto Rico,2860840,America,15312,420
PRI,2020-35,1240,32,Puerto Rico,2860840,America,16552,452
PRI,2020-36,1345,58,Puerto Rico,2860840,America,17897,510
PRI,2020-37,2674,77,Puerto Rico,2860840,America,20571,587
PRI,2020-38,2598,39,Puerto Rico,2860840,America,23169,626
PRI,2020-39,1756,47,Puerto Rico,2860840,America,24925,673
PRI,2020-40,1829,42,Puerto Rico,2860840,America,26754,715
PRI,2020-41,2219,47,Puerto Rico,2860840,America,28973,762
PRI,2020-42,2629,34,Puerto Rico,2860840,America,31602,796
PRI,2020-43,3068,32,Puerto Rico,2860840,America,34670,828
PRI,2020-44,3718,31,Puerto Rico,2860840,America,38388,859
PRI,2020-45,4454,66,Puerto Rico,2860840,America,42842,925
PRI,2020-46,2292,73,Puerto Rico,2860840,America,45134,998
PRI,2020-47,2639,71,Puerto Rico,2860840,America,47773,1069
PRI,2020-48,4345,87,Puerto Rico,2860840,America,52118,1156
PRI,2020-49,5077,72,Puerto Rico,2860840,America,57195,1228
PRI,2020-50,5363,33,Puerto Rico,2860840,America,62558,1261
PRI,2020-51,5864,100,Puerto Rico,2860840,America,68422,1361
PRI,2020-52,4809,74,Puerto Rico,2860840,America,73231,1435
PRI,2020-53,5147,99,Puerto Rico,2860840,America,78378,1534
PRI,2021-01,4663,87,Puerto Rico,2860840,America,83041,1621
PRI,2021-02,4471,61,Puerto Rico,2860840,America,87512,1682
PRI,2021-03,3657,75,Puerto Rico,2860840,America,91169,1757
PRI,2021-04,2642,58,Puerto Rico,2860840,America,93811,1815
PRI,2021-05,1923,52,Puerto Rico,2860840,America,95734,1867
PRI,2021-06,1676,32,Puerto Rico,2860840,America,97410,1899
PRI,2021-07,1420,63,Puerto Rico,2860840,America,98830,1962
PRI,2021-08,1327,54,Puerto Rico,2860840,America,100157,2016
PRI,2021-09,1233,28,Puerto Rico,2860840,America,101390,2044
PRI,2021-10,1178,15,Puerto Rico,2860840,America,102568,2059
PRI,2021-11,1521,16,Puerto Rico,2860840,America,104089,2075
PRI,2021-12,1972,16,Puerto Rico,2860840,America,106061,2091
PRI,2021-13,3395,19,Puerto Rico,2860840,America,109456,2110
PRI,2021-14,5416,24,Puerto Rico,2860840,America,114872,2134
PRI,2021-15,7750,52,Puerto Rico,2860840,America,122622,2186
PRI,2021-16,6154,58,Puerto Rico,2860840,America,128776,2244
PRI,2021-17,3844,50,Puerto Rico,2860840,America,132620,2294
PRI,2021-18,2496,59,Puerto Rico,2860840,America,135116,2353
PRI,2021-19,1420,64,Puerto Rico,2860840,America,136536,2417
PRI,2021-20,1037,36,Puerto Rico,2860840,America,137573,2453
PRI,2021-21,690,28,Puerto Rico,2860840,America,138263,2481
PRI,2021-22,378,17,Puerto Rico,2860840,America,138641,2498
PRI,2021-23,355,11,Puerto Rico,2860840,America,138996,2509
PRI,2021-24,330,10,Puerto Rico,2860840,America,139326,2519
PRI,2021-25,268,7,Puerto Rico,2860840,America,139594,2526
PRI,2021-26,385,5,Puerto Rico,2860840,America,139979,2531
PRI,2021-27,538,3,Puerto Rico,2860840,America,140517,2534
PRI,2021-28,961,6,Puerto Rico,2860840,America,141478,2540
PRI,2021-29,2416,8,Puerto Rico,2860840,America,143894,2548
PRI,2021-30,3499,16,Puerto Rico,2860840,America,147393,2564
PRI,2021-31,5019,35,Puerto Rico,2860840,America,152412,2599
PRI,2021-32,6348,58,Puerto Rico,2860840,America,158760,2657
PRT,2020-11,215,0,Portugal,10295909,Europe,215,0
PRT,2020-12,1355,14,Portugal,10295909,Europe,1570,14
PRT,2020-13,4362,105,Portugal,10295909,Europe,5932,119
PRT,2020-14,5316,176,Portugal,10295909,Europe,11248,295
PRT,2020-15,5307,209,Portugal,10295909,Europe,16555,504
PRT,2020-16,3621,210,Portugal,10295909,Europe,20176,714
PRT,2020-17,3640,214,Portugal,10295909,Europe,23816,928
PRT,2020-18,1678,135,Portugal,10295909,Europe,25494,1063
PRT,2020-19,2057,72,Portugal,10295909,Europe,27551,1135
PRT,2020-20,1455,83,Portugal,10295909,Europe,29006,1218
PRT,2020-21,1587,98,Portugal,10295909,Europe,30593,1316
PRT,2020-22,1877,94,Portugal,10295909,Europe,32470,1410
PRT,2020-23,1993,69,Portugal,10295909,Europe,34463,1479
PRT,2020-24,2197,38,Portugal,10295909,Europe,36660,1517
PRT,2020-25,2443,13,Portugal,10295909,Europe,39103,1530
PRT,2020-26,2513,34,Portugal,10295909,Europe,41616,1564
PRT,2020-27,2251,50,Portugal,10295909,Europe,43867,1614
PRT,2020-28,2615,46,Portugal,10295909,Europe,46482,1660
PRT,2020-29,2124,29,Portugal,10295909,Europe,48606,1689
PRT,2020-30,1528,28,Portugal,10295909,Europe,50134,1717
PRT,2020-31,1299,21,Portugal,10295909,Europe,51433,1738
PRT,2020-32,1205,18,Portugal,10295909,Europe,52638,1756
PRT,2020-33,1434,22,Portugal,10295909,Europe,54072,1778
PRT,2020-34,1495,18,Portugal,10295909,Europe,55567,1796
PRT,2020-35,2171,23,Portugal,10295909,Europe,57738,1819
PRT,2020-36,2490,21,Portugal,10295909,Europe,60228,1840
PRT,2020-37,3725,27,Portugal,10295909,Europe,63953,1867
PRT,2020-38,4594,45,Portugal,10295909,Europe,68547,1912
PRT,2020-39,5027,41,Portugal,10295909,Europe,73574,1953
PRT,2020-40,4643,42,Portugal,10295909,Europe,78217,1995
PRT,2020-41,8417,85,Portugal,10295909,Europe,86634,2080
PRT,2020-42,13247,101,Portugal,10295909,Europe,99881,2181
PRT,2020-43,18775,135,Portugal,10295909,Europe,118656,2316
PRT,2020-44,25655,228,Portugal,10295909,Europe,144311,2544
PRT,2020-45,34983,352,Portugal,10295909,Europe,179294,2896
PRT,2020-46,37977,485,Portugal,10295909,Europe,217271,3381
PRT,2020-47,43457,516,Portugal,10295909,Europe,260728,3897
PRT,2020-48,34041,530,Portugal,10295909,Europe,294769,4427
PRT,2020-49,27675,536,Portugal,10295909,Europe,322444,4963
PRT,2020-50,26270,596,Portugal,10295909,Europe,348714,5559
PRT,2020-51,25377,575,Portugal,10295909,Europe,374091,6134
PRT,2020-52,22545,543,Portugal,10295909,Europe,396636,6677
PRT,2020-53,34957,519,Portugal,10295909,Europe,431593,7196
PRT,2021-01,57670,729,Portugal,10295909,Europe,489263,7925
PRT,2021-02,67210,1103,Portugal,10295909,Europe,556473,9028
PRT,2021-03,86610,1693,Portugal,10295909,Europe,643083,10721
PRT,2021-04,83208,2036,Portugal,10295909,Europe,726291,12757
PRT,2021-05,41598,1597,Portugal,10295909,Europe,767889,14354
PRT,2021-06,19140,1057,Portugal,10295909,Europe,787029,15411
PRT,2021-07,10466,551,Portugal,10295909,Europe,797495,15962
PRT,2021-08,7431,389,Portugal,10295909,Europe,804926,16351
PRT,2021-09,5503,214,Portugal,10295909,Europe,810429,16565
PRT,2021-10,4054,129,Portugal,10295909,Europe,814483,16694
PRT,2021-11,3265,90,Portugal,10295909,Europe,817748,16784
PRT,2021-12,2938,59,Portugal,10295909,Europe,820686,16843
PRT,2021-13,2778,42,Portugal,10295909,Europe,823464,16885
PRT,2021-14,4271,33,Portugal,10295909,Europe,827735,16918
PRT,2021-15,3456,28,Portugal,10295909,Europe,831191,16946
PRT,2021-16,3417,19,Portugal,10295909,Europe,834608,16965
PRT,2021-17,2819,12,Portugal,10295909,Europe,837427,16977
PRT,2021-18,2283,16,Portugal,10295909,Europe,839710,16993
PRT,2021-19,2641,16,Portugal,10295909,Europe,842351,17009
PRT,2021-20,3084,9,Portugal,10295909,Europe,845435,17018
PRT,2021-21,3628,7,Portugal,10295909,Europe,849063,17025
PRT,2021-22,3941,11,Portugal,10295909,Europe,853004,17036
PRT,2021-23,5038,11,Portugal,10295909,Europe,858042,17047
PRT,2021-24,7734,21,Portugal,10295909,Europe,865776,17068
PRT,2021-25,9643,18,Portugal,10295909,Europe,875419,17086
PRT,2021-26,15122,31,Portugal,10295909,Europe,890541,17117
PRT,2021-27,19185,47,Portugal,10295909,Europe,909726,17164
PRT,2021-28,22784,51,Portugal,10295909,Europe,932510,17215
PRT,2021-29,22129,86,Portugal,10295909,Europe,954639,17301
PRT,2021-30,17458,77,Portugal,10295909,Europe,972097,17378
PRT,2021-31,15934,107,Portugal,10295909,Europe,988031,17485
PRT,2021-32,16409,88,Portugal,10295909,Europe,1004440,17573
PRY,2020-12,14,1,Paraguay,7132530,America,14,1
PRY,2020-13,42,2,Paraguay,7132530,America,56,3
PRY,2020-14,49,2,Paraguay,7132530,America,105,5
PRY,2020-15,34,1,Paraguay,7132530,America,139,6
PRY,2020-16,59,2,Paraguay,7132530,America,198,8
PRY,2020-17,22,1,Paraguay,7132530,America,220,9
PRY,2020-18,168,1,Paraguay,7132530,America,388,10
PRY,2020-19,317,0,Paraguay,7132530,America,705,10
PRY,2020-20,73,1,Paraguay,7132530,America,778,11
PRY,2020-21,76,0,Paraguay,7132530,America,854,11
PRY,2020-22,124,0,Paraguay,7132530,America,978,11
PRY,2020-23,149,0,Paraguay,7132530,America,1127,11
PRY,2020-24,154,0,Paraguay,7132530,America,1281,11
PRY,2020-25,90,2,Paraguay,7132530,America,1371,13
PRY,2020-26,748,2,Paraguay,7132530,America,2119,15
PRY,2020-27,300,5,Paraguay,7132530,America,2419,20
PRY,2020-28,521,2,Paraguay,7132530,America,2940,22
PRY,2020-29,773,9,Paraguay,7132530,America,3713,31
PRY,2020-30,723,10,Paraguay,7132530,America,4436,41
PRY,2020-31,1200,11,Paraguay,7132530,America,5636,52
PRY,2020-32,1263,23,Paraguay,7132530,America,6899,75
PRY,2020-33,2884,63,Paraguay,7132530,America,9783,138
PRY,2020-34,3442,67,Paraguay,7132530,America,13225,205
PRY,2020-35,3962,103,Paraguay,7132530,America,17187,308
PRY,2020-36,5291,127,Paraguay,7132530,America,22478,435
PRY,2020-37,5331,90,Paraguay,7132530,America,27809,525
PRY,2020-38,5703,134,Paraguay,7132530,America,33512,659
PRY,2020-39,5164,144,Paraguay,7132530,America,38676,803
PRY,2020-40,5498,126,Paraguay,7132530,America,44174,929
PRY,2020-41,5493,148,Paraguay,7132530,America,49667,1077
PRY,2020-42,5049,111,Paraguay,7132530,America,54716,1188
PRY,2020-43,4870,121,Paraguay,7132530,America,59586,1309
PRY,2020-44,4137,109,Paraguay,7132530,America,63723,1418
PRY,2020-45,3858,72,Paraguay,7132530,America,67581,1490
PRY,2020-46,3985,97,Paraguay,7132530,America,71566,1587
PRY,2020-47,4902,70,Paraguay,7132530,America,76468,1657
PRY,2020-48,5430,86,Paraguay,7132530,America,81898,1743
PRY,2020-49,6014,110,Paraguay,7132530,America,87912,1853
PRY,2020-50,5662,100,Paraguay,7132530,America,93574,1953
PRY,2020-51,7030,150,Paraguay,7132530,America,100604,2103
PRY,2020-52,4762,99,Paraguay,7132530,America,105366,2202
PRY,2020-53,3699,90,Paraguay,7132530,America,109065,2292
PRY,2021-01,6660,113,Paraguay,7132530,America,115725,2405
PRY,2021-02,6427,100,Paraguay,7132530,America,122152,2505
PRY,2021-03,6206,127,Paraguay,7132530,America,128358,2632
PRY,2021-04,4861,86,Paraguay,7132530,America,133219,2718
PRY,2021-05,4891,108,Paraguay,7132530,America,138110,2826
PRY,2021-06,6977,127,Paraguay,7132530,America,145087,2953
PRY,2021-07,6623,112,Paraguay,7132530,America,151710,3065
PRY,2021-08,8730,133,Paraguay,7132530,America,160440,3198
PRY,2021-09,9412,145,Paraguay,7132530,America,169852,3343
PRY,2021-10,11554,174,Paraguay,7132530,America,181406,3517
PRY,2021-11,14698,252,Paraguay,7132530,America,196104,3769
PRY,2021-12,14313,344,Paraguay,7132530,America,210417,4113
PRY,2021-13,12238,350,Paraguay,7132530,America,222655,4463
PRY,2021-14,14879,426,Paraguay,7132530,America,237534,4889
PRY,2021-15,14901,495,Paraguay,7132530,America,252435,5384
PRY,2021-16,16910,618,Paraguay,7132530,America,269345,6002
PRY,2021-17,15100,651,Paraguay,7132530,America,284445,6653
PRY,2021-18,15231,556,Paraguay,7132530,America,299676,7209
PRY,2021-19,13943,387,Paraguay,7132530,America,313619,7596
PRY,2021-20,19344,764,Paraguay,7132530,America,332963,8360
PRY,2021-21,22413,826,Paraguay,7132530,America,355376,9186
PRY,2021-22,20612,819,Paraguay,7132530,America,375988,10005
PRY,2021-23,17486,949,Paraguay,7132530,America,393474,10954
PRY,2021-24,14239,789,Paraguay,7132530,America,407713,11743
PRY,2021-25,12043,898,Paraguay,7132530,America,419756,12641
PRY,2021-26,10120,836,Paraguay,7132530,America,429876,13477
PRY,2021-27,8880,487,Paraguay,7132530,America,438756,13964
PRY,2021-28,6801,376,Paraguay,7132530,America,445557,14340
PRY,2021-29,3776,313,Paraguay,7132530,America,449333,14653
PRY,2021-30,3690,433,Paraguay,7132530,America,453023,15086
PRY,2021-31,2358,229,Paraguay,7132530,America,455381,15315
PRY,2021-32,1453,140,Paraguay,7132530,America,456834,15455
PSE,2020-12,21,0,Palestine,5101416,Asia,21,0
PSE,2020-13,47,1,Palestine,5101416,Asia,68,1
PSE,2020-14,111,0,Palestine,5101416,Asia,179,1
PSE,2020-15,51,1,Palestine,5101416,Asia,230,2
PSE,2020-16,54,0,Palestine,5101416,Asia,284,2
PSE,2020-17,173,0,Palestine,5101416,Asia,457,2
PSE,2020-18,27,2,Palestine,5101416,Asia,484,4
PSE,2020-19,25,0,Palestine,5101416,Asia,509,4
PSE,2020-20,13,0,Palestine,5101416,Asia,522,4
PSE,2020-21,42,1,Palestine,5101416,Asia,564,5
PSE,2020-22,25,0,Palestine,5101416,Asia,589,5
PSE,2020-23,24,0,Palestine,5101416,Asia,613,5
PSE,2020-24,22,0,Palestine,5101416,Asia,635,5
PSE,2020-25,349,0,Palestine,5101416,Asia,984,5
PSE,2020-26,1226,2,Palestine,5101416,Asia,2210,7
PSE,2020-27,2210,13,Palestine,5101416,Asia,4420,20
PSE,2020-28,2580,17,Palestine,5101416,Asia,7000,37
PSE,2020-29,3014,25,Palestine,5101416,Asia,10014,62
PSE,2020-30,3077,16,Palestine,5101416,Asia,13091,78
PSE,2020-31,2651,9,Palestine,5101416,Asia,15742,87
PSE,2020-32,2871,16,Palestine,5101416,Asia,18613,103
PSE,2020-33,3284,18,Palestine,5101416,Asia,21897,121
PSE,2020-34,3089,22,Palestine,5101416,Asia,24986,143
PSE,2020-35,4039,23,Palestine,5101416,Asia,29025,166
PSE,2020-36,4949,37,Palestine,5101416,Asia,33974,203
PSE,2020-37,5498,47,Palestine,5101416,Asia,39472,250
PSE,2020-38,5936,50,Palestine,5101416,Asia,45408,300
PSE,2020-39,3747,43,Palestine,5101416,Asia,49155,343
PSE,2020-40,3240,48,Palestine,5101416,Asia,52395,391
PSE,2020-41,3123,54,Palestine,5101416,Asia,55518,445
PSE,2020-42,2983,34,Palestine,5101416,Asia,58501,479
PSE,2020-43,3507,39,Palestine,5101416,Asia,62008,518
PSE,2020-44,3756,43,Palestine,5101416,Asia,65764,561
PSE,2020-45,4359,26,Palestine,5101416,Asia,70123,587
PSE,2020-46,5165,53,Palestine,5101416,Asia,75288,640
PSE,2020-47,9014,74,Palestine,5101416,Asia,84302,714
PSE,2020-48,12448,93,Palestine,5101416,Asia,96750,807
PSE,2020-49,15247,115,Palestine,5101416,Asia,111997,922
PSE,2020-50,12622,157,Palestine,5101416,Asia,124619,1079
PSE,2020-51,15390,208,Palestine,5101416,Asia,140009,1287
PSE,2020-52,10316,147,Palestine,5101416,Asia,150325,1434
PSE,2020-53,9680,189,Palestine,5101416,Asia,160005,1623
PSE,2021-01,5906,124,Palestine,5101416,Asia,165911,1747
PSE,2021-02,5266,125,Palestine,5101416,Asia,171177,1872
PSE,2021-03,3731,90,Palestine,5101416,Asia,174908,1962
PSE,2021-04,3973,50,Palestine,5101416,Asia,178881,2012
PSE,2021-05,4446,60,Palestine,5101416,Asia,183327,2072
PSE,2021-06,5903,56,Palestine,5101416,Asia,189230,2128
PSE,2021-07,8506,62,Palestine,5101416,Asia,197736,2190
PSE,2021-08,10576,69,Palestine,5101416,Asia,208312,2259
PSE,2021-09,14554,106,Palestine,5101416,Asia,222866,2365
PSE,2021-10,13688,144,Palestine,5101416,Asia,236554,2509
PSE,2021-11,15019,168,Palestine,5101416,Asia,251573,2677
PSE,2021-12,13323,157,Palestine,5101416,Asia,264896,2834
PSE,2021-13,15002,132,Palestine,5101416,Asia,279898,2966
PSE,2021-14,16938,158,Palestine,5101416,Asia,296836,3124
PSE,2021-15,12693,161,Palestine,5101416,Asia,309529,3285
PSE,2021-16,11326,167,Palestine,5101416,Asia,320855,3452
PSE,2021-17,5074,73,Palestine,5101416,Asia,325929,3525
PSE,2021-18,4625,101,Palestine,5101416,Asia,330554,3626
PSE,2021-19,2323,79,Palestine,5101416,Asia,332877,3705
PSE,2021-20,1349,29,Palestine,5101416,Asia,334226,3734
PSE,2021-21,2626,29,Palestine,5101416,Asia,336852,3763
PSE,2021-22,1979,22,Palestine,5101416,Asia,338831,3785
PSE,2021-23,1507,16,Palestine,5101416,Asia,340338,3801
PSE,2021-24,1138,18,Palestine,5101416,Asia,341476,3819
PSE,2021-25,1049,8,Palestine,5101416,Asia,342525,3827
PSE,2021-26,849,14,Palestine,5101416,Asia,343374,3841
PSE,2021-27,591,9,Palestine,5101416,Asia,343965,3850
PSE,2021-28,520,5,Palestine,5101416,Asia,344485,3855
PSE,2021-29,408,12,Palestine,5101416,Asia,344893,3867
PSE,2021-30,884,8,Palestine,5101416,Asia,345777,3875
PSE,2021-31,1241,8,Palestine,5101416,Asia,347018,3883
PSE,2021-32,3946,10,Palestine,5101416,Asia,350964,3893
PYF,2020-13,17,0,French Polynesia,280904,Oceania,17,0
PYF,2020-14,6,0,French Polynesia,280904,Oceania,23,0
PYF,2020-15,12,0,French Polynesia,280904,Oceania,35,0
PYF,2020-16,2,0,French Polynesia,280904,Oceania,37,0
PYF,2020-17,2,0,French Polynesia,280904,Oceania,39,0
PYF,2020-18,1,0,French Polynesia,280904,Oceania,40,0
PYF,2020-19,2,0,French Polynesia,280904,Oceania,42,0
PYF,2020-20,0,0,French Polynesia,280904,Oceania,42,0
PYF,2020-21,0,0,French Polynesia,280904,Oceania,42,0
PYF,2020-22,0,0,French Polynesia,280904,Oceania,42,0
PYF,2020-23,0,0,French Polynesia,280904,Oceania,42,0
PYF,2020-24,0,0,French Polynesia,280904,Oceania,42,0
PYF,2020-25,0,0,French Polynesia,280904,Oceania,42,0
PYF,2020-26,2,0,French Polynesia,280904,Oceania,44,0
PYF,2020-27,0,0,French Polynesia,280904,Oceania,44,0
PYF,2020-28,0,0,French Polynesia,280904,Oceania,44,0
PYF,2020-29,0,0,French Polynesia,280904,Oceania,44,0
PYF,2020-30,0,0,French Polynesia,280904,Oceania,44,0
PYF,2020-31,0,0,French Polynesia,280904,Oceania,44,0
PYF,2020-32,0,0,French Polynesia,280904,Oceania,44,0
PYF,2020-33,130,0,French Polynesia,280904,Oceania,174,0
PYF,2020-34,44,0,French Polynesia,280904,Oceania,218,0
PYF,2020-35,184,0,French Polynesia,280904,Oceania,402,0
PYF,2020-36,274,0,French Polynesia,280904,Oceania,676,0
PYF,2020-37,197,2,French Polynesia,280904,Oceania,873,2
PYF,2020-38,427,0,French Polynesia,280904,Oceania,1300,2
PYF,2020-39,14,3,French Polynesia,280904,Oceania,1314,5
PYF,2020-40,632,3,French Polynesia,280904,Oceania,1946,8
PYF,2020-41,728,2,French Polynesia,280904,Oceania,2674,10
PYF,2020-42,1105,4,French Polynesia,280904,Oceania,3779,14
PYF,2020-43,2000,6,French Polynesia,280904,Oceania,5779,20
PYF,2020-44,1465,9,French Polynesia,280904,Oceania,7244,29
PYF,2020-45,2733,10,French Polynesia,280904,Oceania,9977,39
PYF,2020-46,1711,14,French Polynesia,280904,Oceania,11688,53
PYF,2020-47,1272,10,French Polynesia,280904,Oceania,12960,63
PYF,2020-48,1118,10,French Polynesia,280904,Oceania,14078,73
PYF,2020-49,1011,6,French Polynesia,280904,Oceania,15089,79
PYF,2020-50,640,17,French Polynesia,280904,Oceania,15729,96
PYF,2020-51,435,7,French Polynesia,280904,Oceania,16164,103
PYF,2020-52,368,5,French Polynesia,280904,Oceania,16532,108
PYF,2020-53,376,6,French Polynesia,280904,Oceania,16908,114
PYF,2021-01,315,8,French Polynesia,280904,Oceania,17223,122
PYF,2021-02,394,4,French Polynesia,280904,Oceania,17617,126
PYF,2021-03,0,0,French Polynesia,280904,Oceania,17617,126
PYF,2021-04,425,5,French Polynesia,280904,Oceania,18042,131
PYF,2021-05,125,2,French Polynesia,280904,Oceania,18167,133
PYF,2021-06,78,2,French Polynesia,280904,Oceania,18245,135
PYF,2021-07,83,2,French Polynesia,280904,Oceania,18328,137
PYF,2021-08,41,2,French Polynesia,280904,Oceania,18369,139
PYF,2021-09,72,1,French Polynesia,280904,Oceania,18441,140
PYF,2021-10,68,1,French Polynesia,280904,Oceania,18509,141
PYF,2021-11,49,0,French Polynesia,280904,Oceania,18558,141
PYF,2021-12,31,0,French Polynesia,280904,Oceania,18589,141
PYF,2021-13,26,0,French Polynesia,280904,Oceania,18615,141
PYF,2021-14,19,0,French Polynesia,280904,Oceania,18634,141
PYF,2021-15,44,0,French Polynesia,280904,Oceania,18678,141
PYF,2021-16,38,0,French Polynesia,280904,Oceania,18716,141
PYF,2021-17,24,0,French Polynesia,280904,Oceania,18740,141
PYF,2021-18,32,0,French Polynesia,280904,Oceania,18772,141
PYF,2021-19,25,0,French Polynesia,280904,Oceania,18797,141
PYF,2021-20,29,0,French Polynesia,280904,Oceania,18826,141
PYF,2021-21,16,1,French Polynesia,280904,Oceania,18842,142
PYF,2021-22,29,0,French Polynesia,280904,Oceania,18871,142
PYF,2021-23,41,0,French Polynesia,280904,Oceania,18912,142
PYF,2021-24,33,0,French Polynesia,280904,Oceania,18945,142
PYF,2021-25,29,0,French Polynesia,280904,Oceania,18974,142
PYF,2021-26,15,0,French Polynesia,280904,Oceania,18989,142
PYF,2021-27,19,2,French Polynesia,280904,Oceania,19008,144
PYF,2021-28,59,0,French Polynesia,280904,Oceania,19067,144
PYF,2021-29,149,1,French Polynesia,280904,Oceania,19216,145
PYF,2021-30,1246,8,French Polynesia,280904,Oceania,20462,153
PYF,2021-31,1979,4,French Polynesia,280904,Oceania,22441,157
PYF,2021-32,8082,54,French Polynesia,280904,Oceania,30523,211
QAT,2020-02,0,0,Qatar,2881060,Asia,0,0
QAT,2020-03,0,0,Qatar,2881060,Asia,0,0
QAT,2020-04,0,0,Qatar,2881060,Asia,0,0
QAT,2020-05,0,0,Qatar,2881060,Asia,0,0
QAT,2020-06,0,0,Qatar,2881060,Asia,0,0
QAT,2020-07,0,0,Qatar,2881060,Asia,0,0
QAT,2020-08,0,0,Qatar,2881060,Asia,0,0
QAT,2020-09,3,0,Qatar,2881060,Asia,3,0
QAT,2020-10,12,0,Qatar,2881060,Asia,15,0
QAT,2020-11,386,0,Qatar,2881060,Asia,401,0
QAT,2020-12,93,0,Qatar,2881060,Asia,494,0
QAT,2020-13,140,1,Qatar,2881060,Asia,634,1
QAT,2020-14,970,3,Qatar,2881060,Asia,1604,4
QAT,2020-15,1375,3,Qatar,2881060,Asia,2979,7
QAT,2020-16,2469,1,Qatar,2881060,Asia,5448,8
QAT,2020-17,4839,2,Qatar,2881060,Asia,10287,10
QAT,2020-18,5264,2,Qatar,2881060,Asia,15551,12
QAT,2020-19,6969,2,Qatar,2881060,Asia,22520,14
QAT,2020-20,10084,1,Qatar,2881060,Asia,32604,15
QAT,2020-21,11110,8,Qatar,2881060,Asia,43714,23
QAT,2020-22,13196,15,Qatar,2881060,Asia,56910,38
QAT,2020-23,11880,16,Qatar,2881060,Asia,68790,54
QAT,2020-24,10812,19,Qatar,2881060,Asia,79602,73
QAT,2020-25,7767,25,Qatar,2881060,Asia,87369,98
QAT,2020-26,7044,12,Qatar,2881060,Asia,94413,110
QAT,2020-27,5386,18,Qatar,2881060,Asia,99799,128
QAT,2020-28,3799,19,Qatar,2881060,Asia,103598,147
QAT,2020-29,3050,10,Qatar,2881060,Asia,106648,157
QAT,2020-30,2657,8,Qatar,2881060,Asia,109305,165
QAT,2020-31,1802,12,Qatar,2881060,Asia,111107,177
QAT,2020-32,1840,7,Qatar,2881060,Asia,112947,184
QAT,2020-33,2133,9,Qatar,2881060,Asia,115080,193
QAT,2020-34,1928,0,Qatar,2881060,Asia,117008,193
QAT,2020-35,1567,4,Qatar,2881060,Asia,118575,197
QAT,2020-36,1520,6,Qatar,2881060,Asia,120095,203
QAT,2020-37,1645,2,Qatar,2881060,Asia,121740,205
QAT,2020-38,1636,5,Qatar,2881060,Asia,123376,210
QAT,2020-39,1708,4,Qatar,2881060,Asia,125084,214
QAT,2020-40,1414,2,Qatar,2881060,Asia,126498,216
QAT,2020-41,1487,4,Qatar,2881060,Asia,127985,220
QAT,2020-42,1446,4,Qatar,2881060,Asia,129431,224
QAT,2020-43,1739,6,Qatar,2881060,Asia,131170,230
QAT,2020-44,1550,2,Qatar,2881060,Asia,132720,232
QAT,2020-45,1483,0,Qatar,2881060,Asia,134203,232
QAT,2020-46,1582,2,Qatar,2881060,Asia,135785,234
QAT,2020-47,1444,2,Qatar,2881060,Asia,137229,236
QAT,2020-48,1419,1,Qatar,2881060,Asia,138648,237
QAT,2020-49,1260,2,Qatar,2881060,Asia,139908,239
QAT,2020-50,1213,2,Qatar,2881060,Asia,141121,241
QAT,2020-51,880,2,Qatar,2881060,Asia,142001,243
QAT,2020-52,1061,1,Qatar,2881060,Asia,143062,244
QAT,2020-53,1582,1,Qatar,2881060,Asia,144644,245
QAT,2021-01,1424,1,Qatar,2881060,Asia,146068,246
QAT,2021-02,1436,2,Qatar,2881060,Asia,147504,248
QAT,2021-03,1515,0,Qatar,2881060,Asia,149019,248
QAT,2021-04,2316,0,Qatar,2881060,Asia,151335,248
QAT,2021-05,2763,2,Qatar,2881060,Asia,154098,250
QAT,2021-06,3146,5,Qatar,2881060,Asia,157244,255
QAT,2021-07,3645,2,Qatar,2881060,Asia,160889,257
QAT,2021-08,3248,2,Qatar,2881060,Asia,164137,259
QAT,2021-09,2812,3,Qatar,2881060,Asia,166949,262
QAT,2021-10,3303,4,Qatar,2881060,Asia,170252,266
QAT,2021-11,3976,8,Qatar,2881060,Asia,174228,274
QAT,2021-12,3546,10,Qatar,2881060,Asia,177774,284
QAT,2021-13,5650,19,Qatar,2881060,Asia,183424,303
QAT,2021-14,6601,30,Qatar,2881060,Asia,190025,333
QAT,2021-15,6555,49,Qatar,2881060,Asia,196580,382
QAT,2021-16,6324,55,Qatar,2881060,Asia,202904,437
QAT,2021-17,4688,43,Qatar,2881060,Asia,207592,480
QAT,2021-18,3400,28,Qatar,2881060,Asia,210992,508
QAT,2021-19,2191,22,Qatar,2881060,Asia,213183,530
QAT,2021-20,2260,14,Qatar,2881060,Asia,215443,544
QAT,2021-21,2015,12,Qatar,2881060,Asia,217458,556
QAT,2021-22,1340,13,Qatar,2881060,Asia,218798,569
QAT,2021-23,932,8,Qatar,2881060,Asia,219730,577
QAT,2021-24,1070,6,Qatar,2881060,Asia,220800,583
QAT,2021-25,1010,5,Qatar,2881060,Asia,221810,588
QAT,2021-26,764,4,Qatar,2881060,Asia,222574,592
QAT,2021-27,784,7,Qatar,2881060,Asia,223358,599
QAT,2021-28,920,0,Qatar,2881060,Asia,224278,599
QAT,2021-29,920,1,Qatar,2881060,Asia,225198,600
QAT,2021-30,1342,1,Qatar,2881060,Asia,226540,601
QAT,2021-31,1359,0,Qatar,2881060,Asia,227899,601
QAT,2021-32,1269,0,Qatar,2881060,Asia,229168,601
ROU,2020-02,0,0,Romania,19328838,Europe,0,0
ROU,2020-03,0,0,Romania,19328838,Europe,0,0
ROU,2020-04,0,0,Romania,19328838,Europe,0,0
ROU,2020-05,0,0,Romania,19328838,Europe,0,0
ROU,2020-06,0,0,Romania,19328838,Europe,0,0
ROU,2020-07,0,0,Romania,19328838,Europe,0,0
ROU,2020-08,0,0,Romania,19328838,Europe,0,0
ROU,2020-09,3,0,Romania,19328838,Europe,3,0
ROU,2020-10,12,0,Romania,19328838,Europe,15,0
ROU,2020-11,124,0,Romania,19328838,Europe,139,0
ROU,2020-12,294,2,Romania,19328838,Europe,433,2
ROU,2020-13,1327,38,Romania,19328838,Europe,1760,40
ROU,2020-14,2104,108,Romania,19328838,Europe,3864,148
ROU,2020-15,2436,158,Romania,19328838,Europe,6300,306
ROU,2020-16,2446,128,Romania,19328838,Europe,8746,434
ROU,2020-17,2290,174,Romania,19328838,Europe,11036,608
ROU,2020-18,2127,172,Romania,19328838,Europe,13163,780
ROU,2020-19,2199,172,Romania,19328838,Europe,15362,952
ROU,2020-20,1509,145,Romania,19328838,Europe,16871,1097
ROU,2020-21,1199,82,Romania,19328838,Europe,18070,1179
ROU,2020-22,1187,83,Romania,19328838,Europe,19257,1262
ROU,2020-23,1222,64,Romania,19328838,Europe,20479,1326
ROU,2020-24,1520,84,Romania,19328838,Europe,21999,1410
ROU,2020-25,2046,102,Romania,19328838,Europe,24045,1512
ROU,2020-26,2268,100,Romania,19328838,Europe,26313,1612
ROU,2020-27,2660,138,Romania,19328838,Europe,28973,1750
ROU,2020-28,3562,134,Romania,19328838,Europe,32535,1884
ROU,2020-29,4923,142,Romania,19328838,Europe,37458,2026
ROU,2020-30,7340,161,Romania,19328838,Europe,44798,2187
ROU,2020-31,8388,226,Romania,19328838,Europe,53186,2413
ROU,2020-32,8582,287,Romania,19328838,Europe,61768,2700
ROU,2020-33,8693,291,Romania,19328838,Europe,70461,2991
ROU,2020-34,8064,281,Romania,19328838,Europe,78525,3272
ROU,2020-35,8260,306,Romania,19328838,Europe,86785,3578
ROU,2020-36,8229,315,Romania,19328838,Europe,95014,3893
ROU,2020-37,8481,270,Romania,19328838,Europe,103495,4163
ROU,2020-38,9286,272,Romania,19328838,Europe,112781,4435
ROU,2020-39,9892,283,Romania,19328838,Europe,122673,4718
ROU,2020-40,11392,229,Romania,19328838,Europe,134065,4947
ROU,2020-41,21218,464,Romania,19328838,Europe,155283,5411
ROU,2020-42,25105,461,Romania,19328838,Europe,180388,5872
ROU,2020-43,29260,519,Romania,19328838,Europe,209648,6391
ROU,2020-44,37015,676,Romania,19328838,Europe,246663,7067
ROU,2020-45,57088,812,Romania,19328838,Europe,303751,7879
ROU,2020-46,56530,1047,Romania,19328838,Europe,360281,8926
ROU,2020-47,58364,1121,Romania,19328838,Europe,418645,10047
ROU,2020-48,52891,1146,Romania,19328838,Europe,471536,11193
ROU,2020-49,42040,1127,Romania,19328838,Europe,513576,12320
ROU,2020-50,42759,1065,Romania,19328838,Europe,556335,13385
ROU,2020-51,34959,1009,Romania,19328838,Europe,591294,14394
ROU,2020-52,27135,940,Romania,19328838,Europe,618429,15334
ROU,2020-53,22000,645,Romania,19328838,Europe,640429,15979
ROU,2021-01,32842,746,Romania,19328838,Europe,673271,16725
ROU,2021-02,21882,546,Romania,19328838,Europe,695153,17271
ROU,2021-03,17408,570,Romania,19328838,Europe,712561,17841
ROU,2021-04,17495,561,Romania,19328838,Europe,730056,18402
ROU,2021-05,16581,559,Romania,19328838,Europe,746637,18961
ROU,2021-06,16657,484,Romania,19328838,Europe,763294,19445
ROU,2021-07,18035,449,Romania,19328838,Europe,781329,19894
ROU,2021-08,22761,509,Romania,19328838,Europe,804090,20403
ROU,2021-09,26473,560,Romania,19328838,Europe,830563,20963
ROU,2021-10,32118,602,Romania,19328838,Europe,862681,21565
ROU,2021-11,38177,703,Romania,19328838,Europe,900858,22268
ROU,2021-12,39585,966,Romania,19328838,Europe,940443,23234
ROU,2021-13,37543,956,Romania,19328838,Europe,977986,24190
ROU,2021-14,30504,1058,Romania,19328838,Europe,1008490,25248
ROU,2021-15,22582,1133,Romania,19328838,Europe,1031072,26381
ROU,2021-16,16448,1130,Romania,19328838,Europe,1047520,27511
ROU,2021-17,10817,869,Romania,19328838,Europe,1058337,28380
ROU,2021-18,8394,654,Romania,19328838,Europe,1066731,29034
ROU,2021-19,5560,537,Romania,19328838,Europe,1072291,29571
ROU,2021-20,3482,406,Romania,19328838,Europe,1075773,29977
ROU,2021-21,1964,335,Romania,19328838,Europe,1077737,30312
ROU,2021-22,1215,566,Romania,19328838,Europe,1078952,30878
ROU,2021-23,824,983,Romania,19328838,Europe,1079776,31861
ROU,2021-24,506,530,Romania,19328838,Europe,1080282,32391
ROU,2021-25,385,920,Romania,19328838,Europe,1080667,33311
ROU,2021-26,312,662,Romania,19328838,Europe,1080979,33973
ROU,2021-27,296,246,Romania,19328838,Europe,1081275,34219
ROU,2021-28,403,35,Romania,19328838,Europe,1081678,34254
ROU,2021-29,698,16,Romania,19328838,Europe,1082376,34270
ROU,2021-30,1102,21,Romania,19328838,Europe,1083478,34291
ROU,2021-31,1622,28,Romania,19328838,Europe,1085100,34319
ROU,2021-32,2409,34,Romania,19328838,Europe,1087509,34353
RUS,2020-02,0,0,Russia,145934460,Europe,0,0
RUS,2020-03,0,0,Russia,145934460,Europe,0,0
RUS,2020-04,0,0,Russia,145934460,Europe,0,0
RUS,2020-05,2,0,Russia,145934460,Europe,2,0
RUS,2020-06,0,0,Russia,145934460,Europe,2,0
RUS,2020-07,0,0,Russia,145934460,Europe,2,0
RUS,2020-08,0,0,Russia,145934460,Europe,2,0
RUS,2020-09,0,0,Russia,145934460,Europe,2,0
RUS,2020-10,8,0,Russia,145934460,Europe,10,0
RUS,2020-11,53,0,Russia,145934460,Europe,63,0
RUS,2020-12,304,0,Russia,145934460,Europe,367,0
RUS,2020-13,1167,8,Russia,145934460,Europe,1534,8
RUS,2020-14,3855,37,Russia,145934460,Europe,5389,45
RUS,2020-15,10381,85,Russia,145934460,Europe,15770,130
RUS,2020-16,27083,231,Russia,145934460,Europe,42853,361
RUS,2020-17,38096,386,Russia,145934460,Europe,80949,747
RUS,2020-18,53738,533,Russia,145934460,Europe,134687,1280
RUS,2020-19,75001,635,Russia,145934460,Europe,209688,1915
RUS,2020-20,72064,716,Russia,145934460,Europe,281752,2631
RUS,2020-21,62729,910,Russia,145934460,Europe,344481,3541
RUS,2020-22,61362,1152,Russia,145934460,Europe,405843,4693
RUS,2020-23,61830,1166,Russia,145934460,Europe,467673,5859
RUS,2020-24,61291,1089,Russia,145934460,Europe,528964,6948
RUS,2020-25,55716,1163,Russia,145934460,Europe,584680,8111
RUS,2020-26,49757,962,Russia,145934460,Europe,634437,9073
RUS,2020-27,46814,1088,Russia,145934460,Europe,681251,10161
RUS,2020-28,45911,1174,Russia,145934460,Europe,727162,11335
RUS,2020-29,44384,1007,Russia,145934460,Europe,771546,12342
RUS,2020-30,40939,927,Russia,145934460,Europe,812485,13269
RUS,2020-31,38385,859,Russia,145934460,Europe,850870,14128
RUS,2020-32,36666,803,Russia,145934460,Europe,887536,14931
RUS,2020-33,35317,754,Russia,145934460,Europe,922853,15685
RUS,2020-34,33896,698,Russia,145934460,Europe,956749,16383
RUS,2020-35,33577,710,Russia,145934460,Europe,990326,17093
RUS,2020-36,35179,727,Russia,145934460,Europe,1025505,17820
RUS,2020-37,37306,758,Russia,145934460,Europe,1062811,18578
RUS,2020-38,40588,840,Russia,145934460,Europe,1103399,19418
RUS,2020-39,48039,906,Russia,145934460,Europe,1151438,20324
RUS,2020-40,63563,1034,Russia,145934460,Europe,1215001,21358
RUS,2020-41,83717,1239,Russia,145934460,Europe,1298718,22597
RUS,2020-42,100616,1590,Russia,145934460,Europe,1399334,24187
RUS,2020-43,114543,1863,Russia,145934460,Europe,1513877,26050
RUS,2020-44,122904,2185,Russia,145934460,Europe,1636781,28235
RUS,2020-45,137553,2302,Russia,145934460,Europe,1774334,30537
RUS,2020-46,151491,2649,Russia,145934460,Europe,1925825,33186
RUS,2020-47,163504,2993,Russia,145934460,Europe,2089329,36179
RUS,2020-48,179987,3348,Russia,145934460,Europe,2269316,39527
RUS,2020-49,191454,3614,Russia,145934460,Europe,2460770,43141
RUS,2020-50,193158,3800,Russia,145934460,Europe,2653928,46941
RUS,2020-51,108740,2210,Russia,145934460,Europe,2762668,49151
RUS,2020-52,315367,6114,Russia,145934460,Europe,3078035,55265
RUS,2020-53,182103,3723,Russia,145934460,Europe,3260138,58988
RUS,2021-01,165131,3285,Russia,145934460,Europe,3425269,62273
RUS,2021-02,165797,3764,Russia,145934460,Europe,3591066,66037
RUS,2021-03,147624,3881,Russia,145934460,Europe,3738690,69918
RUS,2021-04,129397,3701,Russia,145934460,Europe,3868087,73619
RUS,2021-05,115110,3449,Russia,145934460,Europe,3983197,77068
RUS,2021-06,102893,3452,Russia,145934460,Europe,4086090,80520
RUS,2021-07,91240,3110,Russia,145934460,Europe,4177330,83630
RUS,2021-08,80320,2825,Russia,145934460,Europe,4257650,86455
RUS,2021-09,75379,3018,Russia,145934460,Europe,4333029,89473
RUS,2021-10,57579,2617,Russia,145934460,Europe,4390608,92090
RUS,2021-11,75545,3301,Russia,145934460,Europe,4466153,95391
RUS,2021-12,62390,2642,Russia,145934460,Europe,4528543,98033
RUS,2021-13,52351,2341,Russia,145934460,Europe,4580894,100374
RUS,2021-14,60496,2612,Russia,145934460,Europe,4641390,102986
RUS,2021-15,60711,2596,Russia,145934460,Europe,4702101,105582
RUS,2021-16,69271,3006,Russia,145934460,Europe,4771372,108588
RUS,2021-17,51883,2274,Russia,145934460,Europe,4823255,110862
RUS,2021-18,57007,2464,Russia,145934460,Europe,4880262,113326
RUS,2021-19,69311,2885,Russia,145934460,Europe,4949573,116211
RUS,2021-20,51932,2271,Russia,145934460,Europe,5001505,118482
RUS,2021-21,70412,3019,Russia,145934460,Europe,5071917,121501
RUS,2021-22,54520,2286,Russia,145934460,Europe,5126437,123787
RUS,2021-23,95971,3014,Russia,145934460,Europe,5222408,126801
RUS,2021-24,94418,2999,Russia,145934460,Europe,5316826,129800
RUS,2021-25,156115,4093,Russia,145934460,Europe,5472941,133893
RUS,2021-26,138000,4032,Russia,145934460,Europe,5610941,137925
RUS,2021-27,197532,5787,Russia,145934460,Europe,5808473,143712
RUS,2021-28,174293,5426,Russia,145934460,Europe,5982766,149138
RUS,2021-29,167014,5463,Russia,145934460,Europe,6149780,154601
RUS,2021-30,162405,5536,Russia,145934460,Europe,6312185,160137
RUS,2021-31,135565,4744,Russia,145934460,Europe,6447750,164881
RUS,2021-32,153086,5618,Russia,145934460,Europe,6600836,170499
RWA,2020-12,14,0,Rwanda,12952209,Africa,14,0
RWA,2020-13,51,0,Rwanda,12952209,Africa,65,0
RWA,2020-14,34,0,Rwanda,12952209,Africa,99,0
RWA,2020-15,22,0,Rwanda,12952209,Africa,121,0
RWA,2020-16,21,0,Rwanda,12952209,Africa,142,0
RWA,2020-17,44,0,Rwanda,12952209,Africa,186,0
RWA,2020-18,68,0,Rwanda,12952209,Africa,254,0
RWA,2020-19,25,0,Rwanda,12952209,Africa,279,0
RWA,2020-20,8,0,Rwanda,12952209,Africa,287,0
RWA,2020-21,35,0,Rwanda,12952209,Africa,322,0
RWA,2020-22,43,1,Rwanda,12952209,Africa,365,1
RWA,2020-23,69,1,Rwanda,12952209,Africa,434,2
RWA,2020-24,143,0,Rwanda,12952209,Africa,577,2
RWA,2020-25,146,0,Rwanda,12952209,Africa,723,2
RWA,2020-26,172,0,Rwanda,12952209,Africa,895,2
RWA,2020-27,205,1,Rwanda,12952209,Africa,1100,3
RWA,2020-28,232,1,Rwanda,12952209,Africa,1332,4
RWA,2020-29,245,1,Rwanda,12952209,Africa,1577,5
RWA,2020-30,239,0,Rwanda,12952209,Africa,1816,5
RWA,2020-31,241,0,Rwanda,12952209,Africa,2057,5
RWA,2020-32,78,2,Rwanda,12952209,Africa,2135,7
RWA,2020-33,313,1,Rwanda,12952209,Africa,2448,8
RWA,2020-34,636,4,Rwanda,12952209,Africa,3084,12
RWA,2020-35,931,4,Rwanda,12952209,Africa,4015,16
RWA,2020-36,354,3,Rwanda,12952209,Africa,4369,19
RWA,2020-37,217,3,Rwanda,12952209,Africa,4586,22
RWA,2020-38,120,4,Rwanda,12952209,Africa,4706,26
RWA,2020-39,109,3,Rwanda,12952209,Africa,4815,29
RWA,2020-40,46,0,Rwanda,12952209,Africa,4861,29
RWA,2020-41,30,2,Rwanda,12952209,Africa,4891,31
RWA,2020-42,78,3,Rwanda,12952209,Africa,4969,34
RWA,2020-43,92,0,Rwanda,12952209,Africa,5061,34
RWA,2020-44,80,1,Rwanda,12952209,Africa,5141,35
RWA,2020-45,76,1,Rwanda,12952209,Africa,5217,36
RWA,2020-46,233,9,Rwanda,12952209,Africa,5450,45
RWA,2020-47,210,2,Rwanda,12952209,Africa,5660,47
RWA,2020-48,254,1,Rwanda,12952209,Africa,5914,48
RWA,2020-49,210,3,Rwanda,12952209,Africa,6124,51
RWA,2020-50,530,5,Rwanda,12952209,Africa,6654,56
RWA,2020-51,634,7,Rwanda,12952209,Africa,7288,63
RWA,2020-52,728,12,Rwanda,12952209,Africa,8016,75
RWA,2020-53,655,26,Rwanda,12952209,Africa,8671,101
RWA,2021-01,954,19,Rwanda,12952209,Africa,9625,120
RWA,2021-02,1402,22,Rwanda,12952209,Africa,11027,142
RWA,2021-03,1943,32,Rwanda,12952209,Africa,12970,174
RWA,2021-04,2484,24,Rwanda,12952209,Africa,15454,198
RWA,2021-05,992,22,Rwanda,12952209,Africa,16446,220
RWA,2021-06,892,19,Rwanda,12952209,Africa,17338,239
RWA,2021-07,710,10,Rwanda,12952209,Africa,18048,249
RWA,2021-08,737,12,Rwanda,12952209,Africa,18785,261
RWA,2021-09,761,7,Rwanda,12952209,Africa,19546,268
RWA,2021-10,635,12,Rwanda,12952209,Africa,20181,280
RWA,2021-11,642,10,Rwanda,12952209,Africa,20823,290
RWA,2021-12,591,11,Rwanda,12952209,Africa,21414,301
RWA,2021-13,1063,10,Rwanda,12952209,Africa,22477,311
RWA,2021-14,944,4,Rwanda,12952209,Africa,23421,315
RWA,2021-15,462,10,Rwanda,12952209,Africa,23883,325
RWA,2021-16,705,5,Rwanda,12952209,Africa,24588,330
RWA,2021-17,660,7,Rwanda,12952209,Africa,25248,337
RWA,2021-18,399,1,Rwanda,12952209,Africa,25647,338
RWA,2021-19,489,6,Rwanda,12952209,Africa,26136,344
RWA,2021-20,547,5,Rwanda,12952209,Africa,26683,349
RWA,2021-21,230,3,Rwanda,12952209,Africa,26913,352
RWA,2021-22,327,8,Rwanda,12952209,Africa,27240,360
RWA,2021-23,1128,10,Rwanda,12952209,Africa,28368,370
RWA,2021-24,2440,12,Rwanda,12952209,Africa,30808,382
RWA,2021-25,5814,38,Rwanda,12952209,Africa,36622,420
RWA,2021-26,5958,50,Rwanda,12952209,Africa,42580,470
RWA,2021-27,5659,90,Rwanda,12952209,Africa,48239,560
RWA,2021-28,9078,89,Rwanda,12952209,Africa,57317,649
RWA,2021-29,5624,93,Rwanda,12952209,Africa,62941,742
RWA,2021-30,8400,79,Rwanda,12952209,Africa,71341,821
RWA,2021-31,4745,69,Rwanda,12952209,Africa,76086,890
RWA,2021-32,3621,69,Rwanda,12952209,Africa,79707,959
SAU,2020-11,107,0,Saudi Arabia,34813867,Asia,107,0
SAU,2020-12,393,0,Saudi Arabia,34813867,Asia,500,0
SAU,2020-13,718,8,Saudi Arabia,34813867,Asia,1218,8
SAU,2020-14,1156,26,Saudi Arabia,34813867,Asia,2374,34
SAU,2020-15,2077,25,Saudi Arabia,34813867,Asia,4451,59
SAU,2020-16,4900,38,Saudi Arabia,34813867,Asia,9351,97
SAU,2020-17,8160,42,Saudi Arabia,34813867,Asia,17511,139
SAU,2020-18,9489,45,Saudi Arabia,34813867,Asia,27000,184
SAU,2020-19,12037,62,Saudi Arabia,34813867,Asia,39037,246
SAU,2020-20,15704,66,Saudi Arabia,34813867,Asia,54741,312
SAU,2020-21,17808,78,Saudi Arabia,34813867,Asia,72549,390
SAU,2020-22,12701,113,Saudi Arabia,34813867,Asia,85250,503
SAU,2020-23,16653,209,Saudi Arabia,34813867,Asia,101903,712
SAU,2020-24,25627,260,Saudi Arabia,34813867,Asia,127530,972
SAU,2020-25,30071,295,Saudi Arabia,34813867,Asia,157601,1267
SAU,2020-26,24881,284,Saudi Arabia,34813867,Asia,182482,1551
SAU,2020-27,27016,365,Saudi Arabia,34813867,Asia,209498,1916
SAU,2020-28,22750,307,Saudi Arabia,34813867,Asia,232248,2223
SAU,2020-29,18661,263,Saudi Arabia,34813867,Asia,250909,2486
SAU,2020-30,16021,247,Saudi Arabia,34813867,Asia,266930,2733
SAU,2020-31,11894,184,Saudi Arabia,34813867,Asia,278824,2917
SAU,2020-32,9855,250,Saudi Arabia,34813867,Asia,288679,3167
SAU,2020-33,9852,241,Saudi Arabia,34813867,Asia,298531,3408
SAU,2020-34,8937,241,Saudi Arabia,34813867,Asia,307468,3649
SAU,2020-35,7342,221,Saudi Arabia,34813867,Asia,314810,3870
SAU,2020-36,6006,211,Saudi Arabia,34813867,Asia,320816,4081
SAU,2020-37,4824,187,Saudi Arabia,34813867,Asia,325640,4268
SAU,2020-38,4103,217,Saudi Arabia,34813867,Asia,329743,4485
SAU,2020-39,3439,198,Saudi Arabia,34813867,Asia,333182,4683
SAU,2020-40,3194,192,Saudi Arabia,34813867,Asia,336376,4875
SAU,2020-41,2880,168,Saudi Arabia,34813867,Asia,339256,5043
SAU,2020-42,2935,142,Saudi Arabia,34813867,Asia,342191,5185
SAU,2020-43,2673,111,Saudi Arabia,34813867,Asia,344864,5296
SAU,2020-44,2781,106,Saudi Arabia,34813867,Asia,347645,5402
SAU,2020-45,2936,138,Saudi Arabia,34813867,Asia,350581,5540
SAU,2020-46,2663,117,Saudi Arabia,34813867,Asia,353244,5657
SAU,2020-47,2003,123,Saudi Arabia,34813867,Asia,355247,5780
SAU,2020-48,1870,104,Saudi Arabia,34813867,Asia,357117,5884
SAU,2020-49,1585,81,Saudi Arabia,34813867,Asia,358702,5965
SAU,2020-50,1175,83,Saudi Arabia,34813867,Asia,359877,6048
SAU,2020-51,1122,74,Saudi Arabia,34813867,Asia,360999,6122
SAU,2020-52,1210,63,Saudi Arabia,34813867,Asia,362209,6185
SAU,2020-53,935,71,Saudi Arabia,34813867,Asia,363144,6256
SAU,2021-01,654,35,Saudi Arabia,34813867,Asia,363798,6291
SAU,2021-02,1120,32,Saudi Arabia,34813867,Asia,364918,6323
SAU,2021-03,1442,29,Saudi Arabia,34813867,Asia,366360,6352
SAU,2021-04,1703,23,Saudi Arabia,34813867,Asia,368063,6375
SAU,2021-05,2204,27,Saudi Arabia,34813867,Asia,370267,6402
SAU,2021-06,2454,31,Saudi Arabia,34813867,Asia,372721,6433
SAU,2021-07,2601,33,Saudi Arabia,34813867,Asia,375322,6466
SAU,2021-08,2050,28,Saudi Arabia,34813867,Asia,377372,6494
SAU,2021-09,2448,34,Saudi Arabia,34813867,Asia,379820,6528
SAU,2021-10,2576,39,Saudi Arabia,34813867,Asia,382396,6567
SAU,2021-11,2613,42,Saudi Arabia,34813867,Asia,385009,6609
SAU,2021-12,3305,41,Saudi Arabia,34813867,Asia,388314,6650
SAU,2021-13,4357,47,Saudi Arabia,34813867,Asia,392671,6697
SAU,2021-14,5753,57,Saudi Arabia,34813867,Asia,398424,6754
SAU,2021-15,6535,69,Saudi Arabia,34813867,Asia,404959,6823
SAU,2021-16,8204,90,Saudi Arabia,34813867,Asia,413163,6913
SAU,2021-17,6174,66,Saudi Arabia,34813867,Asia,419337,6979
SAU,2021-18,7036,93,Saudi Arabia,34813867,Asia,426373,7072
SAU,2021-19,6711,102,Saudi Arabia,34813867,Asia,433084,7174
SAU,2021-20,7819,75,Saudi Arabia,34813867,Asia,440903,7249
SAU,2021-21,8277,98,Saudi Arabia,34813867,Asia,449180,7347
SAU,2021-22,8355,109,Saudi Arabia,34813867,Asia,457535,7456
SAU,2021-23,8251,116,Saudi Arabia,34813867,Asia,465786,7572
SAU,2021-24,8394,105,Saudi Arabia,34813867,Asia,474180,7677
SAU,2021-25,9030,98,Saudi Arabia,34813867,Asia,483210,7775
SAU,2021-26,9564,101,Saudi Arabia,34813867,Asia,492774,7876
SAU,2021-27,8410,100,Saudi Arabia,34813867,Asia,501184,7976
SAU,2021-28,8381,99,Saudi Arabia,34813867,Asia,509565,8075
SAU,2021-29,8567,92,Saudi Arabia,34813867,Asia,518132,8167
SAU,2021-30,8671,82,Saudi Arabia,34813867,Asia,526803,8249
SAU,2021-31,6702,85,Saudi Arabia,34813867,Asia,533505,8334
SAU,2021-32,5009,78,Saudi Arabia,34813867,Asia,538514,8412
SDN,2020-12,1,0,Sudan,43849269,Africa,1,0
SDN,2020-13,3,0,Sudan,43849269,Africa,4,0
SDN,2020-14,7,1,Sudan,43849269,Africa,11,1
SDN,2020-15,7,0,Sudan,43849269,Africa,18,1
SDN,2020-16,47,8,Sudan,43849269,Africa,65,9
SDN,2020-17,171,11,Sudan,43849269,Africa,236,20
SDN,2020-18,441,20,Sudan,43849269,Africa,677,40
SDN,2020-19,685,29,Sudan,43849269,Africa,1362,69
SDN,2020-20,926,27,Sudan,43849269,Africa,2288,96
SDN,2020-21,1345,49,Sudan,43849269,Africa,3633,145
SDN,2020-22,1392,140,Sudan,43849269,Africa,5025,285
SDN,2020-23,1057,73,Sudan,43849269,Africa,6082,358
SDN,2020-24,1137,100,Sudan,43849269,Africa,7219,458
SDN,2020-25,1360,62,Sudan,43849269,Africa,8579,520
SDN,2020-26,678,51,Sudan,43849269,Africa,9257,571
SDN,2020-27,509,36,Sudan,43849269,Africa,9766,607
SDN,2020-28,483,42,Sudan,43849269,Africa,10249,649
SDN,2020-29,512,30,Sudan,43849269,Africa,10761,679
SDN,2020-30,623,37,Sudan,43849269,Africa,11384,716
SDN,2020-31,353,35,Sudan,43849269,Africa,11737,751
SDN,2020-32,156,21,Sudan,43849269,Africa,11893,772
SDN,2020-33,516,30,Sudan,43849269,Africa,12409,802
SDN,2020-34,426,12,Sudan,43849269,Africa,12835,814
SDN,2020-35,353,8,Sudan,43849269,Africa,13188,822
SDN,2020-36,218,9,Sudan,43849269,Africa,13406,831
SDN,2020-37,63,2,Sudan,43849269,Africa,13469,833
SDN,2020-38,85,2,Sudan,43849269,Africa,13554,835
SDN,2020-39,51,0,Sudan,43849269,Africa,13605,835
SDN,2020-40,47,0,Sudan,43849269,Africa,13652,835
SDN,2020-41,17,0,Sudan,43849269,Africa,13669,835
SDN,2020-42,21,0,Sudan,43849269,Africa,13690,835
SDN,2020-43,51,1,Sudan,43849269,Africa,13741,836
SDN,2020-44,77,0,Sudan,43849269,Africa,13818,836
SDN,2020-45,271,278,Sudan,43849269,Africa,14089,1114
SDN,2020-46,536,1,Sudan,43849269,Africa,14625,1115
SDN,2020-47,1213,77,Sudan,43849269,Africa,15838,1192
SDN,2020-48,1788,48,Sudan,43849269,Africa,17626,1240
SDN,2020-49,1841,54,Sudan,43849269,Africa,19467,1294
SDN,2020-50,1918,52,Sudan,43849269,Africa,21385,1346
SDN,2020-51,1437,87,Sudan,43849269,Africa,22822,1433
SDN,2020-52,493,34,Sudan,43849269,Africa,23315,1467
SDN,2020-53,0,0,Sudan,43849269,Africa,23315,1467
SDN,2021-01,0,0,Sudan,43849269,Africa,23315,1467
SDN,2021-02,0,0,Sudan,43849269,Africa,23315,1467
SDN,2021-03,5206,254,Sudan,43849269,Africa,28521,1721
SDN,2021-04,927,85,Sudan,43849269,Africa,29448,1806
SDN,2021-05,185,24,Sudan,43849269,Africa,29633,1830
SDN,2021-06,299,18,Sudan,43849269,Africa,29932,1848
SDN,2021-07,272,22,Sudan,43849269,Africa,30204,1870
SDN,2021-08,142,9,Sudan,43849269,Africa,30346,1879
SDN,2021-09,193,15,Sudan,43849269,Africa,30539,1894
SDN,2021-10,449,64,Sudan,43849269,Africa,30988,1958
SDN,2021-11,158,27,Sudan,43849269,Africa,31146,1985
SDN,2021-12,260,42,Sudan,43849269,Africa,31406,2027
SDN,2021-13,426,35,Sudan,43849269,Africa,31832,2062
SDN,2021-14,0,0,Sudan,43849269,Africa,31832,2062
SDN,2021-15,1189,145,Sudan,43849269,Africa,33021,2207
SDN,2021-16,651,92,Sudan,43849269,Africa,33672,2299
SDN,2021-17,271,49,Sudan,43849269,Africa,33943,2348
SDN,2021-18,517,16,Sudan,43849269,Africa,34460,2364
SDN,2021-19,428,81,Sudan,43849269,Africa,34888,2445
SDN,2021-20,0,0,Sudan,43849269,Africa,34888,2445
SDN,2021-21,606,184,Sudan,43849269,Africa,35494,2629
SDN,2021-22,509,67,Sudan,43849269,Africa,36003,2696
SDN,2021-23,199,22,Sudan,43849269,Africa,36202,2718
SDN,2021-24,144,18,Sudan,43849269,Africa,36346,2736
SDN,2021-25,227,13,Sudan,43849269,Africa,36573,2749
SDN,2021-26,84,4,Sudan,43849269,Africa,36657,2753
SDN,2021-27,147,6,Sudan,43849269,Africa,36804,2759
SDN,2021-28,333,16,Sudan,43849269,Africa,37137,2775
SDN,2021-29,0,0,Sudan,43849269,Africa,37137,2775
SDN,2021-30,0,0,Sudan,43849269,Africa,37137,2775
SDN,2021-31,0,0,Sudan,43849269,Africa,37137,2775
SDN,2021-32,405,4,Sudan,43849269,Africa,37542,2779
SEN,2020-12,41,0,Senegal,16743930,Africa,41,0
SEN,2020-13,75,0,Senegal,16743930,Africa,116,0
SEN,2020-14,80,2,Senegal,16743930,Africa,196,2
SEN,2020-15,58,0,Senegal,16743930,Africa,254,2
SEN,2020-16,87,2,Senegal,16743930,Africa,341,4
SEN,2020-17,304,5,Senegal,16743930,Africa,645,9
SEN,2020-18,511,0,Senegal,16743930,Africa,1156,9
SEN,2020-19,527,10,Senegal,16743930,Africa,1683,19
SEN,2020-20,771,7,Senegal,16743930,Africa,2454,26
SEN,2020-21,567,9,Senegal,16743930,Africa,3021,35
SEN,2020-22,598,7,Senegal,16743930,Africa,3619,42
SEN,2020-23,683,7,Senegal,16743930,Africa,4302,49
SEN,2020-24,762,11,Senegal,16743930,Africa,5064,60
SEN,2020-25,798,24,Senegal,16743930,Africa,5862,84
SEN,2020-26,698,21,Senegal,16743930,Africa,6560,105
SEN,2020-27,814,28,Senegal,16743930,Africa,7374,133
SEN,2020-28,735,15,Senegal,16743930,Africa,8109,148
SEN,2020-29,675,19,Senegal,16743930,Africa,8784,167
SEN,2020-30,871,24,Senegal,16743930,Africa,9655,191
SEN,2020-31,663,18,Senegal,16743930,Africa,10318,209
SEN,2020-32,831,23,Senegal,16743930,Africa,11149,232
SEN,2020-33,987,21,Senegal,16743930,Africa,12136,253
SEN,2020-34,787,16,Senegal,16743930,Africa,12923,269
SEN,2020-35,607,15,Senegal,16743930,Africa,13530,284
SEN,2020-36,431,6,Senegal,16743930,Africa,13961,290
SEN,2020-37,293,7,Senegal,16743930,Africa,14254,297
SEN,2020-38,434,5,Senegal,16743930,Africa,14688,302
SEN,2020-39,195,6,Senegal,16743930,Africa,14883,308
SEN,2020-40,185,4,Senegal,16743930,Africa,15068,312
SEN,2020-41,174,2,Senegal,16743930,Africa,15242,314
SEN,2020-42,150,3,Senegal,16743930,Africa,15392,317
SEN,2020-43,133,4,Senegal,16743930,Africa,15525,321
SEN,2020-44,79,4,Senegal,16743930,Africa,15604,325
SEN,2020-45,78,1,Senegal,16743930,Africa,15682,326
SEN,2020-46,85,2,Senegal,16743930,Africa,15767,328
SEN,2020-47,89,2,Senegal,16743930,Africa,15856,330
SEN,2020-48,193,3,Senegal,16743930,Africa,16049,333
SEN,2020-49,402,5,Senegal,16743930,Africa,16451,338
SEN,2020-50,598,11,Senegal,16743930,Africa,17049,349
SEN,2020-51,683,16,Senegal,16743930,Africa,17732,365
SEN,2020-52,970,25,Senegal,16743930,Africa,18702,390
SEN,2020-53,1075,34,Senegal,16743930,Africa,19777,424
SEN,2021-01,1730,45,Senegal,16743930,Africa,21507,469
SEN,2021-02,1691,57,Senegal,16743930,Africa,23198,526
SEN,2021-03,1769,56,Senegal,16743930,Africa,24967,582
SEN,2021-04,1934,56,Senegal,16743930,Africa,26901,638
SEN,2021-05,1833,44,Senegal,16743930,Africa,28734,682
SEN,2021-06,2247,66,Senegal,16743930,Africa,30981,748
SEN,2021-07,2092,66,Senegal,16743930,Africa,33073,814
SEN,2021-08,1421,58,Senegal,16743930,Africa,34494,872
SEN,2021-09,1439,53,Senegal,16743930,Africa,35933,925
SEN,2021-10,933,38,Senegal,16743930,Africa,36866,963
SEN,2021-11,1028,53,Senegal,16743930,Africa,37894,1016
SEN,2021-12,600,21,Senegal,16743930,Africa,38494,1037
SEN,2021-13,573,26,Senegal,16743930,Africa,39067,1063
SEN,2021-14,338,15,Senegal,16743930,Africa,39405,1078
SEN,2021-15,390,13,Senegal,16743930,Africa,39795,1091
SEN,2021-16,345,13,Senegal,16743930,Africa,40140,1104
SEN,2021-17,267,6,Senegal,16743930,Africa,40407,1110
SEN,2021-18,259,10,Senegal,16743930,Africa,40666,1120
SEN,2021-19,180,7,Senegal,16743930,Africa,40846,1127
SEN,2021-20,270,5,Senegal,16743930,Africa,41116,1132
SEN,2021-21,154,6,Senegal,16743930,Africa,41270,1138
SEN,2021-22,384,8,Senegal,16743930,Africa,41654,1146
SEN,2021-23,318,8,Senegal,16743930,Africa,41972,1154
SEN,2021-24,406,4,Senegal,16743930,Africa,42378,1158
SEN,2021-25,500,6,Senegal,16743930,Africa,42878,1164
SEN,2021-26,864,4,Senegal,16743930,Africa,43742,1168
SEN,2021-27,2407,26,Senegal,16743930,Africa,46149,1194
SEN,2021-28,5921,26,Senegal,16743930,Africa,52070,1220
SEN,2021-29,5167,61,Senegal,16743930,Africa,57237,1281
SEN,2021-30,5739,86,Senegal,16743930,Africa,62976,1367
SEN,2021-31,5010,128,Senegal,16743930,Africa,67986,1495
SEN,2021-32,2842,119,Senegal,16743930,Africa,70828,1614
SGP,2020-02,0,0,Singapore,5850343,Asia,0,0
SGP,2020-03,0,0,Singapore,5850343,Asia,0,0
SGP,2020-04,4,0,Singapore,5850343,Asia,4,0
SGP,2020-05,14,0,Singapore,5850343,Asia,18,0
SGP,2020-06,25,0,Singapore,5850343,Asia,43,0
SGP,2020-07,32,0,Singapore,5850343,Asia,75,0
SGP,2020-08,14,0,Singapore,5850343,Asia,89,0
SGP,2020-09,17,0,Singapore,5850343,Asia,106,0
SGP,2020-10,44,0,Singapore,5850343,Asia,150,0
SGP,2020-11,76,0,Singapore,5850343,Asia,226,0
SGP,2020-12,229,2,Singapore,5850343,Asia,455,2
SGP,2020-13,389,1,Singapore,5850343,Asia,844,3
SGP,2020-14,465,3,Singapore,5850343,Asia,1309,6
SGP,2020-15,1223,2,Singapore,5850343,Asia,2532,8
SGP,2020-16,4056,3,Singapore,5850343,Asia,6588,11
SGP,2020-17,7036,1,Singapore,5850343,Asia,13624,12
SGP,2020-18,4581,6,Singapore,5850343,Asia,18205,18
SGP,2020-19,5131,2,Singapore,5850343,Asia,23336,20
SGP,2020-20,4702,2,Singapore,5850343,Asia,28038,22
SGP,2020-21,3578,1,Singapore,5850343,Asia,31616,23
SGP,2020-22,3268,0,Singapore,5850343,Asia,34884,23
SGP,2020-23,3026,2,Singapore,5850343,Asia,37910,25
SGP,2020-24,2694,1,Singapore,5850343,Asia,40604,26
SGP,2020-25,1491,0,Singapore,5850343,Asia,42095,26
SGP,2020-26,1364,0,Singapore,5850343,Asia,43459,26
SGP,2020-27,1205,0,Singapore,5850343,Asia,44664,26
SGP,2020-28,1297,0,Singapore,5850343,Asia,45961,26
SGP,2020-29,1951,1,Singapore,5850343,Asia,47912,27
SGP,2020-30,2457,0,Singapore,5850343,Asia,50369,27
SGP,2020-31,2456,0,Singapore,5850343,Asia,52825,27
SGP,2020-32,2279,0,Singapore,5850343,Asia,55104,27
SGP,2020-33,643,0,Singapore,5850343,Asia,55747,27
SGP,2020-34,606,0,Singapore,5850343,Asia,56353,27
SGP,2020-35,418,0,Singapore,5850343,Asia,56771,27
SGP,2020-36,251,0,Singapore,5850343,Asia,57022,27
SGP,2020-37,384,0,Singapore,5850343,Asia,57406,27
SGP,2020-38,170,0,Singapore,5850343,Asia,57576,27
SGP,2020-39,124,0,Singapore,5850343,Asia,57700,27
SGP,2020-40,112,0,Singapore,5850343,Asia,57812,27
SGP,2020-41,64,0,Singapore,5850343,Asia,57876,27
SGP,2020-42,35,1,Singapore,5850343,Asia,57911,28
SGP,2020-43,59,0,Singapore,5850343,Asia,57970,28
SGP,2020-44,49,0,Singapore,5850343,Asia,58019,28
SGP,2020-45,37,0,Singapore,5850343,Asia,58056,28
SGP,2020-46,63,0,Singapore,5850343,Asia,58119,28
SGP,2020-47,41,0,Singapore,5850343,Asia,58160,28
SGP,2020-48,53,1,Singapore,5850343,Asia,58213,29
SGP,2020-49,47,0,Singapore,5850343,Asia,58260,29
SGP,2020-50,60,0,Singapore,5850343,Asia,58320,29
SGP,2020-51,102,0,Singapore,5850343,Asia,58422,29
SGP,2020-52,102,0,Singapore,5850343,Asia,58524,29
SGP,2020-53,173,0,Singapore,5850343,Asia,58697,29
SGP,2021-01,210,0,Singapore,5850343,Asia,58907,29
SGP,2021-02,206,0,Singapore,5850343,Asia,59113,29
SGP,2021-03,195,0,Singapore,5850343,Asia,59308,29
SGP,2021-04,228,0,Singapore,5850343,Asia,59536,29
SGP,2021-05,163,0,Singapore,5850343,Asia,59699,29
SGP,2021-06,101,0,Singapore,5850343,Asia,59800,29
SGP,2021-07,69,0,Singapore,5850343,Asia,59869,29
SGP,2021-08,67,0,Singapore,5850343,Asia,59936,29
SGP,2021-09,97,0,Singapore,5850343,Asia,60033,29
SGP,2021-10,72,1,Singapore,5850343,Asia,60105,30
SGP,2021-11,91,0,Singapore,5850343,Asia,60196,30
SGP,2021-12,104,0,Singapore,5850343,Asia,60300,30
SGP,2021-13,178,0,Singapore,5850343,Asia,60478,30
SGP,2021-14,175,0,Singapore,5850343,Asia,60653,30
SGP,2021-15,178,0,Singapore,5850343,Asia,60831,30
SGP,2021-16,175,0,Singapore,5850343,Asia,61006,30
SGP,2021-17,212,1,Singapore,5850343,Asia,61218,31
SGP,2021-18,141,0,Singapore,5850343,Asia,61359,31
SGP,2021-19,226,0,Singapore,5850343,Asia,61585,31
SGP,2021-20,239,1,Singapore,5850343,Asia,61824,32
SGP,2021-21,204,1,Singapore,5850343,Asia,62028,33
SGP,2021-22,168,0,Singapore,5850343,Asia,62196,33
SGP,2021-23,80,1,Singapore,5850343,Asia,62276,34
SGP,2021-24,138,0,Singapore,5850343,Asia,62414,34
SGP,2021-25,130,2,Singapore,5850343,Asia,62544,36
SGP,2021-26,73,0,Singapore,5850343,Asia,62617,36
SGP,2021-27,75,0,Singapore,5850343,Asia,62692,36
SGP,2021-28,381,0,Singapore,5850343,Asia,63073,36
SGP,2021-29,1106,1,Singapore,5850343,Asia,64179,37
SGP,2021-30,923,0,Singapore,5850343,Asia,65102,37
SGP,2021-31,652,5,Singapore,5850343,Asia,65754,42
SGP,2021-32,418,2,Singapore,5850343,Asia,66172,44
SLB,2020-43,1,0,Solomon Islands,686878,Oceania,1,0
SLB,2020-44,4,0,Solomon Islands,686878,Oceania,5,0
SLB,2020-45,5,0,Solomon Islands,686878,Oceania,10,0
SLB,2020-46,3,0,Solomon Islands,686878,Oceania,13,0
SLB,2020-47,0,0,Solomon Islands,686878,Oceania,13,0
SLB,2020-48,1,0,Solomon Islands,686878,Oceania,14,0
SLB,2020-49,0,0,Solomon Islands,686878,Oceania,14,0
SLB,2020-50,0,0,Solomon Islands,686878,Oceania,14,0
SLB,2020-51,0,0,Solomon Islands,686878,Oceania,14,0
SLB,2020-52,0,0,Solomon Islands,686878,Oceania,14,0
SLB,2020-53,0,0,Solomon Islands,686878,Oceania,14,0
SLB,2021-01,0,0,Solomon Islands,686878,Oceania,14,0
SLB,2021-02,0,0,Solomon Islands,686878,Oceania,14,0
SLB,2021-03,0,0,Solomon Islands,686878,Oceania,14,0
SLB,2021-04,0,0,Solomon Islands,686878,Oceania,14,0
SLB,2021-05,0,0,Solomon Islands,686878,Oceania,14,0
SLB,2021-06,1,0,Solomon Islands,686878,Oceania,15,0
SLB,2021-07,0,0,Solomon Islands,686878,Oceania,15,0
SLB,2021-08,0,0,Solomon Islands,686878,Oceania,15,0
SLB,2021-09,0,0,Solomon Islands,686878,Oceania,15,0
SLB,2021-10,0,0,Solomon Islands,686878,Oceania,15,0
SLB,2021-11,0,0,Solomon Islands,686878,Oceania,15,0
SLB,2021-12,0,0,Solomon Islands,686878,Oceania,15,0
SLB,2021-13,1,0,Solomon Islands,686878,Oceania,16,0
SLB,2021-14,0,0,Solomon Islands,686878,Oceania,16,0
SLB,2021-15,1,0,Solomon Islands,686878,Oceania,17,0
SLB,2021-16,0,0,Solomon Islands,686878,Oceania,17,0
SLB,2021-17,0,0,Solomon Islands,686878,Oceania,17,0
SLB,2021-18,0,0,Solomon Islands,686878,Oceania,17,0
SLB,2021-19,0,0,Solomon Islands,686878,Oceania,17,0
SLB,2021-20,0,0,Solomon Islands,686878,Oceania,17,0
SLB,2021-21,0,0,Solomon Islands,686878,Oceania,17,0
SLB,2021-22,0,0,Solomon Islands,686878,Oceania,17,0
SLB,2021-23,0,0,Solomon Islands,686878,Oceania,17,0
SLB,2021-24,0,0,Solomon Islands,686878,Oceania,17,0
SLB,2021-25,0,0,Solomon Islands,686878,Oceania,17,0
SLB,2021-26,0,0,Solomon Islands,686878,Oceania,17,0
SLB,2021-27,0,0,Solomon Islands,686878,Oceania,17,0
SLB,2021-28,0,0,Solomon Islands,686878,Oceania,17,0
SLB,2021-29,0,0,Solomon Islands,686878,Oceania,17,0
SLB,2021-30,0,0,Solomon Islands,686878,Oceania,17,0
SLB,2021-31,0,0,Solomon Islands,686878,Oceania,17,0
SLB,2021-32,0,0,Solomon Islands,686878,Oceania,17,0
SLE,2020-15,4,0,Sierra Leone,7976985,Africa,4,0
SLE,2020-16,25,0,Sierra Leone,7976985,Africa,29,0
SLE,2020-17,58,4,Sierra Leone,7976985,Africa,87,4
SLE,2020-18,64,4,Sierra Leone,7976985,Africa,151,8
SLE,2020-19,150,10,Sierra Leone,7976985,Africa,301,18
SLE,2020-20,198,14,Sierra Leone,7976985,Africa,499,32
SLE,2020-21,202,8,Sierra Leone,7976985,Africa,701,40
SLE,2020-22,154,6,Sierra Leone,7976985,Africa,855,46
SLE,2020-23,108,2,Sierra Leone,7976985,Africa,963,48
SLE,2020-24,200,3,Sierra Leone,7976985,Africa,1163,51
SLE,2020-25,158,4,Sierra Leone,7976985,Africa,1321,55
SLE,2020-26,100,5,Sierra Leone,7976985,Africa,1421,60
SLE,2020-27,115,2,Sierra Leone,7976985,Africa,1536,62
SLE,2020-28,93,1,Sierra Leone,7976985,Africa,1629,63
SLE,2020-29,76,2,Sierra Leone,7976985,Africa,1705,65
SLE,2020-30,72,1,Sierra Leone,7976985,Africa,1777,66
SLE,2020-31,60,1,Sierra Leone,7976985,Africa,1837,67
SLE,2020-32,73,1,Sierra Leone,7976985,Africa,1910,68
SLE,2020-33,40,1,Sierra Leone,7976985,Africa,1950,69
SLE,2020-34,36,0,Sierra Leone,7976985,Africa,1986,69
SLE,2020-35,30,1,Sierra Leone,7976985,Africa,2016,70
SLE,2020-36,32,1,Sierra Leone,7976985,Africa,2048,71
SLE,2020-37,55,1,Sierra Leone,7976985,Africa,2103,72
SLE,2020-38,59,0,Sierra Leone,7976985,Africa,2162,72
SLE,2020-39,47,0,Sierra Leone,7976985,Africa,2209,72
SLE,2020-40,54,0,Sierra Leone,7976985,Africa,2263,72
SLE,2020-41,37,0,Sierra Leone,7976985,Africa,2300,72
SLE,2020-42,24,1,Sierra Leone,7976985,Africa,2324,73
SLE,2020-43,16,1,Sierra Leone,7976985,Africa,2340,74
SLE,2020-44,20,0,Sierra Leone,7976985,Africa,2360,74
SLE,2020-45,15,0,Sierra Leone,7976985,Africa,2375,74
SLE,2020-46,10,0,Sierra Leone,7976985,Africa,2385,74
SLE,2020-47,14,0,Sierra Leone,7976985,Africa,2399,74
SLE,2020-48,6,0,Sierra Leone,7976985,Africa,2405,74
SLE,2020-49,15,0,Sierra Leone,7976985,Africa,2420,74
SLE,2020-50,19,1,Sierra Leone,7976985,Africa,2439,75
SLE,2020-51,64,0,Sierra Leone,7976985,Africa,2503,75
SLE,2020-52,51,1,Sierra Leone,7976985,Africa,2554,76
SLE,2020-53,113,0,Sierra Leone,7976985,Africa,2667,76
SLE,2021-01,173,1,Sierra Leone,7976985,Africa,2840,77
SLE,2021-02,160,0,Sierra Leone,7976985,Africa,3000,77
SLE,2021-03,167,0,Sierra Leone,7976985,Africa,3167,77
SLE,2021-04,461,2,Sierra Leone,7976985,Africa,3628,79
SLE,2021-05,151,0,Sierra Leone,7976985,Africa,3779,79
SLE,2021-06,36,0,Sierra Leone,7976985,Africa,3815,79
SLE,2021-07,36,0,Sierra Leone,7976985,Africa,3851,79
SLE,2021-08,30,0,Sierra Leone,7976985,Africa,3881,79
SLE,2021-09,33,0,Sierra Leone,7976985,Africa,3914,79
SLE,2021-10,17,0,Sierra Leone,7976985,Africa,3931,79
SLE,2021-11,11,0,Sierra Leone,7976985,Africa,3942,79
SLE,2021-12,22,0,Sierra Leone,7976985,Africa,3964,79
SLE,2021-13,19,0,Sierra Leone,7976985,Africa,3983,79
SLE,2021-14,16,0,Sierra Leone,7976985,Africa,3999,79
SLE,2021-15,33,0,Sierra Leone,7976985,Africa,4032,79
SLE,2021-16,8,0,Sierra Leone,7976985,Africa,4040,79
SLE,2021-17,16,0,Sierra Leone,7976985,Africa,4056,79
SLE,2021-18,27,0,Sierra Leone,7976985,Africa,4083,79
SLE,2021-19,18,0,Sierra Leone,7976985,Africa,4101,79
SLE,2021-20,14,0,Sierra Leone,7976985,Africa,4115,79
SLE,2021-21,26,0,Sierra Leone,7976985,Africa,4141,79
SLE,2021-22,54,0,Sierra Leone,7976985,Africa,4195,79
SLE,2021-23,187,3,Sierra Leone,7976985,Africa,4382,82
SLE,2021-24,491,0,Sierra Leone,7976985,Africa,4873,82
SLE,2021-25,502,12,Sierra Leone,7976985,Africa,5375,94
SLE,2021-26,412,12,Sierra Leone,7976985,Africa,5787,106
SLE,2021-27,238,6,Sierra Leone,7976985,Africa,6025,112
SLE,2021-28,155,3,Sierra Leone,7976985,Africa,6180,115
SLE,2021-29,42,3,Sierra Leone,7976985,Africa,6222,118
SLE,2021-30,55,2,Sierra Leone,7976985,Africa,6277,120
SLE,2021-31,32,1,Sierra Leone,7976985,Africa,6309,121
SLE,2021-32,27,0,Sierra Leone,7976985,Africa,6336,121
SLV,2020-13,27,0,El Salvador,6486201,America,27,0
SLV,2020-14,39,3,El Salvador,6486201,America,66,3
SLV,2020-15,56,3,El Salvador,6486201,America,122,6
SLV,2020-16,76,1,El Salvador,6486201,America,198,7
SLV,2020-17,97,1,El Salvador,6486201,America,295,8
SLV,2020-18,257,4,El Salvador,6486201,America,552,12
SLV,2020-19,403,5,El Salvador,6486201,America,955,17
SLV,2020-20,380,13,El Salvador,6486201,America,1335,30
SLV,2020-21,577,5,El Salvador,6486201,America,1912,35
SLV,2020-22,602,11,El Salvador,6486201,America,2514,46
SLV,2020-23,498,9,El Salvador,6486201,America,3012,55
SLV,2020-24,705,19,El Salvador,6486201,America,3717,74
SLV,2020-25,906,33,El Salvador,6486201,America,4623,107
SLV,2020-26,1308,57,El Salvador,6486201,America,5931,164
SLV,2020-27,1843,53,El Salvador,6486201,America,7774,217
SLV,2020-28,1897,50,El Salvador,6486201,America,9671,267
SLV,2020-29,2172,77,El Salvador,6486201,America,11843,344
SLV,2020-30,2784,64,El Salvador,6486201,America,14627,408
SLV,2020-31,2818,59,El Salvador,6486201,America,17445,467
SLV,2020-32,2975,96,El Salvador,6486201,America,20420,563
SLV,2020-33,2489,55,El Salvador,6486201,America,22909,618
SLV,2020-34,1710,51,El Salvador,6486201,America,24619,669
SLV,2020-35,1107,48,El Salvador,6486201,America,25726,717
SLV,2020-36,579,47,El Salvador,6486201,America,26305,764
SLV,2020-37,701,24,El Salvador,6486201,America,27006,788
SLV,2020-38,544,24,El Salvador,6486201,America,27550,812
SLV,2020-39,1077,14,El Salvador,6486201,America,28627,826
SLV,2020-40,820,37,El Salvador,6486201,America,29447,863
SLV,2020-41,746,31,El Salvador,6486201,America,30193,894
SLV,2020-42,1470,28,El Salvador,6486201,America,31663,922
SLV,2020-43,919,31,El Salvador,6486201,America,32582,953
SLV,2020-44,1430,30,El Salvador,6486201,America,34012,983
SLV,2020-45,1130,31,El Salvador,6486201,America,35142,1014
SLV,2020-46,1213,33,El Salvador,6486201,America,36355,1047
SLV,2020-47,1204,34,El Salvador,6486201,America,37559,1081
SLV,2020-48,843,33,El Salvador,6486201,America,38402,1114
SLV,2020-49,1940,50,El Salvador,6486201,America,40342,1164
SLV,2020-50,1535,41,El Salvador,6486201,America,41877,1205
SLV,2020-51,1892,52,El Salvador,6486201,America,43769,1257
SLV,2020-52,847,56,El Salvador,6486201,America,44616,1313
SLV,2020-53,2468,51,El Salvador,6486201,America,47084,1364
SLV,2021-01,1818,64,El Salvador,6486201,America,48902,1428
SLV,2021-02,2532,70,El Salvador,6486201,America,51434,1498
SLV,2021-03,2042,85,El Salvador,6486201,America,53476,1583
SLV,2021-04,1716,49,El Salvador,6486201,America,55192,1632
SLV,2021-05,1458,60,El Salvador,6486201,America,56650,1692
SLV,2021-06,1400,66,El Salvador,6486201,America,58050,1758
SLV,2021-07,1018,34,El Salvador,6486201,America,59068,1792
SLV,2021-08,795,77,El Salvador,6486201,America,59863,1869
SLV,2021-09,1673,54,El Salvador,6486201,America,61536,1923
SLV,2021-10,992,35,El Salvador,6486201,America,62528,1958
SLV,2021-11,813,28,El Salvador,6486201,America,63341,1986
SLV,2021-12,1087,20,El Salvador,6486201,America,64428,2006
SLV,2021-13,1060,24,El Salvador,6486201,America,65488,2030
SLV,2021-14,1325,27,El Salvador,6486201,America,66813,2057
SLV,2021-15,741,21,El Salvador,6486201,America,67554,2078
SLV,2021-16,1365,33,El Salvador,6486201,America,68919,2111
SLV,2021-17,805,26,El Salvador,6486201,America,69724,2137
SLV,2021-18,653,17,El Salvador,6486201,America,70377,2154
SLV,2021-19,1099,37,El Salvador,6486201,America,71476,2191
SLV,2021-20,1342,33,El Salvador,6486201,America,72818,2224
SLV,2021-21,881,28,El Salvador,6486201,America,73699,2252
SLV,2021-22,439,22,El Salvador,6486201,America,74138,2274
SLV,2021-23,1210,25,El Salvador,6486201,America,75348,2299
SLV,2021-24,2133,37,El Salvador,6486201,America,77481,2336
SLV,2021-25,1088,35,El Salvador,6486201,America,78569,2371
SLV,2021-26,1663,38,El Salvador,6486201,America,80232,2409
SLV,2021-27,1409,42,El Salvador,6486201,America,81641,2451
SLV,2021-28,1208,48,El Salvador,6486201,America,82849,2499
SLV,2021-29,1839,68,El Salvador,6486201,America,84688,2567
SLV,2021-30,2807,96,El Salvador,6486201,America,87495,2663
SLV,2021-31,873,79,El Salvador,6486201,America,88368,2742
SLV,2021-32,1758,62,El Salvador,6486201,America,90126,2804
SMR,2020-02,0,0,San Marino,34453,Europe,0,0
SMR,2020-03,0,0,San Marino,34453,Europe,0,0
SMR,2020-04,0,0,San Marino,34453,Europe,0,0
SMR,2020-05,0,0,San Marino,34453,Europe,0,0
SMR,2020-06,0,0,San Marino,34453,Europe,0,0
SMR,2020-07,0,0,San Marino,34453,Europe,0,0
SMR,2020-08,0,0,San Marino,34453,Europe,0,0
SMR,2020-09,8,1,San Marino,34453,Europe,8,1
SMR,2020-10,29,0,San Marino,34453,Europe,37,1
SMR,2020-11,61,6,San Marino,34453,Europe,98,7
SMR,2020-12,53,13,San Marino,34453,Europe,151,20
SMR,2020-13,78,4,San Marino,34453,Europe,229,24
SMR,2020-14,37,8,San Marino,34453,Europe,266,32
SMR,2020-15,90,3,San Marino,34453,Europe,356,35
SMR,2020-16,105,4,San Marino,34453,Europe,461,39
SMR,2020-17,77,2,San Marino,34453,Europe,538,41
SMR,2020-18,44,0,San Marino,34453,Europe,582,41
SMR,2020-19,46,0,San Marino,34453,Europe,628,41
SMR,2020-20,26,0,San Marino,34453,Europe,654,41
SMR,2020-21,11,1,San Marino,34453,Europe,665,42
SMR,2020-22,6,0,San Marino,34453,Europe,671,42
SMR,2020-23,16,0,San Marino,34453,Europe,687,42
SMR,2020-24,7,0,San Marino,34453,Europe,694,42
SMR,2020-25,2,0,San Marino,34453,Europe,696,42
SMR,2020-26,2,0,San Marino,34453,Europe,698,42
SMR,2020-27,0,0,San Marino,34453,Europe,698,42
SMR,2020-28,1,0,San Marino,34453,Europe,699,42
SMR,2020-29,0,0,San Marino,34453,Europe,699,42
SMR,2020-30,0,0,San Marino,34453,Europe,699,42
SMR,2020-31,0,0,San Marino,34453,Europe,699,42
SMR,2020-32,11,0,San Marino,34453,Europe,710,42
SMR,2020-33,0,0,San Marino,34453,Europe,710,42
SMR,2020-34,0,0,San Marino,34453,Europe,710,42
SMR,2020-35,0,0,San Marino,34453,Europe,710,42
SMR,2020-36,6,0,San Marino,34453,Europe,716,42
SMR,2020-37,6,0,San Marino,34453,Europe,722,42
SMR,2020-38,1,0,San Marino,34453,Europe,723,42
SMR,2020-39,4,0,San Marino,34453,Europe,727,42
SMR,2020-40,5,0,San Marino,34453,Europe,732,42
SMR,2020-41,20,0,San Marino,34453,Europe,752,42
SMR,2020-42,7,0,San Marino,34453,Europe,759,42
SMR,2020-43,60,0,San Marino,34453,Europe,819,42
SMR,2020-44,109,0,San Marino,34453,Europe,928,42
SMR,2020-45,115,0,San Marino,34453,Europe,1043,42
SMR,2020-46,210,0,San Marino,34453,Europe,1253,42
SMR,2020-47,142,1,San Marino,34453,Europe,1395,43
SMR,2020-48,191,2,San Marino,34453,Europe,1586,45
SMR,2020-49,203,3,San Marino,34453,Europe,1789,48
SMR,2020-50,158,3,San Marino,34453,Europe,1947,51
SMR,2020-51,160,4,San Marino,34453,Europe,2107,55
SMR,2020-52,168,2,San Marino,34453,Europe,2275,57
SMR,2020-53,218,5,San Marino,34453,Europe,2493,62
SMR,2021-01,174,2,San Marino,34453,Europe,2667,64
SMR,2021-02,120,1,San Marino,34453,Europe,2787,65
SMR,2021-03,87,0,San Marino,34453,Europe,2874,65
SMR,2021-04,151,2,San Marino,34453,Europe,3025,67
SMR,2021-05,112,2,San Marino,34453,Europe,3137,69
SMR,2021-06,180,3,San Marino,34453,Europe,3317,72
SMR,2021-07,155,0,San Marino,34453,Europe,3472,72
SMR,2021-08,244,2,San Marino,34453,Europe,3716,74
SMR,2021-09,219,2,San Marino,34453,Europe,3935,76
SMR,2021-10,0,0,San Marino,34453,Europe,3935,76
SMR,2021-11,421,3,San Marino,34453,Europe,4356,79
SMR,2021-12,0,0,San Marino,34453,Europe,4356,79
SMR,2021-13,419,5,San Marino,34453,Europe,4775,84
SMR,2021-14,187,2,San Marino,34453,Europe,4962,86
SMR,2021-15,64,1,San Marino,34453,Europe,5026,87
SMR,2021-16,29,3,San Marino,34453,Europe,5055,90
SMR,2021-17,12,0,San Marino,34453,Europe,5067,90
SMR,2021-18,0,0,San Marino,34453,Europe,5067,90
SMR,2021-19,20,0,San Marino,34453,Europe,5087,90
SMR,2021-20,2,0,San Marino,34453,Europe,5089,90
SMR,2021-21,1,0,San Marino,34453,Europe,5090,90
SMR,2021-22,0,0,San Marino,34453,Europe,5090,90
SMR,2021-23,0,0,San Marino,34453,Europe,5090,90
SMR,2021-24,1,0,San Marino,34453,Europe,5091,90
SMR,2021-25,1,0,San Marino,34453,Europe,5092,90
SMR,2021-26,0,0,San Marino,34453,Europe,5092,90
SMR,2021-27,0,0,San Marino,34453,Europe,5092,90
SMR,2021-28,4,0,San Marino,34453,Europe,5096,90
SMR,2021-29,20,0,San Marino,34453,Europe,5116,90
SMR,2021-30,31,0,San Marino,34453,Europe,5147,90
SMR,2021-31,47,0,San Marino,34453,Europe,5194,90
SMR,2021-32,37,0,San Marino,34453,Europe,5231,90
SOM,2020-13,2,0,Somalia,15893219,Africa,2,0
SOM,2020-14,4,0,Somalia,15893219,Africa,6,0
SOM,2020-15,18,2,Somalia,15893219,Africa,24,2
SOM,2020-16,139,5,Somalia,15893219,Africa,163,7
SOM,2020-17,272,16,Somalia,15893219,Africa,435,23
SOM,2020-18,286,9,Somalia,15893219,Africa,721,32
SOM,2020-19,332,19,Somalia,15893219,Africa,1053,51
SOM,2020-20,367,5,Somalia,15893219,Africa,1420,56
SOM,2020-21,173,5,Somalia,15893219,Africa,1593,61
SOM,2020-22,382,17,Somalia,15893219,Africa,1975,78
SOM,2020-23,358,5,Somalia,15893219,Africa,2333,83
SOM,2020-24,269,5,Somalia,15893219,Africa,2602,88
SOM,2020-25,176,2,Somalia,15893219,Africa,2778,90
SOM,2020-26,115,0,Somalia,15893219,Africa,2893,90
SOM,2020-27,103,2,Somalia,15893219,Africa,2996,92
SOM,2020-28,62,1,Somalia,15893219,Africa,3058,93
SOM,2020-29,60,0,Somalia,15893219,Africa,3118,93
SOM,2020-30,59,0,Somalia,15893219,Africa,3177,93
SOM,2020-31,34,0,Somalia,15893219,Africa,3211,93
SOM,2020-32,15,0,Somalia,15893219,Africa,3226,93
SOM,2020-33,29,0,Somalia,15893219,Africa,3255,93
SOM,2020-34,13,0,Somalia,15893219,Africa,3268,93
SOM,2020-35,41,4,Somalia,15893219,Africa,3309,97
SOM,2020-36,52,0,Somalia,15893219,Africa,3361,97
SOM,2020-37,27,1,Somalia,15893219,Africa,3388,98
SOM,2020-38,53,0,Somalia,15893219,Africa,3441,98
SOM,2020-39,146,1,Somalia,15893219,Africa,3587,99
SOM,2020-40,157,0,Somalia,15893219,Africa,3744,99
SOM,2020-41,119,0,Somalia,15893219,Africa,3863,99
SOM,2020-42,0,0,Somalia,15893219,Africa,3863,99
SOM,2020-43,77,5,Somalia,15893219,Africa,3940,104
SOM,2020-44,0,0,Somalia,15893219,Africa,3940,104
SOM,2020-45,288,3,Somalia,15893219,Africa,4228,107
SOM,2020-46,72,0,Somalia,15893219,Africa,4300,107
SOM,2020-47,144,6,Somalia,15893219,Africa,4444,113
SOM,2020-48,0,0,Somalia,15893219,Africa,4444,113
SOM,2020-49,80,8,Somalia,15893219,Africa,4524,121
SOM,2020-50,54,0,Somalia,15893219,Africa,4578,121
SOM,2020-51,83,3,Somalia,15893219,Africa,4661,124
SOM,2020-52,28,3,Somalia,15893219,Africa,4689,127
SOM,2020-53,24,3,Somalia,15893219,Africa,4713,130
SOM,2021-01,12,0,Somalia,15893219,Africa,4725,130
SOM,2021-02,18,0,Somalia,15893219,Africa,4743,130
SOM,2021-03,10,0,Somalia,15893219,Africa,4753,130
SOM,2021-04,30,0,Somalia,15893219,Africa,4783,130
SOM,2021-05,78,4,Somalia,15893219,Africa,4861,134
SOM,2021-06,321,18,Somalia,15893219,Africa,5182,152
SOM,2021-07,834,50,Somalia,15893219,Africa,6016,202
SOM,2021-08,1240,37,Somalia,15893219,Africa,7256,239
SOM,2021-09,1064,63,Somalia,15893219,Africa,8320,302
SOM,2021-10,869,65,Somalia,15893219,Africa,9189,367
SOM,2021-11,895,62,Somalia,15893219,Africa,10084,429
SOM,2021-12,591,50,Somalia,15893219,Africa,10675,479
SOM,2021-13,828,58,Somalia,15893219,Africa,11503,537
SOM,2021-14,767,68,Somalia,15893219,Africa,12270,605
SOM,2021-15,566,51,Somalia,15893219,Africa,12836,656
SOM,2021-16,975,46,Somalia,15893219,Africa,13811,702
SOM,2021-17,103,11,Somalia,15893219,Africa,13914,713
SOM,2021-18,453,32,Somalia,15893219,Africa,14367,745
SOM,2021-19,118,8,Somalia,15893219,Africa,14485,753
SOM,2021-20,108,5,Somalia,15893219,Africa,14593,758
SOM,2021-21,66,11,Somalia,15893219,Africa,14659,769
SOM,2021-22,0,0,Somalia,15893219,Africa,14659,769
SOM,2021-23,116,4,Somalia,15893219,Africa,14775,773
SOM,2021-24,0,0,Somalia,15893219,Africa,14775,773
SOM,2021-25,0,0,Somalia,15893219,Africa,14775,773
SOM,2021-26,194,2,Somalia,15893219,Africa,14969,775
SOM,2021-27,66,2,Somalia,15893219,Africa,15035,777
SOM,2021-28,49,4,Somalia,15893219,Africa,15084,781
SOM,2021-29,145,15,Somalia,15893219,Africa,15229,796
SOM,2021-30,226,17,Somalia,15893219,Africa,15455,813
SOM,2021-31,279,24,Somalia,15893219,Africa,15734,837
SOM,2021-32,530,41,Somalia,15893219,Africa,16264,878
SRB,2020-12,133,1,Serbia,6926705,Europe,133,1
SRB,2020-13,553,12,Serbia,6926705,Europe,686,13
SRB,2020-14,1167,38,Serbia,6926705,Europe,1853,51
SRB,2020-15,1722,29,Serbia,6926705,Europe,3575,80
SRB,2020-16,2688,42,Serbia,6926705,Europe,6263,122
SRB,2020-17,1724,34,Serbia,6926705,Europe,7987,156
SRB,2020-18,1422,37,Serbia,6926705,Europe,9409,193
SRB,2020-19,650,22,Serbia,6926705,Europe,10059,215
SRB,2020-20,496,15,Serbia,6926705,Europe,10555,230
SRB,2020-21,549,8,Serbia,6926705,Europe,11104,238
SRB,2020-22,253,5,Serbia,6926705,Europe,11357,243
SRB,2020-23,411,6,Serbia,6926705,Europe,11768,249
SRB,2020-24,487,5,Serbia,6926705,Europe,12255,254
SRB,2020-25,584,7,Serbia,6926705,Europe,12839,261
SRB,2020-26,1152,9,Serbia,6926705,Europe,13991,270
SRB,2020-27,2085,41,Serbia,6926705,Europe,16076,311
SRB,2020-28,2229,82,Serbia,6926705,Europe,18305,393
SRB,2020-29,2534,79,Serbia,6926705,Europe,20839,472
SRB,2020-30,2836,62,Serbia,6926705,Europe,23675,534
SRB,2020-31,2463,56,Serbia,6926705,Europe,26138,590
SRB,2020-32,1906,51,Serbia,6926705,Europe,28044,641
SRB,2020-33,1583,33,Serbia,6926705,Europe,29627,674
SRB,2020-34,975,24,Serbia,6926705,Europe,30602,698
SRB,2020-35,708,13,Serbia,6926705,Europe,31310,711
SRB,2020-36,540,13,Serbia,6926705,Europe,31850,724
SRB,2020-37,503,9,Serbia,6926705,Europe,32353,733
SRB,2020-38,500,8,Serbia,6926705,Europe,32853,741
SRB,2020-39,476,6,Serbia,6926705,Europe,33329,747
SRB,2020-40,517,7,Serbia,6926705,Europe,33846,754
SRB,2020-41,886,9,Serbia,6926705,Europe,34732,763
SRB,2020-42,1373,13,Serbia,6926705,Europe,36105,776
SRB,2020-43,3326,16,Serbia,6926705,Europe,39431,792
SRB,2020-44,8917,34,Serbia,6926705,Europe,48348,826
SRB,2020-45,14344,64,Serbia,6926705,Europe,62692,890
SRB,2020-46,21821,119,Serbia,6926705,Europe,84513,1009
SRB,2020-47,36552,190,Serbia,6926705,Europe,121065,1199
SRB,2020-48,48094,350,Serbia,6926705,Europe,169159,1549
SRB,2020-49,50438,400,Serbia,6926705,Europe,219597,1949
SRB,2020-50,46780,382,Serbia,6926705,Europe,266377,2331
SRB,2020-51,37315,402,Serbia,6926705,Europe,303692,2733
SRB,2020-52,24872,340,Serbia,6926705,Europe,328564,3073
SRB,2020-53,15251,252,Serbia,6926705,Europe,343815,3325
SRB,2021-01,15819,257,Serbia,6926705,Europe,359634,3582
SRB,2021-02,12844,168,Serbia,6926705,Europe,372478,3750
SRB,2021-03,11070,136,Serbia,6926705,Europe,383548,3886
SRB,2021-04,11660,134,Serbia,6926705,Europe,395208,4020
SRB,2021-05,12618,106,Serbia,6926705,Europe,407826,4126
SRB,2021-06,12998,104,Serbia,6926705,Europe,420824,4230
SRB,2021-07,15761,107,Serbia,6926705,Europe,436585,4337
SRB,2021-08,22619,106,Serbia,6926705,Europe,459204,4443
SRB,2021-09,26180,119,Serbia,6926705,Europe,485384,4562
SRB,2021-10,30838,157,Serbia,6926705,Europe,516222,4719
SRB,2021-11,34851,215,Serbia,6926705,Europe,551073,4934
SRB,2021-12,34378,256,Serbia,6926705,Europe,585451,5190
SRB,2021-13,32163,268,Serbia,6926705,Europe,617614,5458
SRB,2021-14,24539,277,Serbia,6926705,Europe,642153,5735
SRB,2021-15,20160,256,Serbia,6926705,Europe,662313,5991
SRB,2021-16,17299,236,Serbia,6926705,Europe,679612,6227
SRB,2021-17,12253,182,Serbia,6926705,Europe,691865,6409
SRB,2021-18,8488,149,Serbia,6926705,Europe,700353,6558
SRB,2021-19,6050,123,Serbia,6926705,Europe,706403,6681
SRB,2021-20,3481,96,Serbia,6926705,Europe,709884,6777
SRB,2021-21,2285,77,Serbia,6926705,Europe,712169,6854
SRB,2021-22,1454,63,Serbia,6926705,Europe,713623,6917
SRB,2021-23,1213,45,Serbia,6926705,Europe,714836,6962
SRB,2021-24,862,39,Serbia,6926705,Europe,715698,7001
SRB,2021-25,548,30,Serbia,6926705,Europe,716246,7031
SRB,2021-26,572,27,Serbia,6926705,Europe,716818,7058
SRB,2021-27,676,14,Serbia,6926705,Europe,717494,7072
SRB,2021-28,1041,11,Serbia,6926705,Europe,718535,7083
SRB,2021-29,1522,21,Serbia,6926705,Europe,720057,7104
SRB,2021-30,2109,14,Serbia,6926705,Europe,722166,7118
SRB,2021-31,3481,21,Serbia,6926705,Europe,725647,7139
SRB,2021-32,6342,28,Serbia,6926705,Europe,731989,7167
SSD,2020-15,3,0,South Sudan,11193729,Africa,3,0
SSD,2020-16,0,0,South Sudan,11193729,Africa,3,0
SSD,2020-17,2,0,South Sudan,11193729,Africa,5,0
SSD,2020-18,40,0,South Sudan,11193729,Africa,45,0
SSD,2020-19,110,0,South Sudan,11193729,Africa,155,0
SSD,2020-20,126,4,South Sudan,11193729,Africa,281,4
SSD,2020-21,281,2,South Sudan,11193729,Africa,562,6
SSD,2020-22,431,4,South Sudan,11193729,Africa,993,10
SSD,2020-23,323,4,South Sudan,11193729,Africa,1316,14
SSD,2020-24,376,13,South Sudan,11193729,Africa,1692,27
SSD,2020-25,189,7,South Sudan,11193729,Africa,1881,34
SSD,2020-26,107,2,South Sudan,11193729,Africa,1988,36
SSD,2020-27,47,2,South Sudan,11193729,Africa,2035,38
SSD,2020-28,103,3,South Sudan,11193729,Africa,2138,41
SSD,2020-29,61,2,South Sudan,11193729,Africa,2199,43
SSD,2020-30,62,2,South Sudan,11193729,Africa,2261,45
SSD,2020-31,167,1,South Sudan,11193729,Africa,2428,46
SSD,2020-32,41,1,South Sudan,11193729,Africa,2469,47
SSD,2020-33,19,0,South Sudan,11193729,Africa,2488,47
SSD,2020-34,10,0,South Sudan,11193729,Africa,2498,47
SSD,2020-35,20,0,South Sudan,11193729,Africa,2518,47
SSD,2020-36,25,1,South Sudan,11193729,Africa,2543,48
SSD,2020-37,34,1,South Sudan,11193729,Africa,2577,49
SSD,2020-38,64,0,South Sudan,11193729,Africa,2641,49
SSD,2020-39,44,0,South Sudan,11193729,Africa,2685,49
SSD,2020-40,40,1,South Sudan,11193729,Africa,2725,50
SSD,2020-41,51,5,South Sudan,11193729,Africa,2776,55
SSD,2020-42,65,0,South Sudan,11193729,Africa,2841,55
SSD,2020-43,41,1,South Sudan,11193729,Africa,2882,56
SSD,2020-44,43,3,South Sudan,11193729,Africa,2925,59
SSD,2020-45,29,0,South Sudan,11193729,Africa,2954,59
SSD,2020-46,48,0,South Sudan,11193729,Africa,3002,59
SSD,2020-47,44,1,South Sudan,11193729,Africa,3046,60
SSD,2020-48,62,1,South Sudan,11193729,Africa,3108,61
SSD,2020-49,72,1,South Sudan,11193729,Africa,3180,62
SSD,2020-50,42,0,South Sudan,11193729,Africa,3222,62
SSD,2020-51,5,0,South Sudan,11193729,Africa,3227,62
SSD,2020-52,263,0,South Sudan,11193729,Africa,3490,62
SSD,2020-53,98,1,South Sudan,11193729,Africa,3588,63
SSD,2021-01,73,0,South Sudan,11193729,Africa,3661,63
SSD,2021-02,8,0,South Sudan,11193729,Africa,3669,63
SSD,2021-03,118,1,South Sudan,11193729,Africa,3787,64
SSD,2021-04,249,0,South Sudan,11193729,Africa,4036,64
SSD,2021-05,572,2,South Sudan,11193729,Africa,4608,66
SSD,2021-06,804,8,South Sudan,11193729,Africa,5412,74
SSD,2021-07,1170,12,South Sudan,11193729,Africa,6582,86
SSD,2021-08,1343,7,South Sudan,11193729,Africa,7925,93
SSD,2021-09,944,9,South Sudan,11193729,Africa,8869,102
SSD,2021-10,743,4,South Sudan,11193729,Africa,9612,106
SSD,2021-11,277,0,South Sudan,11193729,Africa,9889,106
SSD,2021-12,213,2,South Sudan,11193729,Africa,10102,108
SSD,2021-13,178,5,South Sudan,11193729,Africa,10280,113
SSD,2021-14,100,1,South Sudan,11193729,Africa,10380,114
SSD,2021-15,97,0,South Sudan,11193729,Africa,10477,114
SSD,2021-16,60,0,South Sudan,11193729,Africa,10537,114
SSD,2021-17,64,1,South Sudan,11193729,Africa,10601,115
SSD,2021-18,39,0,South Sudan,11193729,Africa,10640,115
SSD,2021-19,11,0,South Sudan,11193729,Africa,10651,115
SSD,2021-20,18,0,South Sudan,11193729,Africa,10669,115
SSD,2021-21,18,0,South Sudan,11193729,Africa,10687,115
SSD,2021-22,0,0,South Sudan,11193729,Africa,10687,115
SSD,2021-23,0,0,South Sudan,11193729,Africa,10687,115
SSD,2021-24,76,0,South Sudan,11193729,Africa,10763,115
SSD,2021-25,60,1,South Sudan,11193729,Africa,10823,116
SSD,2021-26,52,1,South Sudan,11193729,Africa,10875,117
SSD,2021-27,15,0,South Sudan,11193729,Africa,10890,117
SSD,2021-28,26,0,South Sudan,11193729,Africa,10916,117
SSD,2021-29,97,1,South Sudan,11193729,Africa,11013,118
SSD,2021-30,49,1,South Sudan,11193729,Africa,11062,119
SSD,2021-31,58,1,South Sudan,11193729,Africa,11120,120
SSD,2021-32,74,0,South Sudan,11193729,Africa,11194,120
STP,2020-16,0,0,Sao Tome And Principe,219161,Africa,0,0
STP,2020-17,4,0,Sao Tome And Principe,219161,Africa,4,0
STP,2020-18,10,1,Sao Tome And Principe,219161,Africa,14,1
STP,2020-19,190,4,Sao Tome And Principe,219161,Africa,204,5
STP,2020-20,27,2,Sao Tome And Principe,219161,Africa,231,7
STP,2020-21,64,2,Sao Tome And Principe,219161,Africa,295,9
STP,2020-22,184,3,Sao Tome And Principe,219161,Africa,479,12
STP,2020-23,31,0,Sao Tome And Principe,219161,Africa,510,12
STP,2020-24,147,0,Sao Tome And Principe,219161,Africa,657,12
STP,2020-25,37,0,Sao Tome And Principe,219161,Africa,694,12
STP,2020-26,15,1,Sao Tome And Principe,219161,Africa,709,13
STP,2020-27,7,0,Sao Tome And Principe,219161,Africa,716,13
STP,2020-28,9,1,Sao Tome And Principe,219161,Africa,725,14
STP,2020-29,17,0,Sao Tome And Principe,219161,Africa,742,14
STP,2020-30,117,0,Sao Tome And Principe,219161,Africa,859,14
STP,2020-31,11,1,Sao Tome And Principe,219161,Africa,870,15
STP,2020-32,4,0,Sao Tome And Principe,219161,Africa,874,15
STP,2020-33,7,0,Sao Tome And Principe,219161,Africa,881,15
STP,2020-34,7,0,Sao Tome And Principe,219161,Africa,888,15
STP,2020-35,4,0,Sao Tome And Principe,219161,Africa,892,15
STP,2020-36,2,0,Sao Tome And Principe,219161,Africa,894,15
STP,2020-37,8,0,Sao Tome And Principe,219161,Africa,902,15
STP,2020-38,2,0,Sao Tome And Principe,219161,Africa,904,15
STP,2020-39,3,0,Sao Tome And Principe,219161,Africa,907,15
STP,2020-40,2,0,Sao Tome And Principe,219161,Africa,909,15
STP,2020-41,16,0,Sao Tome And Principe,219161,Africa,925,15
STP,2020-42,4,0,Sao Tome And Principe,219161,Africa,929,15
STP,2020-43,7,0,Sao Tome And Principe,219161,Africa,936,15
STP,2020-44,9,1,Sao Tome And Principe,219161,Africa,945,16
STP,2020-45,13,0,Sao Tome And Principe,219161,Africa,958,16
STP,2020-46,3,0,Sao Tome And Principe,219161,Africa,961,16
STP,2020-47,14,1,Sao Tome And Principe,219161,Africa,975,17
STP,2020-48,10,0,Sao Tome And Principe,219161,Africa,985,17
STP,2020-49,10,0,Sao Tome And Principe,219161,Africa,995,17
STP,2020-50,10,0,Sao Tome And Principe,219161,Africa,1005,17
STP,2020-51,3,0,Sao Tome And Principe,219161,Africa,1008,17
STP,2020-52,2,0,Sao Tome And Principe,219161,Africa,1010,17
STP,2020-53,10,0,Sao Tome And Principe,219161,Africa,1020,17
STP,2021-01,42,0,Sao Tome And Principe,219161,Africa,1062,17
STP,2021-02,76,0,Sao Tome And Principe,219161,Africa,1138,17
STP,2021-03,47,0,Sao Tome And Principe,219161,Africa,1185,17
STP,2021-04,58,0,Sao Tome And Principe,219161,Africa,1243,17
STP,2021-05,92,1,Sao Tome And Principe,219161,Africa,1335,18
STP,2021-06,143,1,Sao Tome And Principe,219161,Africa,1478,19
STP,2021-07,128,2,Sao Tome And Principe,219161,Africa,1606,21
STP,2021-08,176,8,Sao Tome And Principe,219161,Africa,1782,29
STP,2021-09,164,3,Sao Tome And Principe,219161,Africa,1946,32
STP,2021-10,128,0,Sao Tome And Principe,219161,Africa,2074,32
STP,2021-11,67,2,Sao Tome And Principe,219161,Africa,2141,34
STP,2021-12,67,0,Sao Tome And Principe,219161,Africa,2208,34
STP,2021-13,28,1,Sao Tome And Principe,219161,Africa,2236,35
STP,2021-14,26,0,Sao Tome And Principe,219161,Africa,2262,35
STP,2021-15,9,0,Sao Tome And Principe,219161,Africa,2271,35
STP,2021-16,23,0,Sao Tome And Principe,219161,Africa,2294,35
STP,2021-17,12,0,Sao Tome And Principe,219161,Africa,2306,35
STP,2021-18,8,0,Sao Tome And Principe,219161,Africa,2314,35
STP,2021-19,9,0,Sao Tome And Principe,219161,Africa,2323,35
STP,2021-20,11,2,Sao Tome And Principe,219161,Africa,2334,37
STP,2021-21,7,0,Sao Tome And Principe,219161,Africa,2341,37
STP,2021-22,8,0,Sao Tome And Principe,219161,Africa,2349,37
STP,2021-23,5,0,Sao Tome And Principe,219161,Africa,2354,37
STP,2021-24,4,0,Sao Tome And Principe,219161,Africa,2358,37
STP,2021-25,3,0,Sao Tome And Principe,219161,Africa,2361,37
STP,2021-26,11,0,Sao Tome And Principe,219161,Africa,2372,37
STP,2021-27,15,0,Sao Tome And Principe,219161,Africa,2387,37
STP,2021-28,19,0,Sao Tome And Principe,219161,Africa,2406,37
STP,2021-29,11,0,Sao Tome And Principe,219161,Africa,2417,37
STP,2021-30,33,0,Sao Tome And Principe,219161,Africa,2450,37
STP,2021-31,16,0,Sao Tome And Principe,219161,Africa,2466,37
STP,2021-32,18,0,Sao Tome And Principe,219161,Africa,2484,37
SUR,2020-13,3,0,Suriname,586634,America,3,0
SUR,2020-14,2,1,Suriname,586634,America,5,1
SUR,2020-15,0,0,Suriname,586634,America,5,1
SUR,2020-16,0,0,Suriname,586634,America,5,1
SUR,2020-17,0,0,Suriname,586634,America,5,1
SUR,2020-18,0,0,Suriname,586634,America,5,1
SUR,2020-19,0,0,Suriname,586634,America,5,1
SUR,2020-20,0,0,Suriname,586634,America,5,1
SUR,2020-21,1,0,Suriname,586634,America,6,1
SUR,2020-22,12,0,Suriname,586634,America,18,1
SUR,2020-23,99,0,Suriname,586634,America,117,1
SUR,2020-24,86,2,Suriname,586634,America,203,3
SUR,2020-25,106,5,Suriname,586634,America,309,8
SUR,2020-26,176,3,Suriname,586634,America,485,11
SUR,2020-27,104,3,Suriname,586634,America,589,14
SUR,2020-28,147,4,Suriname,586634,America,736,18
SUR,2020-29,288,3,Suriname,586634,America,1024,21
SUR,2020-30,410,2,Suriname,586634,America,1434,23
SUR,2020-31,410,4,Suriname,586634,America,1844,27
SUR,2020-32,542,2,Suriname,586634,America,2386,29
SUR,2020-33,625,18,Suriname,586634,America,3011,47
SUR,2020-34,591,11,Suriname,586634,America,3602,58
SUR,2020-35,402,9,Suriname,586634,America,4004,67
SUR,2020-36,337,18,Suriname,586634,America,4341,85
SUR,2020-37,236,8,Suriname,586634,America,4577,93
SUR,2020-38,141,4,Suriname,586634,America,4718,97
SUR,2020-39,112,5,Suriname,586634,America,4830,102
SUR,2020-40,106,4,Suriname,586634,America,4936,106
SUR,2020-41,110,1,Suriname,586634,America,5046,107
SUR,2020-42,79,2,Suriname,586634,America,5125,109
SUR,2020-43,40,0,Suriname,586634,America,5165,109
SUR,2020-44,40,2,Suriname,586634,America,5205,111
SUR,2020-45,29,2,Suriname,586634,America,5234,113
SUR,2020-46,35,1,Suriname,586634,America,5269,114
SUR,2020-47,22,2,Suriname,586634,America,5291,116
SUR,2020-48,16,1,Suriname,586634,America,5307,117
SUR,2020-49,12,0,Suriname,586634,America,5319,117
SUR,2020-50,29,0,Suriname,586634,America,5348,117
SUR,2020-51,230,1,Suriname,586634,America,5578,118
SUR,2020-52,430,2,Suriname,586634,America,6008,120
SUR,2020-53,380,3,Suriname,586634,America,6388,123
SUR,2021-01,671,15,Suriname,586634,America,7059,138
SUR,2021-02,560,7,Suriname,586634,America,7619,145
SUR,2021-03,488,4,Suriname,586634,America,8107,149
SUR,2021-04,337,7,Suriname,586634,America,8444,156
SUR,2021-05,241,6,Suriname,586634,America,8685,162
SUR,2021-06,121,5,Suriname,586634,America,8806,167
SUR,2021-07,58,2,Suriname,586634,America,8864,169
SUR,2021-08,64,4,Suriname,586634,America,8928,173
SUR,2021-09,47,2,Suriname,586634,America,8975,175
SUR,2021-10,48,1,Suriname,586634,America,9023,176
SUR,2021-11,39,1,Suriname,586634,America,9062,177
SUR,2021-12,37,0,Suriname,586634,America,9099,177
SUR,2021-13,70,0,Suriname,586634,America,9169,177
SUR,2021-14,142,5,Suriname,586634,America,9311,182
SUR,2021-15,301,6,Suriname,586634,America,9612,188
SUR,2021-16,540,13,Suriname,586634,America,10152,201
SUR,2021-17,386,6,Suriname,586634,America,10538,207
SUR,2021-18,670,11,Suriname,586634,America,11208,218
SUR,2021-19,894,12,Suriname,586634,America,12102,230
SUR,2021-20,1195,26,Suriname,586634,America,13297,256
SUR,2021-21,1652,46,Suriname,586634,America,14949,302
SUR,2021-22,1832,53,Suriname,586634,America,16781,355
SUR,2021-23,1813,57,Suriname,586634,America,18594,412
SUR,2021-24,1542,55,Suriname,586634,America,20136,467
SUR,2021-25,1219,45,Suriname,586634,America,21355,512
SUR,2021-26,1020,33,Suriname,586634,America,22375,545
SUR,2021-27,1083,42,Suriname,586634,America,23458,587
SUR,2021-28,849,27,Suriname,586634,America,24307,614
SUR,2021-29,591,20,Suriname,586634,America,24898,634
SUR,2021-30,536,18,Suriname,586634,America,25434,652
SUR,2021-31,607,15,Suriname,586634,America,26041,667
SUR,2021-32,595,18,Suriname,586634,America,26636,685
SVK,2020-11,89,0,Slovakia,5457873,Europe,89,0
SVK,2020-12,120,0,Slovakia,5457873,Europe,209,0
SVK,2020-13,184,1,Slovakia,5457873,Europe,393,1
SVK,2020-14,282,1,Slovakia,5457873,Europe,675,2
SVK,2020-15,181,4,Slovakia,5457873,Europe,856,6
SVK,2020-16,381,8,Slovakia,5457873,Europe,1237,14
SVK,2020-17,147,7,Slovakia,5457873,Europe,1384,21
SVK,2020-18,38,4,Slovakia,5457873,Europe,1422,25
SVK,2020-19,40,2,Slovakia,5457873,Europe,1462,27
SVK,2020-20,27,1,Slovakia,5457873,Europe,1489,28
SVK,2020-21,19,0,Slovakia,5457873,Europe,1508,28
SVK,2020-22,10,0,Slovakia,5457873,Europe,1518,28
SVK,2020-23,8,0,Slovakia,5457873,Europe,1526,28
SVK,2020-24,28,0,Slovakia,5457873,Europe,1554,28
SVK,2020-25,46,0,Slovakia,5457873,Europe,1600,28
SVK,2020-26,80,0,Slovakia,5457873,Europe,1680,28
SVK,2020-27,111,0,Slovakia,5457873,Europe,1791,28
SVK,2020-28,129,0,Slovakia,5457873,Europe,1920,28
SVK,2020-29,131,0,Slovakia,5457873,Europe,2051,28
SVK,2020-30,187,0,Slovakia,5457873,Europe,2238,28
SVK,2020-31,172,1,Slovakia,5457873,Europe,2410,29
SVK,2020-32,273,2,Slovakia,5457873,Europe,2683,31
SVK,2020-33,332,2,Slovakia,5457873,Europe,3015,33
SVK,2020-34,514,0,Slovakia,5457873,Europe,3529,33
SVK,2020-35,506,0,Slovakia,5457873,Europe,4035,33
SVK,2020-36,846,4,Slovakia,5457873,Europe,4881,37
SVK,2020-37,972,1,Slovakia,5457873,Europe,5853,38
SVK,2020-38,1409,3,Slovakia,5457873,Europe,7262,41
SVK,2020-39,2872,7,Slovakia,5457873,Europe,10134,48
SVK,2020-40,4548,7,Slovakia,5457873,Europe,14682,55
SVK,2020-41,7731,11,Slovakia,5457873,Europe,22413,66
SVK,2020-42,11507,32,Slovakia,5457873,Europe,33920,98
SVK,2020-43,16219,86,Slovakia,5457873,Europe,50139,184
SVK,2020-44,21565,77,Slovakia,5457873,Europe,71704,261
SVK,2020-45,14834,153,Slovakia,5457873,Europe,86538,414
SVK,2020-46,11806,165,Slovakia,5457873,Europe,98344,579
SVK,2020-47,13371,153,Slovakia,5457873,Europe,111715,732
SVK,2020-48,16236,166,Slovakia,5457873,Europe,127951,898
SVK,2020-49,22399,186,Slovakia,5457873,Europe,150350,1084
SVK,2020-50,34325,225,Slovakia,5457873,Europe,184675,1309
SVK,2020-51,45682,377,Slovakia,5457873,Europe,230357,1686
SVK,2020-52,34717,379,Slovakia,5457873,Europe,265074,2065
SVK,2020-53,49036,592,Slovakia,5457873,Europe,314110,2657
SVK,2021-01,38413,506,Slovakia,5457873,Europe,352523,3163
SVK,2021-02,29639,574,Slovakia,5457873,Europe,382162,3737
SVK,2021-03,36606,624,Slovakia,5457873,Europe,418768,4361
SVK,2021-04,34900,528,Slovakia,5457873,Europe,453668,4889
SVK,2021-05,38175,613,Slovakia,5457873,Europe,491843,5502
SVK,2021-06,36474,666,Slovakia,5457873,Europe,528317,6168
SVK,2021-07,39148,607,Slovakia,5457873,Europe,567465,6775
SVK,2021-08,38661,714,Slovakia,5457873,Europe,606126,7489
SVK,2021-09,33844,657,Slovakia,5457873,Europe,639970,8146
SVK,2021-10,28402,592,Slovakia,5457873,Europe,668372,8738
SVK,2021-11,22841,523,Slovakia,5457873,Europe,691213,9261
SVK,2021-12,19289,458,Slovakia,5457873,Europe,710502,9719
SVK,2021-13,13440,524,Slovakia,5457873,Europe,723942,10243
SVK,2021-14,12657,555,Slovakia,5457873,Europe,736599,10798
SVK,2021-15,9673,506,Slovakia,5457873,Europe,746272,11304
SVK,2021-16,8362,307,Slovakia,5457873,Europe,754634,11611
SVK,2021-17,6887,275,Slovakia,5457873,Europe,761521,11886
SVK,2021-18,4818,210,Slovakia,5457873,Europe,766339,12096
SVK,2021-19,3562,166,Slovakia,5457873,Europe,769901,12262
SVK,2021-20,2472,50,Slovakia,5457873,Europe,772373,12312
SVK,2021-21,1873,54,Slovakia,5457873,Europe,774246,12366
SVK,2021-22,1493,64,Slovakia,5457873,Europe,775739,12430
SVK,2021-23,902,26,Slovakia,5457873,Europe,776641,12456
SVK,2021-24,560,46,Slovakia,5457873,Europe,777201,12502
SVK,2021-25,435,8,Slovakia,5457873,Europe,777636,12510
SVK,2021-26,238,6,Slovakia,5457873,Europe,777874,12516
SVK,2021-27,276,7,Slovakia,5457873,Europe,778150,12523
SVK,2021-28,282,11,Slovakia,5457873,Europe,778432,12534
SVK,2021-29,419,0,Slovakia,5457873,Europe,778851,12534
SVK,2021-30,487,7,Slovakia,5457873,Europe,779338,12541
SVK,2021-31,518,3,Slovakia,5457873,Europe,779856,12544
SVK,2021-32,418,0,Slovakia,5457873,Europe,780274,12544
SVN,2020-11,203,0,Slovenia,2095861,Europe,203,0
SVN,2020-12,195,1,Slovenia,2095861,Europe,398,1
SVN,2020-13,316,10,Slovenia,2095861,Europe,714,11
SVN,2020-14,267,17,Slovenia,2095861,Europe,981,28
SVN,2020-15,208,25,Slovenia,2095861,Europe,1189,53
SVN,2020-16,125,21,Slovenia,2095861,Europe,1314,74
SVN,2020-17,77,8,Slovenia,2095861,Europe,1391,82
SVN,2020-18,32,14,Slovenia,2095861,Europe,1423,96
SVN,2020-19,21,6,Slovenia,2095861,Europe,1444,102
SVN,2020-20,6,2,Slovenia,2095861,Europe,1450,104
SVN,2020-21,3,2,Slovenia,2095861,Europe,1453,106
SVN,2020-22,4,2,Slovenia,2095861,Europe,1457,108
SVN,2020-23,12,0,Slovenia,2095861,Europe,1469,108
SVN,2020-24,10,1,Slovenia,2095861,Europe,1479,109
SVN,2020-25,25,0,Slovenia,2095861,Europe,1504,109
SVN,2020-26,61,2,Slovenia,2095861,Europe,1565,111
SVN,2020-27,119,0,Slovenia,2095861,Europe,1684,111
SVN,2020-28,141,0,Slovenia,2095861,Europe,1825,111
SVN,2020-29,105,0,Slovenia,2095861,Europe,1930,111
SVN,2020-30,136,4,Slovenia,2095861,Europe,2066,115
SVN,2020-31,98,2,Slovenia,2095861,Europe,2164,117
SVN,2020-32,69,3,Slovenia,2095861,Europe,2233,120
SVN,2020-33,167,4,Slovenia,2095861,Europe,2400,124
SVN,2020-34,235,3,Slovenia,2095861,Europe,2635,127
SVN,2020-35,214,1,Slovenia,2095861,Europe,2849,128
SVN,2020-36,309,2,Slovenia,2095861,Europe,3158,130
SVN,2020-37,528,1,Slovenia,2095861,Europe,3686,131
SVN,2020-38,718,2,Slovenia,2095861,Europe,4404,133
SVN,2020-39,930,3,Slovenia,2095861,Europe,5334,136
SVN,2020-40,1148,4,Slovenia,2095861,Europe,6482,140
SVN,2020-41,2167,2,Slovenia,2095861,Europe,8649,142
SVN,2020-42,4479,19,Slovenia,2095861,Europe,13128,161
SVN,2020-43,9806,22,Slovenia,2095861,Europe,22934,183
SVN,2020-44,12699,53,Slovenia,2095861,Europe,35633,236
SVN,2020-45,9512,146,Slovenia,2095861,Europe,45145,382
SVN,2020-46,9881,129,Slovenia,2095861,Europe,55026,511
SVN,2020-47,10266,152,Slovenia,2095861,Europe,65292,663
SVN,2020-48,10073,264,Slovenia,2095861,Europe,75365,927
SVN,2020-49,10424,331,Slovenia,2095861,Europe,85789,1258
SVN,2020-50,10509,954,Slovenia,2095861,Europe,96298,2212
SVN,2020-51,9585,156,Slovenia,2095861,Europe,105883,2368
SVN,2020-52,9428,216,Slovenia,2095861,Europe,115311,2584
SVN,2020-53,10531,307,Slovenia,2095861,Europe,125842,2891
SVN,2021-01,13855,256,Slovenia,2095861,Europe,139697,3147
SVN,2021-02,9721,224,Slovenia,2095861,Europe,149418,3371
SVN,2021-03,8705,210,Slovenia,2095861,Europe,158123,3581
SVN,2021-04,8334,171,Slovenia,2095861,Europe,166457,3752
SVN,2021-05,7527,139,Slovenia,2095861,Europe,173984,3891
SVN,2021-06,5482,86,Slovenia,2095861,Europe,179466,3977
SVN,2021-07,5285,80,Slovenia,2095861,Europe,184751,4057
SVN,2021-08,5557,56,Slovenia,2095861,Europe,190308,4113
SVN,2021-09,5357,56,Slovenia,2095861,Europe,195665,4169
SVN,2021-10,4898,51,Slovenia,2095861,Europe,200563,4220
SVN,2021-11,5738,39,Slovenia,2095861,Europe,206301,4259
SVN,2021-12,6648,52,Slovenia,2095861,Europe,212949,4311
SVN,2021-13,7460,58,Slovenia,2095861,Europe,220409,4369
SVN,2021-14,6362,42,Slovenia,2095861,Europe,226771,4411
SVN,2021-15,5526,50,Slovenia,2095861,Europe,232297,4461
SVN,2021-16,4906,60,Slovenia,2095861,Europe,237203,4521
SVN,2021-17,4664,48,Slovenia,2095861,Europe,241867,4569
SVN,2021-18,4348,48,Slovenia,2095861,Europe,246215,4617
SVN,2021-19,3193,35,Slovenia,2095861,Europe,249408,4652
SVN,2021-20,2349,23,Slovenia,2095861,Europe,251757,4675
SVN,2021-21,1949,18,Slovenia,2095861,Europe,253706,4693
SVN,2021-22,1710,14,Slovenia,2095861,Europe,255416,4707
SVN,2021-23,1035,14,Slovenia,2095861,Europe,256451,4721
SVN,2021-24,599,20,Slovenia,2095861,Europe,257050,4741
SVN,2021-25,222,7,Slovenia,2095861,Europe,257272,4748
SVN,2021-26,189,5,Slovenia,2095861,Europe,257461,4753
SVN,2021-27,482,6,Slovenia,2095861,Europe,257943,4759
SVN,2021-28,327,1,Slovenia,2095861,Europe,258270,4760
SVN,2021-29,493,1,Slovenia,2095861,Europe,258763,4761
SVN,2021-30,707,1,Slovenia,2095861,Europe,259470,4762
SVN,2021-31,885,0,Slovenia,2095861,Europe,260355,4762
SVN,2021-32,1433,2,Slovenia,2095861,Europe,261788,4764
SWE,2020-02,0,0,Sweden,10327589,Europe,0,0
SWE,2020-03,0,0,Sweden,10327589,Europe,0,0
SWE,2020-04,0,0,Sweden,10327589,Europe,0,0
SWE,2020-05,0,0,Sweden,10327589,Europe,0,0
SWE,2020-06,1,0,Sweden,10327589,Europe,1,0
SWE,2020-07,0,0,Sweden,10327589,Europe,1,0
SWE,2020-08,0,0,Sweden,10327589,Europe,1,0
SWE,2020-09,13,0,Sweden,10327589,Europe,14,0
SWE,2020-10,211,0,Sweden,10327589,Europe,225,0
SWE,2020-11,838,42,Sweden,10327589,Europe,1063,42
SWE,2020-12,924,44,Sweden,10327589,Europe,1987,86
SWE,2020-13,1957,190,Sweden,10327589,Europe,3944,276
SWE,2020-14,3229,451,Sweden,10327589,Europe,7173,727
SWE,2020-15,3740,664,Sweden,10327589,Europe,10913,1391
SWE,2020-16,3752,657,Sweden,10327589,Europe,14665,2048
SWE,2020-17,4203,546,Sweden,10327589,Europe,18868,2594
SWE,2020-18,3832,543,Sweden,10327589,Europe,22700,3137
SWE,2020-19,4153,509,Sweden,10327589,Europe,26853,3646
SWE,2020-20,3869,380,Sweden,10327589,Europe,30722,4026
SWE,2020-21,3659,360,Sweden,10327589,Europe,34381,4386
SWE,2020-22,4280,272,Sweden,10327589,Europe,38661,4658
SWE,2020-23,6021,246,Sweden,10327589,Europe,44682,4904
SWE,2020-24,7123,234,Sweden,10327589,Europe,51805,5138
SWE,2020-25,7073,200,Sweden,10327589,Europe,58878,5338
SWE,2020-26,7455,138,Sweden,10327589,Europe,66333,5476
SWE,2020-27,4279,98,Sweden,10327589,Europe,70612,5574
SWE,2020-28,2179,84,Sweden,10327589,Europe,72791,5658
SWE,2020-29,1622,57,Sweden,10327589,Europe,74413,5715
SWE,2020-30,1316,30,Sweden,10327589,Europe,75729,5745
SWE,2020-31,1556,18,Sweden,10327589,Europe,77285,5763
SWE,2020-32,2014,18,Sweden,10327589,Europe,79299,5781
SWE,2020-33,2052,16,Sweden,10327589,Europe,81351,5797
SWE,2020-34,1687,19,Sweden,10327589,Europe,83038,5816
SWE,2020-35,1200,10,Sweden,10327589,Europe,84238,5826
SWE,2020-36,1332,12,Sweden,10327589,Europe,85570,5838
SWE,2020-37,1592,13,Sweden,10327589,Europe,87162,5851
SWE,2020-38,2080,12,Sweden,10327589,Europe,89242,5863
SWE,2020-39,2919,11,Sweden,10327589,Europe,92161,5874
SWE,2020-40,3642,17,Sweden,10327589,Europe,95803,5891
SWE,2020-41,4278,22,Sweden,10327589,Europe,100081,5913
SWE,2020-42,5620,16,Sweden,10327589,Europe,105701,5929
SWE,2020-43,9155,43,Sweden,10327589,Europe,114856,5972
SWE,2020-44,18474,82,Sweden,10327589,Europe,133330,6054
SWE,2020-45,25405,157,Sweden,10327589,Europe,158735,6211
SWE,2020-46,31319,235,Sweden,10327589,Europe,190054,6446
SWE,2020-47,31944,332,Sweden,10327589,Europe,221998,6778
SWE,2020-48,35560,417,Sweden,10327589,Europe,257558,7195
SWE,2020-49,36837,476,Sweden,10327589,Europe,294395,7671
SWE,2020-50,43631,501,Sweden,10327589,Europe,338026,8172
SWE,2020-51,46177,645,Sweden,10327589,Europe,384203,8817
SWE,2020-52,37134,643,Sweden,10327589,Europe,421337,9460
SWE,2020-53,41324,663,Sweden,10327589,Europe,462661,10123
SWE,2021-01,39457,644,Sweden,10327589,Europe,502118,10767
SWE,2021-02,28947,596,Sweden,10327589,Europe,531065,11363
SWE,2021-03,23231,513,Sweden,10327589,Europe,554296,11876
SWE,2021-04,20661,389,Sweden,10327589,Europe,574957,12265
SWE,2021-05,19606,269,Sweden,10327589,Europe,594563,12534
SWE,2021-06,21284,205,Sweden,10327589,Europe,615847,12739
SWE,2021-07,23615,171,Sweden,10327589,Europe,639462,12910
SWE,2021-08,26690,145,Sweden,10327589,Europe,666152,13055
SWE,2021-09,27751,128,Sweden,10327589,Europe,693903,13183
SWE,2021-10,28559,139,Sweden,10327589,Europe,722462,13322
SWE,2021-11,33036,127,Sweden,10327589,Europe,755498,13449
SWE,2021-12,37884,125,Sweden,10327589,Europe,793382,13574
SWE,2021-13,38392,141,Sweden,10327589,Europe,831774,13715
SWE,2021-14,41155,132,Sweden,10327589,Europe,872929,13847
SWE,2021-15,41043,140,Sweden,10327589,Europe,913972,13987
SWE,2021-16,36034,131,Sweden,10327589,Europe,950006,14118
SWE,2021-17,35307,112,Sweden,10327589,Europe,985313,14230
SWE,2021-18,33682,102,Sweden,10327589,Europe,1018995,14332
SWE,2021-19,25915,110,Sweden,10327589,Europe,1044910,14442
SWE,2021-20,18172,69,Sweden,10327589,Europe,1063082,14511
SWE,2021-21,7974,46,Sweden,10327589,Europe,1071056,14557
SWE,2021-22,9103,38,Sweden,10327589,Europe,1080159,14595
SWE,2021-23,4395,22,Sweden,10327589,Europe,1084554,14617
SWE,2021-24,2847,16,Sweden,10327589,Europe,1087401,14633
SWE,2021-25,1981,9,Sweden,10327589,Europe,1089382,14642
SWE,2021-26,1869,7,Sweden,10327589,Europe,1091251,14649
SWE,2021-27,1511,3,Sweden,10327589,Europe,1092762,14652
SWE,2021-28,1882,1,Sweden,10327589,Europe,1094644,14653
SWE,2021-29,2660,3,Sweden,10327589,Europe,1097304,14656
SWE,2021-30,3458,2,Sweden,10327589,Europe,1100762,14658
SWE,2021-31,4603,1,Sweden,10327589,Europe,1105365,14659
SWE,2021-32,5812,0,Sweden,10327589,Europe,1111177,14659
SWZ,2020-12,3,0,Eswatini,1160164,Africa,3,0
SWZ,2020-13,5,0,Eswatini,1160164,Africa,8,0
SWZ,2020-14,0,0,Eswatini,1160164,Africa,8,0
SWZ,2020-15,5,0,Eswatini,1160164,Africa,13,0
SWZ,2020-16,8,1,Eswatini,1160164,Africa,21,1
SWZ,2020-17,37,0,Eswatini,1160164,Africa,58,1
SWZ,2020-18,53,0,Eswatini,1160164,Africa,111,1
SWZ,2020-19,60,1,Eswatini,1160164,Africa,171,2
SWZ,2020-20,31,0,Eswatini,1160164,Africa,202,2
SWZ,2020-21,47,0,Eswatini,1160164,Africa,249,2
SWZ,2020-22,35,0,Eswatini,1160164,Africa,284,2
SWZ,2020-23,48,1,Eswatini,1160164,Africa,332,3
SWZ,2020-24,157,1,Eswatini,1160164,Africa,489,4
SWZ,2020-25,145,1,Eswatini,1160164,Africa,634,5
SWZ,2020-26,146,6,Eswatini,1160164,Africa,780,11
SWZ,2020-27,207,2,Eswatini,1160164,Africa,987,13
SWZ,2020-28,363,7,Eswatini,1160164,Africa,1350,20
SWZ,2020-29,442,1,Eswatini,1160164,Africa,1792,21
SWZ,2020-30,414,11,Eswatini,1160164,Africa,2206,32
SWZ,2020-31,568,11,Eswatini,1160164,Africa,2774,43
SWZ,2020-32,461,15,Eswatini,1160164,Africa,3235,58
SWZ,2020-33,603,12,Eswatini,1160164,Africa,3838,70
SWZ,2020-34,386,15,Eswatini,1160164,Africa,4224,85
SWZ,2020-35,336,6,Eswatini,1160164,Africa,4560,91
SWZ,2020-36,292,3,Eswatini,1160164,Africa,4852,94
SWZ,2020-37,222,4,Eswatini,1160164,Africa,5074,98
SWZ,2020-38,194,6,Eswatini,1160164,Africa,5268,104
SWZ,2020-39,162,4,Eswatini,1160164,Africa,5430,108
SWZ,2020-40,138,3,Eswatini,1160164,Africa,5568,111
SWZ,2020-41,100,2,Eswatini,1160164,Africa,5668,113
SWZ,2020-42,111,3,Eswatini,1160164,Africa,5779,116
SWZ,2020-43,74,0,Eswatini,1160164,Africa,5853,116
SWZ,2020-44,71,1,Eswatini,1160164,Africa,5924,117
SWZ,2020-45,78,0,Eswatini,1160164,Africa,6002,117
SWZ,2020-46,92,2,Eswatini,1160164,Africa,6094,119
SWZ,2020-47,124,1,Eswatini,1160164,Africa,6218,120
SWZ,2020-48,191,1,Eswatini,1160164,Africa,6409,121
SWZ,2020-49,91,1,Eswatini,1160164,Africa,6500,122
SWZ,2020-50,267,5,Eswatini,1160164,Africa,6767,127
SWZ,2020-51,659,13,Eswatini,1160164,Africa,7426,140
SWZ,2020-52,1260,27,Eswatini,1160164,Africa,8686,167
SWZ,2020-53,1256,64,Eswatini,1160164,Africa,9942,231
SWZ,2021-01,1768,67,Eswatini,1160164,Africa,11710,298
SWZ,2021-02,1233,78,Eswatini,1160164,Africa,12943,376
SWZ,2021-03,0,0,Eswatini,1160164,Africa,12943,376
SWZ,2021-04,2860,198,Eswatini,1160164,Africa,15803,574
SWZ,2021-05,400,30,Eswatini,1160164,Africa,16203,604
SWZ,2021-06,331,26,Eswatini,1160164,Africa,16534,630
SWZ,2021-07,304,17,Eswatini,1160164,Africa,16838,647
SWZ,2021-08,175,5,Eswatini,1160164,Africa,17013,652
SWZ,2021-09,170,6,Eswatini,1160164,Africa,17183,658
SWZ,2021-10,53,3,Eswatini,1160164,Africa,17236,661
SWZ,2021-11,49,4,Eswatini,1160164,Africa,17285,665
SWZ,2021-12,35,2,Eswatini,1160164,Africa,17320,667
SWZ,2021-13,31,1,Eswatini,1160164,Africa,17351,668
SWZ,2021-14,24,1,Eswatini,1160164,Africa,17375,669
SWZ,2021-15,1041,2,Eswatini,1160164,Africa,18416,671
SWZ,2021-16,25,0,Eswatini,1160164,Africa,18441,671
SWZ,2021-17,16,0,Eswatini,1160164,Africa,18457,671
SWZ,2021-18,22,0,Eswatini,1160164,Africa,18479,671
SWZ,2021-19,40,1,Eswatini,1160164,Africa,18519,672
SWZ,2021-20,31,0,Eswatini,1160164,Africa,18550,672
SWZ,2021-21,40,1,Eswatini,1160164,Africa,18590,673
SWZ,2021-22,62,0,Eswatini,1160164,Africa,18652,673
SWZ,2021-23,83,3,Eswatini,1160164,Africa,18735,676
SWZ,2021-24,77,1,Eswatini,1160164,Africa,18812,677
SWZ,2021-25,222,1,Eswatini,1160164,Africa,19034,678
SWZ,2021-26,279,4,Eswatini,1160164,Africa,19313,682
SWZ,2021-27,604,10,Eswatini,1160164,Africa,19917,692
SWZ,2021-28,1214,20,Eswatini,1160164,Africa,21131,712
SWZ,2021-29,1873,40,Eswatini,1160164,Africa,23004,752
SWZ,2021-30,3215,46,Eswatini,1160164,Africa,26219,798
SWZ,2021-31,4840,63,Eswatini,1160164,Africa,31059,861
SWZ,2021-32,4948,73,Eswatini,1160164,Africa,36007,934
SXM,2020-14,22,4,Sint Maarten,42882,America,22,4
SXM,2020-15,25,5,Sint Maarten,42882,America,47,9
SXM,2020-16,17,1,Sint Maarten,42882,America,64,10
SXM,2020-17,7,3,Sint Maarten,42882,America,71,13
SXM,2020-18,2,0,Sint Maarten,42882,America,73,13
SXM,2020-19,0,2,Sint Maarten,42882,America,73,15
SXM,2020-20,1,0,Sint Maarten,42882,America,74,15
SXM,2020-21,0,0,Sint Maarten,42882,America,74,15
SXM,2020-22,0,0,Sint Maarten,42882,America,74,15
SXM,2020-23,0,0,Sint Maarten,42882,America,74,15
SXM,2020-24,0,0,Sint Maarten,42882,America,74,15
SXM,2020-25,0,0,Sint Maarten,42882,America,74,15
SXM,2020-26,0,0,Sint Maarten,42882,America,74,15
SXM,2020-27,1,0,Sint Maarten,42882,America,75,15
SXM,2020-28,0,0,Sint Maarten,42882,America,75,15
SXM,2020-29,1,0,Sint Maarten,42882,America,76,15
SXM,2020-30,15,0,Sint Maarten,42882,America,91,15
SXM,2020-31,52,1,Sint Maarten,42882,America,143,16
SXM,2020-32,43,1,Sint Maarten,42882,America,186,17
SXM,2020-33,128,0,Sint Maarten,42882,America,314,17
SXM,2020-34,79,0,Sint Maarten,42882,America,393,17
SXM,2020-35,67,0,Sint Maarten,42882,America,460,17
SXM,2020-36,48,2,Sint Maarten,42882,America,508,19
SXM,2020-37,38,0,Sint Maarten,42882,America,546,19
SXM,2020-38,35,1,Sint Maarten,42882,America,581,20
SXM,2020-39,60,2,Sint Maarten,42882,America,641,22
SXM,2020-40,35,0,Sint Maarten,42882,America,676,22
SXM,2020-41,31,0,Sint Maarten,42882,America,707,22
SXM,2020-42,43,0,Sint Maarten,42882,America,750,22
SXM,2020-43,31,0,Sint Maarten,42882,America,781,22
SXM,2020-44,47,0,Sint Maarten,42882,America,828,22
SXM,2020-45,65,1,Sint Maarten,42882,America,893,23
SXM,2020-46,37,1,Sint Maarten,42882,America,930,24
SXM,2020-47,74,1,Sint Maarten,42882,America,1004,25
SXM,2020-48,59,0,Sint Maarten,42882,America,1063,25
SXM,2020-49,75,1,Sint Maarten,42882,America,1138,26
SXM,2020-50,108,0,Sint Maarten,42882,America,1246,26
SXM,2020-51,89,0,Sint Maarten,42882,America,1335,26
SXM,2020-52,73,1,Sint Maarten,42882,America,1408,27
SXM,2020-53,51,0,Sint Maarten,42882,America,1459,27
SXM,2021-01,113,0,Sint Maarten,42882,America,1572,27
SXM,2021-02,81,0,Sint Maarten,42882,America,1653,27
SXM,2021-03,102,0,Sint Maarten,42882,America,1755,27
SXM,2021-04,112,0,Sint Maarten,42882,America,1867,27
SXM,2021-05,68,0,Sint Maarten,42882,America,1935,27
SXM,2021-06,63,0,Sint Maarten,42882,America,1998,27
SXM,2021-07,41,0,Sint Maarten,42882,America,2039,27
SXM,2021-08,18,0,Sint Maarten,42882,America,2057,27
SXM,2021-09,14,0,Sint Maarten,42882,America,2071,27
SXM,2021-10,11,0,Sint Maarten,42882,America,2082,27
SXM,2021-11,19,0,Sint Maarten,42882,America,2101,27
SXM,2021-12,30,0,Sint Maarten,42882,America,2131,27
SXM,2021-13,17,0,Sint Maarten,42882,America,2148,27
SXM,2021-14,37,0,Sint Maarten,42882,America,2185,27
SXM,2021-15,19,0,Sint Maarten,42882,America,2204,27
SXM,2021-16,13,0,Sint Maarten,42882,America,2217,27
SXM,2021-17,10,0,Sint Maarten,42882,America,2227,27
SXM,2021-18,33,0,Sint Maarten,42882,America,2260,27
SXM,2021-19,19,0,Sint Maarten,42882,America,2279,27
SXM,2021-20,88,1,Sint Maarten,42882,America,2367,28
SXM,2021-21,44,0,Sint Maarten,42882,America,2411,28
SXM,2021-22,70,1,Sint Maarten,42882,America,2481,29
SXM,2021-23,38,2,Sint Maarten,42882,America,2519,31
SXM,2021-24,48,1,Sint Maarten,42882,America,2567,32
SXM,2021-25,43,1,Sint Maarten,42882,America,2610,33
SXM,2021-26,14,0,Sint Maarten,42882,America,2624,33
SXM,2021-27,14,1,Sint Maarten,42882,America,2638,34
SXM,2021-28,36,0,Sint Maarten,42882,America,2674,34
SXM,2021-29,46,0,Sint Maarten,42882,America,2720,34
SXM,2021-30,75,0,Sint Maarten,42882,America,2795,34
SXM,2021-31,203,3,Sint Maarten,42882,America,2998,37
SXM,2021-32,226,4,Sint Maarten,42882,America,3224,41
SYC,2020-12,4,0,Seychelles,98340,Africa,4,0
SYC,2020-13,1,0,Seychelles,98340,Africa,5,0
SYC,2020-14,2,0,Seychelles,98340,Africa,7,0
SYC,2020-15,0,0,Seychelles,98340,Africa,7,0
SYC,2020-16,1,0,Seychelles,98340,Africa,8,0
SYC,2020-17,0,0,Seychelles,98340,Africa,8,0
SYC,2020-18,0,0,Seychelles,98340,Africa,8,0
SYC,2020-19,0,0,Seychelles,98340,Africa,8,0
SYC,2020-20,0,0,Seychelles,98340,Africa,8,0
SYC,2020-21,0,0,Seychelles,98340,Africa,8,0
SYC,2020-22,0,0,Seychelles,98340,Africa,8,0
SYC,2020-23,0,0,Seychelles,98340,Africa,8,0
SYC,2020-24,0,0,Seychelles,98340,Africa,8,0
SYC,2020-25,0,0,Seychelles,98340,Africa,8,0
SYC,2020-26,0,0,Seychelles,98340,Africa,8,0
SYC,2020-27,0,0,Seychelles,98340,Africa,8,0
SYC,2020-28,89,0,Seychelles,98340,Africa,97,0
SYC,2020-29,0,0,Seychelles,98340,Africa,97,0
SYC,2020-30,14,0,Seychelles,98340,Africa,111,0
SYC,2020-31,0,0,Seychelles,98340,Africa,111,0
SYC,2020-32,12,0,Seychelles,98340,Africa,123,0
SYC,2020-33,1,0,Seychelles,98340,Africa,124,0
SYC,2020-34,5,0,Seychelles,98340,Africa,129,0
SYC,2020-35,4,0,Seychelles,98340,Africa,133,0
SYC,2020-36,1,0,Seychelles,98340,Africa,134,0
SYC,2020-37,2,0,Seychelles,98340,Africa,136,0
SYC,2020-38,2,0,Seychelles,98340,Africa,138,0
SYC,2020-39,2,0,Seychelles,98340,Africa,140,0
SYC,2020-40,2,0,Seychelles,98340,Africa,142,0
SYC,2020-41,3,0,Seychelles,98340,Africa,145,0
SYC,2020-42,1,0,Seychelles,98340,Africa,146,0
SYC,2020-43,4,0,Seychelles,98340,Africa,150,0
SYC,2020-44,0,0,Seychelles,98340,Africa,150,0
SYC,2020-45,5,0,Seychelles,98340,Africa,155,0
SYC,2020-46,0,0,Seychelles,98340,Africa,155,0
SYC,2020-47,8,0,Seychelles,98340,Africa,163,0
SYC,2020-48,7,0,Seychelles,98340,Africa,170,0
SYC,2020-49,11,0,Seychelles,98340,Africa,181,0
SYC,2020-50,18,0,Seychelles,98340,Africa,199,0
SYC,2020-51,3,0,Seychelles,98340,Africa,202,0
SYC,2020-52,12,0,Seychelles,98340,Africa,214,0
SYC,2020-53,80,0,Seychelles,98340,Africa,294,0
SYC,2021-01,234,2,Seychelles,98340,Africa,528,2
SYC,2021-02,174,0,Seychelles,98340,Africa,702,2
SYC,2021-03,364,1,Seychelles,98340,Africa,1066,3
SYC,2021-04,154,2,Seychelles,98340,Africa,1220,5
SYC,2021-05,290,2,Seychelles,98340,Africa,1510,7
SYC,2021-06,397,1,Seychelles,98340,Africa,1907,8
SYC,2021-07,491,2,Seychelles,98340,Africa,2398,10
SYC,2021-08,217,1,Seychelles,98340,Africa,2615,11
SYC,2021-09,371,4,Seychelles,98340,Africa,2986,15
SYC,2021-10,526,1,Seychelles,98340,Africa,3512,16
SYC,2021-11,283,0,Seychelles,98340,Africa,3795,16
SYC,2021-12,286,4,Seychelles,98340,Africa,4081,20
SYC,2021-13,210,2,Seychelles,98340,Africa,4291,22
SYC,2021-14,234,2,Seychelles,98340,Africa,4525,24
SYC,2021-15,310,1,Seychelles,98340,Africa,4835,25
SYC,2021-16,332,1,Seychelles,98340,Africa,5167,26
SYC,2021-17,432,1,Seychelles,98340,Africa,5599,27
SYC,2021-18,1209,1,Seychelles,98340,Africa,6808,28
SYC,2021-19,2373,2,Seychelles,98340,Africa,9181,30
SYC,2021-20,1249,8,Seychelles,98340,Africa,10430,38
SYC,2021-21,1303,2,Seychelles,98340,Africa,11733,40
SYC,2021-22,502,2,Seychelles,98340,Africa,12235,42
SYC,2021-23,1176,1,Seychelles,98340,Africa,13411,43
SYC,2021-24,1000,9,Seychelles,98340,Africa,14411,52
SYC,2021-25,1165,16,Seychelles,98340,Africa,15576,68
SYC,2021-26,725,3,Seychelles,98340,Africa,16301,71
SYC,2021-27,701,6,Seychelles,98340,Africa,17002,77
SYC,2021-28,536,9,Seychelles,98340,Africa,17538,86
SYC,2021-29,521,4,Seychelles,98340,Africa,18059,90
SYC,2021-30,322,4,Seychelles,98340,Africa,18381,94
SYC,2021-31,198,0,Seychelles,98340,Africa,18579,94
SYC,2021-32,617,4,Seychelles,98340,Africa,19196,98
SYR,2020-13,8,1,Syria,17500657,Asia,8,1
SYR,2020-14,10,1,Syria,17500657,Asia,18,2
SYR,2020-15,6,0,Syria,17500657,Asia,24,2
SYR,2020-16,14,1,Syria,17500657,Asia,38,3
SYR,2020-17,4,0,Syria,17500657,Asia,42,3
SYR,2020-18,1,0,Syria,17500657,Asia,43,3
SYR,2020-19,3,0,Syria,17500657,Asia,46,3
SYR,2020-20,11,0,Syria,17500657,Asia,57,3
SYR,2020-21,28,1,Syria,17500657,Asia,85,4
SYR,2020-22,36,0,Syria,17500657,Asia,121,4
SYR,2020-23,19,2,Syria,17500657,Asia,140,6
SYR,2020-24,36,0,Syria,17500657,Asia,176,6
SYR,2020-25,27,1,Syria,17500657,Asia,203,7
SYR,2020-26,52,2,Syria,17500657,Asia,255,9
SYR,2020-27,102,4,Syria,17500657,Asia,357,13
SYR,2020-28,36,3,Syria,17500657,Asia,393,16
SYR,2020-29,102,9,Syria,17500657,Asia,495,25
SYR,2020-30,154,13,Syria,17500657,Asia,649,38
SYR,2020-31,159,6,Syria,17500657,Asia,808,44
SYR,2020-32,379,8,Syria,17500657,Asia,1187,52
SYR,2020-33,489,12,Syria,17500657,Asia,1676,64
SYR,2020-34,466,21,Syria,17500657,Asia,2142,85
SYR,2020-35,560,24,Syria,17500657,Asia,2702,109
SYR,2020-36,468,25,Syria,17500657,Asia,3170,134
SYR,2020-37,369,21,Syria,17500657,Asia,3539,155
SYR,2020-38,260,17,Syria,17500657,Asia,3799,172
SYR,2020-39,272,20,Syria,17500657,Asia,4071,192
SYR,2020-40,294,13,Syria,17500657,Asia,4365,205
SYR,2020-41,307,16,Syria,17500657,Asia,4672,221
SYR,2020-42,404,27,Syria,17500657,Asia,5076,248
SYR,2020-43,331,21,Syria,17500657,Asia,5407,269
SYR,2020-44,381,23,Syria,17500657,Asia,5788,292
SYR,2020-45,426,25,Syria,17500657,Asia,6214,317
SYR,2020-46,469,28,Syria,17500657,Asia,6683,345
SYR,2020-47,541,31,Syria,17500657,Asia,7224,376
SYR,2020-48,572,37,Syria,17500657,Asia,7796,413
SYR,2020-49,606,34,Syria,17500657,Asia,8402,447
SYR,2020-50,763,71,Syria,17500657,Asia,9165,518
SYR,2020-51,1029,92,Syria,17500657,Asia,10194,610
SYR,2020-52,838,68,Syria,17500657,Asia,11032,678
SYR,2020-53,677,51,Syria,17500657,Asia,11709,729
SYR,2021-01,654,45,Syria,17500657,Asia,12363,774
SYR,2021-02,672,58,Syria,17500657,Asia,13035,832
SYR,2021-03,592,53,Syria,17500657,Asia,13627,885
SYR,2021-04,420,36,Syria,17500657,Asia,14047,921
SYR,2021-05,429,31,Syria,17500657,Asia,14476,952
SYR,2021-06,386,26,Syria,17500657,Asia,14862,978
SYR,2021-07,254,20,Syria,17500657,Asia,15116,998
SYR,2021-08,441,29,Syria,17500657,Asia,15557,1027
SYR,2021-09,423,36,Syria,17500657,Asia,15980,1063
SYR,2021-10,497,36,Syria,17500657,Asia,16477,1099
SYR,2021-11,933,64,Syria,17500657,Asia,17410,1163
SYR,2021-12,1087,76,Syria,17500657,Asia,18497,1239
SYR,2021-13,906,74,Syria,17500657,Asia,19403,1313
SYR,2021-14,822,65,Syria,17500657,Asia,20225,1378
SYR,2021-15,916,68,Syria,17500657,Asia,21141,1446
SYR,2021-16,993,91,Syria,17500657,Asia,22134,1537
SYR,2021-17,763,66,Syria,17500657,Asia,22897,1603
SYR,2021-18,481,54,Syria,17500657,Asia,23378,1657
SYR,2021-19,359,41,Syria,17500657,Asia,23737,1698
SYR,2021-20,379,36,Syria,17500657,Asia,24116,1734
SYR,2021-21,350,32,Syria,17500657,Asia,24466,1766
SYR,2021-22,192,27,Syria,17500657,Asia,24658,1793
SYR,2021-23,155,17,Syria,17500657,Asia,24813,1810
SYR,2021-24,304,35,Syria,17500657,Asia,25117,1845
SYR,2021-25,286,22,Syria,17500657,Asia,25403,1867
SYR,2021-26,249,20,Syria,17500657,Asia,25652,1887
SYR,2021-27,123,10,Syria,17500657,Asia,25775,1897
SYR,2021-28,58,8,Syria,17500657,Asia,25833,1905
SYR,2021-29,43,1,Syria,17500657,Asia,25876,1906
SYR,2021-30,106,10,Syria,17500657,Asia,25982,1916
SYR,2021-31,114,4,Syria,17500657,Asia,26096,1920
SYR,2021-32,245,17,Syria,17500657,Asia,26341,1937
TCA,2020-14,0,1,Turks And Caicos Islands,38718,America,0,1
TCA,2020-15,4,0,Turks And Caicos Islands,38718,America,4,1
TCA,2020-16,2,0,Turks And Caicos Islands,38718,America,6,1
TCA,2020-17,0,0,Turks And Caicos Islands,38718,America,6,1
TCA,2020-18,1,0,Turks And Caicos Islands,38718,America,7,1
TCA,2020-19,0,0,Turks And Caicos Islands,38718,America,7,1
TCA,2020-20,0,0,Turks And Caicos Islands,38718,America,7,1
TCA,2020-21,0,0,Turks And Caicos Islands,38718,America,7,1
TCA,2020-22,0,0,Turks And Caicos Islands,38718,America,7,1
TCA,2020-23,0,0,Turks And Caicos Islands,38718,America,7,1
TCA,2020-24,0,0,Turks And Caicos Islands,38718,America,7,1
TCA,2020-25,2,0,Turks And Caicos Islands,38718,America,9,1
TCA,2020-26,14,0,Turks And Caicos Islands,38718,America,23,1
TCA,2020-27,19,1,Turks And Caicos Islands,38718,America,42,2
TCA,2020-28,25,0,Turks And Caicos Islands,38718,America,67,2
TCA,2020-29,9,0,Turks And Caicos Islands,38718,America,76,2
TCA,2020-30,18,0,Turks And Caicos Islands,38718,America,94,2
TCA,2020-31,17,0,Turks And Caicos Islands,38718,America,111,2
TCA,2020-32,100,0,Turks And Caicos Islands,38718,America,211,2
TCA,2020-33,82,0,Turks And Caicos Islands,38718,America,293,2
TCA,2020-34,85,0,Turks And Caicos Islands,38718,America,378,2
TCA,2020-35,124,1,Turks And Caicos Islands,38718,America,502,3
TCA,2020-36,91,2,Turks And Caicos Islands,38718,America,593,5
TCA,2020-37,48,0,Turks And Caicos Islands,38718,America,641,5
TCA,2020-38,22,0,Turks And Caicos Islands,38718,America,663,5
TCA,2020-39,14,0,Turks And Caicos Islands,38718,America,677,5
TCA,2020-40,13,1,Turks And Caicos Islands,38718,America,690,6
TCA,2020-41,0,0,Turks And Caicos Islands,38718,America,690,6
TCA,2020-42,3,0,Turks And Caicos Islands,38718,America,693,6
TCA,2020-43,3,0,Turks And Caicos Islands,38718,America,696,6
TCA,2020-44,3,0,Turks And Caicos Islands,38718,America,699,6
TCA,2020-45,3,0,Turks And Caicos Islands,38718,America,702,6
TCA,2020-46,13,0,Turks And Caicos Islands,38718,America,715,6
TCA,2020-47,26,0,Turks And Caicos Islands,38718,America,741,6
TCA,2020-48,2,0,Turks And Caicos Islands,38718,America,743,6
TCA,2020-49,8,0,Turks And Caicos Islands,38718,America,751,6
TCA,2020-50,13,0,Turks And Caicos Islands,38718,America,764,6
TCA,2020-51,29,0,Turks And Caicos Islands,38718,America,793,6
TCA,2020-52,51,0,Turks And Caicos Islands,38718,America,844,6
TCA,2020-53,61,0,Turks And Caicos Islands,38718,America,905,6
TCA,2021-01,84,0,Turks And Caicos Islands,38718,America,989,6
TCA,2021-02,111,1,Turks And Caicos Islands,38718,America,1100,7
TCA,2021-03,182,0,Turks And Caicos Islands,38718,America,1282,7
TCA,2021-04,217,2,Turks And Caicos Islands,38718,America,1499,9
TCA,2021-05,191,0,Turks And Caicos Islands,38718,America,1690,9
TCA,2021-06,179,4,Turks And Caicos Islands,38718,America,1869,13
TCA,2021-07,155,1,Turks And Caicos Islands,38718,America,2024,14
TCA,2021-08,85,0,Turks And Caicos Islands,38718,America,2109,14
TCA,2021-09,63,1,Turks And Caicos Islands,38718,America,2172,15
TCA,2021-10,56,0,Turks And Caicos Islands,38718,America,2228,15
TCA,2021-11,61,1,Turks And Caicos Islands,38718,America,2289,16
TCA,2021-12,33,1,Turks And Caicos Islands,38718,America,2322,17
TCA,2021-13,17,0,Turks And Caicos Islands,38718,America,2339,17
TCA,2021-14,0,0,Turks And Caicos Islands,38718,America,2339,17
TCA,2021-15,25,0,Turks And Caicos Islands,38718,America,2364,17
TCA,2021-16,7,0,Turks And Caicos Islands,38718,America,2371,17
TCA,2021-17,17,0,Turks And Caicos Islands,38718,America,2388,17
TCA,2021-18,9,0,Turks And Caicos Islands,38718,America,2397,17
TCA,2021-19,2,0,Turks And Caicos Islands,38718,America,2399,17
TCA,2021-20,5,0,Turks And Caicos Islands,38718,America,2404,17
TCA,2021-21,8,0,Turks And Caicos Islands,38718,America,2412,17
TCA,2021-22,4,1,Turks And Caicos Islands,38718,America,2416,18
TCA,2021-23,2,0,Turks And Caicos Islands,38718,America,2418,18
TCA,2021-24,1,0,Turks And Caicos Islands,38718,America,2419,18
TCA,2021-25,0,0,Turks And Caicos Islands,38718,America,2419,18
TCA,2021-26,1,0,Turks And Caicos Islands,38718,America,2420,18
TCA,2021-27,11,0,Turks And Caicos Islands,38718,America,2431,18
TCA,2021-28,19,0,Turks And Caicos Islands,38718,America,2450,18
TCA,2021-29,11,0,Turks And Caicos Islands,38718,America,2461,18
TCA,2021-30,20,0,Turks And Caicos Islands,38718,America,2481,18
TCA,2021-31,37,0,Turks And Caicos Islands,38718,America,2518,18
TCA,2021-32,45,1,Turks And Caicos Islands,38718,America,2563,19
TCD,2020-13,3,0,Chad,16425859,Africa,3,0
TCD,2020-14,4,0,Chad,16425859,Africa,7,0
TCD,2020-15,6,0,Chad,16425859,Africa,13,0
TCD,2020-16,18,0,Chad,16425859,Africa,31,0
TCD,2020-17,13,0,Chad,16425859,Africa,44,0
TCD,2020-18,71,10,Chad,16425859,Africa,115,10
TCD,2020-19,205,21,Chad,16425859,Africa,320,31
TCD,2020-20,181,22,Chad,16425859,Africa,501,53
TCD,2020-21,172,7,Chad,16425859,Africa,673,60
TCD,2020-22,103,5,Chad,16425859,Africa,776,65
TCD,2020-23,59,4,Chad,16425859,Africa,835,69
TCD,2020-24,13,4,Chad,16425859,Africa,848,73
TCD,2020-25,8,1,Chad,16425859,Africa,856,74
TCD,2020-26,8,0,Chad,16425859,Africa,864,74
TCD,2020-27,6,0,Chad,16425859,Africa,870,74
TCD,2020-28,8,1,Chad,16425859,Africa,878,75
TCD,2020-29,9,0,Chad,16425859,Africa,887,75
TCD,2020-30,26,0,Chad,16425859,Africa,913,75
TCD,2020-31,21,0,Chad,16425859,Africa,934,75
TCD,2020-32,8,1,Chad,16425859,Africa,942,76
TCD,2020-33,12,0,Chad,16425859,Africa,954,76
TCD,2020-34,30,0,Chad,16425859,Africa,984,76
TCD,2020-35,26,1,Chad,16425859,Africa,1010,77
TCD,2020-36,27,2,Chad,16425859,Africa,1037,79
TCD,2020-37,45,1,Chad,16425859,Africa,1082,80
TCD,2020-38,67,1,Chad,16425859,Africa,1149,81
TCD,2020-39,27,3,Chad,16425859,Africa,1176,84
TCD,2020-40,39,2,Chad,16425859,Africa,1215,86
TCD,2020-41,87,6,Chad,16425859,Africa,1302,92
TCD,2020-42,75,1,Chad,16425859,Africa,1377,93
TCD,2020-43,58,3,Chad,16425859,Africa,1435,96
TCD,2020-44,61,2,Chad,16425859,Africa,1496,98
TCD,2020-45,49,1,Chad,16425859,Africa,1545,99
TCD,2020-46,50,2,Chad,16425859,Africa,1595,101
TCD,2020-47,45,0,Chad,16425859,Africa,1640,101
TCD,2020-48,40,0,Chad,16425859,Africa,1680,101
TCD,2020-49,43,1,Chad,16425859,Africa,1723,102
TCD,2020-50,45,0,Chad,16425859,Africa,1768,102
TCD,2020-51,120,0,Chad,16425859,Africa,1888,102
TCD,2020-52,125,2,Chad,16425859,Africa,2013,104
TCD,2020-53,198,0,Chad,16425859,Africa,2211,104
TCD,2021-01,324,3,Chad,16425859,Africa,2535,107
TCD,2021-02,358,4,Chad,16425859,Africa,2893,111
TCD,2021-03,266,5,Chad,16425859,Africa,3159,116
TCD,2021-04,224,5,Chad,16425859,Africa,3383,121
TCD,2021-05,112,4,Chad,16425859,Africa,3495,125
TCD,2021-06,148,4,Chad,16425859,Africa,3643,129
TCD,2021-07,204,5,Chad,16425859,Africa,3847,134
TCD,2021-08,124,6,Chad,16425859,Africa,3971,140
TCD,2021-09,204,2,Chad,16425859,Africa,4175,142
TCD,2021-10,132,12,Chad,16425859,Africa,4307,154
TCD,2021-11,111,3,Chad,16425859,Africa,4418,157
TCD,2021-12,86,5,Chad,16425859,Africa,4504,162
TCD,2021-13,89,3,Chad,16425859,Africa,4593,165
TCD,2021-14,41,2,Chad,16425859,Africa,4634,167
TCD,2021-15,70,2,Chad,16425859,Africa,4704,169
TCD,2021-16,64,0,Chad,16425859,Africa,4768,169
TCD,2021-17,58,1,Chad,16425859,Africa,4826,170
TCD,2021-18,49,1,Chad,16425859,Africa,4875,171
TCD,2021-19,27,2,Chad,16425859,Africa,4902,173
TCD,2021-20,20,0,Chad,16425859,Africa,4922,173
TCD,2021-21,5,0,Chad,16425859,Africa,4927,173
TCD,2021-22,10,1,Chad,16425859,Africa,4937,174
TCD,2021-23,3,0,Chad,16425859,Africa,4940,174
TCD,2021-24,4,0,Chad,16425859,Africa,4944,174
TCD,2021-25,5,0,Chad,16425859,Africa,4949,174
TCD,2021-26,1,0,Chad,16425859,Africa,4950,174
TCD,2021-27,2,0,Chad,16425859,Africa,4952,174
TCD,2021-28,10,0,Chad,16425859,Africa,4962,174
TCD,2021-29,5,0,Chad,16425859,Africa,4967,174
TCD,2021-30,4,0,Chad,16425859,Africa,4971,174
TCD,2021-31,7,0,Chad,16425859,Africa,4978,174
TCD,2021-32,2,0,Chad,16425859,Africa,4980,174
TGO,2020-12,14,0,Togo,8278737,Africa,14,0
TGO,2020-13,15,1,Togo,8278737,Africa,29,1
TGO,2020-14,14,2,Togo,8278737,Africa,43,3
TGO,2020-15,32,0,Togo,8278737,Africa,75,3
TGO,2020-16,8,2,Togo,8278737,Africa,83,5
TGO,2020-17,14,1,Togo,8278737,Africa,97,6
TGO,2020-18,26,3,Togo,8278737,Africa,123,9
TGO,2020-19,50,2,Togo,8278737,Africa,173,11
TGO,2020-20,127,0,Togo,8278737,Africa,300,11
TGO,2020-21,80,1,Togo,8278737,Africa,380,12
TGO,2020-22,61,1,Togo,8278737,Africa,441,13
TGO,2020-23,53,0,Togo,8278737,Africa,494,13
TGO,2020-24,36,0,Togo,8278737,Africa,530,13
TGO,2020-25,38,0,Togo,8278737,Africa,568,13
TGO,2020-26,73,1,Togo,8278737,Africa,641,14
TGO,2020-27,38,1,Togo,8278737,Africa,679,15
TGO,2020-28,40,0,Togo,8278737,Africa,719,15
TGO,2020-29,54,0,Togo,8278737,Africa,773,15
TGO,2020-30,94,3,Togo,8278737,Africa,867,18
TGO,2020-31,93,1,Togo,8278737,Africa,960,19
TGO,2020-32,99,4,Togo,8278737,Africa,1059,23
TGO,2020-33,87,4,Togo,8278737,Africa,1146,27
TGO,2020-34,130,0,Togo,8278737,Africa,1276,27
TGO,2020-35,119,0,Togo,8278737,Africa,1395,27
TGO,2020-36,92,5,Togo,8278737,Africa,1487,32
TGO,2020-37,84,5,Togo,8278737,Africa,1571,37
TGO,2020-38,94,4,Togo,8278737,Africa,1665,41
TGO,2020-39,77,5,Togo,8278737,Africa,1742,46
TGO,2020-40,111,2,Togo,8278737,Africa,1853,48
TGO,2020-41,86,1,Togo,8278737,Africa,1939,49
TGO,2020-42,117,2,Togo,8278737,Africa,2056,51
TGO,2020-43,143,1,Togo,8278737,Africa,2199,52
TGO,2020-44,157,5,Togo,8278737,Africa,2356,57
TGO,2020-45,159,0,Togo,8278737,Africa,2515,57
TGO,2020-46,159,4,Togo,8278737,Africa,2674,61
TGO,2020-47,168,3,Togo,8278737,Africa,2842,64
TGO,2020-48,119,0,Togo,8278737,Africa,2961,64
TGO,2020-49,133,1,Togo,8278737,Africa,3094,65
TGO,2020-50,156,1,Togo,8278737,Africa,3250,66
TGO,2020-51,165,0,Togo,8278737,Africa,3415,66
TGO,2020-52,160,2,Togo,8278737,Africa,3575,68
TGO,2020-53,126,0,Togo,8278737,Africa,3701,68
TGO,2021-01,255,4,Togo,8278737,Africa,3956,72
TGO,2021-02,345,1,Togo,8278737,Africa,4301,73
TGO,2021-03,360,3,Togo,8278737,Africa,4661,76
TGO,2021-04,430,3,Togo,8278737,Africa,5091,79
TGO,2021-05,391,1,Togo,8278737,Africa,5482,80
TGO,2021-06,391,1,Togo,8278737,Africa,5873,81
TGO,2021-07,592,0,Togo,8278737,Africa,6465,81
TGO,2021-08,435,3,Togo,8278737,Africa,6900,84
TGO,2021-09,697,8,Togo,8278737,Africa,7597,92
TGO,2021-10,585,4,Togo,8278737,Africa,8182,96
TGO,2021-11,777,8,Togo,8278737,Africa,8959,104
TGO,2021-12,995,3,Togo,8278737,Africa,9954,107
TGO,2021-13,1294,5,Togo,8278737,Africa,11248,112
TGO,2021-14,785,4,Togo,8278737,Africa,12033,116
TGO,2021-15,519,4,Togo,8278737,Africa,12552,120
TGO,2021-16,90,2,Togo,8278737,Africa,12642,122
TGO,2021-17,367,1,Togo,8278737,Africa,13009,123
TGO,2021-18,157,2,Togo,8278737,Africa,13166,125
TGO,2021-19,108,0,Togo,8278737,Africa,13274,125
TGO,2021-20,99,0,Togo,8278737,Africa,13373,125
TGO,2021-21,83,0,Togo,8278737,Africa,13456,125
TGO,2021-22,82,0,Togo,8278737,Africa,13538,125
TGO,2021-23,88,1,Togo,8278737,Africa,13626,126
TGO,2021-24,94,2,Togo,8278737,Africa,13720,128
TGO,2021-25,116,0,Togo,8278737,Africa,13836,128
TGO,2021-26,245,4,Togo,8278737,Africa,14081,132
TGO,2021-27,188,1,Togo,8278737,Africa,14269,133
TGO,2021-28,379,5,Togo,8278737,Africa,14648,138
TGO,2021-29,527,10,Togo,8278737,Africa,15175,148
TGO,2021-30,694,5,Togo,8278737,Africa,15869,153
TGO,2021-31,1004,6,Togo,8278737,Africa,16873,159
TGO,2021-32,1126,6,Togo,8278737,Africa,17999,165
THA,2020-02,1,0,Thailand,69799978,Asia,1,0
THA,2020-03,1,0,Thailand,69799978,Asia,2,0
THA,2020-04,6,0,Thailand,69799978,Asia,8,0
THA,2020-05,11,0,Thailand,69799978,Asia,19,0
THA,2020-06,13,0,Thailand,69799978,Asia,32,0
THA,2020-07,2,0,Thailand,69799978,Asia,34,0
THA,2020-08,1,0,Thailand,69799978,Asia,35,0
THA,2020-09,8,1,Thailand,69799978,Asia,43,1
THA,2020-10,7,0,Thailand,69799978,Asia,50,1
THA,2020-11,64,0,Thailand,69799978,Asia,114,1
THA,2020-12,607,0,Thailand,69799978,Asia,721,1
THA,2020-13,667,6,Thailand,69799978,Asia,1388,7
THA,2020-14,832,19,Thailand,69799978,Asia,2220,26
THA,2020-15,359,14,Thailand,69799978,Asia,2579,40
THA,2020-16,186,7,Thailand,69799978,Asia,2765,47
THA,2020-17,157,4,Thailand,69799978,Asia,2922,51
THA,2020-18,47,3,Thailand,69799978,Asia,2969,54
THA,2020-19,46,2,Thailand,69799978,Asia,3015,56
THA,2020-20,13,0,Thailand,69799978,Asia,3028,56
THA,2020-21,14,1,Thailand,69799978,Asia,3042,57
THA,2020-22,39,0,Thailand,69799978,Asia,3081,57
THA,2020-23,38,1,Thailand,69799978,Asia,3119,58
THA,2020-24,16,0,Thailand,69799978,Asia,3135,58
THA,2020-25,13,0,Thailand,69799978,Asia,3148,58
THA,2020-26,14,0,Thailand,69799978,Asia,3162,58
THA,2020-27,33,0,Thailand,69799978,Asia,3195,58
THA,2020-28,25,0,Thailand,69799978,Asia,3220,58
THA,2020-29,30,0,Thailand,69799978,Asia,3250,58
THA,2020-30,45,0,Thailand,69799978,Asia,3295,58
THA,2020-31,25,0,Thailand,69799978,Asia,3320,58
THA,2020-32,31,0,Thailand,69799978,Asia,3351,58
THA,2020-33,27,0,Thailand,69799978,Asia,3378,58
THA,2020-34,19,0,Thailand,69799978,Asia,3397,58
THA,2020-35,15,0,Thailand,69799978,Asia,3412,58
THA,2020-36,33,0,Thailand,69799978,Asia,3445,58
THA,2020-37,30,0,Thailand,69799978,Asia,3475,58
THA,2020-38,31,1,Thailand,69799978,Asia,3506,59
THA,2020-39,39,0,Thailand,69799978,Asia,3545,59
THA,2020-40,45,0,Thailand,69799978,Asia,3590,59
THA,2020-41,51,0,Thailand,69799978,Asia,3641,59
THA,2020-42,50,0,Thailand,69799978,Asia,3691,59
THA,2020-43,52,0,Thailand,69799978,Asia,3743,59
THA,2020-44,44,0,Thailand,69799978,Asia,3787,59
THA,2020-45,53,1,Thailand,69799978,Asia,3840,60
THA,2020-46,35,0,Thailand,69799978,Asia,3875,60
THA,2020-47,38,0,Thailand,69799978,Asia,3913,60
THA,2020-48,64,0,Thailand,69799978,Asia,3977,60
THA,2020-49,130,0,Thailand,69799978,Asia,4107,60
THA,2020-50,130,0,Thailand,69799978,Asia,4237,60
THA,2020-51,670,0,Thailand,69799978,Asia,4907,60
THA,2020-52,1378,0,Thailand,69799978,Asia,6285,60
THA,2020-53,2154,5,Thailand,69799978,Asia,8439,65
THA,2021-01,2108,2,Thailand,69799978,Asia,10547,67
THA,2021-02,1876,3,Thailand,69799978,Asia,12423,70
THA,2021-03,1264,5,Thailand,69799978,Asia,13687,75
THA,2021-04,5931,2,Thailand,69799978,Asia,19618,77
THA,2021-05,3939,2,Thailand,69799978,Asia,23557,79
THA,2021-06,1157,3,Thailand,69799978,Asia,24714,82
THA,2021-07,790,1,Thailand,69799978,Asia,25504,83
THA,2021-08,527,0,Thailand,69799978,Asia,26031,83
THA,2021-09,410,2,Thailand,69799978,Asia,26441,85
THA,2021-10,564,2,Thailand,69799978,Asia,27005,87
THA,2021-11,871,4,Thailand,69799978,Asia,27876,91
THA,2021-12,897,3,Thailand,69799978,Asia,28773,94
THA,2021-13,354,1,Thailand,69799978,Asia,29127,95
THA,2021-14,4483,2,Thailand,69799978,Asia,33610,97
THA,2021-15,10132,7,Thailand,69799978,Asia,43742,104
THA,2021-16,13766,44,Thailand,69799978,Asia,57508,148
THA,2021-17,11476,128,Thailand,69799978,Asia,68984,276
THA,2021-18,14391,123,Thailand,69799978,Asia,83375,399
THA,2021-19,27707,215,Thailand,69799978,Asia,111082,614
THA,2021-20,21131,192,Thailand,69799978,Asia,132213,806
THA,2021-21,27579,225,Thailand,69799978,Asia,159792,1031
THA,2021-22,20094,238,Thailand,69799978,Asia,179886,1269
THA,2021-23,19378,197,Thailand,69799978,Asia,199264,1466
THA,2021-24,22042,192,Thailand,69799978,Asia,221306,1658
THA,2021-25,28547,276,Thailand,69799978,Asia,249853,1934
THA,2021-26,39380,342,Thailand,69799978,Asia,289233,2276
THA,2021-27,47138,435,Thailand,69799978,Asia,336371,2711
THA,2021-28,78799,711,Thailand,69799978,Asia,415170,3422
THA,2021-29,97508,724,Thailand,69799978,Asia,512678,4146
THA,2021-30,120606,1022,Thailand,69799978,Asia,633284,5168
THA,2021-31,142824,1185,Thailand,69799978,Asia,776108,6353
THA,2021-32,131049,1199,Thailand,69799978,Asia,907157,7552
TJK,2020-19,536,18,Tajikistan,9537642,Asia,536,18
TJK,2020-20,912,19,Tajikistan,9537642,Asia,1448,37
TJK,2020-21,1214,5,Tajikistan,9537642,Asia,2662,42
TJK,2020-22,1069,3,Tajikistan,9537642,Asia,3731,45
TJK,2020-23,722,1,Tajikistan,9537642,Asia,4453,46
TJK,2020-24,506,2,Tajikistan,9537642,Asia,4959,48
TJK,2020-25,422,2,Tajikistan,9537642,Asia,5381,50
TJK,2020-26,392,0,Tajikistan,9537642,Asia,5773,50
TJK,2020-27,364,1,Tajikistan,9537642,Asia,6137,51
TJK,2020-28,339,2,Tajikistan,9537642,Asia,6476,53
TJK,2020-29,326,2,Tajikistan,9537642,Asia,6802,55
TJK,2020-30,314,2,Tajikistan,9537642,Asia,7116,57
TJK,2020-31,303,2,Tajikistan,9537642,Asia,7419,59
TJK,2020-32,250,1,Tajikistan,9537642,Asia,7669,60
TJK,2020-33,320,2,Tajikistan,9537642,Asia,7989,62
TJK,2020-34,246,2,Tajikistan,9537642,Asia,8235,64
TJK,2020-35,239,2,Tajikistan,9537642,Asia,8474,66
TJK,2020-36,242,2,Tajikistan,9537642,Asia,8716,68
TJK,2020-37,257,2,Tajikistan,9537642,Asia,8973,70
TJK,2020-38,297,1,Tajikistan,9537642,Asia,9270,71
TJK,2020-39,300,2,Tajikistan,9537642,Asia,9570,73
TJK,2020-40,289,3,Tajikistan,9537642,Asia,9859,76
TJK,2020-41,287,1,Tajikistan,9537642,Asia,10146,77
TJK,2020-42,271,1,Tajikistan,9537642,Asia,10417,78
TJK,2020-43,283,1,Tajikistan,9537642,Asia,10700,79
TJK,2020-44,278,1,Tajikistan,9537642,Asia,10978,80
TJK,2020-45,282,1,Tajikistan,9537642,Asia,11260,81
TJK,2020-46,274,2,Tajikistan,9537642,Asia,11534,83
TJK,2020-47,284,1,Tajikistan,9537642,Asia,11818,84
TJK,2020-48,261,0,Tajikistan,9537642,Asia,12079,84
TJK,2020-49,273,1,Tajikistan,9537642,Asia,12352,85
TJK,2020-50,276,1,Tajikistan,9537642,Asia,12628,86
TJK,2020-51,256,1,Tajikistan,9537642,Asia,12884,87
TJK,2020-52,277,1,Tajikistan,9537642,Asia,13161,88
TJK,2020-53,63,0,Tajikistan,9537642,Asia,13224,88
TJK,2021-01,8,0,Tajikistan,9537642,Asia,13232,88
TJK,2021-02,0,0,Tajikistan,9537642,Asia,13232,88
TJK,2021-03,0,0,Tajikistan,9537642,Asia,13232,88
TJK,2021-04,0,0,Tajikistan,9537642,Asia,13232,88
TJK,2021-05,0,0,Tajikistan,9537642,Asia,13232,88
TJK,2021-06,0,0,Tajikistan,9537642,Asia,13232,88
TJK,2021-07,0,0,Tajikistan,9537642,Asia,13232,88
TJK,2021-08,0,0,Tajikistan,9537642,Asia,13232,88
TJK,2021-09,0,0,Tajikistan,9537642,Asia,13232,88
TJK,2021-10,0,0,Tajikistan,9537642,Asia,13232,88
TJK,2021-11,0,0,Tajikistan,9537642,Asia,13232,88
TJK,2021-12,0,0,Tajikistan,9537642,Asia,13232,88
TJK,2021-13,0,0,Tajikistan,9537642,Asia,13232,88
TJK,2021-14,0,0,Tajikistan,9537642,Asia,13232,88
TJK,2021-15,0,0,Tajikistan,9537642,Asia,13232,88
TJK,2021-16,0,0,Tajikistan,9537642,Asia,13232,88
TJK,2021-17,0,0,Tajikistan,9537642,Asia,13232,88
TJK,2021-18,406,1,Tajikistan,9537642,Asia,13638,89
TJK,2021-19,0,0,Tajikistan,9537642,Asia,13638,89
TJK,2021-20,0,0,Tajikistan,9537642,Asia,13638,89
TJK,2021-21,0,0,Tajikistan,9537642,Asia,13638,89
TJK,2021-22,0,0,Tajikistan,9537642,Asia,13638,89
TJK,2021-23,0,0,Tajikistan,9537642,Asia,13638,89
TJK,2021-24,0,0,Tajikistan,9537642,Asia,13638,89
TJK,2021-25,107,0,Tajikistan,9537642,Asia,13745,89
TJK,2021-26,154,2,Tajikistan,9537642,Asia,13899,91
TJK,2021-27,227,10,Tajikistan,9537642,Asia,14126,101
TJK,2021-28,284,9,Tajikistan,9537642,Asia,14410,110
TJK,2021-29,106,5,Tajikistan,9537642,Asia,14516,115
TJK,2021-30,558,4,Tajikistan,9537642,Asia,15074,119
TJK,2021-31,501,1,Tajikistan,9537642,Asia,15575,120
TJK,2021-32,470,1,Tajikistan,9537642,Asia,16045,121
TLS,2020-13,0,0,Timor Leste,1318442,Asia,0,0
TLS,2020-14,0,0,Timor Leste,1318442,Asia,0,0
TLS,2020-15,1,0,Timor Leste,1318442,Asia,1,0
TLS,2020-16,17,0,Timor Leste,1318442,Asia,18,0
TLS,2020-17,5,0,Timor Leste,1318442,Asia,23,0
TLS,2020-18,0,0,Timor Leste,1318442,Asia,23,0
TLS,2020-19,0,0,Timor Leste,1318442,Asia,23,0
TLS,2020-20,0,0,Timor Leste,1318442,Asia,23,0
TLS,2020-21,0,0,Timor Leste,1318442,Asia,23,0
TLS,2020-22,0,0,Timor Leste,1318442,Asia,23,0
TLS,2020-23,0,0,Timor Leste,1318442,Asia,23,0
TLS,2020-24,0,0,Timor Leste,1318442,Asia,23,0
TLS,2020-25,0,0,Timor Leste,1318442,Asia,23,0
TLS,2020-26,0,0,Timor Leste,1318442,Asia,23,0
TLS,2020-27,0,0,Timor Leste,1318442,Asia,23,0
TLS,2020-28,0,0,Timor Leste,1318442,Asia,23,0
TLS,2020-29,0,0,Timor Leste,1318442,Asia,23,0
TLS,2020-30,0,0,Timor Leste,1318442,Asia,23,0
TLS,2020-31,0,0,Timor Leste,1318442,Asia,23,0
TLS,2020-32,1,0,Timor Leste,1318442,Asia,24,0
TLS,2020-33,0,0,Timor Leste,1318442,Asia,24,0
TLS,2020-34,1,0,Timor Leste,1318442,Asia,25,0
TLS,2020-35,1,0,Timor Leste,1318442,Asia,26,0
TLS,2020-36,0,0,Timor Leste,1318442,Asia,26,0
TLS,2020-37,0,0,Timor Leste,1318442,Asia,26,0
TLS,2020-38,0,0,Timor Leste,1318442,Asia,26,0
TLS,2020-39,0,0,Timor Leste,1318442,Asia,26,0
TLS,2020-40,1,0,Timor Leste,1318442,Asia,27,0
TLS,2020-41,0,0,Timor Leste,1318442,Asia,27,0
TLS,2020-42,1,0,Timor Leste,1318442,Asia,28,0
TLS,2020-43,0,0,Timor Leste,1318442,Asia,28,0
TLS,2020-44,1,0,Timor Leste,1318442,Asia,29,0
TLS,2020-45,0,0,Timor Leste,1318442,Asia,29,0
TLS,2020-46,0,0,Timor Leste,1318442,Asia,29,0
TLS,2020-47,0,0,Timor Leste,1318442,Asia,29,0
TLS,2020-48,0,0,Timor Leste,1318442,Asia,29,0
TLS,2020-49,1,0,Timor Leste,1318442,Asia,30,0
TLS,2020-50,0,0,Timor Leste,1318442,Asia,30,0
TLS,2020-51,0,0,Timor Leste,1318442,Asia,30,0
TLS,2020-52,10,0,Timor Leste,1318442,Asia,40,0
TLS,2020-53,3,0,Timor Leste,1318442,Asia,43,0
TLS,2021-01,5,0,Timor Leste,1318442,Asia,48,0
TLS,2021-02,3,0,Timor Leste,1318442,Asia,51,0
TLS,2021-03,15,0,Timor Leste,1318442,Asia,66,0
TLS,2021-04,3,0,Timor Leste,1318442,Asia,69,0
TLS,2021-05,10,0,Timor Leste,1318442,Asia,79,0
TLS,2021-06,22,0,Timor Leste,1318442,Asia,101,0
TLS,2021-07,1,0,Timor Leste,1318442,Asia,102,0
TLS,2021-08,10,0,Timor Leste,1318442,Asia,112,0
TLS,2021-09,9,0,Timor Leste,1318442,Asia,121,0
TLS,2021-10,74,0,Timor Leste,1318442,Asia,195,0
TLS,2021-11,75,0,Timor Leste,1318442,Asia,270,0
TLS,2021-12,220,0,Timor Leste,1318442,Asia,490,0
TLS,2021-13,223,0,Timor Leste,1318442,Asia,713,0
TLS,2021-14,294,1,Timor Leste,1318442,Asia,1007,1
TLS,2021-15,298,1,Timor Leste,1318442,Asia,1305,2
TLS,2021-16,502,1,Timor Leste,1318442,Asia,1807,3
TLS,2021-17,636,1,Timor Leste,1318442,Asia,2443,4
TLS,2021-18,783,1,Timor Leste,1318442,Asia,3226,5
TLS,2021-19,1231,5,Timor Leste,1318442,Asia,4457,10
TLS,2021-20,1179,3,Timor Leste,1318442,Asia,5636,13
TLS,2021-21,1260,3,Timor Leste,1318442,Asia,6896,16
TLS,2021-22,843,1,Timor Leste,1318442,Asia,7739,17
TLS,2021-23,601,2,Timor Leste,1318442,Asia,8340,19
TLS,2021-24,366,0,Timor Leste,1318442,Asia,8706,19
TLS,2021-25,328,2,Timor Leste,1318442,Asia,9034,21
TLS,2021-26,441,3,Timor Leste,1318442,Asia,9475,24
TLS,2021-27,347,1,Timor Leste,1318442,Asia,9822,25
TLS,2021-28,305,1,Timor Leste,1318442,Asia,10127,26
TLS,2021-29,220,0,Timor Leste,1318442,Asia,10347,26
TLS,2021-30,618,0,Timor Leste,1318442,Asia,10965,26
TLS,2021-31,613,2,Timor Leste,1318442,Asia,11578,28
TLS,2021-32,986,2,Timor Leste,1318442,Asia,12564,30
TTO,2020-12,46,0,Trinidad And Tobago,1399491,America,46,0
TTO,2020-13,28,3,Trinidad And Tobago,1399491,America,74,3
TTO,2020-14,26,4,Trinidad And Tobago,1399491,America,100,7
TTO,2020-15,9,1,Trinidad And Tobago,1399491,America,109,8
TTO,2020-16,1,0,Trinidad And Tobago,1399491,America,110,8
TTO,2020-17,2,0,Trinidad And Tobago,1399491,America,112,8
TTO,2020-18,0,0,Trinidad And Tobago,1399491,America,112,8
TTO,2020-19,0,0,Trinidad And Tobago,1399491,America,112,8
TTO,2020-20,0,0,Trinidad And Tobago,1399491,America,112,8
TTO,2020-21,0,0,Trinidad And Tobago,1399491,America,112,8
TTO,2020-22,1,0,Trinidad And Tobago,1399491,America,113,8
TTO,2020-23,0,0,Trinidad And Tobago,1399491,America,113,8
TTO,2020-24,6,0,Trinidad And Tobago,1399491,America,119,8
TTO,2020-25,0,0,Trinidad And Tobago,1399491,America,119,8
TTO,2020-26,3,0,Trinidad And Tobago,1399491,America,122,8
TTO,2020-27,7,0,Trinidad And Tobago,1399491,America,129,8
TTO,2020-28,0,0,Trinidad And Tobago,1399491,America,129,8
TTO,2020-29,4,0,Trinidad And Tobago,1399491,America,133,8
TTO,2020-30,10,0,Trinidad And Tobago,1399491,America,143,8
TTO,2020-31,35,0,Trinidad And Tobago,1399491,America,178,8
TTO,2020-32,97,0,Trinidad And Tobago,1399491,America,275,8
TTO,2020-33,273,3,Trinidad And Tobago,1399491,America,548,11
TTO,2020-34,455,3,Trinidad And Tobago,1399491,America,1003,14
TTO,2020-35,676,7,Trinidad And Tobago,1399491,America,1679,21
TTO,2020-36,567,13,Trinidad And Tobago,1399491,America,2246,34
TTO,2020-37,792,19,Trinidad And Tobago,1399491,America,3038,53
TTO,2020-38,859,12,Trinidad And Tobago,1399491,America,3897,65
TTO,2020-39,461,6,Trinidad And Tobago,1399491,America,4358,71
TTO,2020-40,401,10,Trinidad And Tobago,1399491,America,4759,81
TTO,2020-41,338,9,Trinidad And Tobago,1399491,America,5097,90
TTO,2020-42,196,6,Trinidad And Tobago,1399491,America,5293,96
TTO,2020-43,214,9,Trinidad And Tobago,1399491,America,5507,105
TTO,2020-44,157,2,Trinidad And Tobago,1399491,America,5664,107
TTO,2020-45,181,4,Trinidad And Tobago,1399491,America,5845,111
TTO,2020-46,231,1,Trinidad And Tobago,1399491,America,6076,112
TTO,2020-47,370,3,Trinidad And Tobago,1399491,America,6446,115
TTO,2020-48,210,5,Trinidad And Tobago,1399491,America,6656,120
TTO,2020-49,107,2,Trinidad And Tobago,1399491,America,6763,122
TTO,2020-50,112,0,Trinidad And Tobago,1399491,America,6875,122
TTO,2020-51,133,3,Trinidad And Tobago,1399491,America,7008,125
TTO,2020-52,103,0,Trinidad And Tobago,1399491,America,7111,125
TTO,2020-53,53,2,Trinidad And Tobago,1399491,America,7164,127
TTO,2021-01,97,1,Trinidad And Tobago,1399491,America,7261,128
TTO,2021-02,128,4,Trinidad And Tobago,1399491,America,7389,132
TTO,2021-03,97,2,Trinidad And Tobago,1399491,America,7486,134
TTO,2021-04,74,0,Trinidad And Tobago,1399491,America,7560,134
TTO,2021-05,52,1,Trinidad And Tobago,1399491,America,7612,135
TTO,2021-06,30,3,Trinidad And Tobago,1399491,America,7642,138
TTO,2021-07,34,1,Trinidad And Tobago,1399491,America,7676,139
TTO,2021-08,33,0,Trinidad And Tobago,1399491,America,7709,139
TTO,2021-09,23,0,Trinidad And Tobago,1399491,America,7732,139
TTO,2021-10,52,1,Trinidad And Tobago,1399491,America,7784,140
TTO,2021-11,67,0,Trinidad And Tobago,1399491,America,7851,140
TTO,2021-12,131,2,Trinidad And Tobago,1399491,America,7982,142
TTO,2021-13,192,3,Trinidad And Tobago,1399491,America,8174,145
TTO,2021-14,263,1,Trinidad And Tobago,1399491,America,8437,146
TTO,2021-15,499,7,Trinidad And Tobago,1399491,America,8936,153
TTO,2021-16,856,6,Trinidad And Tobago,1399491,America,9792,159
TTO,2021-17,1675,20,Trinidad And Tobago,1399491,America,11467,179
TTO,2021-18,1884,32,Trinidad And Tobago,1399491,America,13351,211
TTO,2021-19,2900,74,Trinidad And Tobago,1399491,America,16251,285
TTO,2021-20,3762,90,Trinidad And Tobago,1399491,America,20013,375
TTO,2021-21,3621,104,Trinidad And Tobago,1399491,America,23634,479
TTO,2021-22,2772,98,Trinidad And Tobago,1399491,America,26406,577
TTO,2021-23,2313,93,Trinidad And Tobago,1399491,America,28719,670
TTO,2021-24,1896,67,Trinidad And Tobago,1399491,America,30615,737
TTO,2021-25,1579,80,Trinidad And Tobago,1399491,America,32194,817
TTO,2021-26,1357,82,Trinidad And Tobago,1399491,America,33551,899
TTO,2021-27,1267,42,Trinidad And Tobago,1399491,America,34818,941
TTO,2021-28,1376,57,Trinidad And Tobago,1399491,America,36194,998
TTO,2021-29,1465,45,Trinidad And Tobago,1399491,America,37659,1043
TTO,2021-30,1376,49,Trinidad And Tobago,1399491,America,39035,1092
TTO,2021-31,1322,47,Trinidad And Tobago,1399491,America,40357,1139
TTO,2021-32,1594,49,Trinidad And Tobago,1399491,America,41951,1188
TUN,2020-12,57,3,Tunisia,11818618,Africa,57,3
TUN,2020-13,203,5,Tunisia,11818618,Africa,260,8
TUN,2020-14,275,11,Tunisia,11818618,Africa,535,19
TUN,2020-15,154,12,Tunisia,11818618,Africa,689,31
TUN,2020-16,172,7,Tunisia,11818618,Africa,861,38
TUN,2020-17,70,0,Tunisia,11818618,Africa,931,38
TUN,2020-18,64,4,Tunisia,11818618,Africa,995,42
TUN,2020-19,19,3,Tunisia,11818618,Africa,1014,45
TUN,2020-20,5,0,Tunisia,11818618,Africa,1019,45
TUN,2020-21,14,3,Tunisia,11818618,Africa,1033,48
TUN,2020-22,26,0,Tunisia,11818618,Africa,1059,48
TUN,2020-23,10,1,Tunisia,11818618,Africa,1069,49
TUN,2020-24,9,0,Tunisia,11818618,Africa,1078,49
TUN,2020-25,61,1,Tunisia,11818618,Africa,1139,50
TUN,2020-26,12,0,Tunisia,11818618,Africa,1151,50
TUN,2020-27,19,0,Tunisia,11818618,Africa,1170,50
TUN,2020-28,75,0,Tunisia,11818618,Africa,1245,50
TUN,2020-29,111,0,Tunisia,11818618,Africa,1356,50
TUN,2020-30,78,0,Tunisia,11818618,Africa,1434,50
TUN,2020-31,109,1,Tunisia,11818618,Africa,1543,51
TUN,2020-32,136,0,Tunisia,11818618,Africa,1679,51
TUN,2020-33,410,3,Tunisia,11818618,Africa,2089,54
TUN,2020-34,631,14,Tunisia,11818618,Africa,2720,68
TUN,2020-35,947,8,Tunisia,11818618,Africa,3667,76
TUN,2020-36,1091,17,Tunisia,11818618,Africa,4758,93
TUN,2020-37,1859,14,Tunisia,11818618,Africa,6617,107
TUN,2020-38,4097,52,Tunisia,11818618,Africa,10714,159
TUN,2020-39,5382,55,Tunisia,11818618,Africa,16096,214
TUN,2020-40,7339,107,Tunisia,11818618,Africa,23435,321
TUN,2020-41,7806,135,Tunisia,11818618,Africa,31241,456
TUN,2020-42,9283,170,Tunisia,11818618,Africa,40524,626
TUN,2020-43,8257,193,Tunisia,11818618,Africa,48781,819
TUN,2020-44,13107,562,Tunisia,11818618,Africa,61888,1381
TUN,2020-45,9213,492,Tunisia,11818618,Africa,71101,1873
TUN,2020-46,9285,472,Tunisia,11818618,Africa,80386,2345
TUN,2020-47,8307,476,Tunisia,11818618,Africa,88693,2821
TUN,2020-48,7540,398,Tunisia,11818618,Africa,96233,3219
TUN,2020-49,7751,342,Tunisia,11818618,Africa,103984,3561
TUN,2020-50,7359,333,Tunisia,11818618,Africa,111343,3894
TUN,2020-51,10357,305,Tunisia,11818618,Africa,121700,4199
TUN,2020-52,9874,267,Tunisia,11818618,Africa,131574,4466
TUN,2020-53,11952,334,Tunisia,11818618,Africa,143526,4800
TUN,2021-01,18806,484,Tunisia,11818618,Africa,162332,5284
TUN,2021-02,19535,466,Tunisia,11818618,Africa,181867,5750
TUN,2021-03,16751,537,Tunisia,11818618,Africa,198618,6287
TUN,2021-04,11409,515,Tunisia,11818618,Africa,210027,6802
TUN,2021-05,7041,412,Tunisia,11818618,Africa,217068,7214
TUN,2021-06,6463,361,Tunisia,11818618,Africa,223531,7575
TUN,2021-07,5388,236,Tunisia,11818618,Africa,228919,7811
TUN,2021-08,4732,211,Tunisia,11818618,Africa,233651,8022
TUN,2021-09,4348,203,Tunisia,11818618,Africa,237999,8225
TUN,2021-10,4107,179,Tunisia,11818618,Africa,242106,8404
TUN,2021-11,3799,165,Tunisia,11818618,Africa,245905,8569
TUN,2021-12,5246,191,Tunisia,11818618,Africa,251151,8760
TUN,2021-13,10008,233,Tunisia,11818618,Africa,261159,8993
TUN,2021-14,10684,300,Tunisia,11818618,Africa,271843,9293
TUN,2021-15,15200,532,Tunisia,11818618,Africa,287043,9825
TUN,2021-16,14566,527,Tunisia,11818618,Africa,301609,10352
TUN,2021-17,11120,563,Tunisia,11818618,Africa,312729,10915
TUN,2021-18,9090,553,Tunisia,11818618,Africa,321819,11468
TUN,2021-19,5636,431,Tunisia,11818618,Africa,327455,11899
TUN,2021-20,8941,374,Tunisia,11818618,Africa,336396,12273
TUN,2021-21,9060,381,Tunisia,11818618,Africa,345456,12654
TUN,2021-22,11276,373,Tunisia,11818618,Africa,356732,13027
TUN,2021-23,13474,540,Tunisia,11818618,Africa,370206,13567
TUN,2021-24,12726,471,Tunisia,11818618,Africa,382932,14038
TUN,2021-25,25981,699,Tunisia,11818618,Africa,408913,14737
TUN,2021-26,38230,745,Tunisia,11818618,Africa,447143,15482
TUN,2021-27,55762,1012,Tunisia,11818618,Africa,502905,16494
TUN,2021-28,45830,1150,Tunisia,11818618,Africa,548735,17644
TUN,2021-29,26249,1324,Tunisia,11818618,Africa,574984,18968
TUN,2021-30,21773,1258,Tunisia,11818618,Africa,596757,20226
TUN,2021-31,16853,863,Tunisia,11818618,Africa,613610,21089
TUN,2021-32,13122,936,Tunisia,11818618,Africa,626732,22025
TUR,2020-12,1218,30,Turkey,83154997,Europe,1218,30
TUR,2020-13,8035,101,Turkey,83154997,Europe,9253,131
TUR,2020-14,17798,443,Turkey,83154997,Europe,27051,574
TUR,2020-15,29887,624,Turkey,83154997,Europe,56938,1198
TUR,2020-16,29350,819,Turkey,83154997,Europe,86288,2017
TUR,2020-17,23824,788,Turkey,83154997,Europe,110112,2805
TUR,2020-18,15915,592,Turkey,83154997,Europe,126027,3397
TUR,2020-19,12612,389,Turkey,83154997,Europe,138639,3786
TUR,2020-20,10778,354,Turkey,83154997,Europe,149417,4140
TUR,2020-21,7392,200,Turkey,83154997,Europe,156809,4340
TUR,2020-22,7115,200,Turkey,83154997,Europe,163924,4540
TUR,2020-23,6190,152,Turkey,83154997,Europe,170114,4692
TUR,2020-24,8107,115,Turkey,83154997,Europe,178221,4807
TUR,2020-25,9446,143,Turkey,83154997,Europe,187667,4950
TUR,2020-26,9554,147,Turkey,83154997,Europe,197221,5097
TUR,2020-27,8519,128,Turkey,83154997,Europe,205740,5225
TUR,2020-28,7235,138,Turkey,83154997,Europe,212975,5363
TUR,2020-29,6648,128,Turkey,83154997,Europe,219623,5491
TUR,2020-30,6459,122,Turkey,83154997,Europe,226082,5613
TUR,2020-31,47136,115,Turkey,83154997,Europe,273218,5728
TUR,2020-32,55058,116,Turkey,83154997,Europe,328276,5844
TUR,2020-33,55615,130,Turkey,83154997,Europe,383891,5974
TUR,2020-34,56050,147,Turkey,83154997,Europe,439941,6121
TUR,2020-35,57407,205,Turkey,83154997,Europe,497348,6326
TUR,2020-36,58370,347,Turkey,83154997,Europe,555718,6673
TUR,2020-37,58466,383,Turkey,83154997,Europe,614184,7056
TUR,2020-38,58815,450,Turkey,83154997,Europe,672999,7506
TUR,2020-39,58676,491,Turkey,83154997,Europe,731675,7997
TUR,2020-40,57120,444,Turkey,83154997,Europe,788795,8441
TUR,2020-41,58200,396,Turkey,83154997,Europe,846995,8837
TUR,2020-42,59070,459,Turkey,83154997,Europe,906065,9296
TUR,2020-43,61418,503,Turkey,83154997,Europe,967483,9799
TUR,2020-44,62782,527,Turkey,83154997,Europe,1030265,10326
TUR,2020-45,63892,561,Turkey,83154997,Europe,1094157,10887
TUR,2020-46,67133,620,Turkey,83154997,Europe,1161290,11507
TUR,2020-47,79659,851,Turkey,83154997,Europe,1240949,12358
TUR,2020-48,159462,1200,Turkey,83154997,Europe,1400411,13558
TUR,2020-49,220667,1342,Turkey,83154997,Europe,1621078,14900
TUR,2020-50,215632,1517,Turkey,83154997,Europe,1836710,16417
TUR,2020-51,187873,1680,Turkey,83154997,Europe,2024583,18097
TUR,2020-52,122977,1781,Turkey,83154997,Europe,2147560,19878
TUR,2020-53,94334,1610,Turkey,83154997,Europe,2241894,21488
TUR,2021-01,84344,1319,Turkey,83154997,Europe,2326238,22807
TUR,2021-02,60845,1190,Turkey,83154997,Europe,2387083,23997
TUR,2021-03,42504,1076,Turkey,83154997,Europe,2429587,25073
TUR,2021-04,47858,920,Turkey,83154997,Europe,2477445,25993
TUR,2021-05,53993,804,Turkey,83154997,Europe,2531438,26797
TUR,2021-06,54727,674,Turkey,83154997,Europe,2586165,27471
TUR,2021-07,52239,589,Turkey,83154997,Europe,2638404,28060
TUR,2021-08,63166,509,Turkey,83154997,Europe,2701570,28569
TUR,2021-09,78829,461,Turkey,83154997,Europe,2780399,29030
TUR,2021-10,98973,459,Turkey,83154997,Europe,2879372,29489
TUR,2021-11,133732,572,Turkey,83154997,Europe,3013104,30061
TUR,2021-12,195051,1015,Turkey,83154997,Europe,3208155,31076
TUR,2021-13,278877,1187,Turkey,83154997,Europe,3487032,32263
TUR,2021-14,361961,1676,Turkey,83154997,Europe,3848993,33939
TUR,2021-15,419436,1987,Turkey,83154997,Europe,4268429,35926
TUR,2021-16,361522,2432,Turkey,83154997,Europe,4629951,38358
TUR,2021-17,245419,2486,Turkey,83154997,Europe,4875370,40844
TUR,2021-18,155944,2185,Turkey,83154997,Europe,5031314,43029
TUR,2021-19,86042,1731,Turkey,83154997,Europe,5117356,44760
TUR,2021-20,69113,1508,Turkey,83154997,Europe,5186469,46268
TUR,2021-21,56424,1137,Turkey,83154997,Europe,5242893,47405
TUR,2021-22,45069,759,Turkey,83154997,Europe,5287962,48164
TUR,2021-23,42467,557,Turkey,83154997,Europe,5330429,48721
TUR,2021-24,39852,464,Turkey,83154997,Europe,5370281,49185
TUR,2021-25,38728,391,Turkey,83154997,Europe,5409009,49576
TUR,2021-26,35759,348,Turkey,83154997,Europe,5444768,49924
TUR,2021-27,31508,268,Turkey,83154997,Europe,5476276,50192
TUR,2021-28,53425,362,Turkey,83154997,Europe,5529701,50554
TUR,2021-29,57659,325,Turkey,83154997,Europe,5587360,50879
TUR,2021-30,139667,453,Turkey,83154997,Europe,5727027,51332
TUR,2021-31,144839,649,Turkey,83154997,Europe,5871866,51981
TUR,2021-32,187922,1024,Turkey,83154997,Europe,6059788,53005
TWN,2020-02,0,0,Taiwan,23816775,Asia,0,0
TWN,2020-03,0,0,Taiwan,23816775,Asia,0,0
TWN,2020-04,5,0,Taiwan,23816775,Asia,5,0
TWN,2020-05,5,0,Taiwan,23816775,Asia,10,0
TWN,2020-06,8,0,Taiwan,23816775,Asia,18,0
TWN,2020-07,2,1,Taiwan,23816775,Asia,20,1
TWN,2020-08,8,0,Taiwan,23816775,Asia,28,1
TWN,2020-09,12,0,Taiwan,23816775,Asia,40,1
TWN,2020-10,5,0,Taiwan,23816775,Asia,45,1
TWN,2020-11,14,0,Taiwan,23816775,Asia,59,1
TWN,2020-12,106,1,Taiwan,23816775,Asia,165,2
TWN,2020-13,141,3,Taiwan,23816775,Asia,306,5
TWN,2020-14,57,0,Taiwan,23816775,Asia,363,5
TWN,2020-15,25,1,Taiwan,23816775,Asia,388,6
TWN,2020-16,32,0,Taiwan,23816775,Asia,420,6
TWN,2020-17,9,0,Taiwan,23816775,Asia,429,6
TWN,2020-18,7,0,Taiwan,23816775,Asia,436,6
TWN,2020-19,4,0,Taiwan,23816775,Asia,440,6
TWN,2020-20,0,1,Taiwan,23816775,Asia,440,7
TWN,2020-21,1,0,Taiwan,23816775,Asia,441,7
TWN,2020-22,1,0,Taiwan,23816775,Asia,442,7
TWN,2020-23,1,0,Taiwan,23816775,Asia,443,7
TWN,2020-24,0,0,Taiwan,23816775,Asia,443,7
TWN,2020-25,3,0,Taiwan,23816775,Asia,446,7
TWN,2020-26,1,0,Taiwan,23816775,Asia,447,7
TWN,2020-27,2,0,Taiwan,23816775,Asia,449,7
TWN,2020-28,2,0,Taiwan,23816775,Asia,451,7
TWN,2020-29,4,0,Taiwan,23816775,Asia,455,7
TWN,2020-30,7,0,Taiwan,23816775,Asia,462,7
TWN,2020-31,13,0,Taiwan,23816775,Asia,475,7
TWN,2020-32,5,0,Taiwan,23816775,Asia,480,7
TWN,2020-33,5,0,Taiwan,23816775,Asia,485,7
TWN,2020-34,2,0,Taiwan,23816775,Asia,487,7
TWN,2020-35,1,0,Taiwan,23816775,Asia,488,7
TWN,2020-36,5,0,Taiwan,23816775,Asia,493,7
TWN,2020-37,5,0,Taiwan,23816775,Asia,498,7
TWN,2020-38,11,0,Taiwan,23816775,Asia,509,7
TWN,2020-39,1,0,Taiwan,23816775,Asia,510,7
TWN,2020-40,7,0,Taiwan,23816775,Asia,517,7
TWN,2020-41,10,0,Taiwan,23816775,Asia,527,7
TWN,2020-42,13,0,Taiwan,23816775,Asia,540,7
TWN,2020-43,10,0,Taiwan,23816775,Asia,550,7
TWN,2020-44,13,0,Taiwan,23816775,Asia,563,7
TWN,2020-45,15,0,Taiwan,23816775,Asia,578,7
TWN,2020-46,25,0,Taiwan,23816775,Asia,603,7
TWN,2020-47,15,0,Taiwan,23816775,Asia,618,7
TWN,2020-48,57,0,Taiwan,23816775,Asia,675,7
TWN,2020-49,41,0,Taiwan,23816775,Asia,716,7
TWN,2020-50,24,0,Taiwan,23816775,Asia,740,7
TWN,2020-51,26,0,Taiwan,23816775,Asia,766,7
TWN,2020-52,27,0,Taiwan,23816775,Asia,793,7
TWN,2020-53,22,0,Taiwan,23816775,Asia,815,7
TWN,2021-01,19,0,Taiwan,23816775,Asia,834,7
TWN,2021-02,28,0,Taiwan,23816775,Asia,862,7
TWN,2021-03,27,0,Taiwan,23816775,Asia,889,7
TWN,2021-04,23,1,Taiwan,23816775,Asia,912,8
TWN,2021-05,16,1,Taiwan,23816775,Asia,928,9
TWN,2021-06,9,0,Taiwan,23816775,Asia,937,9
TWN,2021-07,5,0,Taiwan,23816775,Asia,942,9
TWN,2021-08,13,0,Taiwan,23816775,Asia,955,9
TWN,2021-09,21,1,Taiwan,23816775,Asia,976,10
TWN,2021-10,14,0,Taiwan,23816775,Asia,990,10
TWN,2021-11,16,0,Taiwan,23816775,Asia,1006,10
TWN,2021-12,16,0,Taiwan,23816775,Asia,1022,10
TWN,2021-13,26,0,Taiwan,23816775,Asia,1048,10
TWN,2021-14,10,1,Taiwan,23816775,Asia,1058,11
TWN,2021-15,15,0,Taiwan,23816775,Asia,1073,11
TWN,2021-16,31,1,Taiwan,23816775,Asia,1104,12
TWN,2021-17,41,0,Taiwan,23816775,Asia,1145,12
TWN,2021-18,54,0,Taiwan,23816775,Asia,1199,12
TWN,2021-19,818,0,Taiwan,23816775,Asia,2017,12
TWN,2021-20,2305,11,Taiwan,23816775,Asia,4322,23
TWN,2021-21,4189,101,Taiwan,23816775,Asia,8511,124
TWN,2021-22,2980,162,Taiwan,23816775,Asia,11491,286
TWN,2021-23,1615,166,Taiwan,23816775,Asia,13106,452
TWN,2021-24,974,117,Taiwan,23816775,Asia,14080,569
TWN,2021-25,614,66,Taiwan,23816775,Asia,14694,635
TWN,2021-26,367,54,Taiwan,23816775,Asia,15061,689
TWN,2021-27,212,52,Taiwan,23816775,Asia,15273,741
TWN,2021-28,156,28,Taiwan,23816775,Asia,15429,769
TWN,2021-29,142,17,Taiwan,23816775,Asia,15571,786
TWN,2021-30,131,3,Taiwan,23816775,Asia,15702,789
TWN,2021-31,88,24,Taiwan,23816775,Asia,15790,813
TWN,2021-32,62,8,Taiwan,23816775,Asia,15852,821
TZA,2020-13,2,1,United Republic Of Tanzania,59734213,Africa,2,1
TZA,2020-14,8,0,United Republic Of Tanzania,59734213,Africa,10,1
TZA,2020-15,10,2,United Republic Of Tanzania,59734213,Africa,20,3
TZA,2020-16,138,2,United Republic Of Tanzania,59734213,Africa,158,5
TZA,2020-17,130,5,United Republic Of Tanzania,59734213,Africa,288,10
TZA,2020-18,180,6,United Republic Of Tanzania,59734213,Africa,468,16
TZA,2020-19,29,5,United Republic Of Tanzania,59734213,Africa,497,21
TZA,2020-20,0,0,United Republic Of Tanzania,59734213,Africa,497,21
TZA,2020-21,0,0,United Republic Of Tanzania,59734213,Africa,497,21
TZA,2020-22,0,0,United Republic Of Tanzania,59734213,Africa,497,21
TZA,2020-23,0,0,United Republic Of Tanzania,59734213,Africa,497,21
TZA,2020-24,0,0,United Republic Of Tanzania,59734213,Africa,497,21
TZA,2020-25,0,0,United Republic Of Tanzania,59734213,Africa,497,21
TZA,2020-26,0,0,United Republic Of Tanzania,59734213,Africa,497,21
TZA,2020-27,0,0,United Republic Of Tanzania,59734213,Africa,497,21
TZA,2020-28,0,0,United Republic Of Tanzania,59734213,Africa,497,21
TZA,2020-29,0,0,United Republic Of Tanzania,59734213,Africa,497,21
TZA,2020-30,0,0,United Republic Of Tanzania,59734213,Africa,497,21
TZA,2020-31,0,0,United Republic Of Tanzania,59734213,Africa,497,21
TZA,2020-32,0,0,United Republic Of Tanzania,59734213,Africa,497,21
TZA,2020-33,0,0,United Republic Of Tanzania,59734213,Africa,497,21
TZA,2020-34,0,0,United Republic Of Tanzania,59734213,Africa,497,21
TZA,2020-35,0,0,United Republic Of Tanzania,59734213,Africa,497,21
TZA,2020-36,0,0,United Republic Of Tanzania,59734213,Africa,497,21
TZA,2020-37,0,0,United Republic Of Tanzania,59734213,Africa,497,21
TZA,2020-38,0,0,United Republic Of Tanzania,59734213,Africa,497,21
TZA,2020-39,0,0,United Republic Of Tanzania,59734213,Africa,497,21
TZA,2020-40,0,0,United Republic Of Tanzania,59734213,Africa,497,21
TZA,2020-41,0,0,United Republic Of Tanzania,59734213,Africa,497,21
TZA,2020-42,0,0,United Republic Of Tanzania,59734213,Africa,497,21
TZA,2020-43,0,0,United Republic Of Tanzania,59734213,Africa,497,21
TZA,2020-44,0,0,United Republic Of Tanzania,59734213,Africa,497,21
TZA,2020-45,0,0,United Republic Of Tanzania,59734213,Africa,497,21
TZA,2020-46,0,0,United Republic Of Tanzania,59734213,Africa,497,21
TZA,2020-47,0,0,United Republic Of Tanzania,59734213,Africa,497,21
TZA,2020-48,0,0,United Republic Of Tanzania,59734213,Africa,497,21
TZA,2020-49,0,0,United Republic Of Tanzania,59734213,Africa,497,21
TZA,2020-50,0,0,United Republic Of Tanzania,59734213,Africa,497,21
TZA,2020-51,0,0,United Republic Of Tanzania,59734213,Africa,497,21
TZA,2020-52,0,0,United Republic Of Tanzania,59734213,Africa,497,21
TZA,2020-53,0,0,United Republic Of Tanzania,59734213,Africa,497,21
TZA,2021-01,0,0,United Republic Of Tanzania,59734213,Africa,497,21
TZA,2021-02,0,0,United Republic Of Tanzania,59734213,Africa,497,21
TZA,2021-03,0,0,United Republic Of Tanzania,59734213,Africa,497,21
TZA,2021-04,0,0,United Republic Of Tanzania,59734213,Africa,497,21
TZA,2021-05,0,0,United Republic Of Tanzania,59734213,Africa,497,21
TZA,2021-06,0,0,United Republic Of Tanzania,59734213,Africa,497,21
TZA,2021-07,0,0,United Republic Of Tanzania,59734213,Africa,497,21
TZA,2021-08,0,0,United Republic Of Tanzania,59734213,Africa,497,21
TZA,2021-09,0,0,United Republic Of Tanzania,59734213,Africa,497,21
TZA,2021-10,0,0,United Republic Of Tanzania,59734213,Africa,497,21
TZA,2021-11,0,0,United Republic Of Tanzania,59734213,Africa,497,21
TZA,2021-12,0,0,United Republic Of Tanzania,59734213,Africa,497,21
TZA,2021-13,0,0,United Republic Of Tanzania,59734213,Africa,497,21
TZA,2021-14,0,0,United Republic Of Tanzania,59734213,Africa,497,21
TZA,2021-15,0,0,United Republic Of Tanzania,59734213,Africa,497,21
TZA,2021-16,0,0,United Republic Of Tanzania,59734213,Africa,497,21
TZA,2021-17,0,0,United Republic Of Tanzania,59734213,Africa,497,21
TZA,2021-18,0,0,United Republic Of Tanzania,59734213,Africa,497,21
TZA,2021-19,0,0,United Republic Of Tanzania,59734213,Africa,497,21
TZA,2021-20,0,0,United Republic Of Tanzania,59734213,Africa,497,21
TZA,2021-21,0,0,United Republic Of Tanzania,59734213,Africa,497,21
TZA,2021-22,0,0,United Republic Of Tanzania,59734213,Africa,497,21
TZA,2021-23,0,0,United Republic Of Tanzania,59734213,Africa,497,21
TZA,2021-24,0,0,United Republic Of Tanzania,59734213,Africa,497,21
TZA,2021-25,100,0,United Republic Of Tanzania,59734213,Africa,597,21
TZA,2021-26,0,0,United Republic Of Tanzania,59734213,Africa,597,21
TZA,2021-27,408,0,United Republic Of Tanzania,59734213,Africa,1005,21
TZA,2021-28,0,0,United Republic Of Tanzania,59734213,Africa,1005,21
TZA,2021-29,0,0,United Republic Of Tanzania,59734213,Africa,1005,21
TZA,2021-30,0,0,United Republic Of Tanzania,59734213,Africa,1005,21
TZA,2021-31,15953,8,United Republic Of Tanzania,59734213,Africa,16958,29
TZA,2021-32,0,21,United Republic Of Tanzania,59734213,Africa,16958,50
UGA,2020-13,32,0,Uganda,45741000,Africa,32,0
UGA,2020-14,19,0,Uganda,45741000,Africa,51,0
UGA,2020-15,2,0,Uganda,45741000,Africa,53,0
UGA,2020-16,1,0,Uganda,45741000,Africa,54,0
UGA,2020-17,24,0,Uganda,45741000,Africa,78,0
UGA,2020-18,10,0,Uganda,45741000,Africa,88,0
UGA,2020-19,32,0,Uganda,45741000,Africa,120,0
UGA,2020-20,106,0,Uganda,45741000,Africa,226,0
UGA,2020-21,-15,0,Uganda,45741000,Africa,211,0
UGA,2020-22,246,0,Uganda,45741000,Africa,457,0
UGA,2020-23,158,0,Uganda,45741000,Africa,615,0
UGA,2020-24,80,0,Uganda,45741000,Africa,695,0
UGA,2020-25,74,0,Uganda,45741000,Africa,769,0
UGA,2020-26,89,0,Uganda,45741000,Africa,858,0
UGA,2020-27,80,0,Uganda,45741000,Africa,938,0
UGA,2020-28,86,0,Uganda,45741000,Africa,1024,0
UGA,2020-29,40,0,Uganda,45741000,Africa,1064,0
UGA,2020-30,50,2,Uganda,45741000,Africa,1114,2
UGA,2020-31,67,2,Uganda,45741000,Africa,1181,4
UGA,2020-32,101,3,Uganda,45741000,Africa,1282,7
UGA,2020-33,217,6,Uganda,45741000,Africa,1499,13
UGA,2020-34,763,6,Uganda,45741000,Africa,2262,19
UGA,2020-35,665,11,Uganda,45741000,Africa,2927,30
UGA,2020-36,739,11,Uganda,45741000,Africa,3666,41
UGA,2020-37,1132,14,Uganda,45741000,Africa,4798,55
UGA,2020-38,1488,8,Uganda,45741000,Africa,6286,63
UGA,2020-39,1243,10,Uganda,45741000,Africa,7529,73
UGA,2020-40,1278,8,Uganda,45741000,Africa,8807,81
UGA,2020-41,993,12,Uganda,45741000,Africa,9800,93
UGA,2020-42,789,4,Uganda,45741000,Africa,10589,97
UGA,2020-43,853,4,Uganda,45741000,Africa,11442,101
UGA,2020-44,1300,11,Uganda,45741000,Africa,12742,112
UGA,2020-45,1660,20,Uganda,45741000,Africa,14402,132
UGA,2020-46,1617,13,Uganda,45741000,Africa,16019,145
UGA,2020-47,1948,27,Uganda,45741000,Africa,17967,172
UGA,2020-48,2177,29,Uganda,45741000,Africa,20144,201
UGA,2020-49,2354,5,Uganda,45741000,Africa,22498,206
UGA,2020-50,5033,15,Uganda,45741000,Africa,27531,221
UGA,2020-51,3655,10,Uganda,45741000,Africa,31186,231
UGA,2020-52,2786,17,Uganda,45741000,Africa,33972,248
UGA,2020-53,2077,26,Uganda,45741000,Africa,36049,274
UGA,2021-01,1758,28,Uganda,45741000,Africa,37807,302
UGA,2021-02,277,2,Uganda,45741000,Africa,38084,304
UGA,2021-03,1103,14,Uganda,45741000,Africa,39187,318
UGA,2021-04,418,7,Uganda,45741000,Africa,39605,325
UGA,2021-05,254,2,Uganda,45741000,Africa,39859,327
UGA,2021-06,203,4,Uganda,45741000,Africa,40062,331
UGA,2021-07,150,2,Uganda,45741000,Africa,40212,333
UGA,2021-08,122,1,Uganda,45741000,Africa,40334,334
UGA,2021-09,150,0,Uganda,45741000,Africa,40484,334
UGA,2021-10,96,0,Uganda,45741000,Africa,40580,334
UGA,2021-11,70,0,Uganda,45741000,Africa,40650,334
UGA,2021-12,116,1,Uganda,45741000,Africa,40766,335
UGA,2021-13,195,0,Uganda,45741000,Africa,40961,335
UGA,2021-14,242,2,Uganda,45741000,Africa,41203,337
UGA,2021-15,218,4,Uganda,45741000,Africa,41421,341
UGA,2021-16,199,0,Uganda,45741000,Africa,41620,341
UGA,2021-17,352,1,Uganda,45741000,Africa,41972,342
UGA,2021-18,411,4,Uganda,45741000,Africa,42383,346
UGA,2021-19,475,1,Uganda,45741000,Africa,42858,347
UGA,2021-20,875,9,Uganda,45741000,Africa,43733,356
UGA,2021-21,3413,6,Uganda,45741000,Africa,47146,362
UGA,2021-22,5788,21,Uganda,45741000,Africa,52934,383
UGA,2021-23,7315,40,Uganda,45741000,Africa,60249,423
UGA,2021-24,11293,237,Uganda,45741000,Africa,71542,660
UGA,2021-25,7546,296,Uganda,45741000,Africa,79088,956
UGA,2021-26,4547,983,Uganda,45741000,Africa,83635,1939
UGA,2021-27,4120,190,Uganda,45741000,Africa,87755,2129
UGA,2021-28,2900,263,Uganda,45741000,Africa,90655,2392
UGA,2021-29,2139,198,Uganda,45741000,Africa,92794,2590
UGA,2021-30,1742,135,Uganda,45741000,Africa,94536,2725
UGA,2021-31,1338,83,Uganda,45741000,Africa,95874,2808
UGA,2021-32,1112,0,Uganda,45741000,Africa,96986,2808
UKR,2020-12,44,3,Ukraine,43733759,Europe,44,3
UKR,2020-13,371,6,Ukraine,43733759,Europe,415,9
UKR,2020-14,890,28,Ukraine,43733759,Europe,1305,37
UKR,2020-15,1469,46,Ukraine,43733759,Europe,2774,83
UKR,2020-16,2672,58,Ukraine,43733759,Europe,5446,141
UKR,2020-17,3168,68,Ukraine,43733759,Europe,8614,209
UKR,2020-18,3296,79,Ukraine,43733759,Europe,11910,288
UKR,2020-19,3319,103,Ukraine,43733759,Europe,15229,391
UKR,2020-20,3059,123,Ukraine,43733759,Europe,18288,514
UKR,2020-21,2695,103,Ukraine,43733759,Europe,20983,617
UKR,2020-22,2686,91,Ukraine,43733759,Europe,23669,708
UKR,2020-23,3327,80,Ukraine,43733759,Europe,26996,788
UKR,2020-24,4155,101,Ukraine,43733759,Europe,31151,889
UKR,2020-25,5406,113,Ukraine,43733759,Europe,36557,1002
UKR,2020-26,6422,127,Ukraine,43733759,Europe,42979,1129
UKR,2020-27,5518,120,Ukraine,43733759,Europe,48497,1249
UKR,2020-28,5021,134,Ukraine,43733759,Europe,53518,1383
UKR,2020-29,5321,102,Ukraine,43733759,Europe,58839,1485
UKR,2020-30,6007,120,Ukraine,43733759,Europe,64846,1605
UKR,2020-31,7319,120,Ukraine,43733759,Europe,72165,1725
UKR,2020-32,9789,197,Ukraine,43733759,Europe,81954,1922
UKR,2020-33,10863,167,Ukraine,43733759,Europe,92817,2089
UKR,2020-34,12138,182,Ukraine,43733759,Europe,104955,2271
UKR,2020-35,14116,256,Ukraine,43733759,Europe,119071,2527
UKR,2020-36,16820,284,Ukraine,43733759,Europe,135891,2811
UKR,2020-37,18441,367,Ukraine,43733759,Europe,154332,3178
UKR,2020-38,21343,379,Ukraine,43733759,Europe,175675,3557
UKR,2020-39,22956,402,Ukraine,43733759,Europe,198631,3959
UKR,2020-40,27828,438,Ukraine,43733759,Europe,226459,4397
UKR,2020-41,34572,575,Ukraine,43733759,Europe,261031,4972
UKR,2020-42,42604,701,Ukraine,43733759,Europe,303635,5673
UKR,2020-43,39851,718,Ukraine,43733759,Europe,343486,6391
UKR,2020-44,51951,915,Ukraine,43733759,Europe,395437,7306
UKR,2020-45,64891,1144,Ukraine,43733759,Europe,460328,8450
UKR,2020-46,75526,1153,Ukraine,43733759,Europe,535854,9603
UKR,2020-47,76808,1210,Ukraine,43733759,Europe,612662,10813
UKR,2020-48,110014,1400,Ukraine,43733759,Europe,722676,12213
UKR,2020-49,90627,1375,Ukraine,43733759,Europe,813303,13588
UKR,2020-50,87360,1659,Ukraine,43733759,Europe,900663,15247
UKR,2020-51,70327,1418,Ukraine,43733759,Europe,970990,16665
UKR,2020-52,59381,1184,Ukraine,43733759,Europe,1030371,17849
UKR,2020-53,43719,1005,Ukraine,43733759,Europe,1074090,18854
UKR,2021-01,45221,981,Ukraine,43733759,Europe,1119311,19835
UKR,2021-02,44402,1034,Ukraine,43733759,Europe,1163713,20869
UKR,2021-03,30612,1055,Ukraine,43733759,Europe,1194325,21924
UKR,2021-04,29551,1010,Ukraine,43733759,Europe,1223876,22934
UKR,2021-05,23111,710,Ukraine,43733759,Europe,1246987,23644
UKR,2021-06,21059,641,Ukraine,43733759,Europe,1268046,24285
UKR,2021-07,39613,871,Ukraine,43733759,Europe,1307659,25156
UKR,2021-08,44472,894,Ukraine,43733759,Europe,1352131,26050
UKR,2021-09,54666,1078,Ukraine,43733759,Europe,1406797,27128
UKR,2021-10,60748,1305,Ukraine,43733759,Europe,1467545,28433
UKR,2021-11,86708,1665,Ukraine,43733759,Europe,1554253,30098
UKR,2021-12,98153,2034,Ukraine,43733759,Europe,1652406,32132
UKR,2021-13,103479,2455,Ukraine,43733759,Europe,1755885,34587
UKR,2021-14,105217,2714,Ukraine,43733759,Europe,1861102,37301
UKR,2021-15,91911,2699,Ukraine,43733759,Europe,1953013,40000
UKR,2021-16,77317,2518,Ukraine,43733759,Europe,2030330,42518
UKR,2021-17,55605,2232,Ukraine,43733759,Europe,2085935,44750
UKR,2021-18,36389,1762,Ukraine,43733759,Europe,2122324,46512
UKR,2021-19,33673,1672,Ukraine,43733759,Europe,2155997,48184
UKR,2021-20,27855,1252,Ukraine,43733759,Europe,2183852,49436
UKR,2021-21,18639,1100,Ukraine,43733759,Europe,2202491,50536
UKR,2021-22,12558,679,Ukraine,43733759,Europe,2215049,51215
UKR,2021-23,8926,477,Ukraine,43733759,Europe,2223975,51692
UKR,2021-24,5868,340,Ukraine,43733759,Europe,2229843,52032
UKR,2021-25,4435,263,Ukraine,43733759,Europe,2234278,52295
UKR,2021-26,3542,189,Ukraine,43733759,Europe,2237820,52484
UKR,2021-27,3394,120,Ukraine,43733759,Europe,2241214,52604
UKR,2021-28,3460,127,Ukraine,43733759,Europe,2244674,52731
UKR,2021-29,3986,118,Ukraine,43733759,Europe,2248660,52849
UKR,2021-30,4606,102,Ukraine,43733759,Europe,2253266,52951
UKR,2021-31,6182,149,Ukraine,43733759,Europe,2259448,53100
UKR,2021-32,6878,169,Ukraine,43733759,Europe,2266326,53269
URY,2020-12,150,0,Uruguay,3473727,America,150,0
URY,2020-13,137,1,Uruguay,3473727,America,287,1
URY,2020-14,112,5,Uruguay,3473727,America,399,6
URY,2020-15,58,2,Uruguay,3473727,America,457,8
URY,2020-16,63,2,Uruguay,3473727,America,520,10
URY,2020-17,78,5,Uruguay,3473727,America,598,15
URY,2020-18,49,2,Uruguay,3473727,America,647,17
URY,2020-19,52,2,Uruguay,3473727,America,699,19
URY,2020-20,27,1,Uruguay,3473727,America,726,20
URY,2020-21,35,2,Uruguay,3473727,America,761,22
URY,2020-22,54,0,Uruguay,3473727,America,815,22
URY,2020-23,22,1,Uruguay,3473727,America,837,23
URY,2020-24,3,0,Uruguay,3473727,America,840,23
URY,2020-25,28,2,Uruguay,3473727,America,868,25
URY,2020-26,53,2,Uruguay,3473727,America,921,27
URY,2020-27,27,1,Uruguay,3473727,America,948,28
URY,2020-28,31,3,Uruguay,3473727,America,979,31
URY,2020-29,67,2,Uruguay,3473727,America,1046,33
URY,2020-30,138,1,Uruguay,3473727,America,1184,34
URY,2020-31,94,2,Uruguay,3473727,America,1278,36
URY,2020-32,67,1,Uruguay,3473727,America,1345,37
URY,2020-33,87,1,Uruguay,3473727,America,1432,38
URY,2020-34,87,4,Uruguay,3473727,America,1519,42
URY,2020-35,58,2,Uruguay,3473727,America,1577,44
URY,2020-36,94,1,Uruguay,3473727,America,1671,45
URY,2020-37,129,0,Uruguay,3473727,America,1800,45
URY,2020-38,109,1,Uruguay,3473727,America,1909,46
URY,2020-39,91,1,Uruguay,3473727,America,2000,47
URY,2020-40,137,1,Uruguay,3473727,America,2137,48
URY,2020-41,149,2,Uruguay,3473727,America,2286,50
URY,2020-42,237,1,Uruguay,3473727,America,2523,51
URY,2020-43,320,2,Uruguay,3473727,America,2843,53
URY,2020-44,298,6,Uruguay,3473727,America,3141,59
URY,2020-45,365,3,Uruguay,3473727,America,3506,62
URY,2020-46,516,3,Uruguay,3473727,America,4022,65
URY,2020-47,669,6,Uruguay,3473727,America,4691,71
URY,2020-48,1017,5,Uruguay,3473727,America,5708,76
URY,2020-49,1587,6,Uruguay,3473727,America,7295,82
URY,2020-50,2405,10,Uruguay,3473727,America,9700,92
URY,2020-51,3769,27,Uruguay,3473727,America,13469,119
URY,2020-52,3829,41,Uruguay,3473727,America,17298,160
URY,2020-53,3517,44,Uruguay,3473727,America,20815,204
URY,2021-01,6078,58,Uruguay,3473727,America,26893,262
URY,2021-02,5962,57,Uruguay,3473727,America,32855,319
URY,2021-03,5178,71,Uruguay,3473727,America,38033,390
URY,2021-04,4087,54,Uruguay,3473727,America,42120,444
URY,2021-05,3522,53,Uruguay,3473727,America,45642,497
URY,2021-06,3710,44,Uruguay,3473727,America,49352,541
URY,2021-07,3950,42,Uruguay,3473727,America,53302,583
URY,2021-08,5279,28,Uruguay,3473727,America,58581,611
URY,2021-09,6111,47,Uruguay,3473727,America,64692,658
URY,2021-10,8162,59,Uruguay,3473727,America,72854,717
URY,2021-11,11350,94,Uruguay,3473727,America,84204,811
URY,2021-12,15372,117,Uruguay,3473727,America,99576,928
URY,2021-13,20374,218,Uruguay,3473727,America,119950,1146
URY,2021-14,27215,387,Uruguay,3473727,America,147165,1533
URY,2021-15,19860,438,Uruguay,3473727,America,167025,1971
URY,2021-16,20316,420,Uruguay,3473727,America,187341,2391
URY,2021-17,16771,405,Uruguay,3473727,America,204112,2796
URY,2021-18,16563,326,Uruguay,3473727,America,220675,3122
URY,2021-19,19829,337,Uruguay,3473727,America,240504,3459
URY,2021-20,27376,463,Uruguay,3473727,America,267880,3922
URY,2021-21,23600,291,Uruguay,3473727,America,291480,4213
URY,2021-22,25047,427,Uruguay,3473727,America,316527,4640
URY,2021-23,21978,355,Uruguay,3473727,America,338505,4995
URY,2021-24,16352,276,Uruguay,3473727,America,354857,5271
URY,2021-25,12050,253,Uruguay,3473727,America,366907,5524
URY,2021-26,6371,187,Uruguay,3473727,America,373278,5711
URY,2021-27,3590,122,Uruguay,3473727,America,376868,5833
URY,2021-28,2196,56,Uruguay,3473727,America,379064,5889
URY,2021-29,1359,42,Uruguay,3473727,America,380423,5931
URY,2021-30,1284,41,Uruguay,3473727,America,381707,5972
URY,2021-31,791,14,Uruguay,3473727,America,382498,5986
URY,2021-32,881,18,Uruguay,3473727,America,383379,6004
USA,2020-02,0,0,United States Of America,331002647,America,0,0
USA,2020-03,0,0,United States Of America,331002647,America,0,0
USA,2020-04,5,0,United States Of America,331002647,America,5,0
USA,2020-05,6,0,United States Of America,331002647,America,11,0
USA,2020-06,1,0,United States Of America,331002647,America,12,0
USA,2020-07,3,0,United States Of America,331002647,America,15,0
USA,2020-08,20,0,United States Of America,331002647,America,35,0
USA,2020-09,54,2,United States Of America,331002647,America,89,2
USA,2020-10,465,19,United States Of America,331002647,America,554,21
USA,2020-11,3220,48,United States Of America,331002647,America,3774,69
USA,2020-12,31432,402,United States Of America,331002647,America,35206,471
USA,2020-13,107819,2038,United States Of America,331002647,America,143025,2509
USA,2020-14,194610,7138,United States Of America,331002647,America,337635,9647
USA,2020-15,219936,12461,United States Of America,331002647,America,557571,22108
USA,2020-16,202116,18574,United States Of America,331002647,America,759687,40682
USA,2020-17,206223,14194,United States Of America,331002647,America,965910,54876
USA,2020-18,192131,12806,United States Of America,331002647,America,1158041,67682
USA,2020-19,171758,11846,United States Of America,331002647,America,1329799,79528
USA,2020-20,156958,10034,United States Of America,331002647,America,1486757,89562
USA,2020-21,156481,8158,United States Of America,331002647,America,1643238,97720
USA,2020-22,146953,6663,United States Of America,331002647,America,1790191,104383
USA,2020-23,152172,6131,United States Of America,331002647,America,1942363,110514
USA,2020-24,151706,5218,United States Of America,331002647,America,2094069,115732
USA,2020-25,186843,4243,United States Of America,331002647,America,2280912,119975
USA,2020-26,268084,5829,United States Of America,331002647,America,2548996,125804
USA,2020-27,339639,4143,United States Of America,331002647,America,2888635,129947
USA,2020-28,416307,5258,United States Of America,331002647,America,3304942,135205
USA,2020-29,468318,5329,United States Of America,331002647,America,3773260,140534
USA,2020-30,460760,6401,United States Of America,331002647,America,4234020,146935
USA,2020-31,433935,7925,United States Of America,331002647,America,4667955,154860
USA,2020-32,376909,8078,United States Of America,331002647,America,5044864,162938
USA,2020-33,358405,7114,United States Of America,331002647,America,5403269,170052
USA,2020-34,299342,6754,United States Of America,331002647,America,5702611,176806
USA,2020-35,294552,6263,United States Of America,331002647,America,5997163,183069
USA,2020-36,279258,5872,United States Of America,331002647,America,6276421,188941
USA,2020-37,243558,5138,United States Of America,331002647,America,6519979,194079
USA,2020-38,284835,5430,United States Of America,331002647,America,6804814,199509
USA,2020-39,310232,5247,United States Of America,331002647,America,7115046,204756
USA,2020-40,302799,5038,United States Of America,331002647,America,7417845,209794
USA,2020-41,344699,4977,United States Of America,331002647,America,7762544,214771
USA,2020-42,392051,4903,United States Of America,331002647,America,8154595,219674
USA,2020-43,481570,5556,United States Of America,331002647,America,8636165,225230
USA,2020-44,571197,5766,United States Of America,331002647,America,9207362,230996
USA,2020-45,764289,6576,United States Of America,331002647,America,9971651,237572
USA,2020-46,1065410,8642,United States Of America,331002647,America,11037061,246214
USA,2020-47,1209848,10568,United States Of America,331002647,America,12246909,256782
USA,2020-48,1136412,10091,United States Of America,331002647,America,13383321,266873
USA,2020-49,1373677,15437,United States Of America,331002647,America,14756998,282310
USA,2020-50,1499756,16867,United States Of America,331002647,America,16256754,299177
USA,2020-51,1588085,18493,United States Of America,331002647,America,17844839,317670
USA,2020-52,1306812,15656,United States Of America,331002647,America,19151651,333326
USA,2020-53,1488563,18264,United States Of America,331002647,America,20640214,351590
USA,2021-01,1782792,22852,United States Of America,331002647,America,22423006,374442
USA,2021-02,1515282,23169,United States Of America,331002647,America,23938288,397611
USA,2021-03,1358783,23518,United States Of America,331002647,America,25297071,421129
USA,2021-04,1024054,22226,United States Of America,331002647,America,26321125,443355
USA,2021-05,687440,20127,United States Of America,331002647,America,27008565,463482
USA,2021-06,685603,22843,United States Of America,331002647,America,27694168,486325
USA,2021-07,495991,11364,United States Of America,331002647,America,28190159,497689
USA,2021-08,415502,15402,United States Of America,331002647,America,28605661,513091
USA,2021-09,383101,11888,United States Of America,331002647,America,28988762,524979
USA,2021-10,506660,10682,United States Of America,331002647,America,29495422,535661
USA,2021-11,323686,6698,United States Of America,331002647,America,29819108,542359
USA,2021-12,512686,7677,United States Of America,331002647,America,30331794,550036
USA,2021-13,374335,4965,United States Of America,331002647,America,30706129,555001
USA,2021-14,562003,7532,United States Of America,331002647,America,31268132,562533
USA,2021-15,402714,4683,United States Of America,331002647,America,31670846,567216
USA,2021-16,454253,5458,United States Of America,331002647,America,32125099,572674
USA,2021-17,296606,4371,United States Of America,331002647,America,32421705,577045
USA,2021-18,286092,4709,United States Of America,331002647,America,32707797,581754
USA,2021-19,236081,4247,United States Of America,331002647,America,32943878,586001
USA,2021-20,173887,3892,United States Of America,331002647,America,33117765,589893
USA,2021-21,141806,4538,United States Of America,331002647,America,33259571,594431
USA,2021-22,103062,3197,United States Of America,331002647,America,33362633,597628
USA,2021-23,99397,2141,United States Of America,331002647,America,33462030,599769
USA,2021-24,80348,2056,United States Of America,331002647,America,33542378,601825
USA,2021-25,83014,2142,United States Of America,331002647,America,33625392,603967
USA,2021-26,92182,1559,United States Of America,331002647,America,33717574,605526
USA,2021-27,138400,1637,United States Of America,331002647,America,33855974,607163
USA,2021-28,256273,1990,United States Of America,331002647,America,34112247,609153
USA,2021-29,332523,1739,United States Of America,331002647,America,34444770,610892
USA,2021-30,559822,2336,United States Of America,331002647,America,35004592,613228
USA,2021-31,760508,3601,United States Of America,331002647,America,35765100,616829
USA,2021-32,916459,4807,United States Of America,331002647,America,36681559,621636
UZB,2020-12,40,0,Uzbekistan,33469199,Asia,40,0
UZB,2020-13,99,1,Uzbekistan,33469199,Asia,139,1
UZB,2020-14,197,1,Uzbekistan,33469199,Asia,336,2
UZB,2020-15,523,2,Uzbekistan,33469199,Asia,859,4
UZB,2020-16,700,1,Uzbekistan,33469199,Asia,1559,5
UZB,2020-17,322,3,Uzbekistan,33469199,Asia,1881,8
UZB,2020-18,262,2,Uzbekistan,33469199,Asia,2143,10
UZB,2020-19,269,0,Uzbekistan,33469199,Asia,2412,10
UZB,2020-20,335,2,Uzbekistan,33469199,Asia,2747,12
UZB,2020-21,411,1,Uzbekistan,33469199,Asia,3158,13
UZB,2020-22,498,2,Uzbekistan,33469199,Asia,3656,15
UZB,2020-23,690,2,Uzbekistan,33469199,Asia,4346,17
UZB,2020-24,751,2,Uzbekistan,33469199,Asia,5097,19
UZB,2020-25,1255,0,Uzbekistan,33469199,Asia,6352,19
UZB,2020-26,1673,3,Uzbekistan,33469199,Asia,8025,22
UZB,2020-27,2112,13,Uzbekistan,33469199,Asia,10137,35
UZB,2020-28,3050,26,Uzbekistan,33469199,Asia,13187,61
UZB,2020-29,3773,27,Uzbekistan,33469199,Asia,16960,88
UZB,2020-30,3854,29,Uzbekistan,33469199,Asia,20814,117
UZB,2020-31,5008,38,Uzbekistan,33469199,Asia,25822,155
UZB,2020-32,4992,41,Uzbekistan,33469199,Asia,30814,196
UZB,2020-33,4124,32,Uzbekistan,33469199,Asia,34938,228
UZB,2020-34,4002,45,Uzbekistan,33469199,Asia,38940,273
UZB,2020-35,2705,44,Uzbekistan,33469199,Asia,41645,317
UZB,2020-36,2124,33,Uzbekistan,33469199,Asia,43769,350
UZB,2020-37,3845,44,Uzbekistan,33469199,Asia,47614,394
UZB,2020-38,4169,41,Uzbekistan,33469199,Asia,51783,435
UZB,2020-39,3804,25,Uzbekistan,33469199,Asia,55587,460
UZB,2020-40,3266,23,Uzbekistan,33469199,Asia,58853,483
UZB,2020-41,2239,22,Uzbekistan,33469199,Asia,61092,505
UZB,2020-42,2332,24,Uzbekistan,33469199,Asia,63424,529
UZB,2020-43,2050,21,Uzbekistan,33469199,Asia,65474,550
UZB,2020-44,1676,20,Uzbekistan,33469199,Asia,67150,570
UZB,2020-45,1632,15,Uzbekistan,33469199,Asia,68782,585
UZB,2020-46,1455,13,Uzbekistan,33469199,Asia,70237,598
UZB,2020-47,1374,5,Uzbekistan,33469199,Asia,71611,603
UZB,2020-48,1253,5,Uzbekistan,33469199,Asia,72864,608
UZB,2020-49,1183,3,Uzbekistan,33469199,Asia,74047,611
UZB,2020-50,1041,1,Uzbekistan,33469199,Asia,75088,612
UZB,2020-51,954,0,Uzbekistan,33469199,Asia,76042,612
UZB,2020-52,784,1,Uzbekistan,33469199,Asia,76826,613
UZB,2020-53,426,1,Uzbekistan,33469199,Asia,77252,614
UZB,2021-01,353,3,Uzbekistan,33469199,Asia,77605,617
UZB,2021-02,425,2,Uzbekistan,33469199,Asia,78030,619
UZB,2021-03,393,2,Uzbekistan,33469199,Asia,78423,621
UZB,2021-04,326,0,Uzbekistan,33469199,Asia,78749,621
UZB,2021-05,407,0,Uzbekistan,33469199,Asia,79156,621
UZB,2021-06,280,1,Uzbekistan,33469199,Asia,79436,622
UZB,2021-07,239,0,Uzbekistan,33469199,Asia,79675,622
UZB,2021-08,68,0,Uzbekistan,33469199,Asia,79743,622
UZB,2021-09,286,0,Uzbekistan,33469199,Asia,80029,622
UZB,2021-10,212,0,Uzbekistan,33469199,Asia,80241,622
UZB,2021-11,1092,0,Uzbekistan,33469199,Asia,81333,622
UZB,2021-12,1001,4,Uzbekistan,33469199,Asia,82334,626
UZB,2021-13,1462,5,Uzbekistan,33469199,Asia,83796,631
UZB,2021-14,1312,3,Uzbekistan,33469199,Asia,85108,634
UZB,2021-15,1868,4,Uzbekistan,33469199,Asia,86976,638
UZB,2021-16,2373,7,Uzbekistan,33469199,Asia,89349,645
UZB,2021-17,1453,4,Uzbekistan,33469199,Asia,90802,649
UZB,2021-18,3951,13,Uzbekistan,33469199,Asia,94753,662
UZB,2021-19,2134,8,Uzbekistan,33469199,Asia,96887,670
UZB,2021-20,1764,10,Uzbekistan,33469199,Asia,98651,680
UZB,2021-21,1678,10,Uzbekistan,33469199,Asia,100329,690
UZB,2021-22,1629,6,Uzbekistan,33469199,Asia,101958,696
UZB,2021-23,1849,12,Uzbekistan,33469199,Asia,103807,708
UZB,2021-24,2639,10,Uzbekistan,33469199,Asia,106446,718
UZB,2021-25,3240,13,Uzbekistan,33469199,Asia,109686,731
UZB,2021-26,3380,20,Uzbekistan,33469199,Asia,113066,751
UZB,2021-27,3349,23,Uzbekistan,33469199,Asia,116415,774
UZB,2021-28,3552,27,Uzbekistan,33469199,Asia,119967,801
UZB,2021-29,5022,38,Uzbekistan,33469199,Asia,124989,839
UZB,2021-30,6084,47,Uzbekistan,33469199,Asia,131073,886
UZB,2021-31,6412,48,Uzbekistan,33469199,Asia,137485,934
UZB,2021-32,6427,47,Uzbekistan,33469199,Asia,143912,981
VAT,2020-12,0,0,Holy See,809,Europe,0,0
VAT,2020-13,5,0,Holy See,809,Europe,5,0
VAT,2020-14,1,0,Holy See,809,Europe,6,0
VAT,2020-15,1,0,Holy See,809,Europe,7,0
VAT,2020-16,0,0,Holy See,809,Europe,7,0
VAT,2020-17,1,0,Holy See,809,Europe,8,0
VAT,2020-18,2,0,Holy See,809,Europe,10,0
VAT,2020-19,1,0,Holy See,809,Europe,11,0
VAT,2020-20,0,0,Holy See,809,Europe,11,0
VAT,2020-21,0,0,Holy See,809,Europe,11,0
VAT,2020-22,0,0,Holy See,809,Europe,11,0
VAT,2020-23,0,0,Holy See,809,Europe,11,0
VAT,2020-24,0,0,Holy See,809,Europe,11,0
VAT,2020-25,0,0,Holy See,809,Europe,11,0
VAT,2020-26,0,0,Holy See,809,Europe,11,0
VAT,2020-27,0,0,Holy See,809,Europe,11,0
VAT,2020-28,0,0,Holy See,809,Europe,11,0
VAT,2020-29,0,0,Holy See,809,Europe,11,0
VAT,2020-30,0,0,Holy See,809,Europe,11,0
VAT,2020-31,0,0,Holy See,809,Europe,11,0
VAT,2020-32,0,0,Holy See,809,Europe,11,0
VAT,2020-33,0,0,Holy See,809,Europe,11,0
VAT,2020-34,0,0,Holy See,809,Europe,11,0
VAT,2020-35,0,0,Holy See,809,Europe,11,0
VAT,2020-36,0,0,Holy See,809,Europe,11,0
VAT,2020-37,0,0,Holy See,809,Europe,11,0
VAT,2020-38,0,0,Holy See,809,Europe,11,0
VAT,2020-39,0,0,Holy See,809,Europe,11,0
VAT,2020-40,0,0,Holy See,809,Europe,11,0
VAT,2020-41,0,0,Holy See,809,Europe,11,0
VAT,2020-42,15,0,Holy See,809,Europe,26,0
VAT,2020-43,0,0,Holy See,809,Europe,26,0
VAT,2020-44,0,0,Holy See,809,Europe,26,0
VAT,2020-45,0,0,Holy See,809,Europe,26,0
VAT,2020-46,0,0,Holy See,809,Europe,26,0
VAT,2020-47,0,0,Holy See,809,Europe,26,0
VAT,2020-48,0,0,Holy See,809,Europe,26,0
VAT,2020-49,0,0,Holy See,809,Europe,26,0
VAT,2020-50,0,0,Holy See,809,Europe,26,0
VAT,2020-51,0,0,Holy See,809,Europe,26,0
VAT,2020-52,0,0,Holy See,809,Europe,26,0
VAT,2020-53,0,0,Holy See,809,Europe,26,0
VAT,2021-01,0,0,Holy See,809,Europe,26,0
VAT,2021-02,0,0,Holy See,809,Europe,26,0
VAT,2021-03,0,0,Holy See,809,Europe,26,0
VAT,2021-04,0,0,Holy See,809,Europe,26,0
VAT,2021-05,0,0,Holy See,809,Europe,26,0
VAT,2021-06,0,0,Holy See,809,Europe,26,0
VAT,2021-07,0,0,Holy See,809,Europe,26,0
VAT,2021-08,0,0,Holy See,809,Europe,26,0
VAT,2021-09,0,0,Holy See,809,Europe,26,0
VAT,2021-10,0,0,Holy See,809,Europe,26,0
VAT,2021-11,0,0,Holy See,809,Europe,26,0
VAT,2021-12,0,0,Holy See,809,Europe,26,0
VAT,2021-13,0,0,Holy See,809,Europe,26,0
VAT,2021-14,0,0,Holy See,809,Europe,26,0
VAT,2021-15,0,0,Holy See,809,Europe,26,0
VAT,2021-16,0,0,Holy See,809,Europe,26,0
VAT,2021-17,0,0,Holy See,809,Europe,26,0
VAT,2021-18,0,0,Holy See,809,Europe,26,0
VAT,2021-19,0,0,Holy See,809,Europe,26,0
VAT,2021-20,0,0,Holy See,809,Europe,26,0
VAT,2021-21,0,0,Holy See,809,Europe,26,0
VAT,2021-22,0,0,Holy See,809,Europe,26,0
VAT,2021-23,0,0,Holy See,809,Europe,26,0
VAT,2021-24,0,0,Holy See,809,Europe,26,0
VAT,2021-25,0,0,Holy See,809,Europe,26,0
VAT,2021-26,0,0,Holy See,809,Europe,26,0
VAT,2021-27,0,0,Holy See,809,Europe,26,0
VAT,2021-28,0,0,Holy See,809,Europe,26,0
VAT,2021-29,0,0,Holy See,809,Europe,26,0
VAT,2021-30,0,0,Holy See,809,Europe,26,0
VAT,2021-31,0,0,Holy See,809,Europe,26,0
VAT,2021-32,0,0,Holy See,809,Europe,26,0
VCT,2020-14,6,0,Saint Vincent And The Grenadines,110947,America,6,0
VCT,2020-15,5,0,Saint Vincent And The Grenadines,110947,America,11,0
VCT,2020-16,0,0,Saint Vincent And The Grenadines,110947,America,11,0
VCT,2020-17,2,0,Saint Vincent And The Grenadines,110947,America,13,0
VCT,2020-18,3,0,Saint Vincent And The Grenadines,110947,America,16,0
VCT,2020-19,0,0,Saint Vincent And The Grenadines,110947,America,16,0
VCT,2020-20,0,0,Saint Vincent And The Grenadines,110947,America,16,0
VCT,2020-21,1,0,Saint Vincent And The Grenadines,110947,America,17,0
VCT,2020-22,8,0,Saint Vincent And The Grenadines,110947,America,25,0
VCT,2020-23,0,0,Saint Vincent And The Grenadines,110947,America,25,0
VCT,2020-24,1,0,Saint Vincent And The Grenadines,110947,America,26,0
VCT,2020-25,2,0,Saint Vincent And The Grenadines,110947,America,28,0
VCT,2020-26,0,0,Saint Vincent And The Grenadines,110947,America,28,0
VCT,2020-27,0,0,Saint Vincent And The Grenadines,110947,America,28,0
VCT,2020-28,6,0,Saint Vincent And The Grenadines,110947,America,34,0
VCT,2020-29,15,0,Saint Vincent And The Grenadines,110947,America,49,0
VCT,2020-30,2,0,Saint Vincent And The Grenadines,110947,America,51,0
VCT,2020-31,3,0,Saint Vincent And The Grenadines,110947,America,54,0
VCT,2020-32,2,0,Saint Vincent And The Grenadines,110947,America,56,0
VCT,2020-33,0,0,Saint Vincent And The Grenadines,110947,America,56,0
VCT,2020-34,1,0,Saint Vincent And The Grenadines,110947,America,57,0
VCT,2020-35,2,0,Saint Vincent And The Grenadines,110947,America,59,0
VCT,2020-36,1,0,Saint Vincent And The Grenadines,110947,America,60,0
VCT,2020-37,3,0,Saint Vincent And The Grenadines,110947,America,63,0
VCT,2020-38,0,0,Saint Vincent And The Grenadines,110947,America,63,0
VCT,2020-39,0,0,Saint Vincent And The Grenadines,110947,America,63,0
VCT,2020-40,0,0,Saint Vincent And The Grenadines,110947,America,63,0
VCT,2020-41,0,0,Saint Vincent And The Grenadines,110947,America,63,0
VCT,2020-42,3,0,Saint Vincent And The Grenadines,110947,America,66,0
VCT,2020-43,6,0,Saint Vincent And The Grenadines,110947,America,72,0
VCT,2020-44,2,0,Saint Vincent And The Grenadines,110947,America,74,0
VCT,2020-45,1,0,Saint Vincent And The Grenadines,110947,America,75,0
VCT,2020-46,2,0,Saint Vincent And The Grenadines,110947,America,77,0
VCT,2020-47,6,0,Saint Vincent And The Grenadines,110947,America,83,0
VCT,2020-48,1,0,Saint Vincent And The Grenadines,110947,America,84,0
VCT,2020-49,2,0,Saint Vincent And The Grenadines,110947,America,86,0
VCT,2020-50,11,0,Saint Vincent And The Grenadines,110947,America,97,0
VCT,2020-51,6,0,Saint Vincent And The Grenadines,110947,America,103,0
VCT,2020-52,5,0,Saint Vincent And The Grenadines,110947,America,108,0
VCT,2020-53,15,0,Saint Vincent And The Grenadines,110947,America,123,0
VCT,2021-01,125,0,Saint Vincent And The Grenadines,110947,America,248,0
VCT,2021-02,245,1,Saint Vincent And The Grenadines,110947,America,493,1
VCT,2021-03,252,1,Saint Vincent And The Grenadines,110947,America,745,2
VCT,2021-04,205,0,Saint Vincent And The Grenadines,110947,America,950,2
VCT,2021-05,332,2,Saint Vincent And The Grenadines,110947,America,1282,4
VCT,2021-06,170,2,Saint Vincent And The Grenadines,110947,America,1452,6
VCT,2021-07,50,0,Saint Vincent And The Grenadines,110947,America,1502,6
VCT,2021-08,125,2,Saint Vincent And The Grenadines,110947,America,1627,8
VCT,2021-09,35,0,Saint Vincent And The Grenadines,110947,America,1662,8
VCT,2021-10,18,1,Saint Vincent And The Grenadines,110947,America,1680,9
VCT,2021-11,19,1,Saint Vincent And The Grenadines,110947,America,1699,10
VCT,2021-12,39,0,Saint Vincent And The Grenadines,110947,America,1738,10
VCT,2021-13,25,0,Saint Vincent And The Grenadines,110947,America,1763,10
VCT,2021-14,42,0,Saint Vincent And The Grenadines,110947,America,1805,10
VCT,2021-15,13,0,Saint Vincent And The Grenadines,110947,America,1818,10
VCT,2021-16,25,1,Saint Vincent And The Grenadines,110947,America,1843,11
VCT,2021-17,38,0,Saint Vincent And The Grenadines,110947,America,1881,11
VCT,2021-18,40,1,Saint Vincent And The Grenadines,110947,America,1921,12
VCT,2021-19,25,0,Saint Vincent And The Grenadines,110947,America,1946,12
VCT,2021-20,42,0,Saint Vincent And The Grenadines,110947,America,1988,12
VCT,2021-21,46,0,Saint Vincent And The Grenadines,110947,America,2034,12
VCT,2021-22,50,0,Saint Vincent And The Grenadines,110947,America,2084,12
VCT,2021-23,71,0,Saint Vincent And The Grenadines,110947,America,2155,12
VCT,2021-24,39,0,Saint Vincent And The Grenadines,110947,America,2194,12
VCT,2021-25,24,0,Saint Vincent And The Grenadines,110947,America,2218,12
VCT,2021-26,19,0,Saint Vincent And The Grenadines,110947,America,2237,12
VCT,2021-27,7,0,Saint Vincent And The Grenadines,110947,America,2244,12
VCT,2021-28,18,0,Saint Vincent And The Grenadines,110947,America,2262,12
VCT,2021-29,16,0,Saint Vincent And The Grenadines,110947,America,2278,12
VCT,2021-30,18,0,Saint Vincent And The Grenadines,110947,America,2296,12
VCT,2021-31,2,0,Saint Vincent And The Grenadines,110947,America,2298,12
VCT,2021-32,18,0,Saint Vincent And The Grenadines,110947,America,2316,12
VEN,2020-12,21,0,Venezuela,28435943,America,21,0
VEN,2020-13,83,1,Venezuela,28435943,America,104,1
VEN,2020-14,29,4,Venezuela,28435943,America,133,5
VEN,2020-15,33,4,Venezuela,28435943,America,166,9
VEN,2020-16,75,0,Venezuela,28435943,America,241,9
VEN,2020-17,69,1,Venezuela,28435943,America,310,10
VEN,2020-18,32,0,Venezuela,28435943,America,342,10
VEN,2020-19,57,0,Venezuela,28435943,America,399,10
VEN,2020-20,127,0,Venezuela,28435943,America,526,10
VEN,2020-21,580,0,Venezuela,28435943,America,1106,10
VEN,2020-22,389,4,Venezuela,28435943,America,1495,14
VEN,2020-23,867,8,Venezuela,28435943,America,2362,22
VEN,2020-24,601,3,Venezuela,28435943,America,2963,25
VEN,2020-25,940,8,Venezuela,28435943,America,3903,33
VEN,2020-26,1379,11,Venezuela,28435943,America,5282,44
VEN,2020-27,1872,20,Venezuela,28435943,America,7154,64
VEN,2020-28,2296,25,Venezuela,28435943,America,9450,89
VEN,2020-29,2426,23,Venezuela,28435943,America,11876,112
VEN,2020-30,3572,30,Venezuela,28435943,America,15448,142
VEN,2020-31,4743,32,Venezuela,28435943,America,20191,174
VEN,2020-32,5599,49,Venezuela,28435943,America,25790,223
VEN,2020-33,7950,58,Venezuela,28435943,America,33740,281
VEN,2020-34,5809,48,Venezuela,28435943,America,39549,329
VEN,2020-35,6304,52,Venezuela,28435943,America,45853,381
VEN,2020-36,7421,47,Venezuela,28435943,America,53274,428
VEN,2020-37,7251,57,Venezuela,28435943,America,60525,485
VEN,2020-38,6116,62,Venezuela,28435943,America,66641,547
VEN,2020-39,6035,59,Venezuela,28435943,America,72676,606
VEN,2020-40,5743,47,Venezuela,28435943,America,78419,653
VEN,2020-41,4703,44,Venezuela,28435943,America,83122,697
VEN,2020-42,3499,39,Venezuela,28435943,America,86621,736
VEN,2020-43,2929,37,Venezuela,28435943,America,89550,773
VEN,2020-44,2760,28,Venezuela,28435943,America,92310,801
VEN,2020-45,2558,25,Venezuela,28435943,America,94868,826
VEN,2020-46,2469,25,Venezuela,28435943,America,97337,851
VEN,2020-47,2483,20,Venezuela,28435943,America,99820,871
VEN,2020-48,2205,23,Venezuela,28435943,America,102025,894
VEN,2020-49,2402,25,Venezuela,28435943,America,104427,919
VEN,2020-50,2735,30,Venezuela,28435943,America,107162,949
VEN,2020-51,2898,39,Venezuela,28435943,America,110060,988
VEN,2020-52,2241,26,Venezuela,28435943,America,112301,1014
VEN,2020-53,2091,24,Venezuela,28435943,America,114392,1038
VEN,2021-01,2576,35,Venezuela,28435943,America,116968,1073
VEN,2021-02,3461,39,Venezuela,28435943,America,120429,1112
VEN,2021-03,3265,36,Venezuela,28435943,America,123694,1148
VEN,2021-04,3218,41,Venezuela,28435943,America,126912,1189
VEN,2021-05,3189,44,Venezuela,28435943,America,130101,1233
VEN,2021-06,3102,46,Venezuela,28435943,America,133203,1279
VEN,2021-07,2850,37,Venezuela,28435943,America,136053,1316
VEN,2021-08,3048,28,Venezuela,28435943,America,139101,1344
VEN,2021-09,3222,40,Venezuela,28435943,America,142323,1384
VEN,2021-10,3615,53,Venezuela,28435943,America,145938,1437
VEN,2021-11,5170,56,Venezuela,28435943,America,151108,1493
VEN,2021-12,5532,72,Venezuela,28435943,America,156640,1565
VEN,2021-13,9468,97,Venezuela,28435943,America,166108,1662
VEN,2021-14,8764,116,Venezuela,28435943,America,174872,1778
VEN,2021-15,8303,127,Venezuela,28435943,America,183175,1905
VEN,2021-16,8328,142,Venezuela,28435943,America,191503,2047
VEN,2021-17,8549,125,Venezuela,28435943,America,200052,2172
VEN,2021-18,9095,132,Venezuela,28435943,America,209147,2304
VEN,2021-19,6139,92,Venezuela,28435943,America,215286,2396
VEN,2021-20,6751,103,Venezuela,28435943,America,222037,2499
VEN,2021-21,10748,130,Venezuela,28435943,America,232785,2629
VEN,2021-22,7914,79,Venezuela,28435943,America,240699,2708
VEN,2021-23,10972,121,Venezuela,28435943,America,251671,2829
VEN,2021-24,9054,144,Venezuela,28435943,America,260725,2973
VEN,2021-25,8895,95,Venezuela,28435943,America,269620,3068
VEN,2021-26,8000,122,Venezuela,28435943,America,277620,3190
VEN,2021-27,8275,112,Venezuela,28435943,America,285895,3302
VEN,2021-28,6869,75,Venezuela,28435943,America,292764,3377
VEN,2021-29,7043,115,Venezuela,28435943,America,299807,3492
VEN,2021-30,6851,115,Venezuela,28435943,America,306658,3607
VEN,2021-31,6258,98,Venezuela,28435943,America,312916,3705
VEN,2021-32,6163,94,Venezuela,28435943,America,319079,3799
VGB,2020-14,1,0,British Virgin Islands,30237,America,1,0
VGB,2020-15,0,0,British Virgin Islands,30237,America,1,0
VGB,2020-16,1,1,British Virgin Islands,30237,America,2,1
VGB,2020-17,2,0,British Virgin Islands,30237,America,4,1
VGB,2020-18,0,0,British Virgin Islands,30237,America,4,1
VGB,2020-19,1,0,British Virgin Islands,30237,America,5,1
VGB,2020-20,1,0,British Virgin Islands,30237,America,6,1
VGB,2020-21,0,0,British Virgin Islands,30237,America,6,1
VGB,2020-22,0,0,British Virgin Islands,30237,America,6,1
VGB,2020-23,0,0,British Virgin Islands,30237,America,6,1
VGB,2020-24,0,0,British Virgin Islands,30237,America,6,1
VGB,2020-25,0,0,British Virgin Islands,30237,America,6,1
VGB,2020-26,0,0,British Virgin Islands,30237,America,6,1
VGB,2020-27,0,0,British Virgin Islands,30237,America,6,1
VGB,2020-28,0,0,British Virgin Islands,30237,America,6,1
VGB,2020-29,0,0,British Virgin Islands,30237,America,6,1
VGB,2020-30,0,0,British Virgin Islands,30237,America,6,1
VGB,2020-31,1,0,British Virgin Islands,30237,America,7,1
VGB,2020-32,0,0,British Virgin Islands,30237,America,7,1
VGB,2020-33,0,0,British Virgin Islands,30237,America,7,1
VGB,2020-34,12,0,British Virgin Islands,30237,America,19,1
VGB,2020-35,16,0,British Virgin Islands,30237,America,35,1
VGB,2020-36,26,0,British Virgin Islands,30237,America,61,1
VGB,2020-37,3,0,British Virgin Islands,30237,America,64,1
VGB,2020-38,5,0,British Virgin Islands,30237,America,69,1
VGB,2020-39,0,0,British Virgin Islands,30237,America,69,1
VGB,2020-40,0,0,British Virgin Islands,30237,America,69,1
VGB,2020-41,0,0,British Virgin Islands,30237,America,69,1
VGB,2020-42,0,0,British Virgin Islands,30237,America,69,1
VGB,2020-43,1,0,British Virgin Islands,30237,America,70,1
VGB,2020-44,0,0,British Virgin Islands,30237,America,70,1
VGB,2020-45,0,0,British Virgin Islands,30237,America,70,1
VGB,2020-46,0,0,British Virgin Islands,30237,America,70,1
VGB,2020-47,0,0,British Virgin Islands,30237,America,70,1
VGB,2020-48,1,0,British Virgin Islands,30237,America,71,1
VGB,2020-49,0,0,British Virgin Islands,30237,America,71,1
VGB,2020-50,7,0,British Virgin Islands,30237,America,78,1
VGB,2020-51,6,0,British Virgin Islands,30237,America,84,1
VGB,2020-52,7,0,British Virgin Islands,30237,America,91,1
VGB,2020-53,4,0,British Virgin Islands,30237,America,95,1
VGB,2021-01,0,0,British Virgin Islands,30237,America,95,1
VGB,2021-02,24,0,British Virgin Islands,30237,America,119,1
VGB,2021-03,16,0,British Virgin Islands,30237,America,135,1
VGB,2021-04,4,0,British Virgin Islands,30237,America,139,1
VGB,2021-05,0,0,British Virgin Islands,30237,America,139,1
VGB,2021-06,12,0,British Virgin Islands,30237,America,151,1
VGB,2021-07,0,0,British Virgin Islands,30237,America,151,1
VGB,2021-08,0,0,British Virgin Islands,30237,America,151,1
VGB,2021-09,0,0,British Virgin Islands,30237,America,151,1
VGB,2021-10,1,0,British Virgin Islands,30237,America,152,1
VGB,2021-11,0,0,British Virgin Islands,30237,America,152,1
VGB,2021-12,0,0,British Virgin Islands,30237,America,152,1
VGB,2021-13,0,0,British Virgin Islands,30237,America,152,1
VGB,2021-14,24,0,British Virgin Islands,30237,America,176,1
VGB,2021-15,9,0,British Virgin Islands,30237,America,185,1
VGB,2021-16,7,0,British Virgin Islands,30237,America,192,1
VGB,2021-17,22,0,British Virgin Islands,30237,America,214,1
VGB,2021-18,3,0,British Virgin Islands,30237,America,217,1
VGB,2021-19,29,0,British Virgin Islands,30237,America,246,1
VGB,2021-20,0,0,British Virgin Islands,30237,America,246,1
VGB,2021-21,0,0,British Virgin Islands,30237,America,246,1
VGB,2021-22,0,0,British Virgin Islands,30237,America,246,1
VGB,2021-23,0,0,British Virgin Islands,30237,America,246,1
VGB,2021-24,50,0,British Virgin Islands,30237,America,296,1
VGB,2021-25,0,0,British Virgin Islands,30237,America,296,1
VGB,2021-26,94,0,British Virgin Islands,30237,America,390,1
VGB,2021-27,755,2,British Virgin Islands,30237,America,1145,3
VGB,2021-28,877,0,British Virgin Islands,30237,America,2022,3
VGB,2021-29,365,22,British Virgin Islands,30237,America,2387,25
VGB,2021-30,111,6,British Virgin Islands,30237,America,2498,31
VGB,2021-31,32,6,British Virgin Islands,30237,America,2530,37
VGB,2021-32,20,0,British Virgin Islands,30237,America,2550,37
VIR,2020-14,12,1,United States Virgin Islands,104423,America,12,1
VIR,2020-15,9,0,United States Virgin Islands,104423,America,21,1
VIR,2020-16,2,2,United States Virgin Islands,104423,America,23,3
VIR,2020-17,2,0,United States Virgin Islands,104423,America,25,3
VIR,2020-18,11,1,United States Virgin Islands,104423,America,36,4
VIR,2020-19,3,0,United States Virgin Islands,104423,America,39,4
VIR,2020-20,0,2,United States Virgin Islands,104423,America,39,6
VIR,2020-21,0,0,United States Virgin Islands,104423,America,39,6
VIR,2020-22,0,0,United States Virgin Islands,104423,America,39,6
VIR,2020-23,2,0,United States Virgin Islands,104423,America,41,6
VIR,2020-24,2,0,United States Virgin Islands,104423,America,43,6
VIR,2020-25,3,0,United States Virgin Islands,104423,America,46,6
VIR,2020-26,5,0,United States Virgin Islands,104423,America,51,6
VIR,2020-27,31,0,United States Virgin Islands,104423,America,82,6
VIR,2020-28,69,0,United States Virgin Islands,104423,America,151,6
VIR,2020-29,116,0,United States Virgin Islands,104423,America,267,6
VIR,2020-30,64,1,United States Virgin Islands,104423,America,331,7
VIR,2020-31,60,1,United States Virgin Islands,104423,America,391,8
VIR,2020-32,126,1,United States Virgin Islands,104423,America,517,9
VIR,2020-33,194,0,United States Virgin Islands,104423,America,711,9
VIR,2020-34,243,2,United States Virgin Islands,104423,America,954,11
VIR,2020-35,150,3,United States Virgin Islands,104423,America,1104,14
VIR,2020-36,47,3,United States Virgin Islands,104423,America,1151,17
VIR,2020-37,39,2,United States Virgin Islands,104423,America,1190,19
VIR,2020-38,49,0,United States Virgin Islands,104423,America,1239,19
VIR,2020-39,48,0,United States Virgin Islands,104423,America,1287,19
VIR,2020-40,4,1,United States Virgin Islands,104423,America,1291,20
VIR,2020-41,4,0,United States Virgin Islands,104423,America,1295,20
VIR,2020-42,10,1,United States Virgin Islands,104423,America,1305,21
VIR,2020-43,13,0,United States Virgin Islands,104423,America,1318,21
VIR,2020-44,28,0,United States Virgin Islands,104423,America,1346,21
VIR,2020-45,29,2,United States Virgin Islands,104423,America,1375,23
VIR,2020-46,29,0,United States Virgin Islands,104423,America,1404,23
VIR,2020-47,70,0,United States Virgin Islands,104423,America,1474,23
VIR,2020-48,40,0,United States Virgin Islands,104423,America,1514,23
VIR,2020-49,105,0,United States Virgin Islands,104423,America,1619,23
VIR,2020-50,179,0,United States Virgin Islands,104423,America,1798,23
VIR,2020-51,93,0,United States Virgin Islands,104423,America,1891,23
VIR,2020-52,83,0,United States Virgin Islands,104423,America,1974,23
VIR,2020-53,51,1,United States Virgin Islands,104423,America,2025,24
VIR,2021-01,111,0,United States Virgin Islands,104423,America,2136,24
VIR,2021-02,94,0,United States Virgin Islands,104423,America,2230,24
VIR,2021-03,90,0,United States Virgin Islands,104423,America,2320,24
VIR,2021-04,71,0,United States Virgin Islands,104423,America,2391,24
VIR,2021-05,52,0,United States Virgin Islands,104423,America,2443,24
VIR,2021-06,69,1,United States Virgin Islands,104423,America,2512,25
VIR,2021-07,37,0,United States Virgin Islands,104423,America,2549,25
VIR,2021-08,67,0,United States Virgin Islands,104423,America,2616,25
VIR,2021-09,98,0,United States Virgin Islands,104423,America,2714,25
VIR,2021-10,23,0,United States Virgin Islands,104423,America,2737,25
VIR,2021-11,0,0,United States Virgin Islands,104423,America,2737,25
VIR,2021-12,140,1,United States Virgin Islands,104423,America,2877,26
VIR,2021-13,32,0,United States Virgin Islands,104423,America,2909,26
VIR,2021-14,66,0,United States Virgin Islands,104423,America,2975,26
VIR,2021-15,36,1,United States Virgin Islands,104423,America,3011,27
VIR,2021-16,49,0,United States Virgin Islands,104423,America,3060,27
VIR,2021-17,48,0,United States Virgin Islands,104423,America,3108,27
VIR,2021-18,95,0,United States Virgin Islands,104423,America,3203,27
VIR,2021-19,34,0,United States Virgin Islands,104423,America,3237,27
VIR,2021-20,116,0,United States Virgin Islands,104423,America,3353,27
VIR,2021-21,0,0,United States Virgin Islands,104423,America,3353,27
VIR,2021-22,208,1,United States Virgin Islands,104423,America,3561,28
VIR,2021-23,111,0,United States Virgin Islands,104423,America,3672,28
VIR,2021-24,66,2,United States Virgin Islands,104423,America,3738,30
VIR,2021-25,82,0,United States Virgin Islands,104423,America,3820,30
VIR,2021-26,92,2,United States Virgin Islands,104423,America,3912,32
VIR,2021-27,101,0,United States Virgin Islands,104423,America,4013,32
VIR,2021-28,143,0,United States Virgin Islands,104423,America,4156,32
VIR,2021-29,189,3,United States Virgin Islands,104423,America,4345,35
VIR,2021-30,288,4,United States Virgin Islands,104423,America,4633,39
VIR,2021-31,370,1,United States Virgin Islands,104423,America,5003,40
VIR,2021-32,293,1,United States Virgin Islands,104423,America,5296,41
VNM,2020-02,0,0,Vietnam,97338583,Asia,0,0
VNM,2020-03,0,0,Vietnam,97338583,Asia,0,0
VNM,2020-04,2,0,Vietnam,97338583,Asia,2,0
VNM,2020-05,6,0,Vietnam,97338583,Asia,8,0
VNM,2020-06,6,0,Vietnam,97338583,Asia,14,0
VNM,2020-07,2,0,Vietnam,97338583,Asia,16,0
VNM,2020-08,0,0,Vietnam,97338583,Asia,16,0
VNM,2020-09,0,0,Vietnam,97338583,Asia,16,0
VNM,2020-10,14,0,Vietnam,97338583,Asia,30,0
VNM,2020-11,27,0,Vietnam,97338583,Asia,57,0
VNM,2020-12,64,0,Vietnam,97338583,Asia,121,0
VNM,2020-13,82,0,Vietnam,97338583,Asia,203,0
VNM,2020-14,42,0,Vietnam,97338583,Asia,245,0
VNM,2020-15,19,0,Vietnam,97338583,Asia,264,0
VNM,2020-16,4,0,Vietnam,97338583,Asia,268,0
VNM,2020-17,2,0,Vietnam,97338583,Asia,270,0
VNM,2020-18,1,0,Vietnam,97338583,Asia,271,0
VNM,2020-19,17,0,Vietnam,97338583,Asia,288,0
VNM,2020-20,32,0,Vietnam,97338583,Asia,320,0
VNM,2020-21,5,0,Vietnam,97338583,Asia,325,0
VNM,2020-22,3,0,Vietnam,97338583,Asia,328,0
VNM,2020-23,3,0,Vietnam,97338583,Asia,331,0
VNM,2020-24,3,0,Vietnam,97338583,Asia,334,0
VNM,2020-25,15,0,Vietnam,97338583,Asia,349,0
VNM,2020-26,6,0,Vietnam,97338583,Asia,355,0
VNM,2020-27,0,0,Vietnam,97338583,Asia,355,0
VNM,2020-28,17,0,Vietnam,97338583,Asia,372,0
VNM,2020-29,1,0,Vietnam,97338583,Asia,373,0
VNM,2020-30,47,0,Vietnam,97338583,Asia,420,0
VNM,2020-31,201,6,Vietnam,97338583,Asia,621,6
VNM,2020-32,220,7,Vietnam,97338583,Asia,841,13
VNM,2020-33,123,11,Vietnam,97338583,Asia,964,24
VNM,2020-34,52,3,Vietnam,97338583,Asia,1016,27
VNM,2020-35,24,5,Vietnam,97338583,Asia,1040,32
VNM,2020-36,9,3,Vietnam,97338583,Asia,1049,35
VNM,2020-37,14,0,Vietnam,97338583,Asia,1063,35
VNM,2020-38,5,0,Vietnam,97338583,Asia,1068,35
VNM,2020-39,6,0,Vietnam,97338583,Asia,1074,35
VNM,2020-40,22,0,Vietnam,97338583,Asia,1096,35
VNM,2020-41,13,0,Vietnam,97338583,Asia,1109,35
VNM,2020-42,25,0,Vietnam,97338583,Asia,1134,35
VNM,2020-43,34,0,Vietnam,97338583,Asia,1168,35
VNM,2020-44,12,0,Vietnam,97338583,Asia,1180,35
VNM,2020-45,33,0,Vietnam,97338583,Asia,1213,35
VNM,2020-46,68,0,Vietnam,97338583,Asia,1281,35
VNM,2020-47,25,0,Vietnam,97338583,Asia,1306,35
VNM,2020-48,37,0,Vietnam,97338583,Asia,1343,35
VNM,2020-49,23,0,Vietnam,97338583,Asia,1366,35
VNM,2020-50,31,0,Vietnam,97338583,Asia,1397,35
VNM,2020-51,16,0,Vietnam,97338583,Asia,1413,35
VNM,2020-52,28,0,Vietnam,97338583,Asia,1441,35
VNM,2020-53,56,0,Vietnam,97338583,Asia,1497,35
VNM,2021-01,17,0,Vietnam,97338583,Asia,1514,35
VNM,2021-02,25,0,Vietnam,97338583,Asia,1539,35
VNM,2021-03,9,0,Vietnam,97338583,Asia,1548,35
VNM,2021-04,271,0,Vietnam,97338583,Asia,1819,35
VNM,2021-05,186,0,Vietnam,97338583,Asia,2005,35
VNM,2021-06,224,0,Vietnam,97338583,Asia,2229,35
VNM,2021-07,163,0,Vietnam,97338583,Asia,2392,35
VNM,2021-08,56,0,Vietnam,97338583,Asia,2448,35
VNM,2021-09,64,0,Vietnam,97338583,Asia,2512,35
VNM,2021-10,42,0,Vietnam,97338583,Asia,2554,35
VNM,2021-11,18,0,Vietnam,97338583,Asia,2572,35
VNM,2021-12,19,0,Vietnam,97338583,Asia,2591,35
VNM,2021-13,40,0,Vietnam,97338583,Asia,2631,35
VNM,2021-14,65,0,Vietnam,97338583,Asia,2696,35
VNM,2021-15,89,0,Vietnam,97338583,Asia,2785,35
VNM,2021-16,61,0,Vietnam,97338583,Asia,2846,35
VNM,2021-17,116,0,Vietnam,97338583,Asia,2962,35
VNM,2021-18,482,0,Vietnam,97338583,Asia,3444,35
VNM,2021-19,798,2,Vietnam,97338583,Asia,4242,37
VNM,2021-20,1066,6,Vietnam,97338583,Asia,5308,43
VNM,2021-21,1860,4,Vietnam,97338583,Asia,7168,47
VNM,2021-22,67,6,Vietnam,97338583,Asia,7235,53
VNM,2021-23,3495,6,Vietnam,97338583,Asia,10730,59
VNM,2021-24,917,7,Vietnam,97338583,Asia,11647,66
VNM,2021-25,4093,10,Vietnam,97338583,Asia,15740,76
VNM,2021-26,2982,14,Vietnam,97338583,Asia,18722,90
VNM,2021-27,8537,15,Vietnam,97338583,Asia,27259,105
VNM,2021-28,16199,149,Vietnam,97338583,Asia,43458,254
VNM,2021-29,57715,270,Vietnam,97338583,Asia,101173,524
VNM,2021-30,56334,782,Vietnam,97338583,Asia,157507,1306
VNM,2021-31,53053,2091,Vietnam,97338583,Asia,210560,3397
VNM,2021-32,64484,2377,Vietnam,97338583,Asia,275044,5774
VUT,2020-47,0,0,Vanuatu,307150,Oceania,0,0
VUT,2020-48,0,0,Vanuatu,307150,Oceania,0,0
VUT,2020-49,0,0,Vanuatu,307150,Oceania,0,0
VUT,2020-50,0,0,Vanuatu,307150,Oceania,0,0
VUT,2020-51,0,0,Vanuatu,307150,Oceania,0,0
VUT,2020-52,0,0,Vanuatu,307150,Oceania,0,0
VUT,2020-53,0,0,Vanuatu,307150,Oceania,0,0
VUT,2021-01,0,0,Vanuatu,307150,Oceania,0,0
VUT,2021-02,0,0,Vanuatu,307150,Oceania,0,0
VUT,2021-03,0,0,Vanuatu,307150,Oceania,0,0
VUT,2021-04,0,0,Vanuatu,307150,Oceania,0,0
VUT,2021-05,0,0,Vanuatu,307150,Oceania,0,0
VUT,2021-06,0,0,Vanuatu,307150,Oceania,0,0
VUT,2021-07,0,0,Vanuatu,307150,Oceania,0,0
VUT,2021-08,0,0,Vanuatu,307150,Oceania,0,0
VUT,2021-09,2,0,Vanuatu,307150,Oceania,2,0
VUT,2021-10,0,0,Vanuatu,307150,Oceania,2,0
VUT,2021-11,0,0,Vanuatu,307150,Oceania,2,0
VUT,2021-12,0,0,Vanuatu,307150,Oceania,2,0
VUT,2021-13,0,0,Vanuatu,307150,Oceania,2,0
VUT,2021-14,0,0,Vanuatu,307150,Oceania,2,0
VUT,2021-15,0,0,Vanuatu,307150,Oceania,2,0
VUT,2021-16,0,0,Vanuatu,307150,Oceania,2,0
VUT,2021-17,0,0,Vanuatu,307150,Oceania,2,0
VUT,2021-18,0,0,Vanuatu,307150,Oceania,2,0
VUT,2021-19,0,0,Vanuatu,307150,Oceania,2,0
VUT,2021-20,0,0,Vanuatu,307150,Oceania,2,0
VUT,2021-21,0,0,Vanuatu,307150,Oceania,2,0
VUT,2021-22,0,0,Vanuatu,307150,Oceania,2,0
VUT,2021-23,0,0,Vanuatu,307150,Oceania,2,0
VUT,2021-24,0,0,Vanuatu,307150,Oceania,2,0
VUT,2021-25,0,0,Vanuatu,307150,Oceania,2,0
VUT,2021-26,0,0,Vanuatu,307150,Oceania,2,0
VUT,2021-27,0,0,Vanuatu,307150,Oceania,2,0
VUT,2021-28,0,0,Vanuatu,307150,Oceania,2,0
VUT,2021-29,0,0,Vanuatu,307150,Oceania,2,0
VUT,2021-30,0,1,Vanuatu,307150,Oceania,2,1
VUT,2021-31,0,0,Vanuatu,307150,Oceania,2,1
VUT,2021-32,0,0,Vanuatu,307150,Oceania,2,1
WLF,2020-43,0,0,Wallis And Futuna,11246,Oceania,0,0
WLF,2020-44,0,0,Wallis And Futuna,11246,Oceania,0,0
WLF,2020-45,0,0,Wallis And Futuna,11246,Oceania,0,0
WLF,2020-46,0,0,Wallis And Futuna,11246,Oceania,0,0
WLF,2020-47,1,0,Wallis And Futuna,11246,Oceania,1,0
WLF,2020-48,1,0,Wallis And Futuna,11246,Oceania,2,0
WLF,2020-49,0,0,Wallis And Futuna,11246,Oceania,2,0
WLF,2020-50,0,0,Wallis And Futuna,11246,Oceania,2,0
WLF,2020-51,1,0,Wallis And Futuna,11246,Oceania,3,0
WLF,2020-52,0,0,Wallis And Futuna,11246,Oceania,3,0
WLF,2020-53,0,0,Wallis And Futuna,11246,Oceania,3,0
WLF,2021-01,0,0,Wallis And Futuna,11246,Oceania,3,0
WLF,2021-02,0,0,Wallis And Futuna,11246,Oceania,3,0
WLF,2021-03,0,0,Wallis And Futuna,11246,Oceania,3,0
WLF,2021-04,1,0,Wallis And Futuna,11246,Oceania,4,0
WLF,2021-05,4,0,Wallis And Futuna,11246,Oceania,8,0
WLF,2021-06,0,0,Wallis And Futuna,11246,Oceania,8,0
WLF,2021-07,0,0,Wallis And Futuna,11246,Oceania,8,0
WLF,2021-08,0,0,Wallis And Futuna,11246,Oceania,8,0
WLF,2021-09,1,0,Wallis And Futuna,11246,Oceania,9,0
WLF,2021-10,176,0,Wallis And Futuna,11246,Oceania,185,0
WLF,2021-11,132,1,Wallis And Futuna,11246,Oceania,317,1
WLF,2021-12,56,3,Wallis And Futuna,11246,Oceania,373,4
WLF,2021-13,46,0,Wallis And Futuna,11246,Oceania,419,4
WLF,2021-14,17,1,Wallis And Futuna,11246,Oceania,436,5
WLF,2021-15,1,0,Wallis And Futuna,11246,Oceania,437,5
WLF,2021-16,4,0,Wallis And Futuna,11246,Oceania,441,5
WLF,2021-17,2,2,Wallis And Futuna,11246,Oceania,443,7
WLF,2021-18,1,0,Wallis And Futuna,11246,Oceania,444,7
WLF,2021-19,0,0,Wallis And Futuna,11246,Oceania,444,7
WLF,2021-20,0,0,Wallis And Futuna,11246,Oceania,444,7
WLF,2021-21,0,0,Wallis And Futuna,11246,Oceania,444,7
WLF,2021-22,9,0,Wallis And Futuna,11246,Oceania,453,7
WLF,2021-23,0,0,Wallis And Futuna,11246,Oceania,453,7
WLF,2021-24,0,0,Wallis And Futuna,11246,Oceania,453,7
WLF,2021-25,0,0,Wallis And Futuna,11246,Oceania,453,7
WLF,2021-26,0,0,Wallis And Futuna,11246,Oceania,453,7
WLF,2021-27,0,0,Wallis And Futuna,11246,Oceania,453,7
WLF,2021-28,0,0,Wallis And Futuna,11246,Oceania,453,7
WLF,2021-29,0,0,Wallis And Futuna,11246,Oceania,453,7
WLF,2021-30,0,0,Wallis And Futuna,11246,Oceania,453,7
WLF,2021-31,0,0,Wallis And Futuna,11246,Oceania,453,7
WLF,2021-32,0,0,Wallis And Futuna,11246,Oceania,453,7
XKX,2020-12,20,1,Kosovo,1795666,Europe,20,1
XKX,2020-13,65,0,Kosovo,1795666,Europe,85,1
XKX,2020-14,67,0,Kosovo,1795666,Europe,152,1
XKX,2020-15,197,6,Kosovo,1795666,Europe,349,7
XKX,2020-16,199,7,Kosovo,1795666,Europe,548,14
XKX,2020-17,203,6,Kosovo,1795666,Europe,751,20
XKX,2020-18,87,5,Kosovo,1795666,Europe,838,25
XKX,2020-19,33,3,Kosovo,1795666,Europe,871,28
XKX,2020-20,101,1,Kosovo,1795666,Europe,972,29
XKX,2020-21,47,0,Kosovo,1795666,Europe,1019,29
XKX,2020-22,51,1,Kosovo,1795666,Europe,1070,30
XKX,2020-23,151,1,Kosovo,1795666,Europe,1221,31
XKX,2020-24,252,2,Kosovo,1795666,Europe,1473,33
XKX,2020-25,683,3,Kosovo,1795666,Europe,2156,36
XKX,2020-26,508,13,Kosovo,1795666,Europe,2664,49
XKX,2020-27,679,17,Kosovo,1795666,Europe,3343,66
XKX,2020-28,1575,36,Kosovo,1795666,Europe,4918,102
XKX,2020-29,804,33,Kosovo,1795666,Europe,5722,135
XKX,2020-30,1182,34,Kosovo,1795666,Europe,6904,169
XKX,2020-31,1882,80,Kosovo,1795666,Europe,8786,249
XKX,2020-32,1448,78,Kosovo,1795666,Europe,10234,327
XKX,2020-33,1169,74,Kosovo,1795666,Europe,11403,401
XKX,2020-34,1032,66,Kosovo,1795666,Europe,12435,467
XKX,2020-35,886,49,Kosovo,1795666,Europe,13321,516
XKX,2020-36,785,47,Kosovo,1795666,Europe,14106,563
XKX,2020-37,518,33,Kosovo,1795666,Europe,14624,596
XKX,2020-38,426,17,Kosovo,1795666,Europe,15050,613
XKX,2020-39,409,9,Kosovo,1795666,Europe,15459,622
XKX,2020-40,342,8,Kosovo,1795666,Europe,15801,630
XKX,2020-41,365,17,Kosovo,1795666,Europe,16166,647
XKX,2020-42,712,6,Kosovo,1795666,Europe,16878,653
XKX,2020-43,1052,10,Kosovo,1795666,Europe,17930,663
XKX,2020-44,2236,25,Kosovo,1795666,Europe,20166,688
XKX,2020-45,3976,67,Kosovo,1795666,Europe,24142,755
XKX,2020-46,4962,67,Kosovo,1795666,Europe,29104,822
XKX,2020-47,5178,92,Kosovo,1795666,Europe,34282,914
XKX,2020-48,4762,91,Kosovo,1795666,Europe,39044,1005
XKX,2020-49,3748,101,Kosovo,1795666,Europe,42792,1106
XKX,2020-50,3775,92,Kosovo,1795666,Europe,46567,1198
XKX,2020-51,2589,64,Kosovo,1795666,Europe,49156,1262
XKX,2020-52,1632,55,Kosovo,1795666,Europe,50788,1317
XKX,2020-53,1164,27,Kosovo,1795666,Europe,51952,1344
XKX,2021-01,1811,33,Kosovo,1795666,Europe,53763,1377
XKX,2021-02,2075,33,Kosovo,1795666,Europe,55838,1410
XKX,2021-03,2237,46,Kosovo,1795666,Europe,58075,1456
XKX,2021-04,2130,42,Kosovo,1795666,Europe,60205,1498
XKX,2021-05,2040,25,Kosovo,1795666,Europe,62245,1523
XKX,2021-06,2083,21,Kosovo,1795666,Europe,64328,1544
XKX,2021-07,2039,28,Kosovo,1795666,Europe,66367,1572
XKX,2021-08,2850,27,Kosovo,1795666,Europe,69217,1599
XKX,2021-09,3818,50,Kosovo,1795666,Europe,73035,1649
XKX,2021-10,4205,53,Kosovo,1795666,Europe,77240,1702
XKX,2021-11,4932,58,Kosovo,1795666,Europe,82172,1760
XKX,2021-12,5796,80,Kosovo,1795666,Europe,87968,1840
XKX,2021-13,5674,75,Kosovo,1795666,Europe,93642,1915
XKX,2021-14,4341,73,Kosovo,1795666,Europe,97983,1988
XKX,2021-15,3521,84,Kosovo,1795666,Europe,101504,2072
XKX,2021-16,2525,57,Kosovo,1795666,Europe,104029,2129
XKX,2021-17,1493,58,Kosovo,1795666,Europe,105522,2187
XKX,2021-18,954,23,Kosovo,1795666,Europe,106476,2210
XKX,2021-19,354,13,Kosovo,1795666,Europe,106830,2223
XKX,2021-20,401,16,Kosovo,1795666,Europe,107231,2239
XKX,2021-21,161,5,Kosovo,1795666,Europe,107392,2244
XKX,2021-22,102,1,Kosovo,1795666,Europe,107494,2245
XKX,2021-23,71,5,Kosovo,1795666,Europe,107565,2250
XKX,2021-24,77,2,Kosovo,1795666,Europe,107642,2252
XKX,2021-25,84,6,Kosovo,1795666,Europe,107726,2258
XKX,2021-26,61,3,Kosovo,1795666,Europe,107787,2261
XKX,2021-27,59,3,Kosovo,1795666,Europe,107846,2264
XKX,2021-28,47,0,Kosovo,1795666,Europe,107893,2264
XKX,2021-29,111,1,Kosovo,1795666,Europe,108004,2265
XKX,2021-30,496,1,Kosovo,1795666,Europe,108500,2266
XKX,2021-31,1681,5,Kosovo,1795666,Europe,110181,2271
XKX,2021-32,6793,15,Kosovo,1795666,Europe,116974,2286
YEM,2020-16,0,0,Yemen,29825968,Asia,0,0
YEM,2020-17,0,0,Yemen,29825968,Asia,0,0
YEM,2020-18,9,2,Yemen,29825968,Asia,9,2
YEM,2020-19,41,6,Yemen,29825968,Asia,50,8
YEM,2020-20,77,12,Yemen,29825968,Asia,127,20
YEM,2020-21,94,22,Yemen,29825968,Asia,221,42
YEM,2020-22,101,38,Yemen,29825968,Asia,322,80
YEM,2020-23,163,32,Yemen,29825968,Asia,485,112
YEM,2020-24,242,52,Yemen,29825968,Asia,727,164
YEM,2020-25,213,92,Yemen,29825968,Asia,940,256
YEM,2020-26,177,46,Yemen,29825968,Asia,1117,302
YEM,2020-27,147,36,Yemen,29825968,Asia,1264,338
YEM,2020-28,200,79,Yemen,29825968,Asia,1464,417
YEM,2020-29,141,28,Yemen,29825968,Asia,1605,445
YEM,2020-30,75,34,Yemen,29825968,Asia,1680,479
YEM,2020-31,53,18,Yemen,29825968,Asia,1733,497
YEM,2020-32,70,18,Yemen,29825968,Asia,1803,515
YEM,2020-33,65,15,Yemen,29825968,Asia,1868,530
YEM,2020-34,42,17,Yemen,29825968,Asia,1910,547
YEM,2020-35,42,17,Yemen,29825968,Asia,1952,564
YEM,2020-36,34,8,Yemen,29825968,Asia,1986,572
YEM,2020-37,26,11,Yemen,29825968,Asia,2012,583
YEM,2020-38,17,3,Yemen,29825968,Asia,2029,586
YEM,2020-39,4,2,Yemen,29825968,Asia,2033,588
YEM,2020-40,11,3,Yemen,29825968,Asia,2044,591
YEM,2020-41,10,5,Yemen,29825968,Asia,2054,596
YEM,2020-42,4,1,Yemen,29825968,Asia,2058,597
YEM,2020-43,4,2,Yemen,29825968,Asia,2062,599
YEM,2020-44,0,1,Yemen,29825968,Asia,2062,600
YEM,2020-45,0,2,Yemen,29825968,Asia,2062,602
YEM,2020-46,5,0,Yemen,29825968,Asia,2067,602
YEM,2020-47,1,2,Yemen,29825968,Asia,2068,604
YEM,2020-48,8,1,Yemen,29825968,Asia,2076,605
YEM,2020-49,0,1,Yemen,29825968,Asia,2076,606
YEM,2020-50,6,0,Yemen,29825968,Asia,2082,606
YEM,2020-51,6,1,Yemen,29825968,Asia,2088,607
YEM,2020-52,9,1,Yemen,29825968,Asia,2097,608
YEM,2020-53,7,3,Yemen,29825968,Asia,2104,611
YEM,2021-01,3,1,Yemen,29825968,Asia,2107,612
YEM,2021-02,8,1,Yemen,29825968,Asia,2115,613
YEM,2021-03,6,3,Yemen,29825968,Asia,2121,616
YEM,2021-04,3,0,Yemen,29825968,Asia,2124,616
YEM,2021-05,6,0,Yemen,29825968,Asia,2130,616
YEM,2021-06,18,2,Yemen,29825968,Asia,2148,618
YEM,2021-07,20,1,Yemen,29825968,Asia,2168,619
YEM,2021-08,104,13,Yemen,29825968,Asia,2272,632
YEM,2021-09,200,19,Yemen,29825968,Asia,2472,651
YEM,2021-10,363,38,Yemen,29825968,Asia,2835,689
YEM,2021-11,582,62,Yemen,29825968,Asia,3417,751
YEM,2021-12,555,82,Yemen,29825968,Asia,3972,833
YEM,2021-13,825,113,Yemen,29825968,Asia,4797,946
YEM,2021-14,648,122,Yemen,29825968,Asia,5445,1068
YEM,2021-15,412,64,Yemen,29825968,Asia,5857,1132
YEM,2021-16,283,56,Yemen,29825968,Asia,6140,1188
YEM,2021-17,188,42,Yemen,29825968,Asia,6328,1230
YEM,2021-18,137,41,Yemen,29825968,Asia,6465,1271
YEM,2021-19,76,15,Yemen,29825968,Asia,6541,1286
YEM,2021-20,111,19,Yemen,29825968,Asia,6652,1305
YEM,2021-21,82,15,Yemen,29825968,Asia,6734,1320
YEM,2021-22,52,9,Yemen,29825968,Asia,6786,1329
YEM,2021-23,75,20,Yemen,29825968,Asia,6861,1349
YEM,2021-24,23,6,Yemen,29825968,Asia,6884,1355
YEM,2021-25,23,5,Yemen,29825968,Asia,6907,1360
YEM,2021-26,21,1,Yemen,29825968,Asia,6928,1361
YEM,2021-27,19,5,Yemen,29825968,Asia,6947,1366
YEM,2021-28,39,4,Yemen,29825968,Asia,6986,1370
YEM,2021-29,25,3,Yemen,29825968,Asia,7011,1373
YEM,2021-30,58,4,Yemen,29825968,Asia,7069,1377
YEM,2021-31,95,9,Yemen,29825968,Asia,7164,1386
YEM,2021-32,128,17,Yemen,29825968,Asia,7292,1403
ZAF,2020-11,48,0,South Africa,59308690,Africa,48,0
ZAF,2020-12,223,0,South Africa,59308690,Africa,271,0
ZAF,2020-13,1006,2,South Africa,59308690,Africa,1277,2
ZAF,2020-14,375,9,South Africa,59308690,Africa,1652,11
ZAF,2020-15,518,14,South Africa,59308690,Africa,2170,25
ZAF,2020-16,985,29,South Africa,59308690,Africa,3155,54
ZAF,2020-17,1388,33,South Africa,59308690,Africa,4543,87
ZAF,2020-18,2237,44,South Africa,59308690,Africa,6780,131
ZAF,2020-19,3232,63,South Africa,59308690,Africa,10012,194
ZAF,2020-20,5500,70,South Africa,59308690,Africa,15512,264
ZAF,2020-21,7068,165,South Africa,59308690,Africa,22580,429
ZAF,2020-22,10100,254,South Africa,59308690,Africa,32680,683
ZAF,2020-23,15602,315,South Africa,59308690,Africa,48282,998
ZAF,2020-24,21753,482,South Africa,59308690,Africa,70035,1480
ZAF,2020-25,27264,450,South Africa,59308690,Africa,97299,1930
ZAF,2020-26,40832,526,South Africa,59308690,Africa,138131,2456
ZAF,2020-27,58616,743,South Africa,59308690,Africa,196747,3199
ZAF,2020-28,79492,880,South Africa,59308690,Africa,276239,4079
ZAF,2020-29,88086,954,South Africa,59308690,Africa,364325,5033
ZAF,2020-30,81105,1736,South Africa,59308690,Africa,445430,6769
ZAF,2020-31,66052,1597,South Africa,59308690,Africa,511482,8366
ZAF,2020-32,48373,2042,South Africa,59308690,Africa,559855,10408
ZAF,2020-33,27487,1431,South Africa,59308690,Africa,587342,11839
ZAF,2020-34,22428,1220,South Africa,59308690,Africa,609770,13059
ZAF,2020-35,15283,969,South Africa,59308690,Africa,625053,14028
ZAF,2020-36,13461,861,South Africa,59308690,Africa,638514,14889
ZAF,2020-37,11276,558,South Africa,59308690,Africa,649790,15447
ZAF,2020-38,11418,506,South Africa,59308690,Africa,661208,15953
ZAF,2020-39,9555,445,South Africa,59308690,Africa,670763,16398
ZAF,2020-40,10523,578,South Africa,59308690,Africa,681286,16976
ZAF,2020-41,11182,804,South Africa,59308690,Africa,692468,17780
ZAF,2020-42,11322,691,South Africa,59308690,Africa,703790,18471
ZAF,2020-43,12075,497,South Africa,59308690,Africa,715865,18968
ZAF,2020-44,10955,443,South Africa,59308690,Africa,726820,19411
ZAF,2020-45,10455,398,South Africa,59308690,Africa,737275,19809
ZAF,2020-46,13746,432,South Africa,59308690,Africa,751021,20241
ZAF,2020-47,16655,662,South Africa,59308690,Africa,767676,20903
ZAF,2020-48,20023,574,South Africa,59308690,Africa,787699,21477
ZAF,2020-49,26863,729,South Africa,59308690,Africa,814562,22206
ZAF,2020-50,46399,1070,South Africa,59308690,Africa,860961,23276
ZAF,2020-51,60958,1415,South Africa,59308690,Africa,921919,24691
ZAF,2020-52,89949,2380,South Africa,59308690,Africa,1011868,27071
ZAF,2020-53,88877,2506,South Africa,59308690,Africa,1100745,29577
ZAF,2021-01,130849,3586,South Africa,59308690,Africa,1231594,33163
ZAF,2021-02,106329,3942,South Africa,59308690,Africa,1337923,37105
ZAF,2021-03,75060,3769,South Africa,59308690,Africa,1412983,40874
ZAF,2021-04,43323,3525,South Africa,59308690,Africa,1456306,44399
ZAF,2021-05,19826,1891,South Africa,59308690,Africa,1476132,46290
ZAF,2021-06,15672,1609,South Africa,59308690,Africa,1491804,47899
ZAF,2021-07,11989,1154,South Africa,59308690,Africa,1503793,49053
ZAF,2021-08,8429,888,South Africa,59308690,Africa,1512222,49941
ZAF,2021-09,7981,706,South Africa,59308690,Africa,1520203,50647
ZAF,2021-10,9214,679,South Africa,59308690,Africa,1529417,51326
ZAF,2021-11,8432,785,South Africa,59308690,Africa,1537849,52111
ZAF,2021-12,7579,552,South Africa,59308690,Africa,1545428,52663
ZAF,2021-13,6533,324,South Africa,59308690,Africa,1551961,52987
ZAF,2021-14,6494,335,South Africa,59308690,Africa,1558455,53322
ZAF,2021-15,8311,414,South Africa,59308690,Africa,1566766,53736
ZAF,2021-16,8702,412,South Africa,59308690,Africa,1575468,54148
ZAF,2021-17,8593,269,South Africa,59308690,Africa,1584061,54417
ZAF,2021-18,12531,318,South Africa,59308690,Africa,1596592,54735
ZAF,2021-19,17133,475,South Africa,59308690,Africa,1613725,55210
ZAF,2021-20,21737,592,South Africa,59308690,Africa,1635462,55802
ZAF,2021-21,27360,637,South Africa,59308690,Africa,1662822,56439
ZAF,2021-22,33739,535,South Africa,59308690,Africa,1696561,56974
ZAF,2021-23,50518,791,South Africa,59308690,Africa,1747079,57765
ZAF,2021-24,76237,937,South Africa,59308690,Africa,1823316,58702
ZAF,2021-25,105578,1198,South Africa,59308690,Africa,1928894,59900
ZAF,2021-26,133999,1940,South Africa,59308690,Africa,2062893,61840
ZAF,2021-27,132703,2449,South Africa,59308690,Africa,2195596,64289
ZAF,2021-28,99496,2570,South Africa,59308690,Africa,2295092,66859
ZAF,2021-29,82728,2916,South Africa,59308690,Africa,2377820,69775
ZAF,2021-30,78361,2416,South Africa,59308690,Africa,2456181,72191
ZAF,2021-31,77282,2622,South Africa,59308690,Africa,2533463,74813
ZAF,2021-32,72120,2328,South Africa,59308690,Africa,2605583,77141
ZMB,2020-13,26,0,Zambia,18383956,Africa,26,0
ZMB,2020-14,10,1,Zambia,18383956,Africa,36,1
ZMB,2020-15,4,1,Zambia,18383956,Africa,40,2
ZMB,2020-16,18,1,Zambia,18383956,Africa,58,3
ZMB,2020-17,27,0,Zambia,18383956,Africa,85,3
ZMB,2020-18,36,0,Zambia,18383956,Africa,121,3
ZMB,2020-19,143,4,Zambia,18383956,Africa,264,7
ZMB,2020-20,486,0,Zambia,18383956,Africa,750,7
ZMB,2020-21,167,0,Zambia,18383956,Africa,917,7
ZMB,2020-22,137,0,Zambia,18383956,Africa,1054,7
ZMB,2020-23,97,0,Zambia,18383956,Africa,1151,7
ZMB,2020-24,204,4,Zambia,18383956,Africa,1355,11
ZMB,2020-25,72,0,Zambia,18383956,Africa,1427,11
ZMB,2020-26,127,11,Zambia,18383956,Africa,1554,22
ZMB,2020-27,75,8,Zambia,18383956,Africa,1629,30
ZMB,2020-28,263,12,Zambia,18383956,Africa,1892,42
ZMB,2020-29,1085,67,Zambia,18383956,Africa,2977,109
ZMB,2020-30,1501,30,Zambia,18383956,Africa,4478,139
ZMB,2020-31,1866,31,Zambia,18383956,Africa,6344,170
ZMB,2020-32,1738,65,Zambia,18383956,Africa,8082,235
ZMB,2020-33,1258,25,Zambia,18383956,Africa,9340,260
ZMB,2020-34,1739,20,Zambia,18383956,Africa,11079,280
ZMB,2020-35,943,7,Zambia,18383956,Africa,12022,287
ZMB,2020-36,751,8,Zambia,18383956,Africa,12773,295
ZMB,2020-37,763,17,Zambia,18383956,Africa,13536,312
ZMB,2020-38,592,18,Zambia,18383956,Africa,14128,330
ZMB,2020-39,510,2,Zambia,18383956,Africa,14638,332
ZMB,2020-40,411,1,Zambia,18383956,Africa,15049,333
ZMB,2020-41,406,3,Zambia,18383956,Africa,15455,336
ZMB,2020-42,395,10,Zambia,18383956,Africa,15850,346
ZMB,2020-43,264,2,Zambia,18383956,Africa,16114,348
ZMB,2020-44,363,1,Zambia,18383956,Africa,16477,349
ZMB,2020-45,474,0,Zambia,18383956,Africa,16951,349
ZMB,2020-46,169,4,Zambia,18383956,Africa,17120,353
ZMB,2020-47,301,4,Zambia,18383956,Africa,17421,357
ZMB,2020-48,184,0,Zambia,18383956,Africa,17605,357
ZMB,2020-49,308,7,Zambia,18383956,Africa,17913,364
ZMB,2020-50,358,3,Zambia,18383956,Africa,18271,367
ZMB,2020-51,442,6,Zambia,18383956,Africa,18713,373
ZMB,2020-52,1227,11,Zambia,18383956,Africa,19940,384
ZMB,2020-53,2050,14,Zambia,18383956,Africa,21990,398
ZMB,2021-01,6603,73,Zambia,18383956,Africa,28593,471
ZMB,2021-02,9611,88,Zambia,18383956,Africa,38204,559
ZMB,2021-03,7939,101,Zambia,18383956,Africa,46143,660
ZMB,2021-04,8896,120,Zambia,18383956,Africa,55039,780
ZMB,2021-05,7591,73,Zambia,18383956,Africa,62630,853
ZMB,2021-06,6804,98,Zambia,18383956,Africa,69434,951
ZMB,2021-07,6145,89,Zambia,18383956,Africa,75579,1040
ZMB,2021-08,2952,51,Zambia,18383956,Africa,78531,1091
ZMB,2021-09,4121,41,Zambia,18383956,Africa,82652,1132
ZMB,2021-10,2142,26,Zambia,18383956,Africa,84794,1158
ZMB,2021-11,1738,24,Zambia,18383956,Africa,86532,1182
ZMB,2021-12,1337,18,Zambia,18383956,Africa,87869,1200
ZMB,2021-13,1137,22,Zambia,18383956,Africa,89006,1222
ZMB,2021-14,1020,4,Zambia,18383956,Africa,90026,1226
ZMB,2021-15,913,10,Zambia,18383956,Africa,90939,1236
ZMB,2021-16,436,12,Zambia,18383956,Africa,91375,1248
ZMB,2021-17,315,5,Zambia,18383956,Africa,91690,1253
ZMB,2021-18,399,4,Zambia,18383956,Africa,92089,1257
ZMB,2021-19,344,3,Zambia,18383956,Africa,92433,1260
ZMB,2021-20,765,8,Zambia,18383956,Africa,93198,1268
ZMB,2021-21,1849,10,Zambia,18383956,Africa,95047,1278
ZMB,2021-22,5228,30,Zambia,18383956,Africa,100275,1308
ZMB,2021-23,11468,81,Zambia,18383956,Africa,111743,1389
ZMB,2021-24,17287,255,Zambia,18383956,Africa,129030,1644
ZMB,2021-25,19535,378,Zambia,18383956,Africa,148565,2022
ZMB,2021-26,15714,421,Zambia,18383956,Africa,164279,2443
ZMB,2021-27,11447,379,Zambia,18383956,Africa,175726,2822
ZMB,2021-28,9920,262,Zambia,18383956,Africa,185646,3084
ZMB,2021-29,6422,188,Zambia,18383956,Africa,192068,3272
ZMB,2021-30,4222,134,Zambia,18383956,Africa,196290,3406
ZMB,2021-31,3756,78,Zambia,18383956,Africa,200046,3484
ZMB,2021-32,2212,45,Zambia,18383956,Africa,202258,3529
ZWE,2020-13,5,1,Zimbabwe,14862927,Africa,5,1
ZWE,2020-14,2,0,Zimbabwe,14862927,Africa,7,1
ZWE,2020-15,5,2,Zimbabwe,14862927,Africa,12,3
ZWE,2020-16,11,0,Zimbabwe,14862927,Africa,23,3
ZWE,2020-17,6,1,Zimbabwe,14862927,Africa,29,4
ZWE,2020-18,3,0,Zimbabwe,14862927,Africa,32,4
ZWE,2020-19,2,0,Zimbabwe,14862927,Africa,34,4
ZWE,2020-20,10,0,Zimbabwe,14862927,Africa,44,4
ZWE,2020-21,10,0,Zimbabwe,14862927,Africa,54,4
ZWE,2020-22,122,0,Zimbabwe,14862927,Africa,176,4
ZWE,2020-23,104,0,Zimbabwe,14862927,Africa,280,4
ZWE,2020-24,101,0,Zimbabwe,14862927,Africa,381,4
ZWE,2020-25,106,2,Zimbabwe,14862927,Africa,487,6
ZWE,2020-26,78,0,Zimbabwe,14862927,Africa,565,6
ZWE,2020-27,149,2,Zimbabwe,14862927,Africa,714,8
ZWE,2020-28,269,10,Zimbabwe,14862927,Africa,983,18
ZWE,2020-29,626,7,Zimbabwe,14862927,Africa,1609,25
ZWE,2020-30,901,9,Zimbabwe,14862927,Africa,2510,34
ZWE,2020-31,1409,36,Zimbabwe,14862927,Africa,3919,70
ZWE,2020-32,728,34,Zimbabwe,14862927,Africa,4647,104
ZWE,2020-33,612,28,Zimbabwe,14862927,Africa,5259,132
ZWE,2020-34,669,23,Zimbabwe,14862927,Africa,5928,155
ZWE,2020-35,482,41,Zimbabwe,14862927,Africa,6410,196
ZWE,2020-36,565,11,Zimbabwe,14862927,Africa,6975,207
ZWE,2020-37,549,17,Zimbabwe,14862927,Africa,7524,224
ZWE,2020-38,157,1,Zimbabwe,14862927,Africa,7681,225
ZWE,2020-39,129,2,Zimbabwe,14862927,Africa,7810,227
ZWE,2020-40,73,1,Zimbabwe,14862927,Africa,7883,228
ZWE,2020-41,126,2,Zimbabwe,14862927,Africa,8009,230
ZWE,2020-42,136,1,Zimbabwe,14862927,Africa,8145,231
ZWE,2020-43,129,6,Zimbabwe,14862927,Africa,8274,237
ZWE,2020-44,98,6,Zimbabwe,14862927,Africa,8372,243
ZWE,2020-45,157,10,Zimbabwe,14862927,Africa,8529,253
ZWE,2020-46,255,4,Zimbabwe,14862927,Africa,8784,257
ZWE,2020-47,434,11,Zimbabwe,14862927,Africa,9218,268
ZWE,2020-48,730,8,Zimbabwe,14862927,Africa,9948,276
ZWE,2020-49,768,15,Zimbabwe,14862927,Africa,10716,291
ZWE,2020-50,528,16,Zimbabwe,14862927,Africa,11244,307
ZWE,2020-51,1107,13,Zimbabwe,14862927,Africa,12351,320
ZWE,2020-52,795,34,Zimbabwe,14862927,Africa,13146,354
ZWE,2020-53,2117,26,Zimbabwe,14862927,Africa,15263,380
ZWE,2021-01,6212,127,Zimbabwe,14862927,Africa,21475,507
ZWE,2021-02,5726,206,Zimbabwe,14862927,Africa,27201,713
ZWE,2021-03,4117,292,Zimbabwe,14862927,Africa,31318,1005
ZWE,2021-04,2228,229,Zimbabwe,14862927,Africa,33546,1234
ZWE,2021-05,1004,92,Zimbabwe,14862927,Africa,34550,1326
ZWE,2021-06,620,74,Zimbabwe,14862927,Africa,35170,1400
ZWE,2021-07,690,41,Zimbabwe,14862927,Africa,35860,1441
ZWE,2021-08,227,22,Zimbabwe,14862927,Africa,36087,1463
ZWE,2021-09,182,22,Zimbabwe,14862927,Africa,36269,1485
ZWE,2021-10,213,18,Zimbabwe,14862927,Africa,36482,1503
ZWE,2021-11,181,9,Zimbabwe,14862927,Africa,36663,1512
ZWE,2021-12,157,8,Zimbabwe,14862927,Africa,36820,1520
ZWE,2021-13,101,5,Zimbabwe,14862927,Africa,36921,1525
ZWE,2021-14,365,13,Zimbabwe,14862927,Africa,37286,1538
ZWE,2021-15,463,15,Zimbabwe,14862927,Africa,37749,1553
ZWE,2021-16,335,4,Zimbabwe,14862927,Africa,38084,1557
ZWE,2021-17,195,13,Zimbabwe,14862927,Africa,38279,1570
ZWE,2021-18,138,6,Zimbabwe,14862927,Africa,38417,1576
ZWE,2021-19,141,6,Zimbabwe,14862927,Africa,38558,1582
ZWE,2021-20,122,4,Zimbabwe,14862927,Africa,38680,1586
ZWE,2021-21,262,8,Zimbabwe,14862927,Africa,38942,1594
ZWE,2021-22,245,12,Zimbabwe,14862927,Africa,39187,1606
ZWE,2021-23,770,26,Zimbabwe,14862927,Africa,39957,1632
ZWE,2021-24,1820,40,Zimbabwe,14862927,Africa,41777,1672
ZWE,2021-25,4663,64,Zimbabwe,14862927,Africa,46440,1736
ZWE,2021-26,8032,142,Zimbabwe,14862927,Africa,54472,1878
ZWE,2021-27,13291,307,Zimbabwe,14862927,Africa,67763,2185
ZWE,2021-28,15854,437,Zimbabwe,14862927,Africa,83617,2622
ZWE,2021-29,14275,472,Zimbabwe,14862927,Africa,97892,3094
ZWE,2021-30,11652,489,Zimbabwe,14862927,Africa,109544,3583
ZWE,2021-31,6781,317,Zimbabwe,14862927,Africa,116325,3900
ZWE,2021-32,3761,209,Zimbabwe,14862927,Africa,120086,4109
W_AF,2020-02,0,0,Africa,352325033,Africa,0,0
W_AF,2020-03,0,0,Africa,352325033,Africa,0,0
W_AF,2020-04,0,0,Africa,352325033,Africa,0,0
W_AF,2020-05,0,0,Africa,352325033,Africa,0,0
W_AF,2020-06,0,0,Africa,352325033,Africa,0,0
W_AF,2020-07,1,0,Africa,352325033,Africa,1,0
W_AF,2020-08,0,0,Africa,352325033,Africa,1,0
W_AF,2020-09,5,0,Africa,352325033,Africa,6,0
W_AF,2020-10,64,1,Africa,352325033,Africa,70,1
W_AF,2020-11,140,5,Africa,438179587,Africa,210,6
W_AF,2020-12,997,34,Africa,927809342,Africa,1207,40
W_AF,2020-13,3212,99,Africa,1253962389,Africa,4419,139
W_AF,2020-14,4526,290,Africa,1283052508,Africa,8945,429
W_AF,2020-15,5343,355,Africa,1335595583,Africa,14288,784
W_AF,2020-16,7781,331,Africa,1335814744,Africa,22069,1115
W_AF,2020-17,9439,295,Africa,1335814744,Africa,31508,1410
W_AF,2020-18,12684,384,Africa,1336412074,Africa,44192,1794
W_AF,2020-19,18956,491,Africa,1337281669,Africa,63148,2285
W_AF,2020-20,21424,469,Africa,1337281669,Africa,84572,2754
W_AF,2020-21,27093,580,Africa,1339423921,Africa,111665,3334
W_AF,2020-22,35087,883,Africa,1339423921,Africa,146752,4217
W_AF,2020-23,42602,949,Africa,1339423921,Africa,189354,5166
W_AF,2020-24,53527,1352,Africa,1339423921,Africa,242881,6518
W_AF,2020-25,62942,1588,Africa,1339423921,Africa,305823,8106
W_AF,2020-26,76663,1549,Africa,1339423921,Africa,382486,9655
W_AF,2020-27,95341,1712,Africa,1339423921,Africa,477827,11367
W_AF,2020-28,117490,1872,Africa,1339423921,Africa,595317,13239
W_AF,2020-29,126318,1904,Africa,1339423921,Africa,721635,15143
W_AF,2020-30,125799,2616,Africa,1339423921,Africa,847434,17759
W_AF,2020-31,110152,2507,Africa,1339423921,Africa,957586,20266
W_AF,2020-32,90991,2989,Africa,1339423921,Africa,1048577,23255
W_AF,2020-33,70758,2373,Africa,1339423921,Africa,1119335,25628
W_AF,2020-34,68608,2124,Africa,1339423921,Africa,1187943,27752
W_AF,2020-35,57998,1828,Africa,1339423921,Africa,1245941,29580
W_AF,2020-36,53958,1697,Africa,1339423921,Africa,1299899,31277
W_AF,2020-37,53884,1338,Africa,1339423921,Africa,1353783,32615
W_AF,2020-38,54413,1330,Africa,1339423921,Africa,1408196,33945
W_AF,2020-39,52596,1209,Africa,1339423921,Africa,1460792,35154
W_AF,2020-40,55870,1348,Africa,1339423921,Africa,1516662,36502
W_AF,2020-41,62404,1568,Africa,1339423921,Africa,1579066,38070
W_AF,2020-42,67552,1666,Africa,1339423921,Africa,1646618,39736
W_AF,2020-43,72041,1518,Africa,1339423921,Africa,1718659,41254
W_AF,2020-44,77845,1943,Africa,1339423921,Africa,1796504,43197
W_AF,2020-45,86811,2153,Africa,1339423921,Africa,1883315,45350
W_AF,2020-46,92722,2005,Africa,1339423921,Africa,1976037,47355
W_AF,2020-47,90435,2295,Africa,1339423921,Africa,2066472,49650
W_AF,2020-48,97447,2071,Africa,1339423921,Africa,2163919,51721
W_AF,2020-49,98997,2133,Africa,1339423921,Africa,2262916,53854
W_AF,2020-50,117838,2483,Africa,1339423921,Africa,2380754,56337
W_AF,2020-51,130951,3010,Africa,1339423921,Africa,2511705,59347
W_AF,2020-52,162438,3842,Africa,1339423921,Africa,2674143,63189
W_AF,2020-53,158366,4086,Africa,1339423921,Africa,2832509,67275
W_AF,2021-01,227221,5554,Africa,1339423921,Africa,3059730,72829
W_AF,2021-02,203631,6060,Africa,1339423921,Africa,3263361,78889
W_AF,2021-03,183817,6501,Africa,1339423921,Africa,3447178,85390
W_AF,2021-04,132387,6003,Africa,1339423921,Africa,3579565,91393
W_AF,2021-05,93372,3730,Africa,1339423921,Africa,3672937,95123
W_AF,2021-06,81145,3392,Africa,1339423921,Africa,3754082,98515
W_AF,2021-07,81305,2954,Africa,1339423921,Africa,3835387,101469
W_AF,2021-08,62559,2244,Africa,1339423921,Africa,3897946,103713
W_AF,2021-09,72180,2070,Africa,1339423921,Africa,3970126,105783
W_AF,2021-10,66346,2038,Africa,1339423921,Africa,4036472,107821
W_AF,2021-11,71880,2118,Africa,1339423921,Africa,4108352,109939
W_AF,2021-12,77860,2001,Africa,1339423921,Africa,4186212,111940
W_AF,2021-13,82232,1853,Africa,1339423921,Africa,4268444,113793
W_AF,2021-14,78125,1866,Africa,1339423921,Africa,4346569,115659
W_AF,2021-15,84826,2270,Africa,1339423921,Africa,4431395,117929
W_AF,2021-16,77167,2269,Africa,1339423921,Africa,4508562,120198
W_AF,2021-17,62983,2101,Africa,1339423921,Africa,4571545,122299
W_AF,2021-18,63030,2123,Africa,1339423921,Africa,4634575,124422
W_AF,2021-19,60313,1967,Africa,1339423921,Africa,4694888,126389
W_AF,2021-20,66329,1914,Africa,1339423921,Africa,4761217,128303
W_AF,2021-21,74185,2091,Africa,1339423921,Africa,4835402,130394
W_AF,2021-22,92793,1948,Africa,1339423921,Africa,4928195,132342
W_AF,2021-23,120278,2338,Africa,1339423921,Africa,5048473,134680
W_AF,2021-24,164198,2833,Africa,1339423921,Africa,5212671,137513
W_AF,2021-25,212000,3786,Africa,1339423921,Africa,5424671,141299
W_AF,2021-26,251170,4980,Africa,1339423921,Africa,5675841,146279
W_AF,2021-27,285963,5629,Africa,1339423921,Africa,5961804,151908
W_AF,2021-28,282684,5940,Africa,1339423921,Africa,6244488,157848
W_AF,2021-29,240531,6947,Africa,1339423921,Africa,6485019,164795
W_AF,2021-30,270081,6439,Africa,1339423921,Africa,6755100,171234
W_AF,2021-31,288304,6392,Africa,1339423921,Africa,7043404,177626
W_AF,2021-32,248654,6140,Africa,1339423921,Africa,7292058,183766
W_AM,2020-02,0,0,America,738727930,America,0,0
W_AM,2020-03,1,0,America,738727930,America,1,0
W_AM,2020-04,6,0,America,738727930,America,7,0
W_AM,2020-05,10,0,America,738727930,America,17,0
W_AM,2020-06,4,0,America,738727930,America,21,0
W_AM,2020-07,5,0,America,738727930,America,26,0
W_AM,2020-08,22,0,America,738727930,America,48,0
W_AM,2020-09,89,2,America,738727930,America,137,2
W_AM,2020-10,549,19,America,738727930,America,686,21
W_AM,2020-11,4088,52,America,841105876,America,4774,73
W_AM,2020-12,37402,512,America,968889991,America,42176,585
W_AM,2020-13,122951,2430,America,1017749131,America,165127,3015
W_AM,2020-14,223107,8389,America,1021673859,America,388234,11404
W_AM,2020-15,260975,14967,America,1021703563,America,649209,26371
W_AM,2020-16,254206,22580,America,1021703563,America,903415,48951
W_AM,2020-17,286068,19856,America,1021703563,America,1189483,68807
W_AM,2020-18,295501,21601,America,1021703563,America,1484984,90408
W_AM,2020-19,299381,22782,America,1021703563,America,1784365,113190
W_AM,2020-20,320102,22370,America,1021703563,America,2104467,135560
W_AM,2020-21,386993,22527,America,1021703563,America,2491460,158087
W_AM,2020-22,437222,21952,America,1021703563,America,2928682,180039
W_AM,2020-23,466168,24006,America,1021703563,America,3394850,204045
W_AM,2020-24,483501,22582,America,1021703563,America,3878351,226627
W_AM,2020-25,596216,23424,America,1021703563,America,4474567,250051
W_AM,2020-26,697218,24631,America,1021703563,America,5171785,274682
W_AM,2020-27,780273,22847,America,1021703563,America,5952058,297529
W_AM,2020-28,872580,24610,America,1021703563,America,6824638,322139
W_AM,2020-29,930366,25972,America,1021703563,America,7755004,348111
W_AM,2020-30,1031343,27413,America,1021703563,America,8786347,375524
W_AM,2020-31,1015736,28652,America,1021703563,America,9802083,404176
W_AM,2020-32,960795,29295,America,1021703563,America,10762878,433471
W_AM,2020-33,967589,27865,America,1021703563,America,11730467,461336
W_AM,2020-34,851689,26557,America,1021703563,America,12582156,487893
W_AM,2020-35,843399,24974,America,1021703563,America,13425555,512867
W_AM,2020-36,825339,28542,America,1021703563,America,14250894,541409
W_AM,2020-37,711229,20451,America,1021703563,America,14962123,561860
W_AM,2020-38,766221,19847,America,1021703563,America,15728344,581707
W_AM,2020-39,777208,20319,America,1021703563,America,16505552,602026
W_AM,2020-40,743826,21973,America,1021703563,America,17249378,623999
W_AM,2020-41,800395,20709,America,1021703563,America,18049773,644708
W_AM,2020-42,790928,16901,America,1021703563,America,18840701,661609
W_AM,2020-43,933633,17657,America,1021703563,America,19774334,679266
W_AM,2020-44,1004406,17442,America,1021703563,America,20778740,696708
W_AM,2020-45,1146061,17903,America,1021703563,America,21924801,714611
W_AM,2020-46,1525762,20955,America,1021703563,America,23450563,735566
W_AM,2020-47,1664278,22180,America,1021703563,America,25114841,757746
W_AM,2020-48,1669229,22929,America,1021703563,America,26784070,780675
W_AM,2020-49,1964448,28799,America,1021703563,America,28748518,809474
W_AM,2020-50,2096343,30501,America,1021703563,America,30844861,839975
W_AM,2020-51,2324638,35168,America,1021703563,America,33169499,875143
W_AM,2020-52,1846715,29081,America,1021703563,America,35016214,904224
W_AM,2020-53,2070018,33070,America,1021703563,America,37086232,937294
W_AM,2021-01,2698701,45815,America,1021703563,America,39784933,983109
W_AM,2021-02,2409445,45567,America,1021703563,America,42194378,1028676
W_AM,2021-03,2205870,50496,America,1021703563,America,44400248,1079172
W_AM,2021-04,1800194,49242,America,1021703563,America,46200442,1128414
W_AM,2021-05,1347319,45169,America,1021703563,America,47547761,1173583
W_AM,2021-06,1309731,48517,America,1021703563,America,48857492,1222100
W_AM,2021-07,1098154,33980,America,1021703563,America,49955646,1256080
W_AM,2021-08,1080181,38114,America,1021703563,America,51035827,1294194
W_AM,2021-09,1111981,35718,America,1021703563,America,52147808,1329912
W_AM,2021-10,1258566,35480,America,1021703563,America,53406374,1365392
W_AM,2021-11,1160132,34393,America,1021703563,America,54566506,1399785
W_AM,2021-12,1420251,38989,America,1021703563,America,55986757,1438774
W_AM,2021-13,1227623,35967,America,1021703563,America,57214380,1474741
W_AM,2021-14,1627511,47678,America,1021703563,America,58841891,1522419
W_AM,2021-15,1428528,39730,America,1021703563,America,60270419,1562149
W_AM,2021-16,1437931,40399,America,1021703563,America,61708350,1602548
W_AM,2021-17,1241061,38175,America,1021703563,America,62949411,1640723
W_AM,2021-18,1232139,35593,America,1021703563,America,64181550,1676316
W_AM,2021-19,1125942,30808,America,1021703563,America,65307492,1707124
W_AM,2021-20,1267357,33546,America,1021703563,America,66574849,1740670
W_AM,2021-21,1191961,33582,America,1021703563,America,67766810,1774252
W_AM,2021-22,1204900,34600,America,1021703563,America,68971710,1808852
W_AM,2021-23,1149714,31638,America,1021703563,America,70121424,1840490
W_AM,2021-24,1122439,31593,America,1021703563,America,71243863,1872083
W_AM,2021-25,1150821,28391,America,1021703563,America,72394684,1900474
W_AM,2021-26,949611,26018,America,1021703563,America,73344295,1926492
W_AM,2021-27,953997,23461,America,1021703563,America,74298292,1949953
W_AM,2021-28,977000,20912,America,1021703563,America,75275292,1970865
W_AM,2021-29,1060971,28252,America,1021703563,America,76336263,1999117
W_AM,2021-30,1230703,20082,America,1021703563,America,77566966,2019199
W_AM,2021-31,1403541,20076,America,1021703563,America,78970507,2039275
W_AM,2021-32,1506128,19776,America,1021703563,America,80476635,2059051
W_AS,2020-02,1,1,Asia,4099986551,Asia,1,1
W_AS,2020-03,179,2,Asia,4099986551,Asia,180,3
W_AS,2020-04,2568,78,Asia,4099986551,Asia,2748,81
W_AS,2020-05,14514,281,Asia,4099986551,Asia,17262,362
W_AS,2020-06,23078,548,Asia,4099986551,Asia,40340,910
W_AS,2020-07,30493,864,Asia,4099986551,Asia,70833,1774
W_AS,2020-08,7510,839,Asia,4099986551,Asia,78343,2613
W_AS,2020-09,7588,386,Asia,4099986551,Asia,85931,2999
W_AS,2020-10,10094,384,Asia,4099986551,Asia,96025,3383
W_AS,2020-11,10673,689,Asia,4300030343,Asia,106698,4072
W_AS,2020-12,15051,1173,Asia,4368018288,Asia,121749,5245
W_AS,2020-13,30561,1288,Asia,4397411482,Asia,152310,6533
W_AS,2020-14,42717,1496,Asia,4459096832,Asia,195027,8029
W_AS,2020-15,43541,1702,Asia,4459096832,Asia,238568,9731
W_AS,2020-16,54027,2915,Asia,4488922800,Asia,292595,12646
W_AS,2020-17,64707,1700,Asia,4488922800,Asia,357302,14346
W_AS,2020-18,69883,1802,Asia,4488922800,Asia,427185,16148
W_AS,2020-19,96129,2151,Asia,4498460442,Asia,523314,18299
W_AS,2020-20,118930,2207,Asia,4498460442,Asia,642244,20506
W_AS,2020-21,150934,2494,Asia,4498460442,Asia,793178,23000
W_AS,2020-22,166458,3060,Asia,4498460442,Asia,959636,26060
W_AS,2020-23,213084,3951,Asia,4498460442,Asia,1172720,30011
W_AS,2020-24,243252,5110,Asia,4498460442,Asia,1415972,35121
W_AS,2020-25,265844,7736,Asia,4498460442,Asia,1681816,42857
W_AS,2020-26,293051,6221,Asia,4498460442,Asia,1974867,49078
W_AS,2020-27,350269,7135,Asia,4498460442,Asia,2325136,56213
W_AS,2020-28,368154,7877,Asia,4498460442,Asia,2693290,64090
W_AS,2020-29,425608,9346,Asia,4498460442,Asia,3118898,73436
W_AS,2020-30,491525,9778,Asia,4498460442,Asia,3610423,83214
W_AS,2020-31,544936,9444,Asia,4498460442,Asia,4155359,92658
W_AS,2020-32,588521,10111,Asia,4498460442,Asia,4743880,102769
W_AS,2020-33,612707,10161,Asia,4498460442,Asia,5356587,112930
W_AS,2020-34,632575,9898,Asia,4498460442,Asia,5989162,122828
W_AS,2020-35,686756,10714,Asia,4498460442,Asia,6675918,133542
W_AS,2020-36,754516,10693,Asia,4498460442,Asia,7430434,144235
W_AS,2020-37,835343,11783,Asia,4498460442,Asia,8265777,156018
W_AS,2020-38,851577,12466,Asia,4498460442,Asia,9117354,168484
W_AS,2020-39,812699,11843,Asia,4498460442,Asia,9930053,180327
W_AS,2020-40,776626,11487,Asia,4498460442,Asia,10706679,191814
W_AS,2020-41,723551,11236,Asia,4498460442,Asia,11430230,203050
W_AS,2020-42,659287,10248,Asia,4498460442,Asia,12089517,213298
W_AS,2020-43,596327,9671,Asia,4498460442,Asia,12685844,222969
W_AS,2020-44,562378,9066,Asia,4498460442,Asia,13248222,232035
W_AS,2020-45,602872,9992,Asia,4498460442,Asia,13851094,242027
W_AS,2020-46,591328,9729,Asia,4498460442,Asia,14442422,251756
W_AS,2020-47,621667,10501,Asia,4498460442,Asia,15064089,262257
W_AS,2020-48,629773,10111,Asia,4498460442,Asia,15693862,272368
W_AS,2020-49,580305,9407,Asia,4498460442,Asia,16274167,281775
W_AS,2020-50,507725,8353,Asia,4498460442,Asia,16781892,290128
W_AS,2020-51,456340,7698,Asia,4498460442,Asia,17238232,297826
W_AS,2020-52,434466,7252,Asia,4498460442,Asia,17672698,305078
W_AS,2020-53,426554,6454,Asia,4498460442,Asia,18099252,311532
W_AS,2021-01,479462,6120,Asia,4498460442,Asia,18578714,317652
W_AS,2021-02,497268,6640,Asia,4498460442,Asia,19075982,324292
W_AS,2021-03,460650,6513,Asia,4498460442,Asia,19536632,330805
W_AS,2021-04,467221,7221,Asia,4498460442,Asia,20003853,338026
W_AS,2021-05,433513,5849,Asia,4498460442,Asia,20437366,343875
W_AS,2021-06,388397,5374,Asia,4498460442,Asia,20825763,349249
W_AS,2021-07,407827,5113,Asia,4498460442,Asia,21233590,354362
W_AS,2021-08,443949,6149,Asia,4498460442,Asia,21677539,360511
W_AS,2021-09,451723,5238,Asia,4498460442,Asia,22129262,365749
W_AS,2021-10,512027,5286,Asia,4498460442,Asia,22641289,371035
W_AS,2021-11,657242,5783,Asia,4498460442,Asia,23298531,376818
W_AS,2021-12,773618,6185,Asia,4498460442,Asia,24072149,383003
W_AS,2021-13,1033550,7692,Asia,4498460442,Asia,25105699,390695
W_AS,2021-14,1519415,13050,Asia,4498460442,Asia,26625114,403745
W_AS,2021-15,2156801,16874,Asia,4498460442,Asia,28781915,420619
W_AS,2021-16,2658762,25150,Asia,4498460442,Asia,31440677,445769
W_AS,2021-17,3344360,32080,Asia,4498460442,Asia,34785037,477849
W_AS,2021-18,3277557,35786,Asia,4498460442,Asia,38062594,513635
W_AS,2021-19,2796922,36968,Asia,4498460442,Asia,40859516,550603
W_AS,2021-20,2291565,36702,Asia,4498460442,Asia,43151081,587305
W_AS,2021-21,1792846,36901,Asia,4498460442,Asia,44943927,624206
W_AS,2021-22,1328136,28087,Asia,4498460442,Asia,46272063,652293
W_AS,2021-23,1035958,32746,Asia,4498460442,Asia,47308021,685039
W_AS,2021-24,915306,22041,Asia,4498460442,Asia,48223327,707080
W_AS,2021-25,874327,16720,Asia,4498460442,Asia,49097654,723800
W_AS,2021-26,961320,16000,Asia,4498460442,Asia,50058974,739800
W_AS,2021-27,1139532,19034,Asia,4498460442,Asia,51198506,758834
W_AS,2021-28,1380340,21816,Asia,4498460442,Asia,52578846,780650
W_AS,2021-29,1387445,26615,Asia,4498460442,Asia,53966291,807265
W_AS,2021-30,1573168,29410,Asia,4498460442,Asia,55539459,836675
W_AS,2021-31,1709680,31668,Asia,4498460442,Asia,57249139,868343
W_AS,2021-32,1595514,31225,Asia,4498460442,Asia,58844653,899568
W_EU,2020-02,0,0,Europe,628503810,Europe,0,0
W_EU,2020-03,0,0,Europe,628503810,Europe,0,0
W_EU,2020-04,3,0,Europe,628503810,Europe,3,0
W_EU,2020-05,21,0,Europe,628503810,Europe,24,0
W_EU,2020-06,17,0,Europe,628503810,Europe,41,0
W_EU,2020-07,5,1,Europe,628503810,Europe,46,1
W_EU,2020-08,473,2,Europe,628503810,Europe,519,3
W_EU,2020-09,1775,35,Europe,628503810,Europe,2294,38
W_EU,2020-10,10909,361,Europe,628503810,Europe,13203,399
W_EU,2020-11,46867,2002,Europe,706349658,Europe,60070,2401
W_EU,2020-12,128718,6569,Europe,850279301,Europe,188788,8970
W_EU,2020-13,226990,16204,Europe,851192161,Europe,415778,25174
W_EU,2020-14,256619,26576,Europe,851192161,Europe,672397,51750
W_EU,2020-15,246565,28800,Europe,851192161,Europe,918962,80550
W_EU,2020-16,220433,26860,Europe,851192161,Europe,1139395,107410
W_EU,2020-17,200913,20939,Europe,851192161,Europe,1340308,128349
W_EU,2020-18,171794,16035,Europe,851192161,Europe,1512102,144384
W_EU,2020-19,172304,11926,Europe,851192161,Europe,1684406,156310
W_EU,2020-20,152498,9556,Europe,851192161,Europe,1836904,165866
W_EU,2020-21,132659,5689,Europe,851192161,Europe,1969563,171555
W_EU,2020-22,123127,5712,Europe,851192161,Europe,2092690,177267
W_EU,2020-23,120649,4544,Europe,851192161,Europe,2213339,181811
W_EU,2020-24,124452,3790,Europe,851192161,Europe,2337791,185601
W_EU,2020-25,123063,4609,Europe,851192161,Europe,2460854,190210
W_EU,2020-26,118783,2820,Europe,851192161,Europe,2579637,193030
W_EU,2020-27,109916,2818,Europe,851192161,Europe,2689553,195848
W_EU,2020-28,108518,2765,Europe,851192161,Europe,2798071,198613
W_EU,2020-29,113484,2436,Europe,851192161,Europe,2911555,201049
W_EU,2020-30,124724,2239,Europe,851192161,Europe,3036279,203288
W_EU,2020-31,175644,2293,Europe,851192161,Europe,3211923,205581
W_EU,2020-32,200953,2396,Europe,851192161,Europe,3412876,207977
W_EU,2020-33,223102,2493,Europe,851192161,Europe,3635978,210470
W_EU,2020-34,248096,2395,Europe,851192161,Europe,3884074,212865
W_EU,2020-35,278173,2532,Europe,851192161,Europe,4162247,215397
W_EU,2020-36,312139,2967,Europe,851192161,Europe,4474386,218364
W_EU,2020-37,361967,3110,Europe,851192161,Europe,4836353,221474
W_EU,2020-38,422230,4206,Europe,851192161,Europe,5258583,225680
W_EU,2020-39,465910,4663,Europe,851192161,Europe,5724493,230343
W_EU,2020-40,540722,5182,Europe,851192161,Europe,6265215,235525
W_EU,2020-41,783101,6667,Europe,851192161,Europe,7048316,242192
W_EU,2020-42,1077445,8846,Europe,851192161,Europe,8125761,251038
W_EU,2020-43,1532159,12520,Europe,851192161,Europe,9657920,263558
W_EU,2020-44,1908757,18332,Europe,851192161,Europe,11566677,281890
W_EU,2020-45,2023340,26754,Europe,851192161,Europe,13590017,308644
W_EU,2020-46,1901381,30469,Europe,851192161,Europe,15491398,339113
W_EU,2020-47,1765107,33682,Europe,851192161,Europe,17256505,372795
W_EU,2020-48,1705832,37044,Europe,851192161,Europe,18962337,409839
W_EU,2020-49,1658777,36357,Europe,851192161,Europe,20621114,446196
W_EU,2020-50,1704979,36400,Europe,851192161,Europe,22326093,482596
W_EU,2020-51,1683514,35682,Europe,851192161,Europe,24009607,518278
W_EU,2020-52,1725285,35809,Europe,851192161,Europe,25734892,554087
W_EU,2020-53,1593949,33027,Europe,851192161,Europe,27328841,587114
W_EU,2021-01,1898216,37676,Europe,851192161,Europe,29227057,624790
W_EU,2021-02,1644004,38850,Europe,851192161,Europe,30871061,663640
W_EU,2021-03,1495455,40079,Europe,851192161,Europe,32366516,703719
W_EU,2021-04,1325134,38405,Europe,851192161,Europe,33691650,742124
W_EU,2021-05,1163842,35053,Europe,851192161,Europe,34855492,777177
W_EU,2021-06,959143,29600,Europe,851192161,Europe,35814635,806777
W_EU,2021-07,981154,25291,Europe,851192161,Europe,36795789,832068
W_EU,2021-08,1004383,22850,Europe,851192161,Europe,37800172,854918
W_EU,2021-09,1138970,22337,Europe,851192161,Europe,38939142,877255
W_EU,2021-10,1262250,21389,Europe,851192161,Europe,40201392,898644
W_EU,2021-11,1476748,23332,Europe,851192161,Europe,41678140,921976
W_EU,2021-12,1660241,25463,Europe,851192161,Europe,43338381,947439
W_EU,2021-13,1673794,25220,Europe,851192161,Europe,45012175,972659
W_EU,2021-14,1605770,27413,Europe,851192161,Europe,46617945,1000072
W_EU,2021-15,1595775,26463,Europe,851192161,Europe,48213720,1026535
W_EU,2021-16,1433258,25848,Europe,851192161,Europe,49646978,1052383
W_EU,2021-17,1103722,22321,Europe,851192161,Europe,50750700,1074704
W_EU,2021-18,878084,19165,Europe,851192161,Europe,51628784,1093869
W_EU,2021-19,676302,16523,Europe,851192161,Europe,52305086,1110392
W_EU,2021-20,557073,13061,Europe,851192161,Europe,52862159,1123453
W_EU,2021-21,439686,11280,Europe,851192161,Europe,53301845,1134733
W_EU,2021-22,355515,8577,Europe,851192161,Europe,53657360,1143310
W_EU,2021-23,360298,8340,Europe,851192161,Europe,54017658,1151650
W_EU,2021-24,302679,6974,Europe,851192161,Europe,54320337,1158624
W_EU,2021-25,398462,7567,Europe,851192161,Europe,54718799,1166191
W_EU,2021-26,539166,6819,Europe,851192161,Europe,55257965,1173010
W_EU,2021-27,695060,7817,Europe,851192161,Europe,55953025,1180827
W_EU,2021-28,1000202,7246,Europe,851192161,Europe,56953227,1188073
W_EU,2021-29,1013573,7508,Europe,851192161,Europe,57966800,1195581
W_EU,2021-30,1018852,8277,Europe,851192161,Europe,58985652,1203858
W_EU,2021-31,1022807,8180,Europe,851192161,Europe,60008459,1212038
W_EU,2021-32,1087120,9892,Europe,851192161,Europe,61095579,1221930
W_OC,2020-02,0,0,Oceania,30322114,Oceania,0,0
W_OC,2020-03,0,0,Oceania,30322114,Oceania,0,0
W_OC,2020-04,4,0,Oceania,30322114,Oceania,4,0
W_OC,2020-05,7,0,Oceania,30322114,Oceania,11,0
W_OC,2020-06,3,0,Oceania,30322114,Oceania,14,0
W_OC,2020-07,1,0,Oceania,30322114,Oceania,15,0
W_OC,2020-08,7,0,Oceania,30322114,Oceania,22,0
W_OC,2020-09,8,1,Oceania,30322114,Oceania,30,1
W_OC,2020-10,55,2,Oceania,30322114,Oceania,85,3
W_OC,2020-11,221,2,Oceania,30322114,Oceania,306,5
W_OC,2020-12,1505,2,Oceania,30322114,Oceania,1811,7
W_OC,2020-13,2892,10,Oceania,40900763,Oceania,4703,17
W_OC,2020-14,2082,23,Oceania,40900763,Oceania,6785,40
W_OC,2020-15,772,31,Oceania,40958320,Oceania,7557,71
W_OC,2020-16,345,16,Oceania,40958320,Oceania,7902,87
W_OC,2020-17,128,20,Oceania,40958320,Oceania,8030,107
W_OC,2020-18,111,13,Oceania,40958320,Oceania,8141,120
W_OC,2020-19,156,3,Oceania,40958320,Oceania,8297,123
W_OC,2020-20,114,1,Oceania,40958320,Oceania,8411,124
W_OC,2020-21,82,4,Oceania,40958320,Oceania,8493,128
W_OC,2020-22,96,1,Oceania,40958320,Oceania,8589,129
W_OC,2020-23,75,0,Oceania,40958320,Oceania,8664,129
W_OC,2020-24,70,0,Oceania,40958320,Oceania,8734,129
W_OC,2020-25,188,0,Oceania,40958320,Oceania,8922,129
W_OC,2020-26,275,2,Oceania,40958320,Oceania,9197,131
W_OC,2020-27,817,0,Oceania,40958320,Oceania,10014,131
W_OC,2020-28,1380,4,Oceania,40958320,Oceania,11394,135
W_OC,2020-29,2033,14,Oceania,40958320,Oceania,13427,149
W_OC,2020-30,2679,33,Oceania,40958320,Oceania,16106,182
W_OC,2020-31,3607,56,Oceania,40958320,Oceania,19713,238
W_OC,2020-32,3320,88,Oceania,40958320,Oceania,23033,326
W_OC,2020-33,2647,101,Oceania,40958320,Oceania,25680,427
W_OC,2020-34,1964,109,Oceania,40958320,Oceania,27644,536
W_OC,2020-35,1684,114,Oceania,40958320,Oceania,29328,650
W_OC,2020-36,1239,148,Oceania,40958320,Oceania,30567,798
W_OC,2020-37,880,71,Oceania,40958320,Oceania,31447,869
W_OC,2020-38,932,50,Oceania,40958320,Oceania,32379,919
W_OC,2020-39,423,34,Oceania,40958320,Oceania,32802,953
W_OC,2020-40,1106,35,Oceania,40958320,Oceania,33908,988
W_OC,2020-41,1269,14,Oceania,40958320,Oceania,35177,1002
W_OC,2020-42,1879,16,Oceania,40958320,Oceania,37056,1018
W_OC,2020-43,2740,13,Oceania,41656444,Oceania,39796,1031
W_OC,2020-44,2052,18,Oceania,41656444,Oceania,41848,1049
W_OC,2020-45,3376,20,Oceania,41715638,Oceania,45224,1069
W_OC,2020-46,2691,23,Oceania,41715638,Oceania,47915,1092
W_OC,2020-47,1837,18,Oceania,42022788,Oceania,49752,1110
W_OC,2020-48,1547,16,Oceania,42022788,Oceania,51299,1126
W_OC,2020-49,1316,8,Oceania,42022788,Oceania,52615,1134
W_OC,2020-50,886,23,Oceania,42022788,Oceania,53501,1157
W_OC,2020-51,773,10,Oceania,42022788,Oceania,54274,1167
W_OC,2020-52,590,6,Oceania,42022788,Oceania,54864,1173
W_OC,2020-53,686,9,Oceania,42022788,Oceania,55550,1182
W_OC,2021-01,581,9,Oceania,42022788,Oceania,56131,1191
W_OC,2021-02,622,8,Oceania,42137809,Oceania,56753,1199
W_OC,2021-03,169,1,Oceania,42137809,Oceania,56922,1200
W_OC,2021-04,571,5,Oceania,42137809,Oceania,57493,1205
W_OC,2021-05,248,3,Oceania,42137809,Oceania,57741,1208
W_OC,2021-06,262,3,Oceania,42137809,Oceania,58003,1211
W_OC,2021-07,189,3,Oceania,42137809,Oceania,58192,1214
W_OC,2021-08,423,5,Oceania,42137809,Oceania,58615,1219
W_OC,2021-09,597,7,Oceania,42137809,Oceania,59212,1226
W_OC,2021-10,549,6,Oceania,42137809,Oceania,59761,1232
W_OC,2021-11,2100,17,Oceania,42137809,Oceania,61861,1249
W_OC,2021-12,1805,12,Oceania,42137809,Oceania,63666,1261
W_OC,2021-13,1864,18,Oceania,42137809,Oceania,65530,1279
W_OC,2021-14,1942,9,Oceania,42137809,Oceania,67472,1288
W_OC,2021-15,1416,22,Oceania,42137809,Oceania,68888,1310
W_OC,2021-16,1130,12,Oceania,42137809,Oceania,70018,1322
W_OC,2021-17,858,16,Oceania,42137809,Oceania,70876,1338
W_OC,2021-18,1231,9,Oceania,42137809,Oceania,72107,1347
W_OC,2021-19,1883,16,Oceania,42137809,Oceania,73990,1363
W_OC,2021-20,1385,18,Oceania,42137809,Oceania,75375,1381
W_OC,2021-21,1020,9,Oceania,42137809,Oceania,76395,1390
W_OC,2021-22,1001,2,Oceania,42137809,Oceania,77396,1392
W_OC,2021-23,990,1,Oceania,42137809,Oceania,78386,1393
W_OC,2021-24,1383,11,Oceania,42137809,Oceania,79769,1404
W_OC,2021-25,2103,11,Oceania,42137809,Oceania,81872,1415
W_OC,2021-26,3660,22,Oceania,42137809,Oceania,85532,1437
W_OC,2021-27,4940,29,Oceania,42137809,Oceania,90472,1466
W_OC,2021-28,7867,68,Oceania,42137809,Oceania,98339,1534
W_OC,2021-29,4432,58,Oceania,42137809,Oceania,102771,1592
W_OC,2021-30,12095,95,Oceania,42137809,Oceania,114866,1687
W_OC,2021-31,10695,74,Oceania,42137809,Oceania,125561,1761
W_OC,2021-32,14757,171,Oceania,42137809,Oceania,140318,1932
W_WW,2020-02,1,1,World,5849865438,World,1,1
W_WW,2020-03,180,2,World,5849865438,World,181,3
W_WW,2020-04,2581,78,World,5849865438,World,2762,81
W_WW,2020-05,14552,281,World,5849865438,World,17314,362
W_WW,2020-06,23102,548,World,5849865438,World,40416,910
W_WW,2020-07,30505,865,World,5849865438,World,70921,1775
W_WW,2020-08,8012,841,World,5849865438,World,78933,2616
W_WW,2020-09,9465,424,World,5849865438,World,88398,3040
W_WW,2020-10,21671,767,World,5849865438,World,110069,3807
W_WW,2020-11,61989,2750,World,6315987578,World,172058,6557
W_WW,2020-12,183673,8290,World,7145319036,World,355731,14847
W_WW,2020-13,386606,20031,World,7561215926,World,742337,34878
W_WW,2020-14,529051,36774,World,7655916123,World,1271388,71652
W_WW,2020-15,557196,45855,World,7708546459,World,1828584,117507
W_WW,2020-16,536792,52702,World,7738591588,World,2365376,170209
W_WW,2020-17,561255,42810,World,7738591588,World,2926631,213019
W_WW,2020-18,549973,39835,World,7739188918,World,3476604,252854
W_WW,2020-19,586926,37353,World,7749596155,World,4063530,290207
W_WW,2020-20,613068,34603,World,7749596155,World,4676598,324810
W_WW,2020-21,697761,31294,World,7751738407,World,5374359,356104
W_WW,2020-22,761990,31608,World,7751738407,World,6136349,387712
W_WW,2020-23,842578,33450,World,7751738407,World,6978927,421162
W_WW,2020-24,904802,32834,World,7751738407,World,7883729,453996
W_WW,2020-25,1048253,37357,World,7751738407,World,8931982,491353
W_WW,2020-26,1185990,35223,World,7751738407,World,10117972,526576
W_WW,2020-27,1336616,34512,World,7751738407,World,11454588,561088
W_WW,2020-28,1468122,37128,World,7751738407,World,12922710,598216
W_WW,2020-29,1597809,39672,World,7751738407,World,14520519,637888
W_WW,2020-30,1776070,42079,World,7751738407,World,16296589,679967
W_WW,2020-31,1850075,42952,World,7751738407,World,18146664,722919
W_WW,2020-32,1844580,44879,World,7751738407,World,19991244,767798
W_WW,2020-33,1876803,42993,World,7751738407,World,21868047,810791
W_WW,2020-34,1802932,41083,World,7751738407,World,23670979,851874
W_WW,2020-35,1868010,40162,World,7751738407,World,25538989,892036
W_WW,2020-36,1947191,44047,World,7751738407,World,27486180,936083
W_WW,2020-37,1963303,36753,World,7751738407,World,29449483,972836
W_WW,2020-38,2095373,37899,World,7751738407,World,31544856,1010735
W_WW,2020-39,2108836,38068,World,7751738407,World,33653692,1048803
W_WW,2020-40,2118150,40025,World,7751738407,World,35771842,1088828
W_WW,2020-41,2370720,40194,World,7751738407,World,38142562,1129022
W_WW,2020-42,2597091,37677,World,7751738407,World,40739653,1166699
W_WW,2020-43,3136900,41379,World,7752436531,World,43876553,1208078
W_WW,2020-44,3555438,46801,World,7752436531,World,47431991,1254879
W_WW,2020-45,3862460,56822,World,7752495725,World,51294451,1311701
W_WW,2020-46,4113884,63181,World,7752495725,World,55408335,1374882
W_WW,2020-47,4143324,68676,World,7752802875,World,59551659,1443558
W_WW,2020-48,4103828,72171,World,7752802875,World,63655487,1515729
W_WW,2020-49,4303843,76704,World,7752802875,World,67959330,1592433
W_WW,2020-50,4427771,77760,World,7752802875,World,72387101,1670193
W_WW,2020-51,4596216,81568,World,7752802875,World,76983317,1751761
W_WW,2020-52,4169494,75990,World,7752802875,World,81152811,1827751
W_WW,2020-53,4249573,76646,World,7752802875,World,85402384,1904397
W_WW,2021-01,5304181,95174,World,7752802875,World,90706565,1999571
W_WW,2021-02,4754970,97125,World,7752917896,World,95461535,2096696
W_WW,2021-03,4345961,103590,World,7752917896,World,99807496,2200286
W_WW,2021-04,3725507,100876,World,7752917896,World,103533003,2301162
W_WW,2021-05,3038294,89804,World,7752917896,World,106571297,2390966
W_WW,2021-06,2738678,86886,World,7752917896,World,109309975,2477852
W_WW,2021-07,2568629,67341,World,7752917896,World,111878604,2545193
W_WW,2021-08,2591495,69362,World,7752917896,World,114470099,2614555
W_WW,2021-09,2775451,65370,World,7752917896,World,117245550,2679925
W_WW,2021-10,3099738,64199,World,7752917896,World,120345288,2744124
W_WW,2021-11,3368102,65643,World,7752917896,World,123713390,2809767
W_WW,2021-12,3933775,72650,World,7752917896,World,127647165,2882417
W_WW,2021-13,4019063,70750,World,7752917896,World,131666228,2953167
W_WW,2021-14,4832763,90016,World,7752917896,World,136498991,3043183
W_WW,2021-15,5267346,85359,World,7752917896,World,141766337,3128542
W_WW,2021-16,5608248,93678,World,7752917896,World,147374585,3222220
W_WW,2021-17,5752984,94693,World,7752917896,World,153127569,3316913
W_WW,2021-18,5452041,92676,World,7752917896,World,158579610,3409589
W_WW,2021-19,4661362,86282,World,7752917896,World,163240972,3495871
W_WW,2021-20,4183709,85241,World,7752917896,World,167424681,3581112
W_WW,2021-21,3499698,83863,World,7752917896,World,170924379,3664975
W_WW,2021-22,2982345,73214,World,7752917896,World,173906724,3738189
W_WW,2021-23,2667238,75063,World,7752917896,World,176573962,3813252
W_WW,2021-24,2506005,63452,World,7752917896,World,179079967,3876704
W_WW,2021-25,2637713,56475,World,7752917896,World,181717680,3933179
W_WW,2021-26,2704927,53839,World,7752917896,World,184422607,3987018
W_WW,2021-27,3079492,55970,World,7752917896,World,187502099,4042988
W_WW,2021-28,3648093,55982,World,7752917896,World,191150192,4098970
W_WW,2021-29,3706952,69380,World,7752917896,World,194857144,4168350
W_WW,2021-30,4104899,64303,World,7752917896,World,198962043,4232653
W_WW,2021-31,4435027,66390,World,7752917896,World,203397070,4299043
W_WW,2021-32,4452173,67204,World,7752917896,World,207849243,4366247
